Año,Mes,País destino,Codigo Iso 3166,Femenino,Masculino,Indefinido,Total,Latitud - Longitud
2012,Enero,Afganistán,4,0,1,,1,"(10.886611,-74.776708)"
2012,Enero,Afganistán,4,1,20,,21,"(4.697144,-74.140516)"
2012,Enero,Alemania,276,1,0,,1,"(0.814836,-77.662532)"
2012,Enero,Alemania,276,5,2,,7,"(10.445761,-75.516429)"
2012,Enero,Alemania,276,3,2,,5,"(10.886611,-74.776708)"
2012,Enero,Alemania,276,22,13,,35,"(3.541112,-76.384584)"
2012,Enero,Alemania,276,946,800,,1746,"(4.697144,-74.140516)"
2012,Enero,Alemania,276,12,6,,18,"(6.171601,-75.427454)"
2012,Enero,Andorra,20,1,0,,1,"(4.697144,-74.140516)"
2012,Enero,Angola,24,0,1,,1,"(10.445761,-75.516429)"
2012,Enero,Angola,24,4,21,,25,"(4.697144,-74.140516)"
2012,Enero,Angola,24,1,0,,1,"(6.171601,-75.427454)"
2012,Enero,Angola,24,0,1,,1,"(7.128456,-73.183637)"
2012,Enero,Antigua y Barbuda,28,4,2,,6,"(4.697144,-74.140516)"
2012,Enero,Antigua y Barbuda,28,2,1,,3,"(6.171601,-75.427454)"
2012,Enero,Países Bajos,528,660,525,,1185,"(10.408582,-75.538003)"
2012,Enero,Países Bajos,528,4,0,,4,"(10.445761,-75.516429)"
2012,Enero,Países Bajos,528,4,2,,6,"(10.886611,-74.776708)"
2012,Enero,Países Bajos,528,39,11,,50,"(3.541112,-76.384584)"
2012,Enero,Países Bajos,528,239,138,,377,"(4.697144,-74.140516)"
2012,Enero,Países Bajos,528,1,2,,3,"(4.815061,-75.736532)"
2012,Enero,Países Bajos,528,90,66,,156,"(6.171601,-75.427454)"
2012,Enero,Países Bajos,528,1,0,,1,"(7.128456,-73.183637)"
2012,Enero,Países Bajos,528,0,1,,1,"(7.927209,-72.507910)"
2012,Enero,Arabia Saudita,682,0,1,,1,"(3.541112,-76.384584)"
2012,Enero,Arabia Saudita,682,30,48,,78,"(4.697144,-74.140516)"
2012,Enero,Arabia Saudita,682,1,3,,4,"(6.171601,-75.427454)"
2012,Enero,Argelia,12,0,2,,2,"(3.541112,-76.384584)"
2012,Enero,Argelia,12,5,16,,21,"(4.697144,-74.140516)"
2012,Enero,Argelia,12,0,1,,1,"(4.815061,-75.736532)"
2012,Enero,Argentina,32,4,24,,28,"(0.814836,-77.662532)"
2012,Enero,Argentina,32,15,13,,28,"(10.445761,-75.516429)"
2012,Enero,Argentina,32,17,14,,31,"(10.886611,-74.776708)"
2012,Enero,Argentina,32,2,6,,8,"(12.586067,-81.702563)"
2012,Enero,Argentina,32,173,163,,336,"(3.541112,-76.384584)"
2012,Enero,Argentina,32,3084,3102,,6186,"(4.697144,-74.140516)"
2012,Enero,Argentina,32,6,5,,11,"(4.815061,-75.736532)"
2012,Enero,Argentina,32,219,186,,405,"(6.171601,-75.427454)"
2012,Enero,Argentina,32,5,4,,9,"(7.128456,-73.183637)"
2012,Enero,Argentina,32,1,0,,1,"(7.927209,-72.507910)"
2012,Enero,Aruba,533,2251,1787,,4038,"(10.408582,-75.538003)"
2012,Enero,Aruba,533,3,3,,6,"(10.445761,-75.516429)"
2012,Enero,Aruba,533,16,7,,23,"(10.886611,-74.776708)"
2012,Enero,Aruba,533,209,119,,328,"(11.528919,-72.919681)"
2012,Enero,Aruba,533,22,16,,38,"(3.541112,-76.384584)"
2012,Enero,Aruba,533,1118,996,,2114,"(4.697144,-74.140516)"
2012,Enero,Aruba,533,4,1,,5,"(4.815061,-75.736532)"
2012,Enero,Aruba,533,92,65,,157,"(6.171601,-75.427454)"
2012,Enero,Aruba,533,6,4,,10,"(7.128456,-73.183637)"
2012,Enero,Australia,36,4,2,,6,"(10.445761,-75.516429)"
2012,Enero,Australia,36,3,4,,7,"(10.886611,-74.776708)"
2012,Enero,Australia,36,1,1,,2,"(12.586067,-81.702563)"
2012,Enero,Australia,36,23,17,,40,"(3.541112,-76.384584)"
2012,Enero,Australia,36,1,3,,4,"(4.452882,-75.766298)"
2012,Enero,Australia,36,449,358,,807,"(4.697144,-74.140516)"
2012,Enero,Australia,36,1,1,,2,"(4.815061,-75.736532)"
2012,Enero,Australia,36,58,46,,104,"(6.171601,-75.427454)"
2012,Enero,Australia,36,0,1,,1,"(7.128456,-73.183637)"
2012,Enero,Austria,40,1,2,,3,"(3.541112,-76.384584)"
2012,Enero,Austria,40,26,26,,52,"(4.697144,-74.140516)"
2012,Enero,Austria,40,3,1,,4,"(6.171601,-75.427454)"
2012,Enero,Azerbaiyán,31,1,5,,6,"(4.697144,-74.140516)"
2012,Enero,Bahamas,44,8,3,,11,"(10.445761,-75.516429)"
2012,Enero,Bahamas,44,9,13,,22,"(10.886611,-74.776708)"
2012,Enero,Bahamas,44,8,9,,17,"(3.541112,-76.384584)"
2012,Enero,Bahamas,44,47,53,,100,"(4.697144,-74.140516)"
2012,Enero,Bahamas,44,8,5,,13,"(4.815061,-75.736532)"
2012,Enero,Bahamas,44,37,33,,70,"(6.171601,-75.427454)"
2012,Enero,Bahamas,44,1,2,,3,"(7.128456,-73.183637)"
2012,Enero,Bahamas,44,1,1,,2,"(7.927209,-72.507910)"
2012,Enero,Bahréin,48,1,0,,1,"(4.697144,-74.140516)"
2012,Enero,Bangladesh,50,1,0,,1,"(4.697144,-74.140516)"
2012,Enero,Barbados,52,1,0,,1,"(10.445761,-75.516429)"
2012,Enero,Barbados,52,1,0,,1,"(3.541112,-76.384584)"
2012,Enero,Barbados,52,1,5,,6,"(4.697144,-74.140516)"
2012,Enero,Barbados,52,1,1,,2,"(6.171601,-75.427454)"
2012,Enero,República de Belarús,112,2,3,,5,"(11.360009,-72.129330)"
2012,Enero,República de Belarús,112,3,1,,4,"(3.541112,-76.384584)"
2012,Enero,República de Belarús,112,6,2,,8,"(4.697144,-74.140516)"
2012,Enero,República de Belarús,112,1,0,,1,"(6.171601,-75.427454)"
2012,Enero,República de Belarús,112,12,12,,24,"(7.818934,-72.453226)"
2012,Enero,Bélgica,56,0,1,,1,"(10.445761,-75.516429)"
2012,Enero,Bélgica,56,1,0,,1,"(10.886611,-74.776708)"
2012,Enero,Bélgica,56,9,11,,20,"(3.541112,-76.384584)"
2012,Enero,Bélgica,56,122,79,,201,"(4.697144,-74.140516)"
2012,Enero,Bélgica,56,12,7,,19,"(6.171601,-75.427454)"
2012,Enero,Belice,84,1,1,,2,"(3.541112,-76.384584)"
2012,Enero,Belice,84,3,2,,5,"(4.697144,-74.140516)"
2012,Enero,Bermudas/Territorio Británico de Ultramar,60,1,1,,2,"(4.697144,-74.140516)"
2012,Enero,Bolivia,68,1,1,,2,"(0.814836,-77.662532)"
2012,Enero,Bolivia,68,0,1,,1,"(10.445761,-75.516429)"
2012,Enero,Bolivia,68,1,0,,1,"(10.886611,-74.776708)"
2012,Enero,Bolivia,68,14,27,,41,"(3.541112,-76.384584)"
2012,Enero,Bolivia,68,213,378,,591,"(4.697144,-74.140516)"
2012,Enero,Bolivia,68,0,1,,1,"(4.815061,-75.736532)"
2012,Enero,Bolivia,68,19,27,,46,"(6.171601,-75.427454)"
2012,Enero,Bolivia,68,1,2,,3,"(7.128456,-73.183637)"
2012,Enero,Botsuana,72,1,2,,3,"(4.697144,-74.140516)"
2012,Enero,Brasil,76,117,143,,260,"(-4.197703,-69.941278)"
2012,Enero,Brasil,76,0,1,,1,"(0.814836,-77.662532)"
2012,Enero,Brasil,76,6,9,,15,"(10.445761,-75.516429)"
2012,Enero,Brasil,76,6,12,,18,"(10.886611,-74.776708)"
2012,Enero,Brasil,76,0,1,,1,"(12.586067,-81.702563)"
2012,Enero,Brasil,76,37,52,,89,"(3.541112,-76.384584)"
2012,Enero,Brasil,76,1895,2583,,4478,"(4.697144,-74.140516)"
2012,Enero,Brasil,76,1,2,,3,"(4.815061,-75.736532)"
2012,Enero,Brasil,76,74,81,,155,"(6.171601,-75.427454)"
2012,Enero,Brasil,76,0,1,,1,"(7.128456,-73.183637)"
2012,Enero,Brasil,76,0,1,,1,"(7.927209,-72.507910)"
2012,Enero,Brunei Darussalam,96,0,1,,1,"(4.697144,-74.140516)"
2012,Enero,Bulgaria,100,1,3,,4,"(4.697144,-74.140516)"
2012,Enero,Burkina Faso,854,0,1,,1,"(4.697144,-74.140516)"
2012,Enero,Islas Caimán/Territorio Británico de Ultramar,136,1,0,,1,"(10.445761,-75.516429)"
2012,Enero,Islas Caimán/Territorio Británico de Ultramar,136,27,32,,59,"(12.586067,-81.702563)"
2012,Enero,Islas Caimán/Territorio Británico de Ultramar,136,2,0,,2,"(3.541112,-76.384584)"
2012,Enero,Islas Caimán/Territorio Británico de Ultramar,136,1,0,,1,"(4.697144,-74.140516)"
2012,Enero,Islas Caimán/Territorio Británico de Ultramar,136,1,0,,1,"(6.171601,-75.427454)"
2012,Enero,Camerún,120,1,2,,3,"(4.697144,-74.140516)"
2012,Enero,Canadá,124,275,240,,515,"(10.445761,-75.516429)"
2012,Enero,Canadá,124,39,38,,77,"(10.886611,-74.776708)"
2012,Enero,Canadá,124,22,21,,43,"(12.586067,-81.702563)"
2012,Enero,Canadá,124,197,158,,355,"(3.541112,-76.384584)"
2012,Enero,Canadá,124,43,39,,82,"(4.452882,-75.766298)"
2012,Enero,Canadá,124,2499,2404,,4903,"(4.697144,-74.140516)"
2012,Enero,Canadá,124,8,3,,11,"(4.815061,-75.736532)"
2012,Enero,Canadá,124,366,303,,669,"(6.171601,-75.427454)"
2012,Enero,Canadá,124,15,12,,27,"(7.128456,-73.183637)"
2012,Enero,Canadá,124,0,1,,1,"(7.927209,-72.507910)"
2012,Enero,Chad,148,0,1,,1,"(3.541112,-76.384584)"
2012,Enero,España,724,3,0,,3,"(0.814836,-77.662532)"
2012,Enero,España,724,13,9,,22,"(10.445761,-75.516429)"
2012,Enero,España,724,4,3,,7,"(10.886611,-74.776708)"
2012,Enero,España,724,2462,1561,,4023,"(3.541112,-76.384584)"
2012,Enero,España,724,3,0,,3,"(4.452882,-75.766298)"
2012,Enero,España,724,9246,6637,,15883,"(4.697144,-74.140516)"
2012,Enero,España,724,2,0,,2,"(4.815061,-75.736532)"
2012,Enero,España,724,679,500,,1179,"(6.171601,-75.427454)"
2012,Enero,República Democrática del Congo,180,6,7,,13,"(4.697144,-74.140516)"
2012,Enero,República Democrática del Congo,180,1,4,,5,"(6.171601,-75.427454)"
2012,Enero,República Democrática del Congo,180,2,1,,3,"(7.128456,-73.183637)"
2012,Enero,República de Corea,410,0,1,,1,"(3.541112,-76.384584)"
2012,Enero,República de Corea,410,10,20,,30,"(4.697144,-74.140516)"
2012,Enero,República de Corea,410,0,2,,2,"(6.171601,-75.427454)"
2012,Enero,Costa de Marfil,384,0,2,,2,"(4.697144,-74.140516)"
2012,Enero,Costa Rica,188,27,20,,47,"(10.445761,-75.516429)"
2012,Enero,Costa Rica,188,45,39,,84,"(10.886611,-74.776708)"
2012,Enero,Costa Rica,188,2,26,,28,"(12.5744111,-81.703935)"
2012,Enero,Costa Rica,188,10,7,,17,"(12.586067,-81.702563)"
2012,Enero,Costa Rica,188,2,14,,16,"(13.3387613,-81.372937)"
2012,Enero,Costa Rica,188,83,78,,161,"(3.541112,-76.384584)"
2012,Enero,Costa Rica,188,1009,1031,,2040,"(4.697144,-74.140516)"
2012,Enero,Costa Rica,188,15,10,,25,"(4.815061,-75.736532)"
2012,Enero,Costa Rica,188,335,344,,679,"(6.171601,-75.427454)"
2012,Enero,Costa Rica,188,14,7,,21,"(7.128456,-73.183637)"
2012,Enero,Costa Rica,188,3,2,,5,"(7.927209,-72.507910)"
2012,Enero,Croacia,191,1,0,,1,"(4.697144,-74.140516)"
2012,Enero,Cuba,192,14,11,,25,"(10.445761,-75.516429)"
2012,Enero,Cuba,192,33,27,,60,"(10.886611,-74.776708)"
2012,Enero,Cuba,192,3,2,,5,"(12.586067,-81.702563)"
2012,Enero,Cuba,192,76,81,,157,"(3.541112,-76.384584)"
2012,Enero,Cuba,192,729,626,,1355,"(4.697144,-74.140516)"
2012,Enero,Cuba,192,8,10,,18,"(4.815061,-75.736532)"
2012,Enero,Cuba,192,142,108,,250,"(6.171601,-75.427454)"
2012,Enero,Cuba,192,18,17,,35,"(7.128456,-73.183637)"
2012,Enero,Curazao,99999,0,2,,2,"(10.408582,-75.538003)"
2012,Enero,Curazao,99999,2,0,,2,"(10.886611,-74.776708)"
2012,Enero,Curazao,99999,0,1,,1,"(3.541112,-76.384584)"
2012,Enero,Curazao,99999,627,629,,1256,"(4.697144,-74.140516)"
2012,Enero,Curazao,99999,1,1,,2,"(4.815061,-75.736532)"
2012,Enero,Curazao,99999,183,122,,305,"(6.171601,-75.427454)"
2012,Enero,República Checa,203,10,8,,18,"(4.697144,-74.140516)"
2012,Enero,Chile,152,26,28,,54,"(0.814836,-77.662532)"
2012,Enero,Chile,152,7,4,,11,"(10.445761,-75.516429)"
2012,Enero,Chile,152,35,26,,61,"(10.886611,-74.776708)"
2012,Enero,Chile,152,3,3,,6,"(12.586067,-81.702563)"
2012,Enero,Chile,152,498,363,,861,"(3.541112,-76.384584)"
2012,Enero,Chile,152,2764,2418,,5182,"(4.697144,-74.140516)"
2012,Enero,Chile,152,7,4,,11,"(4.815061,-75.736532)"
2012,Enero,Chile,152,187,144,,331,"(6.171601,-75.427454)"
2012,Enero,Chile,152,5,5,,10,"(7.128456,-73.183637)"
2012,Enero,Chile,152,0,1,,1,"(7.927209,-72.507910)"
2012,Enero,China,156,1,2,,3,"(10.886611,-74.776708)"
2012,Enero,China,156,1,4,,5,"(3.541112,-76.384584)"
2012,Enero,China,156,104,147,,251,"(4.697144,-74.140516)"
2012,Enero,China,156,6,9,,15,"(6.171601,-75.427454)"
2012,Enero,China,156,0,1,,1,"(7.128456,-73.183637)"
2012,Enero,Chipre,196,2,0,,2,"(4.697144,-74.140516)"
2012,Enero,Dinamarca,208,1,0,,1,"(3.541112,-76.384584)"
2012,Enero,Dinamarca,208,25,21,,46,"(4.697144,-74.140516)"
2012,Enero,Dominica,212,13,9,,22,"(0.814836,-77.662532)"
2012,Enero,Dominica,212,3,1,,4,"(3.541112,-76.384584)"
2012,Enero,Dominica,212,1,1,,2,"(4.697144,-74.140516)"
2012,Enero,Ecuador,218,363,408,,771,"(0.25129,-76.875963)"
2012,Enero,Ecuador,218,12427,12838,,25265,"(0.814836,-77.662532)"
2012,Enero,Ecuador,218,171,178,,349,"(1.813928,-78.763924)"
2012,Enero,Ecuador,218,0,4,,4,"(10.408582,-75.538003)"
2012,Enero,Ecuador,218,4,3,,7,"(10.445761,-75.516429)"
2012,Enero,Ecuador,218,6,7,,13,"(10.886611,-74.776708)"
2012,Enero,Ecuador,218,941,928,,1869,"(3.541112,-76.384584)"
2012,Enero,Ecuador,218,2628,4092,,6720,"(4.697144,-74.140516)"
2012,Enero,Ecuador,218,1,2,,3,"(4.815061,-75.736532)"
2012,Enero,Ecuador,218,449,529,,978,"(6.171601,-75.427454)"
2012,Enero,Ecuador,218,1,1,,2,"(7.128456,-73.183637)"
2012,Enero,Ecuador,218,0,1,,1,"(7.927209,-72.507910)"
2012,Enero,Egipto,818,44,34,,78,"(0.814836,-77.662532)"
2012,Enero,Egipto,818,1,0,,1,"(10.886611,-74.776708)"
2012,Enero,Egipto,818,1,2,,3,"(3.541112,-76.384584)"
2012,Enero,Egipto,818,51,50,,101,"(4.697144,-74.140516)"
2012,Enero,El Salvador,222,0,3,,3,"(10.445761,-75.516429)"
2012,Enero,El Salvador,222,6,3,,9,"(10.886611,-74.776708)"
2012,Enero,El Salvador,222,1,1,,2,"(12.586067,-81.702563)"
2012,Enero,El Salvador,222,11,14,,25,"(3.541112,-76.384584)"
2012,Enero,El Salvador,222,551,650,,1201,"(4.697144,-74.140516)"
2012,Enero,El Salvador,222,1,1,,2,"(4.815061,-75.736532)"
2012,Enero,El Salvador,222,12,35,,47,"(6.171601,-75.427454)"
2012,Enero,El Salvador,222,9,8,,17,"(7.128456,-73.183637)"
2012,Enero,Emiratos Árabes,784,1,0,,1,"(10.445761,-75.516429)"
2012,Enero,Emiratos Árabes,784,6,4,,10,"(3.541112,-76.384584)"
2012,Enero,Emiratos Árabes,784,74,92,,166,"(4.697144,-74.140516)"
2012,Enero,Emiratos Árabes,784,4,2,,6,"(6.171601,-75.427454)"
2012,Enero,Eslovaquia,703,1,2,,3,"(4.697144,-74.140516)"
2012,Enero,Eslovaquia,703,1,0,,1,"(6.171601,-75.427454)"
2012,Enero,Eslovenia,705,3,3,,6,"(4.697144,-74.140516)"
2012,Enero,Eslovenia,705,0,1,,1,"(6.171601,-75.427454)"
2012,Enero,Estados Unidos de América,840,0,1,,1,"(0.814836,-77.662532)"
2012,Enero,Estados Unidos de América,840,0,1,,1,"(10.408582,-75.538003)"
2012,Enero,Estados Unidos de América,840,1715,1497,,3212,"(10.445761,-75.516429)"
2012,Enero,Estados Unidos de América,840,1863,1628,,3491,"(10.886611,-74.776708)"
2012,Enero,Estados Unidos de América,840,0,5,,5,"(11.117806,-74.232622)"
2012,Enero,Estados Unidos de América,840,46,54,,100,"(12.586067,-81.702563)"
2012,Enero,Estados Unidos de América,840,4568,3584,,8152,"(3.541112,-76.384584)"
2012,Enero,Estados Unidos de América,840,465,427,,892,"(4.452882,-75.766298)"
2012,Enero,Estados Unidos de América,840,26054,24839,,50893,"(4.697144,-74.140516)"
2012,Enero,Estados Unidos de América,840,373,297,,670,"(4.815061,-75.736532)"
2012,Enero,Estados Unidos de América,840,6472,5828,,12300,"(6.171601,-75.427454)"
2012,Enero,Estados Unidos de América,840,128,125,,253,"(7.128456,-73.183637)"
2012,Enero,Estados Unidos de América,840,6,8,,14,"(7.927209,-72.507910)"
2012,Enero,Etiopia,231,0,4,,4,"(4.697144,-74.140516)"
2012,Enero,Filipinas,608,1,3,,4,"(3.541112,-76.384584)"
2012,Enero,Filipinas,608,5,3,,8,"(4.697144,-74.140516)"
2012,Enero,Filipinas,608,1,4,,5,"(6.171601,-75.427454)"
2012,Enero,Finlandia,246,0,1,,1,"(10.445761,-75.516429)"
2012,Enero,Finlandia,246,1,0,,1,"(3.541112,-76.384584)"
2012,Enero,Finlandia,246,13,8,,21,"(4.697144,-74.140516)"
2012,Enero,Francia,250,3,2,,5,"(10.445761,-75.516429)"
2012,Enero,Francia,250,3,1,,4,"(10.886611,-74.776708)"
2012,Enero,Francia,250,61,38,,99,"(3.541112,-76.384584)"
2012,Enero,Francia,250,1542,1195,,2737,"(4.697144,-74.140516)"
2012,Enero,Francia,250,41,24,,65,"(6.171601,-75.427454)"
2012,Enero,Gabón,266,0,7,,7,"(4.697144,-74.140516)"
2012,Enero,Georgia,268,4,1,,5,"(4.697144,-74.140516)"
2012,Enero,Ghana,288,0,5,,5,"(4.697144,-74.140516)"
2012,Enero,Gibraltar/Territorio Británico de Ultramar,292,1,0,,1,"(0.814836,-77.662532)"
2012,Enero,Granada,308,0,2,,2,"(4.697144,-74.140516)"
2012,Enero,Grecia,300,7,1,,8,"(4.697144,-74.140516)"
2012,Enero,Grecia,300,2,0,,2,"(6.171601,-75.427454)"
2012,Enero,Guatemala,320,5,8,,13,"(10.445761,-75.516429)"
2012,Enero,Guatemala,320,7,9,,16,"(10.886611,-74.776708)"
2012,Enero,Guatemala,320,1,1,,2,"(12.586067,-81.702563)"
2012,Enero,Guatemala,320,62,82,,144,"(3.541112,-76.384584)"
2012,Enero,Guatemala,320,205,324,,529,"(4.697144,-74.140516)"
2012,Enero,Guatemala,320,10,15,,25,"(4.815061,-75.736532)"
2012,Enero,Guatemala,320,93,140,,233,"(6.171601,-75.427454)"
2012,Enero,Guatemala,320,10,9,,19,"(7.128456,-73.183637)"
2012,Enero,Guatemala,320,3,0,,3,"(7.927209,-72.507910)"
2012,Enero,Guyana,328,0,12,,12,"(12.5744111,-81.703935)"
2012,Enero,Guyana,328,3,6,,9,"(4.697144,-74.140516)"
2012,Enero,Guyana,328,0,1,,1,"(6.171601,-75.427454)"
2012,Enero,Guinea,324,0,1,,1,"(3.541112,-76.384584)"
2012,Enero,Guinea,324,1,6,,7,"(4.697144,-74.140516)"
2012,Enero,Guinea Ecuatorial,226,2,3,,5,"(3.541112,-76.384584)"
2012,Enero,Guinea Ecuatorial,226,3,13,,16,"(4.697144,-74.140516)"
2012,Enero,Guadalupe/Territorio Francés,312,0,1,,1,"(10.445761,-75.516429)"
2012,Enero,Haití,332,3,4,,7,"(10.886611,-74.776708)"
2012,Enero,Haití,332,0,2,,2,"(3.541112,-76.384584)"
2012,Enero,Haití,332,11,22,,33,"(4.697144,-74.140516)"
2012,Enero,Haití,332,1,6,,7,"(6.171601,-75.427454)"
2012,Enero,Haití,332,0,1,,1,"(7.128456,-73.183637)"
2012,Enero,Honduras,340,3,7,,10,"(10.445761,-75.516429)"
2012,Enero,Honduras,340,6,4,,10,"(10.886611,-74.776708)"
2012,Enero,Honduras,340,0,2,,2,"(12.586067,-81.702563)"
2012,Enero,Honduras,340,20,49,,69,"(3.541112,-76.384584)"
2012,Enero,Honduras,340,104,171,,275,"(4.697144,-74.140516)"
2012,Enero,Honduras,340,2,3,,5,"(4.815061,-75.736532)"
2012,Enero,Honduras,340,31,60,,91,"(6.171601,-75.427454)"
2012,Enero,Honduras,340,1,9,,10,"(7.128456,-73.183637)"
2012,Enero,Hong Kong,344,22,39,,61,"(4.697144,-74.140516)"
2012,Enero,Hong Kong,344,3,2,,5,"(6.171601,-75.427454)"
2012,Enero,Hungría,348,7,6,,13,"(4.697144,-74.140516)"
2012,Enero,India,356,3,0,,3,"(10.886611,-74.776708)"
2012,Enero,India,356,35,43,,78,"(4.697144,-74.140516)"
2012,Enero,India,356,2,2,,4,"(6.171601,-75.427454)"
2012,Enero,Indonesia,360,0,1,,1,"(10.445761,-75.516429)"
2012,Enero,Indonesia,360,9,10,,19,"(4.697144,-74.140516)"
2012,Enero,Indonesia,360,1,1,,2,"(6.171601,-75.427454)"
2012,Enero,Iraq,368,1,0,,1,"(3.541112,-76.384584)"
2012,Enero,Iraq,368,1,11,,12,"(4.697144,-74.140516)"
2012,Enero,Irán,364,3,4,,7,"(4.697144,-74.140516)"
2012,Enero,República de Irlanda,372,2,0,,2,"(10.445761,-75.516429)"
2012,Enero,República de Irlanda,372,16,14,,30,"(4.697144,-74.140516)"
2012,Enero,República de Irlanda,372,1,0,,1,"(6.171601,-75.427454)"
2012,Enero,Islandia,352,0,1,,1,"(10.445761,-75.516429)"
2012,Enero,Islandia,352,4,3,,7,"(4.697144,-74.140516)"
2012,Enero,Israel,376,3,2,,5,"(3.541112,-76.384584)"
2012,Enero,Israel,376,123,95,,218,"(4.697144,-74.140516)"
2012,Enero,Israel,376,2,3,,5,"(6.171601,-75.427454)"
2012,Enero,Italia,380,12,4,,16,"(10.445761,-75.516429)"
2012,Enero,Italia,380,2,1,,3,"(10.886611,-74.776708)"
2012,Enero,Italia,380,1,0,,1,"(12.586067,-81.702563)"
2012,Enero,Italia,380,111,38,,149,"(3.541112,-76.384584)"
2012,Enero,Italia,380,921,524,,1445,"(4.697144,-74.140516)"
2012,Enero,Italia,380,35,16,,51,"(6.171601,-75.427454)"
2012,Enero,Islas Cook,184,0,1,,1,"(4.697144,-74.140516)"
2012,Enero,Jamaica,388,1,0,,1,"(10.408582,-75.538003)"
2012,Enero,Jamaica,388,2,1,,3,"(10.445761,-75.516429)"
2012,Enero,Jamaica,388,2,3,,5,"(10.886611,-74.776708)"
2012,Enero,Jamaica,388,3,4,,7,"(3.541112,-76.384584)"
2012,Enero,Jamaica,388,42,31,,73,"(4.697144,-74.140516)"
2012,Enero,Jamaica,388,2,3,,5,"(4.815061,-75.736532)"
2012,Enero,Jamaica,388,91,79,,170,"(6.171601,-75.427454)"
2012,Enero,Jamaica,388,5,3,,8,"(7.128456,-73.183637)"
2012,Enero,Japón,392,0,2,,2,"(10.886611,-74.776708)"
2012,Enero,Japón,392,2,2,,4,"(3.541112,-76.384584)"
2012,Enero,Japón,392,44,47,,91,"(4.697144,-74.140516)"
2012,Enero,Japón,392,1,3,,4,"(6.171601,-75.427454)"
2012,Enero,Jordania,400,3,1,,4,"(4.697144,-74.140516)"
2012,Enero,Kazajistán,398,3,4,,7,"(4.697144,-74.140516)"
2012,Enero,Kenia,404,0,1,,1,"(3.541112,-76.384584)"
2012,Enero,Kenia,404,6,3,,9,"(4.697144,-74.140516)"
2012,Enero,Kenia,404,1,0,,1,"(6.171601,-75.427454)"
2012,Enero,Kuwait,414,0,1,,1,"(3.541112,-76.384584)"
2012,Enero,Kuwait,414,1,2,,3,"(4.697144,-74.140516)"
2012,Enero,Letonia,428,0,5,,5,"(4.697144,-74.140516)"
2012,Enero,Lituania,440,2,0,,2,"(3.541112,-76.384584)"
2012,Enero,Lituania,440,0,3,,3,"(4.697144,-74.140516)"
2012,Enero,Líbano,422,1,0,,1,"(12.586067,-81.702563)"
2012,Enero,Líbano,422,1,0,,1,"(3.541112,-76.384584)"
2012,Enero,Líbano,422,13,12,,25,"(4.697144,-74.140516)"
2012,Enero,Liberia,430,0,1,,1,"(4.697144,-74.140516)"
2012,Enero,Luxemburgo,442,0,1,,1,"(3.541112,-76.384584)"
2012,Enero,Luxemburgo,442,4,4,,8,"(4.697144,-74.140516)"
2012,Enero,Madagascar,450,0,1,,1,"(4.697144,-74.140516)"
2012,Enero,Malasia,458,1,0,,1,"(12.586067,-81.702563)"
2012,Enero,Malasia,458,5,16,,21,"(4.697144,-74.140516)"
2012,Enero,Malasia,458,0,1,,1,"(6.171601,-75.427454)"
2012,Enero,Malí,466,0,1,,1,"(4.697144,-74.140516)"
2012,Enero,Malta,470,1,0,,1,"(3.541112,-76.384584)"
2012,Enero,Malta,470,7,5,,12,"(4.697144,-74.140516)"
2012,Enero,Marruecos,504,4,8,,12,"(4.697144,-74.140516)"
2012,Enero,Marruecos,504,1,0,,1,"(6.171601,-75.427454)"
2012,Enero,Mauricio,480,0,1,,1,"(4.697144,-74.140516)"
2012,Enero,Martinica/Departamento de Ultramar Francés,474,0,3,,3,"(4.697144,-74.140516)"
2012,Enero,México,484,0,9,,9,"(10.408582,-75.538003)"
2012,Enero,México,484,25,28,,53,"(10.445761,-75.516429)"
2012,Enero,México,484,48,53,,101,"(10.886611,-74.776708)"
2012,Enero,México,484,0,9,,9,"(11.247723,-74.213989)"
2012,Enero,México,484,3,5,,8,"(12.586067,-81.702563)"
2012,Enero,México,484,164,189,,353,"(3.541112,-76.384584)"
2012,Enero,México,484,5331,5284,,10615,"(4.697144,-74.140516)"
2012,Enero,México,484,19,20,,39,"(4.815061,-75.736532)"
2012,Enero,México,484,415,396,,811,"(6.171601,-75.427454)"
2012,Enero,México,484,16,18,,34,"(7.128456,-73.183637)"
2012,Enero,México,484,5,3,,8,"(7.927209,-72.507910)"
2012,Enero,República de Moldavia,498,0,2,,2,"(4.697144,-74.140516)"
2012,Enero,Mónaco,492,2,0,,2,"(4.697144,-74.140516)"
2012,Enero,Montenegro,499,1,0,,1,"(4.697144,-74.140516)"
2012,Enero,Mozambique,508,4,1,,5,"(4.697144,-74.140516)"
2012,Enero,Mozambique,508,1,0,,1,"(6.171601,-75.427454)"
2012,Enero,Nauru,520,0,1,,1,"(7.128456,-73.183637)"
2012,Enero,Nicaragua,558,1,0,,1,"(10.445761,-75.516429)"
2012,Enero,Nicaragua,558,5,9,,14,"(10.886611,-74.776708)"
2012,Enero,Nicaragua,558,0,1,,1,"(12.586067,-81.702563)"
2012,Enero,Nicaragua,558,11,15,,26,"(3.541112,-76.384584)"
2012,Enero,Nicaragua,558,56,79,,135,"(4.697144,-74.140516)"
2012,Enero,Nicaragua,558,5,2,,7,"(4.815061,-75.736532)"
2012,Enero,Nicaragua,558,7,15,,22,"(6.171601,-75.427454)"
2012,Enero,Nicaragua,558,1,4,,5,"(7.128456,-73.183637)"
2012,Enero,Nicaragua,558,0,1,,1,"(7.927209,-72.507910)"
2012,Enero,Nigeria,566,0,1,,1,"(10.445761,-75.516429)"
2012,Enero,Nigeria,566,5,32,,37,"(4.697144,-74.140516)"
2012,Enero,Noruega,578,3,1,,4,"(3.541112,-76.384584)"
2012,Enero,Noruega,578,35,23,,58,"(4.697144,-74.140516)"
2012,Enero,Noruega,578,8,5,,13,"(6.171601,-75.427454)"
2012,Enero,Nueva Caledonia/Territorio francés,540,1,0,,1,"(4.697144,-74.140516)"
2012,Enero,Nueva Zelanda,554,24,26,,50,"(4.697144,-74.140516)"
2012,Enero,Nueva Zelanda,554,7,3,,10,"(6.171601,-75.427454)"
2012,Enero,Omán,512,0,1,,1,"(3.541112,-76.384584)"
2012,Enero,Omán,512,3,2,,5,"(4.697144,-74.140516)"
2012,Enero,Papúa Nueva Guinea,598,0,4,,4,"(4.697144,-74.140516)"
2012,Enero,Pakistán,586,0,2,,2,"(4.697144,-74.140516)"
2012,Enero,Palau,585,0,1,,1,"(10.886611,-74.776708)"
2012,Enero,Panamá,591,314,284,,598,"(10.408582,-75.538003)"
2012,Enero,Panamá,591,494,418,,912,"(10.445761,-75.516429)"
2012,Enero,Panamá,591,1367,1302,,2669,"(10.886611,-74.776708)"
2012,Enero,Panamá,591,1,2,,3,"(11.117806,-74.232622)"
2012,Enero,Panamá,591,1,1,,2,"(11.360009,-72.129330)"
2012,Enero,Panamá,591,2,8,,10,"(12.5744111,-81.703935)"
2012,Enero,Panamá,591,158,155,,313,"(12.586067,-81.702563)"
2012,Enero,Panamá,591,2086,2036,,4122,"(3.541112,-76.384584)"
2012,Enero,Panamá,591,8521,9191,,17712,"(4.697144,-74.140516)"
2012,Enero,Panamá,591,610,449,,1059,"(4.815061,-75.736532)"
2012,Enero,Panamá,591,2599,2628,,5227,"(6.171601,-75.427454)"
2012,Enero,Panamá,591,11,26,,37,"(6.228046,-77.404104)"
2012,Enero,Panamá,591,331,346,,677,"(7.128456,-73.183637)"
2012,Enero,Panamá,591,531,543,,1074,"(7.927209,-72.507910)"
2012,Enero,Panamá,591,119,145,,264,"(8.635765,-77.346578)"
2012,Enero,Paraguay,600,0,1,,1,"(0.814836,-77.662532)"
2012,Enero,Paraguay,600,1,2,,3,"(10.445761,-75.516429)"
2012,Enero,Paraguay,600,3,3,,6,"(10.886611,-74.776708)"
2012,Enero,Paraguay,600,4,15,,19,"(3.541112,-76.384584)"
2012,Enero,Paraguay,600,28,61,,89,"(4.697144,-74.140516)"
2012,Enero,Paraguay,600,4,5,,9,"(6.171601,-75.427454)"
2012,Enero,Perú,604,91,142,,233,"(-4.197703,-69.941278)"
2012,Enero,Perú,604,10,8,,18,"(0.814836,-77.662532)"
2012,Enero,Perú,604,7,17,,24,"(10.445761,-75.516429)"
2012,Enero,Perú,604,14,17,,31,"(10.886611,-74.776708)"
2012,Enero,Perú,604,1,0,,1,"(12.586067,-81.702563)"
2012,Enero,Perú,604,111,129,,240,"(3.541112,-76.384584)"
2012,Enero,Perú,604,1,0,,1,"(3.893038,-77.067921)"
2012,Enero,Perú,604,3576,4632,,8208,"(4.697144,-74.140516)"
2012,Enero,Perú,604,7,8,,15,"(4.815061,-75.736532)"
2012,Enero,Perú,604,375,428,,803,"(6.171601,-75.427454)"
2012,Enero,Perú,604,13,34,,47,"(7.128456,-73.183637)"
2012,Enero,Perú,604,2,6,,8,"(7.927209,-72.507910)"
2012,Enero,Palestina,99999,1,0,,1,"(4.697144,-74.140516)"
2012,Enero,Palestina,99999,1,0,,1,"(6.171601,-75.427454)"
2012,Enero,Polonia,616,10,16,,26,"(4.697144,-74.140516)"
2012,Enero,Polonia,616,0,1,,1,"(6.171601,-75.427454)"
2012,Enero,Portugal,620,2,3,,5,"(10.445761,-75.516429)"
2012,Enero,Portugal,620,3,2,,5,"(3.541112,-76.384584)"
2012,Enero,Portugal,620,36,28,,64,"(4.697144,-74.140516)"
2012,Enero,Polinesia Francesa/Colectividad de Ultramar Francesa,258,1,0,,1,"(4.697144,-74.140516)"
2012,Enero,Puerto Rico/Territorio de Estados Unidos,630,23,17,,40,"(10.445761,-75.516429)"
2012,Enero,Puerto Rico/Territorio de Estados Unidos,630,22,22,,44,"(10.886611,-74.776708)"
2012,Enero,Puerto Rico/Territorio de Estados Unidos,630,2,5,,7,"(12.586067,-81.702563)"
2012,Enero,Puerto Rico/Territorio de Estados Unidos,630,93,76,,169,"(3.541112,-76.384584)"
2012,Enero,Puerto Rico/Territorio de Estados Unidos,630,1,0,,1,"(4.452882,-75.766298)"
2012,Enero,Puerto Rico/Territorio de Estados Unidos,630,141,129,,270,"(4.697144,-74.140516)"
2012,Enero,Puerto Rico/Territorio de Estados Unidos,630,11,11,,22,"(4.815061,-75.736532)"
2012,Enero,Puerto Rico/Territorio de Estados Unidos,630,54,68,,122,"(6.171601,-75.427454)"
2012,Enero,Puerto Rico/Territorio de Estados Unidos,630,11,18,,29,"(7.128456,-73.183637)"
2012,Enero,Puerto Rico/Territorio de Estados Unidos,630,0,1,,1,"(7.927209,-72.507910)"
2012,Enero,Qatar,634,3,0,,3,"(3.541112,-76.384584)"
2012,Enero,Qatar,634,10,10,,20,"(4.697144,-74.140516)"
2012,Enero,Qatar,634,2,1,,3,"(6.171601,-75.427454)"
2012,Enero,Qatar,634,0,1,,1,"(7.128456,-73.183637)"
2012,Enero,Reino Unido de Gran Bretaña e Irlanda del Norte,826,8,6,,14,"(10.445761,-75.516429)"
2012,Enero,Reino Unido de Gran Bretaña e Irlanda del Norte,826,4,3,,7,"(10.886611,-74.776708)"
2012,Enero,Reino Unido de Gran Bretaña e Irlanda del Norte,826,144,115,,259,"(3.541112,-76.384584)"
2012,Enero,Reino Unido de Gran Bretaña e Irlanda del Norte,826,1,1,,2,"(4.452882,-75.766298)"
2012,Enero,Reino Unido de Gran Bretaña e Irlanda del Norte,826,1271,962,,2233,"(4.697144,-74.140516)"
2012,Enero,Reino Unido de Gran Bretaña e Irlanda del Norte,826,81,54,,135,"(6.171601,-75.427454)"
2012,Enero,Federación de Rusia,643,1,0,,1,"(10.445761,-75.516429)"
2012,Enero,Federación de Rusia,643,18,40,,58,"(4.697144,-74.140516)"
2012,Enero,Federación de Rusia,643,0,1,,1,"(4.815061,-75.736532)"
2012,Enero,Federación de Rusia,643,0,1,,1,"(6.171601,-75.427454)"
2012,Enero,República Dominicana,214,10,12,,22,"(10.445761,-75.516429)"
2012,Enero,República Dominicana,214,42,47,,89,"(10.886611,-74.776708)"
2012,Enero,República Dominicana,214,4,4,,8,"(12.586067,-81.702563)"
2012,Enero,República Dominicana,214,124,123,,247,"(3.541112,-76.384584)"
2012,Enero,República Dominicana,214,1735,1820,,3555,"(4.697144,-74.140516)"
2012,Enero,República Dominicana,214,6,6,,12,"(4.815061,-75.736532)"
2012,Enero,República Dominicana,214,354,332,,686,"(6.171601,-75.427454)"
2012,Enero,República Dominicana,214,21,26,,47,"(7.128456,-73.183637)"
2012,Enero,República Dominicana,214,5,3,,8,"(7.927209,-72.507910)"
2012,Enero,Reunión,638,3,1,,4,"(4.697144,-74.140516)"
2012,Enero,Rumania,642,5,7,,12,"(4.697144,-74.140516)"
2012,Enero,Santa Lucia,662,0,1,,1,"(4.697144,-74.140516)"
2012,Enero,Serbia,688,1,0,,1,"(10.886611,-74.776708)"
2012,Enero,Serbia,688,0,2,,2,"(4.697144,-74.140516)"
2012,Enero,Singapur,702,13,12,,25,"(4.697144,-74.140516)"
2012,Enero,Sri Lanka,144,1,2,,3,"(4.697144,-74.140516)"
2012,Enero,Sudáfrica,710,1,0,,1,"(3.541112,-76.384584)"
2012,Enero,Sudáfrica,710,25,34,,59,"(4.697144,-74.140516)"
2012,Enero,Sudáfrica,710,1,0,,1,"(6.171601,-75.427454)"
2012,Enero,Sudán,736,1,2,,3,"(4.697144,-74.140516)"
2012,Enero,Suecia,752,1,1,,2,"(10.886611,-74.776708)"
2012,Enero,Suecia,752,18,15,,33,"(3.541112,-76.384584)"
2012,Enero,Suecia,752,143,132,,275,"(4.697144,-74.140516)"
2012,Enero,Suecia,752,6,4,,10,"(6.171601,-75.427454)"
2012,Enero,Suiza,756,2,1,,3,"(10.886611,-74.776708)"
2012,Enero,Suiza,756,82,36,,118,"(3.541112,-76.384584)"
2012,Enero,Suiza,756,375,234,,609,"(4.697144,-74.140516)"
2012,Enero,Suiza,756,19,11,,30,"(6.171601,-75.427454)"
2012,Enero,Surinam,740,5,4,,9,"(4.697144,-74.140516)"
2012,Enero,Surinam,740,0,1,,1,"(6.171601,-75.427454)"
2012,Enero,Suazilandia,748,1,0,,1,"(4.697144,-74.140516)"
2012,Enero,Taiwán,158,0,1,,1,"(10.886611,-74.776708)"
2012,Enero,Taiwán,158,3,3,,6,"(4.697144,-74.140516)"
2012,Enero,Taiwán,158,0,2,,2,"(6.171601,-75.427454)"
2012,Enero,Tailandia,764,0,1,,1,"(3.541112,-76.384584)"
2012,Enero,Tailandia,764,4,6,,10,"(4.697144,-74.140516)"
2012,Enero,Tanzania,834,0,1,,1,"(4.697144,-74.140516)"
2012,Enero,República Democrática de Timor Oriental,626,1,1,,2,"(4.697144,-74.140516)"
2012,Enero,Trinidad y Tobago,780,6,4,,10,"(10.445761,-75.516429)"
2012,Enero,Trinidad y Tobago,780,3,3,,6,"(10.886611,-74.776708)"
2012,Enero,Trinidad y Tobago,780,12,10,,22,"(3.541112,-76.384584)"
2012,Enero,Trinidad y Tobago,780,27,41,,68,"(4.697144,-74.140516)"
2012,Enero,Trinidad y Tobago,780,3,1,,4,"(4.815061,-75.736532)"
2012,Enero,Trinidad y Tobago,780,13,8,,21,"(6.171601,-75.427454)"
2012,Enero,Trinidad y Tobago,780,8,5,,13,"(7.128456,-73.183637)"
2012,Enero,Túnez,788,1,0,,1,"(4.697144,-74.140516)"
2012,Enero,Túnez,788,1,0,,1,"(7.818934,-72.453226)"
2012,Enero,Turquía,792,4,1,,5,"(3.541112,-76.384584)"
2012,Enero,Turquía,792,10,3,,13,"(4.697144,-74.140516)"
2012,Enero,Uganda,800,0,1,,1,"(4.697144,-74.140516)"
2012,Enero,Uganda,800,0,1,,1,"(6.171601,-75.427454)"
2012,Enero,Uruguay,858,2,0,,2,"(10.445761,-75.516429)"
2012,Enero,Uruguay,858,1,0,,1,"(10.886611,-74.776708)"
2012,Enero,Uruguay,858,8,10,,18,"(3.541112,-76.384584)"
2012,Enero,Uruguay,858,59,62,,121,"(4.697144,-74.140516)"
2012,Enero,Uruguay,858,18,14,,32,"(6.171601,-75.427454)"
2012,Enero,Vanuatu,548,0,1,,1,"(11.360009,-72.129330)"
2012,Enero,Venezuela,862,0,9,,9,"(10.408582,-75.538003)"
2012,Enero,Venezuela,862,17,7,,24,"(10.445761,-75.516429)"
2012,Enero,Venezuela,862,16,17,,33,"(10.886611,-74.776708)"
2012,Enero,Venezuela,862,1,0,,1,"(11.117806,-74.232622)"
2012,Enero,Venezuela,862,12041,9294,,21335,"(11.360009,-72.129330)"
2012,Enero,Venezuela,862,1,5,,6,"(12.586067,-81.702563)"
2012,Enero,Venezuela,862,28,22,,50,"(3.541112,-76.384584)"
2012,Enero,Venezuela,862,3083,3453,,6536,"(4.697144,-74.140516)"
2012,Enero,Venezuela,862,7,8,,15,"(4.815061,-75.736532)"
2012,Enero,Venezuela,862,522,568,,1090,"(6.171601,-75.427454)"
2012,Enero,Venezuela,862,137,154,,291,"(6.185799,-67.483929)"
2012,Enero,Venezuela,862,1303,1107,,2410,"(7.088729,-70.740253)"
2012,Enero,Venezuela,862,3,1,,4,"(7.128456,-73.183637)"
2012,Enero,Venezuela,862,10389,10784,,21173,"(7.818934,-72.453226)"
2012,Enero,Venezuela,862,3,3,,6,"(7.927209,-72.507910)"
2012,Enero,Vietnam,704,0,1,,1,"(3.541112,-76.384584)"
2012,Enero,Vietnam,704,0,2,,2,"(4.697144,-74.140516)"
2012,Enero,Islas Vírgenes Británicas/Territorio Británico de Ultramar,92,2,0,,2,"(4.697144,-74.140516)"
2012,Enero,República Árabe de Yemen,887,0,1,,1,"(4.697144,-74.140516)"
2012,Enero,Yugoslavia,99999,0,1,,1,"(4.697144,-74.140516)"
2012,Enero,Zambia,894,1,0,,1,"(7.818934,-72.453226)"
2012,Enero,Desconocido,99999,0,2,,2,"(3.541112,-76.384584)"
2012,Enero,Desconocido,99999,4,24,,28,"(4.697144,-74.140516)"
2012,Enero,Desconocido,99999,1,0,,1,"(7.128456,-73.183637)"
2012,Febrero,Afganistán,4,1,16,,17,"(4.697144,-74.140516)"
2012,Febrero,Albania,8,0,2,,2,"(4.697144,-74.140516)"
2012,Febrero,Alemania,276,22,14,,36,"(3.541112,-76.384584)"
2012,Febrero,Alemania,276,1,0,,1,"(4.452882,-75.766298)"
2012,Febrero,Alemania,276,638,593,,1231,"(4.697144,-74.140516)"
2012,Febrero,Alemania,276,11,9,,20,"(6.171601,-75.427454)"
2012,Febrero,Andorra,20,3,0,,3,"(4.697144,-74.140516)"
2012,Febrero,Angola,24,2,7,,9,"(4.697144,-74.140516)"
2012,Febrero,Antigua y Barbuda,28,0,1,,1,"(10.886611,-74.776708)"
2012,Febrero,Antigua y Barbuda,28,0,1,,1,"(4.697144,-74.140516)"
2012,Febrero,Países Bajos,528,781,517,,1298,"(10.408582,-75.538003)"
2012,Febrero,Países Bajos,528,1,1,,2,"(10.445761,-75.516429)"
2012,Febrero,Países Bajos,528,1,0,,1,"(10.886611,-74.776708)"
2012,Febrero,Países Bajos,528,38,15,,53,"(3.541112,-76.384584)"
2012,Febrero,Países Bajos,528,133,85,,218,"(4.697144,-74.140516)"
2012,Febrero,Países Bajos,528,22,20,,42,"(6.171601,-75.427454)"
2012,Febrero,Países Bajos,528,0,1,,1,"(7.128456,-73.183637)"
2012,Febrero,Países Bajos,528,2,0,,2,"(7.927209,-72.507910)"
2012,Febrero,Arabia Saudita,682,8,10,,18,"(4.697144,-74.140516)"
2012,Febrero,Arabia Saudita,682,0,1,,1,"(6.171601,-75.427454)"
2012,Febrero,Argelia,12,1,0,,1,"(0.814836,-77.662532)"
2012,Febrero,Argelia,12,2,0,,2,"(3.541112,-76.384584)"
2012,Febrero,Argelia,12,1,9,,10,"(4.697144,-74.140516)"
2012,Febrero,Argelia,12,1,2,,3,"(6.171601,-75.427454)"
2012,Febrero,Argentina,32,16,47,,63,"(0.814836,-77.662532)"
2012,Febrero,Argentina,32,8,3,,11,"(10.445761,-75.516429)"
2012,Febrero,Argentina,32,15,5,,20,"(10.886611,-74.776708)"
2012,Febrero,Argentina,32,1,1,,2,"(12.586067,-81.702563)"
2012,Febrero,Argentina,32,144,125,,269,"(3.541112,-76.384584)"
2012,Febrero,Argentina,32,2693,2745,,5438,"(4.697144,-74.140516)"
2012,Febrero,Argentina,32,4,4,,8,"(4.815061,-75.736532)"
2012,Febrero,Argentina,32,174,157,,331,"(6.171601,-75.427454)"
2012,Febrero,Argentina,32,1,0,,1,"(7.927209,-72.507910)"
2012,Febrero,Aruba,533,1562,997,,2559,"(10.408582,-75.538003)"
2012,Febrero,Aruba,533,3,0,,3,"(10.445761,-75.516429)"
2012,Febrero,Aruba,533,14,11,,25,"(10.886611,-74.776708)"
2012,Febrero,Aruba,533,114,82,,196,"(11.528919,-72.919681)"
2012,Febrero,Aruba,533,12,11,,23,"(3.541112,-76.384584)"
2012,Febrero,Aruba,533,557,592,,1149,"(4.697144,-74.140516)"
2012,Febrero,Aruba,533,1,0,,1,"(4.815061,-75.736532)"
2012,Febrero,Aruba,533,41,24,,65,"(6.171601,-75.427454)"
2012,Febrero,Aruba,533,2,0,,2,"(7.128456,-73.183637)"
2012,Febrero,Australia,36,1,1,,2,"(10.445761,-75.516429)"
2012,Febrero,Australia,36,7,3,,10,"(10.886611,-74.776708)"
2012,Febrero,Australia,36,7,4,,11,"(3.541112,-76.384584)"
2012,Febrero,Australia,36,0,1,,1,"(4.452882,-75.766298)"
2012,Febrero,Australia,36,306,208,,514,"(4.697144,-74.140516)"
2012,Febrero,Australia,36,1,1,,2,"(4.815061,-75.736532)"
2012,Febrero,Australia,36,50,33,,83,"(6.171601,-75.427454)"
2012,Febrero,Australia,36,4,2,,6,"(7.128456,-73.183637)"
2012,Febrero,Austria,40,0,1,,1,"(3.541112,-76.384584)"
2012,Febrero,Austria,40,25,16,,41,"(4.697144,-74.140516)"
2012,Febrero,Austria,40,1,0,,1,"(6.171601,-75.427454)"
2012,Febrero,Azerbaiyán,31,2,1,,3,"(4.697144,-74.140516)"
2012,Febrero,Bahamas,44,1,0,,1,"(10.445761,-75.516429)"
2012,Febrero,Bahamas,44,0,1,,1,"(10.886611,-74.776708)"
2012,Febrero,Bahamas,44,7,7,,14,"(3.541112,-76.384584)"
2012,Febrero,Bahamas,44,33,32,,65,"(4.697144,-74.140516)"
2012,Febrero,Bahamas,44,3,2,,5,"(4.815061,-75.736532)"
2012,Febrero,Bahamas,44,26,22,,48,"(6.171601,-75.427454)"
2012,Febrero,Bahamas,44,2,0,,2,"(7.128456,-73.183637)"
2012,Febrero,Bahréin,48,3,0,,3,"(4.697144,-74.140516)"
2012,Febrero,Bangladesh,50,0,1,,1,"(4.697144,-74.140516)"
2012,Febrero,Barbados,52,0,20,,20,"(4.697144,-74.140516)"
2012,Febrero,República de Belarús,112,1,0,,1,"(11.360009,-72.129330)"
2012,Febrero,República de Belarús,112,1,1,,2,"(4.697144,-74.140516)"
2012,Febrero,República de Belarús,112,1,0,,1,"(6.171601,-75.427454)"
2012,Febrero,República de Belarús,112,0,5,,5,"(7.818934,-72.453226)"
2012,Febrero,Bélgica,56,7,10,,17,"(3.541112,-76.384584)"
2012,Febrero,Bélgica,56,53,33,,86,"(4.697144,-74.140516)"
2012,Febrero,Bélgica,56,6,3,,9,"(6.171601,-75.427454)"
2012,Febrero,Belice,84,0,3,,3,"(4.697144,-74.140516)"
2012,Febrero,Benín,204,2,0,,2,"(4.697144,-74.140516)"
2012,Febrero,Bermudas/Territorio Británico de Ultramar,60,1,0,,1,"(4.697144,-74.140516)"
2012,Febrero,Bolivia,68,3,3,,6,"(0.814836,-77.662532)"
2012,Febrero,Bolivia,68,0,1,,1,"(10.445761,-75.516429)"
2012,Febrero,Bolivia,68,3,1,,4,"(10.886611,-74.776708)"
2012,Febrero,Bolivia,68,19,39,,58,"(3.541112,-76.384584)"
2012,Febrero,Bolivia,68,175,297,,472,"(4.697144,-74.140516)"
2012,Febrero,Bolivia,68,1,2,,3,"(4.815061,-75.736532)"
2012,Febrero,Bolivia,68,17,29,,46,"(6.171601,-75.427454)"
2012,Febrero,Brasil,76,192,238,,430,"(-4.197703,-69.941278)"
2012,Febrero,Brasil,76,0,1,,1,"(0.814836,-77.662532)"
2012,Febrero,Brasil,76,4,6,,10,"(10.445761,-75.516429)"
2012,Febrero,Brasil,76,6,4,,10,"(10.886611,-74.776708)"
2012,Febrero,Brasil,76,0,1,,1,"(12.586067,-81.702563)"
2012,Febrero,Brasil,76,31,58,,89,"(3.541112,-76.384584)"
2012,Febrero,Brasil,76,1628,2304,,3932,"(4.697144,-74.140516)"
2012,Febrero,Brasil,76,1,2,,3,"(4.815061,-75.736532)"
2012,Febrero,Brasil,76,59,69,,128,"(6.171601,-75.427454)"
2012,Febrero,Brasil,76,1,5,,6,"(7.128456,-73.183637)"
2012,Febrero,Brasil,76,0,1,,1,"(7.927209,-72.507910)"
2012,Febrero,Bulgaria,100,3,0,,3,"(4.697144,-74.140516)"
2012,Febrero,Burkina Faso,854,1,2,,3,"(4.697144,-74.140516)"
2012,Febrero,Burundi,108,0,1,,1,"(4.697144,-74.140516)"
2012,Febrero,Cabo Verde,132,1,0,,1,"(3.541112,-76.384584)"
2012,Febrero,Islas Caimán/Territorio Británico de Ultramar,136,0,1,,1,"(10.445761,-75.516429)"
2012,Febrero,Islas Caimán/Territorio Británico de Ultramar,136,4,2,,6,"(12.586067,-81.702563)"
2012,Febrero,Islas Caimán/Territorio Británico de Ultramar,136,0,1,,1,"(3.541112,-76.384584)"
2012,Febrero,Islas Caimán/Territorio Británico de Ultramar,136,0,1,,1,"(4.697144,-74.140516)"
2012,Febrero,Camboya,116,0,1,,1,"(4.697144,-74.140516)"
2012,Febrero,Canadá,124,137,76,,213,"(10.445761,-75.516429)"
2012,Febrero,Canadá,124,9,9,,18,"(10.886611,-74.776708)"
2012,Febrero,Canadá,124,16,15,,31,"(12.586067,-81.702563)"
2012,Febrero,Canadá,124,49,42,,91,"(3.541112,-76.384584)"
2012,Febrero,Canadá,124,13,8,,21,"(4.452882,-75.766298)"
2012,Febrero,Canadá,124,1117,956,,2073,"(4.697144,-74.140516)"
2012,Febrero,Canadá,124,4,2,,6,"(4.815061,-75.736532)"
2012,Febrero,Canadá,124,109,99,,208,"(6.171601,-75.427454)"
2012,Febrero,Canadá,124,6,1,,7,"(7.128456,-73.183637)"
2012,Febrero,Chad,148,0,1,,1,"(3.541112,-76.384584)"
2012,Febrero,España,724,1,0,,1,"(10.445761,-75.516429)"
2012,Febrero,España,724,2,1,,3,"(10.886611,-74.776708)"
2012,Febrero,España,724,2076,1279,,3355,"(3.541112,-76.384584)"
2012,Febrero,España,724,1,0,,1,"(4.452882,-75.766298)"
2012,Febrero,España,724,6337,5019,,11356,"(4.697144,-74.140516)"
2012,Febrero,España,724,0,1,,1,"(4.815061,-75.736532)"
2012,Febrero,España,724,695,507,,1202,"(6.171601,-75.427454)"
2012,Febrero,República Democrática del Congo,180,0,3,,3,"(4.697144,-74.140516)"
2012,Febrero,República Democrática del Congo,180,0,1,,1,"(6.171601,-75.427454)"
2012,Febrero,República de Corea,410,19,22,,41,"(4.697144,-74.140516)"
2012,Febrero,República de Corea,410,3,2,,5,"(6.171601,-75.427454)"
2012,Febrero,Costa Rica,188,9,3,,12,"(10.445761,-75.516429)"
2012,Febrero,Costa Rica,188,22,18,,40,"(10.886611,-74.776708)"
2012,Febrero,Costa Rica,188,7,58,,65,"(12.5744111,-81.703935)"
2012,Febrero,Costa Rica,188,5,2,,7,"(12.586067,-81.702563)"
2012,Febrero,Costa Rica,188,40,43,,83,"(3.541112,-76.384584)"
2012,Febrero,Costa Rica,188,461,725,,1186,"(4.697144,-74.140516)"
2012,Febrero,Costa Rica,188,7,8,,15,"(4.815061,-75.736532)"
2012,Febrero,Costa Rica,188,199,194,,393,"(6.171601,-75.427454)"
2012,Febrero,Costa Rica,188,4,1,,5,"(7.128456,-73.183637)"
2012,Febrero,Croacia,191,1,2,,3,"(4.697144,-74.140516)"
2012,Febrero,Cuba,192,1,4,,5,"(10.445761,-75.516429)"
2012,Febrero,Cuba,192,25,26,,51,"(10.886611,-74.776708)"
2012,Febrero,Cuba,192,46,59,,105,"(3.541112,-76.384584)"
2012,Febrero,Cuba,192,247,282,,529,"(4.697144,-74.140516)"
2012,Febrero,Cuba,192,4,9,,13,"(4.815061,-75.736532)"
2012,Febrero,Cuba,192,95,90,,185,"(6.171601,-75.427454)"
2012,Febrero,Cuba,192,18,13,,31,"(7.128456,-73.183637)"
2012,Febrero,Cuba,192,1,0,,1,"(7.927209,-72.507910)"
2012,Febrero,Curazao,99999,0,2,,2,"(10.408582,-75.538003)"
2012,Febrero,Curazao,99999,2,1,,3,"(3.541112,-76.384584)"
2012,Febrero,Curazao,99999,403,440,,843,"(4.697144,-74.140516)"
2012,Febrero,Curazao,99999,48,23,,71,"(6.171601,-75.427454)"
2012,Febrero,República Checa,203,0,1,,1,"(3.541112,-76.384584)"
2012,Febrero,República Checa,203,3,9,,12,"(4.697144,-74.140516)"
2012,Febrero,Chile,152,45,18,,63,"(0.814836,-77.662532)"
2012,Febrero,Chile,152,2,2,,4,"(10.445761,-75.516429)"
2012,Febrero,Chile,152,7,18,,25,"(10.886611,-74.776708)"
2012,Febrero,Chile,152,308,207,,515,"(3.541112,-76.384584)"
2012,Febrero,Chile,152,1934,1712,,3646,"(4.697144,-74.140516)"
2012,Febrero,Chile,152,8,14,,22,"(4.815061,-75.736532)"
2012,Febrero,Chile,152,69,56,,125,"(6.171601,-75.427454)"
2012,Febrero,Chile,152,2,0,,2,"(7.128456,-73.183637)"
2012,Febrero,China,156,0,4,,4,"(10.886611,-74.776708)"
2012,Febrero,China,156,1,4,,5,"(3.541112,-76.384584)"
2012,Febrero,China,156,206,606,,812,"(4.697144,-74.140516)"
2012,Febrero,China,156,15,32,,47,"(6.171601,-75.427454)"
2012,Febrero,Chipre,196,1,1,,2,"(4.697144,-74.140516)"
2012,Febrero,Dinamarca,208,15,11,,26,"(4.697144,-74.140516)"
2012,Febrero,Dinamarca,208,0,1,,1,"(6.171601,-75.427454)"
2012,Febrero,Dominica,212,0,3,,3,"(0.814836,-77.662532)"
2012,Febrero,Dominica,212,1,1,,2,"(3.541112,-76.384584)"
2012,Febrero,Dominica,212,1,1,,2,"(4.697144,-74.140516)"
2012,Febrero,Ecuador,218,223,287,,510,"(0.25129,-76.875963)"
2012,Febrero,Ecuador,218,5064,6555,,11619,"(0.814836,-77.662532)"
2012,Febrero,Ecuador,218,83,104,,187,"(1.813928,-78.763924)"
2012,Febrero,Ecuador,218,1,1,,2,"(10.445761,-75.516429)"
2012,Febrero,Ecuador,218,7,26,,33,"(10.886611,-74.776708)"
2012,Febrero,Ecuador,218,478,514,,992,"(3.541112,-76.384584)"
2012,Febrero,Ecuador,218,1797,3525,,5322,"(4.697144,-74.140516)"
2012,Febrero,Ecuador,218,0,1,,1,"(4.815061,-75.736532)"
2012,Febrero,Ecuador,218,238,370,,608,"(6.171601,-75.427454)"
2012,Febrero,Ecuador,218,2,2,,4,"(7.128456,-73.183637)"
2012,Febrero,Ecuador,218,1,0,,1,"(7.927209,-72.507910)"
2012,Febrero,Egipto,818,0,3,,3,"(0.814836,-77.662532)"
2012,Febrero,Egipto,818,26,34,,60,"(4.697144,-74.140516)"
2012,Febrero,Egipto,818,1,0,,1,"(6.171601,-75.427454)"
2012,Febrero,El Salvador,222,2,1,,3,"(10.445761,-75.516429)"
2012,Febrero,El Salvador,222,3,3,,6,"(10.886611,-74.776708)"
2012,Febrero,El Salvador,222,2,13,,15,"(3.541112,-76.384584)"
2012,Febrero,El Salvador,222,443,581,,1024,"(4.697144,-74.140516)"
2012,Febrero,El Salvador,222,11,31,,42,"(6.171601,-75.427454)"
2012,Febrero,Emiratos Árabes,784,3,0,,3,"(3.541112,-76.384584)"
2012,Febrero,Emiratos Árabes,784,31,51,,82,"(4.697144,-74.140516)"
2012,Febrero,Emiratos Árabes,784,13,11,,24,"(6.171601,-75.427454)"
2012,Febrero,Eritrea,232,1,1,,2,"(4.697144,-74.140516)"
2012,Febrero,Eslovaquia,703,1,1,,2,"(4.697144,-74.140516)"
2012,Febrero,Eslovenia,705,1,1,,2,"(3.541112,-76.384584)"
2012,Febrero,Estados Unidos de América,840,1097,1049,,2146,"(10.445761,-75.516429)"
2012,Febrero,Estados Unidos de América,840,1439,1361,,2800,"(10.886611,-74.776708)"
2012,Febrero,Estados Unidos de América,840,0,3,,3,"(11.117806,-74.232622)"
2012,Febrero,Estados Unidos de América,840,2,1,,3,"(11.360009,-72.129330)"
2012,Febrero,Estados Unidos de América,840,12,16,,28,"(12.586067,-81.702563)"
2012,Febrero,Estados Unidos de América,840,2937,2243,,5180,"(3.541112,-76.384584)"
2012,Febrero,Estados Unidos de América,840,449,392,,841,"(4.452882,-75.766298)"
2012,Febrero,Estados Unidos de América,840,17291,17622,,34913,"(4.697144,-74.140516)"
2012,Febrero,Estados Unidos de América,840,185,158,,343,"(4.815061,-75.736532)"
2012,Febrero,Estados Unidos de América,840,4270,3728,,7998,"(6.171601,-75.427454)"
2012,Febrero,Estados Unidos de América,840,38,57,,95,"(7.128456,-73.183637)"
2012,Febrero,Estados Unidos de América,840,16,13,,29,"(7.927209,-72.507910)"
2012,Febrero,Estonia,233,0,1,,1,"(3.541112,-76.384584)"
2012,Febrero,Etiopia,231,0,2,,2,"(4.697144,-74.140516)"
2012,Febrero,Filipinas,608,2,2,,4,"(4.697144,-74.140516)"
2012,Febrero,Filipinas,608,1,1,,2,"(6.171601,-75.427454)"
2012,Febrero,Finlandia,246,6,5,,11,"(4.697144,-74.140516)"
2012,Febrero,Francia,250,0,1,,1,"(10.445761,-75.516429)"
2012,Febrero,Francia,250,1,0,,1,"(10.886611,-74.776708)"
2012,Febrero,Francia,250,41,28,,69,"(3.541112,-76.384584)"
2012,Febrero,Francia,250,806,749,,1555,"(4.697144,-74.140516)"
2012,Febrero,Francia,250,35,22,,57,"(6.171601,-75.427454)"
2012,Febrero,Francia,250,1,0,,1,"(7.128456,-73.183637)"
2012,Febrero,Gabón,266,0,4,,4,"(4.697144,-74.140516)"
2012,Febrero,Grecia,300,1,2,,3,"(3.541112,-76.384584)"
2012,Febrero,Grecia,300,4,2,,6,"(4.697144,-74.140516)"
2012,Febrero,Guatemala,320,1,5,,6,"(10.445761,-75.516429)"
2012,Febrero,Guatemala,320,4,10,,14,"(10.886611,-74.776708)"
2012,Febrero,Guatemala,320,37,54,,91,"(3.541112,-76.384584)"
2012,Febrero,Guatemala,320,137,230,,367,"(4.697144,-74.140516)"
2012,Febrero,Guatemala,320,5,3,,8,"(4.815061,-75.736532)"
2012,Febrero,Guatemala,320,32,86,,118,"(6.171601,-75.427454)"
2012,Febrero,Guatemala,320,4,1,,5,"(7.128456,-73.183637)"
2012,Febrero,Guyana,328,0,1,,1,"(4.697144,-74.140516)"
2012,Febrero,Guinea,324,1,7,,8,"(4.697144,-74.140516)"
2012,Febrero,Guinea,324,0,1,,1,"(6.171601,-75.427454)"
2012,Febrero,Guinea Ecuatorial,226,2,18,,20,"(4.697144,-74.140516)"
2012,Febrero,Guinea Bissau,624,0,1,,1,"(4.697144,-74.140516)"
2012,Febrero,Haití,332,3,3,,6,"(10.445761,-75.516429)"
2012,Febrero,Haití,332,0,5,,5,"(10.886611,-74.776708)"
2012,Febrero,Haití,332,0,1,,1,"(3.893038,-77.067921)"
2012,Febrero,Haití,332,2,14,,16,"(4.697144,-74.140516)"
2012,Febrero,Haití,332,0,3,,3,"(6.171601,-75.427454)"
2012,Febrero,Honduras,340,0,7,,7,"(10.408582,-75.538003)"
2012,Febrero,Honduras,340,6,4,,10,"(10.445761,-75.516429)"
2012,Febrero,Honduras,340,4,8,,12,"(10.886611,-74.776708)"
2012,Febrero,Honduras,340,0,1,,1,"(12.586067,-81.702563)"
2012,Febrero,Honduras,340,15,30,,45,"(3.541112,-76.384584)"
2012,Febrero,Honduras,340,37,125,,162,"(4.697144,-74.140516)"
2012,Febrero,Honduras,340,2,3,,5,"(4.815061,-75.736532)"
2012,Febrero,Honduras,340,32,52,,84,"(6.171601,-75.427454)"
2012,Febrero,Honduras,340,2,6,,8,"(7.128456,-73.183637)"
2012,Febrero,Honduras,340,2,0,,2,"(7.927209,-72.507910)"
2012,Febrero,Hong Kong,344,17,51,,68,"(4.697144,-74.140516)"
2012,Febrero,Hong Kong,344,2,1,,3,"(6.171601,-75.427454)"
2012,Febrero,Hungría,348,3,2,,5,"(4.697144,-74.140516)"
2012,Febrero,India,356,1,4,,5,"(3.541112,-76.384584)"
2012,Febrero,India,356,41,33,,74,"(4.697144,-74.140516)"
2012,Febrero,India,356,3,2,,5,"(6.171601,-75.427454)"
2012,Febrero,Indonesia,360,3,4,,7,"(4.697144,-74.140516)"
2012,Febrero,Iraq,368,0,3,,3,"(4.697144,-74.140516)"
2012,Febrero,Irán,364,3,4,,7,"(4.697144,-74.140516)"
2012,Febrero,República de Irlanda,372,1,0,,1,"(10.886611,-74.776708)"
2012,Febrero,República de Irlanda,372,9,4,,13,"(4.697144,-74.140516)"
2012,Febrero,República de Irlanda,372,1,0,,1,"(6.171601,-75.427454)"
2012,Febrero,Islandia,352,1,1,,2,"(4.697144,-74.140516)"
2012,Febrero,Isla de Man,833,1,0,,1,"(4.697144,-74.140516)"
2012,Febrero,Israel,376,1,1,,2,"(10.445761,-75.516429)"
2012,Febrero,Israel,376,1,1,,2,"(3.541112,-76.384584)"
2012,Febrero,Israel,376,126,105,,231,"(4.697144,-74.140516)"
2012,Febrero,Israel,376,4,3,,7,"(6.171601,-75.427454)"
2012,Febrero,Italia,380,3,0,,3,"(10.445761,-75.516429)"
2012,Febrero,Italia,380,1,0,,1,"(10.886611,-74.776708)"
2012,Febrero,Italia,380,147,60,,207,"(3.541112,-76.384584)"
2012,Febrero,Italia,380,647,329,,976,"(4.697144,-74.140516)"
2012,Febrero,Italia,380,54,26,,80,"(6.171601,-75.427454)"
2012,Febrero,Jamaica,388,0,4,,4,"(10.445761,-75.516429)"
2012,Febrero,Jamaica,388,5,5,,10,"(10.886611,-74.776708)"
2012,Febrero,Jamaica,388,7,5,,12,"(3.541112,-76.384584)"
2012,Febrero,Jamaica,388,34,20,,54,"(4.697144,-74.140516)"
2012,Febrero,Jamaica,388,5,12,,17,"(6.171601,-75.427454)"
2012,Febrero,Japón,392,4,0,,4,"(3.541112,-76.384584)"
2012,Febrero,Japón,392,44,55,,99,"(4.697144,-74.140516)"
2012,Febrero,Japón,392,2,3,,5,"(6.171601,-75.427454)"
2012,Febrero,Jordania,400,2,3,,5,"(4.697144,-74.140516)"
2012,Febrero,Kazajistán,398,0,2,,2,"(4.697144,-74.140516)"
2012,Febrero,Kenia,404,1,0,,1,"(4.697144,-74.140516)"
2012,Febrero,Kenia,404,0,1,,1,"(6.171601,-75.427454)"
2012,Febrero,Kuwait,414,2,0,,2,"(3.541112,-76.384584)"
2012,Febrero,Kuwait,414,1,3,,4,"(4.697144,-74.140516)"
2012,Febrero,Letonia,428,0,1,,1,"(6.171601,-75.427454)"
2012,Febrero,Líbano,422,5,18,,23,"(4.697144,-74.140516)"
2012,Febrero,Liechtenstein,438,2,0,,2,"(4.697144,-74.140516)"
2012,Febrero,Luxemburgo,442,2,2,,4,"(4.697144,-74.140516)"
2012,Febrero,Madagascar,450,1,1,,2,"(4.697144,-74.140516)"
2012,Febrero,Malasia,458,4,14,,18,"(4.697144,-74.140516)"
2012,Febrero,Malasia,458,1,0,,1,"(6.171601,-75.427454)"
2012,Febrero,Malta,470,7,1,,8,"(4.697144,-74.140516)"
2012,Febrero,Marruecos,504,1,0,,1,"(3.541112,-76.384584)"
2012,Febrero,Marruecos,504,2,2,,4,"(4.697144,-74.140516)"
2012,Febrero,Martinica/Departamento de Ultramar Francés,474,0,1,,1,"(10.445761,-75.516429)"
2012,Febrero,México,484,13,14,,27,"(10.445761,-75.516429)"
2012,Febrero,México,484,22,19,,41,"(10.886611,-74.776708)"
2012,Febrero,México,484,88,94,,182,"(3.541112,-76.384584)"
2012,Febrero,México,484,2799,3423,,6222,"(4.697144,-74.140516)"
2012,Febrero,México,484,8,9,,17,"(4.815061,-75.736532)"
2012,Febrero,México,484,159,168,,327,"(6.171601,-75.427454)"
2012,Febrero,México,484,7,8,,15,"(7.128456,-73.183637)"
2012,Febrero,México,484,1,1,,2,"(7.927209,-72.507910)"
2012,Febrero,República de Moldavia,498,0,1,,1,"(4.697144,-74.140516)"
2012,Febrero,Mónaco,492,1,1,,2,"(4.697144,-74.140516)"
2012,Febrero,Mongolia,496,1,0,,1,"(4.697144,-74.140516)"
2012,Febrero,Mozambique,508,3,0,,3,"(4.697144,-74.140516)"
2012,Febrero,Nauru,520,1,0,,1,"(4.697144,-74.140516)"
2012,Febrero,Nicaragua,558,1,2,,3,"(10.445761,-75.516429)"
2012,Febrero,Nicaragua,558,2,1,,3,"(10.886611,-74.776708)"
2012,Febrero,Nicaragua,558,2,0,,2,"(12.586067,-81.702563)"
2012,Febrero,Nicaragua,558,2,8,,10,"(3.541112,-76.384584)"
2012,Febrero,Nicaragua,558,24,43,,67,"(4.697144,-74.140516)"
2012,Febrero,Nicaragua,558,7,18,,25,"(6.171601,-75.427454)"
2012,Febrero,Nigeria,566,0,19,,19,"(4.697144,-74.140516)"
2012,Febrero,Niue,570,0,1,,1,"(4.697144,-74.140516)"
2012,Febrero,Noruega,578,1,0,,1,"(10.886611,-74.776708)"
2012,Febrero,Noruega,578,3,2,,5,"(3.541112,-76.384584)"
2012,Febrero,Noruega,578,23,19,,42,"(4.697144,-74.140516)"
2012,Febrero,Noruega,578,0,1,,1,"(6.171601,-75.427454)"
2012,Febrero,Nueva Caledonia/Territorio francés,540,0,1,,1,"(4.697144,-74.140516)"
2012,Febrero,Nueva Zelanda,554,1,1,,2,"(3.541112,-76.384584)"
2012,Febrero,Nueva Zelanda,554,16,22,,38,"(4.697144,-74.140516)"
2012,Febrero,Nueva Zelanda,554,1,0,,1,"(6.171601,-75.427454)"
2012,Febrero,Omán,512,3,1,,4,"(4.697144,-74.140516)"
2012,Febrero,Papúa Nueva Guinea,598,0,3,,3,"(4.697144,-74.140516)"
2012,Febrero,Papúa Nueva Guinea,598,0,1,,1,"(6.171601,-75.427454)"
2012,Febrero,Pakistán,586,0,1,,1,"(4.697144,-74.140516)"
2012,Febrero,Panamá,591,427,340,,767,"(10.408582,-75.538003)"
2012,Febrero,Panamá,591,333,333,,666,"(10.445761,-75.516429)"
2012,Febrero,Panamá,591,1120,1036,,2156,"(10.886611,-74.776708)"
2012,Febrero,Panamá,591,1,0,,1,"(11.247723,-74.213989)"
2012,Febrero,Panamá,591,1,18,,19,"(12.5744111,-81.703935)"
2012,Febrero,Panamá,591,111,138,,249,"(12.586067,-81.702563)"
2012,Febrero,Panamá,591,1825,1664,,3489,"(3.541112,-76.384584)"
2012,Febrero,Panamá,591,0,17,,17,"(3.893038,-77.067921)"
2012,Febrero,Panamá,591,5913,6804,,12717,"(4.697144,-74.140516)"
2012,Febrero,Panamá,591,634,503,,1137,"(4.815061,-75.736532)"
2012,Febrero,Panamá,591,1863,2071,,3934,"(6.171601,-75.427454)"
2012,Febrero,Panamá,591,7,28,,35,"(6.228046,-77.404104)"
2012,Febrero,Panamá,591,284,283,,567,"(7.128456,-73.183637)"
2012,Febrero,Panamá,591,154,192,,346,"(7.927209,-72.507910)"
2012,Febrero,Panamá,591,80,161,,241,"(8.635765,-77.346578)"
2012,Febrero,Paraguay,600,0,1,,1,"(0.814836,-77.662532)"
2012,Febrero,Paraguay,600,0,1,,1,"(10.445761,-75.516429)"
2012,Febrero,Paraguay,600,0,1,,1,"(10.886611,-74.776708)"
2012,Febrero,Paraguay,600,8,7,,15,"(3.541112,-76.384584)"
2012,Febrero,Paraguay,600,43,68,,111,"(4.697144,-74.140516)"
2012,Febrero,Paraguay,600,0,7,,7,"(6.171601,-75.427454)"
2012,Febrero,Paraguay,600,1,0,,1,"(7.128456,-73.183637)"
2012,Febrero,Perú,604,50,87,,137,"(-4.197703,-69.941278)"
2012,Febrero,Perú,604,13,17,,30,"(0.814836,-77.662532)"
2012,Febrero,Perú,604,1,4,,5,"(10.445761,-75.516429)"
2012,Febrero,Perú,604,6,4,,10,"(10.886611,-74.776708)"
2012,Febrero,Perú,604,3,2,,5,"(12.586067,-81.702563)"
2012,Febrero,Perú,604,100,115,,215,"(3.541112,-76.384584)"
2012,Febrero,Perú,604,2818,3731,,6549,"(4.697144,-74.140516)"
2012,Febrero,Perú,604,3,3,,6,"(4.815061,-75.736532)"
2012,Febrero,Perú,604,194,258,,452,"(6.171601,-75.427454)"
2012,Febrero,Perú,604,3,4,,7,"(7.128456,-73.183637)"
2012,Febrero,Perú,604,9,23,,32,"(7.927209,-72.507910)"
2012,Febrero,Polonia,616,8,8,,16,"(4.697144,-74.140516)"
2012,Febrero,Portugal,620,3,1,,4,"(3.541112,-76.384584)"
2012,Febrero,Portugal,620,21,12,,33,"(4.697144,-74.140516)"
2012,Febrero,Portugal,620,2,3,,5,"(6.171601,-75.427454)"
2012,Febrero,Puerto Rico/Territorio de Estados Unidos,630,3,1,,4,"(10.445761,-75.516429)"
2012,Febrero,Puerto Rico/Territorio de Estados Unidos,630,8,11,,19,"(10.886611,-74.776708)"
2012,Febrero,Puerto Rico/Territorio de Estados Unidos,630,5,5,,10,"(12.586067,-81.702563)"
2012,Febrero,Puerto Rico/Territorio de Estados Unidos,630,21,17,,38,"(3.541112,-76.384584)"
2012,Febrero,Puerto Rico/Territorio de Estados Unidos,630,93,89,,182,"(4.697144,-74.140516)"
2012,Febrero,Puerto Rico/Territorio de Estados Unidos,630,5,7,,12,"(4.815061,-75.736532)"
2012,Febrero,Puerto Rico/Territorio de Estados Unidos,630,31,39,,70,"(6.171601,-75.427454)"
2012,Febrero,Puerto Rico/Territorio de Estados Unidos,630,2,3,,5,"(7.128456,-73.183637)"
2012,Febrero,Qatar,634,3,1,,4,"(4.697144,-74.140516)"
2012,Febrero,Qatar,634,0,1,,1,"(6.171601,-75.427454)"
2012,Febrero,Reino Unido de Gran Bretaña e Irlanda del Norte,826,1,1,,2,"(10.445761,-75.516429)"
2012,Febrero,Reino Unido de Gran Bretaña e Irlanda del Norte,826,1,2,,3,"(10.886611,-74.776708)"
2012,Febrero,Reino Unido de Gran Bretaña e Irlanda del Norte,826,52,35,,87,"(3.541112,-76.384584)"
2012,Febrero,Reino Unido de Gran Bretaña e Irlanda del Norte,826,0,1,,1,"(4.452882,-75.766298)"
2012,Febrero,Reino Unido de Gran Bretaña e Irlanda del Norte,826,539,433,,972,"(4.697144,-74.140516)"
2012,Febrero,Reino Unido de Gran Bretaña e Irlanda del Norte,826,34,21,,55,"(6.171601,-75.427454)"
2012,Febrero,Federación de Rusia,643,0,1,,1,"(11.360009,-72.129330)"
2012,Febrero,Federación de Rusia,643,11,34,,45,"(4.697144,-74.140516)"
2012,Febrero,Federación de Rusia,643,6,0,,6,"(6.171601,-75.427454)"
2012,Febrero,República Dominicana,214,9,17,,26,"(10.445761,-75.516429)"
2012,Febrero,República Dominicana,214,9,26,,35,"(10.886611,-74.776708)"
2012,Febrero,República Dominicana,214,38,38,,76,"(3.541112,-76.384584)"
2012,Febrero,República Dominicana,214,676,890,,1566,"(4.697144,-74.140516)"
2012,Febrero,República Dominicana,214,3,3,,6,"(4.815061,-75.736532)"
2012,Febrero,República Dominicana,214,71,95,,166,"(6.171601,-75.427454)"
2012,Febrero,República Dominicana,214,8,8,,16,"(7.128456,-73.183637)"
2012,Febrero,República Dominicana,214,5,4,,9,"(7.927209,-72.507910)"
2012,Febrero,Reunión,638,2,0,,2,"(4.697144,-74.140516)"
2012,Febrero,Rumania,642,0,1,,1,"(12.586067,-81.702563)"
2012,Febrero,Rumania,642,1,4,,5,"(4.697144,-74.140516)"
2012,Febrero,San Cristóbal y Nevis,659,1,0,,1,"(3.541112,-76.384584)"
2012,Febrero,Santa Lucia,662,1,1,,2,"(4.697144,-74.140516)"
2012,Febrero,Senegal,686,1,0,,1,"(10.445761,-75.516429)"
2012,Febrero,Senegal,686,1,1,,2,"(4.697144,-74.140516)"
2012,Febrero,Singapur,702,0,1,,1,"(3.541112,-76.384584)"
2012,Febrero,Singapur,702,9,25,,34,"(4.697144,-74.140516)"
2012,Febrero,Singapur,702,1,0,,1,"(6.171601,-75.427454)"
2012,Febrero,Sudáfrica,710,7,10,,17,"(4.697144,-74.140516)"
2012,Febrero,Suecia,752,0,1,,1,"(12.586067,-81.702563)"
2012,Febrero,Suecia,752,5,1,,6,"(3.541112,-76.384584)"
2012,Febrero,Suecia,752,73,68,,141,"(4.697144,-74.140516)"
2012,Febrero,Suecia,752,6,6,,12,"(6.171601,-75.427454)"
2012,Febrero,Suecia,752,1,0,,1,"(7.128456,-73.183637)"
2012,Febrero,Suiza,756,35,10,,45,"(3.541112,-76.384584)"
2012,Febrero,Suiza,756,182,129,,311,"(4.697144,-74.140516)"
2012,Febrero,Suiza,756,16,8,,24,"(6.171601,-75.427454)"
2012,Febrero,Surinam,740,1,7,,8,"(4.697144,-74.140516)"
2012,Febrero,Taiwán,158,0,5,,5,"(4.697144,-74.140516)"
2012,Febrero,Taiwán,158,1,0,,1,"(7.128456,-73.183637)"
2012,Febrero,Tailandia,764,4,11,,15,"(4.697144,-74.140516)"
2012,Febrero,Tailandia,764,1,1,,2,"(6.171601,-75.427454)"
2012,Febrero,Trinidad y Tobago,780,2,9,,11,"(10.445761,-75.516429)"
2012,Febrero,Trinidad y Tobago,780,1,3,,4,"(10.886611,-74.776708)"
2012,Febrero,Trinidad y Tobago,780,7,5,,12,"(3.541112,-76.384584)"
2012,Febrero,Trinidad y Tobago,780,24,46,,70,"(4.697144,-74.140516)"
2012,Febrero,Trinidad y Tobago,780,4,3,,7,"(4.815061,-75.736532)"
2012,Febrero,Trinidad y Tobago,780,7,8,,15,"(6.171601,-75.427454)"
2012,Febrero,Trinidad y Tobago,780,3,6,,9,"(7.128456,-73.183637)"
2012,Febrero,Trinidad y Tobago,780,0,11,,11,"(7.927209,-72.507910)"
2012,Febrero,Túnez,788,1,0,,1,"(4.697144,-74.140516)"
2012,Febrero,Turquía,792,1,1,,2,"(3.541112,-76.384584)"
2012,Febrero,Turquía,792,23,16,,39,"(4.697144,-74.140516)"
2012,Febrero,Turquía,792,1,0,,1,"(6.171601,-75.427454)"
2012,Febrero,Ucrania,804,0,1,,1,"(4.697144,-74.140516)"
2012,Febrero,Uruguay,858,3,2,,5,"(10.445761,-75.516429)"
2012,Febrero,Uruguay,858,3,0,,3,"(10.886611,-74.776708)"
2012,Febrero,Uruguay,858,14,6,,20,"(3.541112,-76.384584)"
2012,Febrero,Uruguay,858,38,59,,97,"(4.697144,-74.140516)"
2012,Febrero,Uruguay,858,1,1,,2,"(4.815061,-75.736532)"
2012,Febrero,Uruguay,858,8,30,,38,"(6.171601,-75.427454)"
2012,Febrero,Uruguay,858,1,0,,1,"(7.927209,-72.507910)"
2012,Febrero,Vanuatu,548,0,1,,1,"(11.360009,-72.129330)"
2012,Febrero,Venezuela,862,0,1,,1,"(10.408582,-75.538003)"
2012,Febrero,Venezuela,862,1,3,,4,"(10.445761,-75.516429)"
2012,Febrero,Venezuela,862,19,22,,41,"(10.886611,-74.776708)"
2012,Febrero,Venezuela,862,0,2,,2,"(11.247723,-74.213989)"
2012,Febrero,Venezuela,862,5423,5255,,10678,"(11.360009,-72.129330)"
2012,Febrero,Venezuela,862,1,2,,3,"(12.586067,-81.702563)"
2012,Febrero,Venezuela,862,24,19,,43,"(3.541112,-76.384584)"
2012,Febrero,Venezuela,862,2017,2743,,4760,"(4.697144,-74.140516)"
2012,Febrero,Venezuela,862,5,6,,11,"(4.815061,-75.736532)"
2012,Febrero,Venezuela,862,229,286,,515,"(6.171601,-75.427454)"
2012,Febrero,Venezuela,862,96,119,,215,"(6.185799,-67.483929)"
2012,Febrero,Venezuela,862,764,771,,1535,"(7.088729,-70.740253)"
2012,Febrero,Venezuela,862,4,4,,8,"(7.128456,-73.183637)"
2012,Febrero,Venezuela,862,4554,5422,,9976,"(7.818934,-72.453226)"
2012,Febrero,Venezuela,862,8,16,,24,"(7.927209,-72.507910)"
2012,Febrero,Vietnam,704,1,1,,2,"(4.697144,-74.140516)"
2012,Febrero,Islas Turcas y Caicos/Territorio Británico de Ultramar,796,0,2,,2,"(10.445761,-75.516429)"
2012,Febrero,Desconocido,99999,2,0,,2,"(3.541112,-76.384584)"
2012,Febrero,Desconocido,99999,5,16,,21,"(4.697144,-74.140516)"
2012,Febrero,Desconocido,99999,0,1,,1,"(6.171601,-75.427454)"
2012,Marzo,Afganistán,4,2,29,,31,"(4.697144,-74.140516)"
2012,Marzo,Afganistán,4,1,0,,1,"(6.185799,-67.483929)"
2012,Marzo,Alemania,276,1,1,,2,"(10.445761,-75.516429)"
2012,Marzo,Alemania,276,22,16,,38,"(3.541112,-76.384584)"
2012,Marzo,Alemania,276,911,896,,1807,"(4.697144,-74.140516)"
2012,Marzo,Alemania,276,16,19,,35,"(6.171601,-75.427454)"
2012,Marzo,Angola,24,0,1,,1,"(3.541112,-76.384584)"
2012,Marzo,Angola,24,0,10,,10,"(4.697144,-74.140516)"
2012,Marzo,Países Bajos,528,396,241,,637,"(10.408582,-75.538003)"
2012,Marzo,Países Bajos,528,2,2,,4,"(10.886611,-74.776708)"
2012,Marzo,Países Bajos,528,32,22,,54,"(3.541112,-76.384584)"
2012,Marzo,Países Bajos,528,110,77,,187,"(4.697144,-74.140516)"
2012,Marzo,Países Bajos,528,45,26,,71,"(6.171601,-75.427454)"
2012,Marzo,Arabia Saudita,682,0,1,,1,"(10.445761,-75.516429)"
2012,Marzo,Arabia Saudita,682,15,20,,35,"(4.697144,-74.140516)"
2012,Marzo,Arabia Saudita,682,1,1,,2,"(6.171601,-75.427454)"
2012,Marzo,Argelia,12,3,1,,4,"(3.541112,-76.384584)"
2012,Marzo,Argelia,12,2,11,,13,"(4.697144,-74.140516)"
2012,Marzo,Argelia,12,0,1,,1,"(6.171601,-75.427454)"
2012,Marzo,Argentina,32,1,1,,2,"(0.25129,-76.875963)"
2012,Marzo,Argentina,32,11,16,,27,"(0.814836,-77.662532)"
2012,Marzo,Argentina,32,4,12,,16,"(10.445761,-75.516429)"
2012,Marzo,Argentina,32,31,22,,53,"(10.886611,-74.776708)"
2012,Marzo,Argentina,32,294,308,,602,"(3.541112,-76.384584)"
2012,Marzo,Argentina,32,3619,3554,,7173,"(4.697144,-74.140516)"
2012,Marzo,Argentina,32,24,21,,45,"(4.815061,-75.736532)"
2012,Marzo,Argentina,32,339,382,,721,"(6.171601,-75.427454)"
2012,Marzo,Argentina,32,2,7,,9,"(7.128456,-73.183637)"
2012,Marzo,Argentina,32,1,1,,2,"(7.927209,-72.507910)"
2012,Marzo,República de Armenia,51,1,1,,2,"(4.697144,-74.140516)"
2012,Marzo,Aruba,533,719,395,,1114,"(10.408582,-75.538003)"
2012,Marzo,Aruba,533,0,1,,1,"(10.445761,-75.516429)"
2012,Marzo,Aruba,533,14,17,,31,"(10.886611,-74.776708)"
2012,Marzo,Aruba,533,74,61,,135,"(11.528919,-72.919681)"
2012,Marzo,Aruba,533,34,21,,55,"(3.541112,-76.384584)"
2012,Marzo,Aruba,533,887,808,,1695,"(4.697144,-74.140516)"
2012,Marzo,Aruba,533,0,1,,1,"(4.815061,-75.736532)"
2012,Marzo,Aruba,533,58,47,,105,"(6.171601,-75.427454)"
2012,Marzo,Aruba,533,1,2,,3,"(7.128456,-73.183637)"
2012,Marzo,Australia,36,1,0,,1,"(10.445761,-75.516429)"
2012,Marzo,Australia,36,7,1,,8,"(10.886611,-74.776708)"
2012,Marzo,Australia,36,9,5,,14,"(3.541112,-76.384584)"
2012,Marzo,Australia,36,1,1,,2,"(4.452882,-75.766298)"
2012,Marzo,Australia,36,166,123,,289,"(4.697144,-74.140516)"
2012,Marzo,Australia,36,1,0,,1,"(4.815061,-75.736532)"
2012,Marzo,Australia,36,20,24,,44,"(6.171601,-75.427454)"
2012,Marzo,Australia,36,4,1,,5,"(7.128456,-73.183637)"
2012,Marzo,Austria,40,0,1,,1,"(3.541112,-76.384584)"
2012,Marzo,Austria,40,30,39,,69,"(4.697144,-74.140516)"
2012,Marzo,Austria,40,0,1,,1,"(6.171601,-75.427454)"
2012,Marzo,Azerbaiyán,31,2,2,,4,"(4.697144,-74.140516)"
2012,Marzo,Bahamas,44,2,1,,3,"(10.445761,-75.516429)"
2012,Marzo,Bahamas,44,10,4,,14,"(10.886611,-74.776708)"
2012,Marzo,Bahamas,44,15,15,,30,"(3.541112,-76.384584)"
2012,Marzo,Bahamas,44,39,33,,72,"(4.697144,-74.140516)"
2012,Marzo,Bahamas,44,4,0,,4,"(4.815061,-75.736532)"
2012,Marzo,Bahamas,44,43,43,,86,"(6.171601,-75.427454)"
2012,Marzo,Bahamas,44,14,19,,33,"(7.128456,-73.183637)"
2012,Marzo,Bahamas,44,1,1,,2,"(7.927209,-72.507910)"
2012,Marzo,Barbados,52,0,1,,1,"(3.541112,-76.384584)"
2012,Marzo,Barbados,52,2,22,,24,"(4.697144,-74.140516)"
2012,Marzo,República de Belarús,112,3,2,,5,"(4.697144,-74.140516)"
2012,Marzo,República de Belarús,112,4,3,,7,"(7.818934,-72.453226)"
2012,Marzo,Bélgica,56,0,1,,1,"(10.445761,-75.516429)"
2012,Marzo,Bélgica,56,12,5,,17,"(3.541112,-76.384584)"
2012,Marzo,Bélgica,56,54,27,,81,"(4.697144,-74.140516)"
2012,Marzo,Bélgica,56,7,3,,10,"(6.171601,-75.427454)"
2012,Marzo,Belice,84,5,2,,7,"(4.697144,-74.140516)"
2012,Marzo,Benín,204,0,1,,1,"(3.541112,-76.384584)"
2012,Marzo,Benín,204,0,1,,1,"(4.697144,-74.140516)"
2012,Marzo,Bermudas/Territorio Británico de Ultramar,60,1,0,,1,"(4.697144,-74.140516)"
2012,Marzo,Bolivia,68,1,2,,3,"(0.814836,-77.662532)"
2012,Marzo,Bolivia,68,1,0,,1,"(10.445761,-75.516429)"
2012,Marzo,Bolivia,68,2,6,,8,"(10.886611,-74.776708)"
2012,Marzo,Bolivia,68,22,29,,51,"(3.541112,-76.384584)"
2012,Marzo,Bolivia,68,233,284,,517,"(4.697144,-74.140516)"
2012,Marzo,Bolivia,68,1,0,,1,"(4.815061,-75.736532)"
2012,Marzo,Bolivia,68,12,27,,39,"(6.171601,-75.427454)"
2012,Marzo,Botsuana,72,1,0,,1,"(4.697144,-74.140516)"
2012,Marzo,Brasil,76,73,119,,192,"(-4.197703,-69.941278)"
2012,Marzo,Brasil,76,0,2,,2,"(0.814836,-77.662532)"
2012,Marzo,Brasil,76,5,7,,12,"(10.445761,-75.516429)"
2012,Marzo,Brasil,76,10,15,,25,"(10.886611,-74.776708)"
2012,Marzo,Brasil,76,0,1,,1,"(12.586067,-81.702563)"
2012,Marzo,Brasil,76,51,87,,138,"(3.541112,-76.384584)"
2012,Marzo,Brasil,76,2248,3254,,5502,"(4.697144,-74.140516)"
2012,Marzo,Brasil,76,1,2,,3,"(4.815061,-75.736532)"
2012,Marzo,Brasil,76,58,91,,149,"(6.171601,-75.427454)"
2012,Marzo,Brasil,76,27,10,,37,"(7.128456,-73.183637)"
2012,Marzo,Brasil,76,0,1,,1,"(7.927209,-72.507910)"
2012,Marzo,Burkina Faso,854,0,1,,1,"(4.697144,-74.140516)"
2012,Marzo,Islas Caimán/Territorio Británico de Ultramar,136,0,1,,1,"(10.445761,-75.516429)"
2012,Marzo,Islas Caimán/Territorio Británico de Ultramar,136,1,0,,1,"(10.886611,-74.776708)"
2012,Marzo,Islas Caimán/Territorio Británico de Ultramar,136,0,5,,5,"(12.5744111,-81.703935)"
2012,Marzo,Islas Caimán/Territorio Británico de Ultramar,136,1,1,,2,"(12.586067,-81.702563)"
2012,Marzo,Islas Caimán/Territorio Británico de Ultramar,136,2,2,,4,"(13.3387613,-81.372937)"
2012,Marzo,Islas Caimán/Territorio Británico de Ultramar,136,0,1,,1,"(3.541112,-76.384584)"
2012,Marzo,Islas Caimán/Territorio Británico de Ultramar,136,1,0,,1,"(6.171601,-75.427454)"
2012,Marzo,Camboya,116,1,2,,3,"(4.697144,-74.140516)"
2012,Marzo,Canadá,124,129,94,,223,"(10.445761,-75.516429)"
2012,Marzo,Canadá,124,11,9,,20,"(10.886611,-74.776708)"
2012,Marzo,Canadá,124,6,3,,9,"(12.586067,-81.702563)"
2012,Marzo,Canadá,124,73,42,,115,"(3.541112,-76.384584)"
2012,Marzo,Canadá,124,5,4,,9,"(4.452882,-75.766298)"
2012,Marzo,Canadá,124,1242,1071,,2313,"(4.697144,-74.140516)"
2012,Marzo,Canadá,124,8,5,,13,"(4.815061,-75.736532)"
2012,Marzo,Canadá,124,140,103,,243,"(6.171601,-75.427454)"
2012,Marzo,Canadá,124,1,0,,1,"(7.927209,-72.507910)"
2012,Marzo,España,724,4,2,,6,"(10.445761,-75.516429)"
2012,Marzo,España,724,0,1,,1,"(10.886611,-74.776708)"
2012,Marzo,España,724,1810,1152,,2962,"(3.541112,-76.384584)"
2012,Marzo,España,724,6107,4932,,11039,"(4.697144,-74.140516)"
2012,Marzo,España,724,3,1,,4,"(4.815061,-75.736532)"
2012,Marzo,España,724,578,433,,1011,"(6.171601,-75.427454)"
2012,Marzo,España,724,1,0,,1,"(7.128456,-73.183637)"
2012,Marzo,República Democrática del Congo,180,0,1,,1,"(4.815061,-75.736532)"
2012,Marzo,República Democrática del Congo,180,1,2,,3,"(6.171601,-75.427454)"
2012,Marzo,República de Corea,410,12,22,,34,"(4.697144,-74.140516)"
2012,Marzo,Costa de Marfil,384,0,1,,1,"(3.541112,-76.384584)"
2012,Marzo,Costa Rica,188,7,11,,18,"(10.445761,-75.516429)"
2012,Marzo,Costa Rica,188,13,16,,29,"(10.886611,-74.776708)"
2012,Marzo,Costa Rica,188,3,34,,37,"(12.5744111,-81.703935)"
2012,Marzo,Costa Rica,188,6,6,,12,"(12.586067,-81.702563)"
2012,Marzo,Costa Rica,188,37,45,,82,"(3.541112,-76.384584)"
2012,Marzo,Costa Rica,188,637,833,,1470,"(4.697144,-74.140516)"
2012,Marzo,Costa Rica,188,4,0,,4,"(4.815061,-75.736532)"
2012,Marzo,Costa Rica,188,162,187,,349,"(6.171601,-75.427454)"
2012,Marzo,Costa Rica,188,0,1,,1,"(6.228046,-77.404104)"
2012,Marzo,Costa Rica,188,2,2,,4,"(7.128456,-73.183637)"
2012,Marzo,Croacia,191,1,1,,2,"(4.697144,-74.140516)"
2012,Marzo,Cuba,192,8,3,,11,"(10.445761,-75.516429)"
2012,Marzo,Cuba,192,26,24,,50,"(10.886611,-74.776708)"
2012,Marzo,Cuba,192,90,55,,145,"(3.541112,-76.384584)"
2012,Marzo,Cuba,192,650,597,,1247,"(4.697144,-74.140516)"
2012,Marzo,Cuba,192,4,3,,7,"(4.815061,-75.736532)"
2012,Marzo,Cuba,192,287,159,,446,"(6.171601,-75.427454)"
2012,Marzo,Cuba,192,3,1,,4,"(7.128456,-73.183637)"
2012,Marzo,Cuba,192,3,1,,4,"(7.927209,-72.507910)"
2012,Marzo,Curazao,99999,0,1,,1,"(10.408582,-75.538003)"
2012,Marzo,Curazao,99999,1,1,,2,"(3.541112,-76.384584)"
2012,Marzo,Curazao,99999,537,592,,1129,"(4.697144,-74.140516)"
2012,Marzo,Curazao,99999,89,61,,150,"(6.171601,-75.427454)"
2012,Marzo,República Checa,203,10,12,,22,"(4.697144,-74.140516)"
2012,Marzo,Chile,152,16,18,,34,"(0.814836,-77.662532)"
2012,Marzo,Chile,152,6,1,,7,"(10.445761,-75.516429)"
2012,Marzo,Chile,152,30,21,,51,"(10.886611,-74.776708)"
2012,Marzo,Chile,152,1,1,,2,"(12.586067,-81.702563)"
2012,Marzo,Chile,152,574,385,,959,"(3.541112,-76.384584)"
2012,Marzo,Chile,152,2877,2900,,5777,"(4.697144,-74.140516)"
2012,Marzo,Chile,152,46,31,,77,"(4.815061,-75.736532)"
2012,Marzo,Chile,152,220,180,,400,"(6.171601,-75.427454)"
2012,Marzo,Chile,152,6,5,,11,"(7.128456,-73.183637)"
2012,Marzo,Chile,152,0,1,,1,"(7.927209,-72.507910)"
2012,Marzo,China,156,1,0,,1,"(0.814836,-77.662532)"
2012,Marzo,China,156,2,1,,3,"(10.445761,-75.516429)"
2012,Marzo,China,156,3,3,,6,"(10.886611,-74.776708)"
2012,Marzo,China,156,6,9,,15,"(3.541112,-76.384584)"
2012,Marzo,China,156,251,585,,836,"(4.697144,-74.140516)"
2012,Marzo,China,156,14,31,,45,"(6.171601,-75.427454)"
2012,Marzo,Dinamarca,208,0,2,,2,"(3.541112,-76.384584)"
2012,Marzo,Dinamarca,208,15,18,,33,"(4.697144,-74.140516)"
2012,Marzo,Dominica,212,0,1,,1,"(0.814836,-77.662532)"
2012,Marzo,Dominica,212,1,1,,2,"(4.697144,-74.140516)"
2012,Marzo,Ecuador,218,361,440,,801,"(0.25129,-76.875963)"
2012,Marzo,Ecuador,218,5806,6959,,12765,"(0.814836,-77.662532)"
2012,Marzo,Ecuador,218,91,100,,191,"(1.813928,-78.763924)"
2012,Marzo,Ecuador,218,1,1,,2,"(10.445761,-75.516429)"
2012,Marzo,Ecuador,218,2,9,,11,"(10.886611,-74.776708)"
2012,Marzo,Ecuador,218,695,708,,1403,"(3.541112,-76.384584)"
2012,Marzo,Ecuador,218,2502,4010,,6512,"(4.697144,-74.140516)"
2012,Marzo,Ecuador,218,375,464,,839,"(6.171601,-75.427454)"
2012,Marzo,Ecuador,218,1,0,,1,"(7.128456,-73.183637)"
2012,Marzo,Ecuador,218,0,1,,1,"(7.927209,-72.507910)"
2012,Marzo,Egipto,818,1,0,,1,"(0.814836,-77.662532)"
2012,Marzo,Egipto,818,127,48,,175,"(4.697144,-74.140516)"
2012,Marzo,El Salvador,222,3,2,,5,"(10.886611,-74.776708)"
2012,Marzo,El Salvador,222,6,11,,17,"(3.541112,-76.384584)"
2012,Marzo,El Salvador,222,767,848,,1615,"(4.697144,-74.140516)"
2012,Marzo,El Salvador,222,12,23,,35,"(6.171601,-75.427454)"
2012,Marzo,El Salvador,222,2,1,,3,"(7.128456,-73.183637)"
2012,Marzo,Emiratos Árabes,784,5,1,,6,"(3.541112,-76.384584)"
2012,Marzo,Emiratos Árabes,784,37,59,,96,"(4.697144,-74.140516)"
2012,Marzo,Emiratos Árabes,784,2,0,,2,"(6.171601,-75.427454)"
2012,Marzo,Eslovaquia,703,2,1,,3,"(4.697144,-74.140516)"
2012,Marzo,Eslovenia,705,1,1,,2,"(3.541112,-76.384584)"
2012,Marzo,Eslovenia,705,1,1,,2,"(4.697144,-74.140516)"
2012,Marzo,Estados Unidos de América,840,0,4,,4,"(10.408582,-75.538003)"
2012,Marzo,Estados Unidos de América,840,1449,1312,,2761,"(10.445761,-75.516429)"
2012,Marzo,Estados Unidos de América,840,1796,1513,,3309,"(10.886611,-74.776708)"
2012,Marzo,Estados Unidos de América,840,11,20,,31,"(12.586067,-81.702563)"
2012,Marzo,Estados Unidos de América,840,4400,3386,,7786,"(3.541112,-76.384584)"
2012,Marzo,Estados Unidos de América,840,492,391,,883,"(4.452882,-75.766298)"
2012,Marzo,Estados Unidos de América,840,26264,24819,,51083,"(4.697144,-74.140516)"
2012,Marzo,Estados Unidos de América,840,203,135,,338,"(4.815061,-75.736532)"
2012,Marzo,Estados Unidos de América,840,5552,4846,,10398,"(6.171601,-75.427454)"
2012,Marzo,Estados Unidos de América,840,164,114,,278,"(7.128456,-73.183637)"
2012,Marzo,Estados Unidos de América,840,12,17,,29,"(7.927209,-72.507910)"
2012,Marzo,Estados Unidos de América,840,0,1,,1,"(9.402978,-75.681599)"
2012,Marzo,Estonia,233,0,1,,1,"(6.171601,-75.427454)"
2012,Marzo,Etiopia,231,1,0,,1,"(4.452882,-75.766298)"
2012,Marzo,Etiopia,231,1,1,,2,"(4.697144,-74.140516)"
2012,Marzo,Filipinas,608,1,0,,1,"(3.541112,-76.384584)"
2012,Marzo,Filipinas,608,1,4,,5,"(4.697144,-74.140516)"
2012,Marzo,Finlandia,246,1,0,,1,"(3.541112,-76.384584)"
2012,Marzo,Finlandia,246,9,11,,20,"(4.697144,-74.140516)"
2012,Marzo,Francia,250,1,0,,1,"(10.445761,-75.516429)"
2012,Marzo,Francia,250,45,31,,76,"(3.541112,-76.384584)"
2012,Marzo,Francia,250,1190,1099,,2289,"(4.697144,-74.140516)"
2012,Marzo,Francia,250,25,23,,48,"(6.171601,-75.427454)"
2012,Marzo,Gabón,266,0,4,,4,"(4.697144,-74.140516)"
2012,Marzo,Granada,308,1,0,,1,"(4.697144,-74.140516)"
2012,Marzo,Grecia,300,6,0,,6,"(3.541112,-76.384584)"
2012,Marzo,Grecia,300,14,11,,25,"(4.697144,-74.140516)"
2012,Marzo,Grecia,300,0,1,,1,"(6.171601,-75.427454)"
2012,Marzo,Guatemala,320,2,2,,4,"(10.445761,-75.516429)"
2012,Marzo,Guatemala,320,3,4,,7,"(10.886611,-74.776708)"
2012,Marzo,Guatemala,320,18,28,,46,"(3.541112,-76.384584)"
2012,Marzo,Guatemala,320,143,269,,412,"(4.697144,-74.140516)"
2012,Marzo,Guatemala,320,7,4,,11,"(4.815061,-75.736532)"
2012,Marzo,Guatemala,320,61,86,,147,"(6.171601,-75.427454)"
2012,Marzo,Guatemala,320,2,5,,7,"(7.128456,-73.183637)"
2012,Marzo,Guyana,328,0,1,,1,"(10.886611,-74.776708)"
2012,Marzo,Guyana,328,2,5,,7,"(4.697144,-74.140516)"
2012,Marzo,Guinea,324,1,0,,1,"(3.541112,-76.384584)"
2012,Marzo,Guinea,324,0,3,,3,"(4.697144,-74.140516)"
2012,Marzo,Guinea Ecuatorial,226,0,9,,9,"(4.697144,-74.140516)"
2012,Marzo,Guadalupe/Territorio Francés,312,1,1,,2,"(4.697144,-74.140516)"
2012,Marzo,Guayana Francesa/Departamento de Ultramar Francés,254,0,1,,1,"(10.408582,-75.538003)"
2012,Marzo,Haití,332,1,7,,8,"(10.886611,-74.776708)"
2012,Marzo,Haití,332,2,2,,4,"(3.541112,-76.384584)"
2012,Marzo,Haití,332,5,20,,25,"(4.697144,-74.140516)"
2012,Marzo,Haití,332,1,5,,6,"(6.171601,-75.427454)"
2012,Marzo,Honduras,340,0,6,,6,"(10.408582,-75.538003)"
2012,Marzo,Honduras,340,1,5,,6,"(10.445761,-75.516429)"
2012,Marzo,Honduras,340,4,5,,9,"(10.886611,-74.776708)"
2012,Marzo,Honduras,340,1,4,,5,"(12.5744111,-81.703935)"
2012,Marzo,Honduras,340,18,49,,67,"(3.541112,-76.384584)"
2012,Marzo,Honduras,340,73,150,,223,"(4.697144,-74.140516)"
2012,Marzo,Honduras,340,1,0,,1,"(4.815061,-75.736532)"
2012,Marzo,Honduras,340,31,52,,83,"(6.171601,-75.427454)"
2012,Marzo,Honduras,340,3,11,,14,"(7.128456,-73.183637)"
2012,Marzo,Honduras,340,2,1,,3,"(7.927209,-72.507910)"
2012,Marzo,Hong Kong,344,1,2,,3,"(10.445761,-75.516429)"
2012,Marzo,Hong Kong,344,0,1,,1,"(3.541112,-76.384584)"
2012,Marzo,Hong Kong,344,45,69,,114,"(4.697144,-74.140516)"
2012,Marzo,Hong Kong,344,1,3,,4,"(6.171601,-75.427454)"
2012,Marzo,Hungría,348,7,7,,14,"(4.697144,-74.140516)"
2012,Marzo,India,356,1,0,,1,"(10.886611,-74.776708)"
2012,Marzo,India,356,2,0,,2,"(3.541112,-76.384584)"
2012,Marzo,India,356,32,29,,61,"(4.697144,-74.140516)"
2012,Marzo,India,356,1,2,,3,"(6.171601,-75.427454)"
2012,Marzo,Indonesia,360,4,6,,10,"(4.697144,-74.140516)"
2012,Marzo,Indonesia,360,1,1,,2,"(6.171601,-75.427454)"
2012,Marzo,Iraq,368,0,1,,1,"(3.541112,-76.384584)"
2012,Marzo,Iraq,368,0,8,,8,"(4.697144,-74.140516)"
2012,Marzo,Irán,364,0,4,,4,"(4.697144,-74.140516)"
2012,Marzo,República de Irlanda,372,13,7,,20,"(4.697144,-74.140516)"
2012,Marzo,Islandia,352,3,1,,4,"(4.697144,-74.140516)"
2012,Marzo,Isla de Man,833,0,1,,1,"(4.697144,-74.140516)"
2012,Marzo,Israel,376,4,2,,6,"(3.541112,-76.384584)"
2012,Marzo,Israel,376,129,98,,227,"(4.697144,-74.140516)"
2012,Marzo,Israel,376,1,0,,1,"(6.171601,-75.427454)"
2012,Marzo,Islas Aland/Provincia de Finlandia,248,1,0,,1,"(10.445761,-75.516429)"
2012,Marzo,Italia,380,152,61,,213,"(3.541112,-76.384584)"
2012,Marzo,Italia,380,611,411,,1022,"(4.697144,-74.140516)"
2012,Marzo,Italia,380,42,26,,68,"(6.171601,-75.427454)"
2012,Marzo,Jamaica,388,6,13,,19,"(10.445761,-75.516429)"
2012,Marzo,Jamaica,388,1,5,,6,"(10.886611,-74.776708)"
2012,Marzo,Jamaica,388,12,7,,19,"(3.541112,-76.384584)"
2012,Marzo,Jamaica,388,39,47,,86,"(4.697144,-74.140516)"
2012,Marzo,Jamaica,388,2,2,,4,"(4.815061,-75.736532)"
2012,Marzo,Jamaica,388,49,45,,94,"(6.171601,-75.427454)"
2012,Marzo,Jamaica,388,1,0,,1,"(7.927209,-72.507910)"
2012,Marzo,Japón,392,17,11,,28,"(3.541112,-76.384584)"
2012,Marzo,Japón,392,66,48,,114,"(4.697144,-74.140516)"
2012,Marzo,Japón,392,5,0,,5,"(6.171601,-75.427454)"
2012,Marzo,Jordania,400,1,0,,1,"(3.541112,-76.384584)"
2012,Marzo,Jordania,400,3,2,,5,"(4.697144,-74.140516)"
2012,Marzo,Kazajistán,398,0,1,,1,"(4.697144,-74.140516)"
2012,Marzo,Kenia,404,0,1,,1,"(3.541112,-76.384584)"
2012,Marzo,Kenia,404,0,3,,3,"(4.697144,-74.140516)"
2012,Marzo,Kenia,404,1,0,,1,"(6.171601,-75.427454)"
2012,Marzo,Kuwait,414,1,4,,5,"(4.697144,-74.140516)"
2012,Marzo,Lituania,440,1,1,,2,"(4.697144,-74.140516)"
2012,Marzo,Líbano,422,9,14,,23,"(4.697144,-74.140516)"
2012,Marzo,Luxemburgo,442,2,0,,2,"(4.697144,-74.140516)"
2012,Marzo,Malasia,458,1,13,,14,"(4.697144,-74.140516)"
2012,Marzo,Malasia,458,0,1,,1,"(6.171601,-75.427454)"
2012,Marzo,Malta,470,2,5,,7,"(4.697144,-74.140516)"
2012,Marzo,Malta,470,1,0,,1,"(6.171601,-75.427454)"
2012,Marzo,Marruecos,504,1,1,,2,"(3.541112,-76.384584)"
2012,Marzo,Marruecos,504,6,5,,11,"(4.697144,-74.140516)"
2012,Marzo,Mauritania,478,0,1,,1,"(4.697144,-74.140516)"
2012,Marzo,México,484,13,10,,23,"(10.445761,-75.516429)"
2012,Marzo,México,484,20,24,,44,"(10.886611,-74.776708)"
2012,Marzo,México,484,128,113,,241,"(3.541112,-76.384584)"
2012,Marzo,México,484,4184,4485,,8669,"(4.697144,-74.140516)"
2012,Marzo,México,484,13,5,,18,"(4.815061,-75.736532)"
2012,Marzo,México,484,315,259,,574,"(6.171601,-75.427454)"
2012,Marzo,México,484,13,5,,18,"(7.128456,-73.183637)"
2012,Marzo,México,484,0,1,,1,"(7.927209,-72.507910)"
2012,Marzo,República de Moldavia,498,1,1,,2,"(4.697144,-74.140516)"
2012,Marzo,Mónaco,492,1,4,,5,"(4.697144,-74.140516)"
2012,Marzo,Mozambique,508,1,1,,2,"(4.697144,-74.140516)"
2012,Marzo,Nauru,520,2,0,,2,"(4.697144,-74.140516)"
2012,Marzo,Nepal,524,0,2,,2,"(4.697144,-74.140516)"
2012,Marzo,Nicaragua,558,2,8,,10,"(10.886611,-74.776708)"
2012,Marzo,Nicaragua,558,3,4,,7,"(12.5744111,-81.703935)"
2012,Marzo,Nicaragua,558,10,11,,21,"(3.541112,-76.384584)"
2012,Marzo,Nicaragua,558,20,46,,66,"(4.697144,-74.140516)"
2012,Marzo,Nicaragua,558,0,1,,1,"(4.815061,-75.736532)"
2012,Marzo,Nicaragua,558,7,16,,23,"(6.171601,-75.427454)"
2012,Marzo,Nigeria,566,1,10,,11,"(4.697144,-74.140516)"
2012,Marzo,Noruega,578,2,0,,2,"(10.445761,-75.516429)"
2012,Marzo,Noruega,578,2,1,,3,"(3.541112,-76.384584)"
2012,Marzo,Noruega,578,24,16,,40,"(4.697144,-74.140516)"
2012,Marzo,Noruega,578,2,0,,2,"(6.171601,-75.427454)"
2012,Marzo,Nueva Caledonia/Territorio francés,540,0,1,,1,"(4.697144,-74.140516)"
2012,Marzo,Nueva Zelanda,554,16,17,,33,"(4.697144,-74.140516)"
2012,Marzo,Nueva Zelanda,554,3,0,,3,"(6.171601,-75.427454)"
2012,Marzo,Omán,512,1,0,,1,"(4.697144,-74.140516)"
2012,Marzo,Papúa Nueva Guinea,598,0,1,,1,"(3.541112,-76.384584)"
2012,Marzo,Papúa Nueva Guinea,598,0,5,,5,"(4.697144,-74.140516)"
2012,Marzo,Pakistán,586,0,1,,1,"(4.697144,-74.140516)"
2012,Marzo,Panamá,591,226,168,,394,"(10.408582,-75.538003)"
2012,Marzo,Panamá,591,312,300,,612,"(10.445761,-75.516429)"
2012,Marzo,Panamá,591,1002,1051,,2053,"(10.886611,-74.776708)"
2012,Marzo,Panamá,591,1,1,,2,"(11.247723,-74.213989)"
2012,Marzo,Panamá,591,66,81,,147,"(12.586067,-81.702563)"
2012,Marzo,Panamá,591,1941,1921,,3862,"(3.541112,-76.384584)"
2012,Marzo,Panamá,591,7244,8065,,15309,"(4.697144,-74.140516)"
2012,Marzo,Panamá,591,680,488,,1168,"(4.815061,-75.736532)"
2012,Marzo,Panamá,591,2059,2086,,4145,"(6.171601,-75.427454)"
2012,Marzo,Panamá,591,11,33,,44,"(6.228046,-77.404104)"
2012,Marzo,Panamá,591,281,258,,539,"(7.128456,-73.183637)"
2012,Marzo,Panamá,591,185,220,,405,"(7.927209,-72.507910)"
2012,Marzo,Panamá,591,55,144,,199,"(8.635765,-77.346578)"
2012,Marzo,Paraguay,600,1,0,,1,"(10.445761,-75.516429)"
2012,Marzo,Paraguay,600,2,2,,4,"(10.886611,-74.776708)"
2012,Marzo,Paraguay,600,2,11,,13,"(3.541112,-76.384584)"
2012,Marzo,Paraguay,600,31,51,,82,"(4.697144,-74.140516)"
2012,Marzo,Paraguay,600,4,7,,11,"(6.171601,-75.427454)"
2012,Marzo,Perú,604,59,124,,183,"(-4.197703,-69.941278)"
2012,Marzo,Perú,604,16,13,,29,"(0.814836,-77.662532)"
2012,Marzo,Perú,604,4,5,,9,"(10.445761,-75.516429)"
2012,Marzo,Perú,604,9,16,,25,"(10.886611,-74.776708)"
2012,Marzo,Perú,604,154,208,,362,"(3.541112,-76.384584)"
2012,Marzo,Perú,604,3472,4629,,8101,"(4.697144,-74.140516)"
2012,Marzo,Perú,604,4,5,,9,"(4.815061,-75.736532)"
2012,Marzo,Perú,604,265,340,,605,"(6.171601,-75.427454)"
2012,Marzo,Perú,604,2,2,,4,"(7.128456,-73.183637)"
2012,Marzo,Perú,604,2,2,,4,"(7.927209,-72.507910)"
2012,Marzo,Polonia,616,0,1,,1,"(3.541112,-76.384584)"
2012,Marzo,Polonia,616,4,8,,12,"(4.697144,-74.140516)"
2012,Marzo,Polonia,616,0,1,,1,"(6.171601,-75.427454)"
2012,Marzo,Portugal,620,7,6,,13,"(3.541112,-76.384584)"
2012,Marzo,Portugal,620,18,13,,31,"(4.697144,-74.140516)"
2012,Marzo,Portugal,620,2,4,,6,"(6.171601,-75.427454)"
2012,Marzo,Puerto Rico/Territorio de Estados Unidos,630,0,1,,1,"(10.445761,-75.516429)"
2012,Marzo,Puerto Rico/Territorio de Estados Unidos,630,14,11,,25,"(10.886611,-74.776708)"
2012,Marzo,Puerto Rico/Territorio de Estados Unidos,630,0,1,,1,"(12.586067,-81.702563)"
2012,Marzo,Puerto Rico/Territorio de Estados Unidos,630,55,58,,113,"(3.541112,-76.384584)"
2012,Marzo,Puerto Rico/Territorio de Estados Unidos,630,87,111,,198,"(4.697144,-74.140516)"
2012,Marzo,Puerto Rico/Territorio de Estados Unidos,630,5,1,,6,"(4.815061,-75.736532)"
2012,Marzo,Puerto Rico/Territorio de Estados Unidos,630,43,37,,80,"(6.171601,-75.427454)"
2012,Marzo,Puerto Rico/Territorio de Estados Unidos,630,10,6,,16,"(7.128456,-73.183637)"
2012,Marzo,Qatar,634,4,0,,4,"(4.697144,-74.140516)"
2012,Marzo,Reino Unido de Gran Bretaña e Irlanda del Norte,826,2,0,,2,"(10.445761,-75.516429)"
2012,Marzo,Reino Unido de Gran Bretaña e Irlanda del Norte,826,59,47,,106,"(3.541112,-76.384584)"
2012,Marzo,Reino Unido de Gran Bretaña e Irlanda del Norte,826,552,452,,1004,"(4.697144,-74.140516)"
2012,Marzo,Reino Unido de Gran Bretaña e Irlanda del Norte,826,48,27,,75,"(6.171601,-75.427454)"
2012,Marzo,Federación de Rusia,643,3,3,,6,"(3.541112,-76.384584)"
2012,Marzo,Federación de Rusia,643,23,32,,55,"(4.697144,-74.140516)"
2012,Marzo,Federación de Rusia,643,0,1,,1,"(6.171601,-75.427454)"
2012,Marzo,República Dominicana,214,4,15,,19,"(10.445761,-75.516429)"
2012,Marzo,República Dominicana,214,29,18,,47,"(10.886611,-74.776708)"
2012,Marzo,República Dominicana,214,0,1,,1,"(12.586067,-81.702563)"
2012,Marzo,República Dominicana,214,72,66,,138,"(3.541112,-76.384584)"
2012,Marzo,República Dominicana,214,1062,1104,,2166,"(4.697144,-74.140516)"
2012,Marzo,República Dominicana,214,11,8,,19,"(4.815061,-75.736532)"
2012,Marzo,República Dominicana,214,183,190,,373,"(6.171601,-75.427454)"
2012,Marzo,República Dominicana,214,9,5,,14,"(7.128456,-73.183637)"
2012,Marzo,República Dominicana,214,4,4,,8,"(7.927209,-72.507910)"
2012,Marzo,Reunión,638,0,1,,1,"(4.697144,-74.140516)"
2012,Marzo,Rumania,642,1,2,,3,"(4.697144,-74.140516)"
2012,Marzo,Sahara Occidental/Desierto Sahara,732,0,1,,1,"(4.697144,-74.140516)"
2012,Marzo,San Cristóbal y Nevis,659,0,1,,1,"(3.541112,-76.384584)"
2012,Marzo,San Marino,674,1,0,,1,"(3.541112,-76.384584)"
2012,Marzo,Serbia,688,2,2,,4,"(4.697144,-74.140516)"
2012,Marzo,Sierra Leona,694,0,1,,1,"(4.697144,-74.140516)"
2012,Marzo,Singapur,702,30,29,,59,"(4.697144,-74.140516)"
2012,Marzo,Sri Lanka,144,1,1,,2,"(4.697144,-74.140516)"
2012,Marzo,Sudáfrica,710,9,16,,25,"(4.697144,-74.140516)"
2012,Marzo,Sudáfrica,710,1,0,,1,"(6.171601,-75.427454)"
2012,Marzo,Suecia,752,7,3,,10,"(3.541112,-76.384584)"
2012,Marzo,Suecia,752,48,47,,95,"(4.697144,-74.140516)"
2012,Marzo,Suiza,756,1,1,,2,"(10.445761,-75.516429)"
2012,Marzo,Suiza,756,25,22,,47,"(3.541112,-76.384584)"
2012,Marzo,Suiza,756,177,150,,327,"(4.697144,-74.140516)"
2012,Marzo,Suiza,756,11,11,,22,"(6.171601,-75.427454)"
2012,Marzo,Surinam,740,4,7,,11,"(4.697144,-74.140516)"
2012,Marzo,Surinam,740,2,0,,2,"(6.171601,-75.427454)"
2012,Marzo,Taiwán,158,6,4,,10,"(4.697144,-74.140516)"
2012,Marzo,Taiwán,158,0,4,,4,"(6.171601,-75.427454)"
2012,Marzo,República de Tayikistán,762,1,0,,1,"(4.697144,-74.140516)"
2012,Marzo,Tailandia,764,0,1,,1,"(10.886611,-74.776708)"
2012,Marzo,Tailandia,764,7,8,,15,"(4.697144,-74.140516)"
2012,Marzo,Tailandia,764,0,1,,1,"(6.171601,-75.427454)"
2012,Marzo,Tanzania,834,0,1,,1,"(4.697144,-74.140516)"
2012,Marzo,Trinidad y Tobago,780,4,15,,19,"(10.445761,-75.516429)"
2012,Marzo,Trinidad y Tobago,780,3,1,,4,"(10.886611,-74.776708)"
2012,Marzo,Trinidad y Tobago,780,5,11,,16,"(3.541112,-76.384584)"
2012,Marzo,Trinidad y Tobago,780,33,33,,66,"(4.697144,-74.140516)"
2012,Marzo,Trinidad y Tobago,780,3,0,,3,"(4.815061,-75.736532)"
2012,Marzo,Trinidad y Tobago,780,10,11,,21,"(6.171601,-75.427454)"
2012,Marzo,Trinidad y Tobago,780,8,5,,13,"(7.128456,-73.183637)"
2012,Marzo,Trinidad y Tobago,780,1,0,,1,"(7.927209,-72.507910)"
2012,Marzo,Turquía,792,1,1,,2,"(3.541112,-76.384584)"
2012,Marzo,Turquía,792,26,29,,55,"(4.697144,-74.140516)"
2012,Marzo,Ucrania,804,2,2,,4,"(4.697144,-74.140516)"
2012,Marzo,Uganda,800,0,1,,1,"(4.697144,-74.140516)"
2012,Marzo,Uruguay,858,0,2,,2,"(0.814836,-77.662532)"
2012,Marzo,Uruguay,858,1,1,,2,"(10.886611,-74.776708)"
2012,Marzo,Uruguay,858,18,12,,30,"(3.541112,-76.384584)"
2012,Marzo,Uruguay,858,70,82,,152,"(4.697144,-74.140516)"
2012,Marzo,Uruguay,858,18,23,,41,"(6.171601,-75.427454)"
2012,Marzo,Uruguay,858,1,0,,1,"(7.128456,-73.183637)"
2012,Marzo,Venezuela,862,2,2,,4,"(10.445761,-75.516429)"
2012,Marzo,Venezuela,862,13,21,,34,"(10.886611,-74.776708)"
2012,Marzo,Venezuela,862,0,3,,3,"(10.971302,-74.765397)"
2012,Marzo,Venezuela,862,5839,5857,,11696,"(11.360009,-72.129330)"
2012,Marzo,Venezuela,862,1,0,,1,"(11.528919,-72.919681)"
2012,Marzo,Venezuela,862,12,14,,26,"(3.541112,-76.384584)"
2012,Marzo,Venezuela,862,2290,2977,,5267,"(4.697144,-74.140516)"
2012,Marzo,Venezuela,862,0,3,,3,"(4.815061,-75.736532)"
2012,Marzo,Venezuela,862,241,312,,553,"(6.171601,-75.427454)"
2012,Marzo,Venezuela,862,111,135,,246,"(6.185799,-67.483929)"
2012,Marzo,Venezuela,862,977,933,,1910,"(7.088729,-70.740253)"
2012,Marzo,Venezuela,862,0,1,,1,"(7.128456,-73.183637)"
2012,Marzo,Venezuela,862,5763,6338,,12101,"(7.818934,-72.453226)"
2012,Marzo,Venezuela,862,1,0,,1,"(7.927209,-72.507910)"
2012,Marzo,Vietnam,704,0,2,,2,"(4.697144,-74.140516)"
2012,Marzo,Vietnam,704,1,1,,2,"(6.171601,-75.427454)"
2012,Marzo,Islas Vírgenes Británicas/Territorio Británico de Ultramar,92,1,0,,1,"(10.886611,-74.776708)"
2012,Marzo,Zambia,894,1,1,,2,"(4.697144,-74.140516)"
2012,Marzo,Zimbabue,716,1,0,,1,"(4.697144,-74.140516)"
2012,Marzo,Desconocido,99999,2,1,,3,"(3.541112,-76.384584)"
2012,Marzo,Desconocido,99999,6,12,,18,"(4.697144,-74.140516)"
2012,Abril,Afganistán,4,2,29,,31,"(4.697144,-74.140516)"
2012,Abril,Alemania,276,0,1,,1,"(0.814836,-77.662532)"
2012,Abril,Alemania,276,1,0,,1,"(10.445761,-75.516429)"
2012,Abril,Alemania,276,25,9,,34,"(3.541112,-76.384584)"
2012,Abril,Alemania,276,870,800,,1670,"(4.697144,-74.140516)"
2012,Abril,Alemania,276,11,10,,21,"(6.171601,-75.427454)"
2012,Abril,Andorra,20,3,2,,5,"(4.697144,-74.140516)"
2012,Abril,Angola,24,0,14,,14,"(4.697144,-74.140516)"
2012,Abril,Países Bajos,528,153,114,,267,"(10.408582,-75.538003)"
2012,Abril,Países Bajos,528,2,3,,5,"(10.445761,-75.516429)"
2012,Abril,Países Bajos,528,1,1,,2,"(10.886611,-74.776708)"
2012,Abril,Países Bajos,528,34,16,,50,"(3.541112,-76.384584)"
2012,Abril,Países Bajos,528,120,105,,225,"(4.697144,-74.140516)"
2012,Abril,Países Bajos,528,52,29,,81,"(6.171601,-75.427454)"
2012,Abril,Arabia Saudita,682,7,19,,26,"(4.697144,-74.140516)"
2012,Abril,Argelia,12,3,0,,3,"(3.541112,-76.384584)"
2012,Abril,Argelia,12,1,5,,6,"(4.697144,-74.140516)"
2012,Abril,Argentina,32,3,9,,12,"(0.814836,-77.662532)"
2012,Abril,Argentina,32,3,3,,6,"(10.445761,-75.516429)"
2012,Abril,Argentina,32,25,15,,40,"(10.886611,-74.776708)"
2012,Abril,Argentina,32,0,3,,3,"(12.586067,-81.702563)"
2012,Abril,Argentina,32,151,176,,327,"(3.541112,-76.384584)"
2012,Abril,Argentina,32,2269,2365,,4634,"(4.697144,-74.140516)"
2012,Abril,Argentina,32,8,10,,18,"(4.815061,-75.736532)"
2012,Abril,Argentina,32,175,174,,349,"(6.171601,-75.427454)"
2012,Abril,Argentina,32,7,6,,13,"(7.128456,-73.183637)"
2012,Abril,Argentina,32,1,1,,2,"(7.927209,-72.507910)"
2012,Abril,Aruba,533,166,109,,275,"(10.408582,-75.538003)"
2012,Abril,Aruba,533,14,11,,25,"(10.886611,-74.776708)"
2012,Abril,Aruba,533,0,1,,1,"(11.247723,-74.213989)"
2012,Abril,Aruba,533,85,44,,129,"(11.528919,-72.919681)"
2012,Abril,Aruba,533,2,2,,4,"(12.586067,-81.702563)"
2012,Abril,Aruba,533,21,15,,36,"(3.541112,-76.384584)"
2012,Abril,Aruba,533,805,753,,1558,"(4.697144,-74.140516)"
2012,Abril,Aruba,533,34,27,,61,"(6.171601,-75.427454)"
2012,Abril,Aruba,533,0,4,,4,"(7.128456,-73.183637)"
2012,Abril,Aruba,533,4,1,,5,"(7.927209,-72.507910)"
2012,Abril,Australia,36,4,2,,6,"(10.886611,-74.776708)"
2012,Abril,Australia,36,7,10,,17,"(3.541112,-76.384584)"
2012,Abril,Australia,36,155,126,,281,"(4.697144,-74.140516)"
2012,Abril,Australia,36,17,13,,30,"(6.171601,-75.427454)"
2012,Abril,Australia,36,2,2,,4,"(7.128456,-73.183637)"
2012,Abril,Austria,40,1,0,,1,"(3.541112,-76.384584)"
2012,Abril,Austria,40,35,34,,69,"(4.697144,-74.140516)"
2012,Abril,Austria,40,1,0,,1,"(6.171601,-75.427454)"
2012,Abril,Bahamas,44,2,0,,2,"(10.445761,-75.516429)"
2012,Abril,Bahamas,44,9,7,,16,"(10.886611,-74.776708)"
2012,Abril,Bahamas,44,25,20,,45,"(3.541112,-76.384584)"
2012,Abril,Bahamas,44,35,25,,60,"(4.697144,-74.140516)"
2012,Abril,Bahamas,44,2,1,,3,"(4.815061,-75.736532)"
2012,Abril,Bahamas,44,40,30,,70,"(6.171601,-75.427454)"
2012,Abril,Bahamas,44,1,0,,1,"(7.128456,-73.183637)"
2012,Abril,Bahamas,44,0,1,,1,"(7.927209,-72.507910)"
2012,Abril,Bahréin,48,1,3,,4,"(4.697144,-74.140516)"
2012,Abril,Bahréin,48,0,1,,1,"(6.171601,-75.427454)"
2012,Abril,Barbados,52,1,3,,4,"(12.586067,-81.702563)"
2012,Abril,Barbados,52,0,12,,12,"(4.697144,-74.140516)"
2012,Abril,Barbados,52,1,2,,3,"(6.171601,-75.427454)"
2012,Abril,República de Belarús,112,1,3,,4,"(11.360009,-72.129330)"
2012,Abril,República de Belarús,112,1,0,,1,"(3.541112,-76.384584)"
2012,Abril,República de Belarús,112,0,3,,3,"(4.697144,-74.140516)"
2012,Abril,República de Belarús,112,0,1,,1,"(6.171601,-75.427454)"
2012,Abril,República de Belarús,112,3,1,,4,"(7.088729,-70.740253)"
2012,Abril,República de Belarús,112,0,1,,1,"(7.818934,-72.453226)"
2012,Abril,Bélgica,56,5,0,,5,"(3.541112,-76.384584)"
2012,Abril,Bélgica,56,64,42,,106,"(4.697144,-74.140516)"
2012,Abril,Bélgica,56,6,6,,12,"(6.171601,-75.427454)"
2012,Abril,Belice,84,2,3,,5,"(4.697144,-74.140516)"
2012,Abril,Bermudas/Territorio Británico de Ultramar,60,1,0,,1,"(4.697144,-74.140516)"
2012,Abril,Bermudas/Territorio Británico de Ultramar,60,1,0,,1,"(6.171601,-75.427454)"
2012,Abril,Bolivia,68,0,2,,2,"(0.814836,-77.662532)"
2012,Abril,Bolivia,68,0,1,,1,"(10.445761,-75.516429)"
2012,Abril,Bolivia,68,2,7,,9,"(10.886611,-74.776708)"
2012,Abril,Bolivia,68,1,0,,1,"(11.360009,-72.129330)"
2012,Abril,Bolivia,68,14,31,,45,"(3.541112,-76.384584)"
2012,Abril,Bolivia,68,160,324,,484,"(4.697144,-74.140516)"
2012,Abril,Bolivia,68,0,1,,1,"(4.815061,-75.736532)"
2012,Abril,Bolivia,68,15,21,,36,"(6.171601,-75.427454)"
2012,Abril,Bolivia,68,0,2,,2,"(7.128456,-73.183637)"
2012,Abril,Brasil,76,105,117,,222,"(-4.197703,-69.941278)"
2012,Abril,Brasil,76,4,8,,12,"(10.445761,-75.516429)"
2012,Abril,Brasil,76,2,5,,7,"(10.886611,-74.776708)"
2012,Abril,Brasil,76,21,33,,54,"(3.541112,-76.384584)"
2012,Abril,Brasil,76,1828,2766,,4594,"(4.697144,-74.140516)"
2012,Abril,Brasil,76,2,1,,3,"(4.815061,-75.736532)"
2012,Abril,Brasil,76,32,54,,86,"(6.171601,-75.427454)"
2012,Abril,Brasil,76,2,4,,6,"(7.128456,-73.183637)"
2012,Abril,Brunei Darussalam,96,0,1,,1,"(4.697144,-74.140516)"
2012,Abril,Bulgaria,100,2,1,,3,"(4.697144,-74.140516)"
2012,Abril,Cabo Verde,132,0,1,,1,"(6.171601,-75.427454)"
2012,Abril,Islas Caimán/Territorio Británico de Ultramar,136,1,0,,1,"(10.445761,-75.516429)"
2012,Abril,Islas Caimán/Territorio Británico de Ultramar,136,5,5,,10,"(12.586067,-81.702563)"
2012,Abril,Islas Caimán/Territorio Británico de Ultramar,136,1,0,,1,"(4.697144,-74.140516)"
2012,Abril,Islas Caimán/Territorio Británico de Ultramar,136,1,0,,1,"(6.171601,-75.427454)"
2012,Abril,Camboya,116,0,2,,2,"(4.697144,-74.140516)"
2012,Abril,Camerún,120,0,1,,1,"(4.697144,-74.140516)"
2012,Abril,Canadá,124,59,42,,101,"(10.445761,-75.516429)"
2012,Abril,Canadá,124,17,8,,25,"(10.886611,-74.776708)"
2012,Abril,Canadá,124,6,4,,10,"(12.586067,-81.702563)"
2012,Abril,Canadá,124,61,43,,104,"(3.541112,-76.384584)"
2012,Abril,Canadá,124,4,3,,7,"(4.452882,-75.766298)"
2012,Abril,Canadá,124,1003,976,,1979,"(4.697144,-74.140516)"
2012,Abril,Canadá,124,4,2,,6,"(4.815061,-75.736532)"
2012,Abril,Canadá,124,96,122,,218,"(6.171601,-75.427454)"
2012,Abril,Canadá,124,1,1,,2,"(7.128456,-73.183637)"
2012,Abril,Chad,148,0,1,,1,"(4.697144,-74.140516)"
2012,Abril,España,724,1,0,,1,"(10.445761,-75.516429)"
2012,Abril,España,724,0,2,,2,"(10.886611,-74.776708)"
2012,Abril,España,724,1,0,,1,"(12.586067,-81.702563)"
2012,Abril,España,724,1365,922,,2287,"(3.541112,-76.384584)"
2012,Abril,España,724,5972,5083,,11055,"(4.697144,-74.140516)"
2012,Abril,España,724,455,327,,782,"(6.171601,-75.427454)"
2012,Abril,República Democrática del Congo,180,0,1,,1,"(4.697144,-74.140516)"
2012,Abril,República de Corea,410,0,1,,1,"(10.445761,-75.516429)"
2012,Abril,República de Corea,410,9,26,,35,"(4.697144,-74.140516)"
2012,Abril,República de Corea,410,3,2,,5,"(6.171601,-75.427454)"
2012,Abril,Costa Rica,188,4,4,,8,"(10.445761,-75.516429)"
2012,Abril,Costa Rica,188,25,16,,41,"(10.886611,-74.776708)"
2012,Abril,Costa Rica,188,1,18,,19,"(12.5744111,-81.703935)"
2012,Abril,Costa Rica,188,3,1,,4,"(12.586067,-81.702563)"
2012,Abril,Costa Rica,188,38,37,,75,"(3.541112,-76.384584)"
2012,Abril,Costa Rica,188,621,738,,1359,"(4.697144,-74.140516)"
2012,Abril,Costa Rica,188,7,4,,11,"(4.815061,-75.736532)"
2012,Abril,Costa Rica,188,143,155,,298,"(6.171601,-75.427454)"
2012,Abril,Costa Rica,188,6,7,,13,"(7.128456,-73.183637)"
2012,Abril,Cuba,192,3,2,,5,"(10.445761,-75.516429)"
2012,Abril,Cuba,192,16,10,,26,"(10.886611,-74.776708)"
2012,Abril,Cuba,192,66,56,,122,"(3.541112,-76.384584)"
2012,Abril,Cuba,192,764,678,,1442,"(4.697144,-74.140516)"
2012,Abril,Cuba,192,6,1,,7,"(4.815061,-75.736532)"
2012,Abril,Cuba,192,152,121,,273,"(6.171601,-75.427454)"
2012,Abril,Cuba,192,10,11,,21,"(7.128456,-73.183637)"
2012,Abril,Cuba,192,2,1,,3,"(7.927209,-72.507910)"
2012,Abril,Curazao,99999,0,2,,2,"(10.886611,-74.776708)"
2012,Abril,Curazao,99999,1,1,,2,"(3.541112,-76.384584)"
2012,Abril,Curazao,99999,438,438,,876,"(4.697144,-74.140516)"
2012,Abril,Curazao,99999,1,0,,1,"(4.815061,-75.736532)"
2012,Abril,Curazao,99999,76,36,,112,"(6.171601,-75.427454)"
2012,Abril,República Checa,203,3,5,,8,"(4.697144,-74.140516)"
2012,Abril,Chile,152,4,8,,12,"(0.814836,-77.662532)"
2012,Abril,Chile,152,5,5,,10,"(10.445761,-75.516429)"
2012,Abril,Chile,152,14,18,,32,"(10.886611,-74.776708)"
2012,Abril,Chile,152,415,318,,733,"(3.541112,-76.384584)"
2012,Abril,Chile,152,1938,2205,,4143,"(4.697144,-74.140516)"
2012,Abril,Chile,152,37,50,,87,"(4.815061,-75.736532)"
2012,Abril,Chile,152,120,142,,262,"(6.171601,-75.427454)"
2012,Abril,Chile,152,4,4,,8,"(7.128456,-73.183637)"
2012,Abril,China,156,1,12,,13,"(10.886611,-74.776708)"
2012,Abril,China,156,0,1,,1,"(11.360009,-72.129330)"
2012,Abril,China,156,9,32,,41,"(3.541112,-76.384584)"
2012,Abril,China,156,285,794,,1079,"(4.697144,-74.140516)"
2012,Abril,China,156,0,1,,1,"(4.815061,-75.736532)"
2012,Abril,China,156,29,75,,104,"(6.171601,-75.427454)"
2012,Abril,China,156,2,6,,8,"(7.128456,-73.183637)"
2012,Abril,Chipre,196,1,0,,1,"(4.697144,-74.140516)"
2012,Abril,Dinamarca,208,4,0,,4,"(3.541112,-76.384584)"
2012,Abril,Dinamarca,208,22,19,,41,"(4.697144,-74.140516)"
2012,Abril,Dinamarca,208,2,0,,2,"(6.171601,-75.427454)"
2012,Abril,Dominica,212,7,3,,10,"(0.814836,-77.662532)"
2012,Abril,Dominica,212,0,1,,1,"(3.541112,-76.384584)"
2012,Abril,Dominica,212,2,2,,4,"(4.697144,-74.140516)"
2012,Abril,Ecuador,218,406,533,,939,"(0.25129,-76.875963)"
2012,Abril,Ecuador,218,8143,8679,,16822,"(0.814836,-77.662532)"
2012,Abril,Ecuador,218,99,109,,208,"(1.813928,-78.763924)"
2012,Abril,Ecuador,218,0,1,,1,"(10.408582,-75.538003)"
2012,Abril,Ecuador,218,0,4,,4,"(10.445761,-75.516429)"
2012,Abril,Ecuador,218,2,2,,4,"(10.886611,-74.776708)"
2012,Abril,Ecuador,218,635,643,,1278,"(3.541112,-76.384584)"
2012,Abril,Ecuador,218,2084,3604,,5688,"(4.697144,-74.140516)"
2012,Abril,Ecuador,218,2,0,,2,"(4.815061,-75.736532)"
2012,Abril,Ecuador,218,415,492,,907,"(6.171601,-75.427454)"
2012,Abril,Ecuador,218,2,3,,5,"(7.128456,-73.183637)"
2012,Abril,Egipto,818,5,6,,11,"(0.814836,-77.662532)"
2012,Abril,Egipto,818,2,1,,3,"(3.541112,-76.384584)"
2012,Abril,Egipto,818,75,37,,112,"(4.697144,-74.140516)"
2012,Abril,Egipto,818,12,7,,19,"(6.171601,-75.427454)"
2012,Abril,El Salvador,222,4,3,,7,"(10.445761,-75.516429)"
2012,Abril,El Salvador,222,2,1,,3,"(10.886611,-74.776708)"
2012,Abril,El Salvador,222,0,1,,1,"(12.586067,-81.702563)"
2012,Abril,El Salvador,222,22,23,,45,"(3.541112,-76.384584)"
2012,Abril,El Salvador,222,789,935,,1724,"(4.697144,-74.140516)"
2012,Abril,El Salvador,222,0,1,,1,"(4.815061,-75.736532)"
2012,Abril,El Salvador,222,14,25,,39,"(6.171601,-75.427454)"
2012,Abril,El Salvador,222,1,0,,1,"(7.128456,-73.183637)"
2012,Abril,Emiratos Árabes,784,0,1,,1,"(3.541112,-76.384584)"
2012,Abril,Emiratos Árabes,784,37,66,,103,"(4.697144,-74.140516)"
2012,Abril,Emiratos Árabes,784,1,5,,6,"(6.171601,-75.427454)"
2012,Abril,Eritrea,232,0,1,,1,"(4.697144,-74.140516)"
2012,Abril,Eslovaquia,703,0,1,,1,"(3.541112,-76.384584)"
2012,Abril,Eslovaquia,703,1,2,,3,"(4.697144,-74.140516)"
2012,Abril,Eslovenia,705,1,0,,1,"(12.586067,-81.702563)"
2012,Abril,Eslovenia,705,3,3,,6,"(4.697144,-74.140516)"
2012,Abril,Estados Unidos de América,840,1358,1269,,2627,"(10.445761,-75.516429)"
2012,Abril,Estados Unidos de América,840,1598,1295,,2893,"(10.886611,-74.776708)"
2012,Abril,Estados Unidos de América,840,0,1,,1,"(11.360009,-72.129330)"
2012,Abril,Estados Unidos de América,840,0,1,,1,"(12.5744111,-81.703935)"
2012,Abril,Estados Unidos de América,840,26,13,,39,"(12.586067,-81.702563)"
2012,Abril,Estados Unidos de América,840,4050,3014,,7064,"(3.541112,-76.384584)"
2012,Abril,Estados Unidos de América,840,420,361,,781,"(4.452882,-75.766298)"
2012,Abril,Estados Unidos de América,840,23779,22558,,46337,"(4.697144,-74.140516)"
2012,Abril,Estados Unidos de América,840,186,105,,291,"(4.815061,-75.736532)"
2012,Abril,Estados Unidos de América,840,5556,4494,,10050,"(6.171601,-75.427454)"
2012,Abril,Estados Unidos de América,840,62,60,,122,"(7.128456,-73.183637)"
2012,Abril,Estados Unidos de América,840,7,8,,15,"(7.927209,-72.507910)"
2012,Abril,Etiopia,231,0,2,,2,"(4.697144,-74.140516)"
2012,Abril,Filipinas,608,1,0,,1,"(4.697144,-74.140516)"
2012,Abril,Finlandia,246,5,3,,8,"(4.697144,-74.140516)"
2012,Abril,Finlandia,246,1,0,,1,"(4.815061,-75.736532)"
2012,Abril,Francia,250,3,1,,4,"(10.445761,-75.516429)"
2012,Abril,Francia,250,1,1,,2,"(10.886611,-74.776708)"
2012,Abril,Francia,250,41,28,,69,"(3.541112,-76.384584)"
2012,Abril,Francia,250,1043,980,,2023,"(4.697144,-74.140516)"
2012,Abril,Francia,250,22,5,,27,"(6.171601,-75.427454)"
2012,Abril,Gabón,266,0,2,,2,"(4.697144,-74.140516)"
2012,Abril,Ghana,288,0,2,,2,"(4.697144,-74.140516)"
2012,Abril,Granada,308,1,0,,1,"(4.697144,-74.140516)"
2012,Abril,Grecia,300,0,1,,1,"(3.541112,-76.384584)"
2012,Abril,Grecia,300,14,10,,24,"(4.697144,-74.140516)"
2012,Abril,Guatemala,320,4,9,,13,"(10.445761,-75.516429)"
2012,Abril,Guatemala,320,3,2,,5,"(10.886611,-74.776708)"
2012,Abril,Guatemala,320,23,52,,75,"(3.541112,-76.384584)"
2012,Abril,Guatemala,320,159,223,,382,"(4.697144,-74.140516)"
2012,Abril,Guatemala,320,5,8,,13,"(4.815061,-75.736532)"
2012,Abril,Guatemala,320,62,95,,157,"(6.171601,-75.427454)"
2012,Abril,Guatemala,320,3,2,,5,"(7.128456,-73.183637)"
2012,Abril,Guyana,328,0,4,,4,"(10.886611,-74.776708)"
2012,Abril,Guyana,328,0,3,,3,"(4.697144,-74.140516)"
2012,Abril,Guyana,328,0,1,,1,"(6.171601,-75.427454)"
2012,Abril,Guinea,324,1,4,,5,"(4.697144,-74.140516)"
2012,Abril,Guinea Ecuatorial,226,1,9,,10,"(4.697144,-74.140516)"
2012,Abril,Guadalupe/Territorio Francés,312,1,0,,1,"(4.697144,-74.140516)"
2012,Abril,Haití,332,1,2,,3,"(10.445761,-75.516429)"
2012,Abril,Haití,332,0,6,,6,"(10.886611,-74.776708)"
2012,Abril,Haití,332,0,4,,4,"(3.541112,-76.384584)"
2012,Abril,Haití,332,7,14,,21,"(4.697144,-74.140516)"
2012,Abril,Haití,332,6,5,,11,"(6.171601,-75.427454)"
2012,Abril,Honduras,340,2,6,,8,"(10.445761,-75.516429)"
2012,Abril,Honduras,340,1,9,,10,"(10.886611,-74.776708)"
2012,Abril,Honduras,340,1,1,,2,"(12.5744111,-81.703935)"
2012,Abril,Honduras,340,14,35,,49,"(3.541112,-76.384584)"
2012,Abril,Honduras,340,73,151,,224,"(4.697144,-74.140516)"
2012,Abril,Honduras,340,1,5,,6,"(4.815061,-75.736532)"
2012,Abril,Honduras,340,18,54,,72,"(6.171601,-75.427454)"
2012,Abril,Honduras,340,0,2,,2,"(7.128456,-73.183637)"
2012,Abril,Honduras,340,0,1,,1,"(7.927209,-72.507910)"
2012,Abril,Hong Kong,344,0,5,,5,"(3.541112,-76.384584)"
2012,Abril,Hong Kong,344,61,156,,217,"(4.697144,-74.140516)"
2012,Abril,Hong Kong,344,4,8,,12,"(6.171601,-75.427454)"
2012,Abril,Hong Kong,344,1,1,,2,"(7.128456,-73.183637)"
2012,Abril,Hungría,348,4,2,,6,"(4.697144,-74.140516)"
2012,Abril,India,356,0,1,,1,"(10.445761,-75.516429)"
2012,Abril,India,356,3,5,,8,"(3.541112,-76.384584)"
2012,Abril,India,356,18,20,,38,"(4.697144,-74.140516)"
2012,Abril,India,356,0,2,,2,"(6.171601,-75.427454)"
2012,Abril,Indonesia,360,1,0,,1,"(3.541112,-76.384584)"
2012,Abril,Indonesia,360,6,5,,11,"(4.697144,-74.140516)"
2012,Abril,Indonesia,360,0,1,,1,"(6.171601,-75.427454)"
2012,Abril,Iraq,368,1,14,,15,"(4.697144,-74.140516)"
2012,Abril,Iraq,368,0,1,,1,"(6.171601,-75.427454)"
2012,Abril,Irán,364,2,2,,4,"(4.697144,-74.140516)"
2012,Abril,República de Irlanda,372,1,1,,2,"(3.541112,-76.384584)"
2012,Abril,República de Irlanda,372,5,8,,13,"(4.697144,-74.140516)"
2012,Abril,Islandia,352,0,1,,1,"(4.697144,-74.140516)"
2012,Abril,Isla de Man,833,2,0,,2,"(10.445761,-75.516429)"
2012,Abril,Isla de Man,833,1,2,,3,"(4.697144,-74.140516)"
2012,Abril,Israel,376,1,0,,1,"(10.886611,-74.776708)"
2012,Abril,Israel,376,149,93,,242,"(4.697144,-74.140516)"
2012,Abril,Israel,376,3,1,,4,"(6.171601,-75.427454)"
2012,Abril,Italia,380,1,0,,1,"(10.445761,-75.516429)"
2012,Abril,Italia,380,2,0,,2,"(10.886611,-74.776708)"
2012,Abril,Italia,380,125,70,,195,"(3.541112,-76.384584)"
2012,Abril,Italia,380,539,315,,854,"(4.697144,-74.140516)"
2012,Abril,Italia,380,33,17,,50,"(6.171601,-75.427454)"
2012,Abril,Jamaica,388,2,1,,3,"(10.445761,-75.516429)"
2012,Abril,Jamaica,388,1,2,,3,"(10.886611,-74.776708)"
2012,Abril,Jamaica,388,0,1,,1,"(12.586067,-81.702563)"
2012,Abril,Jamaica,388,90,58,,148,"(3.541112,-76.384584)"
2012,Abril,Jamaica,388,125,91,,216,"(4.697144,-74.140516)"
2012,Abril,Jamaica,388,10,12,,22,"(6.171601,-75.427454)"
2012,Abril,Jamaica,388,0,1,,1,"(7.927209,-72.507910)"
2012,Abril,Japón,392,5,4,,9,"(3.541112,-76.384584)"
2012,Abril,Japón,392,55,44,,99,"(4.697144,-74.140516)"
2012,Abril,Japón,392,1,5,,6,"(6.171601,-75.427454)"
2012,Abril,Jordania,400,5,4,,9,"(4.697144,-74.140516)"
2012,Abril,Kazajistán,398,0,1,,1,"(4.697144,-74.140516)"
2012,Abril,Kenia,404,2,6,,8,"(4.697144,-74.140516)"
2012,Abril,Kenia,404,0,1,,1,"(6.171601,-75.427454)"
2012,Abril,Kuwait,414,0,4,,4,"(4.697144,-74.140516)"
2012,Abril,Líbano,422,11,18,,29,"(4.697144,-74.140516)"
2012,Abril,Liechtenstein,438,1,0,,1,"(4.697144,-74.140516)"
2012,Abril,Luxemburgo,442,7,2,,9,"(4.697144,-74.140516)"
2012,Abril,Malasia,458,4,4,,8,"(4.697144,-74.140516)"
2012,Abril,Malta,470,0,4,,4,"(4.697144,-74.140516)"
2012,Abril,Marruecos,504,5,4,,9,"(4.697144,-74.140516)"
2012,Abril,Mauritania,478,1,0,,1,"(4.697144,-74.140516)"
2012,Abril,México,484,0,2,,2,"(10.408582,-75.538003)"
2012,Abril,México,484,6,14,,20,"(10.445761,-75.516429)"
2012,Abril,México,484,19,22,,41,"(10.886611,-74.776708)"
2012,Abril,México,484,2,0,,2,"(12.586067,-81.702563)"
2012,Abril,México,484,102,116,,218,"(3.541112,-76.384584)"
2012,Abril,México,484,3830,4215,,8045,"(4.697144,-74.140516)"
2012,Abril,México,484,19,9,,28,"(4.815061,-75.736532)"
2012,Abril,México,484,321,229,,550,"(6.171601,-75.427454)"
2012,Abril,México,484,16,11,,27,"(7.128456,-73.183637)"
2012,Abril,México,484,4,3,,7,"(7.927209,-72.507910)"
2012,Abril,República de Moldavia,498,1,0,,1,"(4.697144,-74.140516)"
2012,Abril,Mónaco,492,0,1,,1,"(4.697144,-74.140516)"
2012,Abril,Mozambique,508,0,2,,2,"(4.697144,-74.140516)"
2012,Abril,Nicaragua,558,1,0,,1,"(10.445761,-75.516429)"
2012,Abril,Nicaragua,558,1,5,,6,"(10.886611,-74.776708)"
2012,Abril,Nicaragua,558,3,0,,3,"(12.586067,-81.702563)"
2012,Abril,Nicaragua,558,4,10,,14,"(3.541112,-76.384584)"
2012,Abril,Nicaragua,558,24,34,,58,"(4.697144,-74.140516)"
2012,Abril,Nicaragua,558,0,3,,3,"(4.815061,-75.736532)"
2012,Abril,Nicaragua,558,8,12,,20,"(6.171601,-75.427454)"
2012,Abril,Nicaragua,558,0,1,,1,"(7.128456,-73.183637)"
2012,Abril,Nicaragua,558,1,0,,1,"(7.927209,-72.507910)"
2012,Abril,Nigeria,566,2,23,,25,"(4.697144,-74.140516)"
2012,Abril,Noruega,578,1,1,,2,"(3.541112,-76.384584)"
2012,Abril,Noruega,578,27,23,,50,"(4.697144,-74.140516)"
2012,Abril,Noruega,578,2,0,,2,"(6.171601,-75.427454)"
2012,Abril,Nueva Zelanda,554,12,16,,28,"(4.697144,-74.140516)"
2012,Abril,Nueva Zelanda,554,3,5,,8,"(6.171601,-75.427454)"
2012,Abril,Omán,512,3,2,,5,"(4.697144,-74.140516)"
2012,Abril,Papúa Nueva Guinea,598,1,9,,10,"(4.697144,-74.140516)"
2012,Abril,Panamá,591,273,206,,479,"(10.408582,-75.538003)"
2012,Abril,Panamá,591,307,308,,615,"(10.445761,-75.516429)"
2012,Abril,Panamá,591,895,965,,1860,"(10.886611,-74.776708)"
2012,Abril,Panamá,591,0,4,,4,"(10.971302,-74.765397)"
2012,Abril,Panamá,591,1,6,,7,"(11.247723,-74.213989)"
2012,Abril,Panamá,591,0,1,,1,"(11.360009,-72.129330)"
2012,Abril,Panamá,591,3,25,,28,"(12.5744111,-81.703935)"
2012,Abril,Panamá,591,78,109,,187,"(12.586067,-81.702563)"
2012,Abril,Panamá,591,1627,1561,,3188,"(3.541112,-76.384584)"
2012,Abril,Panamá,591,1,2,,3,"(4.452882,-75.766298)"
2012,Abril,Panamá,591,6324,7326,,13650,"(4.697144,-74.140516)"
2012,Abril,Panamá,591,639,478,,1117,"(4.815061,-75.736532)"
2012,Abril,Panamá,591,1909,1943,,3852,"(6.171601,-75.427454)"
2012,Abril,Panamá,591,15,32,,47,"(6.228046,-77.404104)"
2012,Abril,Panamá,591,234,243,,477,"(7.128456,-73.183637)"
2012,Abril,Panamá,591,186,176,,362,"(7.927209,-72.507910)"
2012,Abril,Panamá,591,66,133,,199,"(8.635765,-77.346578)"
2012,Abril,Paraguay,600,1,2,,3,"(10.886611,-74.776708)"
2012,Abril,Paraguay,600,6,16,,22,"(3.541112,-76.384584)"
2012,Abril,Paraguay,600,24,63,,87,"(4.697144,-74.140516)"
2012,Abril,Paraguay,600,3,8,,11,"(6.171601,-75.427454)"
2012,Abril,Perú,604,49,91,,140,"(-4.197703,-69.941278)"
2012,Abril,Perú,604,6,8,,14,"(0.814836,-77.662532)"
2012,Abril,Perú,604,1,8,,9,"(10.445761,-75.516429)"
2012,Abril,Perú,604,10,17,,27,"(10.886611,-74.776708)"
2012,Abril,Perú,604,1,2,,3,"(12.586067,-81.702563)"
2012,Abril,Perú,604,132,142,,274,"(3.541112,-76.384584)"
2012,Abril,Perú,604,3171,3907,,7078,"(4.697144,-74.140516)"
2012,Abril,Perú,604,8,10,,18,"(4.815061,-75.736532)"
2012,Abril,Perú,604,292,318,,610,"(6.171601,-75.427454)"
2012,Abril,Perú,604,4,5,,9,"(7.128456,-73.183637)"
2012,Abril,Perú,604,0,4,,4,"(7.927209,-72.507910)"
2012,Abril,Polonia,616,0,1,,1,"(3.541112,-76.384584)"
2012,Abril,Polonia,616,6,7,,13,"(4.697144,-74.140516)"
2012,Abril,Portugal,620,3,2,,5,"(3.541112,-76.384584)"
2012,Abril,Portugal,620,36,34,,70,"(4.697144,-74.140516)"
2012,Abril,Portugal,620,0,1,,1,"(6.171601,-75.427454)"
2012,Abril,Puerto Rico/Territorio de Estados Unidos,630,3,5,,8,"(10.445761,-75.516429)"
2012,Abril,Puerto Rico/Territorio de Estados Unidos,630,12,9,,21,"(10.886611,-74.776708)"
2012,Abril,Puerto Rico/Territorio de Estados Unidos,630,42,39,,81,"(3.541112,-76.384584)"
2012,Abril,Puerto Rico/Territorio de Estados Unidos,630,83,100,,183,"(4.697144,-74.140516)"
2012,Abril,Puerto Rico/Territorio de Estados Unidos,630,7,3,,10,"(4.815061,-75.736532)"
2012,Abril,Puerto Rico/Territorio de Estados Unidos,630,60,40,,100,"(6.171601,-75.427454)"
2012,Abril,Puerto Rico/Territorio de Estados Unidos,630,5,1,,6,"(7.128456,-73.183637)"
2012,Abril,Qatar,634,0,1,,1,"(4.697144,-74.140516)"
2012,Abril,Reino Unido de Gran Bretaña e Irlanda del Norte,826,2,1,,3,"(10.445761,-75.516429)"
2012,Abril,Reino Unido de Gran Bretaña e Irlanda del Norte,826,1,0,,1,"(10.886611,-74.776708)"
2012,Abril,Reino Unido de Gran Bretaña e Irlanda del Norte,826,54,42,,96,"(3.541112,-76.384584)"
2012,Abril,Reino Unido de Gran Bretaña e Irlanda del Norte,826,765,519,,1284,"(4.697144,-74.140516)"
2012,Abril,Reino Unido de Gran Bretaña e Irlanda del Norte,826,30,14,,44,"(6.171601,-75.427454)"
2012,Abril,Federación de Rusia,643,1,1,,2,"(11.360009,-72.129330)"
2012,Abril,Federación de Rusia,643,9,30,,39,"(4.697144,-74.140516)"
2012,Abril,República Dominicana,214,3,16,,19,"(10.445761,-75.516429)"
2012,Abril,República Dominicana,214,15,40,,55,"(10.886611,-74.776708)"
2012,Abril,República Dominicana,214,75,58,,133,"(3.541112,-76.384584)"
2012,Abril,República Dominicana,214,1043,1163,,2206,"(4.697144,-74.140516)"
2012,Abril,República Dominicana,214,6,4,,10,"(4.815061,-75.736532)"
2012,Abril,República Dominicana,214,116,131,,247,"(6.171601,-75.427454)"
2012,Abril,República Dominicana,214,5,5,,10,"(7.128456,-73.183637)"
2012,Abril,República Dominicana,214,1,0,,1,"(7.927209,-72.507910)"
2012,Abril,Reunión,638,1,1,,2,"(4.697144,-74.140516)"
2012,Abril,Rumania,642,5,7,,12,"(4.697144,-74.140516)"
2012,Abril,Rumania,642,0,1,,1,"(6.171601,-75.427454)"
2012,Abril,Sahara Occidental/Desierto Sahara,732,0,1,,1,"(4.697144,-74.140516)"
2012,Abril,San Cristóbal y Nevis,659,2,0,,2,"(3.541112,-76.384584)"
2012,Abril,Santa Lucia,662,1,1,,2,"(10.886611,-74.776708)"
2012,Abril,Senegal,686,1,1,,2,"(4.697144,-74.140516)"
2012,Abril,Sierra Leona,694,1,0,,1,"(4.697144,-74.140516)"
2012,Abril,Singapur,702,11,33,,44,"(4.697144,-74.140516)"
2012,Abril,Sri Lanka,144,1,1,,2,"(3.541112,-76.384584)"
2012,Abril,Sudáfrica,710,22,14,,36,"(4.697144,-74.140516)"
2012,Abril,Sudáfrica,710,0,1,,1,"(6.171601,-75.427454)"
2012,Abril,Sudán,736,0,1,,1,"(4.697144,-74.140516)"
2012,Abril,Suecia,752,2,0,,2,"(10.445761,-75.516429)"
2012,Abril,Suecia,752,5,2,,7,"(3.541112,-76.384584)"
2012,Abril,Suecia,752,59,49,,108,"(4.697144,-74.140516)"
2012,Abril,Suecia,752,1,1,,2,"(6.171601,-75.427454)"
2012,Abril,Suiza,756,43,16,,59,"(3.541112,-76.384584)"
2012,Abril,Suiza,756,222,124,,346,"(4.697144,-74.140516)"
2012,Abril,Suiza,756,15,7,,22,"(6.171601,-75.427454)"
2012,Abril,Surinam,740,1,3,,4,"(10.886611,-74.776708)"
2012,Abril,Surinam,740,4,6,,10,"(4.697144,-74.140516)"
2012,Abril,Surinam,740,1,0,,1,"(6.171601,-75.427454)"
2012,Abril,Taiwán,158,1,0,,1,"(3.541112,-76.384584)"
2012,Abril,Taiwán,158,3,5,,8,"(4.697144,-74.140516)"
2012,Abril,Taiwán,158,0,4,,4,"(6.171601,-75.427454)"
2012,Abril,Tailandia,764,6,4,,10,"(4.697144,-74.140516)"
2012,Abril,Tailandia,764,1,1,,2,"(6.171601,-75.427454)"
2012,Abril,Tanzania,834,0,1,,1,"(4.697144,-74.140516)"
2012,Abril,Trinidad y Tobago,780,4,4,,8,"(10.445761,-75.516429)"
2012,Abril,Trinidad y Tobago,780,3,5,,8,"(10.886611,-74.776708)"
2012,Abril,Trinidad y Tobago,780,7,6,,13,"(3.541112,-76.384584)"
2012,Abril,Trinidad y Tobago,780,38,65,,103,"(4.697144,-74.140516)"
2012,Abril,Trinidad y Tobago,780,11,15,,26,"(6.171601,-75.427454)"
2012,Abril,Trinidad y Tobago,780,2,1,,3,"(7.128456,-73.183637)"
2012,Abril,Trinidad y Tobago,780,1,1,,2,"(7.927209,-72.507910)"
2012,Abril,Túnez,788,0,1,,1,"(4.697144,-74.140516)"
2012,Abril,Turquía,792,1,0,,1,"(10.886611,-74.776708)"
2012,Abril,Turquía,792,71,51,,122,"(4.697144,-74.140516)"
2012,Abril,Turquía,792,2,2,,4,"(6.171601,-75.427454)"
2012,Abril,Ucrania,804,0,1,,1,"(4.697144,-74.140516)"
2012,Abril,Uruguay,858,1,1,,2,"(10.886611,-74.776708)"
2012,Abril,Uruguay,858,11,21,,32,"(3.541112,-76.384584)"
2012,Abril,Uruguay,858,39,54,,93,"(4.697144,-74.140516)"
2012,Abril,Uruguay,858,6,6,,12,"(6.171601,-75.427454)"
2012,Abril,Venezuela,862,0,1,,1,"(10.433609,-73.247863)"
2012,Abril,Venezuela,862,5,3,,8,"(10.445761,-75.516429)"
2012,Abril,Venezuela,862,9,14,,23,"(10.886611,-74.776708)"
2012,Abril,Venezuela,862,6951,6200,,13151,"(11.360009,-72.129330)"
2012,Abril,Venezuela,862,0,2,,2,"(12.586067,-81.702563)"
2012,Abril,Venezuela,862,20,17,,37,"(3.541112,-76.384584)"
2012,Abril,Venezuela,862,2352,2839,,5191,"(4.697144,-74.140516)"
2012,Abril,Venezuela,862,2,2,,4,"(4.815061,-75.736532)"
2012,Abril,Venezuela,862,290,318,,608,"(6.171601,-75.427454)"
2012,Abril,Venezuela,862,115,151,,266,"(6.185799,-67.483929)"
2012,Abril,Venezuela,862,1078,1102,,2180,"(7.088729,-70.740253)"
2012,Abril,Venezuela,862,3,2,,5,"(7.128456,-73.183637)"
2012,Abril,Venezuela,862,6053,6726,,12779,"(7.818934,-72.453226)"
2012,Abril,Vietnam,704,0,2,,2,"(4.697144,-74.140516)"
2012,Abril,Desconocido,99999,0,1,,1,"(12.586067,-81.702563)"
2012,Abril,Desconocido,99999,3,11,,14,"(4.697144,-74.140516)"
2012,Mayo,Afganistán,4,1,29,,30,"(4.697144,-74.140516)"
2012,Mayo,Albania,8,3,0,,3,"(4.697144,-74.140516)"
2012,Mayo,Alemania,276,2,0,,2,"(0.814836,-77.662532)"
2012,Mayo,Alemania,276,25,27,,52,"(3.541112,-76.384584)"
2012,Mayo,Alemania,276,1069,1109,,2178,"(4.697144,-74.140516)"
2012,Mayo,Alemania,276,8,16,,24,"(6.171601,-75.427454)"
2012,Mayo,Andorra,20,3,0,,3,"(4.697144,-74.140516)"
2012,Mayo,Angola,24,0,1,,1,"(3.541112,-76.384584)"
2012,Mayo,Angola,24,1,14,,15,"(4.697144,-74.140516)"
2012,Mayo,Países Bajos,528,1,1,,2,"(10.445761,-75.516429)"
2012,Mayo,Países Bajos,528,3,2,,5,"(10.886611,-74.776708)"
2012,Mayo,Países Bajos,528,36,8,,44,"(3.541112,-76.384584)"
2012,Mayo,Países Bajos,528,183,106,,289,"(4.697144,-74.140516)"
2012,Mayo,Países Bajos,528,1,0,,1,"(4.815061,-75.736532)"
2012,Mayo,Países Bajos,528,38,35,,73,"(6.171601,-75.427454)"
2012,Mayo,Arabia Saudita,682,0,2,,2,"(10.445761,-75.516429)"
2012,Mayo,Arabia Saudita,682,1,1,,2,"(3.541112,-76.384584)"
2012,Mayo,Arabia Saudita,682,4,26,,30,"(4.697144,-74.140516)"
2012,Mayo,Arabia Saudita,682,0,3,,3,"(6.171601,-75.427454)"
2012,Mayo,Argelia,12,1,0,,1,"(3.541112,-76.384584)"
2012,Mayo,Argelia,12,1,6,,7,"(4.697144,-74.140516)"
2012,Mayo,Argelia,12,1,0,,1,"(6.171601,-75.427454)"
2012,Mayo,Argentina,32,13,20,,33,"(0.814836,-77.662532)"
2012,Mayo,Argentina,32,12,7,,19,"(10.445761,-75.516429)"
2012,Mayo,Argentina,32,25,28,,53,"(10.886611,-74.776708)"
2012,Mayo,Argentina,32,124,127,,251,"(3.541112,-76.384584)"
2012,Mayo,Argentina,32,1826,1940,,3766,"(4.697144,-74.140516)"
2012,Mayo,Argentina,32,11,22,,33,"(4.815061,-75.736532)"
2012,Mayo,Argentina,32,142,177,,319,"(6.171601,-75.427454)"
2012,Mayo,Argentina,32,6,6,,12,"(7.128456,-73.183637)"
2012,Mayo,Argentina,32,2,0,,2,"(7.927209,-72.507910)"
2012,Mayo,República de Armenia,51,1,0,,1,"(4.697144,-74.140516)"
2012,Mayo,Aruba,533,16,8,,24,"(10.886611,-74.776708)"
2012,Mayo,Aruba,533,91,47,,138,"(11.528919,-72.919681)"
2012,Mayo,Aruba,533,24,8,,32,"(3.541112,-76.384584)"
2012,Mayo,Aruba,533,734,665,,1399,"(4.697144,-74.140516)"
2012,Mayo,Aruba,533,2,1,,3,"(4.815061,-75.736532)"
2012,Mayo,Aruba,533,59,43,,102,"(6.171601,-75.427454)"
2012,Mayo,Aruba,533,3,1,,4,"(7.128456,-73.183637)"
2012,Mayo,Australia,36,1,0,,1,"(10.445761,-75.516429)"
2012,Mayo,Australia,36,7,9,,16,"(3.541112,-76.384584)"
2012,Mayo,Australia,36,0,1,,1,"(4.452882,-75.766298)"
2012,Mayo,Australia,36,131,111,,242,"(4.697144,-74.140516)"
2012,Mayo,Australia,36,0,1,,1,"(4.815061,-75.736532)"
2012,Mayo,Australia,36,19,16,,35,"(6.171601,-75.427454)"
2012,Mayo,Austria,40,28,27,,55,"(4.697144,-74.140516)"
2012,Mayo,Azerbaiyán,31,1,1,,2,"(4.697144,-74.140516)"
2012,Mayo,Bahamas,44,0,1,,1,"(10.445761,-75.516429)"
2012,Mayo,Bahamas,44,5,7,,12,"(10.886611,-74.776708)"
2012,Mayo,Bahamas,44,19,12,,31,"(3.541112,-76.384584)"
2012,Mayo,Bahamas,44,17,22,,39,"(4.697144,-74.140516)"
2012,Mayo,Bahamas,44,1,1,,2,"(4.815061,-75.736532)"
2012,Mayo,Bahamas,44,38,35,,73,"(6.171601,-75.427454)"
2012,Mayo,Bahamas,44,0,1,,1,"(7.128456,-73.183637)"
2012,Mayo,Bahréin,48,1,0,,1,"(11.360009,-72.129330)"
2012,Mayo,Bahréin,48,5,4,,9,"(4.697144,-74.140516)"
2012,Mayo,Bangladesh,50,1,1,,2,"(4.697144,-74.140516)"
2012,Mayo,Barbados,52,1,8,,9,"(4.697144,-74.140516)"
2012,Mayo,Barbados,52,0,1,,1,"(4.815061,-75.736532)"
2012,Mayo,Barbados,52,0,1,,1,"(6.171601,-75.427454)"
2012,Mayo,República de Belarús,112,1,0,,1,"(11.360009,-72.129330)"
2012,Mayo,República de Belarús,112,2,0,,2,"(4.697144,-74.140516)"
2012,Mayo,República de Belarús,112,0,1,,1,"(7.128456,-73.183637)"
2012,Mayo,República de Belarús,112,3,7,,10,"(7.818934,-72.453226)"
2012,Mayo,Bélgica,56,4,5,,9,"(3.541112,-76.384584)"
2012,Mayo,Bélgica,56,60,30,,90,"(4.697144,-74.140516)"
2012,Mayo,Bélgica,56,9,5,,14,"(6.171601,-75.427454)"
2012,Mayo,Belice,84,2,3,,5,"(4.697144,-74.140516)"
2012,Mayo,Belice,84,1,0,,1,"(6.171601,-75.427454)"
2012,Mayo,Bermudas/Territorio Británico de Ultramar,60,2,1,,3,"(4.697144,-74.140516)"
2012,Mayo,Bolivia,68,0,4,,4,"(0.814836,-77.662532)"
2012,Mayo,Bolivia,68,1,0,,1,"(10.445761,-75.516429)"
2012,Mayo,Bolivia,68,3,3,,6,"(10.886611,-74.776708)"
2012,Mayo,Bolivia,68,1,2,,3,"(12.586067,-81.702563)"
2012,Mayo,Bolivia,68,7,26,,33,"(3.541112,-76.384584)"
2012,Mayo,Bolivia,68,144,224,,368,"(4.697144,-74.140516)"
2012,Mayo,Bolivia,68,2,1,,3,"(4.815061,-75.736532)"
2012,Mayo,Bolivia,68,15,23,,38,"(6.171601,-75.427454)"
2012,Mayo,Botsuana,72,0,1,,1,"(4.697144,-74.140516)"
2012,Mayo,Brasil,76,74,160,,234,"(-4.197703,-69.941278)"
2012,Mayo,Brasil,76,0,1,,1,"(0.814836,-77.662532)"
2012,Mayo,Brasil,76,1,4,,5,"(10.445761,-75.516429)"
2012,Mayo,Brasil,76,2,8,,10,"(10.886611,-74.776708)"
2012,Mayo,Brasil,76,24,43,,67,"(3.541112,-76.384584)"
2012,Mayo,Brasil,76,1874,2776,,4650,"(4.697144,-74.140516)"
2012,Mayo,Brasil,76,3,5,,8,"(4.815061,-75.736532)"
2012,Mayo,Brasil,76,21,60,,81,"(6.171601,-75.427454)"
2012,Mayo,Brasil,76,1,3,,4,"(7.128456,-73.183637)"
2012,Mayo,Bulgaria,100,1,3,,4,"(4.697144,-74.140516)"
2012,Mayo,Burundi,108,0,1,,1,"(4.697144,-74.140516)"
2012,Mayo,Islas Caimán/Territorio Británico de Ultramar,136,2,1,,3,"(12.586067,-81.702563)"
2012,Mayo,Islas Caimán/Territorio Británico de Ultramar,136,0,1,,1,"(4.697144,-74.140516)"
2012,Mayo,Camboya,116,1,1,,2,"(4.697144,-74.140516)"
2012,Mayo,Camerún,120,0,1,,1,"(6.171601,-75.427454)"
2012,Mayo,Canadá,124,16,11,,27,"(10.445761,-75.516429)"
2012,Mayo,Canadá,124,10,13,,23,"(10.886611,-74.776708)"
2012,Mayo,Canadá,124,78,50,,128,"(3.541112,-76.384584)"
2012,Mayo,Canadá,124,5,6,,11,"(4.452882,-75.766298)"
2012,Mayo,Canadá,124,1073,983,,2056,"(4.697144,-74.140516)"
2012,Mayo,Canadá,124,4,4,,8,"(4.815061,-75.736532)"
2012,Mayo,Canadá,124,201,152,,353,"(6.171601,-75.427454)"
2012,Mayo,Canadá,124,2,0,,2,"(7.128456,-73.183637)"
2012,Mayo,Canadá,124,0,1,,1,"(7.927209,-72.507910)"
2012,Mayo,España,724,0,2,,2,"(10.445761,-75.516429)"
2012,Mayo,España,724,2,2,,4,"(10.886611,-74.776708)"
2012,Mayo,España,724,0,1,,1,"(12.586067,-81.702563)"
2012,Mayo,España,724,1441,852,,2293,"(3.541112,-76.384584)"
2012,Mayo,España,724,6653,5390,,12043,"(4.697144,-74.140516)"
2012,Mayo,España,724,3,1,,4,"(4.815061,-75.736532)"
2012,Mayo,España,724,562,396,,958,"(6.171601,-75.427454)"
2012,Mayo,España,724,0,1,,1,"(7.818934,-72.453226)"
2012,Mayo,República Democrática del Congo,180,0,1,,1,"(7.128456,-73.183637)"
2012,Mayo,República de Corea,410,0,1,,1,"(3.541112,-76.384584)"
2012,Mayo,República de Corea,410,28,47,,75,"(4.697144,-74.140516)"
2012,Mayo,Costa Rica,188,9,11,,20,"(10.445761,-75.516429)"
2012,Mayo,Costa Rica,188,19,20,,39,"(10.886611,-74.776708)"
2012,Mayo,Costa Rica,188,0,8,,8,"(11.247723,-74.213989)"
2012,Mayo,Costa Rica,188,2,24,,26,"(12.5744111,-81.703935)"
2012,Mayo,Costa Rica,188,7,6,,13,"(12.586067,-81.702563)"
2012,Mayo,Costa Rica,188,1,8,,9,"(13.3387613,-81.372937)"
2012,Mayo,Costa Rica,188,38,35,,73,"(3.541112,-76.384584)"
2012,Mayo,Costa Rica,188,534,681,,1215,"(4.697144,-74.140516)"
2012,Mayo,Costa Rica,188,5,1,,6,"(4.815061,-75.736532)"
2012,Mayo,Costa Rica,188,152,133,,285,"(6.171601,-75.427454)"
2012,Mayo,Costa Rica,188,5,8,,13,"(7.128456,-73.183637)"
2012,Mayo,Costa Rica,188,1,2,,3,"(7.927209,-72.507910)"
2012,Mayo,Croacia,191,2,1,,3,"(4.697144,-74.140516)"
2012,Mayo,Cuba,192,8,11,,19,"(10.445761,-75.516429)"
2012,Mayo,Cuba,192,21,21,,42,"(10.886611,-74.776708)"
2012,Mayo,Cuba,192,138,99,,237,"(3.541112,-76.384584)"
2012,Mayo,Cuba,192,692,614,,1306,"(4.697144,-74.140516)"
2012,Mayo,Cuba,192,5,6,,11,"(4.815061,-75.736532)"
2012,Mayo,Cuba,192,173,107,,280,"(6.171601,-75.427454)"
2012,Mayo,Cuba,192,12,15,,27,"(7.128456,-73.183637)"
2012,Mayo,Cuba,192,1,3,,4,"(7.927209,-72.507910)"
2012,Mayo,Curazao,99999,0,2,,2,"(11.117806,-74.232622)"
2012,Mayo,Curazao,99999,0,1,,1,"(3.541112,-76.384584)"
2012,Mayo,Curazao,99999,352,371,,723,"(4.697144,-74.140516)"
2012,Mayo,Curazao,99999,103,40,,143,"(6.171601,-75.427454)"
2012,Mayo,República Checa,203,0,1,,1,"(10.886611,-74.776708)"
2012,Mayo,República Checa,203,2,0,,2,"(3.541112,-76.384584)"
2012,Mayo,República Checa,203,8,6,,14,"(4.697144,-74.140516)"
2012,Mayo,Chile,152,25,21,,46,"(0.814836,-77.662532)"
2012,Mayo,Chile,152,6,7,,13,"(10.445761,-75.516429)"
2012,Mayo,Chile,152,16,5,,21,"(10.886611,-74.776708)"
2012,Mayo,Chile,152,2,1,,3,"(12.586067,-81.702563)"
2012,Mayo,Chile,152,303,249,,552,"(3.541112,-76.384584)"
2012,Mayo,Chile,152,1660,1703,,3363,"(4.697144,-74.140516)"
2012,Mayo,Chile,152,40,47,,87,"(4.815061,-75.736532)"
2012,Mayo,Chile,152,86,102,,188,"(6.171601,-75.427454)"
2012,Mayo,Chile,152,7,6,,13,"(7.128456,-73.183637)"
2012,Mayo,Chile,152,2,0,,2,"(7.927209,-72.507910)"
2012,Mayo,China,156,1,3,,4,"(10.445761,-75.516429)"
2012,Mayo,China,156,1,3,,4,"(10.886611,-74.776708)"
2012,Mayo,China,156,3,3,,6,"(3.541112,-76.384584)"
2012,Mayo,China,156,252,492,,744,"(4.697144,-74.140516)"
2012,Mayo,China,156,8,12,,20,"(6.171601,-75.427454)"
2012,Mayo,Chipre,196,1,1,,2,"(4.697144,-74.140516)"
2012,Mayo,Dinamarca,208,1,0,,1,"(3.541112,-76.384584)"
2012,Mayo,Dinamarca,208,33,26,,59,"(4.697144,-74.140516)"
2012,Mayo,Dominica,212,1,2,,3,"(4.697144,-74.140516)"
2012,Mayo,Ecuador,218,280,396,,676,"(0.25129,-76.875963)"
2012,Mayo,Ecuador,218,5765,6174,,11939,"(0.814836,-77.662532)"
2012,Mayo,Ecuador,218,93,137,,230,"(1.813928,-78.763924)"
2012,Mayo,Ecuador,218,1,8,,9,"(10.445761,-75.516429)"
2012,Mayo,Ecuador,218,5,3,,8,"(10.886611,-74.776708)"
2012,Mayo,Ecuador,218,557,557,,1114,"(3.541112,-76.384584)"
2012,Mayo,Ecuador,218,1920,3699,,5619,"(4.697144,-74.140516)"
2012,Mayo,Ecuador,218,3,3,,6,"(4.815061,-75.736532)"
2012,Mayo,Ecuador,218,375,431,,806,"(6.171601,-75.427454)"
2012,Mayo,Ecuador,218,1,0,,1,"(7.128456,-73.183637)"
2012,Mayo,Ecuador,218,0,1,,1,"(7.927209,-72.507910)"
2012,Mayo,Egipto,818,1,0,,1,"(0.814836,-77.662532)"
2012,Mayo,Egipto,818,93,43,,136,"(4.697144,-74.140516)"
2012,Mayo,Egipto,818,2,3,,5,"(6.171601,-75.427454)"
2012,Mayo,El Salvador,222,0,3,,3,"(10.445761,-75.516429)"
2012,Mayo,El Salvador,222,2,0,,2,"(10.886611,-74.776708)"
2012,Mayo,El Salvador,222,12,21,,33,"(3.541112,-76.384584)"
2012,Mayo,El Salvador,222,965,1009,,1974,"(4.697144,-74.140516)"
2012,Mayo,El Salvador,222,16,38,,54,"(6.171601,-75.427454)"
2012,Mayo,Emiratos Árabes,784,2,0,,2,"(3.541112,-76.384584)"
2012,Mayo,Emiratos Árabes,784,28,129,,157,"(4.697144,-74.140516)"
2012,Mayo,Emiratos Árabes,784,5,3,,8,"(6.171601,-75.427454)"
2012,Mayo,Eslovenia,705,1,0,,1,"(3.541112,-76.384584)"
2012,Mayo,Eslovenia,705,2,1,,3,"(4.697144,-74.140516)"
2012,Mayo,Estados Unidos de América,840,0,1,,1,"(10.433609,-73.247863)"
2012,Mayo,Estados Unidos de América,840,1264,1090,,2354,"(10.445761,-75.516429)"
2012,Mayo,Estados Unidos de América,840,1634,1249,,2883,"(10.886611,-74.776708)"
2012,Mayo,Estados Unidos de América,840,0,1,,1,"(11.117806,-74.232622)"
2012,Mayo,Estados Unidos de América,840,29,25,,54,"(12.586067,-81.702563)"
2012,Mayo,Estados Unidos de América,840,4137,3085,,7222,"(3.541112,-76.384584)"
2012,Mayo,Estados Unidos de América,840,494,352,,846,"(4.452882,-75.766298)"
2012,Mayo,Estados Unidos de América,840,25192,23696,,48888,"(4.697144,-74.140516)"
2012,Mayo,Estados Unidos de América,840,211,157,,368,"(4.815061,-75.736532)"
2012,Mayo,Estados Unidos de América,840,6013,4609,,10622,"(6.171601,-75.427454)"
2012,Mayo,Estados Unidos de América,840,107,77,,184,"(7.128456,-73.183637)"
2012,Mayo,Estados Unidos de América,840,1,0,,1,"(7.818934,-72.453226)"
2012,Mayo,Estados Unidos de América,840,15,13,,28,"(7.927209,-72.507910)"
2012,Mayo,Estonia,233,2,2,,4,"(4.697144,-74.140516)"
2012,Mayo,Etiopia,231,0,1,,1,"(3.541112,-76.384584)"
2012,Mayo,Etiopia,231,1,0,,1,"(4.697144,-74.140516)"
2012,Mayo,Filipinas,608,2,1,,3,"(3.541112,-76.384584)"
2012,Mayo,Filipinas,608,2,4,,6,"(4.697144,-74.140516)"
2012,Mayo,Finlandia,246,0,2,,2,"(3.541112,-76.384584)"
2012,Mayo,Finlandia,246,12,10,,22,"(4.697144,-74.140516)"
2012,Mayo,Francia,250,1,0,,1,"(10.445761,-75.516429)"
2012,Mayo,Francia,250,46,34,,80,"(3.541112,-76.384584)"
2012,Mayo,Francia,250,1358,1176,,2534,"(4.697144,-74.140516)"
2012,Mayo,Francia,250,31,20,,51,"(6.171601,-75.427454)"
2012,Mayo,Gabón,266,1,4,,5,"(4.697144,-74.140516)"
2012,Mayo,Georgia,268,0,1,,1,"(4.697144,-74.140516)"
2012,Mayo,Ghana,288,0,3,,3,"(4.697144,-74.140516)"
2012,Mayo,Gibraltar/Territorio Británico de Ultramar,292,0,2,,2,"(4.697144,-74.140516)"
2012,Mayo,Granada,308,0,1,,1,"(4.697144,-74.140516)"
2012,Mayo,Grecia,300,22,10,,32,"(4.697144,-74.140516)"
2012,Mayo,Grecia,300,2,1,,3,"(6.171601,-75.427454)"
2012,Mayo,Guatemala,320,2,3,,5,"(10.445761,-75.516429)"
2012,Mayo,Guatemala,320,5,10,,15,"(10.886611,-74.776708)"
2012,Mayo,Guatemala,320,0,1,,1,"(12.586067,-81.702563)"
2012,Mayo,Guatemala,320,24,41,,65,"(3.541112,-76.384584)"
2012,Mayo,Guatemala,320,153,256,,409,"(4.697144,-74.140516)"
2012,Mayo,Guatemala,320,8,3,,11,"(4.815061,-75.736532)"
2012,Mayo,Guatemala,320,59,110,,169,"(6.171601,-75.427454)"
2012,Mayo,Guatemala,320,3,1,,4,"(7.128456,-73.183637)"
2012,Mayo,Guatemala,320,1,1,,2,"(7.927209,-72.507910)"
2012,Mayo,Guyana,328,4,2,,6,"(4.697144,-74.140516)"
2012,Mayo,Guinea,324,1,1,,2,"(4.697144,-74.140516)"
2012,Mayo,Guinea Ecuatorial,226,0,2,,2,"(3.541112,-76.384584)"
2012,Mayo,Guinea Ecuatorial,226,3,8,,11,"(4.697144,-74.140516)"
2012,Mayo,Haití,332,2,7,,9,"(10.886611,-74.776708)"
2012,Mayo,Haití,332,1,0,,1,"(3.541112,-76.384584)"
2012,Mayo,Haití,332,3,6,,9,"(4.697144,-74.140516)"
2012,Mayo,Haití,332,2,3,,5,"(6.171601,-75.427454)"
2012,Mayo,Honduras,340,1,8,,9,"(10.445761,-75.516429)"
2012,Mayo,Honduras,340,4,8,,12,"(10.886611,-74.776708)"
2012,Mayo,Honduras,340,1,0,,1,"(12.586067,-81.702563)"
2012,Mayo,Honduras,340,16,54,,70,"(3.541112,-76.384584)"
2012,Mayo,Honduras,340,69,161,,230,"(4.697144,-74.140516)"
2012,Mayo,Honduras,340,0,5,,5,"(4.815061,-75.736532)"
2012,Mayo,Honduras,340,31,53,,84,"(6.171601,-75.427454)"
2012,Mayo,Honduras,340,1,1,,2,"(7.128456,-73.183637)"
2012,Mayo,Honduras,340,0,1,,1,"(7.927209,-72.507910)"
2012,Mayo,Hong Kong,344,22,51,,73,"(4.697144,-74.140516)"
2012,Mayo,Hong Kong,344,1,2,,3,"(6.171601,-75.427454)"
2012,Mayo,Hungría,348,2,5,,7,"(4.697144,-74.140516)"
2012,Mayo,India,356,0,1,,1,"(10.886611,-74.776708)"
2012,Mayo,India,356,0,3,,3,"(3.541112,-76.384584)"
2012,Mayo,India,356,19,22,,41,"(4.697144,-74.140516)"
2012,Mayo,India,356,1,0,,1,"(6.171601,-75.427454)"
2012,Mayo,Indonesia,360,0,1,,1,"(3.541112,-76.384584)"
2012,Mayo,Indonesia,360,7,15,,22,"(4.697144,-74.140516)"
2012,Mayo,Iraq,368,1,4,,5,"(4.697144,-74.140516)"
2012,Mayo,Irán,364,0,7,,7,"(4.697144,-74.140516)"
2012,Mayo,República de Irlanda,372,21,17,,38,"(4.697144,-74.140516)"
2012,Mayo,República de Irlanda,372,1,0,,1,"(6.171601,-75.427454)"
2012,Mayo,Isla de Man,833,1,0,,1,"(4.697144,-74.140516)"
2012,Mayo,Israel,376,0,1,,1,"(10.886611,-74.776708)"
2012,Mayo,Israel,376,144,92,,236,"(4.697144,-74.140516)"
2012,Mayo,Israel,376,1,2,,3,"(6.171601,-75.427454)"
2012,Mayo,Italia,380,0,2,,2,"(10.445761,-75.516429)"
2012,Mayo,Italia,380,113,34,,147,"(3.541112,-76.384584)"
2012,Mayo,Italia,380,519,358,,877,"(4.697144,-74.140516)"
2012,Mayo,Italia,380,50,37,,87,"(6.171601,-75.427454)"
2012,Mayo,Italia,380,0,1,,1,"(7.128456,-73.183637)"
2012,Mayo,Jamaica,388,9,7,,16,"(3.541112,-76.384584)"
2012,Mayo,Jamaica,388,32,33,,65,"(4.697144,-74.140516)"
2012,Mayo,Jamaica,388,4,4,,8,"(6.171601,-75.427454)"
2012,Mayo,Jamaica,388,1,1,,2,"(7.128456,-73.183637)"
2012,Mayo,Japón,392,1,0,,1,"(10.886611,-74.776708)"
2012,Mayo,Japón,392,1,3,,4,"(3.541112,-76.384584)"
2012,Mayo,Japón,392,30,32,,62,"(4.697144,-74.140516)"
2012,Mayo,Japón,392,4,1,,5,"(6.171601,-75.427454)"
2012,Mayo,Jordania,400,3,4,,7,"(4.697144,-74.140516)"
2012,Mayo,Kenia,404,2,2,,4,"(4.697144,-74.140516)"
2012,Mayo,Kuwait,414,2,2,,4,"(4.697144,-74.140516)"
2012,Mayo,Kuwait,414,0,1,,1,"(6.171601,-75.427454)"
2012,Mayo,Lituania,440,0,16,,16,"(4.697144,-74.140516)"
2012,Mayo,Líbano,422,32,36,,68,"(4.697144,-74.140516)"
2012,Mayo,Luxemburgo,442,3,1,,4,"(4.697144,-74.140516)"
2012,Mayo,Malasia,458,5,8,,13,"(4.697144,-74.140516)"
2012,Mayo,Malta,470,4,1,,5,"(4.697144,-74.140516)"
2012,Mayo,Marruecos,504,0,1,,1,"(3.541112,-76.384584)"
2012,Mayo,Marruecos,504,10,9,,19,"(4.697144,-74.140516)"
2012,Mayo,Martinica/Departamento de Ultramar Francés,474,0,3,,3,"(4.697144,-74.140516)"
2012,Mayo,México,484,14,12,,26,"(10.445761,-75.516429)"
2012,Mayo,México,484,34,36,,70,"(10.886611,-74.776708)"
2012,Mayo,México,484,1,1,,2,"(12.586067,-81.702563)"
2012,Mayo,México,484,118,120,,238,"(3.541112,-76.384584)"
2012,Mayo,México,484,4329,4429,,8758,"(4.697144,-74.140516)"
2012,Mayo,México,484,14,22,,36,"(4.815061,-75.736532)"
2012,Mayo,México,484,374,327,,701,"(6.171601,-75.427454)"
2012,Mayo,México,484,10,5,,15,"(7.128456,-73.183637)"
2012,Mayo,México,484,3,2,,5,"(7.927209,-72.507910)"
2012,Mayo,Mozambique,508,0,1,,1,"(4.697144,-74.140516)"
2012,Mayo,Nicaragua,558,0,1,,1,"(10.445761,-75.516429)"
2012,Mayo,Nicaragua,558,5,5,,10,"(10.886611,-74.776708)"
2012,Mayo,Nicaragua,558,11,18,,29,"(3.541112,-76.384584)"
2012,Mayo,Nicaragua,558,32,43,,75,"(4.697144,-74.140516)"
2012,Mayo,Nicaragua,558,1,1,,2,"(4.815061,-75.736532)"
2012,Mayo,Nicaragua,558,10,20,,30,"(6.171601,-75.427454)"
2012,Mayo,Nicaragua,558,0,1,,1,"(7.927209,-72.507910)"
2012,Mayo,Nigeria,566,0,21,,21,"(4.697144,-74.140516)"
2012,Mayo,Noruega,578,2,2,,4,"(3.541112,-76.384584)"
2012,Mayo,Noruega,578,19,15,,34,"(4.697144,-74.140516)"
2012,Mayo,Noruega,578,1,2,,3,"(6.171601,-75.427454)"
2012,Mayo,Nueva Caledonia/Territorio francés,540,1,0,,1,"(4.697144,-74.140516)"
2012,Mayo,Nueva Zelanda,554,13,12,,25,"(4.697144,-74.140516)"
2012,Mayo,Nueva Zelanda,554,0,1,,1,"(4.815061,-75.736532)"
2012,Mayo,Papúa Nueva Guinea,598,1,0,,1,"(10.886611,-74.776708)"
2012,Mayo,Papúa Nueva Guinea,598,0,2,,2,"(4.697144,-74.140516)"
2012,Mayo,Pakistán,586,0,2,,2,"(4.697144,-74.140516)"
2012,Mayo,Panamá,591,12,99,,111,"(10.408582,-75.538003)"
2012,Mayo,Panamá,591,227,245,,472,"(10.445761,-75.516429)"
2012,Mayo,Panamá,591,727,841,,1568,"(10.886611,-74.776708)"
2012,Mayo,Panamá,591,0,1,,1,"(11.247723,-74.213989)"
2012,Mayo,Panamá,591,0,18,,18,"(12.5744111,-81.703935)"
2012,Mayo,Panamá,591,95,106,,201,"(12.586067,-81.702563)"
2012,Mayo,Panamá,591,1557,1384,,2941,"(3.541112,-76.384584)"
2012,Mayo,Panamá,591,6100,7283,,13383,"(4.697144,-74.140516)"
2012,Mayo,Panamá,591,574,464,,1038,"(4.815061,-75.736532)"
2012,Mayo,Panamá,591,1647,1736,,3383,"(6.171601,-75.427454)"
2012,Mayo,Panamá,591,4,24,,28,"(6.228046,-77.404104)"
2012,Mayo,Panamá,591,277,268,,545,"(7.128456,-73.183637)"
2012,Mayo,Panamá,591,147,149,,296,"(7.927209,-72.507910)"
2012,Mayo,Panamá,591,65,111,,176,"(8.635765,-77.346578)"
2012,Mayo,Paraguay,600,1,0,,1,"(10.886611,-74.776708)"
2012,Mayo,Paraguay,600,5,18,,23,"(3.541112,-76.384584)"
2012,Mayo,Paraguay,600,31,67,,98,"(4.697144,-74.140516)"
2012,Mayo,Paraguay,600,1,0,,1,"(4.815061,-75.736532)"
2012,Mayo,Paraguay,600,10,14,,24,"(6.171601,-75.427454)"
2012,Mayo,Perú,604,70,118,,188,"(-4.197703,-69.941278)"
2012,Mayo,Perú,604,14,28,,42,"(0.814836,-77.662532)"
2012,Mayo,Perú,604,7,5,,12,"(10.445761,-75.516429)"
2012,Mayo,Perú,604,1,9,,10,"(10.886611,-74.776708)"
2012,Mayo,Perú,604,4,0,,4,"(12.586067,-81.702563)"
2012,Mayo,Perú,604,106,124,,230,"(3.541112,-76.384584)"
2012,Mayo,Perú,604,2827,4049,,6876,"(4.697144,-74.140516)"
2012,Mayo,Perú,604,3,5,,8,"(4.815061,-75.736532)"
2012,Mayo,Perú,604,191,263,,454,"(6.171601,-75.427454)"
2012,Mayo,Perú,604,6,14,,20,"(7.128456,-73.183637)"
2012,Mayo,Palestina,99999,0,1,,1,"(4.697144,-74.140516)"
2012,Mayo,Polonia,616,0,1,,1,"(3.541112,-76.384584)"
2012,Mayo,Polonia,616,7,24,,31,"(4.697144,-74.140516)"
2012,Mayo,Polonia,616,1,0,,1,"(6.171601,-75.427454)"
2012,Mayo,Portugal,620,2,1,,3,"(3.541112,-76.384584)"
2012,Mayo,Portugal,620,23,27,,50,"(4.697144,-74.140516)"
2012,Mayo,Puerto Rico/Territorio de Estados Unidos,630,7,5,,12,"(10.445761,-75.516429)"
2012,Mayo,Puerto Rico/Territorio de Estados Unidos,630,15,10,,25,"(10.886611,-74.776708)"
2012,Mayo,Puerto Rico/Territorio de Estados Unidos,630,37,22,,59,"(3.541112,-76.384584)"
2012,Mayo,Puerto Rico/Territorio de Estados Unidos,630,70,104,,174,"(4.697144,-74.140516)"
2012,Mayo,Puerto Rico/Territorio de Estados Unidos,630,5,1,,6,"(4.815061,-75.736532)"
2012,Mayo,Puerto Rico/Territorio de Estados Unidos,630,28,23,,51,"(6.171601,-75.427454)"
2012,Mayo,Puerto Rico/Territorio de Estados Unidos,630,1,1,,2,"(7.128456,-73.183637)"
2012,Mayo,Puerto Rico/Territorio de Estados Unidos,630,1,0,,1,"(7.927209,-72.507910)"
2012,Mayo,Qatar,634,4,3,,7,"(4.697144,-74.140516)"
2012,Mayo,Qatar,634,0,1,,1,"(6.171601,-75.427454)"
2012,Mayo,Reino Unido de Gran Bretaña e Irlanda del Norte,826,0,1,,1,"(10.445761,-75.516429)"
2012,Mayo,Reino Unido de Gran Bretaña e Irlanda del Norte,826,1,1,,2,"(10.886611,-74.776708)"
2012,Mayo,Reino Unido de Gran Bretaña e Irlanda del Norte,826,62,39,,101,"(3.541112,-76.384584)"
2012,Mayo,Reino Unido de Gran Bretaña e Irlanda del Norte,826,546,432,,978,"(4.697144,-74.140516)"
2012,Mayo,Reino Unido de Gran Bretaña e Irlanda del Norte,826,40,25,,65,"(6.171601,-75.427454)"
2012,Mayo,Federación de Rusia,643,1,0,,1,"(10.886611,-74.776708)"
2012,Mayo,Federación de Rusia,643,1,1,,2,"(3.541112,-76.384584)"
2012,Mayo,Federación de Rusia,643,45,73,,118,"(4.697144,-74.140516)"
2012,Mayo,Federación de Rusia,643,0,1,,1,"(6.171601,-75.427454)"
2012,Mayo,República Dominicana,214,0,4,,4,"(10.408582,-75.538003)"
2012,Mayo,República Dominicana,214,5,15,,20,"(10.445761,-75.516429)"
2012,Mayo,República Dominicana,214,25,31,,56,"(10.886611,-74.776708)"
2012,Mayo,República Dominicana,214,1,3,,4,"(11.117806,-74.232622)"
2012,Mayo,República Dominicana,214,2,0,,2,"(12.586067,-81.702563)"
2012,Mayo,República Dominicana,214,106,81,,187,"(3.541112,-76.384584)"
2012,Mayo,República Dominicana,214,955,1001,,1956,"(4.697144,-74.140516)"
2012,Mayo,República Dominicana,214,21,18,,39,"(4.815061,-75.736532)"
2012,Mayo,República Dominicana,214,151,101,,252,"(6.171601,-75.427454)"
2012,Mayo,República Dominicana,214,16,18,,34,"(7.128456,-73.183637)"
2012,Mayo,República Dominicana,214,6,4,,10,"(7.927209,-72.507910)"
2012,Mayo,Reunión,638,0,2,,2,"(4.697144,-74.140516)"
2012,Mayo,Rumania,642,1,0,,1,"(3.541112,-76.384584)"
2012,Mayo,Rumania,642,3,6,,9,"(4.697144,-74.140516)"
2012,Mayo,Santa Lucia,662,0,1,,1,"(4.697144,-74.140516)"
2012,Mayo,Serbia,688,1,2,,3,"(4.697144,-74.140516)"
2012,Mayo,Singapur,702,48,78,,126,"(4.697144,-74.140516)"
2012,Mayo,Singapur,702,0,1,,1,"(6.171601,-75.427454)"
2012,Mayo,Sri Lanka,144,3,0,,3,"(4.697144,-74.140516)"
2012,Mayo,Sudáfrica,710,1,0,,1,"(3.541112,-76.384584)"
2012,Mayo,Sudáfrica,710,8,9,,17,"(4.697144,-74.140516)"
2012,Mayo,Sudán,736,1,1,,2,"(4.697144,-74.140516)"
2012,Mayo,Suecia,752,1,0,,1,"(10.445761,-75.516429)"
2012,Mayo,Suecia,752,7,4,,11,"(3.541112,-76.384584)"
2012,Mayo,Suecia,752,58,54,,112,"(4.697144,-74.140516)"
2012,Mayo,Suecia,752,4,5,,9,"(6.171601,-75.427454)"
2012,Mayo,Suiza,756,24,15,,39,"(3.541112,-76.384584)"
2012,Mayo,Suiza,756,207,168,,375,"(4.697144,-74.140516)"
2012,Mayo,Suiza,756,8,6,,14,"(6.171601,-75.427454)"
2012,Mayo,Surinam,740,1,5,,6,"(4.697144,-74.140516)"
2012,Mayo,Taiwán,158,1,3,,4,"(4.697144,-74.140516)"
2012,Mayo,Taiwán,158,1,0,,1,"(6.171601,-75.427454)"
2012,Mayo,Tailandia,764,8,8,,16,"(4.697144,-74.140516)"
2012,Mayo,Tanzania,834,1,0,,1,"(6.171601,-75.427454)"
2012,Mayo,Togo,768,1,0,,1,"(7.818934,-72.453226)"
2012,Mayo,Trinidad y Tobago,780,4,3,,7,"(10.445761,-75.516429)"
2012,Mayo,Trinidad y Tobago,780,6,2,,8,"(10.886611,-74.776708)"
2012,Mayo,Trinidad y Tobago,780,1,1,,2,"(12.586067,-81.702563)"
2012,Mayo,Trinidad y Tobago,780,11,9,,20,"(3.541112,-76.384584)"
2012,Mayo,Trinidad y Tobago,780,20,41,,61,"(4.697144,-74.140516)"
2012,Mayo,Trinidad y Tobago,780,4,2,,6,"(4.815061,-75.736532)"
2012,Mayo,Trinidad y Tobago,780,10,9,,19,"(6.171601,-75.427454)"
2012,Mayo,Trinidad y Tobago,780,5,7,,12,"(7.128456,-73.183637)"
2012,Mayo,Túnez,788,1,1,,2,"(4.697144,-74.140516)"
2012,Mayo,Turquía,792,1,1,,2,"(3.541112,-76.384584)"
2012,Mayo,Turquía,792,62,39,,101,"(4.697144,-74.140516)"
2012,Mayo,Turquía,792,5,1,,6,"(6.171601,-75.427454)"
2012,Mayo,Ucrania,804,2,1,,3,"(4.697144,-74.140516)"
2012,Mayo,Uganda,800,0,2,,2,"(4.697144,-74.140516)"
2012,Mayo,Uruguay,858,1,2,,3,"(10.886611,-74.776708)"
2012,Mayo,Uruguay,858,8,7,,15,"(3.541112,-76.384584)"
2012,Mayo,Uruguay,858,52,61,,113,"(4.697144,-74.140516)"
2012,Mayo,Uruguay,858,2,1,,3,"(4.815061,-75.736532)"
2012,Mayo,Uruguay,858,10,16,,26,"(6.171601,-75.427454)"
2012,Mayo,Uruguay,858,1,13,,14,"(7.128456,-73.183637)"
2012,Mayo,Venezuela,862,7,6,,13,"(10.445761,-75.516429)"
2012,Mayo,Venezuela,862,10,29,,39,"(10.886611,-74.776708)"
2012,Mayo,Venezuela,862,5462,5824,,11286,"(11.360009,-72.129330)"
2012,Mayo,Venezuela,862,2,0,,2,"(11.528919,-72.919681)"
2012,Mayo,Venezuela,862,23,27,,50,"(3.541112,-76.384584)"
2012,Mayo,Venezuela,862,2227,3144,,5371,"(4.697144,-74.140516)"
2012,Mayo,Venezuela,862,1,1,,2,"(4.815061,-75.736532)"
2012,Mayo,Venezuela,862,272,335,,607,"(6.171601,-75.427454)"
2012,Mayo,Venezuela,862,138,165,,303,"(6.185799,-67.483929)"
2012,Mayo,Venezuela,862,894,953,,1847,"(7.088729,-70.740253)"
2012,Mayo,Venezuela,862,1,3,,4,"(7.128456,-73.183637)"
2012,Mayo,Venezuela,862,4877,5972,,10849,"(7.818934,-72.453226)"
2012,Mayo,Venezuela,862,0,2,,2,"(7.927209,-72.507910)"
2012,Mayo,Vietnam,704,4,2,,6,"(4.697144,-74.140516)"
2012,Mayo,Desconocido,99999,0,1,,1,"(3.541112,-76.384584)"
2012,Mayo,Desconocido,99999,5,11,,16,"(4.697144,-74.140516)"
2012,Junio,Afganistán,4,2,44,,46,"(4.697144,-74.140516)"
2012,Junio,Afganistán,4,0,1,,1,"(6.171601,-75.427454)"
2012,Junio,Alemania,276,2,0,,2,"(0.814836,-77.662532)"
2012,Junio,Alemania,276,1,2,,3,"(10.445761,-75.516429)"
2012,Junio,Alemania,276,1,2,,3,"(10.886611,-74.776708)"
2012,Junio,Alemania,276,19,21,,40,"(3.541112,-76.384584)"
2012,Junio,Alemania,276,1392,1209,,2601,"(4.697144,-74.140516)"
2012,Junio,Alemania,276,1,0,,1,"(4.815061,-75.736532)"
2012,Junio,Alemania,276,29,26,,55,"(6.171601,-75.427454)"
2012,Junio,Angola,24,4,15,,19,"(4.697144,-74.140516)"
2012,Junio,Países Bajos,528,1,1,,2,"(10.445761,-75.516429)"
2012,Junio,Países Bajos,528,0,3,,3,"(10.886611,-74.776708)"
2012,Junio,Países Bajos,528,0,2,,2,"(11.247723,-74.213989)"
2012,Junio,Países Bajos,528,50,28,,78,"(3.541112,-76.384584)"
2012,Junio,Países Bajos,528,154,108,,262,"(4.697144,-74.140516)"
2012,Junio,Países Bajos,528,1,0,,1,"(4.815061,-75.736532)"
2012,Junio,Países Bajos,528,54,59,,113,"(6.171601,-75.427454)"
2012,Junio,Arabia Saudita,682,0,1,,1,"(10.445761,-75.516429)"
2012,Junio,Arabia Saudita,682,0,2,,2,"(3.541112,-76.384584)"
2012,Junio,Arabia Saudita,682,4,21,,25,"(4.697144,-74.140516)"
2012,Junio,Arabia Saudita,682,0,1,,1,"(6.171601,-75.427454)"
2012,Junio,Argelia,12,0,4,,4,"(4.697144,-74.140516)"
2012,Junio,Argelia,12,0,1,,1,"(6.171601,-75.427454)"
2012,Junio,Argentina,32,6,18,,24,"(0.814836,-77.662532)"
2012,Junio,Argentina,32,19,17,,36,"(10.445761,-75.516429)"
2012,Junio,Argentina,32,47,38,,85,"(10.886611,-74.776708)"
2012,Junio,Argentina,32,0,1,,1,"(12.586067,-81.702563)"
2012,Junio,Argentina,32,141,160,,301,"(3.541112,-76.384584)"
2012,Junio,Argentina,32,2427,2205,,4632,"(4.697144,-74.140516)"
2012,Junio,Argentina,32,18,26,,44,"(4.815061,-75.736532)"
2012,Junio,Argentina,32,221,179,,400,"(6.171601,-75.427454)"
2012,Junio,Argentina,32,25,21,,46,"(7.128456,-73.183637)"
2012,Junio,Argentina,32,2,1,,3,"(7.927209,-72.507910)"
2012,Junio,Aruba,533,0,1,,1,"(10.445761,-75.516429)"
2012,Junio,Aruba,533,20,9,,29,"(10.886611,-74.776708)"
2012,Junio,Aruba,533,68,78,,146,"(11.528919,-72.919681)"
2012,Junio,Aruba,533,50,40,,90,"(3.541112,-76.384584)"
2012,Junio,Aruba,533,1243,1102,,2345,"(4.697144,-74.140516)"
2012,Junio,Aruba,533,11,7,,18,"(4.815061,-75.736532)"
2012,Junio,Aruba,533,124,92,,216,"(6.171601,-75.427454)"
2012,Junio,Aruba,533,13,17,,30,"(7.128456,-73.183637)"
2012,Junio,Aruba,533,0,2,,2,"(7.927209,-72.507910)"
2012,Junio,Australia,36,3,1,,4,"(10.445761,-75.516429)"
2012,Junio,Australia,36,2,1,,3,"(10.886611,-74.776708)"
2012,Junio,Australia,36,11,2,,13,"(3.541112,-76.384584)"
2012,Junio,Australia,36,172,142,,314,"(4.697144,-74.140516)"
2012,Junio,Australia,36,1,1,,2,"(4.815061,-75.736532)"
2012,Junio,Australia,36,26,32,,58,"(6.171601,-75.427454)"
2012,Junio,Australia,36,1,0,,1,"(7.128456,-73.183637)"
2012,Junio,Austria,40,2,0,,2,"(3.541112,-76.384584)"
2012,Junio,Austria,40,45,28,,73,"(4.697144,-74.140516)"
2012,Junio,Azerbaiyán,31,0,3,,3,"(4.697144,-74.140516)"
2012,Junio,Bahamas,44,1,5,,6,"(10.445761,-75.516429)"
2012,Junio,Bahamas,44,7,3,,10,"(10.886611,-74.776708)"
2012,Junio,Bahamas,44,23,24,,47,"(3.541112,-76.384584)"
2012,Junio,Bahamas,44,44,50,,94,"(4.697144,-74.140516)"
2012,Junio,Bahamas,44,4,5,,9,"(4.815061,-75.736532)"
2012,Junio,Bahamas,44,51,47,,98,"(6.171601,-75.427454)"
2012,Junio,Bahamas,44,7,1,,8,"(7.927209,-72.507910)"
2012,Junio,Bahréin,48,1,1,,2,"(11.360009,-72.129330)"
2012,Junio,Bahréin,48,1,3,,4,"(4.697144,-74.140516)"
2012,Junio,Bahréin,48,1,0,,1,"(7.927209,-72.507910)"
2012,Junio,Barbados,52,2,0,,2,"(10.445761,-75.516429)"
2012,Junio,Barbados,52,1,12,,13,"(4.697144,-74.140516)"
2012,Junio,Barbados,52,2,0,,2,"(4.815061,-75.736532)"
2012,Junio,Barbados,52,0,1,,1,"(6.171601,-75.427454)"
2012,Junio,República de Belarús,112,1,2,,3,"(11.360009,-72.129330)"
2012,Junio,República de Belarús,112,0,2,,2,"(3.541112,-76.384584)"
2012,Junio,República de Belarús,112,1,1,,2,"(4.697144,-74.140516)"
2012,Junio,República de Belarús,112,1,0,,1,"(7.088729,-70.740253)"
2012,Junio,República de Belarús,112,9,9,,18,"(7.818934,-72.453226)"
2012,Junio,Bélgica,56,7,6,,13,"(3.541112,-76.384584)"
2012,Junio,Bélgica,56,64,42,,106,"(4.697144,-74.140516)"
2012,Junio,Bélgica,56,10,8,,18,"(6.171601,-75.427454)"
2012,Junio,Belice,84,1,1,,2,"(4.697144,-74.140516)"
2012,Junio,Bermudas/Territorio Británico de Ultramar,60,0,1,,1,"(4.697144,-74.140516)"
2012,Junio,Bermudas/Territorio Británico de Ultramar,60,1,0,,1,"(6.171601,-75.427454)"
2012,Junio,Bolivia,68,2,5,,7,"(0.814836,-77.662532)"
2012,Junio,Bolivia,68,2,3,,5,"(10.886611,-74.776708)"
2012,Junio,Bolivia,68,1,0,,1,"(12.586067,-81.702563)"
2012,Junio,Bolivia,68,11,17,,28,"(3.541112,-76.384584)"
2012,Junio,Bolivia,68,176,258,,434,"(4.697144,-74.140516)"
2012,Junio,Bolivia,68,10,15,,25,"(6.171601,-75.427454)"
2012,Junio,Bolivia,68,0,2,,2,"(7.128456,-73.183637)"
2012,Junio,Botsuana,72,0,1,,1,"(4.697144,-74.140516)"
2012,Junio,Brasil,76,82,161,,243,"(-4.197703,-69.941278)"
2012,Junio,Brasil,76,0,1,,1,"(10.408582,-75.538003)"
2012,Junio,Brasil,76,5,5,,10,"(10.445761,-75.516429)"
2012,Junio,Brasil,76,9,8,,17,"(10.886611,-74.776708)"
2012,Junio,Brasil,76,0,1,,1,"(12.586067,-81.702563)"
2012,Junio,Brasil,76,24,39,,63,"(3.541112,-76.384584)"
2012,Junio,Brasil,76,2233,2933,,5166,"(4.697144,-74.140516)"
2012,Junio,Brasil,76,0,2,,2,"(4.815061,-75.736532)"
2012,Junio,Brasil,76,48,60,,108,"(6.171601,-75.427454)"
2012,Junio,Brunei Darussalam,96,0,1,,1,"(4.697144,-74.140516)"
2012,Junio,Bulgaria,100,0,1,,1,"(4.697144,-74.140516)"
2012,Junio,Cabo Verde,132,0,2,,2,"(0.814836,-77.662532)"
2012,Junio,Islas Caimán/Territorio Británico de Ultramar,136,1,1,,2,"(10.445761,-75.516429)"
2012,Junio,Islas Caimán/Territorio Británico de Ultramar,136,21,8,,29,"(12.586067,-81.702563)"
2012,Junio,Islas Caimán/Territorio Británico de Ultramar,136,0,1,,1,"(13.3387613,-81.372937)"
2012,Junio,Islas Caimán/Territorio Británico de Ultramar,136,1,0,,1,"(3.541112,-76.384584)"
2012,Junio,Camboya,116,0,2,,2,"(4.697144,-74.140516)"
2012,Junio,Camerún,120,0,1,,1,"(3.541112,-76.384584)"
2012,Junio,Canadá,124,19,12,,31,"(10.445761,-75.516429)"
2012,Junio,Canadá,124,26,13,,39,"(10.886611,-74.776708)"
2012,Junio,Canadá,124,0,1,,1,"(12.586067,-81.702563)"
2012,Junio,Canadá,124,54,45,,99,"(3.541112,-76.384584)"
2012,Junio,Canadá,124,2,2,,4,"(4.452882,-75.766298)"
2012,Junio,Canadá,124,1447,1312,,2759,"(4.697144,-74.140516)"
2012,Junio,Canadá,124,2,6,,8,"(4.815061,-75.736532)"
2012,Junio,Canadá,124,143,120,,263,"(6.171601,-75.427454)"
2012,Junio,Canadá,124,9,3,,12,"(7.128456,-73.183637)"
2012,Junio,Canadá,124,1,1,,2,"(7.927209,-72.507910)"
2012,Junio,España,724,13,7,,20,"(10.445761,-75.516429)"
2012,Junio,España,724,1729,1085,,2814,"(3.541112,-76.384584)"
2012,Junio,España,724,1,0,,1,"(4.452882,-75.766298)"
2012,Junio,España,724,8397,6444,,14841,"(4.697144,-74.140516)"
2012,Junio,España,724,702,595,,1297,"(6.171601,-75.427454)"
2012,Junio,España,724,1,0,,1,"(7.128456,-73.183637)"
2012,Junio,República Democrática del Congo,180,0,1,,1,"(4.697144,-74.140516)"
2012,Junio,República de Corea,410,1,1,,2,"(10.445761,-75.516429)"
2012,Junio,República de Corea,410,2,1,,3,"(10.886611,-74.776708)"
2012,Junio,República de Corea,410,19,32,,51,"(4.697144,-74.140516)"
2012,Junio,República de Corea,410,0,1,,1,"(6.171601,-75.427454)"
2012,Junio,Costa Rica,188,9,4,,13,"(10.445761,-75.516429)"
2012,Junio,Costa Rica,188,12,17,,29,"(10.886611,-74.776708)"
2012,Junio,Costa Rica,188,2,28,,30,"(12.5744111,-81.703935)"
2012,Junio,Costa Rica,188,2,3,,5,"(12.586067,-81.702563)"
2012,Junio,Costa Rica,188,39,41,,80,"(3.541112,-76.384584)"
2012,Junio,Costa Rica,188,811,966,,1777,"(4.697144,-74.140516)"
2012,Junio,Costa Rica,188,3,5,,8,"(4.815061,-75.736532)"
2012,Junio,Costa Rica,188,165,135,,300,"(6.171601,-75.427454)"
2012,Junio,Costa Rica,188,5,5,,10,"(7.128456,-73.183637)"
2012,Junio,Costa Rica,188,0,3,,3,"(7.927209,-72.507910)"
2012,Junio,Croacia,191,5,3,,8,"(4.697144,-74.140516)"
2012,Junio,Croacia,191,0,2,,2,"(6.171601,-75.427454)"
2012,Junio,Cuba,192,18,13,,31,"(10.445761,-75.516429)"
2012,Junio,Cuba,192,26,26,,52,"(10.886611,-74.776708)"
2012,Junio,Cuba,192,2,3,,5,"(12.586067,-81.702563)"
2012,Junio,Cuba,192,165,120,,285,"(3.541112,-76.384584)"
2012,Junio,Cuba,192,1095,832,,1927,"(4.697144,-74.140516)"
2012,Junio,Cuba,192,32,34,,66,"(4.815061,-75.736532)"
2012,Junio,Cuba,192,263,148,,411,"(6.171601,-75.427454)"
2012,Junio,Cuba,192,13,9,,22,"(7.128456,-73.183637)"
2012,Junio,Cuba,192,2,3,,5,"(7.927209,-72.507910)"
2012,Junio,Curazao,99999,6,5,,11,"(10.886611,-74.776708)"
2012,Junio,Curazao,99999,0,1,,1,"(11.247723,-74.213989)"
2012,Junio,Curazao,99999,7,2,,9,"(3.541112,-76.384584)"
2012,Junio,Curazao,99999,497,429,,926,"(4.697144,-74.140516)"
2012,Junio,Curazao,99999,2,3,,5,"(4.815061,-75.736532)"
2012,Junio,Curazao,99999,185,110,,295,"(6.171601,-75.427454)"
2012,Junio,República Checa,203,1,0,,1,"(3.541112,-76.384584)"
2012,Junio,República Checa,203,4,12,,16,"(4.697144,-74.140516)"
2012,Junio,República Checa,203,1,1,,2,"(6.171601,-75.427454)"
2012,Junio,Chile,152,14,18,,32,"(0.814836,-77.662532)"
2012,Junio,Chile,152,16,8,,24,"(10.445761,-75.516429)"
2012,Junio,Chile,152,23,14,,37,"(10.886611,-74.776708)"
2012,Junio,Chile,152,2,0,,2,"(12.586067,-81.702563)"
2012,Junio,Chile,152,304,219,,523,"(3.541112,-76.384584)"
2012,Junio,Chile,152,1966,1921,,3887,"(4.697144,-74.140516)"
2012,Junio,Chile,152,38,40,,78,"(4.815061,-75.736532)"
2012,Junio,Chile,152,156,112,,268,"(6.171601,-75.427454)"
2012,Junio,Chile,152,8,5,,13,"(7.128456,-73.183637)"
2012,Junio,Chile,152,1,1,,2,"(7.927209,-72.507910)"
2012,Junio,China,156,1,1,,2,"(10.445761,-75.516429)"
2012,Junio,China,156,1,4,,5,"(10.886611,-74.776708)"
2012,Junio,China,156,0,7,,7,"(3.541112,-76.384584)"
2012,Junio,China,156,270,404,,674,"(4.697144,-74.140516)"
2012,Junio,China,156,8,13,,21,"(6.171601,-75.427454)"
2012,Junio,Chipre,196,2,1,,3,"(4.697144,-74.140516)"
2012,Junio,Dinamarca,208,3,0,,3,"(3.541112,-76.384584)"
2012,Junio,Dinamarca,208,69,38,,107,"(4.697144,-74.140516)"
2012,Junio,Dinamarca,208,6,3,,9,"(6.171601,-75.427454)"
2012,Junio,Dominica,212,1,1,,2,"(4.697144,-74.140516)"
2012,Junio,Ecuador,218,583,786,,1369,"(0.25129,-76.875963)"
2012,Junio,Ecuador,218,9786,12037,,21823,"(0.814836,-77.662532)"
2012,Junio,Ecuador,218,143,131,,274,"(1.813928,-78.763924)"
2012,Junio,Ecuador,218,0,9,,9,"(10.445761,-75.516429)"
2012,Junio,Ecuador,218,11,15,,26,"(10.886611,-74.776708)"
2012,Junio,Ecuador,218,1,0,,1,"(12.586067,-81.702563)"
2012,Junio,Ecuador,218,1040,962,,2002,"(3.541112,-76.384584)"
2012,Junio,Ecuador,218,2488,4231,,6719,"(4.697144,-74.140516)"
2012,Junio,Ecuador,218,1,1,,2,"(4.815061,-75.736532)"
2012,Junio,Ecuador,218,596,623,,1219,"(6.171601,-75.427454)"
2012,Junio,Ecuador,218,4,8,,12,"(7.128456,-73.183637)"
2012,Junio,Ecuador,218,1,3,,4,"(7.927209,-72.507910)"
2012,Junio,Egipto,818,4,4,,8,"(0.814836,-77.662532)"
2012,Junio,Egipto,818,0,1,,1,"(3.541112,-76.384584)"
2012,Junio,Egipto,818,287,275,,562,"(4.697144,-74.140516)"
2012,Junio,Egipto,818,1,0,,1,"(6.171601,-75.427454)"
2012,Junio,El Salvador,222,2,1,,3,"(10.445761,-75.516429)"
2012,Junio,El Salvador,222,1,5,,6,"(10.886611,-74.776708)"
2012,Junio,El Salvador,222,0,1,,1,"(12.586067,-81.702563)"
2012,Junio,El Salvador,222,14,18,,32,"(3.541112,-76.384584)"
2012,Junio,El Salvador,222,963,1019,,1982,"(4.697144,-74.140516)"
2012,Junio,El Salvador,222,1,2,,3,"(4.815061,-75.736532)"
2012,Junio,El Salvador,222,14,23,,37,"(6.171601,-75.427454)"
2012,Junio,El Salvador,222,5,3,,8,"(7.128456,-73.183637)"
2012,Junio,Emiratos Árabes,784,2,0,,2,"(3.541112,-76.384584)"
2012,Junio,Emiratos Árabes,784,35,68,,103,"(4.697144,-74.140516)"
2012,Junio,Emiratos Árabes,784,1,2,,3,"(6.171601,-75.427454)"
2012,Junio,Eritrea,232,0,1,,1,"(4.697144,-74.140516)"
2012,Junio,Eslovaquia,703,0,4,,4,"(4.697144,-74.140516)"
2012,Junio,Eslovenia,705,3,0,,3,"(3.541112,-76.384584)"
2012,Junio,Eslovenia,705,4,1,,5,"(4.697144,-74.140516)"
2012,Junio,Eslovenia,705,1,0,,1,"(6.171601,-75.427454)"
2012,Junio,Estados Unidos de América,840,1974,1567,,3541,"(10.445761,-75.516429)"
2012,Junio,Estados Unidos de América,840,2437,1908,,4345,"(10.886611,-74.776708)"
2012,Junio,Estados Unidos de América,840,34,32,,66,"(12.586067,-81.702563)"
2012,Junio,Estados Unidos de América,840,5910,4360,,10270,"(3.541112,-76.384584)"
2012,Junio,Estados Unidos de América,840,485,402,,887,"(4.452882,-75.766298)"
2012,Junio,Estados Unidos de América,840,36242,31348,,67590,"(4.697144,-74.140516)"
2012,Junio,Estados Unidos de América,840,282,196,,478,"(4.815061,-75.736532)"
2012,Junio,Estados Unidos de América,840,8457,6640,,15097,"(6.171601,-75.427454)"
2012,Junio,Estados Unidos de América,840,276,177,,453,"(7.128456,-73.183637)"
2012,Junio,Estados Unidos de América,840,34,34,,68,"(7.927209,-72.507910)"
2012,Junio,Estonia,233,1,4,,5,"(4.697144,-74.140516)"
2012,Junio,Estonia,233,1,0,,1,"(6.171601,-75.427454)"
2012,Junio,Etiopia,231,1,1,,2,"(4.697144,-74.140516)"
2012,Junio,Filipinas,608,2,0,,2,"(3.541112,-76.384584)"
2012,Junio,Filipinas,608,2,5,,7,"(4.697144,-74.140516)"
2012,Junio,Finlandia,246,1,0,,1,"(10.886611,-74.776708)"
2012,Junio,Finlandia,246,1,0,,1,"(3.541112,-76.384584)"
2012,Junio,Finlandia,246,11,23,,34,"(4.697144,-74.140516)"
2012,Junio,Finlandia,246,1,0,,1,"(6.171601,-75.427454)"
2012,Junio,Francia,250,3,1,,4,"(10.445761,-75.516429)"
2012,Junio,Francia,250,1,2,,3,"(10.886611,-74.776708)"
2012,Junio,Francia,250,49,39,,88,"(3.541112,-76.384584)"
2012,Junio,Francia,250,2068,1649,,3717,"(4.697144,-74.140516)"
2012,Junio,Francia,250,62,47,,109,"(6.171601,-75.427454)"
2012,Junio,Francia,250,2,1,,3,"(7.128456,-73.183637)"
2012,Junio,Georgia,268,0,1,,1,"(4.697144,-74.140516)"
2012,Junio,Grecia,300,32,45,,77,"(4.697144,-74.140516)"
2012,Junio,Grecia,300,5,1,,6,"(6.171601,-75.427454)"
2012,Junio,Guatemala,320,2,3,,5,"(10.445761,-75.516429)"
2012,Junio,Guatemala,320,2,18,,20,"(10.886611,-74.776708)"
2012,Junio,Guatemala,320,31,41,,72,"(3.541112,-76.384584)"
2012,Junio,Guatemala,320,135,230,,365,"(4.697144,-74.140516)"
2012,Junio,Guatemala,320,4,12,,16,"(4.815061,-75.736532)"
2012,Junio,Guatemala,320,59,102,,161,"(6.171601,-75.427454)"
2012,Junio,Guatemala,320,1,3,,4,"(7.128456,-73.183637)"
2012,Junio,Guyana,328,1,0,,1,"(10.886611,-74.776708)"
2012,Junio,Guyana,328,1,0,,1,"(4.697144,-74.140516)"
2012,Junio,Guinea,324,0,1,,1,"(3.541112,-76.384584)"
2012,Junio,Guinea,324,0,5,,5,"(4.697144,-74.140516)"
2012,Junio,Guinea,324,0,1,,1,"(6.171601,-75.427454)"
2012,Junio,Guinea Ecuatorial,226,0,1,,1,"(3.541112,-76.384584)"
2012,Junio,Guinea Ecuatorial,226,2,4,,6,"(4.697144,-74.140516)"
2012,Junio,Guadalupe/Territorio Francés,312,0,1,,1,"(4.697144,-74.140516)"
2012,Junio,Haití,332,1,0,,1,"(10.445761,-75.516429)"
2012,Junio,Haití,332,0,3,,3,"(10.886611,-74.776708)"
2012,Junio,Haití,332,0,1,,1,"(3.893038,-77.067921)"
2012,Junio,Haití,332,5,7,,12,"(4.697144,-74.140516)"
2012,Junio,Haití,332,0,3,,3,"(6.171601,-75.427454)"
2012,Junio,Honduras,340,0,8,,8,"(10.445761,-75.516429)"
2012,Junio,Honduras,340,1,13,,14,"(10.886611,-74.776708)"
2012,Junio,Honduras,340,0,2,,2,"(12.586067,-81.702563)"
2012,Junio,Honduras,340,27,40,,67,"(3.541112,-76.384584)"
2012,Junio,Honduras,340,62,153,,215,"(4.697144,-74.140516)"
2012,Junio,Honduras,340,2,0,,2,"(4.815061,-75.736532)"
2012,Junio,Honduras,340,43,68,,111,"(6.171601,-75.427454)"
2012,Junio,Honduras,340,0,3,,3,"(7.128456,-73.183637)"
2012,Junio,Hong Kong,344,0,1,,1,"(3.541112,-76.384584)"
2012,Junio,Hong Kong,344,34,59,,93,"(4.697144,-74.140516)"
2012,Junio,Hong Kong,344,0,2,,2,"(6.171601,-75.427454)"
2012,Junio,Hungría,348,8,10,,18,"(4.697144,-74.140516)"
2012,Junio,India,356,22,29,,51,"(4.697144,-74.140516)"
2012,Junio,Indonesia,360,5,7,,12,"(4.697144,-74.140516)"
2012,Junio,Iraq,368,1,12,,13,"(4.697144,-74.140516)"
2012,Junio,Irán,364,0,1,,1,"(4.697144,-74.140516)"
2012,Junio,República de Irlanda,372,2,2,,4,"(3.541112,-76.384584)"
2012,Junio,República de Irlanda,372,14,12,,26,"(4.697144,-74.140516)"
2012,Junio,República de Irlanda,372,1,0,,1,"(6.171601,-75.427454)"
2012,Junio,Islandia,352,1,0,,1,"(3.541112,-76.384584)"
2012,Junio,Islandia,352,2,3,,5,"(4.697144,-74.140516)"
2012,Junio,Isla de Man,833,1,0,,1,"(4.697144,-74.140516)"
2012,Junio,Israel,376,4,1,,5,"(3.541112,-76.384584)"
2012,Junio,Israel,376,249,143,,392,"(4.697144,-74.140516)"
2012,Junio,Israel,376,3,0,,3,"(6.171601,-75.427454)"
2012,Junio,Italia,380,11,6,,17,"(10.445761,-75.516429)"
2012,Junio,Italia,380,0,1,,1,"(10.886611,-74.776708)"
2012,Junio,Italia,380,109,38,,147,"(3.541112,-76.384584)"
2012,Junio,Italia,380,583,465,,1048,"(4.697144,-74.140516)"
2012,Junio,Italia,380,57,37,,94,"(6.171601,-75.427454)"
2012,Junio,Jamaica,388,2,2,,4,"(10.445761,-75.516429)"
2012,Junio,Jamaica,388,7,5,,12,"(3.541112,-76.384584)"
2012,Junio,Jamaica,388,42,44,,86,"(4.697144,-74.140516)"
2012,Junio,Jamaica,388,3,1,,4,"(4.815061,-75.736532)"
2012,Junio,Jamaica,388,161,97,,258,"(6.171601,-75.427454)"
2012,Junio,Jamaica,388,4,1,,5,"(7.927209,-72.507910)"
2012,Junio,Japón,392,1,0,,1,"(10.886611,-74.776708)"
2012,Junio,Japón,392,5,5,,10,"(3.541112,-76.384584)"
2012,Junio,Japón,392,61,69,,130,"(4.697144,-74.140516)"
2012,Junio,Japón,392,14,12,,26,"(6.171601,-75.427454)"
2012,Junio,Jordania,400,5,6,,11,"(4.697144,-74.140516)"
2012,Junio,Kazajistán,398,1,2,,3,"(4.697144,-74.140516)"
2012,Junio,Kenia,404,1,4,,5,"(4.697144,-74.140516)"
2012,Junio,Kenia,404,1,1,,2,"(6.171601,-75.427454)"
2012,Junio,Kuwait,414,1,1,,2,"(4.697144,-74.140516)"
2012,Junio,República de Kosovo,901,1,0,,1,"(4.697144,-74.140516)"
2012,Junio,Lituania,440,0,20,,20,"(4.697144,-74.140516)"
2012,Junio,Líbano,422,51,73,,124,"(4.697144,-74.140516)"
2012,Junio,Líbano,422,0,2,,2,"(6.171601,-75.427454)"
2012,Junio,Luxemburgo,442,6,2,,8,"(4.697144,-74.140516)"
2012,Junio,Madagascar,450,0,1,,1,"(4.697144,-74.140516)"
2012,Junio,Malasia,458,1,0,,1,"(3.541112,-76.384584)"
2012,Junio,Malasia,458,3,7,,10,"(4.697144,-74.140516)"
2012,Junio,Malasia,458,0,2,,2,"(6.171601,-75.427454)"
2012,Junio,Maldivas,462,0,1,,1,"(4.697144,-74.140516)"
2012,Junio,Malí,466,0,1,,1,"(10.445761,-75.516429)"
2012,Junio,Malta,470,3,5,,8,"(4.697144,-74.140516)"
2012,Junio,Marruecos,504,6,3,,9,"(4.697144,-74.140516)"
2012,Junio,Martinica/Departamento de Ultramar Francés,474,1,1,,2,"(3.541112,-76.384584)"
2012,Junio,Martinica/Departamento de Ultramar Francés,474,2,1,,3,"(4.697144,-74.140516)"
2012,Junio,México,484,22,24,,46,"(10.445761,-75.516429)"
2012,Junio,México,484,54,60,,114,"(10.886611,-74.776708)"
2012,Junio,México,484,3,2,,5,"(12.586067,-81.702563)"
2012,Junio,México,484,231,215,,446,"(3.541112,-76.384584)"
2012,Junio,México,484,6530,6085,,12615,"(4.697144,-74.140516)"
2012,Junio,México,484,18,22,,40,"(4.815061,-75.736532)"
2012,Junio,México,484,519,472,,991,"(6.171601,-75.427454)"
2012,Junio,México,484,25,26,,51,"(7.128456,-73.183637)"
2012,Junio,México,484,37,10,,47,"(7.927209,-72.507910)"
2012,Junio,República de Moldavia,498,0,1,,1,"(4.697144,-74.140516)"
2012,Junio,República de Moldavia,498,1,0,,1,"(6.171601,-75.427454)"
2012,Junio,Mozambique,508,1,0,,1,"(4.697144,-74.140516)"
2012,Junio,Nicaragua,558,1,2,,3,"(10.445761,-75.516429)"
2012,Junio,Nicaragua,558,5,3,,8,"(10.886611,-74.776708)"
2012,Junio,Nicaragua,558,0,1,,1,"(12.5744111,-81.703935)"
2012,Junio,Nicaragua,558,0,3,,3,"(12.586067,-81.702563)"
2012,Junio,Nicaragua,558,9,15,,24,"(3.541112,-76.384584)"
2012,Junio,Nicaragua,558,12,40,,52,"(4.697144,-74.140516)"
2012,Junio,Nicaragua,558,4,9,,13,"(6.171601,-75.427454)"
2012,Junio,Nicaragua,558,0,1,,1,"(7.128456,-73.183637)"
2012,Junio,Nicaragua,558,0,1,,1,"(7.927209,-72.507910)"
2012,Junio,Nigeria,566,2,17,,19,"(4.697144,-74.140516)"
2012,Junio,Noruega,578,1,1,,2,"(10.886611,-74.776708)"
2012,Junio,Noruega,578,1,1,,2,"(3.541112,-76.384584)"
2012,Junio,Noruega,578,34,28,,62,"(4.697144,-74.140516)"
2012,Junio,Noruega,578,2,0,,2,"(6.171601,-75.427454)"
2012,Junio,Nueva Caledonia/Territorio francés,540,0,1,,1,"(0.814836,-77.662532)"
2012,Junio,Nueva Zelanda,554,0,1,,1,"(3.541112,-76.384584)"
2012,Junio,Nueva Zelanda,554,11,11,,22,"(4.697144,-74.140516)"
2012,Junio,Nueva Zelanda,554,1,1,,2,"(6.171601,-75.427454)"
2012,Junio,Omán,512,1,3,,4,"(4.697144,-74.140516)"
2012,Junio,Papúa Nueva Guinea,598,0,10,,10,"(4.697144,-74.140516)"
2012,Junio,Pakistán,586,0,1,,1,"(4.697144,-74.140516)"
2012,Junio,Panamá,591,12,33,,45,"(10.408582,-75.538003)"
2012,Junio,Panamá,591,349,357,,706,"(10.445761,-75.516429)"
2012,Junio,Panamá,591,984,1055,,2039,"(10.886611,-74.776708)"
2012,Junio,Panamá,591,0,1,,1,"(10.971302,-74.765397)"
2012,Junio,Panamá,591,0,3,,3,"(11.247723,-74.213989)"
2012,Junio,Panamá,591,1,8,,9,"(12.5744111,-81.703935)"
2012,Junio,Panamá,591,93,104,,197,"(12.586067,-81.702563)"
2012,Junio,Panamá,591,1682,1603,,3285,"(3.541112,-76.384584)"
2012,Junio,Panamá,591,7839,8446,,16285,"(4.697144,-74.140516)"
2012,Junio,Panamá,591,747,545,,1292,"(4.815061,-75.736532)"
2012,Junio,Panamá,591,2901,2693,,5594,"(6.171601,-75.427454)"
2012,Junio,Panamá,591,12,19,,31,"(6.228046,-77.404104)"
2012,Junio,Panamá,591,404,319,,723,"(7.128456,-73.183637)"
2012,Junio,Panamá,591,245,217,,462,"(7.927209,-72.507910)"
2012,Junio,Panamá,591,38,67,,105,"(8.635765,-77.346578)"
2012,Junio,Paraguay,600,0,1,,1,"(0.814836,-77.662532)"
2012,Junio,Paraguay,600,1,1,,2,"(10.886611,-74.776708)"
2012,Junio,Paraguay,600,6,14,,20,"(3.541112,-76.384584)"
2012,Junio,Paraguay,600,27,95,,122,"(4.697144,-74.140516)"
2012,Junio,Paraguay,600,4,23,,27,"(6.171601,-75.427454)"
2012,Junio,Perú,604,91,174,,265,"(-4.197703,-69.941278)"
2012,Junio,Perú,604,24,29,,53,"(0.814836,-77.662532)"
2012,Junio,Perú,604,3,9,,12,"(10.445761,-75.516429)"
2012,Junio,Perú,604,18,9,,27,"(10.886611,-74.776708)"
2012,Junio,Perú,604,167,204,,371,"(3.541112,-76.384584)"
2012,Junio,Perú,604,3842,5030,,8872,"(4.697144,-74.140516)"
2012,Junio,Perú,604,8,13,,21,"(4.815061,-75.736532)"
2012,Junio,Perú,604,236,255,,491,"(6.171601,-75.427454)"
2012,Junio,Perú,604,21,18,,39,"(7.128456,-73.183637)"
2012,Junio,Perú,604,1,1,,2,"(7.818934,-72.453226)"
2012,Junio,Perú,604,2,0,,2,"(7.927209,-72.507910)"
2012,Junio,Palestina,99999,0,1,,1,"(6.171601,-75.427454)"
2012,Junio,Polonia,616,1,0,,1,"(10.445761,-75.516429)"
2012,Junio,Polonia,616,34,40,,74,"(4.697144,-74.140516)"
2012,Junio,Portugal,620,2,2,,4,"(3.541112,-76.384584)"
2012,Junio,Portugal,620,46,23,,69,"(4.697144,-74.140516)"
2012,Junio,Portugal,620,2,2,,4,"(6.171601,-75.427454)"
2012,Junio,Puerto Rico/Territorio de Estados Unidos,630,3,6,,9,"(10.445761,-75.516429)"
2012,Junio,Puerto Rico/Territorio de Estados Unidos,630,14,14,,28,"(10.886611,-74.776708)"
2012,Junio,Puerto Rico/Territorio de Estados Unidos,630,44,24,,68,"(3.541112,-76.384584)"
2012,Junio,Puerto Rico/Territorio de Estados Unidos,630,122,133,,255,"(4.697144,-74.140516)"
2012,Junio,Puerto Rico/Territorio de Estados Unidos,630,12,4,,16,"(4.815061,-75.736532)"
2012,Junio,Puerto Rico/Territorio de Estados Unidos,630,38,37,,75,"(6.171601,-75.427454)"
2012,Junio,Puerto Rico/Territorio de Estados Unidos,630,6,7,,13,"(7.128456,-73.183637)"
2012,Junio,Puerto Rico/Territorio de Estados Unidos,630,0,1,,1,"(7.927209,-72.507910)"
2012,Junio,Qatar,634,2,0,,2,"(4.697144,-74.140516)"
2012,Junio,Qatar,634,1,0,,1,"(6.171601,-75.427454)"
2012,Junio,Reino Unido de Gran Bretaña e Irlanda del Norte,826,1,3,,4,"(10.445761,-75.516429)"
2012,Junio,Reino Unido de Gran Bretaña e Irlanda del Norte,826,6,2,,8,"(10.886611,-74.776708)"
2012,Junio,Reino Unido de Gran Bretaña e Irlanda del Norte,826,1,1,,2,"(12.586067,-81.702563)"
2012,Junio,Reino Unido de Gran Bretaña e Irlanda del Norte,826,67,42,,109,"(3.541112,-76.384584)"
2012,Junio,Reino Unido de Gran Bretaña e Irlanda del Norte,826,932,614,,1546,"(4.697144,-74.140516)"
2012,Junio,Reino Unido de Gran Bretaña e Irlanda del Norte,826,60,38,,98,"(6.171601,-75.427454)"
2012,Junio,Federación de Rusia,643,0,1,,1,"(11.360009,-72.129330)"
2012,Junio,Federación de Rusia,643,0,1,,1,"(3.541112,-76.384584)"
2012,Junio,Federación de Rusia,643,133,143,,276,"(4.697144,-74.140516)"
2012,Junio,Federación de Rusia,643,1,0,,1,"(6.171601,-75.427454)"
2012,Junio,República Dominicana,214,6,10,,16,"(10.445761,-75.516429)"
2012,Junio,República Dominicana,214,70,43,,113,"(10.886611,-74.776708)"
2012,Junio,República Dominicana,214,331,293,,624,"(3.541112,-76.384584)"
2012,Junio,República Dominicana,214,1509,1432,,2941,"(4.697144,-74.140516)"
2012,Junio,República Dominicana,214,16,10,,26,"(4.815061,-75.736532)"
2012,Junio,República Dominicana,214,444,283,,727,"(6.171601,-75.427454)"
2012,Junio,República Dominicana,214,14,21,,35,"(7.128456,-73.183637)"
2012,Junio,República Dominicana,214,5,2,,7,"(7.927209,-72.507910)"
2012,Junio,Rumania,642,8,5,,13,"(4.697144,-74.140516)"
2012,Junio,Santo Tomé y Príncipe,678,0,1,,1,"(6.171601,-75.427454)"
2012,Junio,Serbia,688,2,0,,2,"(4.697144,-74.140516)"
2012,Junio,Singapur,702,17,26,,43,"(4.697144,-74.140516)"
2012,Junio,Singapur,702,0,1,,1,"(6.171601,-75.427454)"
2012,Junio,Sri Lanka,144,1,0,,1,"(4.697144,-74.140516)"
2012,Junio,Sudáfrica,710,0,1,,1,"(10.445761,-75.516429)"
2012,Junio,Sudáfrica,710,1,0,,1,"(10.886611,-74.776708)"
2012,Junio,Sudáfrica,710,9,21,,30,"(4.697144,-74.140516)"
2012,Junio,Sudán,736,2,0,,2,"(4.697144,-74.140516)"
2012,Junio,Sudán,736,0,1,,1,"(6.171601,-75.427454)"
2012,Junio,Suecia,752,1,0,,1,"(10.445761,-75.516429)"
2012,Junio,Suecia,752,2,1,,3,"(12.586067,-81.702563)"
2012,Junio,Suecia,752,6,5,,11,"(3.541112,-76.384584)"
2012,Junio,Suecia,752,81,85,,166,"(4.697144,-74.140516)"
2012,Junio,Suecia,752,0,1,,1,"(4.815061,-75.736532)"
2012,Junio,Suecia,752,7,5,,12,"(6.171601,-75.427454)"
2012,Junio,Suiza,756,2,1,,3,"(10.445761,-75.516429)"
2012,Junio,Suiza,756,50,19,,69,"(3.541112,-76.384584)"
2012,Junio,Suiza,756,252,162,,414,"(4.697144,-74.140516)"
2012,Junio,Suiza,756,12,11,,23,"(6.171601,-75.427454)"
2012,Junio,Surinam,740,4,5,,9,"(4.697144,-74.140516)"
2012,Junio,Surinam,740,2,1,,3,"(6.171601,-75.427454)"
2012,Junio,Taiwán,158,4,1,,5,"(4.697144,-74.140516)"
2012,Junio,Tailandia,764,32,35,,67,"(4.697144,-74.140516)"
2012,Junio,Togo,768,0,2,,2,"(4.697144,-74.140516)"
2012,Junio,Trinidad y Tobago,780,2,3,,5,"(10.445761,-75.516429)"
2012,Junio,Trinidad y Tobago,780,1,0,,1,"(10.886611,-74.776708)"
2012,Junio,Trinidad y Tobago,780,13,7,,20,"(3.541112,-76.384584)"
2012,Junio,Trinidad y Tobago,780,27,30,,57,"(4.697144,-74.140516)"
2012,Junio,Trinidad y Tobago,780,1,0,,1,"(4.815061,-75.736532)"
2012,Junio,Trinidad y Tobago,780,12,6,,18,"(6.171601,-75.427454)"
2012,Junio,Trinidad y Tobago,780,2,2,,4,"(7.128456,-73.183637)"
2012,Junio,Trinidad y Tobago,780,0,1,,1,"(7.927209,-72.507910)"
2012,Junio,Túnez,788,4,5,,9,"(4.697144,-74.140516)"
2012,Junio,Túnez,788,1,0,,1,"(7.818934,-72.453226)"
2012,Junio,Turquía,792,6,4,,10,"(3.541112,-76.384584)"
2012,Junio,Turquía,792,67,84,,151,"(4.697144,-74.140516)"
2012,Junio,Ucrania,804,0,1,,1,"(3.541112,-76.384584)"
2012,Junio,Ucrania,804,3,13,,16,"(4.697144,-74.140516)"
2012,Junio,Uganda,800,0,2,,2,"(3.541112,-76.384584)"
2012,Junio,Uganda,800,0,1,,1,"(4.697144,-74.140516)"
2012,Junio,Uruguay,858,0,1,,1,"(10.445761,-75.516429)"
2012,Junio,Uruguay,858,1,2,,3,"(10.886611,-74.776708)"
2012,Junio,Uruguay,858,0,4,,4,"(3.541112,-76.384584)"
2012,Junio,Uruguay,858,48,66,,114,"(4.697144,-74.140516)"
2012,Junio,Uruguay,858,5,6,,11,"(6.171601,-75.427454)"
2012,Junio,Uruguay,858,0,1,,1,"(7.128456,-73.183637)"
2012,Junio,Venezuela,862,7,11,,18,"(10.445761,-75.516429)"
2012,Junio,Venezuela,862,11,20,,31,"(10.886611,-74.776708)"
2012,Junio,Venezuela,862,7752,6969,,14721,"(11.360009,-72.129330)"
2012,Junio,Venezuela,862,1,2,,3,"(12.586067,-81.702563)"
2012,Junio,Venezuela,862,18,10,,28,"(3.541112,-76.384584)"
2012,Junio,Venezuela,862,2701,3312,,6013,"(4.697144,-74.140516)"
2012,Junio,Venezuela,862,2,2,,4,"(4.815061,-75.736532)"
2012,Junio,Venezuela,862,334,366,,700,"(6.171601,-75.427454)"
2012,Junio,Venezuela,862,194,221,,415,"(6.185799,-67.483929)"
2012,Junio,Venezuela,862,1512,1382,,2894,"(7.088729,-70.740253)"
2012,Junio,Venezuela,862,144,104,,248,"(7.128456,-73.183637)"
2012,Junio,Venezuela,862,8618,8237,,16855,"(7.818934,-72.453226)"
2012,Junio,Venezuela,862,0,1,,1,"(7.927209,-72.507910)"
2012,Junio,Vietnam,704,2,3,,5,"(4.697144,-74.140516)"
2012,Junio,República Árabe de Yemen,887,1,0,,1,"(3.541112,-76.384584)"
2012,Junio,República Árabe de Yemen,887,0,1,,1,"(4.697144,-74.140516)"
2012,Junio,Zambia,894,0,1,,1,"(10.886611,-74.776708)"
2012,Junio,Anguila/Territorio Británico de Ultramar,660,1,0,,1,"(6.171601,-75.427454)"
2012,Junio,Desconocido,99999,1,0,,1,"(3.541112,-76.384584)"
2012,Junio,Desconocido,99999,6,11,,17,"(4.697144,-74.140516)"
2012,Junio,Desconocido,99999,0,1,,1,"(6.171601,-75.427454)"
2012,Julio,Afganistán,4,0,1,,1,"(10.886611,-74.776708)"
2012,Julio,Afganistán,4,5,29,,34,"(4.697144,-74.140516)"
2012,Julio,Albania,8,1,0,,1,"(4.697144,-74.140516)"
2012,Julio,Alemania,276,2,0,,2,"(0.814836,-77.662532)"
2012,Julio,Alemania,276,1,1,,2,"(10.445761,-75.516429)"
2012,Julio,Alemania,276,0,1,,1,"(10.886611,-74.776708)"
2012,Julio,Alemania,276,46,31,,77,"(3.541112,-76.384584)"
2012,Julio,Alemania,276,1053,887,,1940,"(4.697144,-74.140516)"
2012,Julio,Alemania,276,21,6,,27,"(6.171601,-75.427454)"
2012,Julio,Alemania,276,0,1,,1,"(7.128456,-73.183637)"
2012,Julio,Andorra,20,0,1,,1,"(4.697144,-74.140516)"
2012,Julio,Angola,24,2,11,,13,"(4.697144,-74.140516)"
2012,Julio,Antigua y Barbuda,28,1,5,,6,"(4.697144,-74.140516)"
2012,Julio,Países Bajos,528,1,2,,3,"(10.445761,-75.516429)"
2012,Julio,Países Bajos,528,5,2,,7,"(10.886611,-74.776708)"
2012,Julio,Países Bajos,528,0,1,,1,"(12.586067,-81.702563)"
2012,Julio,Países Bajos,528,40,21,,61,"(3.541112,-76.384584)"
2012,Julio,Países Bajos,528,188,123,,311,"(4.697144,-74.140516)"
2012,Julio,Países Bajos,528,7,6,,13,"(4.815061,-75.736532)"
2012,Julio,Países Bajos,528,39,23,,62,"(6.171601,-75.427454)"
2012,Julio,Países Bajos,528,2,0,,2,"(7.128456,-73.183637)"
2012,Julio,Arabia Saudita,682,0,1,,1,"(10.445761,-75.516429)"
2012,Julio,Arabia Saudita,682,1,22,,23,"(4.697144,-74.140516)"
2012,Julio,Arabia Saudita,682,3,4,,7,"(6.171601,-75.427454)"
2012,Julio,Argelia,12,0,1,,1,"(3.541112,-76.384584)"
2012,Julio,Argelia,12,2,8,,10,"(4.697144,-74.140516)"
2012,Julio,Argelia,12,0,1,,1,"(7.128456,-73.183637)"
2012,Julio,Argentina,32,0,4,,4,"(0.25129,-76.875963)"
2012,Julio,Argentina,32,16,30,,46,"(0.814836,-77.662532)"
2012,Julio,Argentina,32,9,6,,15,"(10.445761,-75.516429)"
2012,Julio,Argentina,32,43,33,,76,"(10.886611,-74.776708)"
2012,Julio,Argentina,32,2,1,,3,"(12.586067,-81.702563)"
2012,Julio,Argentina,32,128,115,,243,"(3.541112,-76.384584)"
2012,Julio,Argentina,32,2391,2530,,4921,"(4.697144,-74.140516)"
2012,Julio,Argentina,32,11,26,,37,"(4.815061,-75.736532)"
2012,Julio,Argentina,32,156,113,,269,"(6.171601,-75.427454)"
2012,Julio,Argentina,32,11,7,,18,"(7.128456,-73.183637)"
2012,Julio,Argentina,32,0,4,,4,"(7.818934,-72.453226)"
2012,Julio,Argentina,32,0,1,,1,"(7.927209,-72.507910)"
2012,Julio,Aruba,533,1,1,,2,"(10.445761,-75.516429)"
2012,Julio,Aruba,533,20,12,,32,"(10.886611,-74.776708)"
2012,Julio,Aruba,533,114,83,,197,"(11.528919,-72.919681)"
2012,Julio,Aruba,533,41,30,,71,"(3.541112,-76.384584)"
2012,Julio,Aruba,533,991,903,,1894,"(4.697144,-74.140516)"
2012,Julio,Aruba,533,3,2,,5,"(4.815061,-75.736532)"
2012,Julio,Aruba,533,49,31,,80,"(6.171601,-75.427454)"
2012,Julio,Aruba,533,9,22,,31,"(7.128456,-73.183637)"
2012,Julio,Australia,36,1,0,,1,"(10.445761,-75.516429)"
2012,Julio,Australia,36,3,2,,5,"(10.886611,-74.776708)"
2012,Julio,Australia,36,10,8,,18,"(3.541112,-76.384584)"
2012,Julio,Australia,36,238,165,,403,"(4.697144,-74.140516)"
2012,Julio,Australia,36,21,18,,39,"(6.171601,-75.427454)"
2012,Julio,Australia,36,1,0,,1,"(7.128456,-73.183637)"
2012,Julio,Austria,40,0,1,,1,"(3.541112,-76.384584)"
2012,Julio,Austria,40,59,53,,112,"(4.697144,-74.140516)"
2012,Julio,Austria,40,1,0,,1,"(6.171601,-75.427454)"
2012,Julio,Azerbaiyán,31,0,3,,3,"(4.697144,-74.140516)"
2012,Julio,Bahamas,44,7,5,,12,"(10.445761,-75.516429)"
2012,Julio,Bahamas,44,2,4,,6,"(10.886611,-74.776708)"
2012,Julio,Bahamas,44,54,32,,86,"(3.541112,-76.384584)"
2012,Julio,Bahamas,44,53,57,,110,"(4.697144,-74.140516)"
2012,Julio,Bahamas,44,5,5,,10,"(4.815061,-75.736532)"
2012,Julio,Bahamas,44,31,25,,56,"(6.171601,-75.427454)"
2012,Julio,Bahamas,44,3,1,,4,"(7.927209,-72.507910)"
2012,Julio,Bahréin,48,1,4,,5,"(4.697144,-74.140516)"
2012,Julio,Barbados,52,0,1,,1,"(3.541112,-76.384584)"
2012,Julio,Barbados,52,2,6,,8,"(4.697144,-74.140516)"
2012,Julio,Barbados,52,1,2,,3,"(6.171601,-75.427454)"
2012,Julio,Barbados,52,2,3,,5,"(7.128456,-73.183637)"
2012,Julio,República de Belarús,112,1,0,,1,"(11.360009,-72.129330)"
2012,Julio,República de Belarús,112,2,1,,3,"(3.541112,-76.384584)"
2012,Julio,República de Belarús,112,3,1,,4,"(4.697144,-74.140516)"
2012,Julio,República de Belarús,112,3,2,,5,"(7.818934,-72.453226)"
2012,Julio,Bélgica,56,2,0,,2,"(10.445761,-75.516429)"
2012,Julio,Bélgica,56,13,11,,24,"(3.541112,-76.384584)"
2012,Julio,Bélgica,56,108,72,,180,"(4.697144,-74.140516)"
2012,Julio,Bélgica,56,6,5,,11,"(6.171601,-75.427454)"
2012,Julio,Belice,84,1,1,,2,"(3.541112,-76.384584)"
2012,Julio,Belice,84,2,1,,3,"(4.697144,-74.140516)"
2012,Julio,Benín,204,1,4,,5,"(4.697144,-74.140516)"
2012,Julio,Bermudas/Territorio Británico de Ultramar,60,3,1,,4,"(4.697144,-74.140516)"
2012,Julio,Bermudas/Territorio Británico de Ultramar,60,1,0,,1,"(4.815061,-75.736532)"
2012,Julio,Bolivia,68,2,6,,8,"(0.814836,-77.662532)"
2012,Julio,Bolivia,68,0,1,,1,"(10.445761,-75.516429)"
2012,Julio,Bolivia,68,1,3,,4,"(10.886611,-74.776708)"
2012,Julio,Bolivia,68,21,29,,50,"(3.541112,-76.384584)"
2012,Julio,Bolivia,68,189,291,,480,"(4.697144,-74.140516)"
2012,Julio,Bolivia,68,7,19,,26,"(6.171601,-75.427454)"
2012,Julio,Brasil,76,100,131,,231,"(-4.197703,-69.941278)"
2012,Julio,Brasil,76,0,1,,1,"(0.814836,-77.662532)"
2012,Julio,Brasil,76,5,7,,12,"(10.445761,-75.516429)"
2012,Julio,Brasil,76,11,14,,25,"(10.886611,-74.776708)"
2012,Julio,Brasil,76,3,1,,4,"(12.586067,-81.702563)"
2012,Julio,Brasil,76,29,30,,59,"(3.541112,-76.384584)"
2012,Julio,Brasil,76,2018,2864,,4882,"(4.697144,-74.140516)"
2012,Julio,Brasil,76,1,3,,4,"(4.815061,-75.736532)"
2012,Julio,Brasil,76,43,88,,131,"(6.171601,-75.427454)"
2012,Julio,Brasil,76,2,1,,3,"(7.128456,-73.183637)"
2012,Julio,Bulgaria,100,0,1,,1,"(4.697144,-74.140516)"
2012,Julio,Islas Caimán/Territorio Británico de Ultramar,136,1,1,,2,"(10.445761,-75.516429)"
2012,Julio,Islas Caimán/Territorio Británico de Ultramar,136,1,0,,1,"(10.886611,-74.776708)"
2012,Julio,Islas Caimán/Territorio Británico de Ultramar,136,24,13,,37,"(12.586067,-81.702563)"
2012,Julio,Islas Caimán/Territorio Británico de Ultramar,136,1,0,,1,"(3.541112,-76.384584)"
2012,Julio,Islas Caimán/Territorio Británico de Ultramar,136,1,1,,2,"(6.171601,-75.427454)"
2012,Julio,Camboya,116,1,1,,2,"(4.697144,-74.140516)"
2012,Julio,Camerún,120,0,1,,1,"(4.697144,-74.140516)"
2012,Julio,Camerún,120,1,0,,1,"(6.171601,-75.427454)"
2012,Julio,Canadá,124,16,12,,28,"(10.445761,-75.516429)"
2012,Julio,Canadá,124,14,7,,21,"(10.886611,-74.776708)"
2012,Julio,Canadá,124,69,44,,113,"(3.541112,-76.384584)"
2012,Julio,Canadá,124,1,3,,4,"(4.452882,-75.766298)"
2012,Julio,Canadá,124,1859,1650,,3509,"(4.697144,-74.140516)"
2012,Julio,Canadá,124,2,0,,2,"(4.815061,-75.736532)"
2012,Julio,Canadá,124,112,111,,223,"(6.171601,-75.427454)"
2012,Julio,Canadá,124,3,3,,6,"(7.128456,-73.183637)"
2012,Julio,Canadá,124,1,0,,1,"(7.927209,-72.507910)"
2012,Julio,Chad,148,1,0,,1,"(4.697144,-74.140516)"
2012,Julio,España,724,4,2,,6,"(10.445761,-75.516429)"
2012,Julio,España,724,3,5,,8,"(10.886611,-74.776708)"
2012,Julio,España,724,1631,1015,,2646,"(3.541112,-76.384584)"
2012,Julio,España,724,0,3,,3,"(4.452882,-75.766298)"
2012,Julio,España,724,6574,4963,,11537,"(4.697144,-74.140516)"
2012,Julio,España,724,0,2,,2,"(4.815061,-75.736532)"
2012,Julio,España,724,484,369,,853,"(6.171601,-75.427454)"
2012,Julio,España,724,0,1,,1,"(7.128456,-73.183637)"
2012,Julio,República Democrática del Congo,180,0,2,,2,"(4.697144,-74.140516)"
2012,Julio,República Democrática del Congo,180,0,2,,2,"(6.171601,-75.427454)"
2012,Julio,República de Corea,410,0,1,,1,"(3.541112,-76.384584)"
2012,Julio,República de Corea,410,14,20,,34,"(4.697144,-74.140516)"
2012,Julio,Costa de Marfil,384,0,1,,1,"(4.697144,-74.140516)"
2012,Julio,Costa Rica,188,0,5,,5,"(10.408582,-75.538003)"
2012,Julio,Costa Rica,188,9,15,,24,"(10.445761,-75.516429)"
2012,Julio,Costa Rica,188,23,28,,51,"(10.886611,-74.776708)"
2012,Julio,Costa Rica,188,3,31,,34,"(12.5744111,-81.703935)"
2012,Julio,Costa Rica,188,7,6,,13,"(12.586067,-81.702563)"
2012,Julio,Costa Rica,188,74,55,,129,"(3.541112,-76.384584)"
2012,Julio,Costa Rica,188,735,906,,1641,"(4.697144,-74.140516)"
2012,Julio,Costa Rica,188,6,2,,8,"(4.815061,-75.736532)"
2012,Julio,Costa Rica,188,188,201,,389,"(6.171601,-75.427454)"
2012,Julio,Costa Rica,188,5,6,,11,"(7.128456,-73.183637)"
2012,Julio,Costa Rica,188,0,1,,1,"(7.927209,-72.507910)"
2012,Julio,Croacia,191,2,0,,2,"(4.697144,-74.140516)"
2012,Julio,Cuba,192,20,25,,45,"(10.445761,-75.516429)"
2012,Julio,Cuba,192,14,13,,27,"(10.886611,-74.776708)"
2012,Julio,Cuba,192,2,2,,4,"(12.586067,-81.702563)"
2012,Julio,Cuba,192,292,186,,478,"(3.541112,-76.384584)"
2012,Julio,Cuba,192,885,714,,1599,"(4.697144,-74.140516)"
2012,Julio,Cuba,192,3,1,,4,"(4.815061,-75.736532)"
2012,Julio,Cuba,192,130,114,,244,"(6.171601,-75.427454)"
2012,Julio,Cuba,192,24,14,,38,"(7.128456,-73.183637)"
2012,Julio,Curazao,99999,1,0,,1,"(10.445761,-75.516429)"
2012,Julio,Curazao,99999,6,4,,10,"(10.886611,-74.776708)"
2012,Julio,Curazao,99999,22,15,,37,"(3.541112,-76.384584)"
2012,Julio,Curazao,99999,593,554,,1147,"(4.697144,-74.140516)"
2012,Julio,Curazao,99999,1,0,,1,"(4.815061,-75.736532)"
2012,Julio,Curazao,99999,116,64,,180,"(6.171601,-75.427454)"
2012,Julio,Curazao,99999,2,1,,3,"(7.128456,-73.183637)"
2012,Julio,Curazao,99999,1,0,,1,"(7.927209,-72.507910)"
2012,Julio,República Checa,203,1,2,,3,"(3.541112,-76.384584)"
2012,Julio,República Checa,203,11,6,,17,"(4.697144,-74.140516)"
2012,Julio,República Checa,203,0,1,,1,"(6.171601,-75.427454)"
2012,Julio,Chile,152,18,18,,36,"(0.814836,-77.662532)"
2012,Julio,Chile,152,3,9,,12,"(10.445761,-75.516429)"
2012,Julio,Chile,152,25,23,,48,"(10.886611,-74.776708)"
2012,Julio,Chile,152,3,2,,5,"(12.586067,-81.702563)"
2012,Julio,Chile,152,221,188,,409,"(3.541112,-76.384584)"
2012,Julio,Chile,152,1974,1996,,3970,"(4.697144,-74.140516)"
2012,Julio,Chile,152,32,25,,57,"(4.815061,-75.736532)"
2012,Julio,Chile,152,89,81,,170,"(6.171601,-75.427454)"
2012,Julio,Chile,152,15,13,,28,"(7.128456,-73.183637)"
2012,Julio,China,156,1,5,,6,"(3.541112,-76.384584)"
2012,Julio,China,156,199,401,,600,"(4.697144,-74.140516)"
2012,Julio,China,156,9,12,,21,"(6.171601,-75.427454)"
2012,Julio,Chipre,196,1,2,,3,"(6.171601,-75.427454)"
2012,Julio,Dinamarca,208,1,3,,4,"(3.541112,-76.384584)"
2012,Julio,Dinamarca,208,19,20,,39,"(4.697144,-74.140516)"
2012,Julio,Dinamarca,208,2,0,,2,"(6.171601,-75.427454)"
2012,Julio,Dinamarca,208,1,0,,1,"(7.128456,-73.183637)"
2012,Julio,Dominica,212,5,2,,7,"(4.697144,-74.140516)"
2012,Julio,Ecuador,218,650,773,,1423,"(0.25129,-76.875963)"
2012,Julio,Ecuador,218,12548,11811,,24359,"(0.814836,-77.662532)"
2012,Julio,Ecuador,218,124,124,,248,"(1.813928,-78.763924)"
2012,Julio,Ecuador,218,8,6,,14,"(10.445761,-75.516429)"
2012,Julio,Ecuador,218,5,8,,13,"(10.886611,-74.776708)"
2012,Julio,Ecuador,218,1,2,,3,"(12.586067,-81.702563)"
2012,Julio,Ecuador,218,846,843,,1689,"(3.541112,-76.384584)"
2012,Julio,Ecuador,218,2220,3757,,5977,"(4.697144,-74.140516)"
2012,Julio,Ecuador,218,1,2,,3,"(4.815061,-75.736532)"
2012,Julio,Ecuador,218,485,584,,1069,"(6.171601,-75.427454)"
2012,Julio,Ecuador,218,6,7,,13,"(7.128456,-73.183637)"
2012,Julio,Ecuador,218,2,1,,3,"(7.927209,-72.507910)"
2012,Julio,Egipto,818,1,1,,2,"(10.886611,-74.776708)"
2012,Julio,Egipto,818,68,60,,128,"(4.697144,-74.140516)"
2012,Julio,El Salvador,222,3,5,,8,"(10.445761,-75.516429)"
2012,Julio,El Salvador,222,7,9,,16,"(10.886611,-74.776708)"
2012,Julio,El Salvador,222,0,1,,1,"(12.586067,-81.702563)"
2012,Julio,El Salvador,222,54,45,,99,"(3.541112,-76.384584)"
2012,Julio,El Salvador,222,864,923,,1787,"(4.697144,-74.140516)"
2012,Julio,El Salvador,222,21,36,,57,"(6.171601,-75.427454)"
2012,Julio,El Salvador,222,0,1,,1,"(7.128456,-73.183637)"
2012,Julio,Emiratos Árabes,784,3,1,,4,"(3.541112,-76.384584)"
2012,Julio,Emiratos Árabes,784,44,111,,155,"(4.697144,-74.140516)"
2012,Julio,Emiratos Árabes,784,7,9,,16,"(6.171601,-75.427454)"
2012,Julio,Eritrea,232,0,1,,1,"(4.697144,-74.140516)"
2012,Julio,Eslovenia,705,0,1,,1,"(10.886611,-74.776708)"
2012,Julio,Eslovenia,705,1,0,,1,"(3.541112,-76.384584)"
2012,Julio,Eslovenia,705,3,1,,4,"(4.697144,-74.140516)"
2012,Julio,Estados Unidos de América,840,1902,1752,,3654,"(10.445761,-75.516429)"
2012,Julio,Estados Unidos de América,840,2309,2174,,4483,"(10.886611,-74.776708)"
2012,Julio,Estados Unidos de América,840,34,32,,66,"(12.586067,-81.702563)"
2012,Julio,Estados Unidos de América,840,6085,4451,,10536,"(3.541112,-76.384584)"
2012,Julio,Estados Unidos de América,840,528,434,,962,"(4.452882,-75.766298)"
2012,Julio,Estados Unidos de América,840,31662,28079,,59741,"(4.697144,-74.140516)"
2012,Julio,Estados Unidos de América,840,285,185,,470,"(4.815061,-75.736532)"
2012,Julio,Estados Unidos de América,840,6287,5000,,11287,"(6.171601,-75.427454)"
2012,Julio,Estados Unidos de América,840,123,91,,214,"(7.128456,-73.183637)"
2012,Julio,Estados Unidos de América,840,8,10,,18,"(7.927209,-72.507910)"
2012,Julio,Estonia,233,0,3,,3,"(3.541112,-76.384584)"
2012,Julio,Etiopia,231,1,1,,2,"(4.697144,-74.140516)"
2012,Julio,Filipinas,608,8,6,,14,"(4.697144,-74.140516)"
2012,Julio,Filipinas,608,1,0,,1,"(6.171601,-75.427454)"
2012,Julio,Finlandia,246,7,4,,11,"(4.697144,-74.140516)"
2012,Julio,Francia,250,0,1,,1,"(10.445761,-75.516429)"
2012,Julio,Francia,250,3,0,,3,"(10.886611,-74.776708)"
2012,Julio,Francia,250,38,23,,61,"(3.541112,-76.384584)"
2012,Julio,Francia,250,1668,1323,,2991,"(4.697144,-74.140516)"
2012,Julio,Francia,250,39,21,,60,"(6.171601,-75.427454)"
2012,Julio,Gabón,266,1,4,,5,"(4.697144,-74.140516)"
2012,Julio,Georgia,268,6,1,,7,"(4.697144,-74.140516)"
2012,Julio,Ghana,288,3,3,,6,"(4.697144,-74.140516)"
2012,Julio,Granada,308,0,1,,1,"(4.697144,-74.140516)"
2012,Julio,Grecia,300,11,10,,21,"(4.697144,-74.140516)"
2012,Julio,Grecia,300,3,1,,4,"(6.171601,-75.427454)"
2012,Julio,Guatemala,320,1,8,,9,"(10.445761,-75.516429)"
2012,Julio,Guatemala,320,10,17,,27,"(10.886611,-74.776708)"
2012,Julio,Guatemala,320,37,63,,100,"(3.541112,-76.384584)"
2012,Julio,Guatemala,320,168,246,,414,"(4.697144,-74.140516)"
2012,Julio,Guatemala,320,7,11,,18,"(4.815061,-75.736532)"
2012,Julio,Guatemala,320,69,102,,171,"(6.171601,-75.427454)"
2012,Julio,Guatemala,320,3,2,,5,"(7.128456,-73.183637)"
2012,Julio,Guyana,328,0,1,,1,"(10.886611,-74.776708)"
2012,Julio,Guyana,328,0,8,,8,"(10.971302,-74.765397)"
2012,Julio,Guyana,328,2,1,,3,"(3.541112,-76.384584)"
2012,Julio,Guyana,328,1,1,,2,"(4.697144,-74.140516)"
2012,Julio,Guyana,328,1,1,,2,"(6.171601,-75.427454)"
2012,Julio,Guinea,324,0,7,,7,"(4.697144,-74.140516)"
2012,Julio,Guinea Ecuatorial,226,4,11,,15,"(4.697144,-74.140516)"
2012,Julio,Haití,332,0,6,,6,"(10.886611,-74.776708)"
2012,Julio,Haití,332,0,1,,1,"(3.541112,-76.384584)"
2012,Julio,Haití,332,5,18,,23,"(4.697144,-74.140516)"
2012,Julio,Haití,332,1,5,,6,"(6.171601,-75.427454)"
2012,Julio,Honduras,340,2,8,,10,"(10.445761,-75.516429)"
2012,Julio,Honduras,340,6,13,,19,"(10.886611,-74.776708)"
2012,Julio,Honduras,340,0,11,,11,"(12.5744111,-81.703935)"
2012,Julio,Honduras,340,1,1,,2,"(12.586067,-81.702563)"
2012,Julio,Honduras,340,14,28,,42,"(3.541112,-76.384584)"
2012,Julio,Honduras,340,67,154,,221,"(4.697144,-74.140516)"
2012,Julio,Honduras,340,1,2,,3,"(4.815061,-75.736532)"
2012,Julio,Honduras,340,32,59,,91,"(6.171601,-75.427454)"
2012,Julio,Honduras,340,0,1,,1,"(7.128456,-73.183637)"
2012,Julio,Honduras,340,1,2,,3,"(7.927209,-72.507910)"
2012,Julio,Hong Kong,344,27,47,,74,"(4.697144,-74.140516)"
2012,Julio,Hong Kong,344,1,1,,2,"(6.171601,-75.427454)"
2012,Julio,Hungría,348,1,0,,1,"(3.541112,-76.384584)"
2012,Julio,Hungría,348,4,6,,10,"(4.697144,-74.140516)"
2012,Julio,India,356,1,0,,1,"(3.541112,-76.384584)"
2012,Julio,India,356,49,49,,98,"(4.697144,-74.140516)"
2012,Julio,India,356,2,0,,2,"(6.171601,-75.427454)"
2012,Julio,Indonesia,360,6,8,,14,"(4.697144,-74.140516)"
2012,Julio,Iraq,368,0,1,,1,"(3.541112,-76.384584)"
2012,Julio,Iraq,368,1,9,,10,"(4.697144,-74.140516)"
2012,Julio,Irán,364,4,7,,11,"(4.697144,-74.140516)"
2012,Julio,República de Irlanda,372,3,3,,6,"(3.541112,-76.384584)"
2012,Julio,República de Irlanda,372,15,15,,30,"(4.697144,-74.140516)"
2012,Julio,República de Irlanda,372,2,0,,2,"(6.171601,-75.427454)"
2012,Julio,Islandia,352,0,1,,1,"(4.697144,-74.140516)"
2012,Julio,Isla de Man,833,0,1,,1,"(4.697144,-74.140516)"
2012,Julio,Isla de Man,833,1,0,,1,"(6.171601,-75.427454)"
2012,Julio,Israel,376,0,1,,1,"(10.445761,-75.516429)"
2012,Julio,Israel,376,0,2,,2,"(10.886611,-74.776708)"
2012,Julio,Israel,376,2,3,,5,"(3.541112,-76.384584)"
2012,Julio,Israel,376,150,115,,265,"(4.697144,-74.140516)"
2012,Julio,Israel,376,2,0,,2,"(6.171601,-75.427454)"
2012,Julio,Italia,380,1,2,,3,"(10.445761,-75.516429)"
2012,Julio,Italia,380,0,1,,1,"(10.886611,-74.776708)"
2012,Julio,Italia,380,0,1,,1,"(12.586067,-81.702563)"
2012,Julio,Italia,380,125,46,,171,"(3.541112,-76.384584)"
2012,Julio,Italia,380,584,414,,998,"(4.697144,-74.140516)"
2012,Julio,Italia,380,37,23,,60,"(6.171601,-75.427454)"
2012,Julio,Italia,380,1,1,,2,"(7.128456,-73.183637)"
2012,Julio,Jamaica,388,0,2,,2,"(10.408582,-75.538003)"
2012,Julio,Jamaica,388,1,3,,4,"(10.886611,-74.776708)"
2012,Julio,Jamaica,388,11,12,,23,"(3.541112,-76.384584)"
2012,Julio,Jamaica,388,32,39,,71,"(4.697144,-74.140516)"
2012,Julio,Jamaica,388,2,1,,3,"(4.815061,-75.736532)"
2012,Julio,Jamaica,388,19,13,,32,"(6.171601,-75.427454)"
2012,Julio,Jamaica,388,1,1,,2,"(7.128456,-73.183637)"
2012,Julio,Islas Marianas del Norte,580,1,0,,1,"(10.445761,-75.516429)"
2012,Julio,Japón,392,4,2,,6,"(3.541112,-76.384584)"
2012,Julio,Japón,392,40,56,,96,"(4.697144,-74.140516)"
2012,Julio,Japón,392,8,5,,13,"(6.171601,-75.427454)"
2012,Julio,Jordania,400,5,6,,11,"(4.697144,-74.140516)"
2012,Julio,Kazajistán,398,0,4,,4,"(4.697144,-74.140516)"
2012,Julio,Kenia,404,2,0,,2,"(3.541112,-76.384584)"
2012,Julio,Kenia,404,7,3,,10,"(4.697144,-74.140516)"
2012,Julio,Kenia,404,1,1,,2,"(6.171601,-75.427454)"
2012,Julio,Kuwait,414,2,3,,5,"(4.697144,-74.140516)"
2012,Julio,Lituania,440,1,1,,2,"(3.541112,-76.384584)"
2012,Julio,Lituania,440,1,17,,18,"(4.697144,-74.140516)"
2012,Julio,Líbano,422,28,34,,62,"(4.697144,-74.140516)"
2012,Julio,Luxemburgo,442,2,4,,6,"(4.697144,-74.140516)"
2012,Julio,Macao,446,0,1,,1,"(4.697144,-74.140516)"
2012,Julio,Madagascar,450,1,2,,3,"(4.697144,-74.140516)"
2012,Julio,Malasia,458,1,3,,4,"(4.697144,-74.140516)"
2012,Julio,Malta,470,6,3,,9,"(4.697144,-74.140516)"
2012,Julio,Marruecos,504,1,2,,3,"(4.697144,-74.140516)"
2012,Julio,Martinica/Departamento de Ultramar Francés,474,0,4,,4,"(4.697144,-74.140516)"
2012,Julio,México,484,19,22,,41,"(10.445761,-75.516429)"
2012,Julio,México,484,39,23,,62,"(10.886611,-74.776708)"
2012,Julio,México,484,3,0,,3,"(12.586067,-81.702563)"
2012,Julio,México,484,371,315,,686,"(3.541112,-76.384584)"
2012,Julio,México,484,4880,4922,,9802,"(4.697144,-74.140516)"
2012,Julio,México,484,31,29,,60,"(4.815061,-75.736532)"
2012,Julio,México,484,376,325,,701,"(6.171601,-75.427454)"
2012,Julio,México,484,24,33,,57,"(7.128456,-73.183637)"
2012,Julio,México,484,3,0,,3,"(7.927209,-72.507910)"
2012,Julio,Mónaco,492,1,0,,1,"(3.541112,-76.384584)"
2012,Julio,Mónaco,492,1,2,,3,"(4.697144,-74.140516)"
2012,Julio,Mongolia,496,0,1,,1,"(4.697144,-74.140516)"
2012,Julio,Mozambique,508,1,0,,1,"(4.697144,-74.140516)"
2012,Julio,Nicaragua,558,0,2,,2,"(10.445761,-75.516429)"
2012,Julio,Nicaragua,558,6,11,,17,"(10.886611,-74.776708)"
2012,Julio,Nicaragua,558,8,7,,15,"(12.5744111,-81.703935)"
2012,Julio,Nicaragua,558,0,1,,1,"(12.586067,-81.702563)"
2012,Julio,Nicaragua,558,8,12,,20,"(3.541112,-76.384584)"
2012,Julio,Nicaragua,558,24,54,,78,"(4.697144,-74.140516)"
2012,Julio,Nicaragua,558,2,3,,5,"(4.815061,-75.736532)"
2012,Julio,Nicaragua,558,7,22,,29,"(6.171601,-75.427454)"
2012,Julio,Nicaragua,558,0,1,,1,"(7.128456,-73.183637)"
2012,Julio,Nigeria,566,0,25,,25,"(4.697144,-74.140516)"
2012,Julio,Noruega,578,1,0,,1,"(10.445761,-75.516429)"
2012,Julio,Noruega,578,2,0,,2,"(10.886611,-74.776708)"
2012,Julio,Noruega,578,7,3,,10,"(3.541112,-76.384584)"
2012,Julio,Noruega,578,28,27,,55,"(4.697144,-74.140516)"
2012,Julio,Noruega,578,5,3,,8,"(6.171601,-75.427454)"
2012,Julio,Nueva Caledonia/Territorio francés,540,2,0,,2,"(3.541112,-76.384584)"
2012,Julio,Nueva Caledonia/Territorio francés,540,1,1,,2,"(4.697144,-74.140516)"
2012,Julio,Nueva Zelanda,554,1,0,,1,"(3.541112,-76.384584)"
2012,Julio,Nueva Zelanda,554,36,28,,64,"(4.697144,-74.140516)"
2012,Julio,Nueva Zelanda,554,1,3,,4,"(6.171601,-75.427454)"
2012,Julio,Omán,512,5,6,,11,"(4.697144,-74.140516)"
2012,Julio,Papúa Nueva Guinea,598,0,6,,6,"(4.697144,-74.140516)"
2012,Julio,Papúa Nueva Guinea,598,2,1,,3,"(7.128456,-73.183637)"
2012,Julio,Pakistán,586,2,2,,4,"(4.697144,-74.140516)"
2012,Julio,Palau,585,1,0,,1,"(6.171601,-75.427454)"
2012,Julio,Panamá,591,20,36,,56,"(10.408582,-75.538003)"
2012,Julio,Panamá,591,378,429,,807,"(10.445761,-75.516429)"
2012,Julio,Panamá,591,1004,1062,,2066,"(10.886611,-74.776708)"
2012,Julio,Panamá,591,0,1,,1,"(11.247723,-74.213989)"
2012,Julio,Panamá,591,1,8,,9,"(12.5744111,-81.703935)"
2012,Julio,Panamá,591,121,119,,240,"(12.586067,-81.702563)"
2012,Julio,Panamá,591,2200,1914,,4114,"(3.541112,-76.384584)"
2012,Julio,Panamá,591,7056,8127,,15183,"(4.697144,-74.140516)"
2012,Julio,Panamá,591,724,621,,1345,"(4.815061,-75.736532)"
2012,Julio,Panamá,591,1985,2241,,4226,"(6.171601,-75.427454)"
2012,Julio,Panamá,591,11,27,,38,"(6.228046,-77.404104)"
2012,Julio,Panamá,591,257,264,,521,"(7.128456,-73.183637)"
2012,Julio,Panamá,591,141,154,,295,"(7.927209,-72.507910)"
2012,Julio,Panamá,591,1,7,,8,"(8.066966,-76.735404)"
2012,Julio,Panamá,591,86,148,,234,"(8.635765,-77.346578)"
2012,Julio,Paraguay,600,0,1,,1,"(0.814836,-77.662532)"
2012,Julio,Paraguay,600,2,0,,2,"(10.886611,-74.776708)"
2012,Julio,Paraguay,600,5,15,,20,"(3.541112,-76.384584)"
2012,Julio,Paraguay,600,27,74,,101,"(4.697144,-74.140516)"
2012,Julio,Paraguay,600,0,1,,1,"(4.815061,-75.736532)"
2012,Julio,Paraguay,600,2,6,,8,"(6.171601,-75.427454)"
2012,Julio,Paraguay,600,1,1,,2,"(7.128456,-73.183637)"
2012,Julio,Perú,604,63,94,,157,"(-4.197703,-69.941278)"
2012,Julio,Perú,604,1,2,,3,"(0.25129,-76.875963)"
2012,Julio,Perú,604,16,24,,40,"(0.814836,-77.662532)"
2012,Julio,Perú,604,8,16,,24,"(10.445761,-75.516429)"
2012,Julio,Perú,604,6,13,,19,"(10.886611,-74.776708)"
2012,Julio,Perú,604,4,0,,4,"(12.586067,-81.702563)"
2012,Julio,Perú,604,202,199,,401,"(3.541112,-76.384584)"
2012,Julio,Perú,604,3193,4191,,7384,"(4.697144,-74.140516)"
2012,Julio,Perú,604,18,5,,23,"(4.815061,-75.736532)"
2012,Julio,Perú,604,212,242,,454,"(6.171601,-75.427454)"
2012,Julio,Perú,604,9,6,,15,"(7.128456,-73.183637)"
2012,Julio,Perú,604,1,1,,2,"(7.927209,-72.507910)"
2012,Julio,Palestina,99999,0,1,,1,"(12.5744111,-81.703935)"
2012,Julio,Palestina,99999,1,1,,2,"(4.697144,-74.140516)"
2012,Julio,Polonia,616,0,1,,1,"(3.541112,-76.384584)"
2012,Julio,Polonia,616,9,11,,20,"(4.697144,-74.140516)"
2012,Julio,Polonia,616,1,0,,1,"(6.171601,-75.427454)"
2012,Julio,Portugal,620,1,2,,3,"(3.541112,-76.384584)"
2012,Julio,Portugal,620,32,28,,60,"(4.697144,-74.140516)"
2012,Julio,Portugal,620,1,0,,1,"(6.171601,-75.427454)"
2012,Julio,Puerto Rico/Territorio de Estados Unidos,630,14,23,,37,"(10.445761,-75.516429)"
2012,Julio,Puerto Rico/Territorio de Estados Unidos,630,9,1,,10,"(10.886611,-74.776708)"
2012,Julio,Puerto Rico/Territorio de Estados Unidos,630,52,38,,90,"(3.541112,-76.384584)"
2012,Julio,Puerto Rico/Territorio de Estados Unidos,630,90,118,,208,"(4.697144,-74.140516)"
2012,Julio,Puerto Rico/Territorio de Estados Unidos,630,5,4,,9,"(4.815061,-75.736532)"
2012,Julio,Puerto Rico/Territorio de Estados Unidos,630,54,41,,95,"(6.171601,-75.427454)"
2012,Julio,Puerto Rico/Territorio de Estados Unidos,630,16,22,,38,"(7.128456,-73.183637)"
2012,Julio,Puerto Rico/Territorio de Estados Unidos,630,2,1,,3,"(7.927209,-72.507910)"
2012,Julio,Qatar,634,4,3,,7,"(4.697144,-74.140516)"
2012,Julio,Reino Unido de Gran Bretaña e Irlanda del Norte,826,2,2,,4,"(10.445761,-75.516429)"
2012,Julio,Reino Unido de Gran Bretaña e Irlanda del Norte,826,3,1,,4,"(10.886611,-74.776708)"
2012,Julio,Reino Unido de Gran Bretaña e Irlanda del Norte,826,89,58,,147,"(3.541112,-76.384584)"
2012,Julio,Reino Unido de Gran Bretaña e Irlanda del Norte,826,807,765,,1572,"(4.697144,-74.140516)"
2012,Julio,Reino Unido de Gran Bretaña e Irlanda del Norte,826,44,29,,73,"(6.171601,-75.427454)"
2012,Julio,Reino Unido de Gran Bretaña e Irlanda del Norte,826,1,2,,3,"(7.128456,-73.183637)"
2012,Julio,Federación de Rusia,643,0,1,,1,"(11.360009,-72.129330)"
2012,Julio,Federación de Rusia,643,69,70,,139,"(4.697144,-74.140516)"
2012,Julio,Federación de Rusia,643,0,1,,1,"(6.171601,-75.427454)"
2012,Julio,República Dominicana,214,13,14,,27,"(10.445761,-75.516429)"
2012,Julio,República Dominicana,214,31,45,,76,"(10.886611,-74.776708)"
2012,Julio,República Dominicana,214,0,1,,1,"(10.971302,-74.765397)"
2012,Julio,República Dominicana,214,292,201,,493,"(3.541112,-76.384584)"
2012,Julio,República Dominicana,214,1442,1358,,2800,"(4.697144,-74.140516)"
2012,Julio,República Dominicana,214,18,9,,27,"(4.815061,-75.736532)"
2012,Julio,República Dominicana,214,120,128,,248,"(6.171601,-75.427454)"
2012,Julio,República Dominicana,214,5,7,,12,"(7.128456,-73.183637)"
2012,Julio,República Dominicana,214,1,3,,4,"(7.927209,-72.507910)"
2012,Julio,Reunión,638,1,0,,1,"(3.541112,-76.384584)"
2012,Julio,Reunión,638,0,3,,3,"(4.697144,-74.140516)"
2012,Julio,Rumania,642,4,3,,7,"(4.697144,-74.140516)"
2012,Julio,Rumania,642,1,2,,3,"(6.171601,-75.427454)"
2012,Julio,Sahara Occidental/Desierto Sahara,732,1,0,,1,"(4.697144,-74.140516)"
2012,Julio,San Pedro y Miquelón/territorio de Ultramar de La Unión Europea,666,0,1,,1,"(4.697144,-74.140516)"
2012,Julio,Santo Tomé y Príncipe,678,0,1,,1,"(6.171601,-75.427454)"
2012,Julio,Serbia,688,1,1,,2,"(4.697144,-74.140516)"
2012,Julio,Singapur,702,0,1,,1,"(3.541112,-76.384584)"
2012,Julio,Singapur,702,13,11,,24,"(4.697144,-74.140516)"
2012,Julio,Sudáfrica,710,19,24,,43,"(4.697144,-74.140516)"
2012,Julio,Sudáfrica,710,1,0,,1,"(6.171601,-75.427454)"
2012,Julio,Sudán,736,1,1,,2,"(4.697144,-74.140516)"
2012,Julio,Sudán,736,0,1,,1,"(6.171601,-75.427454)"
2012,Julio,Suecia,752,1,0,,1,"(10.445761,-75.516429)"
2012,Julio,Suecia,752,2,3,,5,"(10.886611,-74.776708)"
2012,Julio,Suecia,752,8,2,,10,"(3.541112,-76.384584)"
2012,Julio,Suecia,752,85,68,,153,"(4.697144,-74.140516)"
2012,Julio,Suecia,752,5,1,,6,"(6.171601,-75.427454)"
2012,Julio,Suiza,756,3,1,,4,"(10.445761,-75.516429)"
2012,Julio,Suiza,756,44,16,,60,"(3.541112,-76.384584)"
2012,Julio,Suiza,756,278,175,,453,"(4.697144,-74.140516)"
2012,Julio,Suiza,756,6,2,,8,"(6.171601,-75.427454)"
2012,Julio,Surinam,740,2,3,,5,"(4.697144,-74.140516)"
2012,Julio,Taiwán,158,4,4,,8,"(4.697144,-74.140516)"
2012,Julio,Tailandia,764,2,10,,12,"(4.697144,-74.140516)"
2012,Julio,Tailandia,764,0,1,,1,"(6.171601,-75.427454)"
2012,Julio,Togo,768,0,1,,1,"(4.697144,-74.140516)"
2012,Julio,Trinidad y Tobago,780,6,5,,11,"(10.445761,-75.516429)"
2012,Julio,Trinidad y Tobago,780,5,2,,7,"(10.886611,-74.776708)"
2012,Julio,Trinidad y Tobago,780,11,15,,26,"(3.541112,-76.384584)"
2012,Julio,Trinidad y Tobago,780,26,34,,60,"(4.697144,-74.140516)"
2012,Julio,Trinidad y Tobago,780,3,2,,5,"(4.815061,-75.736532)"
2012,Julio,Trinidad y Tobago,780,7,20,,27,"(6.171601,-75.427454)"
2012,Julio,Trinidad y Tobago,780,4,2,,6,"(7.128456,-73.183637)"
2012,Julio,Túnez,788,1,0,,1,"(3.541112,-76.384584)"
2012,Julio,Turquía,792,0,1,,1,"(12.586067,-81.702563)"
2012,Julio,Turquía,792,110,70,,180,"(4.697144,-74.140516)"
2012,Julio,Turquía,792,6,4,,10,"(6.171601,-75.427454)"
2012,Julio,Ucrania,804,1,3,,4,"(4.697144,-74.140516)"
2012,Julio,Uganda,800,1,0,,1,"(4.697144,-74.140516)"
2012,Julio,Uruguay,858,0,1,,1,"(0.814836,-77.662532)"
2012,Julio,Uruguay,858,0,1,,1,"(10.445761,-75.516429)"
2012,Julio,Uruguay,858,3,2,,5,"(10.886611,-74.776708)"
2012,Julio,Uruguay,858,7,4,,11,"(3.541112,-76.384584)"
2012,Julio,Uruguay,858,44,75,,119,"(4.697144,-74.140516)"
2012,Julio,Uruguay,858,1,1,,2,"(4.815061,-75.736532)"
2012,Julio,Uruguay,858,14,12,,26,"(6.171601,-75.427454)"
2012,Julio,Uruguay,858,0,1,,1,"(7.128456,-73.183637)"
2012,Julio,Vanuatu,548,1,0,,1,"(4.697144,-74.140516)"
2012,Julio,Venezuela,862,8,7,,15,"(10.445761,-75.516429)"
2012,Julio,Venezuela,862,13,15,,28,"(10.886611,-74.776708)"
2012,Julio,Venezuela,862,7760,7438,,15198,"(11.360009,-72.129330)"
2012,Julio,Venezuela,862,12,13,,25,"(3.541112,-76.384584)"
2012,Julio,Venezuela,862,2306,3195,,5501,"(4.697144,-74.140516)"
2012,Julio,Venezuela,862,3,3,,6,"(4.815061,-75.736532)"
2012,Julio,Venezuela,862,276,358,,634,"(6.171601,-75.427454)"
2012,Julio,Venezuela,862,183,274,,457,"(6.185799,-67.483929)"
2012,Julio,Venezuela,862,1126,1092,,2218,"(7.088729,-70.740253)"
2012,Julio,Venezuela,862,2,6,,8,"(7.128456,-73.183637)"
2012,Julio,Venezuela,862,7556,8559,,16115,"(7.818934,-72.453226)"
2012,Julio,Vietnam,704,3,3,,6,"(4.697144,-74.140516)"
2012,Julio,Islas Vírgenes Británicas/Territorio Británico de Ultramar,92,0,1,,1,"(6.171601,-75.427454)"
2012,Julio,República Árabe de Yemen,887,0,1,,1,"(4.697144,-74.140516)"
2012,Julio,Zambia,894,1,3,,4,"(4.697144,-74.140516)"
2012,Julio,Desconocido,99999,1,2,,3,"(3.541112,-76.384584)"
2012,Julio,Desconocido,99999,5,16,,21,"(4.697144,-74.140516)"
2012,Julio,Desconocido,99999,0,1,,1,"(6.171601,-75.427454)"
2012,Agosto,Afganistán,4,0,1,,1,"(3.541112,-76.384584)"
2012,Agosto,Afganistán,4,3,41,,44,"(4.697144,-74.140516)"
2012,Agosto,Alemania,276,0,2,,2,"(0.814836,-77.662532)"
2012,Agosto,Alemania,276,2,0,,2,"(10.445761,-75.516429)"
2012,Agosto,Alemania,276,44,18,,62,"(3.541112,-76.384584)"
2012,Agosto,Alemania,276,885,744,,1629,"(4.697144,-74.140516)"
2012,Agosto,Alemania,276,30,23,,53,"(6.171601,-75.427454)"
2012,Agosto,Andorra,20,1,0,,1,"(4.697144,-74.140516)"
2012,Agosto,Angola,24,2,16,,18,"(4.697144,-74.140516)"
2012,Agosto,Antigua y Barbuda,28,3,2,,5,"(4.697144,-74.140516)"
2012,Agosto,Países Bajos,528,2,1,,3,"(10.445761,-75.516429)"
2012,Agosto,Países Bajos,528,8,4,,12,"(10.886611,-74.776708)"
2012,Agosto,Países Bajos,528,1,0,,1,"(12.586067,-81.702563)"
2012,Agosto,Países Bajos,528,69,40,,109,"(3.541112,-76.384584)"
2012,Agosto,Países Bajos,528,287,168,,455,"(4.697144,-74.140516)"
2012,Agosto,Países Bajos,528,0,1,,1,"(4.815061,-75.736532)"
2012,Agosto,Países Bajos,528,64,46,,110,"(6.171601,-75.427454)"
2012,Agosto,Países Bajos,528,1,2,,3,"(7.128456,-73.183637)"
2012,Agosto,Arabia Saudita,682,0,1,,1,"(10.886611,-74.776708)"
2012,Agosto,Arabia Saudita,682,1,1,,2,"(3.541112,-76.384584)"
2012,Agosto,Arabia Saudita,682,30,56,,86,"(4.697144,-74.140516)"
2012,Agosto,Arabia Saudita,682,1,4,,5,"(6.171601,-75.427454)"
2012,Agosto,Argelia,12,1,0,,1,"(10.886611,-74.776708)"
2012,Agosto,Argelia,12,3,5,,8,"(4.697144,-74.140516)"
2012,Agosto,Argelia,12,0,1,,1,"(4.815061,-75.736532)"
2012,Agosto,Argentina,32,0,4,,4,"(0.814836,-77.662532)"
2012,Agosto,Argentina,32,12,16,,28,"(10.445761,-75.516429)"
2012,Agosto,Argentina,32,25,19,,44,"(10.886611,-74.776708)"
2012,Agosto,Argentina,32,0,1,,1,"(12.586067,-81.702563)"
2012,Agosto,Argentina,32,183,182,,365,"(3.541112,-76.384584)"
2012,Agosto,Argentina,32,2454,2545,,4999,"(4.697144,-74.140516)"
2012,Agosto,Argentina,32,11,14,,25,"(4.815061,-75.736532)"
2012,Agosto,Argentina,32,173,180,,353,"(6.171601,-75.427454)"
2012,Agosto,Argentina,32,19,13,,32,"(7.128456,-73.183637)"
2012,Agosto,República de Armenia,51,1,0,,1,"(3.541112,-76.384584)"
2012,Agosto,Aruba,533,3,1,,4,"(10.445761,-75.516429)"
2012,Agosto,Aruba,533,15,12,,27,"(10.886611,-74.776708)"
2012,Agosto,Aruba,533,0,1,,1,"(11.247723,-74.213989)"
2012,Agosto,Aruba,533,148,87,,235,"(11.528919,-72.919681)"
2012,Agosto,Aruba,533,66,34,,100,"(3.541112,-76.384584)"
2012,Agosto,Aruba,533,1134,967,,2101,"(4.697144,-74.140516)"
2012,Agosto,Aruba,533,8,1,,9,"(4.815061,-75.736532)"
2012,Agosto,Aruba,533,68,43,,111,"(6.171601,-75.427454)"
2012,Agosto,Aruba,533,4,10,,14,"(7.128456,-73.183637)"
2012,Agosto,Australia,36,1,0,,1,"(10.445761,-75.516429)"
2012,Agosto,Australia,36,2,3,,5,"(10.886611,-74.776708)"
2012,Agosto,Australia,36,8,7,,15,"(3.541112,-76.384584)"
2012,Agosto,Australia,36,209,159,,368,"(4.697144,-74.140516)"
2012,Agosto,Australia,36,17,15,,32,"(6.171601,-75.427454)"
2012,Agosto,Australia,36,2,1,,3,"(7.128456,-73.183637)"
2012,Agosto,Austria,40,2,2,,4,"(10.445761,-75.516429)"
2012,Agosto,Austria,40,1,0,,1,"(3.541112,-76.384584)"
2012,Agosto,Austria,40,34,40,,74,"(4.697144,-74.140516)"
2012,Agosto,Austria,40,0,1,,1,"(6.171601,-75.427454)"
2012,Agosto,Azerbaiyán,31,11,10,,21,"(4.697144,-74.140516)"
2012,Agosto,Bahamas,44,1,0,,1,"(10.445761,-75.516429)"
2012,Agosto,Bahamas,44,9,4,,13,"(10.886611,-74.776708)"
2012,Agosto,Bahamas,44,0,1,,1,"(12.586067,-81.702563)"
2012,Agosto,Bahamas,44,58,23,,81,"(3.541112,-76.384584)"
2012,Agosto,Bahamas,44,38,36,,74,"(4.697144,-74.140516)"
2012,Agosto,Bahamas,44,17,9,,26,"(4.815061,-75.736532)"
2012,Agosto,Bahamas,44,15,12,,27,"(6.171601,-75.427454)"
2012,Agosto,Bahréin,48,8,5,,13,"(4.697144,-74.140516)"
2012,Agosto,Bahréin,48,0,1,,1,"(6.171601,-75.427454)"
2012,Agosto,Bahréin,48,0,2,,2,"(7.818934,-72.453226)"
2012,Agosto,Bangladesh,50,0,1,,1,"(4.697144,-74.140516)"
2012,Agosto,Barbados,52,4,12,,16,"(4.697144,-74.140516)"
2012,Agosto,República de Belarús,112,0,1,,1,"(11.360009,-72.129330)"
2012,Agosto,República de Belarús,112,1,0,,1,"(3.541112,-76.384584)"
2012,Agosto,República de Belarús,112,7,3,,10,"(4.697144,-74.140516)"
2012,Agosto,República de Belarús,112,1,1,,2,"(7.088729,-70.740253)"
2012,Agosto,República de Belarús,112,7,8,,15,"(7.818934,-72.453226)"
2012,Agosto,Bélgica,56,2,1,,3,"(10.445761,-75.516429)"
2012,Agosto,Bélgica,56,1,0,,1,"(12.586067,-81.702563)"
2012,Agosto,Bélgica,56,12,15,,27,"(3.541112,-76.384584)"
2012,Agosto,Bélgica,56,185,103,,288,"(4.697144,-74.140516)"
2012,Agosto,Bélgica,56,29,22,,51,"(6.171601,-75.427454)"
2012,Agosto,Belice,84,5,4,,9,"(4.697144,-74.140516)"
2012,Agosto,Belice,84,1,0,,1,"(6.171601,-75.427454)"
2012,Agosto,Bermudas/Territorio Británico de Ultramar,60,1,1,,2,"(4.697144,-74.140516)"
2012,Agosto,Bermudas/Territorio Británico de Ultramar,60,1,0,,1,"(6.171601,-75.427454)"
2012,Agosto,Bolivia,68,1,0,,1,"(0.814836,-77.662532)"
2012,Agosto,Bolivia,68,0,1,,1,"(10.445761,-75.516429)"
2012,Agosto,Bolivia,68,2,0,,2,"(10.886611,-74.776708)"
2012,Agosto,Bolivia,68,11,21,,32,"(3.541112,-76.384584)"
2012,Agosto,Bolivia,68,175,281,,456,"(4.697144,-74.140516)"
2012,Agosto,Bolivia,68,2,0,,2,"(4.815061,-75.736532)"
2012,Agosto,Bolivia,68,13,18,,31,"(6.171601,-75.427454)"
2012,Agosto,Bosnia y Herzegovina,70,2,2,,4,"(4.697144,-74.140516)"
2012,Agosto,Botsuana,72,1,1,,2,"(4.697144,-74.140516)"
2012,Agosto,Brasil,76,105,192,,297,"(-4.197703,-69.941278)"
2012,Agosto,Brasil,76,0,3,,3,"(10.408582,-75.538003)"
2012,Agosto,Brasil,76,6,5,,11,"(10.445761,-75.516429)"
2012,Agosto,Brasil,76,4,5,,9,"(10.886611,-74.776708)"
2012,Agosto,Brasil,76,1,0,,1,"(12.586067,-81.702563)"
2012,Agosto,Brasil,76,21,37,,58,"(3.541112,-76.384584)"
2012,Agosto,Brasil,76,2145,3364,,5509,"(4.697144,-74.140516)"
2012,Agosto,Brasil,76,0,6,,6,"(4.815061,-75.736532)"
2012,Agosto,Brasil,76,38,65,,103,"(6.171601,-75.427454)"
2012,Agosto,Brasil,76,17,37,,54,"(7.128456,-73.183637)"
2012,Agosto,Brasil,76,0,2,,2,"(7.818934,-72.453226)"
2012,Agosto,Brunei Darussalam,96,0,2,,2,"(4.697144,-74.140516)"
2012,Agosto,Bulgaria,100,6,2,,8,"(4.697144,-74.140516)"
2012,Agosto,Burundi,108,1,0,,1,"(4.697144,-74.140516)"
2012,Agosto,Cabo Verde,132,1,1,,2,"(0.814836,-77.662532)"
2012,Agosto,Islas Caimán/Territorio Británico de Ultramar,136,3,1,,4,"(10.445761,-75.516429)"
2012,Agosto,Islas Caimán/Territorio Británico de Ultramar,136,0,1,,1,"(12.5744111,-81.703935)"
2012,Agosto,Islas Caimán/Territorio Británico de Ultramar,136,19,3,,22,"(12.586067,-81.702563)"
2012,Agosto,Islas Caimán/Territorio Británico de Ultramar,136,2,1,,3,"(3.541112,-76.384584)"
2012,Agosto,Islas Caimán/Territorio Británico de Ultramar,136,6,0,,6,"(4.697144,-74.140516)"
2012,Agosto,Camboya,116,1,0,,1,"(6.171601,-75.427454)"
2012,Agosto,Camerún,120,0,1,,1,"(4.697144,-74.140516)"
2012,Agosto,Canadá,124,37,28,,65,"(10.445761,-75.516429)"
2012,Agosto,Canadá,124,21,13,,34,"(10.886611,-74.776708)"
2012,Agosto,Canadá,124,0,2,,2,"(12.586067,-81.702563)"
2012,Agosto,Canadá,124,86,54,,140,"(3.541112,-76.384584)"
2012,Agosto,Canadá,124,12,7,,19,"(4.452882,-75.766298)"
2012,Agosto,Canadá,124,2319,1907,,4226,"(4.697144,-74.140516)"
2012,Agosto,Canadá,124,5,1,,6,"(4.815061,-75.736532)"
2012,Agosto,Canadá,124,183,126,,309,"(6.171601,-75.427454)"
2012,Agosto,Canadá,124,7,3,,10,"(7.128456,-73.183637)"
2012,Agosto,Chad,148,1,1,,2,"(4.697144,-74.140516)"
2012,Agosto,España,724,5,7,,12,"(10.445761,-75.516429)"
2012,Agosto,España,724,0,1,,1,"(10.886611,-74.776708)"
2012,Agosto,España,724,0,1,,1,"(12.586067,-81.702563)"
2012,Agosto,España,724,1693,1018,,2711,"(3.541112,-76.384584)"
2012,Agosto,España,724,5848,3936,,9784,"(4.697144,-74.140516)"
2012,Agosto,España,724,2,0,,2,"(4.815061,-75.736532)"
2012,Agosto,España,724,666,413,,1079,"(6.171601,-75.427454)"
2012,Agosto,España,724,0,2,,2,"(7.128456,-73.183637)"
2012,Agosto,República Democrática del Congo,180,0,3,,3,"(4.697144,-74.140516)"
2012,Agosto,República de Corea,410,0,1,,1,"(3.541112,-76.384584)"
2012,Agosto,República de Corea,410,13,61,,74,"(4.697144,-74.140516)"
2012,Agosto,República de Corea,410,4,1,,5,"(6.171601,-75.427454)"
2012,Agosto,Costa Rica,188,7,20,,27,"(10.445761,-75.516429)"
2012,Agosto,Costa Rica,188,10,18,,28,"(10.886611,-74.776708)"
2012,Agosto,Costa Rica,188,1,22,,23,"(12.5744111,-81.703935)"
2012,Agosto,Costa Rica,188,6,9,,15,"(12.586067,-81.702563)"
2012,Agosto,Costa Rica,188,62,50,,112,"(3.541112,-76.384584)"
2012,Agosto,Costa Rica,188,625,822,,1447,"(4.697144,-74.140516)"
2012,Agosto,Costa Rica,188,5,2,,7,"(4.815061,-75.736532)"
2012,Agosto,Costa Rica,188,176,192,,368,"(6.171601,-75.427454)"
2012,Agosto,Costa Rica,188,4,7,,11,"(7.128456,-73.183637)"
2012,Agosto,Costa Rica,188,0,1,,1,"(8.635765,-77.346578)"
2012,Agosto,Croacia,191,1,1,,2,"(4.697144,-74.140516)"
2012,Agosto,Cuba,192,11,11,,22,"(10.445761,-75.516429)"
2012,Agosto,Cuba,192,24,21,,45,"(10.886611,-74.776708)"
2012,Agosto,Cuba,192,187,123,,310,"(3.541112,-76.384584)"
2012,Agosto,Cuba,192,775,644,,1419,"(4.697144,-74.140516)"
2012,Agosto,Cuba,192,5,7,,12,"(4.815061,-75.736532)"
2012,Agosto,Cuba,192,140,96,,236,"(6.171601,-75.427454)"
2012,Agosto,Cuba,192,19,10,,29,"(7.128456,-73.183637)"
2012,Agosto,Cuba,192,1,1,,2,"(7.927209,-72.507910)"
2012,Agosto,Curazao,99999,9,9,,18,"(10.886611,-74.776708)"
2012,Agosto,Curazao,99999,11,10,,21,"(3.541112,-76.384584)"
2012,Agosto,Curazao,99999,652,604,,1256,"(4.697144,-74.140516)"
2012,Agosto,Curazao,99999,1,1,,2,"(4.815061,-75.736532)"
2012,Agosto,Curazao,99999,126,96,,222,"(6.171601,-75.427454)"
2012,Agosto,Curazao,99999,2,2,,4,"(7.128456,-73.183637)"
2012,Agosto,Curazao,99999,0,1,,1,"(7.818934,-72.453226)"
2012,Agosto,República Checa,203,1,0,,1,"(10.886611,-74.776708)"
2012,Agosto,República Checa,203,26,44,,70,"(4.697144,-74.140516)"
2012,Agosto,República Checa,203,1,1,,2,"(6.171601,-75.427454)"
2012,Agosto,República Checa,203,2,0,,2,"(7.128456,-73.183637)"
2012,Agosto,Chile,152,25,21,,46,"(0.814836,-77.662532)"
2012,Agosto,Chile,152,11,8,,19,"(10.445761,-75.516429)"
2012,Agosto,Chile,152,20,19,,39,"(10.886611,-74.776708)"
2012,Agosto,Chile,152,1,2,,3,"(12.586067,-81.702563)"
2012,Agosto,Chile,152,244,211,,455,"(3.541112,-76.384584)"
2012,Agosto,Chile,152,2102,1949,,4051,"(4.697144,-74.140516)"
2012,Agosto,Chile,152,49,44,,93,"(4.815061,-75.736532)"
2012,Agosto,Chile,152,129,127,,256,"(6.171601,-75.427454)"
2012,Agosto,Chile,152,6,5,,11,"(7.128456,-73.183637)"
2012,Agosto,Chile,152,3,1,,4,"(7.927209,-72.507910)"
2012,Agosto,China,156,3,1,,4,"(10.886611,-74.776708)"
2012,Agosto,China,156,1,0,,1,"(12.586067,-81.702563)"
2012,Agosto,China,156,4,5,,9,"(3.541112,-76.384584)"
2012,Agosto,China,156,184,349,,533,"(4.697144,-74.140516)"
2012,Agosto,China,156,0,3,,3,"(4.815061,-75.736532)"
2012,Agosto,China,156,16,26,,42,"(6.171601,-75.427454)"
2012,Agosto,China,156,0,1,,1,"(7.128456,-73.183637)"
2012,Agosto,Chipre,196,1,2,,3,"(4.697144,-74.140516)"
2012,Agosto,Dinamarca,208,2,0,,2,"(3.541112,-76.384584)"
2012,Agosto,Dinamarca,208,35,34,,69,"(4.697144,-74.140516)"
2012,Agosto,Dinamarca,208,1,2,,3,"(6.171601,-75.427454)"
2012,Agosto,República de Yibuti,262,2,0,,2,"(4.697144,-74.140516)"
2012,Agosto,Dominica,212,0,1,,1,"(6.171601,-75.427454)"
2012,Agosto,Ecuador,218,381,447,,828,"(0.25129,-76.875963)"
2012,Agosto,Ecuador,218,7302,7881,,15183,"(0.814836,-77.662532)"
2012,Agosto,Ecuador,218,105,111,,216,"(1.813928,-78.763924)"
2012,Agosto,Ecuador,218,0,1,,1,"(10.408582,-75.538003)"
2012,Agosto,Ecuador,218,3,4,,7,"(10.445761,-75.516429)"
2012,Agosto,Ecuador,218,6,5,,11,"(10.886611,-74.776708)"
2012,Agosto,Ecuador,218,1,0,,1,"(12.586067,-81.702563)"
2012,Agosto,Ecuador,218,705,742,,1447,"(3.541112,-76.384584)"
2012,Agosto,Ecuador,218,1918,3374,,5292,"(4.697144,-74.140516)"
2012,Agosto,Ecuador,218,2,2,,4,"(4.815061,-75.736532)"
2012,Agosto,Ecuador,218,464,503,,967,"(6.171601,-75.427454)"
2012,Agosto,Ecuador,218,6,4,,10,"(7.128456,-73.183637)"
2012,Agosto,Egipto,818,2,0,,2,"(3.541112,-76.384584)"
2012,Agosto,Egipto,818,69,47,,116,"(4.697144,-74.140516)"
2012,Agosto,Egipto,818,3,0,,3,"(6.171601,-75.427454)"
2012,Agosto,El Salvador,222,2,3,,5,"(10.445761,-75.516429)"
2012,Agosto,El Salvador,222,1,5,,6,"(10.886611,-74.776708)"
2012,Agosto,El Salvador,222,1,1,,2,"(12.586067,-81.702563)"
2012,Agosto,El Salvador,222,43,43,,86,"(3.541112,-76.384584)"
2012,Agosto,El Salvador,222,785,945,,1730,"(4.697144,-74.140516)"
2012,Agosto,El Salvador,222,6,2,,8,"(4.815061,-75.736532)"
2012,Agosto,El Salvador,222,12,33,,45,"(6.171601,-75.427454)"
2012,Agosto,El Salvador,222,0,1,,1,"(7.128456,-73.183637)"
2012,Agosto,Emiratos Árabes,784,0,1,,1,"(10.886611,-74.776708)"
2012,Agosto,Emiratos Árabes,784,4,3,,7,"(3.541112,-76.384584)"
2012,Agosto,Emiratos Árabes,784,113,184,,297,"(4.697144,-74.140516)"
2012,Agosto,Emiratos Árabes,784,7,9,,16,"(6.171601,-75.427454)"
2012,Agosto,Eritrea,232,0,1,,1,"(6.171601,-75.427454)"
2012,Agosto,Eslovaquia,703,3,1,,4,"(4.697144,-74.140516)"
2012,Agosto,Eslovenia,705,0,4,,4,"(3.541112,-76.384584)"
2012,Agosto,Eslovenia,705,3,2,,5,"(4.697144,-74.140516)"
2012,Agosto,Estados Unidos de América,840,0,1,,1,"(10.408582,-75.538003)"
2012,Agosto,Estados Unidos de América,840,1800,1418,,3218,"(10.445761,-75.516429)"
2012,Agosto,Estados Unidos de América,840,2071,1618,,3689,"(10.886611,-74.776708)"
2012,Agosto,Estados Unidos de América,840,0,3,,3,"(10.971302,-74.765397)"
2012,Agosto,Estados Unidos de América,840,2,3,,5,"(11.117806,-74.232622)"
2012,Agosto,Estados Unidos de América,840,48,30,,78,"(12.586067,-81.702563)"
2012,Agosto,Estados Unidos de América,840,5767,3946,,9713,"(3.541112,-76.384584)"
2012,Agosto,Estados Unidos de América,840,501,408,,909,"(4.452882,-75.766298)"
2012,Agosto,Estados Unidos de América,840,29556,25270,,54826,"(4.697144,-74.140516)"
2012,Agosto,Estados Unidos de América,840,404,275,,679,"(4.815061,-75.736532)"
2012,Agosto,Estados Unidos de América,840,7309,5613,,12922,"(6.171601,-75.427454)"
2012,Agosto,Estados Unidos de América,840,138,99,,237,"(7.128456,-73.183637)"
2012,Agosto,Estados Unidos de América,840,9,6,,15,"(7.927209,-72.507910)"
2012,Agosto,Etiopia,231,1,3,,4,"(4.697144,-74.140516)"
2012,Agosto,Filipinas,608,0,1,,1,"(3.541112,-76.384584)"
2012,Agosto,Filipinas,608,7,5,,12,"(4.697144,-74.140516)"
2012,Agosto,Finlandia,246,1,0,,1,"(10.445761,-75.516429)"
2012,Agosto,Finlandia,246,2,3,,5,"(3.541112,-76.384584)"
2012,Agosto,Finlandia,246,21,18,,39,"(4.697144,-74.140516)"
2012,Agosto,Finlandia,246,0,1,,1,"(6.171601,-75.427454)"
2012,Agosto,Francia,250,3,2,,5,"(10.445761,-75.516429)"
2012,Agosto,Francia,250,0,1,,1,"(10.886611,-74.776708)"
2012,Agosto,Francia,250,103,58,,161,"(3.541112,-76.384584)"
2012,Agosto,Francia,250,1930,1311,,3241,"(4.697144,-74.140516)"
2012,Agosto,Francia,250,47,25,,72,"(6.171601,-75.427454)"
2012,Agosto,Ghana,288,1,1,,2,"(3.541112,-76.384584)"
2012,Agosto,Granada,308,1,0,,1,"(4.697144,-74.140516)"
2012,Agosto,Grecia,300,1,0,,1,"(3.541112,-76.384584)"
2012,Agosto,Grecia,300,17,9,,26,"(4.697144,-74.140516)"
2012,Agosto,Grecia,300,3,0,,3,"(6.171601,-75.427454)"
2012,Agosto,Guatemala,320,3,7,,10,"(10.445761,-75.516429)"
2012,Agosto,Guatemala,320,5,7,,12,"(10.886611,-74.776708)"
2012,Agosto,Guatemala,320,33,53,,86,"(3.541112,-76.384584)"
2012,Agosto,Guatemala,320,131,226,,357,"(4.697144,-74.140516)"
2012,Agosto,Guatemala,320,10,12,,22,"(4.815061,-75.736532)"
2012,Agosto,Guatemala,320,67,98,,165,"(6.171601,-75.427454)"
2012,Agosto,Guatemala,320,3,4,,7,"(7.128456,-73.183637)"
2012,Agosto,Guyana,328,1,1,,2,"(4.697144,-74.140516)"
2012,Agosto,Guyana,328,1,2,,3,"(6.171601,-75.427454)"
2012,Agosto,Guinea,324,1,7,,8,"(4.697144,-74.140516)"
2012,Agosto,Guinea Ecuatorial,226,0,1,,1,"(3.541112,-76.384584)"
2012,Agosto,Guinea Ecuatorial,226,1,3,,4,"(4.697144,-74.140516)"
2012,Agosto,Guadalupe/Territorio Francés,312,2,2,,4,"(4.697144,-74.140516)"
2012,Agosto,Guayana Francesa/Departamento de Ultramar Francés,254,1,1,,2,"(4.697144,-74.140516)"
2012,Agosto,Haití,332,2,6,,8,"(10.886611,-74.776708)"
2012,Agosto,Haití,332,0,1,,1,"(3.541112,-76.384584)"
2012,Agosto,Haití,332,2,8,,10,"(4.697144,-74.140516)"
2012,Agosto,Haití,332,2,7,,9,"(6.171601,-75.427454)"
2012,Agosto,Honduras,340,1,9,,10,"(10.445761,-75.516429)"
2012,Agosto,Honduras,340,3,5,,8,"(10.886611,-74.776708)"
2012,Agosto,Honduras,340,0,1,,1,"(13.3387613,-81.372937)"
2012,Agosto,Honduras,340,19,41,,60,"(3.541112,-76.384584)"
2012,Agosto,Honduras,340,67,191,,258,"(4.697144,-74.140516)"
2012,Agosto,Honduras,340,3,7,,10,"(4.815061,-75.736532)"
2012,Agosto,Honduras,340,22,35,,57,"(6.171601,-75.427454)"
2012,Agosto,Honduras,340,4,7,,11,"(7.128456,-73.183637)"
2012,Agosto,Honduras,340,0,1,,1,"(7.927209,-72.507910)"
2012,Agosto,Hong Kong,344,1,0,,1,"(3.541112,-76.384584)"
2012,Agosto,Hong Kong,344,31,68,,99,"(4.697144,-74.140516)"
2012,Agosto,Hong Kong,344,1,4,,5,"(6.171601,-75.427454)"
2012,Agosto,Hungría,348,0,1,,1,"(10.445761,-75.516429)"
2012,Agosto,Hungría,348,9,15,,24,"(4.697144,-74.140516)"
2012,Agosto,Hungría,348,4,1,,5,"(6.171601,-75.427454)"
2012,Agosto,India,356,1,3,,4,"(3.541112,-76.384584)"
2012,Agosto,India,356,16,24,,40,"(4.697144,-74.140516)"
2012,Agosto,India,356,2,1,,3,"(6.171601,-75.427454)"
2012,Agosto,Indonesia,360,5,12,,17,"(4.697144,-74.140516)"
2012,Agosto,Indonesia,360,0,1,,1,"(6.171601,-75.427454)"
2012,Agosto,Iraq,368,1,14,,15,"(4.697144,-74.140516)"
2012,Agosto,Irán,364,3,4,,7,"(4.697144,-74.140516)"
2012,Agosto,República de Irlanda,372,0,1,,1,"(3.541112,-76.384584)"
2012,Agosto,República de Irlanda,372,14,18,,32,"(4.697144,-74.140516)"
2012,Agosto,República de Irlanda,372,15,8,,23,"(6.171601,-75.427454)"
2012,Agosto,Islandia,352,1,0,,1,"(4.697144,-74.140516)"
2012,Agosto,Isla de Man,833,1,0,,1,"(10.445761,-75.516429)"
2012,Agosto,Isla de Man,833,1,0,,1,"(3.541112,-76.384584)"
2012,Agosto,Israel,376,6,4,,10,"(3.541112,-76.384584)"
2012,Agosto,Israel,376,179,126,,305,"(4.697144,-74.140516)"
2012,Agosto,Israel,376,4,3,,7,"(6.171601,-75.427454)"
2012,Agosto,Italia,380,4,1,,5,"(10.445761,-75.516429)"
2012,Agosto,Italia,380,83,42,,125,"(3.541112,-76.384584)"
2012,Agosto,Italia,380,614,439,,1053,"(4.697144,-74.140516)"
2012,Agosto,Italia,380,1,1,,2,"(4.815061,-75.736532)"
2012,Agosto,Italia,380,39,26,,65,"(6.171601,-75.427454)"
2012,Agosto,Jamaica,388,1,2,,3,"(10.445761,-75.516429)"
2012,Agosto,Jamaica,388,4,3,,7,"(10.886611,-74.776708)"
2012,Agosto,Jamaica,388,19,15,,34,"(3.541112,-76.384584)"
2012,Agosto,Jamaica,388,40,30,,70,"(4.697144,-74.140516)"
2012,Agosto,Jamaica,388,5,4,,9,"(4.815061,-75.736532)"
2012,Agosto,Jamaica,388,11,19,,30,"(6.171601,-75.427454)"
2012,Agosto,Jamaica,388,4,1,,5,"(7.128456,-73.183637)"
2012,Agosto,Japón,392,3,0,,3,"(3.541112,-76.384584)"
2012,Agosto,Japón,392,44,39,,83,"(4.697144,-74.140516)"
2012,Agosto,Japón,392,3,4,,7,"(6.171601,-75.427454)"
2012,Agosto,Jordania,400,5,6,,11,"(4.697144,-74.140516)"
2012,Agosto,Kazajistán,398,2,1,,3,"(4.697144,-74.140516)"
2012,Agosto,Kenia,404,5,2,,7,"(4.697144,-74.140516)"
2012,Agosto,Kenia,404,0,2,,2,"(6.171601,-75.427454)"
2012,Agosto,Kuwait,414,1,0,,1,"(10.445761,-75.516429)"
2012,Agosto,Kuwait,414,10,4,,14,"(4.697144,-74.140516)"
2012,Agosto,Lituania,440,1,15,,16,"(4.697144,-74.140516)"
2012,Agosto,Líbano,422,12,23,,35,"(4.697144,-74.140516)"
2012,Agosto,Líbano,422,0,1,,1,"(6.171601,-75.427454)"
2012,Agosto,Libia,434,0,1,,1,"(4.697144,-74.140516)"
2012,Agosto,Luxemburgo,442,8,3,,11,"(4.697144,-74.140516)"
2012,Agosto,Malasia,458,1,1,,2,"(3.541112,-76.384584)"
2012,Agosto,Malasia,458,4,9,,13,"(4.697144,-74.140516)"
2012,Agosto,Maldivas,462,1,1,,2,"(4.697144,-74.140516)"
2012,Agosto,Malta,470,7,2,,9,"(4.697144,-74.140516)"
2012,Agosto,Malta,470,0,1,,1,"(6.171601,-75.427454)"
2012,Agosto,Marruecos,504,2,4,,6,"(4.697144,-74.140516)"
2012,Agosto,Mauricio,480,0,1,,1,"(4.697144,-74.140516)"
2012,Agosto,Mauritania,478,1,0,,1,"(10.445761,-75.516429)"
2012,Agosto,Martinica/Departamento de Ultramar Francés,474,0,1,,1,"(4.697144,-74.140516)"
2012,Agosto,México,484,28,25,,53,"(10.445761,-75.516429)"
2012,Agosto,México,484,38,36,,74,"(10.886611,-74.776708)"
2012,Agosto,México,484,1,1,,2,"(12.586067,-81.702563)"
2012,Agosto,México,484,275,264,,539,"(3.541112,-76.384584)"
2012,Agosto,México,484,4633,4748,,9381,"(4.697144,-74.140516)"
2012,Agosto,México,484,32,21,,53,"(4.815061,-75.736532)"
2012,Agosto,México,484,443,338,,781,"(6.171601,-75.427454)"
2012,Agosto,México,484,22,41,,63,"(7.128456,-73.183637)"
2012,Agosto,México,484,1,1,,2,"(7.818934,-72.453226)"
2012,Agosto,República de Moldavia,498,2,2,,4,"(4.697144,-74.140516)"
2012,Agosto,Mónaco,492,0,1,,1,"(4.697144,-74.140516)"
2012,Agosto,Myanmar,104,0,1,,1,"(4.697144,-74.140516)"
2012,Agosto,Namibia,516,1,1,,2,"(4.697144,-74.140516)"
2012,Agosto,Nepal,524,3,0,,3,"(4.697144,-74.140516)"
2012,Agosto,Nicaragua,558,2,4,,6,"(10.445761,-75.516429)"
2012,Agosto,Nicaragua,558,0,3,,3,"(10.886611,-74.776708)"
2012,Agosto,Nicaragua,558,0,1,,1,"(12.586067,-81.702563)"
2012,Agosto,Nicaragua,558,1,17,,18,"(3.541112,-76.384584)"
2012,Agosto,Nicaragua,558,25,44,,69,"(4.697144,-74.140516)"
2012,Agosto,Nicaragua,558,1,4,,5,"(4.815061,-75.736532)"
2012,Agosto,Nicaragua,558,7,16,,23,"(6.171601,-75.427454)"
2012,Agosto,Nigeria,566,5,20,,25,"(4.697144,-74.140516)"
2012,Agosto,Níger,562,0,1,,1,"(4.697144,-74.140516)"
2012,Agosto,Noruega,578,2,3,,5,"(3.541112,-76.384584)"
2012,Agosto,Noruega,578,35,18,,53,"(4.697144,-74.140516)"
2012,Agosto,Noruega,578,4,5,,9,"(6.171601,-75.427454)"
2012,Agosto,Nueva Zelanda,554,27,14,,41,"(4.697144,-74.140516)"
2012,Agosto,Nueva Zelanda,554,3,0,,3,"(6.171601,-75.427454)"
2012,Agosto,Omán,512,0,1,,1,"(10.886611,-74.776708)"
2012,Agosto,Omán,512,4,10,,14,"(4.697144,-74.140516)"
2012,Agosto,Papúa Nueva Guinea,598,0,9,,9,"(4.697144,-74.140516)"
2012,Agosto,Papúa Nueva Guinea,598,1,1,,2,"(7.128456,-73.183637)"
2012,Agosto,Pakistán,586,0,2,,2,"(4.697144,-74.140516)"
2012,Agosto,Panamá,591,22,46,,68,"(10.408582,-75.538003)"
2012,Agosto,Panamá,591,371,415,,786,"(10.445761,-75.516429)"
2012,Agosto,Panamá,591,936,923,,1859,"(10.886611,-74.776708)"
2012,Agosto,Panamá,591,1,7,,8,"(10.971302,-74.765397)"
2012,Agosto,Panamá,591,0,5,,5,"(11.247723,-74.213989)"
2012,Agosto,Panamá,591,0,1,,1,"(12.5744111,-81.703935)"
2012,Agosto,Panamá,591,82,86,,168,"(12.586067,-81.702563)"
2012,Agosto,Panamá,591,1,8,,9,"(13.3387613,-81.372937)"
2012,Agosto,Panamá,591,2154,1980,,4134,"(3.541112,-76.384584)"
2012,Agosto,Panamá,591,7552,8283,,15835,"(4.697144,-74.140516)"
2012,Agosto,Panamá,591,727,565,,1292,"(4.815061,-75.736532)"
2012,Agosto,Panamá,591,2327,2357,,4684,"(6.171601,-75.427454)"
2012,Agosto,Panamá,591,10,13,,23,"(6.228046,-77.404104)"
2012,Agosto,Panamá,591,273,288,,561,"(7.128456,-73.183637)"
2012,Agosto,Panamá,591,84,91,,175,"(7.927209,-72.507910)"
2012,Agosto,Panamá,591,0,69,,69,"(8.066966,-76.735404)"
2012,Agosto,Panamá,591,66,156,,222,"(8.635765,-77.346578)"
2012,Agosto,Paraguay,600,0,1,,1,"(0.814836,-77.662532)"
2012,Agosto,Paraguay,600,0,1,,1,"(10.445761,-75.516429)"
2012,Agosto,Paraguay,600,1,1,,2,"(10.886611,-74.776708)"
2012,Agosto,Paraguay,600,18,18,,36,"(3.541112,-76.384584)"
2012,Agosto,Paraguay,600,33,110,,143,"(4.697144,-74.140516)"
2012,Agosto,Paraguay,600,4,8,,12,"(6.171601,-75.427454)"
2012,Agosto,Paraguay,600,3,5,,8,"(7.128456,-73.183637)"
2012,Agosto,Perú,604,39,101,,140,"(-4.197703,-69.941278)"
2012,Agosto,Perú,604,15,17,,32,"(0.814836,-77.662532)"
2012,Agosto,Perú,604,9,6,,15,"(10.445761,-75.516429)"
2012,Agosto,Perú,604,17,10,,27,"(10.886611,-74.776708)"
2012,Agosto,Perú,604,203,210,,413,"(3.541112,-76.384584)"
2012,Agosto,Perú,604,3416,4535,,7951,"(4.697144,-74.140516)"
2012,Agosto,Perú,604,7,9,,16,"(4.815061,-75.736532)"
2012,Agosto,Perú,604,271,272,,543,"(6.171601,-75.427454)"
2012,Agosto,Perú,604,5,7,,12,"(7.128456,-73.183637)"
2012,Agosto,Perú,604,1,0,,1,"(7.927209,-72.507910)"
2012,Agosto,Palestina,99999,0,1,,1,"(4.697144,-74.140516)"
2012,Agosto,Palestina,99999,0,1,,1,"(6.171601,-75.427454)"
2012,Agosto,Polonia,616,0,1,,1,"(3.541112,-76.384584)"
2012,Agosto,Polonia,616,9,14,,23,"(4.697144,-74.140516)"
2012,Agosto,Polonia,616,0,1,,1,"(6.171601,-75.427454)"
2012,Agosto,Portugal,620,14,19,,33,"(3.541112,-76.384584)"
2012,Agosto,Portugal,620,16,16,,32,"(4.697144,-74.140516)"
2012,Agosto,Portugal,620,1,1,,2,"(6.171601,-75.427454)"
2012,Agosto,Polinesia Francesa/Colectividad de Ultramar Francesa,258,1,1,,2,"(4.697144,-74.140516)"
2012,Agosto,Puerto Rico/Territorio de Estados Unidos,630,5,8,,13,"(10.445761,-75.516429)"
2012,Agosto,Puerto Rico/Territorio de Estados Unidos,630,11,13,,24,"(10.886611,-74.776708)"
2012,Agosto,Puerto Rico/Territorio de Estados Unidos,630,3,2,,5,"(12.586067,-81.702563)"
2012,Agosto,Puerto Rico/Territorio de Estados Unidos,630,59,61,,120,"(3.541112,-76.384584)"
2012,Agosto,Puerto Rico/Territorio de Estados Unidos,630,108,130,,238,"(4.697144,-74.140516)"
2012,Agosto,Puerto Rico/Territorio de Estados Unidos,630,9,6,,15,"(4.815061,-75.736532)"
2012,Agosto,Puerto Rico/Territorio de Estados Unidos,630,48,77,,125,"(6.171601,-75.427454)"
2012,Agosto,Puerto Rico/Territorio de Estados Unidos,630,6,5,,11,"(7.128456,-73.183637)"
2012,Agosto,Qatar,634,19,15,,34,"(4.697144,-74.140516)"
2012,Agosto,Qatar,634,1,4,,5,"(6.171601,-75.427454)"
2012,Agosto,Reino Unido de Gran Bretaña e Irlanda del Norte,826,1,0,,1,"(10.445761,-75.516429)"
2012,Agosto,Reino Unido de Gran Bretaña e Irlanda del Norte,826,3,2,,5,"(10.886611,-74.776708)"
2012,Agosto,Reino Unido de Gran Bretaña e Irlanda del Norte,826,81,58,,139,"(3.541112,-76.384584)"
2012,Agosto,Reino Unido de Gran Bretaña e Irlanda del Norte,826,739,593,,1332,"(4.697144,-74.140516)"
2012,Agosto,Reino Unido de Gran Bretaña e Irlanda del Norte,826,1,2,,3,"(4.815061,-75.736532)"
2012,Agosto,Reino Unido de Gran Bretaña e Irlanda del Norte,826,66,46,,112,"(6.171601,-75.427454)"
2012,Agosto,Federación de Rusia,643,0,2,,2,"(3.541112,-76.384584)"
2012,Agosto,Federación de Rusia,643,79,90,,169,"(4.697144,-74.140516)"
2012,Agosto,Federación de Rusia,643,2,2,,4,"(6.171601,-75.427454)"
2012,Agosto,República Dominicana,214,1,0,,1,"(10.408582,-75.538003)"
2012,Agosto,República Dominicana,214,20,41,,61,"(10.445761,-75.516429)"
2012,Agosto,República Dominicana,214,41,23,,64,"(10.886611,-74.776708)"
2012,Agosto,República Dominicana,214,3,3,,6,"(12.586067,-81.702563)"
2012,Agosto,República Dominicana,214,207,156,,363,"(3.541112,-76.384584)"
2012,Agosto,República Dominicana,214,1250,1304,,2554,"(4.697144,-74.140516)"
2012,Agosto,República Dominicana,214,19,18,,37,"(4.815061,-75.736532)"
2012,Agosto,República Dominicana,214,166,154,,320,"(6.171601,-75.427454)"
2012,Agosto,República Dominicana,214,15,14,,29,"(7.128456,-73.183637)"
2012,Agosto,República Dominicana,214,3,1,,4,"(7.927209,-72.507910)"
2012,Agosto,Rumania,642,7,0,,7,"(4.697144,-74.140516)"
2012,Agosto,San  Vicente y las Granadinas,670,1,1,,2,"(3.541112,-76.384584)"
2012,Agosto,Santo Tomé y Príncipe,678,1,1,,2,"(6.171601,-75.427454)"
2012,Agosto,Serbia,688,2,0,,2,"(6.171601,-75.427454)"
2012,Agosto,Singapur,702,22,15,,37,"(4.697144,-74.140516)"
2012,Agosto,Singapur,702,1,1,,2,"(6.171601,-75.427454)"
2012,Agosto,Sudáfrica,710,12,10,,22,"(4.697144,-74.140516)"
2012,Agosto,Sudáfrica,710,0,1,,1,"(6.171601,-75.427454)"
2012,Agosto,Sudán,736,1,0,,1,"(4.697144,-74.140516)"
2012,Agosto,Suecia,752,8,7,,15,"(3.541112,-76.384584)"
2012,Agosto,Suecia,752,121,58,,179,"(4.697144,-74.140516)"
2012,Agosto,Suecia,752,7,1,,8,"(6.171601,-75.427454)"
2012,Agosto,Suiza,756,1,0,,1,"(10.886611,-74.776708)"
2012,Agosto,Suiza,756,72,26,,98,"(3.541112,-76.384584)"
2012,Agosto,Suiza,756,362,215,,577,"(4.697144,-74.140516)"
2012,Agosto,Suiza,756,25,13,,38,"(6.171601,-75.427454)"
2012,Agosto,Surinam,740,2,1,,3,"(4.697144,-74.140516)"
2012,Agosto,Taiwán,158,1,4,,5,"(4.697144,-74.140516)"
2012,Agosto,Taiwán,158,0,1,,1,"(6.171601,-75.427454)"
2012,Agosto,Tailandia,764,1,0,,1,"(3.541112,-76.384584)"
2012,Agosto,Tailandia,764,10,9,,19,"(4.697144,-74.140516)"
2012,Agosto,Tailandia,764,1,0,,1,"(6.171601,-75.427454)"
2012,Agosto,Tanzania,834,0,1,,1,"(4.697144,-74.140516)"
2012,Agosto,Trinidad y Tobago,780,1,1,,2,"(10.886611,-74.776708)"
2012,Agosto,Trinidad y Tobago,780,11,5,,16,"(3.541112,-76.384584)"
2012,Agosto,Trinidad y Tobago,780,21,32,,53,"(4.697144,-74.140516)"
2012,Agosto,Trinidad y Tobago,780,1,1,,2,"(4.815061,-75.736532)"
2012,Agosto,Trinidad y Tobago,780,14,10,,24,"(6.171601,-75.427454)"
2012,Agosto,Trinidad y Tobago,780,4,3,,7,"(7.128456,-73.183637)"
2012,Agosto,Túnez,788,1,2,,3,"(4.697144,-74.140516)"
2012,Agosto,Turquía,792,34,21,,55,"(4.697144,-74.140516)"
2012,Agosto,Turquía,792,2,0,,2,"(6.171601,-75.427454)"
2012,Agosto,Ucrania,804,0,9,,9,"(4.697144,-74.140516)"
2012,Agosto,Uruguay,858,0,1,,1,"(10.445761,-75.516429)"
2012,Agosto,Uruguay,858,2,1,,3,"(10.886611,-74.776708)"
2012,Agosto,Uruguay,858,9,13,,22,"(3.541112,-76.384584)"
2012,Agosto,Uruguay,858,44,64,,108,"(4.697144,-74.140516)"
2012,Agosto,Uruguay,858,7,7,,14,"(6.171601,-75.427454)"
2012,Agosto,Uruguay,858,0,2,,2,"(7.128456,-73.183637)"
2012,Agosto,Uzbekistán,860,1,0,,1,"(4.697144,-74.140516)"
2012,Agosto,Venezuela,862,9,9,,18,"(10.445761,-75.516429)"
2012,Agosto,Venezuela,862,9,15,,24,"(10.886611,-74.776708)"
2012,Agosto,Venezuela,862,7084,6497,,13581,"(11.360009,-72.129330)"
2012,Agosto,Venezuela,862,9,13,,22,"(3.541112,-76.384584)"
2012,Agosto,Venezuela,862,2036,2628,,4664,"(4.697144,-74.140516)"
2012,Agosto,Venezuela,862,3,1,,4,"(4.815061,-75.736532)"
2012,Agosto,Venezuela,862,283,309,,592,"(6.171601,-75.427454)"
2012,Agosto,Venezuela,862,215,270,,485,"(6.185799,-67.483929)"
2012,Agosto,Venezuela,862,1402,1352,,2754,"(7.088729,-70.740253)"
2012,Agosto,Venezuela,862,1,3,,4,"(7.128456,-73.183637)"
2012,Agosto,Venezuela,862,7353,8095,,15448,"(7.818934,-72.453226)"
2012,Agosto,Venezuela,862,1,0,,1,"(7.927209,-72.507910)"
2012,Agosto,Vietnam,704,11,6,,17,"(4.697144,-74.140516)"
2012,Agosto,Islas Vírgenes Británicas/Territorio Británico de Ultramar,92,1,1,,2,"(4.697144,-74.140516)"
2012,Agosto,Desconocido,99999,0,1,,1,"(12.586067,-81.702563)"
2012,Agosto,Desconocido,99999,6,12,,18,"(4.697144,-74.140516)"
2012,Septiembre,Afganistán,4,0,1,,1,"(3.541112,-76.384584)"
2012,Septiembre,Afganistán,4,3,31,,34,"(4.697144,-74.140516)"
2012,Septiembre,Alemania,276,3,5,,8,"(10.445761,-75.516429)"
2012,Septiembre,Alemania,276,5,0,,5,"(10.886611,-74.776708)"
2012,Septiembre,Alemania,276,36,22,,58,"(3.541112,-76.384584)"
2012,Septiembre,Alemania,276,1120,1093,,2213,"(4.697144,-74.140516)"
2012,Septiembre,Alemania,276,25,31,,56,"(6.171601,-75.427454)"
2012,Septiembre,Alemania,276,0,1,,1,"(7.128456,-73.183637)"
2012,Septiembre,Andorra,20,1,1,,2,"(4.697144,-74.140516)"
2012,Septiembre,Andorra,20,0,1,,1,"(6.171601,-75.427454)"
2012,Septiembre,Angola,24,0,1,,1,"(3.541112,-76.384584)"
2012,Septiembre,Angola,24,5,9,,14,"(4.697144,-74.140516)"
2012,Septiembre,Países Bajos,528,0,1,,1,"(10.408582,-75.538003)"
2012,Septiembre,Países Bajos,528,1,0,,1,"(10.886611,-74.776708)"
2012,Septiembre,Países Bajos,528,26,20,,46,"(3.541112,-76.384584)"
2012,Septiembre,Países Bajos,528,137,113,,250,"(4.697144,-74.140516)"
2012,Septiembre,Países Bajos,528,1,1,,2,"(4.815061,-75.736532)"
2012,Septiembre,Países Bajos,528,48,38,,86,"(6.171601,-75.427454)"
2012,Septiembre,Países Bajos,528,2,3,,5,"(7.128456,-73.183637)"
2012,Septiembre,Países Bajos,528,1,0,,1,"(7.927209,-72.507910)"
2012,Septiembre,Arabia Saudita,682,0,1,,1,"(10.445761,-75.516429)"
2012,Septiembre,Arabia Saudita,682,0,1,,1,"(10.886611,-74.776708)"
2012,Septiembre,Arabia Saudita,682,13,31,,44,"(4.697144,-74.140516)"
2012,Septiembre,Arabia Saudita,682,0,1,,1,"(6.171601,-75.427454)"
2012,Septiembre,Argelia,12,1,1,,2,"(3.541112,-76.384584)"
2012,Septiembre,Argelia,12,0,4,,4,"(4.697144,-74.140516)"
2012,Septiembre,Argelia,12,1,1,,2,"(6.171601,-75.427454)"
2012,Septiembre,Argelia,12,1,0,,1,"(7.128456,-73.183637)"
2012,Septiembre,Argentina,32,5,13,,18,"(0.814836,-77.662532)"
2012,Septiembre,Argentina,32,15,18,,33,"(10.445761,-75.516429)"
2012,Septiembre,Argentina,32,24,21,,45,"(10.886611,-74.776708)"
2012,Septiembre,Argentina,32,3,3,,6,"(12.586067,-81.702563)"
2012,Septiembre,Argentina,32,162,184,,346,"(3.541112,-76.384584)"
2012,Septiembre,Argentina,32,2236,2384,,4620,"(4.697144,-74.140516)"
2012,Septiembre,Argentina,32,8,13,,21,"(4.815061,-75.736532)"
2012,Septiembre,Argentina,32,238,212,,450,"(6.171601,-75.427454)"
2012,Septiembre,Argentina,32,7,8,,15,"(7.128456,-73.183637)"
2012,Septiembre,Aruba,533,2,3,,5,"(10.408582,-75.538003)"
2012,Septiembre,Aruba,533,11,3,,14,"(10.445761,-75.516429)"
2012,Septiembre,Aruba,533,8,7,,15,"(10.886611,-74.776708)"
2012,Septiembre,Aruba,533,71,44,,115,"(11.528919,-72.919681)"
2012,Septiembre,Aruba,533,9,3,,12,"(3.541112,-76.384584)"
2012,Septiembre,Aruba,533,868,815,,1683,"(4.697144,-74.140516)"
2012,Septiembre,Aruba,533,3,0,,3,"(4.815061,-75.736532)"
2012,Septiembre,Aruba,533,49,31,,80,"(6.171601,-75.427454)"
2012,Septiembre,Aruba,533,6,13,,19,"(7.128456,-73.183637)"
2012,Septiembre,Aruba,533,0,1,,1,"(9.402978,-75.681599)"
2012,Septiembre,Australia,36,0,1,,1,"(10.445761,-75.516429)"
2012,Septiembre,Australia,36,9,9,,18,"(3.541112,-76.384584)"
2012,Septiembre,Australia,36,162,146,,308,"(4.697144,-74.140516)"
2012,Septiembre,Australia,36,0,1,,1,"(4.815061,-75.736532)"
2012,Septiembre,Australia,36,21,17,,38,"(6.171601,-75.427454)"
2012,Septiembre,Austria,40,2,1,,3,"(10.445761,-75.516429)"
2012,Septiembre,Austria,40,2,3,,5,"(3.541112,-76.384584)"
2012,Septiembre,Austria,40,33,47,,80,"(4.697144,-74.140516)"
2012,Septiembre,Austria,40,1,0,,1,"(6.171601,-75.427454)"
2012,Septiembre,Azerbaiyán,31,3,6,,9,"(4.697144,-74.140516)"
2012,Septiembre,Bahamas,44,1,1,,2,"(10.886611,-74.776708)"
2012,Septiembre,Bahamas,44,12,9,,21,"(3.541112,-76.384584)"
2012,Septiembre,Bahamas,44,40,37,,77,"(4.697144,-74.140516)"
2012,Septiembre,Bahamas,44,3,4,,7,"(4.815061,-75.736532)"
2012,Septiembre,Bahamas,44,7,11,,18,"(6.171601,-75.427454)"
2012,Septiembre,Bahamas,44,1,0,,1,"(7.128456,-73.183637)"
2012,Septiembre,Bahamas,44,8,3,,11,"(7.927209,-72.507910)"
2012,Septiembre,Bahréin,48,1,0,,1,"(3.541112,-76.384584)"
2012,Septiembre,Bahréin,48,3,0,,3,"(4.697144,-74.140516)"
2012,Septiembre,Barbados,52,0,1,,1,"(10.886611,-74.776708)"
2012,Septiembre,Barbados,52,1,1,,2,"(3.541112,-76.384584)"
2012,Septiembre,Barbados,52,2,11,,13,"(4.697144,-74.140516)"
2012,Septiembre,Barbados,52,5,5,,10,"(6.171601,-75.427454)"
2012,Septiembre,Barbados,52,1,1,,2,"(7.128456,-73.183637)"
2012,Septiembre,República de Belarús,112,1,1,,2,"(3.541112,-76.384584)"
2012,Septiembre,República de Belarús,112,3,0,,3,"(4.697144,-74.140516)"
2012,Septiembre,República de Belarús,112,1,1,,2,"(7.088729,-70.740253)"
2012,Septiembre,República de Belarús,112,2,2,,4,"(7.818934,-72.453226)"
2012,Septiembre,Bélgica,56,4,4,,8,"(3.541112,-76.384584)"
2012,Septiembre,Bélgica,56,74,56,,130,"(4.697144,-74.140516)"
2012,Septiembre,Bélgica,56,12,7,,19,"(6.171601,-75.427454)"
2012,Septiembre,Belice,84,2,5,,7,"(4.697144,-74.140516)"
2012,Septiembre,Belice,84,1,1,,2,"(6.171601,-75.427454)"
2012,Septiembre,Benín,204,0,4,,4,"(4.697144,-74.140516)"
2012,Septiembre,Bermudas/Territorio Británico de Ultramar,60,1,1,,2,"(6.171601,-75.427454)"
2012,Septiembre,Bolivia,68,4,5,,9,"(0.814836,-77.662532)"
2012,Septiembre,Bolivia,68,0,2,,2,"(10.445761,-75.516429)"
2012,Septiembre,Bolivia,68,7,4,,11,"(10.886611,-74.776708)"
2012,Septiembre,Bolivia,68,13,31,,44,"(3.541112,-76.384584)"
2012,Septiembre,Bolivia,68,204,335,,539,"(4.697144,-74.140516)"
2012,Septiembre,Bolivia,68,12,28,,40,"(6.171601,-75.427454)"
2012,Septiembre,Botsuana,72,0,1,,1,"(4.697144,-74.140516)"
2012,Septiembre,Brasil,76,59,124,,183,"(-4.197703,-69.941278)"
2012,Septiembre,Brasil,76,0,1,,1,"(0.814836,-77.662532)"
2012,Septiembre,Brasil,76,3,9,,12,"(10.445761,-75.516429)"
2012,Septiembre,Brasil,76,3,6,,9,"(10.886611,-74.776708)"
2012,Septiembre,Brasil,76,36,62,,98,"(3.541112,-76.384584)"
2012,Septiembre,Brasil,76,1932,3045,,4977,"(4.697144,-74.140516)"
2012,Septiembre,Brasil,76,0,4,,4,"(4.815061,-75.736532)"
2012,Septiembre,Brasil,76,65,89,,154,"(6.171601,-75.427454)"
2012,Septiembre,Brasil,76,2,2,,4,"(7.128456,-73.183637)"
2012,Septiembre,Bulgaria,100,0,5,,5,"(4.697144,-74.140516)"
2012,Septiembre,Burundi,108,1,1,,2,"(4.697144,-74.140516)"
2012,Septiembre,Cabo Verde,132,1,0,,1,"(0.814836,-77.662532)"
2012,Septiembre,Islas Caimán/Territorio Británico de Ultramar,136,5,2,,7,"(10.445761,-75.516429)"
2012,Septiembre,Islas Caimán/Territorio Británico de Ultramar,136,1,0,,1,"(10.886611,-74.776708)"
2012,Septiembre,Islas Caimán/Territorio Británico de Ultramar,136,6,2,,8,"(12.586067,-81.702563)"
2012,Septiembre,Islas Caimán/Territorio Británico de Ultramar,136,0,1,,1,"(3.541112,-76.384584)"
2012,Septiembre,Islas Caimán/Territorio Británico de Ultramar,136,0,1,,1,"(4.697144,-74.140516)"
2012,Septiembre,Canadá,124,16,18,,34,"(10.445761,-75.516429)"
2012,Septiembre,Canadá,124,9,7,,16,"(10.886611,-74.776708)"
2012,Septiembre,Canadá,124,2,0,,2,"(11.360009,-72.129330)"
2012,Septiembre,Canadá,124,50,41,,91,"(3.541112,-76.384584)"
2012,Septiembre,Canadá,124,6,3,,9,"(4.452882,-75.766298)"
2012,Septiembre,Canadá,124,1620,1458,,3078,"(4.697144,-74.140516)"
2012,Septiembre,Canadá,124,117,106,,223,"(6.171601,-75.427454)"
2012,Septiembre,Canadá,124,2,0,,2,"(7.128456,-73.183637)"
2012,Septiembre,España,724,9,10,,19,"(10.445761,-75.516429)"
2012,Septiembre,España,724,2313,1475,,3788,"(3.541112,-76.384584)"
2012,Septiembre,España,724,7585,5765,,13350,"(4.697144,-74.140516)"
2012,Septiembre,España,724,902,655,,1557,"(6.171601,-75.427454)"
2012,Septiembre,República Democrática del Congo,180,1,1,,2,"(4.697144,-74.140516)"
2012,Septiembre,República de Corea,410,19,47,,66,"(4.697144,-74.140516)"
2012,Septiembre,República de Corea,410,1,2,,3,"(6.171601,-75.427454)"
2012,Septiembre,Costa de Marfil,384,0,1,,1,"(4.697144,-74.140516)"
2012,Septiembre,Costa Rica,188,4,13,,17,"(10.445761,-75.516429)"
2012,Septiembre,Costa Rica,188,8,20,,28,"(10.886611,-74.776708)"
2012,Septiembre,Costa Rica,188,1,5,,6,"(11.247723,-74.213989)"
2012,Septiembre,Costa Rica,188,3,37,,40,"(12.5744111,-81.703935)"
2012,Septiembre,Costa Rica,188,4,1,,5,"(12.586067,-81.702563)"
2012,Septiembre,Costa Rica,188,40,45,,85,"(3.541112,-76.384584)"
2012,Septiembre,Costa Rica,188,635,832,,1467,"(4.697144,-74.140516)"
2012,Septiembre,Costa Rica,188,7,8,,15,"(4.815061,-75.736532)"
2012,Septiembre,Costa Rica,188,203,241,,444,"(6.171601,-75.427454)"
2012,Septiembre,Costa Rica,188,2,4,,6,"(7.128456,-73.183637)"
2012,Septiembre,Costa Rica,188,0,1,,1,"(7.927209,-72.507910)"
2012,Septiembre,Costa Rica,188,0,1,,1,"(8.635765,-77.346578)"
2012,Septiembre,Croacia,191,1,0,,1,"(3.541112,-76.384584)"
2012,Septiembre,Cuba,192,8,5,,13,"(10.445761,-75.516429)"
2012,Septiembre,Cuba,192,20,17,,37,"(10.886611,-74.776708)"
2012,Septiembre,Cuba,192,1,1,,2,"(12.586067,-81.702563)"
2012,Septiembre,Cuba,192,123,92,,215,"(3.541112,-76.384584)"
2012,Septiembre,Cuba,192,849,740,,1589,"(4.697144,-74.140516)"
2012,Septiembre,Cuba,192,15,12,,27,"(4.815061,-75.736532)"
2012,Septiembre,Cuba,192,199,153,,352,"(6.171601,-75.427454)"
2012,Septiembre,Cuba,192,18,12,,30,"(7.128456,-73.183637)"
2012,Septiembre,Cuba,192,0,2,,2,"(7.927209,-72.507910)"
2012,Septiembre,Curazao,99999,0,2,,2,"(10.408582,-75.538003)"
2012,Septiembre,Curazao,99999,1,0,,1,"(10.445761,-75.516429)"
2012,Septiembre,Curazao,99999,1,8,,9,"(10.886611,-74.776708)"
2012,Septiembre,Curazao,99999,5,4,,9,"(3.541112,-76.384584)"
2012,Septiembre,Curazao,99999,547,425,,972,"(4.697144,-74.140516)"
2012,Septiembre,Curazao,99999,103,53,,156,"(6.171601,-75.427454)"
2012,Septiembre,República Checa,203,11,11,,22,"(4.697144,-74.140516)"
2012,Septiembre,Chile,152,36,34,,70,"(0.814836,-77.662532)"
2012,Septiembre,Chile,152,14,25,,39,"(10.445761,-75.516429)"
2012,Septiembre,Chile,152,44,107,,151,"(10.886611,-74.776708)"
2012,Septiembre,Chile,152,1,1,,2,"(12.586067,-81.702563)"
2012,Septiembre,Chile,152,342,275,,617,"(3.541112,-76.384584)"
2012,Septiembre,Chile,152,2179,2269,,4448,"(4.697144,-74.140516)"
2012,Septiembre,Chile,152,32,58,,90,"(4.815061,-75.736532)"
2012,Septiembre,Chile,152,151,122,,273,"(6.171601,-75.427454)"
2012,Septiembre,Chile,152,7,12,,19,"(7.128456,-73.183637)"
2012,Septiembre,Chile,152,7,6,,13,"(7.927209,-72.507910)"
2012,Septiembre,China,156,1,2,,3,"(10.886611,-74.776708)"
2012,Septiembre,China,156,4,9,,13,"(3.541112,-76.384584)"
2012,Septiembre,China,156,217,410,,627,"(4.697144,-74.140516)"
2012,Septiembre,China,156,5,16,,21,"(6.171601,-75.427454)"
2012,Septiembre,China,156,0,1,,1,"(7.128456,-73.183637)"
2012,Septiembre,Chipre,196,1,1,,2,"(4.697144,-74.140516)"
2012,Septiembre,Dinamarca,208,1,1,,2,"(3.541112,-76.384584)"
2012,Septiembre,Dinamarca,208,23,20,,43,"(4.697144,-74.140516)"
2012,Septiembre,Dinamarca,208,1,0,,1,"(6.171601,-75.427454)"
2012,Septiembre,República de Yibuti,262,1,0,,1,"(4.697144,-74.140516)"
2012,Septiembre,Dominica,212,2,5,,7,"(4.697144,-74.140516)"
2012,Septiembre,Dominica,212,1,0,,1,"(6.171601,-75.427454)"
2012,Septiembre,Dominica,212,2,1,,3,"(7.927209,-72.507910)"
2012,Septiembre,Ecuador,218,307,423,,730,"(0.25129,-76.875963)"
2012,Septiembre,Ecuador,218,5238,6190,,11428,"(0.814836,-77.662532)"
2012,Septiembre,Ecuador,218,103,125,,228,"(1.813928,-78.763924)"
2012,Septiembre,Ecuador,218,15,14,,29,"(10.445761,-75.516429)"
2012,Septiembre,Ecuador,218,7,6,,13,"(10.886611,-74.776708)"
2012,Septiembre,Ecuador,218,574,554,,1128,"(3.541112,-76.384584)"
2012,Septiembre,Ecuador,218,1913,3693,,5606,"(4.697144,-74.140516)"
2012,Septiembre,Ecuador,218,4,0,,4,"(4.815061,-75.736532)"
2012,Septiembre,Ecuador,218,275,388,,663,"(6.171601,-75.427454)"
2012,Septiembre,Ecuador,218,0,3,,3,"(7.128456,-73.183637)"
2012,Septiembre,Ecuador,218,0,1,,1,"(7.927209,-72.507910)"
2012,Septiembre,Egipto,818,166,222,,388,"(4.697144,-74.140516)"
2012,Septiembre,Egipto,818,1,1,,2,"(6.171601,-75.427454)"
2012,Septiembre,El Salvador,222,2,10,,12,"(10.445761,-75.516429)"
2012,Septiembre,El Salvador,222,1,3,,4,"(10.886611,-74.776708)"
2012,Septiembre,El Salvador,222,43,55,,98,"(3.541112,-76.384584)"
2012,Septiembre,El Salvador,222,775,931,,1706,"(4.697144,-74.140516)"
2012,Septiembre,El Salvador,222,2,0,,2,"(4.815061,-75.736532)"
2012,Septiembre,El Salvador,222,42,54,,96,"(6.171601,-75.427454)"
2012,Septiembre,El Salvador,222,1,0,,1,"(7.128456,-73.183637)"
2012,Septiembre,Emiratos Árabes,784,2,1,,3,"(3.541112,-76.384584)"
2012,Septiembre,Emiratos Árabes,784,84,256,,340,"(4.697144,-74.140516)"
2012,Septiembre,Emiratos Árabes,784,2,1,,3,"(6.171601,-75.427454)"
2012,Septiembre,Emiratos Árabes,784,0,1,,1,"(7.128456,-73.183637)"
2012,Septiembre,Eritrea,232,0,1,,1,"(3.541112,-76.384584)"
2012,Septiembre,Eslovaquia,703,0,3,,3,"(4.697144,-74.140516)"
2012,Septiembre,Eslovenia,705,1,1,,2,"(3.541112,-76.384584)"
2012,Septiembre,Eslovenia,705,5,1,,6,"(4.697144,-74.140516)"
2012,Septiembre,Estados Unidos de América,840,0,1,,1,"(10.408582,-75.538003)"
2012,Septiembre,Estados Unidos de América,840,1472,1375,,2847,"(10.445761,-75.516429)"
2012,Septiembre,Estados Unidos de América,840,1600,1375,,2975,"(10.886611,-74.776708)"
2012,Septiembre,Estados Unidos de América,840,23,13,,36,"(12.586067,-81.702563)"
2012,Septiembre,Estados Unidos de América,840,4238,3186,,7424,"(3.541112,-76.384584)"
2012,Septiembre,Estados Unidos de América,840,521,411,,932,"(4.452882,-75.766298)"
2012,Septiembre,Estados Unidos de América,840,25535,24085,,49620,"(4.697144,-74.140516)"
2012,Septiembre,Estados Unidos de América,840,197,148,,345,"(4.815061,-75.736532)"
2012,Septiembre,Estados Unidos de América,840,6598,5260,,11858,"(6.171601,-75.427454)"
2012,Septiembre,Estados Unidos de América,840,76,49,,125,"(7.128456,-73.183637)"
2012,Septiembre,Estados Unidos de América,840,6,2,,8,"(7.927209,-72.507910)"
2012,Septiembre,Etiopia,231,0,2,,2,"(4.697144,-74.140516)"
2012,Septiembre,Filipinas,608,0,1,,1,"(4.697144,-74.140516)"
2012,Septiembre,Filipinas,608,0,3,,3,"(6.171601,-75.427454)"
2012,Septiembre,Finlandia,246,0,1,,1,"(10.445761,-75.516429)"
2012,Septiembre,Finlandia,246,1,0,,1,"(10.886611,-74.776708)"
2012,Septiembre,Finlandia,246,0,1,,1,"(3.541112,-76.384584)"
2012,Septiembre,Finlandia,246,10,5,,15,"(4.697144,-74.140516)"
2012,Septiembre,Finlandia,246,10,9,,19,"(6.171601,-75.427454)"
2012,Septiembre,Francia,250,2,1,,3,"(10.445761,-75.516429)"
2012,Septiembre,Francia,250,1,0,,1,"(10.886611,-74.776708)"
2012,Septiembre,Francia,250,89,78,,167,"(3.541112,-76.384584)"
2012,Septiembre,Francia,250,1775,1420,,3195,"(4.697144,-74.140516)"
2012,Septiembre,Francia,250,66,49,,115,"(6.171601,-75.427454)"
2012,Septiembre,Gabón,266,0,2,,2,"(4.697144,-74.140516)"
2012,Septiembre,Georgia,268,1,0,,1,"(4.697144,-74.140516)"
2012,Septiembre,Ghana,288,1,2,,3,"(4.697144,-74.140516)"
2012,Septiembre,Granada,308,1,1,,2,"(4.697144,-74.140516)"
2012,Septiembre,Grecia,300,2,1,,3,"(3.541112,-76.384584)"
2012,Septiembre,Grecia,300,31,16,,47,"(4.697144,-74.140516)"
2012,Septiembre,Grecia,300,2,1,,3,"(6.171601,-75.427454)"
2012,Septiembre,Guatemala,320,4,11,,15,"(10.445761,-75.516429)"
2012,Septiembre,Guatemala,320,10,6,,16,"(10.886611,-74.776708)"
2012,Septiembre,Guatemala,320,22,33,,55,"(3.541112,-76.384584)"
2012,Septiembre,Guatemala,320,139,284,,423,"(4.697144,-74.140516)"
2012,Septiembre,Guatemala,320,5,9,,14,"(4.815061,-75.736532)"
2012,Septiembre,Guatemala,320,56,91,,147,"(6.171601,-75.427454)"
2012,Septiembre,Guatemala,320,2,3,,5,"(7.128456,-73.183637)"
2012,Septiembre,Guyana,328,0,1,,1,"(10.445761,-75.516429)"
2012,Septiembre,Guyana,328,0,3,,3,"(10.886611,-74.776708)"
2012,Septiembre,Guyana,328,1,3,,4,"(4.697144,-74.140516)"
2012,Septiembre,Guinea,324,1,3,,4,"(4.697144,-74.140516)"
2012,Septiembre,Guinea Ecuatorial,226,2,5,,7,"(4.697144,-74.140516)"
2012,Septiembre,Guadalupe/Territorio Francés,312,1,0,,1,"(4.697144,-74.140516)"
2012,Septiembre,Haití,332,1,5,,6,"(10.886611,-74.776708)"
2012,Septiembre,Haití,332,0,1,,1,"(3.541112,-76.384584)"
2012,Septiembre,Haití,332,4,9,,13,"(4.697144,-74.140516)"
2012,Septiembre,Haití,332,2,6,,8,"(6.171601,-75.427454)"
2012,Septiembre,Honduras,340,2,11,,13,"(10.445761,-75.516429)"
2012,Septiembre,Honduras,340,2,17,,19,"(10.886611,-74.776708)"
2012,Septiembre,Honduras,340,15,45,,60,"(3.541112,-76.384584)"
2012,Septiembre,Honduras,340,84,188,,272,"(4.697144,-74.140516)"
2012,Septiembre,Honduras,340,2,1,,3,"(4.815061,-75.736532)"
2012,Septiembre,Honduras,340,23,47,,70,"(6.171601,-75.427454)"
2012,Septiembre,Honduras,340,0,1,,1,"(7.927209,-72.507910)"
2012,Septiembre,Hong Kong,344,1,0,,1,"(10.886611,-74.776708)"
2012,Septiembre,Hong Kong,344,0,2,,2,"(3.541112,-76.384584)"
2012,Septiembre,Hong Kong,344,27,73,,100,"(4.697144,-74.140516)"
2012,Septiembre,Hong Kong,344,2,7,,9,"(6.171601,-75.427454)"
2012,Septiembre,Hungría,348,2,3,,5,"(4.697144,-74.140516)"
2012,Septiembre,India,356,3,1,,4,"(3.541112,-76.384584)"
2012,Septiembre,India,356,57,53,,110,"(4.697144,-74.140516)"
2012,Septiembre,India,356,1,3,,4,"(6.171601,-75.427454)"
2012,Septiembre,Indonesia,360,10,9,,19,"(4.697144,-74.140516)"
2012,Septiembre,Iraq,368,0,6,,6,"(4.697144,-74.140516)"
2012,Septiembre,Iraq,368,0,1,,1,"(6.171601,-75.427454)"
2012,Septiembre,Irán,364,2,3,,5,"(4.697144,-74.140516)"
2012,Septiembre,República de Irlanda,372,0,1,,1,"(3.541112,-76.384584)"
2012,Septiembre,República de Irlanda,372,25,18,,43,"(4.697144,-74.140516)"
2012,Septiembre,República de Irlanda,372,1,1,,2,"(6.171601,-75.427454)"
2012,Septiembre,Islandia,352,1,0,,1,"(10.886611,-74.776708)"
2012,Septiembre,Islandia,352,2,1,,3,"(4.697144,-74.140516)"
2012,Septiembre,Islandia,352,1,0,,1,"(6.171601,-75.427454)"
2012,Septiembre,Israel,376,5,4,,9,"(3.541112,-76.384584)"
2012,Septiembre,Israel,376,286,180,,466,"(4.697144,-74.140516)"
2012,Septiembre,Israel,376,9,7,,16,"(6.171601,-75.427454)"
2012,Septiembre,Italia,380,1,1,,2,"(10.445761,-75.516429)"
2012,Septiembre,Italia,380,2,0,,2,"(10.886611,-74.776708)"
2012,Septiembre,Italia,380,101,41,,142,"(3.541112,-76.384584)"
2012,Septiembre,Italia,380,794,577,,1371,"(4.697144,-74.140516)"
2012,Septiembre,Italia,380,54,50,,104,"(6.171601,-75.427454)"
2012,Septiembre,Jamaica,388,3,3,,6,"(10.445761,-75.516429)"
2012,Septiembre,Jamaica,388,1,5,,6,"(10.886611,-74.776708)"
2012,Septiembre,Jamaica,388,8,11,,19,"(3.541112,-76.384584)"
2012,Septiembre,Jamaica,388,37,34,,71,"(4.697144,-74.140516)"
2012,Septiembre,Jamaica,388,1,1,,2,"(4.815061,-75.736532)"
2012,Septiembre,Jamaica,388,21,8,,29,"(6.171601,-75.427454)"
2012,Septiembre,Jamaica,388,4,3,,7,"(7.128456,-73.183637)"
2012,Septiembre,Japón,392,6,1,,7,"(3.541112,-76.384584)"
2012,Septiembre,Japón,392,58,55,,113,"(4.697144,-74.140516)"
2012,Septiembre,Japón,392,1,2,,3,"(6.171601,-75.427454)"
2012,Septiembre,Jordania,400,2,4,,6,"(4.697144,-74.140516)"
2012,Septiembre,Kazajistán,398,2,4,,6,"(4.697144,-74.140516)"
2012,Septiembre,Kenia,404,1,0,,1,"(3.541112,-76.384584)"
2012,Septiembre,Kenia,404,1,3,,4,"(4.697144,-74.140516)"
2012,Septiembre,Kuwait,414,2,2,,4,"(4.697144,-74.140516)"
2012,Septiembre,Lituania,440,0,13,,13,"(4.697144,-74.140516)"
2012,Septiembre,Líbano,422,0,1,,1,"(10.886611,-74.776708)"
2012,Septiembre,Líbano,422,19,26,,45,"(4.697144,-74.140516)"
2012,Septiembre,Libia,434,0,1,,1,"(4.697144,-74.140516)"
2012,Septiembre,Luxemburgo,442,3,2,,5,"(4.697144,-74.140516)"
2012,Septiembre,Madagascar,450,0,1,,1,"(4.697144,-74.140516)"
2012,Septiembre,Malasia,458,0,1,,1,"(3.541112,-76.384584)"
2012,Septiembre,Malasia,458,4,6,,10,"(4.697144,-74.140516)"
2012,Septiembre,Malasia,458,1,1,,2,"(6.171601,-75.427454)"
2012,Septiembre,Malí,466,1,0,,1,"(4.697144,-74.140516)"
2012,Septiembre,Malta,470,6,4,,10,"(4.697144,-74.140516)"
2012,Septiembre,Marruecos,504,7,5,,12,"(4.697144,-74.140516)"
2012,Septiembre,Marruecos,504,3,1,,4,"(6.171601,-75.427454)"
2012,Septiembre,Mauritania,478,1,0,,1,"(4.697144,-74.140516)"
2012,Septiembre,Martinica/Departamento de Ultramar Francés,474,0,2,,2,"(4.697144,-74.140516)"
2012,Septiembre,México,484,1,1,,2,"(0.814836,-77.662532)"
2012,Septiembre,México,484,15,16,,31,"(10.445761,-75.516429)"
2012,Septiembre,México,484,41,40,,81,"(10.886611,-74.776708)"
2012,Septiembre,México,484,2,2,,4,"(12.586067,-81.702563)"
2012,Septiembre,México,484,154,132,,286,"(3.541112,-76.384584)"
2012,Septiembre,México,484,3982,4239,,8221,"(4.697144,-74.140516)"
2012,Septiembre,México,484,28,39,,67,"(4.815061,-75.736532)"
2012,Septiembre,México,484,379,329,,708,"(6.171601,-75.427454)"
2012,Septiembre,México,484,33,44,,77,"(7.128456,-73.183637)"
2012,Septiembre,México,484,4,2,,6,"(7.927209,-72.507910)"
2012,Septiembre,Mónaco,492,1,2,,3,"(4.697144,-74.140516)"
2012,Septiembre,Mónaco,492,1,1,,2,"(6.171601,-75.427454)"
2012,Septiembre,Mozambique,508,0,2,,2,"(4.697144,-74.140516)"
2012,Septiembre,Namibia,516,1,0,,1,"(4.697144,-74.140516)"
2012,Septiembre,Nicaragua,558,0,2,,2,"(10.445761,-75.516429)"
2012,Septiembre,Nicaragua,558,3,4,,7,"(10.886611,-74.776708)"
2012,Septiembre,Nicaragua,558,0,6,,6,"(12.5744111,-81.703935)"
2012,Septiembre,Nicaragua,558,5,15,,20,"(3.541112,-76.384584)"
2012,Septiembre,Nicaragua,558,20,67,,87,"(4.697144,-74.140516)"
2012,Septiembre,Nicaragua,558,1,0,,1,"(4.815061,-75.736532)"
2012,Septiembre,Nicaragua,558,7,16,,23,"(6.171601,-75.427454)"
2012,Septiembre,Nicaragua,558,0,1,,1,"(7.128456,-73.183637)"
2012,Septiembre,Nigeria,566,3,20,,23,"(4.697144,-74.140516)"
2012,Septiembre,Noruega,578,3,1,,4,"(3.541112,-76.384584)"
2012,Septiembre,Noruega,578,20,21,,41,"(4.697144,-74.140516)"
2012,Septiembre,Noruega,578,1,0,,1,"(6.171601,-75.427454)"
2012,Septiembre,Nueva Caledonia/Territorio francés,540,1,0,,1,"(4.697144,-74.140516)"
2012,Septiembre,Nueva Zelanda,554,2,0,,2,"(3.541112,-76.384584)"
2012,Septiembre,Nueva Zelanda,554,17,13,,30,"(4.697144,-74.140516)"
2012,Septiembre,Nueva Zelanda,554,2,0,,2,"(6.171601,-75.427454)"
2012,Septiembre,Omán,512,0,2,,2,"(4.697144,-74.140516)"
2012,Septiembre,Papúa Nueva Guinea,598,0,7,,7,"(4.697144,-74.140516)"
2012,Septiembre,Papúa Nueva Guinea,598,0,1,,1,"(6.171601,-75.427454)"
2012,Septiembre,Pakistán,586,2,2,,4,"(4.697144,-74.140516)"
2012,Septiembre,Panamá,591,11,38,,49,"(10.408582,-75.538003)"
2012,Septiembre,Panamá,591,291,345,,636,"(10.445761,-75.516429)"
2012,Septiembre,Panamá,591,873,958,,1831,"(10.886611,-74.776708)"
2012,Septiembre,Panamá,591,0,1,,1,"(10.971302,-74.765397)"
2012,Septiembre,Panamá,591,1,3,,4,"(12.5744111,-81.703935)"
2012,Septiembre,Panamá,591,68,70,,138,"(12.586067,-81.702563)"
2012,Septiembre,Panamá,591,0,16,,16,"(13.3387613,-81.372937)"
2012,Septiembre,Panamá,591,1344,1365,,2709,"(3.541112,-76.384584)"
2012,Septiembre,Panamá,591,0,1,,1,"(3.893038,-77.067921)"
2012,Septiembre,Panamá,591,6995,7930,,14925,"(4.697144,-74.140516)"
2012,Septiembre,Panamá,591,724,587,,1311,"(4.815061,-75.736532)"
2012,Septiembre,Panamá,591,1812,1930,,3742,"(6.171601,-75.427454)"
2012,Septiembre,Panamá,591,2,12,,14,"(6.228046,-77.404104)"
2012,Septiembre,Panamá,591,279,285,,564,"(7.128456,-73.183637)"
2012,Septiembre,Panamá,591,143,205,,348,"(7.927209,-72.507910)"
2012,Septiembre,Panamá,591,2,90,,92,"(8.066966,-76.735404)"
2012,Septiembre,Panamá,591,71,139,,210,"(8.635765,-77.346578)"
2012,Septiembre,Paraguay,600,0,1,,1,"(10.886611,-74.776708)"
2012,Septiembre,Paraguay,600,11,14,,25,"(3.541112,-76.384584)"
2012,Septiembre,Paraguay,600,31,94,,125,"(4.697144,-74.140516)"
2012,Septiembre,Paraguay,600,2,11,,13,"(6.171601,-75.427454)"
2012,Septiembre,Perú,604,43,80,,123,"(-4.197703,-69.941278)"
2012,Septiembre,Perú,604,31,31,,62,"(0.814836,-77.662532)"
2012,Septiembre,Perú,604,5,7,,12,"(10.445761,-75.516429)"
2012,Septiembre,Perú,604,4,14,,18,"(10.886611,-74.776708)"
2012,Septiembre,Perú,604,0,1,,1,"(12.586067,-81.702563)"
2012,Septiembre,Perú,604,233,223,,456,"(3.541112,-76.384584)"
2012,Septiembre,Perú,604,3153,4254,,7407,"(4.697144,-74.140516)"
2012,Septiembre,Perú,604,2,9,,11,"(4.815061,-75.736532)"
2012,Septiembre,Perú,604,322,387,,709,"(6.171601,-75.427454)"
2012,Septiembre,Perú,604,6,3,,9,"(7.128456,-73.183637)"
2012,Septiembre,Perú,604,3,1,,4,"(7.927209,-72.507910)"
2012,Septiembre,Polonia,616,1,1,,2,"(3.541112,-76.384584)"
2012,Septiembre,Polonia,616,15,12,,27,"(4.697144,-74.140516)"
2012,Septiembre,Polonia,616,1,1,,2,"(4.815061,-75.736532)"
2012,Septiembre,Polonia,616,0,3,,3,"(6.171601,-75.427454)"
2012,Septiembre,Portugal,620,8,3,,11,"(3.541112,-76.384584)"
2012,Septiembre,Portugal,620,52,49,,101,"(4.697144,-74.140516)"
2012,Septiembre,Portugal,620,5,5,,10,"(6.171601,-75.427454)"
2012,Septiembre,Puerto Rico/Territorio de Estados Unidos,630,3,1,,4,"(10.445761,-75.516429)"
2012,Septiembre,Puerto Rico/Territorio de Estados Unidos,630,9,10,,19,"(10.886611,-74.776708)"
2012,Septiembre,Puerto Rico/Territorio de Estados Unidos,630,29,32,,61,"(3.541112,-76.384584)"
2012,Septiembre,Puerto Rico/Territorio de Estados Unidos,630,73,100,,173,"(4.697144,-74.140516)"
2012,Septiembre,Puerto Rico/Territorio de Estados Unidos,630,2,4,,6,"(4.815061,-75.736532)"
2012,Septiembre,Puerto Rico/Territorio de Estados Unidos,630,60,73,,133,"(6.171601,-75.427454)"
2012,Septiembre,Puerto Rico/Territorio de Estados Unidos,630,3,3,,6,"(7.128456,-73.183637)"
2012,Septiembre,Qatar,634,9,8,,17,"(4.697144,-74.140516)"
2012,Septiembre,Reino Unido de Gran Bretaña e Irlanda del Norte,826,2,0,,2,"(10.445761,-75.516429)"
2012,Septiembre,Reino Unido de Gran Bretaña e Irlanda del Norte,826,2,1,,3,"(10.886611,-74.776708)"
2012,Septiembre,Reino Unido de Gran Bretaña e Irlanda del Norte,826,0,1,,1,"(12.586067,-81.702563)"
2012,Septiembre,Reino Unido de Gran Bretaña e Irlanda del Norte,826,98,78,,176,"(3.541112,-76.384584)"
2012,Septiembre,Reino Unido de Gran Bretaña e Irlanda del Norte,826,999,689,,1688,"(4.697144,-74.140516)"
2012,Septiembre,Reino Unido de Gran Bretaña e Irlanda del Norte,826,82,52,,134,"(6.171601,-75.427454)"
2012,Septiembre,Federación de Rusia,643,1,0,,1,"(10.886611,-74.776708)"
2012,Septiembre,Federación de Rusia,643,0,2,,2,"(3.541112,-76.384584)"
2012,Septiembre,Federación de Rusia,643,71,87,,158,"(4.697144,-74.140516)"
2012,Septiembre,Federación de Rusia,643,0,3,,3,"(6.171601,-75.427454)"
2012,Septiembre,República Dominicana,214,16,25,,41,"(10.445761,-75.516429)"
2012,Septiembre,República Dominicana,214,14,17,,31,"(10.886611,-74.776708)"
2012,Septiembre,República Dominicana,214,73,84,,157,"(3.541112,-76.384584)"
2012,Septiembre,República Dominicana,214,1139,1198,,2337,"(4.697144,-74.140516)"
2012,Septiembre,República Dominicana,214,4,9,,13,"(4.815061,-75.736532)"
2012,Septiembre,República Dominicana,214,127,138,,265,"(6.171601,-75.427454)"
2012,Septiembre,República Dominicana,214,16,12,,28,"(7.128456,-73.183637)"
2012,Septiembre,República Dominicana,214,4,7,,11,"(7.927209,-72.507910)"
2012,Septiembre,Reunión,638,1,0,,1,"(4.697144,-74.140516)"
2012,Septiembre,Rumania,642,6,3,,9,"(4.697144,-74.140516)"
2012,Septiembre,San Pedro y Miquelón/territorio de Ultramar de La Unión Europea,666,1,1,,2,"(7.927209,-72.507910)"
2012,Septiembre,Senegal,686,0,1,,1,"(4.697144,-74.140516)"
2012,Septiembre,Singapur,702,0,1,,1,"(3.541112,-76.384584)"
2012,Septiembre,Singapur,702,21,16,,37,"(4.697144,-74.140516)"
2012,Septiembre,Sudáfrica,710,0,1,,1,"(3.541112,-76.384584)"
2012,Septiembre,Sudáfrica,710,18,21,,39,"(4.697144,-74.140516)"
2012,Septiembre,Sudán,736,0,1,,1,"(4.697144,-74.140516)"
2012,Septiembre,Suecia,752,2,8,,10,"(3.541112,-76.384584)"
2012,Septiembre,Suecia,752,45,42,,87,"(4.697144,-74.140516)"
2012,Septiembre,Suecia,752,5,4,,9,"(6.171601,-75.427454)"
2012,Septiembre,Suiza,756,1,0,,1,"(10.445761,-75.516429)"
2012,Septiembre,Suiza,756,29,19,,48,"(3.541112,-76.384584)"
2012,Septiembre,Suiza,756,175,127,,302,"(4.697144,-74.140516)"
2012,Septiembre,Suiza,756,13,4,,17,"(6.171601,-75.427454)"
2012,Septiembre,Surinam,740,3,1,,4,"(4.697144,-74.140516)"
2012,Septiembre,Taiwán,158,3,3,,6,"(4.697144,-74.140516)"
2012,Septiembre,Tailandia,764,17,22,,39,"(4.697144,-74.140516)"
2012,Septiembre,Tailandia,764,0,1,,1,"(6.171601,-75.427454)"
2012,Septiembre,Togo,768,0,2,,2,"(4.697144,-74.140516)"
2012,Septiembre,Trinidad y Tobago,780,4,4,,8,"(10.445761,-75.516429)"
2012,Septiembre,Trinidad y Tobago,780,6,3,,9,"(10.886611,-74.776708)"
2012,Septiembre,Trinidad y Tobago,780,13,7,,20,"(3.541112,-76.384584)"
2012,Septiembre,Trinidad y Tobago,780,19,26,,45,"(4.697144,-74.140516)"
2012,Septiembre,Trinidad y Tobago,780,1,3,,4,"(4.815061,-75.736532)"
2012,Septiembre,Trinidad y Tobago,780,9,11,,20,"(6.171601,-75.427454)"
2012,Septiembre,Trinidad y Tobago,780,2,1,,3,"(7.128456,-73.183637)"
2012,Septiembre,Trinidad y Tobago,780,0,1,,1,"(7.818934,-72.453226)"
2012,Septiembre,Túnez,788,0,1,,1,"(4.697144,-74.140516)"
2012,Septiembre,Turquía,792,5,4,,9,"(3.541112,-76.384584)"
2012,Septiembre,Turquía,792,98,65,,163,"(4.697144,-74.140516)"
2012,Septiembre,Turquía,792,3,3,,6,"(6.171601,-75.427454)"
2012,Septiembre,Ucrania,804,1,5,,6,"(4.697144,-74.140516)"
2012,Septiembre,Uganda,800,0,1,,1,"(4.697144,-74.140516)"
2012,Septiembre,Uruguay,858,6,14,,20,"(3.541112,-76.384584)"
2012,Septiembre,Uruguay,858,43,52,,95,"(4.697144,-74.140516)"
2012,Septiembre,Uruguay,858,18,38,,56,"(6.171601,-75.427454)"
2012,Septiembre,Uruguay,858,1,1,,2,"(7.128456,-73.183637)"
2012,Septiembre,Venezuela,862,10,4,,14,"(10.445761,-75.516429)"
2012,Septiembre,Venezuela,862,6,17,,23,"(10.886611,-74.776708)"
2012,Septiembre,Venezuela,862,7220,6579,,13799,"(11.360009,-72.129330)"
2012,Septiembre,Venezuela,862,5,16,,21,"(3.541112,-76.384584)"
2012,Septiembre,Venezuela,862,2049,2504,,4553,"(4.697144,-74.140516)"
2012,Septiembre,Venezuela,862,7,1,,8,"(4.815061,-75.736532)"
2012,Septiembre,Venezuela,862,225,290,,515,"(6.171601,-75.427454)"
2012,Septiembre,Venezuela,862,166,219,,385,"(6.185799,-67.483929)"
2012,Septiembre,Venezuela,862,1366,1340,,2706,"(7.088729,-70.740253)"
2012,Septiembre,Venezuela,862,0,2,,2,"(7.128456,-73.183637)"
2012,Septiembre,Venezuela,862,7471,8395,,15866,"(7.818934,-72.453226)"
2012,Septiembre,Venezuela,862,7,11,,18,"(7.927209,-72.507910)"
2012,Septiembre,Vietnam,704,2,4,,6,"(4.697144,-74.140516)"
2012,Septiembre,República Árabe de Yemen,887,1,1,,2,"(7.818934,-72.453226)"
2012,Septiembre,Desconocido,99999,0,1,,1,"(10.445761,-75.516429)"
2012,Septiembre,Desconocido,99999,4,10,,14,"(4.697144,-74.140516)"
2012,Septiembre,Desconocido,99999,0,1,,1,"(6.171601,-75.427454)"
2012,Octubre,Afganistán,4,0,2,,2,"(10.886611,-74.776708)"
2012,Octubre,Afganistán,4,3,34,,37,"(4.697144,-74.140516)"
2012,Octubre,Alemania,276,0,2,,2,"(10.445761,-75.516429)"
2012,Octubre,Alemania,276,2,2,,4,"(10.886611,-74.776708)"
2012,Octubre,Alemania,276,18,10,,28,"(3.541112,-76.384584)"
2012,Octubre,Alemania,276,783,874,,1657,"(4.697144,-74.140516)"
2012,Octubre,Alemania,276,12,13,,25,"(6.171601,-75.427454)"
2012,Octubre,Andorra,20,1,0,,1,"(4.697144,-74.140516)"
2012,Octubre,Angola,24,0,1,,1,"(3.541112,-76.384584)"
2012,Octubre,Angola,24,1,12,,13,"(4.697144,-74.140516)"
2012,Octubre,Antigua y Barbuda,28,0,4,,4,"(10.445761,-75.516429)"
2012,Octubre,Países Bajos,528,0,1,,1,"(10.445761,-75.516429)"
2012,Octubre,Países Bajos,528,2,0,,2,"(10.886611,-74.776708)"
2012,Octubre,Países Bajos,528,37,14,,51,"(3.541112,-76.384584)"
2012,Octubre,Países Bajos,528,146,128,,274,"(4.697144,-74.140516)"
2012,Octubre,Países Bajos,528,55,36,,91,"(6.171601,-75.427454)"
2012,Octubre,Países Bajos,528,1,1,,2,"(7.128456,-73.183637)"
2012,Octubre,Arabia Saudita,682,10,20,,30,"(4.697144,-74.140516)"
2012,Octubre,Argelia,12,1,5,,6,"(4.697144,-74.140516)"
2012,Octubre,Argentina,32,5,13,,18,"(0.814836,-77.662532)"
2012,Octubre,Argentina,32,22,18,,40,"(10.445761,-75.516429)"
2012,Octubre,Argentina,32,41,44,,85,"(10.886611,-74.776708)"
2012,Octubre,Argentina,32,3,2,,5,"(12.586067,-81.702563)"
2012,Octubre,Argentina,32,186,201,,387,"(3.541112,-76.384584)"
2012,Octubre,Argentina,32,3397,3213,,6610,"(4.697144,-74.140516)"
2012,Octubre,Argentina,32,22,13,,35,"(4.815061,-75.736532)"
2012,Octubre,Argentina,32,275,237,,512,"(6.171601,-75.427454)"
2012,Octubre,Argentina,32,11,5,,16,"(7.128456,-73.183637)"
2012,Octubre,Argentina,32,6,3,,9,"(7.927209,-72.507910)"
2012,Octubre,República de Armenia,51,1,0,,1,"(4.697144,-74.140516)"
2012,Octubre,Aruba,533,1,3,,4,"(10.445761,-75.516429)"
2012,Octubre,Aruba,533,12,23,,35,"(10.886611,-74.776708)"
2012,Octubre,Aruba,533,75,48,,123,"(11.528919,-72.919681)"
2012,Octubre,Aruba,533,29,27,,56,"(3.541112,-76.384584)"
2012,Octubre,Aruba,533,2,4,,6,"(4.452882,-75.766298)"
2012,Octubre,Aruba,533,1071,955,,2026,"(4.697144,-74.140516)"
2012,Octubre,Aruba,533,1,0,,1,"(4.815061,-75.736532)"
2012,Octubre,Aruba,533,105,89,,194,"(6.171601,-75.427454)"
2012,Octubre,Aruba,533,6,8,,14,"(7.128456,-73.183637)"
2012,Octubre,Aruba,533,0,2,,2,"(7.927209,-72.507910)"
2012,Octubre,Australia,36,3,2,,5,"(10.445761,-75.516429)"
2012,Octubre,Australia,36,0,1,,1,"(10.886611,-74.776708)"
2012,Octubre,Australia,36,8,6,,14,"(3.541112,-76.384584)"
2012,Octubre,Australia,36,163,125,,288,"(4.697144,-74.140516)"
2012,Octubre,Australia,36,0,1,,1,"(4.815061,-75.736532)"
2012,Octubre,Australia,36,20,17,,37,"(6.171601,-75.427454)"
2012,Octubre,Australia,36,2,1,,3,"(7.128456,-73.183637)"
2012,Octubre,Austria,40,30,30,,60,"(4.697144,-74.140516)"
2012,Octubre,Azerbaiyán,31,1,2,,3,"(4.697144,-74.140516)"
2012,Octubre,Bahamas,44,1,1,,2,"(10.445761,-75.516429)"
2012,Octubre,Bahamas,44,7,6,,13,"(10.886611,-74.776708)"
2012,Octubre,Bahamas,44,0,1,,1,"(12.586067,-81.702563)"
2012,Octubre,Bahamas,44,24,10,,34,"(3.541112,-76.384584)"
2012,Octubre,Bahamas,44,57,53,,110,"(4.697144,-74.140516)"
2012,Octubre,Bahamas,44,5,4,,9,"(4.815061,-75.736532)"
2012,Octubre,Bahamas,44,22,25,,47,"(6.171601,-75.427454)"
2012,Octubre,Bahamas,44,1,0,,1,"(7.128456,-73.183637)"
2012,Octubre,Bahamas,44,13,9,,22,"(7.927209,-72.507910)"
2012,Octubre,Bahréin,48,3,4,,7,"(4.697144,-74.140516)"
2012,Octubre,Bahréin,48,1,0,,1,"(6.171601,-75.427454)"
2012,Octubre,Bahréin,48,1,0,,1,"(7.818934,-72.453226)"
2012,Octubre,Bangladesh,50,0,1,,1,"(4.697144,-74.140516)"
2012,Octubre,Barbados,52,2,13,,15,"(4.697144,-74.140516)"
2012,Octubre,Barbados,52,0,1,,1,"(6.171601,-75.427454)"
2012,Octubre,República de Belarús,112,2,0,,2,"(11.360009,-72.129330)"
2012,Octubre,República de Belarús,112,0,3,,3,"(3.541112,-76.384584)"
2012,Octubre,República de Belarús,112,2,0,,2,"(4.697144,-74.140516)"
2012,Octubre,República de Belarús,112,0,1,,1,"(7.088729,-70.740253)"
2012,Octubre,República de Belarús,112,3,0,,3,"(7.818934,-72.453226)"
2012,Octubre,Bélgica,56,14,6,,20,"(3.541112,-76.384584)"
2012,Octubre,Bélgica,56,55,41,,96,"(4.697144,-74.140516)"
2012,Octubre,Bélgica,56,4,5,,9,"(6.171601,-75.427454)"
2012,Octubre,Belice,84,2,0,,2,"(10.886611,-74.776708)"
2012,Octubre,Belice,84,2,1,,3,"(4.697144,-74.140516)"
2012,Octubre,Bermudas/Territorio Británico de Ultramar,60,2,1,,3,"(4.697144,-74.140516)"
2012,Octubre,Bermudas/Territorio Británico de Ultramar,60,1,1,,2,"(6.171601,-75.427454)"
2012,Octubre,Bolivia,68,1,2,,3,"(0.814836,-77.662532)"
2012,Octubre,Bolivia,68,1,0,,1,"(10.445761,-75.516429)"
2012,Octubre,Bolivia,68,4,5,,9,"(10.886611,-74.776708)"
2012,Octubre,Bolivia,68,15,32,,47,"(3.541112,-76.384584)"
2012,Octubre,Bolivia,68,242,363,,605,"(4.697144,-74.140516)"
2012,Octubre,Bolivia,68,1,1,,2,"(4.815061,-75.736532)"
2012,Octubre,Bolivia,68,4,18,,22,"(6.171601,-75.427454)"
2012,Octubre,Botsuana,72,0,1,,1,"(4.697144,-74.140516)"
2012,Octubre,Brasil,76,112,161,,273,"(-4.197703,-69.941278)"
2012,Octubre,Brasil,76,5,14,,19,"(10.445761,-75.516429)"
2012,Octubre,Brasil,76,6,7,,13,"(10.886611,-74.776708)"
2012,Octubre,Brasil,76,52,66,,118,"(3.541112,-76.384584)"
2012,Octubre,Brasil,76,2082,3134,,5216,"(4.697144,-74.140516)"
2012,Octubre,Brasil,76,1,11,,12,"(4.815061,-75.736532)"
2012,Octubre,Brasil,76,67,78,,145,"(6.171601,-75.427454)"
2012,Octubre,Brasil,76,3,3,,6,"(7.128456,-73.183637)"
2012,Octubre,Bulgaria,100,1,3,,4,"(4.697144,-74.140516)"
2012,Octubre,Burundi,108,0,1,,1,"(4.697144,-74.140516)"
2012,Octubre,Islas Caimán/Territorio Británico de Ultramar,136,3,1,,4,"(10.445761,-75.516429)"
2012,Octubre,Islas Caimán/Territorio Británico de Ultramar,136,3,0,,3,"(12.586067,-81.702563)"
2012,Octubre,Camboya,116,0,2,,2,"(4.697144,-74.140516)"
2012,Octubre,Camerún,120,1,0,,1,"(4.697144,-74.140516)"
2012,Octubre,Canadá,124,11,10,,21,"(10.445761,-75.516429)"
2012,Octubre,Canadá,124,7,5,,12,"(10.886611,-74.776708)"
2012,Octubre,Canadá,124,33,33,,66,"(3.541112,-76.384584)"
2012,Octubre,Canadá,124,0,2,,2,"(4.452882,-75.766298)"
2012,Octubre,Canadá,124,1083,1042,,2125,"(4.697144,-74.140516)"
2012,Octubre,Canadá,124,5,6,,11,"(4.815061,-75.736532)"
2012,Octubre,Canadá,124,142,69,,211,"(6.171601,-75.427454)"
2012,Octubre,Canadá,124,1,2,,3,"(7.128456,-73.183637)"
2012,Octubre,España,724,3,2,,5,"(10.445761,-75.516429)"
2012,Octubre,España,724,1516,1092,,2608,"(3.541112,-76.384584)"
2012,Octubre,España,724,6046,4864,,10910,"(4.697144,-74.140516)"
2012,Octubre,España,724,1,2,,3,"(4.815061,-75.736532)"
2012,Octubre,España,724,628,462,,1090,"(6.171601,-75.427454)"
2012,Octubre,República Democrática del Congo,180,0,1,,1,"(12.586067,-81.702563)"
2012,Octubre,República Democrática del Congo,180,2,5,,7,"(4.697144,-74.140516)"
2012,Octubre,República de Corea,410,0,1,,1,"(3.541112,-76.384584)"
2012,Octubre,República de Corea,410,19,43,,62,"(4.697144,-74.140516)"
2012,Octubre,República de Corea,410,0,1,,1,"(6.171601,-75.427454)"
2012,Octubre,Costa Rica,188,3,10,,13,"(10.445761,-75.516429)"
2012,Octubre,Costa Rica,188,12,12,,24,"(10.886611,-74.776708)"
2012,Octubre,Costa Rica,188,1,13,,14,"(12.5744111,-81.703935)"
2012,Octubre,Costa Rica,188,3,5,,8,"(12.586067,-81.702563)"
2012,Octubre,Costa Rica,188,47,39,,86,"(3.541112,-76.384584)"
2012,Octubre,Costa Rica,188,683,824,,1507,"(4.697144,-74.140516)"
2012,Octubre,Costa Rica,188,8,5,,13,"(4.815061,-75.736532)"
2012,Octubre,Costa Rica,188,179,204,,383,"(6.171601,-75.427454)"
2012,Octubre,Costa Rica,188,0,1,,1,"(6.228046,-77.404104)"
2012,Octubre,Costa Rica,188,4,4,,8,"(7.128456,-73.183637)"
2012,Octubre,Croacia,191,1,0,,1,"(3.541112,-76.384584)"
2012,Octubre,Croacia,191,2,1,,3,"(4.697144,-74.140516)"
2012,Octubre,Cuba,192,0,5,,5,"(1.397318,-77.290564)"
2012,Octubre,Cuba,192,20,38,,58,"(10.445761,-75.516429)"
2012,Octubre,Cuba,192,27,11,,38,"(10.886611,-74.776708)"
2012,Octubre,Cuba,192,2,4,,6,"(12.586067,-81.702563)"
2012,Octubre,Cuba,192,176,105,,281,"(3.541112,-76.384584)"
2012,Octubre,Cuba,192,969,880,,1849,"(4.697144,-74.140516)"
2012,Octubre,Cuba,192,13,4,,17,"(4.815061,-75.736532)"
2012,Octubre,Cuba,192,201,130,,331,"(6.171601,-75.427454)"
2012,Octubre,Cuba,192,35,29,,64,"(7.128456,-73.183637)"
2012,Octubre,Cuba,192,2,4,,6,"(7.927209,-72.507910)"
2012,Octubre,Curazao,99999,0,1,,1,"(11.117806,-74.232622)"
2012,Octubre,Curazao,99999,6,2,,8,"(3.541112,-76.384584)"
2012,Octubre,Curazao,99999,545,599,,1144,"(4.697144,-74.140516)"
2012,Octubre,Curazao,99999,6,2,,8,"(4.815061,-75.736532)"
2012,Octubre,Curazao,99999,110,53,,163,"(6.171601,-75.427454)"
2012,Octubre,Curazao,99999,0,2,,2,"(7.128456,-73.183637)"
2012,Octubre,República Checa,203,1,1,,2,"(3.541112,-76.384584)"
2012,Octubre,República Checa,203,6,3,,9,"(4.697144,-74.140516)"
2012,Octubre,Chile,152,12,29,,41,"(0.814836,-77.662532)"
2012,Octubre,Chile,152,5,2,,7,"(10.445761,-75.516429)"
2012,Octubre,Chile,152,26,16,,42,"(10.886611,-74.776708)"
2012,Octubre,Chile,152,5,5,,10,"(12.586067,-81.702563)"
2012,Octubre,Chile,152,309,241,,550,"(3.541112,-76.384584)"
2012,Octubre,Chile,152,2415,2434,,4849,"(4.697144,-74.140516)"
2012,Octubre,Chile,152,54,40,,94,"(4.815061,-75.736532)"
2012,Octubre,Chile,152,204,168,,372,"(6.171601,-75.427454)"
2012,Octubre,Chile,152,6,6,,12,"(7.128456,-73.183637)"
2012,Octubre,China,156,0,4,,4,"(10.445761,-75.516429)"
2012,Octubre,China,156,1,10,,11,"(10.886611,-74.776708)"
2012,Octubre,China,156,6,3,,9,"(3.541112,-76.384584)"
2012,Octubre,China,156,269,524,,793,"(4.697144,-74.140516)"
2012,Octubre,China,156,19,33,,52,"(6.171601,-75.427454)"
2012,Octubre,China,156,1,3,,4,"(7.128456,-73.183637)"
2012,Octubre,Chipre,196,1,1,,2,"(4.697144,-74.140516)"
2012,Octubre,Dinamarca,208,2,1,,3,"(3.541112,-76.384584)"
2012,Octubre,Dinamarca,208,14,10,,24,"(4.697144,-74.140516)"
2012,Octubre,Dominica,212,0,1,,1,"(0.814836,-77.662532)"
2012,Octubre,Dominica,212,1,0,,1,"(3.541112,-76.384584)"
2012,Octubre,Dominica,212,0,1,,1,"(4.697144,-74.140516)"
2012,Octubre,Ecuador,218,335,374,,709,"(0.25129,-76.875963)"
2012,Octubre,Ecuador,218,7122,7781,,14903,"(0.814836,-77.662532)"
2012,Octubre,Ecuador,218,92,116,,208,"(1.813928,-78.763924)"
2012,Octubre,Ecuador,218,0,10,,10,"(10.408582,-75.538003)"
2012,Octubre,Ecuador,218,1,6,,7,"(10.445761,-75.516429)"
2012,Octubre,Ecuador,218,2,7,,9,"(10.886611,-74.776708)"
2012,Octubre,Ecuador,218,0,2,,2,"(12.586067,-81.702563)"
2012,Octubre,Ecuador,218,617,700,,1317,"(3.541112,-76.384584)"
2012,Octubre,Ecuador,218,2332,4058,,6390,"(4.697144,-74.140516)"
2012,Octubre,Ecuador,218,2,2,,4,"(4.815061,-75.736532)"
2012,Octubre,Ecuador,218,356,365,,721,"(6.171601,-75.427454)"
2012,Octubre,Ecuador,218,1,4,,5,"(7.128456,-73.183637)"
2012,Octubre,Egipto,818,1,0,,1,"(10.445761,-75.516429)"
2012,Octubre,Egipto,818,192,89,,281,"(4.697144,-74.140516)"
2012,Octubre,Egipto,818,1,2,,3,"(6.171601,-75.427454)"
2012,Octubre,El Salvador,222,1,6,,7,"(10.445761,-75.516429)"
2012,Octubre,El Salvador,222,4,1,,5,"(10.886611,-74.776708)"
2012,Octubre,El Salvador,222,0,1,,1,"(12.586067,-81.702563)"
2012,Octubre,El Salvador,222,49,57,,106,"(3.541112,-76.384584)"
2012,Octubre,El Salvador,222,796,892,,1688,"(4.697144,-74.140516)"
2012,Octubre,El Salvador,222,3,3,,6,"(4.815061,-75.736532)"
2012,Octubre,El Salvador,222,32,45,,77,"(6.171601,-75.427454)"
2012,Octubre,El Salvador,222,4,4,,8,"(7.128456,-73.183637)"
2012,Octubre,El Salvador,222,2,1,,3,"(7.927209,-72.507910)"
2012,Octubre,Emiratos Árabes,784,2,1,,3,"(3.541112,-76.384584)"
2012,Octubre,Emiratos Árabes,784,75,133,,208,"(4.697144,-74.140516)"
2012,Octubre,Emiratos Árabes,784,2,0,,2,"(6.171601,-75.427454)"
2012,Octubre,Eslovenia,705,1,0,,1,"(3.541112,-76.384584)"
2012,Octubre,Eslovenia,705,1,0,,1,"(4.697144,-74.140516)"
2012,Octubre,Estados Unidos de América,840,1,3,,4,"(10.408582,-75.538003)"
2012,Octubre,Estados Unidos de América,840,1858,1727,,3585,"(10.445761,-75.516429)"
2012,Octubre,Estados Unidos de América,840,1709,1570,,3279,"(10.886611,-74.776708)"
2012,Octubre,Estados Unidos de América,840,5,15,,20,"(11.117806,-74.232622)"
2012,Octubre,Estados Unidos de América,840,16,14,,30,"(12.586067,-81.702563)"
2012,Octubre,Estados Unidos de América,840,3886,3031,,6917,"(3.541112,-76.384584)"
2012,Octubre,Estados Unidos de América,840,578,429,,1007,"(4.452882,-75.766298)"
2012,Octubre,Estados Unidos de América,840,28419,26535,,54954,"(4.697144,-74.140516)"
2012,Octubre,Estados Unidos de América,840,217,155,,372,"(4.815061,-75.736532)"
2012,Octubre,Estados Unidos de América,840,6771,5562,,12333,"(6.171601,-75.427454)"
2012,Octubre,Estados Unidos de América,840,122,85,,207,"(7.128456,-73.183637)"
2012,Octubre,Estados Unidos de América,840,24,15,,39,"(7.927209,-72.507910)"
2012,Octubre,Estonia,233,1,0,,1,"(4.697144,-74.140516)"
2012,Octubre,Etiopia,231,0,2,,2,"(4.697144,-74.140516)"
2012,Octubre,Filipinas,608,0,2,,2,"(10.408582,-75.538003)"
2012,Octubre,Filipinas,608,1,0,,1,"(3.541112,-76.384584)"
2012,Octubre,Filipinas,608,1,5,,6,"(4.697144,-74.140516)"
2012,Octubre,Finlandia,246,1,0,,1,"(3.541112,-76.384584)"
2012,Octubre,Finlandia,246,1,12,,13,"(4.697144,-74.140516)"
2012,Octubre,Francia,250,2,0,,2,"(10.445761,-75.516429)"
2012,Octubre,Francia,250,46,42,,88,"(3.541112,-76.384584)"
2012,Octubre,Francia,250,1164,1076,,2240,"(4.697144,-74.140516)"
2012,Octubre,Francia,250,27,17,,44,"(6.171601,-75.427454)"
2012,Octubre,Gabón,266,0,5,,5,"(4.697144,-74.140516)"
2012,Octubre,Georgia,268,1,1,,2,"(4.697144,-74.140516)"
2012,Octubre,Ghana,288,0,1,,1,"(4.697144,-74.140516)"
2012,Octubre,Gibraltar/Territorio Británico de Ultramar,292,0,1,,1,"(4.697144,-74.140516)"
2012,Octubre,Granada,308,1,0,,1,"(4.697144,-74.140516)"
2012,Octubre,Grecia,300,5,11,,16,"(4.697144,-74.140516)"
2012,Octubre,Grecia,300,1,2,,3,"(6.171601,-75.427454)"
2012,Octubre,Guatemala,320,3,3,,6,"(10.445761,-75.516429)"
2012,Octubre,Guatemala,320,3,7,,10,"(10.886611,-74.776708)"
2012,Octubre,Guatemala,320,1,1,,2,"(12.586067,-81.702563)"
2012,Octubre,Guatemala,320,21,47,,68,"(3.541112,-76.384584)"
2012,Octubre,Guatemala,320,149,254,,403,"(4.697144,-74.140516)"
2012,Octubre,Guatemala,320,8,3,,11,"(4.815061,-75.736532)"
2012,Octubre,Guatemala,320,65,88,,153,"(6.171601,-75.427454)"
2012,Octubre,Guatemala,320,3,1,,4,"(7.128456,-73.183637)"
2012,Octubre,Guatemala,320,1,3,,4,"(7.927209,-72.507910)"
2012,Octubre,Guyana,328,0,1,,1,"(10.886611,-74.776708)"
2012,Octubre,Guyana,328,0,1,,1,"(3.541112,-76.384584)"
2012,Octubre,Guyana,328,1,3,,4,"(4.697144,-74.140516)"
2012,Octubre,Guinea,324,0,1,,1,"(3.541112,-76.384584)"
2012,Octubre,Guinea,324,0,2,,2,"(4.697144,-74.140516)"
2012,Octubre,Guinea Ecuatorial,226,1,0,,1,"(3.541112,-76.384584)"
2012,Octubre,Guinea Ecuatorial,226,1,15,,16,"(4.697144,-74.140516)"
2012,Octubre,Guinea Ecuatorial,226,0,1,,1,"(6.171601,-75.427454)"
2012,Octubre,Guinea Bissau,624,0,1,,1,"(4.697144,-74.140516)"
2012,Octubre,Haití,332,0,2,,2,"(10.445761,-75.516429)"
2012,Octubre,Haití,332,0,7,,7,"(10.886611,-74.776708)"
2012,Octubre,Haití,332,0,2,,2,"(3.893038,-77.067921)"
2012,Octubre,Haití,332,6,18,,24,"(4.697144,-74.140516)"
2012,Octubre,Haití,332,3,4,,7,"(6.171601,-75.427454)"
2012,Octubre,Honduras,340,0,5,,5,"(10.445761,-75.516429)"
2012,Octubre,Honduras,340,1,8,,9,"(10.886611,-74.776708)"
2012,Octubre,Honduras,340,0,1,,1,"(12.586067,-81.702563)"
2012,Octubre,Honduras,340,17,32,,49,"(3.541112,-76.384584)"
2012,Octubre,Honduras,340,65,198,,263,"(4.697144,-74.140516)"
2012,Octubre,Honduras,340,2,6,,8,"(4.815061,-75.736532)"
2012,Octubre,Honduras,340,41,45,,86,"(6.171601,-75.427454)"
2012,Octubre,Honduras,340,0,1,,1,"(7.128456,-73.183637)"
2012,Octubre,Honduras,340,1,2,,3,"(7.927209,-72.507910)"
2012,Octubre,Hong Kong,344,0,2,,2,"(10.445761,-75.516429)"
2012,Octubre,Hong Kong,344,1,3,,4,"(3.541112,-76.384584)"
2012,Octubre,Hong Kong,344,58,151,,209,"(4.697144,-74.140516)"
2012,Octubre,Hong Kong,344,2,18,,20,"(6.171601,-75.427454)"
2012,Octubre,Hungría,348,2,3,,5,"(4.697144,-74.140516)"
2012,Octubre,Hungría,348,0,1,,1,"(6.171601,-75.427454)"
2012,Octubre,India,356,91,56,,147,"(4.697144,-74.140516)"
2012,Octubre,India,356,0,2,,2,"(6.171601,-75.427454)"
2012,Octubre,Indonesia,360,7,17,,24,"(4.697144,-74.140516)"
2012,Octubre,Indonesia,360,0,1,,1,"(6.171601,-75.427454)"
2012,Octubre,Iraq,368,1,20,,21,"(4.697144,-74.140516)"
2012,Octubre,Irán,364,4,6,,10,"(4.697144,-74.140516)"
2012,Octubre,República de Irlanda,372,0,1,,1,"(3.541112,-76.384584)"
2012,Octubre,República de Irlanda,372,9,8,,17,"(4.697144,-74.140516)"
2012,Octubre,Isla de Man,833,0,1,,1,"(6.171601,-75.427454)"
2012,Octubre,Israel,376,2,3,,5,"(3.541112,-76.384584)"
2012,Octubre,Israel,376,239,184,,423,"(4.697144,-74.140516)"
2012,Octubre,Israel,376,1,1,,2,"(6.171601,-75.427454)"
2012,Octubre,Italia,380,2,0,,2,"(10.445761,-75.516429)"
2012,Octubre,Italia,380,72,33,,105,"(3.541112,-76.384584)"
2012,Octubre,Italia,380,555,445,,1000,"(4.697144,-74.140516)"
2012,Octubre,Italia,380,29,20,,49,"(6.171601,-75.427454)"
2012,Octubre,Jamaica,388,7,10,,17,"(10.445761,-75.516429)"
2012,Octubre,Jamaica,388,1,2,,3,"(10.886611,-74.776708)"
2012,Octubre,Jamaica,388,0,4,,4,"(12.586067,-81.702563)"
2012,Octubre,Jamaica,388,11,12,,23,"(3.541112,-76.384584)"
2012,Octubre,Jamaica,388,49,37,,86,"(4.697144,-74.140516)"
2012,Octubre,Jamaica,388,4,0,,4,"(4.815061,-75.736532)"
2012,Octubre,Jamaica,388,14,14,,28,"(6.171601,-75.427454)"
2012,Octubre,Jamaica,388,2,2,,4,"(7.128456,-73.183637)"
2012,Octubre,Jamaica,388,0,2,,2,"(7.927209,-72.507910)"
2012,Octubre,Japón,392,0,1,,1,"(10.886611,-74.776708)"
2012,Octubre,Japón,392,2,5,,7,"(3.541112,-76.384584)"
2012,Octubre,Japón,392,0,1,,1,"(4.452882,-75.766298)"
2012,Octubre,Japón,392,79,106,,185,"(4.697144,-74.140516)"
2012,Octubre,Japón,392,9,12,,21,"(6.171601,-75.427454)"
2012,Octubre,Japón,392,1,0,,1,"(7.128456,-73.183637)"
2012,Octubre,Jordania,400,1,6,,7,"(4.697144,-74.140516)"
2012,Octubre,Kazajistán,398,0,2,,2,"(4.697144,-74.140516)"
2012,Octubre,Kenia,404,5,4,,9,"(4.697144,-74.140516)"
2012,Octubre,Kuwait,414,0,4,,4,"(4.697144,-74.140516)"
2012,Octubre,Lituania,440,1,15,,16,"(4.697144,-74.140516)"
2012,Octubre,Líbano,422,1,0,,1,"(3.541112,-76.384584)"
2012,Octubre,Líbano,422,9,4,,13,"(4.697144,-74.140516)"
2012,Octubre,Luxemburgo,442,2,3,,5,"(4.697144,-74.140516)"
2012,Octubre,Luxemburgo,442,1,0,,1,"(6.171601,-75.427454)"
2012,Octubre,Madagascar,450,0,1,,1,"(4.697144,-74.140516)"
2012,Octubre,Malasia,458,9,3,,12,"(4.697144,-74.140516)"
2012,Octubre,Malawi,454,0,1,,1,"(4.697144,-74.140516)"
2012,Octubre,Malí,466,1,0,,1,"(4.697144,-74.140516)"
2012,Octubre,Malta,470,1,1,,2,"(4.697144,-74.140516)"
2012,Octubre,Marruecos,504,4,8,,12,"(4.697144,-74.140516)"
2012,Octubre,Marruecos,504,0,2,,2,"(6.171601,-75.427454)"
2012,Octubre,Mauritania,478,0,1,,1,"(4.697144,-74.140516)"
2012,Octubre,Martinica/Departamento de Ultramar Francés,474,1,0,,1,"(3.541112,-76.384584)"
2012,Octubre,Martinica/Departamento de Ultramar Francés,474,1,0,,1,"(6.171601,-75.427454)"
2012,Octubre,México,484,17,14,,31,"(10.445761,-75.516429)"
2012,Octubre,México,484,42,32,,74,"(10.886611,-74.776708)"
2012,Octubre,México,484,2,4,,6,"(12.586067,-81.702563)"
2012,Octubre,México,484,230,200,,430,"(3.541112,-76.384584)"
2012,Octubre,México,484,5151,5116,,10267,"(4.697144,-74.140516)"
2012,Octubre,México,484,31,42,,73,"(4.815061,-75.736532)"
2012,Octubre,México,484,608,499,,1107,"(6.171601,-75.427454)"
2012,Octubre,México,484,26,28,,54,"(7.128456,-73.183637)"
2012,Octubre,México,484,13,5,,18,"(7.927209,-72.507910)"
2012,Octubre,República de Moldavia,498,2,1,,3,"(4.697144,-74.140516)"
2012,Octubre,Mónaco,492,1,1,,2,"(4.697144,-74.140516)"
2012,Octubre,Mongolia,496,0,1,,1,"(4.697144,-74.140516)"
2012,Octubre,Montenegro,499,1,0,,1,"(4.697144,-74.140516)"
2012,Octubre,Micronesia,583,1,0,,1,"(4.697144,-74.140516)"
2012,Octubre,Mozambique,508,1,3,,4,"(4.697144,-74.140516)"
2012,Octubre,Myanmar,104,0,11,,11,"(4.697144,-74.140516)"
2012,Octubre,Nepal,524,1,0,,1,"(4.697144,-74.140516)"
2012,Octubre,Nicaragua,558,2,2,,4,"(10.445761,-75.516429)"
2012,Octubre,Nicaragua,558,1,8,,9,"(10.886611,-74.776708)"
2012,Octubre,Nicaragua,558,11,16,,27,"(3.541112,-76.384584)"
2012,Octubre,Nicaragua,558,46,69,,115,"(4.697144,-74.140516)"
2012,Octubre,Nicaragua,558,1,2,,3,"(4.815061,-75.736532)"
2012,Octubre,Nicaragua,558,5,13,,18,"(6.171601,-75.427454)"
2012,Octubre,Nicaragua,558,1,0,,1,"(7.927209,-72.507910)"
2012,Octubre,Nigeria,566,0,30,,30,"(4.697144,-74.140516)"
2012,Octubre,Noruega,578,0,1,,1,"(3.541112,-76.384584)"
2012,Octubre,Noruega,578,22,34,,56,"(4.697144,-74.140516)"
2012,Octubre,Noruega,578,0,1,,1,"(6.171601,-75.427454)"
2012,Octubre,Nueva Caledonia/Territorio francés,540,1,2,,3,"(4.697144,-74.140516)"
2012,Octubre,Nueva Zelanda,554,3,1,,4,"(3.541112,-76.384584)"
2012,Octubre,Nueva Zelanda,554,12,11,,23,"(4.697144,-74.140516)"
2012,Octubre,Nueva Zelanda,554,0,1,,1,"(4.815061,-75.736532)"
2012,Octubre,Nueva Zelanda,554,2,0,,2,"(6.171601,-75.427454)"
2012,Octubre,Omán,512,0,1,,1,"(10.886611,-74.776708)"
2012,Octubre,Omán,512,8,16,,24,"(4.697144,-74.140516)"
2012,Octubre,Papúa Nueva Guinea,598,0,6,,6,"(4.697144,-74.140516)"
2012,Octubre,Panamá,591,13,83,,96,"(10.408582,-75.538003)"
2012,Octubre,Panamá,591,393,451,,844,"(10.445761,-75.516429)"
2012,Octubre,Panamá,591,1040,1064,,2104,"(10.886611,-74.776708)"
2012,Octubre,Panamá,591,0,6,,6,"(11.117806,-74.232622)"
2012,Octubre,Panamá,591,0,7,,7,"(12.5744111,-81.703935)"
2012,Octubre,Panamá,591,80,88,,168,"(12.586067,-81.702563)"
2012,Octubre,Panamá,591,0,8,,8,"(13.3387613,-81.372937)"
2012,Octubre,Panamá,591,1514,1539,,3053,"(3.541112,-76.384584)"
2012,Octubre,Panamá,591,0,7,,7,"(3.893038,-77.067921)"
2012,Octubre,Panamá,591,7624,8305,,15929,"(4.697144,-74.140516)"
2012,Octubre,Panamá,591,647,563,,1210,"(4.815061,-75.736532)"
2012,Octubre,Panamá,591,2143,2179,,4322,"(6.171601,-75.427454)"
2012,Octubre,Panamá,591,7,17,,24,"(6.228046,-77.404104)"
2012,Octubre,Panamá,591,341,318,,659,"(7.128456,-73.183637)"
2012,Octubre,Panamá,591,276,270,,546,"(7.927209,-72.507910)"
2012,Octubre,Panamá,591,2,53,,55,"(8.066966,-76.735404)"
2012,Octubre,Panamá,591,71,148,,219,"(8.635765,-77.346578)"
2012,Octubre,Paraguay,600,3,5,,8,"(10.886611,-74.776708)"
2012,Octubre,Paraguay,600,20,31,,51,"(3.541112,-76.384584)"
2012,Octubre,Paraguay,600,66,119,,185,"(4.697144,-74.140516)"
2012,Octubre,Paraguay,600,0,2,,2,"(4.815061,-75.736532)"
2012,Octubre,Paraguay,600,15,24,,39,"(6.171601,-75.427454)"
2012,Octubre,Paraguay,600,1,1,,2,"(7.128456,-73.183637)"
2012,Octubre,Perú,604,50,105,,155,"(-4.197703,-69.941278)"
2012,Octubre,Perú,604,18,39,,57,"(0.814836,-77.662532)"
2012,Octubre,Perú,604,7,11,,18,"(10.445761,-75.516429)"
2012,Octubre,Perú,604,11,14,,25,"(10.886611,-74.776708)"
2012,Octubre,Perú,604,0,1,,1,"(12.586067,-81.702563)"
2012,Octubre,Perú,604,293,313,,606,"(3.541112,-76.384584)"
2012,Octubre,Perú,604,3983,5063,,9046,"(4.697144,-74.140516)"
2012,Octubre,Perú,604,29,6,,35,"(4.815061,-75.736532)"
2012,Octubre,Perú,604,416,461,,877,"(6.171601,-75.427454)"
2012,Octubre,Perú,604,2,2,,4,"(7.128456,-73.183637)"
2012,Octubre,Perú,604,0,1,,1,"(7.927209,-72.507910)"
2012,Octubre,Palestina,99999,1,2,,3,"(4.697144,-74.140516)"
2012,Octubre,Palestina,99999,1,3,,4,"(6.171601,-75.427454)"
2012,Octubre,Polonia,616,9,14,,23,"(4.697144,-74.140516)"
2012,Octubre,Portugal,620,1,3,,4,"(3.541112,-76.384584)"
2012,Octubre,Portugal,620,28,30,,58,"(4.697144,-74.140516)"
2012,Octubre,Portugal,620,0,2,,2,"(6.171601,-75.427454)"
2012,Octubre,Puerto Rico/Territorio de Estados Unidos,630,11,10,,21,"(10.445761,-75.516429)"
2012,Octubre,Puerto Rico/Territorio de Estados Unidos,630,16,7,,23,"(10.886611,-74.776708)"
2012,Octubre,Puerto Rico/Territorio de Estados Unidos,630,36,22,,58,"(3.541112,-76.384584)"
2012,Octubre,Puerto Rico/Territorio de Estados Unidos,630,83,108,,191,"(4.697144,-74.140516)"
2012,Octubre,Puerto Rico/Territorio de Estados Unidos,630,2,2,,4,"(4.815061,-75.736532)"
2012,Octubre,Puerto Rico/Territorio de Estados Unidos,630,36,44,,80,"(6.171601,-75.427454)"
2012,Octubre,Puerto Rico/Territorio de Estados Unidos,630,3,2,,5,"(7.128456,-73.183637)"
2012,Octubre,Qatar,634,4,6,,10,"(4.697144,-74.140516)"
2012,Octubre,Reino Unido de Gran Bretaña e Irlanda del Norte,826,2,1,,3,"(10.445761,-75.516429)"
2012,Octubre,Reino Unido de Gran Bretaña e Irlanda del Norte,826,1,1,,2,"(10.886611,-74.776708)"
2012,Octubre,Reino Unido de Gran Bretaña e Irlanda del Norte,826,62,34,,96,"(3.541112,-76.384584)"
2012,Octubre,Reino Unido de Gran Bretaña e Irlanda del Norte,826,442,404,,846,"(4.697144,-74.140516)"
2012,Octubre,Reino Unido de Gran Bretaña e Irlanda del Norte,826,1,1,,2,"(4.815061,-75.736532)"
2012,Octubre,Reino Unido de Gran Bretaña e Irlanda del Norte,826,30,19,,49,"(6.171601,-75.427454)"
2012,Octubre,República CentroÁfricana,140,0,1,,1,"(4.697144,-74.140516)"
2012,Octubre,Federación de Rusia,643,2,2,,4,"(3.541112,-76.384584)"
2012,Octubre,Federación de Rusia,643,19,42,,61,"(4.697144,-74.140516)"
2012,Octubre,Federación de Rusia,643,0,1,,1,"(6.171601,-75.427454)"
2012,Octubre,República Dominicana,214,10,24,,34,"(10.445761,-75.516429)"
2012,Octubre,República Dominicana,214,29,37,,66,"(10.886611,-74.776708)"
2012,Octubre,República Dominicana,214,0,1,,1,"(12.586067,-81.702563)"
2012,Octubre,República Dominicana,214,108,103,,211,"(3.541112,-76.384584)"
2012,Octubre,República Dominicana,214,1355,1357,,2712,"(4.697144,-74.140516)"
2012,Octubre,República Dominicana,214,48,36,,84,"(4.815061,-75.736532)"
2012,Octubre,República Dominicana,214,245,219,,464,"(6.171601,-75.427454)"
2012,Octubre,República Dominicana,214,26,27,,53,"(7.128456,-73.183637)"
2012,Octubre,República Dominicana,214,5,8,,13,"(7.927209,-72.507910)"
2012,Octubre,Reunión,638,0,1,,1,"(4.697144,-74.140516)"
2012,Octubre,Rumania,642,1,2,,3,"(4.697144,-74.140516)"
2012,Octubre,Sahara Occidental/Desierto Sahara,732,0,1,,1,"(4.697144,-74.140516)"
2012,Octubre,San Cristóbal y Nevis,659,2,0,,2,"(6.171601,-75.427454)"
2012,Octubre,Singapur,702,11,29,,40,"(4.697144,-74.140516)"
2012,Octubre,Singapur,702,0,2,,2,"(6.171601,-75.427454)"
2012,Octubre,Sudáfrica,710,0,1,,1,"(3.541112,-76.384584)"
2012,Octubre,Sudáfrica,710,11,13,,24,"(4.697144,-74.140516)"
2012,Octubre,Sudáfrica,710,1,1,,2,"(6.171601,-75.427454)"
2012,Octubre,Suecia,752,1,0,,1,"(10.445761,-75.516429)"
2012,Octubre,Suecia,752,5,1,,6,"(3.541112,-76.384584)"
2012,Octubre,Suecia,752,40,35,,75,"(4.697144,-74.140516)"
2012,Octubre,Suecia,752,4,1,,5,"(6.171601,-75.427454)"
2012,Octubre,Suiza,756,1,0,,1,"(10.445761,-75.516429)"
2012,Octubre,Suiza,756,24,9,,33,"(3.541112,-76.384584)"
2012,Octubre,Suiza,756,163,138,,301,"(4.697144,-74.140516)"
2012,Octubre,Suiza,756,7,3,,10,"(6.171601,-75.427454)"
2012,Octubre,Surinam,740,4,4,,8,"(4.697144,-74.140516)"
2012,Octubre,Surinam,740,0,3,,3,"(6.171601,-75.427454)"
2012,Octubre,Taiwán,158,1,2,,3,"(4.697144,-74.140516)"
2012,Octubre,Tailandia,764,0,1,,1,"(3.541112,-76.384584)"
2012,Octubre,Tailandia,764,11,28,,39,"(4.697144,-74.140516)"
2012,Octubre,Tailandia,764,0,1,,1,"(6.171601,-75.427454)"
2012,Octubre,Tanzania,834,0,1,,1,"(4.697144,-74.140516)"
2012,Octubre,Trinidad y Tobago,780,2,8,,10,"(10.445761,-75.516429)"
2012,Octubre,Trinidad y Tobago,780,0,2,,2,"(10.886611,-74.776708)"
2012,Octubre,Trinidad y Tobago,780,8,9,,17,"(3.541112,-76.384584)"
2012,Octubre,Trinidad y Tobago,780,30,49,,79,"(4.697144,-74.140516)"
2012,Octubre,Trinidad y Tobago,780,1,2,,3,"(4.815061,-75.736532)"
2012,Octubre,Trinidad y Tobago,780,3,8,,11,"(6.171601,-75.427454)"
2012,Octubre,Trinidad y Tobago,780,4,1,,5,"(7.128456,-73.183637)"
2012,Octubre,Túnez,788,1,0,,1,"(7.818934,-72.453226)"
2012,Octubre,Turquía,792,1,1,,2,"(3.541112,-76.384584)"
2012,Octubre,Turquía,792,78,50,,128,"(4.697144,-74.140516)"
2012,Octubre,Turquía,792,4,0,,4,"(6.171601,-75.427454)"
2012,Octubre,Ucrania,804,0,2,,2,"(4.697144,-74.140516)"
2012,Octubre,Uruguay,858,4,0,,4,"(0.814836,-77.662532)"
2012,Octubre,Uruguay,858,3,0,,3,"(10.445761,-75.516429)"
2012,Octubre,Uruguay,858,1,2,,3,"(10.886611,-74.776708)"
2012,Octubre,Uruguay,858,8,13,,21,"(3.541112,-76.384584)"
2012,Octubre,Uruguay,858,89,102,,191,"(4.697144,-74.140516)"
2012,Octubre,Uruguay,858,1,1,,2,"(4.815061,-75.736532)"
2012,Octubre,Uruguay,858,16,15,,31,"(6.171601,-75.427454)"
2012,Octubre,Vanuatu,548,2,0,,2,"(11.360009,-72.129330)"
2012,Octubre,Vanuatu,548,1,0,,1,"(6.171601,-75.427454)"
2012,Octubre,Venezuela,862,3,10,,13,"(10.445761,-75.516429)"
2012,Octubre,Venezuela,862,8,22,,30,"(10.886611,-74.776708)"
2012,Octubre,Venezuela,862,5842,5916,,11758,"(11.360009,-72.129330)"
2012,Octubre,Venezuela,862,4,13,,17,"(3.541112,-76.384584)"
2012,Octubre,Venezuela,862,2115,2746,,4861,"(4.697144,-74.140516)"
2012,Octubre,Venezuela,862,1,0,,1,"(4.815061,-75.736532)"
2012,Octubre,Venezuela,862,240,278,,518,"(6.171601,-75.427454)"
2012,Octubre,Venezuela,862,186,275,,461,"(6.185799,-67.483929)"
2012,Octubre,Venezuela,862,1605,1533,,3138,"(7.088729,-70.740253)"
2012,Octubre,Venezuela,862,5,2,,7,"(7.128456,-73.183637)"
2012,Octubre,Venezuela,862,7647,8162,,15809,"(7.818934,-72.453226)"
2012,Octubre,Venezuela,862,1,2,,3,"(7.927209,-72.507910)"
2012,Octubre,Vietnam,704,0,1,,1,"(11.360009,-72.129330)"
2012,Octubre,Vietnam,704,2,10,,12,"(4.697144,-74.140516)"
2012,Octubre,Islas Vírgenes Estadounidenses/Territorio de Estados Unidos,850,0,1,,1,"(6.171601,-75.427454)"
2012,Octubre,Desconocido,99999,2,1,,3,"(3.541112,-76.384584)"
2012,Octubre,Desconocido,99999,5,18,,23,"(4.697144,-74.140516)"
2012,Octubre,Desconocido,99999,1,0,,1,"(6.171601,-75.427454)"
2012,Noviembre,Afganistán,4,0,1,,1,"(10.886611,-74.776708)"
2012,Noviembre,Afganistán,4,2,31,,33,"(4.697144,-74.140516)"
2012,Noviembre,Albania,8,1,0,,1,"(4.697144,-74.140516)"
2012,Noviembre,Alemania,276,3,1,,4,"(0.814836,-77.662532)"
2012,Noviembre,Alemania,276,16,10,,26,"(3.541112,-76.384584)"
2012,Noviembre,Alemania,276,643,736,,1379,"(4.697144,-74.140516)"
2012,Noviembre,Alemania,276,3,7,,10,"(6.171601,-75.427454)"
2012,Noviembre,Andorra,20,2,0,,2,"(4.697144,-74.140516)"
2012,Noviembre,Angola,24,0,2,,2,"(3.541112,-76.384584)"
2012,Noviembre,Angola,24,0,9,,9,"(4.697144,-74.140516)"
2012,Noviembre,Angola,24,0,1,,1,"(7.128456,-73.183637)"
2012,Noviembre,Antigua y Barbuda,28,0,1,,1,"(4.697144,-74.140516)"
2012,Noviembre,Países Bajos,528,0,1,,1,"(10.445761,-75.516429)"
2012,Noviembre,Países Bajos,528,3,2,,5,"(10.886611,-74.776708)"
2012,Noviembre,Países Bajos,528,29,12,,41,"(3.541112,-76.384584)"
2012,Noviembre,Países Bajos,528,102,73,,175,"(4.697144,-74.140516)"
2012,Noviembre,Países Bajos,528,1,0,,1,"(4.815061,-75.736532)"
2012,Noviembre,Países Bajos,528,42,29,,71,"(6.171601,-75.427454)"
2012,Noviembre,Países Bajos,528,9,22,,31,"(7.128456,-73.183637)"
2012,Noviembre,Países Bajos,528,0,1,,1,"(7.927209,-72.507910)"
2012,Noviembre,Arabia Saudita,682,0,1,,1,"(10.445761,-75.516429)"
2012,Noviembre,Arabia Saudita,682,8,41,,49,"(4.697144,-74.140516)"
2012,Noviembre,Arabia Saudita,682,1,3,,4,"(6.171601,-75.427454)"
2012,Noviembre,Argelia,12,0,1,,1,"(0.814836,-77.662532)"
2012,Noviembre,Argelia,12,1,0,,1,"(3.541112,-76.384584)"
2012,Noviembre,Argelia,12,1,3,,4,"(4.697144,-74.140516)"
2012,Noviembre,Argelia,12,1,3,,4,"(6.171601,-75.427454)"
2012,Noviembre,Argentina,32,3,12,,15,"(0.814836,-77.662532)"
2012,Noviembre,Argentina,32,22,20,,42,"(10.445761,-75.516429)"
2012,Noviembre,Argentina,32,46,24,,70,"(10.886611,-74.776708)"
2012,Noviembre,Argentina,32,2,2,,4,"(12.586067,-81.702563)"
2012,Noviembre,Argentina,32,159,154,,313,"(3.541112,-76.384584)"
2012,Noviembre,Argentina,32,3128,3306,,6434,"(4.697144,-74.140516)"
2012,Noviembre,Argentina,32,16,13,,29,"(4.815061,-75.736532)"
2012,Noviembre,Argentina,32,249,238,,487,"(6.171601,-75.427454)"
2012,Noviembre,Argentina,32,13,14,,27,"(7.128456,-73.183637)"
2012,Noviembre,Argentina,32,3,2,,5,"(7.927209,-72.507910)"
2012,Noviembre,República de Armenia,51,0,1,,1,"(4.697144,-74.140516)"
2012,Noviembre,República de Armenia,51,0,1,,1,"(6.171601,-75.427454)"
2012,Noviembre,Aruba,533,391,260,,651,"(10.408582,-75.538003)"
2012,Noviembre,Aruba,533,2,1,,3,"(10.445761,-75.516429)"
2012,Noviembre,Aruba,533,17,10,,27,"(10.886611,-74.776708)"
2012,Noviembre,Aruba,533,60,44,,104,"(11.528919,-72.919681)"
2012,Noviembre,Aruba,533,17,15,,32,"(3.541112,-76.384584)"
2012,Noviembre,Aruba,533,59,48,,107,"(4.452882,-75.766298)"
2012,Noviembre,Aruba,533,1112,976,,2088,"(4.697144,-74.140516)"
2012,Noviembre,Aruba,533,7,2,,9,"(4.815061,-75.736532)"
2012,Noviembre,Aruba,533,103,69,,172,"(6.171601,-75.427454)"
2012,Noviembre,Aruba,533,10,10,,20,"(7.128456,-73.183637)"
2012,Noviembre,Australia,36,0,1,,1,"(10.445761,-75.516429)"
2012,Noviembre,Australia,36,1,0,,1,"(10.886611,-74.776708)"
2012,Noviembre,Australia,36,15,9,,24,"(3.541112,-76.384584)"
2012,Noviembre,Australia,36,214,196,,410,"(4.697144,-74.140516)"
2012,Noviembre,Australia,36,25,7,,32,"(6.171601,-75.427454)"
2012,Noviembre,Australia,36,1,1,,2,"(7.128456,-73.183637)"
2012,Noviembre,Austria,40,2,0,,2,"(3.541112,-76.384584)"
2012,Noviembre,Austria,40,25,26,,51,"(4.697144,-74.140516)"
2012,Noviembre,Azerbaiyán,31,9,3,,12,"(4.697144,-74.140516)"
2012,Noviembre,Bahamas,44,3,5,,8,"(10.445761,-75.516429)"
2012,Noviembre,Bahamas,44,3,2,,5,"(10.886611,-74.776708)"
2012,Noviembre,Bahamas,44,6,5,,11,"(3.541112,-76.384584)"
2012,Noviembre,Bahamas,44,38,32,,70,"(4.697144,-74.140516)"
2012,Noviembre,Bahamas,44,7,6,,13,"(4.815061,-75.736532)"
2012,Noviembre,Bahamas,44,12,8,,20,"(6.171601,-75.427454)"
2012,Noviembre,Bahamas,44,2,1,,3,"(7.128456,-73.183637)"
2012,Noviembre,Bahamas,44,1,2,,3,"(7.927209,-72.507910)"
2012,Noviembre,Bahréin,48,3,6,,9,"(4.697144,-74.140516)"
2012,Noviembre,Bangladesh,50,2,7,,9,"(4.697144,-74.140516)"
2012,Noviembre,Barbados,52,2,10,,12,"(4.697144,-74.140516)"
2012,Noviembre,Barbados,52,0,1,,1,"(6.171601,-75.427454)"
2012,Noviembre,República de Belarús,112,2,1,,3,"(11.360009,-72.129330)"
2012,Noviembre,República de Belarús,112,2,0,,2,"(3.541112,-76.384584)"
2012,Noviembre,República de Belarús,112,1,0,,1,"(4.697144,-74.140516)"
2012,Noviembre,República de Belarús,112,2,1,,3,"(7.088729,-70.740253)"
2012,Noviembre,República de Belarús,112,1,3,,4,"(7.818934,-72.453226)"
2012,Noviembre,Bélgica,56,4,1,,5,"(3.541112,-76.384584)"
2012,Noviembre,Bélgica,56,44,47,,91,"(4.697144,-74.140516)"
2012,Noviembre,Bélgica,56,5,2,,7,"(6.171601,-75.427454)"
2012,Noviembre,Belice,84,1,4,,5,"(4.697144,-74.140516)"
2012,Noviembre,Benín,204,0,2,,2,"(4.697144,-74.140516)"
2012,Noviembre,Bermudas/Territorio Británico de Ultramar,60,1,1,,2,"(4.697144,-74.140516)"
2012,Noviembre,Bolivia,68,0,4,,4,"(0.814836,-77.662532)"
2012,Noviembre,Bolivia,68,3,2,,5,"(10.886611,-74.776708)"
2012,Noviembre,Bolivia,68,20,16,,36,"(3.541112,-76.384584)"
2012,Noviembre,Bolivia,68,178,316,,494,"(4.697144,-74.140516)"
2012,Noviembre,Bolivia,68,12,19,,31,"(6.171601,-75.427454)"
2012,Noviembre,Bolivia,68,1,0,,1,"(7.128456,-73.183637)"
2012,Noviembre,Bolivia,68,0,1,,1,"(7.927209,-72.507910)"
2012,Noviembre,Brasil,76,69,124,,193,"(-4.197703,-69.941278)"
2012,Noviembre,Brasil,76,7,9,,16,"(10.445761,-75.516429)"
2012,Noviembre,Brasil,76,4,7,,11,"(10.886611,-74.776708)"
2012,Noviembre,Brasil,76,2,15,,17,"(10.971302,-74.765397)"
2012,Noviembre,Brasil,76,0,1,,1,"(12.586067,-81.702563)"
2012,Noviembre,Brasil,76,78,83,,161,"(3.541112,-76.384584)"
2012,Noviembre,Brasil,76,2575,3580,,6155,"(4.697144,-74.140516)"
2012,Noviembre,Brasil,76,2,7,,9,"(4.815061,-75.736532)"
2012,Noviembre,Brasil,76,108,113,,221,"(6.171601,-75.427454)"
2012,Noviembre,Brasil,76,1,7,,8,"(7.128456,-73.183637)"
2012,Noviembre,Brasil,76,1,0,,1,"(7.818934,-72.453226)"
2012,Noviembre,Brasil,76,0,2,,2,"(7.927209,-72.507910)"
2012,Noviembre,Bulgaria,100,1,1,,2,"(4.697144,-74.140516)"
2012,Noviembre,Cabo Verde,132,1,0,,1,"(10.445761,-75.516429)"
2012,Noviembre,Cabo Verde,132,0,1,,1,"(4.697144,-74.140516)"
2012,Noviembre,Islas Caimán/Territorio Británico de Ultramar,136,2,1,,3,"(12.586067,-81.702563)"
2012,Noviembre,Islas Caimán/Territorio Británico de Ultramar,136,1,0,,1,"(3.541112,-76.384584)"
2012,Noviembre,Islas Caimán/Territorio Británico de Ultramar,136,1,0,,1,"(4.697144,-74.140516)"
2012,Noviembre,Camboya,116,3,1,,4,"(4.697144,-74.140516)"
2012,Noviembre,Canadá,124,21,12,,33,"(10.445761,-75.516429)"
2012,Noviembre,Canadá,124,11,9,,20,"(10.886611,-74.776708)"
2012,Noviembre,Canadá,124,38,20,,58,"(3.541112,-76.384584)"
2012,Noviembre,Canadá,124,2,1,,3,"(4.452882,-75.766298)"
2012,Noviembre,Canadá,124,758,696,,1454,"(4.697144,-74.140516)"
2012,Noviembre,Canadá,124,0,1,,1,"(4.815061,-75.736532)"
2012,Noviembre,Canadá,124,79,70,,149,"(6.171601,-75.427454)"
2012,Noviembre,Canadá,124,0,1,,1,"(7.128456,-73.183637)"
2012,Noviembre,España,724,1,0,,1,"(10.445761,-75.516429)"
2012,Noviembre,España,724,1073,678,,1751,"(3.541112,-76.384584)"
2012,Noviembre,España,724,1,0,,1,"(4.452882,-75.766298)"
2012,Noviembre,España,724,4215,3667,,7882,"(4.697144,-74.140516)"
2012,Noviembre,España,724,416,322,,738,"(6.171601,-75.427454)"
2012,Noviembre,República Democrática del Congo,180,0,1,,1,"(10.445761,-75.516429)"
2012,Noviembre,República Democrática del Congo,180,2,4,,6,"(4.697144,-74.140516)"
2012,Noviembre,República de Corea,410,0,1,,1,"(10.445761,-75.516429)"
2012,Noviembre,República de Corea,410,8,28,,36,"(4.697144,-74.140516)"
2012,Noviembre,República de Corea,410,2,0,,2,"(6.171601,-75.427454)"
2012,Noviembre,Costa Rica,188,9,16,,25,"(10.445761,-75.516429)"
2012,Noviembre,Costa Rica,188,10,18,,28,"(10.886611,-74.776708)"
2012,Noviembre,Costa Rica,188,4,39,,43,"(12.5744111,-81.703935)"
2012,Noviembre,Costa Rica,188,4,4,,8,"(12.586067,-81.702563)"
2012,Noviembre,Costa Rica,188,37,44,,81,"(3.541112,-76.384584)"
2012,Noviembre,Costa Rica,188,613,828,,1441,"(4.697144,-74.140516)"
2012,Noviembre,Costa Rica,188,10,4,,14,"(4.815061,-75.736532)"
2012,Noviembre,Costa Rica,188,183,185,,368,"(6.171601,-75.427454)"
2012,Noviembre,Costa Rica,188,5,6,,11,"(7.128456,-73.183637)"
2012,Noviembre,Costa Rica,188,2,0,,2,"(7.927209,-72.507910)"
2012,Noviembre,Croacia,191,0,1,,1,"(4.697144,-74.140516)"
2012,Noviembre,Cuba,192,14,12,,26,"(10.445761,-75.516429)"
2012,Noviembre,Cuba,192,16,17,,33,"(10.886611,-74.776708)"
2012,Noviembre,Cuba,192,1,0,,1,"(12.586067,-81.702563)"
2012,Noviembre,Cuba,192,65,81,,146,"(3.541112,-76.384584)"
2012,Noviembre,Cuba,192,779,702,,1481,"(4.697144,-74.140516)"
2012,Noviembre,Cuba,192,15,10,,25,"(4.815061,-75.736532)"
2012,Noviembre,Cuba,192,179,133,,312,"(6.171601,-75.427454)"
2012,Noviembre,Cuba,192,15,18,,33,"(7.128456,-73.183637)"
2012,Noviembre,Cuba,192,0,3,,3,"(7.927209,-72.507910)"
2012,Noviembre,Curazao,99999,5,1,,6,"(10.886611,-74.776708)"
2012,Noviembre,Curazao,99999,16,6,,22,"(3.541112,-76.384584)"
2012,Noviembre,Curazao,99999,547,554,,1101,"(4.697144,-74.140516)"
2012,Noviembre,Curazao,99999,101,71,,172,"(6.171601,-75.427454)"
2012,Noviembre,Curazao,99999,2,2,,4,"(7.128456,-73.183637)"
2012,Noviembre,República Checa,203,5,6,,11,"(4.697144,-74.140516)"
2012,Noviembre,República Checa,203,1,0,,1,"(7.128456,-73.183637)"
2012,Noviembre,Chile,152,3,1,,4,"(0.25129,-76.875963)"
2012,Noviembre,Chile,152,21,26,,47,"(0.814836,-77.662532)"
2012,Noviembre,Chile,152,15,16,,31,"(10.445761,-75.516429)"
2012,Noviembre,Chile,152,23,23,,46,"(10.886611,-74.776708)"
2012,Noviembre,Chile,152,328,247,,575,"(3.541112,-76.384584)"
2012,Noviembre,Chile,152,2474,2572,,5046,"(4.697144,-74.140516)"
2012,Noviembre,Chile,152,43,30,,73,"(4.815061,-75.736532)"
2012,Noviembre,Chile,152,164,141,,305,"(6.171601,-75.427454)"
2012,Noviembre,Chile,152,10,8,,18,"(7.128456,-73.183637)"
2012,Noviembre,Chile,152,1,0,,1,"(7.927209,-72.507910)"
2012,Noviembre,China,156,0,1,,1,"(10.886611,-74.776708)"
2012,Noviembre,China,156,3,4,,7,"(3.541112,-76.384584)"
2012,Noviembre,China,156,215,345,,560,"(4.697144,-74.140516)"
2012,Noviembre,China,156,0,2,,2,"(4.815061,-75.736532)"
2012,Noviembre,China,156,5,13,,18,"(6.171601,-75.427454)"
2012,Noviembre,China,156,1,0,,1,"(7.128456,-73.183637)"
2012,Noviembre,Chipre,196,0,2,,2,"(4.697144,-74.140516)"
2012,Noviembre,Dinamarca,208,0,1,,1,"(3.541112,-76.384584)"
2012,Noviembre,Dinamarca,208,9,17,,26,"(4.697144,-74.140516)"
2012,Noviembre,República de Yibuti,262,0,1,,1,"(4.697144,-74.140516)"
2012,Noviembre,Dominica,212,0,2,,2,"(0.814836,-77.662532)"
2012,Noviembre,Dominica,212,2,0,,2,"(3.541112,-76.384584)"
2012,Noviembre,Dominica,212,1,2,,3,"(4.697144,-74.140516)"
2012,Noviembre,Dominica,212,0,1,,1,"(7.927209,-72.507910)"
2012,Noviembre,Ecuador,218,345,547,,892,"(0.25129,-76.875963)"
2012,Noviembre,Ecuador,218,7333,7863,,15196,"(0.814836,-77.662532)"
2012,Noviembre,Ecuador,218,193,109,,302,"(1.813928,-78.763924)"
2012,Noviembre,Ecuador,218,1,1,,2,"(10.445761,-75.516429)"
2012,Noviembre,Ecuador,218,2,4,,6,"(10.886611,-74.776708)"
2012,Noviembre,Ecuador,218,736,763,,1499,"(3.541112,-76.384584)"
2012,Noviembre,Ecuador,218,2294,3803,,6097,"(4.697144,-74.140516)"
2012,Noviembre,Ecuador,218,2,8,,10,"(4.815061,-75.736532)"
2012,Noviembre,Ecuador,218,412,465,,877,"(6.171601,-75.427454)"
2012,Noviembre,Ecuador,218,0,1,,1,"(6.228046,-77.404104)"
2012,Noviembre,Ecuador,218,4,3,,7,"(7.128456,-73.183637)"
2012,Noviembre,Egipto,818,1,1,,2,"(10.886611,-74.776708)"
2012,Noviembre,Egipto,818,66,40,,106,"(4.697144,-74.140516)"
2012,Noviembre,Egipto,818,2,2,,4,"(6.171601,-75.427454)"
2012,Noviembre,El Salvador,222,3,3,,6,"(10.445761,-75.516429)"
2012,Noviembre,El Salvador,222,3,4,,7,"(10.886611,-74.776708)"
2012,Noviembre,El Salvador,222,40,51,,91,"(3.541112,-76.384584)"
2012,Noviembre,El Salvador,222,812,850,,1662,"(4.697144,-74.140516)"
2012,Noviembre,El Salvador,222,37,46,,83,"(6.171601,-75.427454)"
2012,Noviembre,El Salvador,222,3,3,,6,"(7.128456,-73.183637)"
2012,Noviembre,Emiratos Árabes,784,82,262,,344,"(4.697144,-74.140516)"
2012,Noviembre,Emiratos Árabes,784,2,1,,3,"(6.171601,-75.427454)"
2012,Noviembre,Eritrea,232,0,1,,1,"(3.541112,-76.384584)"
2012,Noviembre,Eritrea,232,0,1,,1,"(4.697144,-74.140516)"
2012,Noviembre,Eslovaquia,703,1,2,,3,"(4.697144,-74.140516)"
2012,Noviembre,Eslovenia,705,1,0,,1,"(3.541112,-76.384584)"
2012,Noviembre,Eslovenia,705,5,2,,7,"(4.697144,-74.140516)"
2012,Noviembre,Estados Unidos de América,840,0,1,,1,"(0.814836,-77.662532)"
2012,Noviembre,Estados Unidos de América,840,2192,1789,,3981,"(10.445761,-75.516429)"
2012,Noviembre,Estados Unidos de América,840,1875,1487,,3362,"(10.886611,-74.776708)"
2012,Noviembre,Estados Unidos de América,840,22,16,,38,"(12.586067,-81.702563)"
2012,Noviembre,Estados Unidos de América,840,4036,2993,,7029,"(3.541112,-76.384584)"
2012,Noviembre,Estados Unidos de América,840,546,420,,966,"(4.452882,-75.766298)"
2012,Noviembre,Estados Unidos de América,840,28198,25404,,53602,"(4.697144,-74.140516)"
2012,Noviembre,Estados Unidos de América,840,199,124,,323,"(4.815061,-75.736532)"
2012,Noviembre,Estados Unidos de América,840,6646,5199,,11845,"(6.171601,-75.427454)"
2012,Noviembre,Estados Unidos de América,840,112,89,,201,"(7.128456,-73.183637)"
2012,Noviembre,Estados Unidos de América,840,17,18,,35,"(7.927209,-72.507910)"
2012,Noviembre,Etiopia,231,0,4,,4,"(4.697144,-74.140516)"
2012,Noviembre,Filipinas,608,0,2,,2,"(10.886611,-74.776708)"
2012,Noviembre,Filipinas,608,1,0,,1,"(3.541112,-76.384584)"
2012,Noviembre,Filipinas,608,2,4,,6,"(4.697144,-74.140516)"
2012,Noviembre,Finlandia,246,7,12,,19,"(4.697144,-74.140516)"
2012,Noviembre,Finlandia,246,0,1,,1,"(6.171601,-75.427454)"
2012,Noviembre,Francia,250,22,20,,42,"(3.541112,-76.384584)"
2012,Noviembre,Francia,250,761,827,,1588,"(4.697144,-74.140516)"
2012,Noviembre,Francia,250,18,10,,28,"(6.171601,-75.427454)"
2012,Noviembre,Gabón,266,0,3,,3,"(4.697144,-74.140516)"
2012,Noviembre,Georgia,268,0,1,,1,"(4.697144,-74.140516)"
2012,Noviembre,Ghana,288,2,3,,5,"(4.697144,-74.140516)"
2012,Noviembre,Grecia,300,6,7,,13,"(4.697144,-74.140516)"
2012,Noviembre,Guatemala,320,2,3,,5,"(10.445761,-75.516429)"
2012,Noviembre,Guatemala,320,5,9,,14,"(10.886611,-74.776708)"
2012,Noviembre,Guatemala,320,1,0,,1,"(12.586067,-81.702563)"
2012,Noviembre,Guatemala,320,37,51,,88,"(3.541112,-76.384584)"
2012,Noviembre,Guatemala,320,0,1,,1,"(3.893038,-77.067921)"
2012,Noviembre,Guatemala,320,146,267,,413,"(4.697144,-74.140516)"
2012,Noviembre,Guatemala,320,6,9,,15,"(4.815061,-75.736532)"
2012,Noviembre,Guatemala,320,80,108,,188,"(6.171601,-75.427454)"
2012,Noviembre,Guatemala,320,4,5,,9,"(7.128456,-73.183637)"
2012,Noviembre,Guatemala,320,1,2,,3,"(7.927209,-72.507910)"
2012,Noviembre,Guyana,328,4,3,,7,"(4.697144,-74.140516)"
2012,Noviembre,Guyana,328,0,1,,1,"(6.171601,-75.427454)"
2012,Noviembre,Guinea,324,1,0,,1,"(3.541112,-76.384584)"
2012,Noviembre,Guinea,324,0,3,,3,"(4.697144,-74.140516)"
2012,Noviembre,Guinea Ecuatorial,226,0,7,,7,"(4.697144,-74.140516)"
2012,Noviembre,Guinea Ecuatorial,226,0,1,,1,"(6.171601,-75.427454)"
2012,Noviembre,Guayana Francesa/Departamento de Ultramar Francés,254,1,6,,7,"(10.445761,-75.516429)"
2012,Noviembre,Haití,332,0,2,,2,"(10.445761,-75.516429)"
2012,Noviembre,Haití,332,0,4,,4,"(10.886611,-74.776708)"
2012,Noviembre,Haití,332,0,5,,5,"(12.586067,-81.702563)"
2012,Noviembre,Haití,332,1,2,,3,"(3.541112,-76.384584)"
2012,Noviembre,Haití,332,6,26,,32,"(4.697144,-74.140516)"
2012,Noviembre,Haití,332,3,8,,11,"(6.171601,-75.427454)"
2012,Noviembre,Honduras,340,0,3,,3,"(10.445761,-75.516429)"
2012,Noviembre,Honduras,340,3,5,,8,"(10.886611,-74.776708)"
2012,Noviembre,Honduras,340,18,38,,56,"(3.541112,-76.384584)"
2012,Noviembre,Honduras,340,70,159,,229,"(4.697144,-74.140516)"
2012,Noviembre,Honduras,340,2,2,,4,"(4.815061,-75.736532)"
2012,Noviembre,Honduras,340,32,60,,92,"(6.171601,-75.427454)"
2012,Noviembre,Honduras,340,1,5,,6,"(7.128456,-73.183637)"
2012,Noviembre,Honduras,340,0,1,,1,"(7.927209,-72.507910)"
2012,Noviembre,Hong Kong,344,0,1,,1,"(10.886611,-74.776708)"
2012,Noviembre,Hong Kong,344,0,2,,2,"(3.541112,-76.384584)"
2012,Noviembre,Hong Kong,344,23,34,,57,"(4.697144,-74.140516)"
2012,Noviembre,Hong Kong,344,0,2,,2,"(6.171601,-75.427454)"
2012,Noviembre,Hungría,348,1,0,,1,"(3.541112,-76.384584)"
2012,Noviembre,Hungría,348,0,3,,3,"(4.697144,-74.140516)"
2012,Noviembre,India,356,1,3,,4,"(10.445761,-75.516429)"
2012,Noviembre,India,356,1,1,,2,"(10.886611,-74.776708)"
2012,Noviembre,India,356,2,1,,3,"(3.541112,-76.384584)"
2012,Noviembre,India,356,58,37,,95,"(4.697144,-74.140516)"
2012,Noviembre,India,356,1,1,,2,"(6.171601,-75.427454)"
2012,Noviembre,Indonesia,360,1,1,,2,"(3.541112,-76.384584)"
2012,Noviembre,Indonesia,360,10,5,,15,"(4.697144,-74.140516)"
2012,Noviembre,Indonesia,360,1,2,,3,"(6.171601,-75.427454)"
2012,Noviembre,Iraq,368,0,12,,12,"(4.697144,-74.140516)"
2012,Noviembre,Irán,364,1,1,,2,"(4.697144,-74.140516)"
2012,Noviembre,República de Irlanda,372,1,0,,1,"(10.445761,-75.516429)"
2012,Noviembre,República de Irlanda,372,1,0,,1,"(3.541112,-76.384584)"
2012,Noviembre,República de Irlanda,372,9,7,,16,"(4.697144,-74.140516)"
2012,Noviembre,República de Irlanda,372,1,0,,1,"(6.171601,-75.427454)"
2012,Noviembre,Israel,376,1,0,,1,"(10.445761,-75.516429)"
2012,Noviembre,Israel,376,5,2,,7,"(3.541112,-76.384584)"
2012,Noviembre,Israel,376,193,131,,324,"(4.697144,-74.140516)"
2012,Noviembre,Israel,376,2,2,,4,"(6.171601,-75.427454)"
2012,Noviembre,Islas Aland/Provincia de Finlandia,248,1,0,,1,"(3.541112,-76.384584)"
2012,Noviembre,Italia,380,2,0,,2,"(10.445761,-75.516429)"
2012,Noviembre,Italia,380,57,40,,97,"(3.541112,-76.384584)"
2012,Noviembre,Italia,380,333,281,,614,"(4.697144,-74.140516)"
2012,Noviembre,Italia,380,12,8,,20,"(6.171601,-75.427454)"
2012,Noviembre,Jamaica,388,3,2,,5,"(10.445761,-75.516429)"
2012,Noviembre,Jamaica,388,4,6,,10,"(10.886611,-74.776708)"
2012,Noviembre,Jamaica,388,2,4,,6,"(3.541112,-76.384584)"
2012,Noviembre,Jamaica,388,64,49,,113,"(4.697144,-74.140516)"
2012,Noviembre,Jamaica,388,1,1,,2,"(4.815061,-75.736532)"
2012,Noviembre,Jamaica,388,31,28,,59,"(6.171601,-75.427454)"
2012,Noviembre,Jamaica,388,4,2,,6,"(7.128456,-73.183637)"
2012,Noviembre,Islas Salomón,90,1,5,,6,"(4.697144,-74.140516)"
2012,Noviembre,Japón,392,1,0,,1,"(10.886611,-74.776708)"
2012,Noviembre,Japón,392,1,1,,2,"(3.541112,-76.384584)"
2012,Noviembre,Japón,392,53,66,,119,"(4.697144,-74.140516)"
2012,Noviembre,Japón,392,6,5,,11,"(6.171601,-75.427454)"
2012,Noviembre,Jordania,400,12,10,,22,"(4.697144,-74.140516)"
2012,Noviembre,Kazajistán,398,1,1,,2,"(4.697144,-74.140516)"
2012,Noviembre,Kenia,404,1,1,,2,"(3.541112,-76.384584)"
2012,Noviembre,Kenia,404,1,1,,2,"(4.697144,-74.140516)"
2012,Noviembre,Kuwait,414,1,1,,2,"(4.697144,-74.140516)"
2012,Noviembre,Letonia,428,1,0,,1,"(4.697144,-74.140516)"
2012,Noviembre,Lituania,440,0,8,,8,"(4.697144,-74.140516)"
2012,Noviembre,Líbano,422,4,6,,10,"(4.697144,-74.140516)"
2012,Noviembre,Libia,434,0,1,,1,"(4.697144,-74.140516)"
2012,Noviembre,Luxemburgo,442,3,2,,5,"(4.697144,-74.140516)"
2012,Noviembre,Malasia,458,6,5,,11,"(4.697144,-74.140516)"
2012,Noviembre,Malasia,458,2,1,,3,"(6.171601,-75.427454)"
2012,Noviembre,Malta,470,4,2,,6,"(4.697144,-74.140516)"
2012,Noviembre,Marruecos,504,1,0,,1,"(3.541112,-76.384584)"
2012,Noviembre,Marruecos,504,7,7,,14,"(4.697144,-74.140516)"
2012,Noviembre,Marruecos,504,2,2,,4,"(6.171601,-75.427454)"
2012,Noviembre,Mauricio,480,0,1,,1,"(4.697144,-74.140516)"
2012,Noviembre,Martinica/Departamento de Ultramar Francés,474,0,22,,22,"(10.445761,-75.516429)"
2012,Noviembre,México,484,20,36,,56,"(10.445761,-75.516429)"
2012,Noviembre,México,484,55,49,,104,"(10.886611,-74.776708)"
2012,Noviembre,México,484,228,228,,456,"(3.541112,-76.384584)"
2012,Noviembre,México,484,4657,4934,,9591,"(4.697144,-74.140516)"
2012,Noviembre,México,484,60,58,,118,"(4.815061,-75.736532)"
2012,Noviembre,México,484,591,471,,1062,"(6.171601,-75.427454)"
2012,Noviembre,México,484,72,49,,121,"(7.128456,-73.183637)"
2012,Noviembre,México,484,7,12,,19,"(7.927209,-72.507910)"
2012,Noviembre,República de Moldavia,498,1,0,,1,"(4.697144,-74.140516)"
2012,Noviembre,Mónaco,492,1,1,,2,"(4.697144,-74.140516)"
2012,Noviembre,Mónaco,492,1,0,,1,"(6.171601,-75.427454)"
2012,Noviembre,Nauru,520,1,0,,1,"(4.697144,-74.140516)"
2012,Noviembre,Nicaragua,558,2,0,,2,"(10.445761,-75.516429)"
2012,Noviembre,Nicaragua,558,3,1,,4,"(10.886611,-74.776708)"
2012,Noviembre,Nicaragua,558,2,1,,3,"(12.586067,-81.702563)"
2012,Noviembre,Nicaragua,558,5,10,,15,"(3.541112,-76.384584)"
2012,Noviembre,Nicaragua,558,32,55,,87,"(4.697144,-74.140516)"
2012,Noviembre,Nicaragua,558,0,1,,1,"(4.815061,-75.736532)"
2012,Noviembre,Nicaragua,558,9,21,,30,"(6.171601,-75.427454)"
2012,Noviembre,Nicaragua,558,0,2,,2,"(7.128456,-73.183637)"
2012,Noviembre,Nigeria,566,1,15,,16,"(4.697144,-74.140516)"
2012,Noviembre,Noruega,578,0,1,,1,"(10.886611,-74.776708)"
2012,Noviembre,Noruega,578,1,1,,2,"(3.541112,-76.384584)"
2012,Noviembre,Noruega,578,12,17,,29,"(4.697144,-74.140516)"
2012,Noviembre,Nueva Zelanda,554,1,1,,2,"(3.541112,-76.384584)"
2012,Noviembre,Nueva Zelanda,554,17,15,,32,"(4.697144,-74.140516)"
2012,Noviembre,Nueva Zelanda,554,3,4,,7,"(6.171601,-75.427454)"
2012,Noviembre,Omán,512,1,6,,7,"(4.697144,-74.140516)"
2012,Noviembre,Papúa Nueva Guinea,598,0,7,,7,"(4.697144,-74.140516)"
2012,Noviembre,Panamá,591,1,2,,3,"(0.814836,-77.662532)"
2012,Noviembre,Panamá,591,14,70,,84,"(10.408582,-75.538003)"
2012,Noviembre,Panamá,591,525,493,,1018,"(10.445761,-75.516429)"
2012,Noviembre,Panamá,591,923,910,,1833,"(10.886611,-74.776708)"
2012,Noviembre,Panamá,591,0,2,,2,"(11.247723,-74.213989)"
2012,Noviembre,Panamá,591,1,4,,5,"(12.5744111,-81.703935)"
2012,Noviembre,Panamá,591,91,90,,181,"(12.586067,-81.702563)"
2012,Noviembre,Panamá,591,0,9,,9,"(13.3387613,-81.372937)"
2012,Noviembre,Panamá,591,1990,1771,,3761,"(3.541112,-76.384584)"
2012,Noviembre,Panamá,591,2,2,,4,"(3.893038,-77.067921)"
2012,Noviembre,Panamá,591,7372,8038,,15410,"(4.697144,-74.140516)"
2012,Noviembre,Panamá,591,551,490,,1041,"(4.815061,-75.736532)"
2012,Noviembre,Panamá,591,2484,2536,,5020,"(6.171601,-75.427454)"
2012,Noviembre,Panamá,591,12,9,,21,"(6.228046,-77.404104)"
2012,Noviembre,Panamá,591,376,339,,715,"(7.128456,-73.183637)"
2012,Noviembre,Panamá,591,0,1,,1,"(7.818934,-72.453226)"
2012,Noviembre,Panamá,591,166,180,,346,"(7.927209,-72.507910)"
2012,Noviembre,Panamá,591,3,69,,72,"(8.066966,-76.735404)"
2012,Noviembre,Panamá,591,64,92,,156,"(8.635765,-77.346578)"
2012,Noviembre,Paraguay,600,3,0,,3,"(10.445761,-75.516429)"
2012,Noviembre,Paraguay,600,1,9,,10,"(10.886611,-74.776708)"
2012,Noviembre,Paraguay,600,10,21,,31,"(3.541112,-76.384584)"
2012,Noviembre,Paraguay,600,48,92,,140,"(4.697144,-74.140516)"
2012,Noviembre,Paraguay,600,8,10,,18,"(6.171601,-75.427454)"
2012,Noviembre,Paraguay,600,1,1,,2,"(7.128456,-73.183637)"
2012,Noviembre,Perú,604,70,137,,207,"(-4.197703,-69.941278)"
2012,Noviembre,Perú,604,2,2,,4,"(0.25129,-76.875963)"
2012,Noviembre,Perú,604,24,38,,62,"(0.814836,-77.662532)"
2012,Noviembre,Perú,604,3,6,,9,"(10.445761,-75.516429)"
2012,Noviembre,Perú,604,16,17,,33,"(10.886611,-74.776708)"
2012,Noviembre,Perú,604,202,248,,450,"(3.541112,-76.384584)"
2012,Noviembre,Perú,604,3627,4782,,8409,"(4.697144,-74.140516)"
2012,Noviembre,Perú,604,12,6,,18,"(4.815061,-75.736532)"
2012,Noviembre,Perú,604,424,449,,873,"(6.171601,-75.427454)"
2012,Noviembre,Perú,604,3,5,,8,"(7.128456,-73.183637)"
2012,Noviembre,Perú,604,0,3,,3,"(7.927209,-72.507910)"
2012,Noviembre,Palestina,99999,2,3,,5,"(4.697144,-74.140516)"
2012,Noviembre,Palestina,99999,2,1,,3,"(6.171601,-75.427454)"
2012,Noviembre,Polonia,616,8,10,,18,"(4.697144,-74.140516)"
2012,Noviembre,Polonia,616,1,1,,2,"(6.171601,-75.427454)"
2012,Noviembre,Portugal,620,2,1,,3,"(3.541112,-76.384584)"
2012,Noviembre,Portugal,620,32,59,,91,"(4.697144,-74.140516)"
2012,Noviembre,Portugal,620,2,4,,6,"(6.171601,-75.427454)"
2012,Noviembre,Puerto Rico/Territorio de Estados Unidos,630,11,2,,13,"(10.445761,-75.516429)"
2012,Noviembre,Puerto Rico/Territorio de Estados Unidos,630,17,8,,25,"(10.886611,-74.776708)"
2012,Noviembre,Puerto Rico/Territorio de Estados Unidos,630,1,1,,2,"(12.586067,-81.702563)"
2012,Noviembre,Puerto Rico/Territorio de Estados Unidos,630,49,43,,92,"(3.541112,-76.384584)"
2012,Noviembre,Puerto Rico/Territorio de Estados Unidos,630,99,119,,218,"(4.697144,-74.140516)"
2012,Noviembre,Puerto Rico/Territorio de Estados Unidos,630,4,7,,11,"(4.815061,-75.736532)"
2012,Noviembre,Puerto Rico/Territorio de Estados Unidos,630,46,46,,92,"(6.171601,-75.427454)"
2012,Noviembre,Puerto Rico/Territorio de Estados Unidos,630,2,8,,10,"(7.128456,-73.183637)"
2012,Noviembre,Qatar,634,8,7,,15,"(4.697144,-74.140516)"
2012,Noviembre,Reino Unido de Gran Bretaña e Irlanda del Norte,826,0,1,,1,"(10.445761,-75.516429)"
2012,Noviembre,Reino Unido de Gran Bretaña e Irlanda del Norte,826,0,1,,1,"(10.886611,-74.776708)"
2012,Noviembre,Reino Unido de Gran Bretaña e Irlanda del Norte,826,52,42,,94,"(3.541112,-76.384584)"
2012,Noviembre,Reino Unido de Gran Bretaña e Irlanda del Norte,826,418,355,,773,"(4.697144,-74.140516)"
2012,Noviembre,Reino Unido de Gran Bretaña e Irlanda del Norte,826,25,16,,41,"(6.171601,-75.427454)"
2012,Noviembre,Reino Unido de Gran Bretaña e Irlanda del Norte,826,1,0,,1,"(7.128456,-73.183637)"
2012,Noviembre,Federación de Rusia,643,15,36,,51,"(4.697144,-74.140516)"
2012,Noviembre,Federación de Rusia,643,0,1,,1,"(6.171601,-75.427454)"
2012,Noviembre,República Dominicana,214,6,5,,11,"(10.445761,-75.516429)"
2012,Noviembre,República Dominicana,214,28,31,,59,"(10.886611,-74.776708)"
2012,Noviembre,República Dominicana,214,86,87,,173,"(3.541112,-76.384584)"
2012,Noviembre,República Dominicana,214,1042,1051,,2093,"(4.697144,-74.140516)"
2012,Noviembre,República Dominicana,214,29,30,,59,"(4.815061,-75.736532)"
2012,Noviembre,República Dominicana,214,194,164,,358,"(6.171601,-75.427454)"
2012,Noviembre,República Dominicana,214,27,27,,54,"(7.128456,-73.183637)"
2012,Noviembre,República Dominicana,214,2,2,,4,"(7.927209,-72.507910)"
2012,Noviembre,Reunión,638,1,0,,1,"(4.697144,-74.140516)"
2012,Noviembre,Rumania,642,5,3,,8,"(4.697144,-74.140516)"
2012,Noviembre,Rwanda,646,0,2,,2,"(4.697144,-74.140516)"
2012,Noviembre,San Marino,674,0,1,,1,"(10.445761,-75.516429)"
2012,Noviembre,Santa Lucia,662,0,1,,1,"(10.445761,-75.516429)"
2012,Noviembre,Senegal,686,1,2,,3,"(4.697144,-74.140516)"
2012,Noviembre,Singapur,702,16,23,,39,"(4.697144,-74.140516)"
2012,Noviembre,Sri Lanka,144,1,0,,1,"(4.697144,-74.140516)"
2012,Noviembre,Sudáfrica,710,0,2,,2,"(3.541112,-76.384584)"
2012,Noviembre,Sudáfrica,710,12,11,,23,"(4.697144,-74.140516)"
2012,Noviembre,Sudán,736,0,2,,2,"(4.697144,-74.140516)"
2012,Noviembre,Suecia,752,3,2,,5,"(3.541112,-76.384584)"
2012,Noviembre,Suecia,752,36,36,,72,"(4.697144,-74.140516)"
2012,Noviembre,Suecia,752,2,0,,2,"(6.171601,-75.427454)"
2012,Noviembre,Suiza,756,10,7,,17,"(3.541112,-76.384584)"
2012,Noviembre,Suiza,756,146,108,,254,"(4.697144,-74.140516)"
2012,Noviembre,Suiza,756,3,5,,8,"(6.171601,-75.427454)"
2012,Noviembre,Surinam,740,3,11,,14,"(4.697144,-74.140516)"
2012,Noviembre,Surinam,740,1,1,,2,"(6.171601,-75.427454)"
2012,Noviembre,Taiwán,158,0,1,,1,"(3.541112,-76.384584)"
2012,Noviembre,Taiwán,158,3,8,,11,"(4.697144,-74.140516)"
2012,Noviembre,Taiwán,158,0,2,,2,"(6.171601,-75.427454)"
2012,Noviembre,Tailandia,764,0,1,,1,"(10.445761,-75.516429)"
2012,Noviembre,Tailandia,764,9,10,,19,"(4.697144,-74.140516)"
2012,Noviembre,Trinidad y Tobago,780,2,2,,4,"(10.445761,-75.516429)"
2012,Noviembre,Trinidad y Tobago,780,3,3,,6,"(10.886611,-74.776708)"
2012,Noviembre,Trinidad y Tobago,780,10,26,,36,"(3.541112,-76.384584)"
2012,Noviembre,Trinidad y Tobago,780,32,46,,78,"(4.697144,-74.140516)"
2012,Noviembre,Trinidad y Tobago,780,2,1,,3,"(4.815061,-75.736532)"
2012,Noviembre,Trinidad y Tobago,780,5,9,,14,"(6.171601,-75.427454)"
2012,Noviembre,Trinidad y Tobago,780,4,2,,6,"(7.128456,-73.183637)"
2012,Noviembre,Túnez,788,0,2,,2,"(4.697144,-74.140516)"
2012,Noviembre,Turquía,792,26,36,,62,"(4.697144,-74.140516)"
2012,Noviembre,Turquía,792,24,2,,26,"(6.171601,-75.427454)"
2012,Noviembre,Ucrania,804,1,7,,8,"(4.697144,-74.140516)"
2012,Noviembre,Uganda,800,1,1,,2,"(4.697144,-74.140516)"
2012,Noviembre,Uruguay,858,1,0,,1,"(10.445761,-75.516429)"
2012,Noviembre,Uruguay,858,5,1,,6,"(10.886611,-74.776708)"
2012,Noviembre,Uruguay,858,1,0,,1,"(12.586067,-81.702563)"
2012,Noviembre,Uruguay,858,10,16,,26,"(3.541112,-76.384584)"
2012,Noviembre,Uruguay,858,123,126,,249,"(4.697144,-74.140516)"
2012,Noviembre,Uruguay,858,25,28,,53,"(6.171601,-75.427454)"
2012,Noviembre,Venezuela,862,2,2,,4,"(10.445761,-75.516429)"
2012,Noviembre,Venezuela,862,8,8,,16,"(10.886611,-74.776708)"
2012,Noviembre,Venezuela,862,7343,7485,,14828,"(11.360009,-72.129330)"
2012,Noviembre,Venezuela,862,15,16,,31,"(3.541112,-76.384584)"
2012,Noviembre,Venezuela,862,0,1,,1,"(4.452882,-75.766298)"
2012,Noviembre,Venezuela,862,2102,2807,,4909,"(4.697144,-74.140516)"
2012,Noviembre,Venezuela,862,0,1,,1,"(4.815061,-75.736532)"
2012,Noviembre,Venezuela,862,258,254,,512,"(6.171601,-75.427454)"
2012,Noviembre,Venezuela,862,253,333,,586,"(6.185799,-67.483929)"
2012,Noviembre,Venezuela,862,1832,1601,,3433,"(7.088729,-70.740253)"
2012,Noviembre,Venezuela,862,2,4,,6,"(7.128456,-73.183637)"
2012,Noviembre,Venezuela,862,10148,10188,,20336,"(7.818934,-72.453226)"
2012,Noviembre,Vietnam,704,2,1,,3,"(4.697144,-74.140516)"
2012,Noviembre,Vietnam,704,1,0,,1,"(6.171601,-75.427454)"
2012,Noviembre,República Árabe de Yemen,887,0,1,,1,"(4.697144,-74.140516)"
2012,Noviembre,Zambia,894,1,1,,2,"(4.697144,-74.140516)"
2012,Noviembre,Anguila/Territorio Británico de Ultramar,660,2,6,,8,"(4.697144,-74.140516)"
2012,Noviembre,Desconocido,99999,5,15,,20,"(4.697144,-74.140516)"
2012,Diciembre,Afganistán,4,0,1,,1,"(10.433609,-73.247863)"
2012,Diciembre,Afganistán,4,12,26,,38,"(4.697144,-74.140516)"
2012,Diciembre,Albania,8,1,0,,1,"(4.697144,-74.140516)"
2012,Diciembre,Alemania,276,1,2,,3,"(0.814836,-77.662532)"
2012,Diciembre,Alemania,276,0,1,,1,"(10.445761,-75.516429)"
2012,Diciembre,Alemania,276,1,0,,1,"(10.886611,-74.776708)"
2012,Diciembre,Alemania,276,29,20,,49,"(3.541112,-76.384584)"
2012,Diciembre,Alemania,276,966,806,,1772,"(4.697144,-74.140516)"
2012,Diciembre,Alemania,276,8,7,,15,"(6.171601,-75.427454)"
2012,Diciembre,Alemania,276,0,1,,1,"(7.128456,-73.183637)"
2012,Diciembre,Andorra,20,3,0,,3,"(10.408582,-75.538003)"
2012,Diciembre,Andorra,20,1,1,,2,"(4.697144,-74.140516)"
2012,Diciembre,Andorra,20,1,0,,1,"(6.171601,-75.427454)"
2012,Diciembre,Angola,24,1,8,,9,"(4.697144,-74.140516)"
2012,Diciembre,Antigua y Barbuda,28,2,0,,2,"(4.697144,-74.140516)"
2012,Diciembre,Países Bajos,528,571,392,,963,"(10.408582,-75.538003)"
2012,Diciembre,Países Bajos,528,1,1,,2,"(10.445761,-75.516429)"
2012,Diciembre,Países Bajos,528,2,1,,3,"(10.886611,-74.776708)"
2012,Diciembre,Países Bajos,528,1,0,,1,"(12.586067,-81.702563)"
2012,Diciembre,Países Bajos,528,36,16,,52,"(3.541112,-76.384584)"
2012,Diciembre,Países Bajos,528,160,114,,274,"(4.697144,-74.140516)"
2012,Diciembre,Países Bajos,528,1,0,,1,"(4.815061,-75.736532)"
2012,Diciembre,Países Bajos,528,43,21,,64,"(6.171601,-75.427454)"
2012,Diciembre,Arabia Saudita,682,1,0,,1,"(10.445761,-75.516429)"
2012,Diciembre,Arabia Saudita,682,1,2,,3,"(3.541112,-76.384584)"
2012,Diciembre,Arabia Saudita,682,0,1,,1,"(4.452882,-75.766298)"
2012,Diciembre,Arabia Saudita,682,13,21,,34,"(4.697144,-74.140516)"
2012,Diciembre,Argelia,12,0,1,,1,"(3.541112,-76.384584)"
2012,Diciembre,Argelia,12,1,2,,3,"(4.697144,-74.140516)"
2012,Diciembre,Argelia,12,0,1,,1,"(6.171601,-75.427454)"
2012,Diciembre,Argentina,32,7,7,,14,"(0.814836,-77.662532)"
2012,Diciembre,Argentina,32,20,8,,28,"(10.445761,-75.516429)"
2012,Diciembre,Argentina,32,47,37,,84,"(10.886611,-74.776708)"
2012,Diciembre,Argentina,32,1,1,,2,"(12.586067,-81.702563)"
2012,Diciembre,Argentina,32,170,134,,304,"(3.541112,-76.384584)"
2012,Diciembre,Argentina,32,4417,3765,,8182,"(4.697144,-74.140516)"
2012,Diciembre,Argentina,32,10,12,,22,"(4.815061,-75.736532)"
2012,Diciembre,Argentina,32,242,216,,458,"(6.171601,-75.427454)"
2012,Diciembre,Argentina,32,13,9,,22,"(7.128456,-73.183637)"
2012,Diciembre,Argentina,32,0,1,,1,"(7.927209,-72.507910)"
2012,Diciembre,Aruba,533,3379,2363,,5742,"(10.408582,-75.538003)"
2012,Diciembre,Aruba,533,3,2,,5,"(10.445761,-75.516429)"
2012,Diciembre,Aruba,533,9,7,,16,"(10.886611,-74.776708)"
2012,Diciembre,Aruba,533,0,1,,1,"(11.247723,-74.213989)"
2012,Diciembre,Aruba,533,124,77,,201,"(11.528919,-72.919681)"
2012,Diciembre,Aruba,533,56,45,,101,"(3.541112,-76.384584)"
2012,Diciembre,Aruba,533,111,104,,215,"(4.452882,-75.766298)"
2012,Diciembre,Aruba,533,1118,978,,2096,"(4.697144,-74.140516)"
2012,Diciembre,Aruba,533,1,4,,5,"(4.815061,-75.736532)"
2012,Diciembre,Aruba,533,160,102,,262,"(6.171601,-75.427454)"
2012,Diciembre,Aruba,533,7,12,,19,"(7.128456,-73.183637)"
2012,Diciembre,Australia,36,1,0,,1,"(10.445761,-75.516429)"
2012,Diciembre,Australia,36,3,2,,5,"(10.886611,-74.776708)"
2012,Diciembre,Australia,36,8,11,,19,"(3.541112,-76.384584)"
2012,Diciembre,Australia,36,314,230,,544,"(4.697144,-74.140516)"
2012,Diciembre,Australia,36,2,2,,4,"(4.815061,-75.736532)"
2012,Diciembre,Australia,36,33,29,,62,"(6.171601,-75.427454)"
2012,Diciembre,Australia,36,1,0,,1,"(7.128456,-73.183637)"
2012,Diciembre,Australia,36,2,1,,3,"(7.927209,-72.507910)"
2012,Diciembre,Austria,40,1,0,,1,"(10.445761,-75.516429)"
2012,Diciembre,Austria,40,32,33,,65,"(4.697144,-74.140516)"
2012,Diciembre,Azerbaiyán,31,0,2,,2,"(4.697144,-74.140516)"
2012,Diciembre,Bahamas,44,10,5,,15,"(10.445761,-75.516429)"
2012,Diciembre,Bahamas,44,6,2,,8,"(10.886611,-74.776708)"
2012,Diciembre,Bahamas,44,19,11,,30,"(3.541112,-76.384584)"
2012,Diciembre,Bahamas,44,46,45,,91,"(4.697144,-74.140516)"
2012,Diciembre,Bahamas,44,7,4,,11,"(4.815061,-75.736532)"
2012,Diciembre,Bahamas,44,8,5,,13,"(6.171601,-75.427454)"
2012,Diciembre,Bahamas,44,1,1,,2,"(7.927209,-72.507910)"
2012,Diciembre,Bahréin,48,5,2,,7,"(4.697144,-74.140516)"
2012,Diciembre,Bahréin,48,0,1,,1,"(7.818934,-72.453226)"
2012,Diciembre,Bangladesh,50,2,2,,4,"(4.697144,-74.140516)"
2012,Diciembre,Barbados,52,1,13,,14,"(4.697144,-74.140516)"
2012,Diciembre,República de Belarús,112,3,10,,13,"(11.360009,-72.129330)"
2012,Diciembre,República de Belarús,112,1,0,,1,"(3.541112,-76.384584)"
2012,Diciembre,República de Belarús,112,0,1,,1,"(4.697144,-74.140516)"
2012,Diciembre,República de Belarús,112,0,2,,2,"(7.088729,-70.740253)"
2012,Diciembre,República de Belarús,112,1,0,,1,"(7.818934,-72.453226)"
2012,Diciembre,Bélgica,56,9,3,,12,"(3.541112,-76.384584)"
2012,Diciembre,Bélgica,56,68,44,,112,"(4.697144,-74.140516)"
2012,Diciembre,Bélgica,56,4,5,,9,"(6.171601,-75.427454)"
2012,Diciembre,Belice,84,1,11,,12,"(4.697144,-74.140516)"
2012,Diciembre,Benín,204,0,1,,1,"(4.697144,-74.140516)"
2012,Diciembre,Bermudas/Territorio Británico de Ultramar,60,5,2,,7,"(4.697144,-74.140516)"
2012,Diciembre,Bermudas/Territorio Británico de Ultramar,60,1,0,,1,"(6.171601,-75.427454)"
2012,Diciembre,Bolivia,68,5,3,,8,"(0.814836,-77.662532)"
2012,Diciembre,Bolivia,68,2,2,,4,"(10.445761,-75.516429)"
2012,Diciembre,Bolivia,68,10,16,,26,"(3.541112,-76.384584)"
2012,Diciembre,Bolivia,68,286,311,,597,"(4.697144,-74.140516)"
2012,Diciembre,Bolivia,68,7,10,,17,"(6.171601,-75.427454)"
2012,Diciembre,Brasil,76,93,126,,219,"(-4.197703,-69.941278)"
2012,Diciembre,Brasil,76,0,1,,1,"(0.814836,-77.662532)"
2012,Diciembre,Brasil,76,8,6,,14,"(10.445761,-75.516429)"
2012,Diciembre,Brasil,76,10,11,,21,"(10.886611,-74.776708)"
2012,Diciembre,Brasil,76,37,48,,85,"(3.541112,-76.384584)"
2012,Diciembre,Brasil,76,2816,3157,,5973,"(4.697144,-74.140516)"
2012,Diciembre,Brasil,76,3,1,,4,"(4.815061,-75.736532)"
2012,Diciembre,Brasil,76,65,82,,147,"(6.171601,-75.427454)"
2012,Diciembre,Brasil,76,2,8,,10,"(7.128456,-73.183637)"
2012,Diciembre,Bulgaria,100,5,2,,7,"(4.697144,-74.140516)"
2012,Diciembre,Bulgaria,100,1,1,,2,"(6.171601,-75.427454)"
2012,Diciembre,Cabo Verde,132,1,0,,1,"(3.541112,-76.384584)"
2012,Diciembre,Cabo Verde,132,1,0,,1,"(4.697144,-74.140516)"
2012,Diciembre,Islas Caimán/Territorio Británico de Ultramar,136,1,0,,1,"(10.445761,-75.516429)"
2012,Diciembre,Islas Caimán/Territorio Británico de Ultramar,136,115,74,,189,"(12.586067,-81.702563)"
2012,Diciembre,Islas Caimán/Territorio Británico de Ultramar,136,3,0,,3,"(4.697144,-74.140516)"
2012,Diciembre,Camboya,116,0,1,,1,"(3.541112,-76.384584)"
2012,Diciembre,Camerún,120,2,1,,3,"(4.697144,-74.140516)"
2012,Diciembre,Canadá,124,47,41,,88,"(10.445761,-75.516429)"
2012,Diciembre,Canadá,124,7,4,,11,"(10.886611,-74.776708)"
2012,Diciembre,Canadá,124,3,3,,6,"(12.586067,-81.702563)"
2012,Diciembre,Canadá,124,37,38,,75,"(3.541112,-76.384584)"
2012,Diciembre,Canadá,124,3,2,,5,"(4.452882,-75.766298)"
2012,Diciembre,Canadá,124,1207,1046,,2253,"(4.697144,-74.140516)"
2012,Diciembre,Canadá,124,3,5,,8,"(4.815061,-75.736532)"
2012,Diciembre,Canadá,124,103,89,,192,"(6.171601,-75.427454)"
2012,Diciembre,Canadá,124,6,2,,8,"(7.128456,-73.183637)"
2012,Diciembre,España,724,3,1,,4,"(10.445761,-75.516429)"
2012,Diciembre,España,724,2,0,,2,"(10.886611,-74.776708)"
2012,Diciembre,España,724,1,0,,1,"(12.586067,-81.702563)"
2012,Diciembre,España,724,1474,1039,,2513,"(3.541112,-76.384584)"
2012,Diciembre,España,724,6187,4765,,10952,"(4.697144,-74.140516)"
2012,Diciembre,España,724,683,488,,1171,"(6.171601,-75.427454)"
2012,Diciembre,España,724,1,0,,1,"(7.818934,-72.453226)"
2012,Diciembre,España,724,1,0,,1,"(7.927209,-72.507910)"
2012,Diciembre,República Democrática del Congo,180,0,1,,1,"(12.586067,-81.702563)"
2012,Diciembre,República Democrática del Congo,180,1,0,,1,"(3.541112,-76.384584)"
2012,Diciembre,República Democrática del Congo,180,0,3,,3,"(4.697144,-74.140516)"
2012,Diciembre,República de Corea,410,0,1,,1,"(3.541112,-76.384584)"
2012,Diciembre,República de Corea,410,9,21,,30,"(4.697144,-74.140516)"
2012,Diciembre,Costa de Marfil,384,1,2,,3,"(4.697144,-74.140516)"
2012,Diciembre,Costa Rica,188,8,4,,12,"(10.445761,-75.516429)"
2012,Diciembre,Costa Rica,188,21,20,,41,"(10.886611,-74.776708)"
2012,Diciembre,Costa Rica,188,3,30,,33,"(12.5744111,-81.703935)"
2012,Diciembre,Costa Rica,188,2,6,,8,"(12.586067,-81.702563)"
2012,Diciembre,Costa Rica,188,53,59,,112,"(3.541112,-76.384584)"
2012,Diciembre,Costa Rica,188,874,940,,1814,"(4.697144,-74.140516)"
2012,Diciembre,Costa Rica,188,7,5,,12,"(4.815061,-75.736532)"
2012,Diciembre,Costa Rica,188,239,223,,462,"(6.171601,-75.427454)"
2012,Diciembre,Costa Rica,188,12,9,,21,"(7.128456,-73.183637)"
2012,Diciembre,Costa Rica,188,3,2,,5,"(7.927209,-72.507910)"
2012,Diciembre,Costa Rica,188,0,1,,1,"(8.635765,-77.346578)"
2012,Diciembre,Cuba,192,19,16,,35,"(10.445761,-75.516429)"
2012,Diciembre,Cuba,192,45,34,,79,"(10.886611,-74.776708)"
2012,Diciembre,Cuba,192,39,11,,50,"(12.586067,-81.702563)"
2012,Diciembre,Cuba,192,108,101,,209,"(3.541112,-76.384584)"
2012,Diciembre,Cuba,192,1559,1359,,2918,"(4.697144,-74.140516)"
2012,Diciembre,Cuba,192,12,5,,17,"(4.815061,-75.736532)"
2012,Diciembre,Cuba,192,276,214,,490,"(6.171601,-75.427454)"
2012,Diciembre,Cuba,192,8,7,,15,"(7.128456,-73.183637)"
2012,Diciembre,Cuba,192,3,0,,3,"(7.927209,-72.507910)"
2012,Diciembre,Curazao,99999,6,4,,10,"(10.886611,-74.776708)"
2012,Diciembre,Curazao,99999,12,8,,20,"(3.541112,-76.384584)"
2012,Diciembre,Curazao,99999,1,0,,1,"(4.452882,-75.766298)"
2012,Diciembre,Curazao,99999,648,600,,1248,"(4.697144,-74.140516)"
2012,Diciembre,Curazao,99999,1,1,,2,"(4.815061,-75.736532)"
2012,Diciembre,Curazao,99999,138,82,,220,"(6.171601,-75.427454)"
2012,Diciembre,Curazao,99999,3,7,,10,"(7.128456,-73.183637)"
2012,Diciembre,República Checa,203,5,5,,10,"(4.697144,-74.140516)"
2012,Diciembre,Chile,152,0,1,,1,"(0.25129,-76.875963)"
2012,Diciembre,Chile,152,26,17,,43,"(0.814836,-77.662532)"
2012,Diciembre,Chile,152,21,21,,42,"(10.445761,-75.516429)"
2012,Diciembre,Chile,152,45,21,,66,"(10.886611,-74.776708)"
2012,Diciembre,Chile,152,2,1,,3,"(12.586067,-81.702563)"
2012,Diciembre,Chile,152,301,209,,510,"(3.541112,-76.384584)"
2012,Diciembre,Chile,152,3809,3079,,6888,"(4.697144,-74.140516)"
2012,Diciembre,Chile,152,34,33,,67,"(4.815061,-75.736532)"
2012,Diciembre,Chile,152,194,148,,342,"(6.171601,-75.427454)"
2012,Diciembre,Chile,152,11,9,,20,"(7.128456,-73.183637)"
2012,Diciembre,Chile,152,3,2,,5,"(7.927209,-72.507910)"
2012,Diciembre,China,156,0,4,,4,"(3.541112,-76.384584)"
2012,Diciembre,China,156,99,183,,282,"(4.697144,-74.140516)"
2012,Diciembre,China,156,5,12,,17,"(6.171601,-75.427454)"
2012,Diciembre,Chipre,196,3,3,,6,"(4.697144,-74.140516)"
2012,Diciembre,Dinamarca,208,0,1,,1,"(10.445761,-75.516429)"
2012,Diciembre,Dinamarca,208,1,0,,1,"(3.541112,-76.384584)"
2012,Diciembre,Dinamarca,208,32,23,,55,"(4.697144,-74.140516)"
2012,Diciembre,Dominica,212,0,1,,1,"(0.814836,-77.662532)"
2012,Diciembre,Dominica,212,5,10,,15,"(4.697144,-74.140516)"
2012,Diciembre,Ecuador,218,655,737,,1392,"(0.25129,-76.875963)"
2012,Diciembre,Ecuador,218,11209,11123,,22332,"(0.814836,-77.662532)"
2012,Diciembre,Ecuador,218,196,167,,363,"(1.813928,-78.763924)"
2012,Diciembre,Ecuador,218,0,8,,8,"(10.408582,-75.538003)"
2012,Diciembre,Ecuador,218,0,1,,1,"(10.445761,-75.516429)"
2012,Diciembre,Ecuador,218,10,8,,18,"(10.886611,-74.776708)"
2012,Diciembre,Ecuador,218,1197,1009,,2206,"(3.541112,-76.384584)"
2012,Diciembre,Ecuador,218,3267,4271,,7538,"(4.697144,-74.140516)"
2012,Diciembre,Ecuador,218,1,2,,3,"(4.815061,-75.736532)"
2012,Diciembre,Ecuador,218,768,693,,1461,"(6.171601,-75.427454)"
2012,Diciembre,Ecuador,218,4,7,,11,"(7.128456,-73.183637)"
2012,Diciembre,Ecuador,218,3,0,,3,"(7.927209,-72.507910)"
2012,Diciembre,Egipto,818,1,0,,1,"(3.541112,-76.384584)"
2012,Diciembre,Egipto,818,197,111,,308,"(4.697144,-74.140516)"
2012,Diciembre,El Salvador,222,7,7,,14,"(10.445761,-75.516429)"
2012,Diciembre,El Salvador,222,3,4,,7,"(10.886611,-74.776708)"
2012,Diciembre,El Salvador,222,48,55,,103,"(3.541112,-76.384584)"
2012,Diciembre,El Salvador,222,836,835,,1671,"(4.697144,-74.140516)"
2012,Diciembre,El Salvador,222,3,1,,4,"(4.815061,-75.736532)"
2012,Diciembre,El Salvador,222,33,26,,59,"(6.171601,-75.427454)"
2012,Diciembre,El Salvador,222,1,1,,2,"(7.128456,-73.183637)"
2012,Diciembre,El Salvador,222,2,1,,3,"(7.927209,-72.507910)"
2012,Diciembre,Emiratos Árabes,784,2,4,,6,"(3.541112,-76.384584)"
2012,Diciembre,Emiratos Árabes,784,116,194,,310,"(4.697144,-74.140516)"
2012,Diciembre,Emiratos Árabes,784,1,3,,4,"(6.171601,-75.427454)"
2012,Diciembre,Eritrea,232,1,0,,1,"(4.697144,-74.140516)"
2012,Diciembre,Eslovaquia,703,1,0,,1,"(4.697144,-74.140516)"
2012,Diciembre,Eslovenia,705,1,0,,1,"(4.697144,-74.140516)"
2012,Diciembre,Estados Unidos de América,840,0,2,,2,"(10.408582,-75.538003)"
2012,Diciembre,Estados Unidos de América,840,2627,2344,,4971,"(10.445761,-75.516429)"
2012,Diciembre,Estados Unidos de América,840,2573,2097,,4670,"(10.886611,-74.776708)"
2012,Diciembre,Estados Unidos de América,840,25,20,,45,"(12.586067,-81.702563)"
2012,Diciembre,Estados Unidos de América,840,5601,4288,,9889,"(3.541112,-76.384584)"
2012,Diciembre,Estados Unidos de América,840,525,379,,904,"(4.452882,-75.766298)"
2012,Diciembre,Estados Unidos de América,840,35616,30704,,66320,"(4.697144,-74.140516)"
2012,Diciembre,Estados Unidos de América,840,323,237,,560,"(4.815061,-75.736532)"
2012,Diciembre,Estados Unidos de América,840,8733,6865,,15598,"(6.171601,-75.427454)"
2012,Diciembre,Estados Unidos de América,840,222,181,,403,"(7.128456,-73.183637)"
2012,Diciembre,Estados Unidos de América,840,62,47,,109,"(7.927209,-72.507910)"
2012,Diciembre,Estonia,233,0,3,,3,"(4.697144,-74.140516)"
2012,Diciembre,Etiopia,231,0,1,,1,"(4.697144,-74.140516)"
2012,Diciembre,Filipinas,608,1,3,,4,"(4.697144,-74.140516)"
2012,Diciembre,Filipinas,608,1,0,,1,"(6.171601,-75.427454)"
2012,Diciembre,Finlandia,246,1,2,,3,"(3.541112,-76.384584)"
2012,Diciembre,Finlandia,246,9,8,,17,"(4.697144,-74.140516)"
2012,Diciembre,Francia,250,52,32,,84,"(3.541112,-76.384584)"
2012,Diciembre,Francia,250,1386,1097,,2483,"(4.697144,-74.140516)"
2012,Diciembre,Francia,250,32,13,,45,"(6.171601,-75.427454)"
2012,Diciembre,Gabón,266,0,1,,1,"(4.697144,-74.140516)"
2012,Diciembre,Georgia,268,0,1,,1,"(4.697144,-74.140516)"
2012,Diciembre,Gibraltar/Territorio Británico de Ultramar,292,0,1,,1,"(4.697144,-74.140516)"
2012,Diciembre,Grecia,300,0,1,,1,"(3.541112,-76.384584)"
2012,Diciembre,Grecia,300,7,6,,13,"(4.697144,-74.140516)"
2012,Diciembre,Guatemala,320,2,15,,17,"(10.445761,-75.516429)"
2012,Diciembre,Guatemala,320,7,8,,15,"(10.886611,-74.776708)"
2012,Diciembre,Guatemala,320,2,0,,2,"(12.586067,-81.702563)"
2012,Diciembre,Guatemala,320,42,34,,76,"(3.541112,-76.384584)"
2012,Diciembre,Guatemala,320,171,230,,401,"(4.697144,-74.140516)"
2012,Diciembre,Guatemala,320,8,4,,12,"(4.815061,-75.736532)"
2012,Diciembre,Guatemala,320,52,66,,118,"(6.171601,-75.427454)"
2012,Diciembre,Guatemala,320,5,3,,8,"(7.128456,-73.183637)"
2012,Diciembre,Guatemala,320,2,1,,3,"(7.927209,-72.507910)"
2012,Diciembre,Guyana,328,1,0,,1,"(4.697144,-74.140516)"
2012,Diciembre,Guyana,328,0,1,,1,"(6.171601,-75.427454)"
2012,Diciembre,Guinea,324,0,1,,1,"(4.697144,-74.140516)"
2012,Diciembre,Guinea Ecuatorial,226,0,1,,1,"(4.697144,-74.140516)"
2012,Diciembre,Guayana Francesa/Departamento de Ultramar Francés,254,1,0,,1,"(10.445761,-75.516429)"
2012,Diciembre,Haití,332,0,4,,4,"(10.886611,-74.776708)"
2012,Diciembre,Haití,332,1,0,,1,"(3.541112,-76.384584)"
2012,Diciembre,Haití,332,2,5,,7,"(4.697144,-74.140516)"
2012,Diciembre,Haití,332,0,10,,10,"(6.171601,-75.427454)"
2012,Diciembre,Honduras,340,5,7,,12,"(10.445761,-75.516429)"
2012,Diciembre,Honduras,340,1,5,,6,"(10.886611,-74.776708)"
2012,Diciembre,Honduras,340,0,6,,6,"(12.586067,-81.702563)"
2012,Diciembre,Honduras,340,0,1,,1,"(13.3387613,-81.372937)"
2012,Diciembre,Honduras,340,17,27,,44,"(3.541112,-76.384584)"
2012,Diciembre,Honduras,340,69,135,,204,"(4.697144,-74.140516)"
2012,Diciembre,Honduras,340,5,0,,5,"(4.815061,-75.736532)"
2012,Diciembre,Honduras,340,47,58,,105,"(6.171601,-75.427454)"
2012,Diciembre,Honduras,340,1,1,,2,"(7.128456,-73.183637)"
2012,Diciembre,Honduras,340,1,1,,2,"(7.927209,-72.507910)"
2012,Diciembre,Hong Kong,344,21,20,,41,"(4.697144,-74.140516)"
2012,Diciembre,Hong Kong,344,2,2,,4,"(6.171601,-75.427454)"
2012,Diciembre,Hungría,348,0,4,,4,"(4.697144,-74.140516)"
2012,Diciembre,Hungría,348,2,2,,4,"(6.171601,-75.427454)"
2012,Diciembre,India,356,1,0,,1,"(3.541112,-76.384584)"
2012,Diciembre,India,356,55,50,,105,"(4.697144,-74.140516)"
2012,Diciembre,India,356,2,3,,5,"(6.171601,-75.427454)"
2012,Diciembre,Indonesia,360,15,13,,28,"(4.697144,-74.140516)"
2012,Diciembre,Indonesia,360,1,0,,1,"(6.171601,-75.427454)"
2012,Diciembre,Iraq,368,2,19,,21,"(4.697144,-74.140516)"
2012,Diciembre,Irán,364,2,0,,2,"(4.697144,-74.140516)"
2012,Diciembre,República de Irlanda,372,12,15,,27,"(4.697144,-74.140516)"
2012,Diciembre,República de Irlanda,372,1,0,,1,"(6.171601,-75.427454)"
2012,Diciembre,Islandia,352,1,1,,2,"(4.697144,-74.140516)"
2012,Diciembre,Israel,376,1,0,,1,"(10.886611,-74.776708)"
2012,Diciembre,Israel,376,4,3,,7,"(3.541112,-76.384584)"
2012,Diciembre,Israel,376,179,112,,291,"(4.697144,-74.140516)"
2012,Diciembre,Israel,376,1,0,,1,"(6.171601,-75.427454)"
2012,Diciembre,Islas Aland/Provincia de Finlandia,248,0,1,,1,"(4.697144,-74.140516)"
2012,Diciembre,Italia,380,1,0,,1,"(10.445761,-75.516429)"
2012,Diciembre,Italia,380,63,24,,87,"(3.541112,-76.384584)"
2012,Diciembre,Italia,380,510,352,,862,"(4.697144,-74.140516)"
2012,Diciembre,Italia,380,16,16,,32,"(6.171601,-75.427454)"
2012,Diciembre,Jamaica,388,0,1,,1,"(10.408582,-75.538003)"
2012,Diciembre,Jamaica,388,5,10,,15,"(10.445761,-75.516429)"
2012,Diciembre,Jamaica,388,1,2,,3,"(10.886611,-74.776708)"
2012,Diciembre,Jamaica,388,2,0,,2,"(12.586067,-81.702563)"
2012,Diciembre,Jamaica,388,5,3,,8,"(3.541112,-76.384584)"
2012,Diciembre,Jamaica,388,79,81,,160,"(4.697144,-74.140516)"
2012,Diciembre,Jamaica,388,0,3,,3,"(4.815061,-75.736532)"
2012,Diciembre,Jamaica,388,36,31,,67,"(6.171601,-75.427454)"
2012,Diciembre,Jamaica,388,2,3,,5,"(7.128456,-73.183637)"
2012,Diciembre,Japón,392,5,0,,5,"(3.541112,-76.384584)"
2012,Diciembre,Japón,392,41,56,,97,"(4.697144,-74.140516)"
2012,Diciembre,Japón,392,1,1,,2,"(6.171601,-75.427454)"
2012,Diciembre,Jordania,400,0,2,,2,"(3.541112,-76.384584)"
2012,Diciembre,Jordania,400,5,1,,6,"(4.697144,-74.140516)"
2012,Diciembre,Kazajistán,398,0,2,,2,"(4.697144,-74.140516)"
2012,Diciembre,Kenia,404,2,0,,2,"(4.697144,-74.140516)"
2012,Diciembre,Kenia,404,4,1,,5,"(6.171601,-75.427454)"
2012,Diciembre,República de Kosovo,901,1,0,,1,"(4.697144,-74.140516)"
2012,Diciembre,Lituania,440,2,0,,2,"(4.697144,-74.140516)"
2012,Diciembre,Líbano,422,14,11,,25,"(4.697144,-74.140516)"
2012,Diciembre,Luxemburgo,442,1,0,,1,"(3.541112,-76.384584)"
2012,Diciembre,Luxemburgo,442,3,2,,5,"(4.697144,-74.140516)"
2012,Diciembre,Malasia,458,1,2,,3,"(10.886611,-74.776708)"
2012,Diciembre,Malasia,458,5,4,,9,"(4.697144,-74.140516)"
2012,Diciembre,Malasia,458,1,1,,2,"(6.171601,-75.427454)"
2012,Diciembre,Malta,470,1,0,,1,"(4.697144,-74.140516)"
2012,Diciembre,Malta,470,1,1,,2,"(6.171601,-75.427454)"
2012,Diciembre,Marruecos,504,7,10,,17,"(4.697144,-74.140516)"
2012,Diciembre,Marruecos,504,0,1,,1,"(6.171601,-75.427454)"
2012,Diciembre,Islas Marshall,584,0,1,,1,"(4.697144,-74.140516)"
2012,Diciembre,México,484,57,57,,114,"(10.445761,-75.516429)"
2012,Diciembre,México,484,78,57,,135,"(10.886611,-74.776708)"
2012,Diciembre,México,484,420,327,,747,"(3.541112,-76.384584)"
2012,Diciembre,México,484,7840,6690,,14530,"(4.697144,-74.140516)"
2012,Diciembre,México,484,92,59,,151,"(4.815061,-75.736532)"
2012,Diciembre,México,484,1097,777,,1874,"(6.171601,-75.427454)"
2012,Diciembre,México,484,68,54,,122,"(7.128456,-73.183637)"
2012,Diciembre,México,484,20,15,,35,"(7.927209,-72.507910)"
2012,Diciembre,Mayotte/Colectividad Territorial Francesa,175,1,0,,1,"(4.697144,-74.140516)"
2012,Diciembre,Mónaco,492,3,1,,4,"(4.697144,-74.140516)"
2012,Diciembre,Myanmar,104,0,5,,5,"(4.697144,-74.140516)"
2012,Diciembre,Namibia,516,0,1,,1,"(4.697144,-74.140516)"
2012,Diciembre,Nepal,524,1,0,,1,"(3.541112,-76.384584)"
2012,Diciembre,Nicaragua,558,5,4,,9,"(10.445761,-75.516429)"
2012,Diciembre,Nicaragua,558,2,2,,4,"(10.886611,-74.776708)"
2012,Diciembre,Nicaragua,558,2,1,,3,"(12.586067,-81.702563)"
2012,Diciembre,Nicaragua,558,7,5,,12,"(3.541112,-76.384584)"
2012,Diciembre,Nicaragua,558,41,61,,102,"(4.697144,-74.140516)"
2012,Diciembre,Nicaragua,558,1,2,,3,"(4.815061,-75.736532)"
2012,Diciembre,Nicaragua,558,9,8,,17,"(6.171601,-75.427454)"
2012,Diciembre,Nicaragua,558,1,0,,1,"(7.128456,-73.183637)"
2012,Diciembre,Nigeria,566,0,1,,1,"(12.586067,-81.702563)"
2012,Diciembre,Nigeria,566,0,9,,9,"(4.697144,-74.140516)"
2012,Diciembre,Noruega,578,2,2,,4,"(10.886611,-74.776708)"
2012,Diciembre,Noruega,578,2,1,,3,"(3.541112,-76.384584)"
2012,Diciembre,Noruega,578,30,21,,51,"(4.697144,-74.140516)"
2012,Diciembre,Noruega,578,1,1,,2,"(6.171601,-75.427454)"
2012,Diciembre,Nueva Zelanda,554,18,15,,33,"(4.697144,-74.140516)"
2012,Diciembre,Nueva Zelanda,554,3,2,,5,"(6.171601,-75.427454)"
2012,Diciembre,Omán,512,5,6,,11,"(4.697144,-74.140516)"
2012,Diciembre,Papúa Nueva Guinea,598,0,1,,1,"(3.541112,-76.384584)"
2012,Diciembre,Papúa Nueva Guinea,598,0,7,,7,"(4.697144,-74.140516)"
2012,Diciembre,Pakistán,586,0,1,,1,"(4.697144,-74.140516)"
2012,Diciembre,Palau,585,0,1,,1,"(3.541112,-76.384584)"
2012,Diciembre,Panamá,591,31,62,,93,"(10.408582,-75.538003)"
2012,Diciembre,Panamá,591,420,399,,819,"(10.445761,-75.516429)"
2012,Diciembre,Panamá,591,1031,989,,2020,"(10.886611,-74.776708)"
2012,Diciembre,Panamá,591,0,2,,2,"(10.971302,-74.765397)"
2012,Diciembre,Panamá,591,1,2,,3,"(11.247723,-74.213989)"
2012,Diciembre,Panamá,591,2,8,,10,"(12.5744111,-81.703935)"
2012,Diciembre,Panamá,591,192,136,,328,"(12.586067,-81.702563)"
2012,Diciembre,Panamá,591,2179,1797,,3976,"(3.541112,-76.384584)"
2012,Diciembre,Panamá,591,1,2,,3,"(3.893038,-77.067921)"
2012,Diciembre,Panamá,591,8613,8179,,16792,"(4.697144,-74.140516)"
2012,Diciembre,Panamá,591,714,499,,1213,"(4.815061,-75.736532)"
2012,Diciembre,Panamá,591,2866,2381,,5247,"(6.171601,-75.427454)"
2012,Diciembre,Panamá,591,5,10,,15,"(6.228046,-77.404104)"
2012,Diciembre,Panamá,591,254,233,,487,"(7.128456,-73.183637)"
2012,Diciembre,Panamá,591,180,194,,374,"(7.927209,-72.507910)"
2012,Diciembre,Panamá,591,1,44,,45,"(8.066966,-76.735404)"
2012,Diciembre,Panamá,591,73,136,,209,"(8.635765,-77.346578)"
2012,Diciembre,Paraguay,600,3,1,,4,"(0.814836,-77.662532)"
2012,Diciembre,Paraguay,600,0,1,,1,"(10.445761,-75.516429)"
2012,Diciembre,Paraguay,600,3,2,,5,"(10.886611,-74.776708)"
2012,Diciembre,Paraguay,600,7,9,,16,"(3.541112,-76.384584)"
2012,Diciembre,Paraguay,600,57,87,,144,"(4.697144,-74.140516)"
2012,Diciembre,Paraguay,600,3,1,,4,"(4.815061,-75.736532)"
2012,Diciembre,Paraguay,600,7,10,,17,"(6.171601,-75.427454)"
2012,Diciembre,Perú,604,125,136,,261,"(-4.197703,-69.941278)"
2012,Diciembre,Perú,604,1,3,,4,"(0.25129,-76.875963)"
2012,Diciembre,Perú,604,44,41,,85,"(0.814836,-77.662532)"
2012,Diciembre,Perú,604,12,22,,34,"(10.445761,-75.516429)"
2012,Diciembre,Perú,604,17,13,,30,"(10.886611,-74.776708)"
2012,Diciembre,Perú,604,2,0,,2,"(12.586067,-81.702563)"
2012,Diciembre,Perú,604,266,208,,474,"(3.541112,-76.384584)"
2012,Diciembre,Perú,604,4988,4889,,9877,"(4.697144,-74.140516)"
2012,Diciembre,Perú,604,18,11,,29,"(4.815061,-75.736532)"
2012,Diciembre,Perú,604,429,406,,835,"(6.171601,-75.427454)"
2012,Diciembre,Perú,604,11,7,,18,"(7.128456,-73.183637)"
2012,Diciembre,Perú,604,0,2,,2,"(7.927209,-72.507910)"
2012,Diciembre,Palestina,99999,1,1,,2,"(3.541112,-76.384584)"
2012,Diciembre,Palestina,99999,0,1,,1,"(4.697144,-74.140516)"
2012,Diciembre,Palestina,99999,1,0,,1,"(6.171601,-75.427454)"
2012,Diciembre,Polonia,616,9,9,,18,"(4.697144,-74.140516)"
2012,Diciembre,Portugal,620,5,2,,7,"(3.541112,-76.384584)"
2012,Diciembre,Portugal,620,34,28,,62,"(4.697144,-74.140516)"
2012,Diciembre,Portugal,620,8,2,,10,"(6.171601,-75.427454)"
2012,Diciembre,Puerto Rico/Territorio de Estados Unidos,630,6,9,,15,"(10.445761,-75.516429)"
2012,Diciembre,Puerto Rico/Territorio de Estados Unidos,630,20,17,,37,"(10.886611,-74.776708)"
2012,Diciembre,Puerto Rico/Territorio de Estados Unidos,630,0,2,,2,"(12.586067,-81.702563)"
2012,Diciembre,Puerto Rico/Territorio de Estados Unidos,630,42,31,,73,"(3.541112,-76.384584)"
2012,Diciembre,Puerto Rico/Territorio de Estados Unidos,630,172,148,,320,"(4.697144,-74.140516)"
2012,Diciembre,Puerto Rico/Territorio de Estados Unidos,630,18,9,,27,"(4.815061,-75.736532)"
2012,Diciembre,Puerto Rico/Territorio de Estados Unidos,630,91,87,,178,"(6.171601,-75.427454)"
2012,Diciembre,Puerto Rico/Territorio de Estados Unidos,630,5,3,,8,"(7.128456,-73.183637)"
2012,Diciembre,Puerto Rico/Territorio de Estados Unidos,630,1,0,,1,"(7.927209,-72.507910)"
2012,Diciembre,Qatar,634,4,3,,7,"(4.697144,-74.140516)"
2012,Diciembre,Qatar,634,0,2,,2,"(6.171601,-75.427454)"
2012,Diciembre,Reino Unido de Gran Bretaña e Irlanda del Norte,826,2,2,,4,"(10.445761,-75.516429)"
2012,Diciembre,Reino Unido de Gran Bretaña e Irlanda del Norte,826,1,0,,1,"(10.886611,-74.776708)"
2012,Diciembre,Reino Unido de Gran Bretaña e Irlanda del Norte,826,43,32,,75,"(3.541112,-76.384584)"
2012,Diciembre,Reino Unido de Gran Bretaña e Irlanda del Norte,826,615,402,,1017,"(4.697144,-74.140516)"
2012,Diciembre,Reino Unido de Gran Bretaña e Irlanda del Norte,826,2,0,,2,"(4.815061,-75.736532)"
2012,Diciembre,Reino Unido de Gran Bretaña e Irlanda del Norte,826,23,12,,35,"(6.171601,-75.427454)"
2012,Diciembre,Federación de Rusia,643,1,1,,2,"(3.541112,-76.384584)"
2012,Diciembre,Federación de Rusia,643,13,34,,47,"(4.697144,-74.140516)"
2012,Diciembre,República Dominicana,214,18,23,,41,"(10.445761,-75.516429)"
2012,Diciembre,República Dominicana,214,49,26,,75,"(10.886611,-74.776708)"
2012,Diciembre,República Dominicana,214,80,59,,139,"(3.541112,-76.384584)"
2012,Diciembre,República Dominicana,214,1875,1645,,3520,"(4.697144,-74.140516)"
2012,Diciembre,República Dominicana,214,31,18,,49,"(4.815061,-75.736532)"
2012,Diciembre,República Dominicana,214,293,186,,479,"(6.171601,-75.427454)"
2012,Diciembre,República Dominicana,214,15,13,,28,"(7.128456,-73.183637)"
2012,Diciembre,República Dominicana,214,22,7,,29,"(7.927209,-72.507910)"
2012,Diciembre,Reunión,638,1,0,,1,"(4.697144,-74.140516)"
2012,Diciembre,Rumania,642,1,0,,1,"(3.541112,-76.384584)"
2012,Diciembre,Rumania,642,6,3,,9,"(4.697144,-74.140516)"
2012,Diciembre,San Pedro y Miquelón/territorio de Ultramar de La Unión Europea,666,1,0,,1,"(4.697144,-74.140516)"
2012,Diciembre,Samoa Estadounidense/Territorio no incorporado de Estados Unidos,16,0,1,,1,"(4.697144,-74.140516)"
2012,Diciembre,Santa Lucia,662,0,1,,1,"(4.697144,-74.140516)"
2012,Diciembre,Serbia,688,0,3,,3,"(4.697144,-74.140516)"
2012,Diciembre,Singapur,702,35,32,,67,"(4.697144,-74.140516)"
2012,Diciembre,Singapur,702,0,1,,1,"(6.171601,-75.427454)"
2012,Diciembre,Sudáfrica,710,1,0,,1,"(3.541112,-76.384584)"
2012,Diciembre,Sudáfrica,710,24,18,,42,"(4.697144,-74.140516)"
2012,Diciembre,Sudán,736,1,0,,1,"(4.697144,-74.140516)"
2012,Diciembre,Sudán,736,0,1,,1,"(6.171601,-75.427454)"
2012,Diciembre,Suecia,752,0,1,,1,"(10.886611,-74.776708)"
2012,Diciembre,Suecia,752,4,4,,8,"(3.541112,-76.384584)"
2012,Diciembre,Suecia,752,60,40,,100,"(4.697144,-74.140516)"
2012,Diciembre,Suecia,752,4,1,,5,"(6.171601,-75.427454)"
2012,Diciembre,Suiza,756,1,0,,1,"(10.445761,-75.516429)"
2012,Diciembre,Suiza,756,1,0,,1,"(10.886611,-74.776708)"
2012,Diciembre,Suiza,756,0,1,,1,"(12.586067,-81.702563)"
2012,Diciembre,Suiza,756,26,17,,43,"(3.541112,-76.384584)"
2012,Diciembre,Suiza,756,233,181,,414,"(4.697144,-74.140516)"
2012,Diciembre,Suiza,756,10,8,,18,"(6.171601,-75.427454)"
2012,Diciembre,Surinam,740,3,3,,6,"(4.697144,-74.140516)"
2012,Diciembre,Taiwán,158,0,2,,2,"(4.697144,-74.140516)"
2012,Diciembre,Tailandia,764,15,12,,27,"(4.697144,-74.140516)"
2012,Diciembre,Tailandia,764,0,1,,1,"(6.171601,-75.427454)"
2012,Diciembre,Trinidad y Tobago,780,0,2,,2,"(10.445761,-75.516429)"
2012,Diciembre,Trinidad y Tobago,780,3,1,,4,"(10.886611,-74.776708)"
2012,Diciembre,Trinidad y Tobago,780,5,6,,11,"(3.541112,-76.384584)"
2012,Diciembre,Trinidad y Tobago,780,31,42,,73,"(4.697144,-74.140516)"
2012,Diciembre,Trinidad y Tobago,780,1,0,,1,"(4.815061,-75.736532)"
2012,Diciembre,Trinidad y Tobago,780,9,11,,20,"(6.171601,-75.427454)"
2012,Diciembre,Trinidad y Tobago,780,1,1,,2,"(7.128456,-73.183637)"
2012,Diciembre,Túnez,788,2,0,,2,"(4.697144,-74.140516)"
2012,Diciembre,Turquía,792,3,4,,7,"(3.541112,-76.384584)"
2012,Diciembre,Turquía,792,62,57,,119,"(4.697144,-74.140516)"
2012,Diciembre,Turquía,792,2,3,,5,"(6.171601,-75.427454)"
2012,Diciembre,Ucrania,804,3,5,,8,"(4.697144,-74.140516)"
2012,Diciembre,Uruguay,858,2,2,,4,"(0.814836,-77.662532)"
2012,Diciembre,Uruguay,858,2,5,,7,"(10.445761,-75.516429)"
2012,Diciembre,Uruguay,858,3,0,,3,"(10.886611,-74.776708)"
2012,Diciembre,Uruguay,858,19,12,,31,"(3.541112,-76.384584)"
2012,Diciembre,Uruguay,858,111,109,,220,"(4.697144,-74.140516)"
2012,Diciembre,Uruguay,858,3,0,,3,"(4.815061,-75.736532)"
2012,Diciembre,Uruguay,858,16,16,,32,"(6.171601,-75.427454)"
2012,Diciembre,Uruguay,858,1,1,,2,"(7.128456,-73.183637)"
2012,Diciembre,Venezuela,862,8,10,,18,"(10.445761,-75.516429)"
2012,Diciembre,Venezuela,862,18,11,,29,"(10.886611,-74.776708)"
2012,Diciembre,Venezuela,862,10044,8421,,18465,"(11.360009,-72.129330)"
2012,Diciembre,Venezuela,862,14,12,,26,"(3.541112,-76.384584)"
2012,Diciembre,Venezuela,862,0,1,,1,"(4.452882,-75.766298)"
2012,Diciembre,Venezuela,862,2629,2385,,5014,"(4.697144,-74.140516)"
2012,Diciembre,Venezuela,862,2,3,,5,"(4.815061,-75.736532)"
2012,Diciembre,Venezuela,862,366,289,,655,"(6.171601,-75.427454)"
2012,Diciembre,Venezuela,862,471,483,,954,"(6.185799,-67.483929)"
2012,Diciembre,Venezuela,862,2623,2358,,4981,"(7.088729,-70.740253)"
2012,Diciembre,Venezuela,862,15053,13602,,28655,"(7.818934,-72.453226)"
2012,Diciembre,Venezuela,862,2,5,,7,"(7.927209,-72.507910)"
2012,Diciembre,Vietnam,704,5,3,,8,"(4.697144,-74.140516)"
2012,Diciembre,Islas Vírgenes Británicas/Territorio Británico de Ultramar,92,0,1,,1,"(4.697144,-74.140516)"
2012,Diciembre,Zimbabue,716,1,0,,1,"(4.697144,-74.140516)"
2012,Diciembre,Desconocido,99999,0,2,,2,"(10.445761,-75.516429)"
2012,Diciembre,Desconocido,99999,1,1,,2,"(3.541112,-76.384584)"
2012,Diciembre,Desconocido,99999,6,26,,32,"(4.697144,-74.140516)"
2013,Enero,Afganistán,4,0,1,,1,"(10.886611,-74.776708)"
2013,Enero,Afganistán,4,1,3,,4,"(3.541112,-76.384584)"
2013,Enero,Afganistán,4,7,42,,49,"(4.697144,-74.140516)"
2013,Enero,Afganistán,4,1,0,,1,"(6.171601,-75.427454)"
2013,Enero,Alemania,276,8,3,,11,"(0.814836,-77.662532)"
2013,Enero,Alemania,276,6,2,,8,"(10.445761,-75.516429)"
2013,Enero,Alemania,276,3,4,,7,"(10.886611,-74.776708)"
2013,Enero,Alemania,276,39,32,,71,"(3.541112,-76.384584)"
2013,Enero,Alemania,276,1022,886,,1908,"(4.697144,-74.140516)"
2013,Enero,Alemania,276,1,0,,1,"(4.815061,-75.736532)"
2013,Enero,Alemania,276,24,25,,49,"(6.171601,-75.427454)"
2013,Enero,Alemania,276,0,1,,1,"(7.128456,-73.183637)"
2013,Enero,Alemania,276,1,0,,1,"(7.927209,-72.507910)"
2013,Enero,Andorra,20,0,1,,1,"(3.541112,-76.384584)"
2013,Enero,Andorra,20,4,0,,4,"(4.697144,-74.140516)"
2013,Enero,Angola,24,3,17,,20,"(4.697144,-74.140516)"
2013,Enero,Angola,24,1,0,,1,"(6.171601,-75.427454)"
2013,Enero,Angola,24,1,1,,2,"(7.128456,-73.183637)"
2013,Enero,Países Bajos,528,265,158,,423,"(10.408582,-75.538003)"
2013,Enero,Países Bajos,528,3,1,,4,"(10.445761,-75.516429)"
2013,Enero,Países Bajos,528,4,1,,5,"(10.886611,-74.776708)"
2013,Enero,Países Bajos,528,34,16,,50,"(3.541112,-76.384584)"
2013,Enero,Países Bajos,528,1,0,,1,"(4.452882,-75.766298)"
2013,Enero,Países Bajos,528,252,153,,405,"(4.697144,-74.140516)"
2013,Enero,Países Bajos,528,1,0,,1,"(4.815061,-75.736532)"
2013,Enero,Países Bajos,528,67,60,,127,"(6.171601,-75.427454)"
2013,Enero,Países Bajos,528,1,0,,1,"(7.128456,-73.183637)"
2013,Enero,Arabia Saudita,682,0,1,,1,"(10.445761,-75.516429)"
2013,Enero,Arabia Saudita,682,1,2,,3,"(3.541112,-76.384584)"
2013,Enero,Arabia Saudita,682,26,53,,79,"(4.697144,-74.140516)"
2013,Enero,Arabia Saudita,682,3,5,,8,"(6.171601,-75.427454)"
2013,Enero,Argelia,12,1,0,,1,"(0.814836,-77.662532)"
2013,Enero,Argelia,12,1,4,,5,"(3.541112,-76.384584)"
2013,Enero,Argelia,12,1,7,,8,"(4.697144,-74.140516)"
2013,Enero,Argelia,12,1,0,,1,"(6.171601,-75.427454)"
2013,Enero,Argentina,32,8,16,,24,"(0.814836,-77.662532)"
2013,Enero,Argentina,32,24,22,,46,"(10.445761,-75.516429)"
2013,Enero,Argentina,32,31,22,,53,"(10.886611,-74.776708)"
2013,Enero,Argentina,32,1,1,,2,"(12.586067,-81.702563)"
2013,Enero,Argentina,32,190,187,,377,"(3.541112,-76.384584)"
2013,Enero,Argentina,32,3818,3677,,7495,"(4.697144,-74.140516)"
2013,Enero,Argentina,32,9,8,,17,"(4.815061,-75.736532)"
2013,Enero,Argentina,32,195,216,,411,"(6.171601,-75.427454)"
2013,Enero,Argentina,32,8,5,,13,"(7.128456,-73.183637)"
2013,Enero,Argentina,32,1,0,,1,"(7.818934,-72.453226)"
2013,Enero,Argentina,32,3,2,,5,"(7.927209,-72.507910)"
2013,Enero,Aruba,533,2608,1989,,4597,"(10.408582,-75.538003)"
2013,Enero,Aruba,533,7,8,,15,"(10.445761,-75.516429)"
2013,Enero,Aruba,533,13,5,,18,"(10.886611,-74.776708)"
2013,Enero,Aruba,533,144,132,,276,"(11.528919,-72.919681)"
2013,Enero,Aruba,533,25,16,,41,"(3.541112,-76.384584)"
2013,Enero,Aruba,533,157,129,,286,"(4.452882,-75.766298)"
2013,Enero,Aruba,533,1166,1015,,2181,"(4.697144,-74.140516)"
2013,Enero,Aruba,533,0,1,,1,"(4.815061,-75.736532)"
2013,Enero,Aruba,533,158,123,,281,"(6.171601,-75.427454)"
2013,Enero,Aruba,533,2,3,,5,"(7.128456,-73.183637)"
2013,Enero,Australia,36,4,3,,7,"(10.445761,-75.516429)"
2013,Enero,Australia,36,4,1,,5,"(10.886611,-74.776708)"
2013,Enero,Australia,36,47,32,,79,"(3.541112,-76.384584)"
2013,Enero,Australia,36,556,456,,1012,"(4.697144,-74.140516)"
2013,Enero,Australia,36,3,3,,6,"(4.815061,-75.736532)"
2013,Enero,Australia,36,69,61,,130,"(6.171601,-75.427454)"
2013,Enero,Australia,36,3,2,,5,"(7.128456,-73.183637)"
2013,Enero,Australia,36,0,1,,1,"(7.818934,-72.453226)"
2013,Enero,Australia,36,0,1,,1,"(7.927209,-72.507910)"
2013,Enero,Austria,40,2,1,,3,"(3.541112,-76.384584)"
2013,Enero,Austria,40,52,30,,82,"(4.697144,-74.140516)"
2013,Enero,Austria,40,0,1,,1,"(6.171601,-75.427454)"
2013,Enero,Azerbaiyán,31,7,9,,16,"(4.697144,-74.140516)"
2013,Enero,Azerbaiyán,31,0,1,,1,"(6.171601,-75.427454)"
2013,Enero,Bahamas,44,0,1,,1,"(10.445761,-75.516429)"
2013,Enero,Bahamas,44,9,7,,16,"(10.886611,-74.776708)"
2013,Enero,Bahamas,44,10,4,,14,"(3.541112,-76.384584)"
2013,Enero,Bahamas,44,40,45,,85,"(4.697144,-74.140516)"
2013,Enero,Bahamas,44,6,0,,6,"(4.815061,-75.736532)"
2013,Enero,Bahamas,44,32,23,,55,"(6.171601,-75.427454)"
2013,Enero,Bahamas,44,2,1,,3,"(7.128456,-73.183637)"
2013,Enero,Bahamas,44,3,3,,6,"(7.927209,-72.507910)"
2013,Enero,Bahréin,48,3,3,,6,"(4.697144,-74.140516)"
2013,Enero,Bahréin,48,0,2,,2,"(7.818934,-72.453226)"
2013,Enero,Bangladesh,50,0,6,,6,"(4.697144,-74.140516)"
2013,Enero,Barbados,52,2,12,,14,"(4.697144,-74.140516)"
2013,Enero,Barbados,52,1,1,,2,"(4.815061,-75.736532)"
2013,Enero,Barbados,52,0,2,,2,"(6.171601,-75.427454)"
2013,Enero,República de Belarús,112,4,7,,11,"(11.360009,-72.129330)"
2013,Enero,República de Belarús,112,1,1,,2,"(3.541112,-76.384584)"
2013,Enero,República de Belarús,112,1,2,,3,"(4.697144,-74.140516)"
2013,Enero,República de Belarús,112,1,1,,2,"(6.171601,-75.427454)"
2013,Enero,República de Belarús,112,5,3,,8,"(7.818934,-72.453226)"
2013,Enero,Bélgica,56,0,1,,1,"(10.445761,-75.516429)"
2013,Enero,Bélgica,56,10,8,,18,"(3.541112,-76.384584)"
2013,Enero,Bélgica,56,186,100,,286,"(4.697144,-74.140516)"
2013,Enero,Bélgica,56,0,1,,1,"(4.815061,-75.736532)"
2013,Enero,Bélgica,56,27,18,,45,"(6.171601,-75.427454)"
2013,Enero,Bélgica,56,1,1,,2,"(7.128456,-73.183637)"
2013,Enero,Belice,84,1,0,,1,"(3.541112,-76.384584)"
2013,Enero,Belice,84,5,11,,16,"(4.697144,-74.140516)"
2013,Enero,Benín,204,2,0,,2,"(4.697144,-74.140516)"
2013,Enero,Bolivia,68,5,9,,14,"(0.814836,-77.662532)"
2013,Enero,Bolivia,68,5,3,,8,"(10.445761,-75.516429)"
2013,Enero,Bolivia,68,2,6,,8,"(10.886611,-74.776708)"
2013,Enero,Bolivia,68,0,1,,1,"(12.586067,-81.702563)"
2013,Enero,Bolivia,68,8,28,,36,"(3.541112,-76.384584)"
2013,Enero,Bolivia,68,294,463,,757,"(4.697144,-74.140516)"
2013,Enero,Bolivia,68,0,1,,1,"(4.815061,-75.736532)"
2013,Enero,Bolivia,68,31,29,,60,"(6.171601,-75.427454)"
2013,Enero,Bolivia,68,1,0,,1,"(7.128456,-73.183637)"
2013,Enero,Bolivia,68,0,1,,1,"(7.927209,-72.507910)"
2013,Enero,Botsuana,72,1,1,,2,"(4.697144,-74.140516)"
2013,Enero,Brasil,76,106,145,,251,"(-4.197703,-69.941278)"
2013,Enero,Brasil,76,0,3,,3,"(0.814836,-77.662532)"
2013,Enero,Brasil,76,2,6,,8,"(10.445761,-75.516429)"
2013,Enero,Brasil,76,1,5,,6,"(10.886611,-74.776708)"
2013,Enero,Brasil,76,1,3,,4,"(12.586067,-81.702563)"
2013,Enero,Brasil,76,51,57,,108,"(3.541112,-76.384584)"
2013,Enero,Brasil,76,2602,3484,,6086,"(4.697144,-74.140516)"
2013,Enero,Brasil,76,1,0,,1,"(4.815061,-75.736532)"
2013,Enero,Brasil,76,61,74,,135,"(6.171601,-75.427454)"
2013,Enero,Brasil,76,1,3,,4,"(7.128456,-73.183637)"
2013,Enero,Brasil,76,2,1,,3,"(7.927209,-72.507910)"
2013,Enero,Brunei Darussalam,96,1,0,,1,"(6.171601,-75.427454)"
2013,Enero,Bulgaria,100,1,4,,5,"(4.697144,-74.140516)"
2013,Enero,Burkina Faso,854,0,1,,1,"(4.697144,-74.140516)"
2013,Enero,Cabo Verde,132,1,1,,2,"(0.814836,-77.662532)"
2013,Enero,Cabo Verde,132,1,0,,1,"(4.815061,-75.736532)"
2013,Enero,Islas Caimán/Territorio Británico de Ultramar,136,1,0,,1,"(10.445761,-75.516429)"
2013,Enero,Islas Caimán/Territorio Británico de Ultramar,136,37,35,,72,"(12.586067,-81.702563)"
2013,Enero,Islas Caimán/Territorio Británico de Ultramar,136,0,1,,1,"(4.697144,-74.140516)"
2013,Enero,Islas Caimán/Territorio Británico de Ultramar,136,1,0,,1,"(6.171601,-75.427454)"
2013,Enero,Camboya,116,0,1,,1,"(4.697144,-74.140516)"
2013,Enero,Camerún,120,0,1,,1,"(10.445761,-75.516429)"
2013,Enero,Camerún,120,0,2,,2,"(4.697144,-74.140516)"
2013,Enero,Canadá,124,288,226,,514,"(10.445761,-75.516429)"
2013,Enero,Canadá,124,37,34,,71,"(10.886611,-74.776708)"
2013,Enero,Canadá,124,15,13,,28,"(12.586067,-81.702563)"
2013,Enero,Canadá,124,177,151,,328,"(3.541112,-76.384584)"
2013,Enero,Canadá,124,15,21,,36,"(4.452882,-75.766298)"
2013,Enero,Canadá,124,2791,2622,,5413,"(4.697144,-74.140516)"
2013,Enero,Canadá,124,9,5,,14,"(4.815061,-75.736532)"
2013,Enero,Canadá,124,371,297,,668,"(6.171601,-75.427454)"
2013,Enero,Canadá,124,16,10,,26,"(7.128456,-73.183637)"
2013,Enero,Canadá,124,0,1,,1,"(7.927209,-72.507910)"
2013,Enero,Chad,148,0,1,,1,"(4.697144,-74.140516)"
2013,Enero,España,724,19,15,,34,"(10.445761,-75.516429)"
2013,Enero,España,724,2,0,,2,"(10.886611,-74.776708)"
2013,Enero,España,724,2304,1429,,3733,"(3.541112,-76.384584)"
2013,Enero,España,724,7887,5789,,13676,"(4.697144,-74.140516)"
2013,Enero,España,724,3,2,,5,"(4.815061,-75.736532)"
2013,Enero,España,724,823,577,,1400,"(6.171601,-75.427454)"
2013,Enero,España,724,3,2,,5,"(7.128456,-73.183637)"
2013,Enero,España,724,1,1,,2,"(7.818934,-72.453226)"
2013,Enero,República Democrática del Congo,180,2,3,,5,"(4.697144,-74.140516)"
2013,Enero,República Democrática del Congo,180,0,2,,2,"(6.171601,-75.427454)"
2013,Enero,República de Corea,410,10,17,,27,"(4.697144,-74.140516)"
2013,Enero,República de Corea,410,2,2,,4,"(6.171601,-75.427454)"
2013,Enero,Costa Rica,188,4,2,,6,"(10.408582,-75.538003)"
2013,Enero,Costa Rica,188,31,27,,58,"(10.445761,-75.516429)"
2013,Enero,Costa Rica,188,48,31,,79,"(10.886611,-74.776708)"
2013,Enero,Costa Rica,188,1,1,,2,"(11.247723,-74.213989)"
2013,Enero,Costa Rica,188,2,22,,24,"(12.5744111,-81.703935)"
2013,Enero,Costa Rica,188,5,14,,19,"(12.586067,-81.702563)"
2013,Enero,Costa Rica,188,99,101,,200,"(3.541112,-76.384584)"
2013,Enero,Costa Rica,188,1148,1231,,2379,"(4.697144,-74.140516)"
2013,Enero,Costa Rica,188,20,22,,42,"(4.815061,-75.736532)"
2013,Enero,Costa Rica,188,381,323,,704,"(6.171601,-75.427454)"
2013,Enero,Costa Rica,188,7,9,,16,"(7.128456,-73.183637)"
2013,Enero,Costa Rica,188,8,4,,12,"(7.927209,-72.507910)"
2013,Enero,Costa Rica,188,0,1,,1,"(8.635765,-77.346578)"
2013,Enero,Croacia,191,1,1,,2,"(4.697144,-74.140516)"
2013,Enero,Cuba,192,15,11,,26,"(10.445761,-75.516429)"
2013,Enero,Cuba,192,19,15,,34,"(10.886611,-74.776708)"
2013,Enero,Cuba,192,96,87,,183,"(3.541112,-76.384584)"
2013,Enero,Cuba,192,1098,980,,2078,"(4.697144,-74.140516)"
2013,Enero,Cuba,192,9,7,,16,"(4.815061,-75.736532)"
2013,Enero,Cuba,192,201,164,,365,"(6.171601,-75.427454)"
2013,Enero,Cuba,192,6,10,,16,"(7.128456,-73.183637)"
2013,Enero,Cuba,192,2,2,,4,"(7.927209,-72.507910)"
2013,Enero,Curazao,99999,2,0,,2,"(10.445761,-75.516429)"
2013,Enero,Curazao,99999,10,8,,18,"(3.541112,-76.384584)"
2013,Enero,Curazao,99999,701,721,,1422,"(4.697144,-74.140516)"
2013,Enero,Curazao,99999,175,124,,299,"(6.171601,-75.427454)"
2013,Enero,República Checa,203,8,8,,16,"(4.697144,-74.140516)"
2013,Enero,Chile,152,97,93,,190,"(0.814836,-77.662532)"
2013,Enero,Chile,152,18,21,,39,"(10.445761,-75.516429)"
2013,Enero,Chile,152,33,28,,61,"(10.886611,-74.776708)"
2013,Enero,Chile,152,1,2,,3,"(12.586067,-81.702563)"
2013,Enero,Chile,152,412,261,,673,"(3.541112,-76.384584)"
2013,Enero,Chile,152,3696,3297,,6993,"(4.697144,-74.140516)"
2013,Enero,Chile,152,14,11,,25,"(4.815061,-75.736532)"
2013,Enero,Chile,152,179,154,,333,"(6.171601,-75.427454)"
2013,Enero,Chile,152,6,2,,8,"(7.128456,-73.183637)"
2013,Enero,Chile,152,6,4,,10,"(7.927209,-72.507910)"
2013,Enero,China,156,1,1,,2,"(10.445761,-75.516429)"
2013,Enero,China,156,0,3,,3,"(10.886611,-74.776708)"
2013,Enero,China,156,3,6,,9,"(3.541112,-76.384584)"
2013,Enero,China,156,139,254,,393,"(4.697144,-74.140516)"
2013,Enero,China,156,0,3,,3,"(4.815061,-75.736532)"
2013,Enero,China,156,8,21,,29,"(6.171601,-75.427454)"
2013,Enero,Chipre,196,1,1,,2,"(4.697144,-74.140516)"
2013,Enero,Dinamarca,208,1,0,,1,"(10.445761,-75.516429)"
2013,Enero,Dinamarca,208,0,1,,1,"(3.541112,-76.384584)"
2013,Enero,Dinamarca,208,31,20,,51,"(4.697144,-74.140516)"
2013,Enero,Dinamarca,208,4,2,,6,"(6.171601,-75.427454)"
2013,Enero,Dominica,212,9,5,,14,"(0.814836,-77.662532)"
2013,Enero,Dominica,212,0,1,,1,"(3.541112,-76.384584)"
2013,Enero,Ecuador,218,810,791,,1601,"(0.25129,-76.875963)"
2013,Enero,Ecuador,218,16608,16786,,33394,"(0.814836,-77.662532)"
2013,Enero,Ecuador,218,204,211,,415,"(1.813928,-78.763924)"
2013,Enero,Ecuador,218,1,6,,7,"(10.445761,-75.516429)"
2013,Enero,Ecuador,218,7,8,,15,"(10.886611,-74.776708)"
2013,Enero,Ecuador,218,0,2,,2,"(12.586067,-81.702563)"
2013,Enero,Ecuador,218,1037,939,,1976,"(3.541112,-76.384584)"
2013,Enero,Ecuador,218,3094,4558,,7652,"(4.697144,-74.140516)"
2013,Enero,Ecuador,218,2,0,,2,"(4.815061,-75.736532)"
2013,Enero,Ecuador,218,505,485,,990,"(6.171601,-75.427454)"
2013,Enero,Ecuador,218,3,5,,8,"(7.128456,-73.183637)"
2013,Enero,Ecuador,218,2,3,,5,"(7.927209,-72.507910)"
2013,Enero,Egipto,818,4,2,,6,"(0.814836,-77.662532)"
2013,Enero,Egipto,818,1,0,,1,"(10.886611,-74.776708)"
2013,Enero,Egipto,818,1,0,,1,"(3.541112,-76.384584)"
2013,Enero,Egipto,818,29,20,,49,"(4.697144,-74.140516)"
2013,Enero,Egipto,818,0,1,,1,"(6.171601,-75.427454)"
2013,Enero,El Salvador,222,5,8,,13,"(10.445761,-75.516429)"
2013,Enero,El Salvador,222,3,3,,6,"(10.886611,-74.776708)"
2013,Enero,El Salvador,222,0,1,,1,"(12.586067,-81.702563)"
2013,Enero,El Salvador,222,57,72,,129,"(3.541112,-76.384584)"
2013,Enero,El Salvador,222,676,728,,1404,"(4.697144,-74.140516)"
2013,Enero,El Salvador,222,2,4,,6,"(4.815061,-75.736532)"
2013,Enero,El Salvador,222,74,89,,163,"(6.171601,-75.427454)"
2013,Enero,El Salvador,222,5,3,,8,"(7.128456,-73.183637)"
2013,Enero,Emiratos Árabes,784,15,6,,21,"(3.541112,-76.384584)"
2013,Enero,Emiratos Árabes,784,83,179,,262,"(4.697144,-74.140516)"
2013,Enero,Emiratos Árabes,784,6,4,,10,"(6.171601,-75.427454)"
2013,Enero,Eritrea,232,1,0,,1,"(4.697144,-74.140516)"
2013,Enero,Eslovaquia,703,1,1,,2,"(4.697144,-74.140516)"
2013,Enero,Eslovenia,705,3,4,,7,"(4.697144,-74.140516)"
2013,Enero,Estados Unidos de América,840,0,3,,3,"(10.408582,-75.538003)"
2013,Enero,Estados Unidos de América,840,2338,2071,,4409,"(10.445761,-75.516429)"
2013,Enero,Estados Unidos de América,840,2026,1622,,3648,"(10.886611,-74.776708)"
2013,Enero,Estados Unidos de América,840,96,71,,167,"(12.586067,-81.702563)"
2013,Enero,Estados Unidos de América,840,4930,3955,,8885,"(3.541112,-76.384584)"
2013,Enero,Estados Unidos de América,840,431,389,,820,"(4.452882,-75.766298)"
2013,Enero,Estados Unidos de América,840,31420,29297,,60717,"(4.697144,-74.140516)"
2013,Enero,Estados Unidos de América,840,449,379,,828,"(4.815061,-75.736532)"
2013,Enero,Estados Unidos de América,840,6835,6154,,12989,"(6.171601,-75.427454)"
2013,Enero,Estados Unidos de América,840,179,147,,326,"(7.128456,-73.183637)"
2013,Enero,Estados Unidos de América,840,71,55,,126,"(7.927209,-72.507910)"
2013,Enero,Estonia,233,0,1,,1,"(4.697144,-74.140516)"
2013,Enero,Etiopia,231,0,2,,2,"(4.697144,-74.140516)"
2013,Enero,Filipinas,608,0,1,,1,"(3.541112,-76.384584)"
2013,Enero,Filipinas,608,16,9,,25,"(4.697144,-74.140516)"
2013,Enero,Filipinas,608,1,0,,1,"(6.171601,-75.427454)"
2013,Enero,Finlandia,246,1,0,,1,"(10.445761,-75.516429)"
2013,Enero,Finlandia,246,0,3,,3,"(3.541112,-76.384584)"
2013,Enero,Finlandia,246,18,18,,36,"(4.697144,-74.140516)"
2013,Enero,Finlandia,246,1,0,,1,"(6.171601,-75.427454)"
2013,Enero,Francia,250,2,2,,4,"(10.445761,-75.516429)"
2013,Enero,Francia,250,76,52,,128,"(3.541112,-76.384584)"
2013,Enero,Francia,250,1443,1122,,2565,"(4.697144,-74.140516)"
2013,Enero,Francia,250,1,0,,1,"(4.815061,-75.736532)"
2013,Enero,Francia,250,56,32,,88,"(6.171601,-75.427454)"
2013,Enero,Gabón,266,2,3,,5,"(4.697144,-74.140516)"
2013,Enero,Georgia,268,3,1,,4,"(4.697144,-74.140516)"
2013,Enero,Ghana,288,2,5,,7,"(4.697144,-74.140516)"
2013,Enero,Granada,308,1,0,,1,"(4.697144,-74.140516)"
2013,Enero,Grecia,300,4,0,,4,"(4.697144,-74.140516)"
2013,Enero,Grecia,300,1,0,,1,"(6.171601,-75.427454)"
2013,Enero,Guatemala,320,6,9,,15,"(10.445761,-75.516429)"
2013,Enero,Guatemala,320,13,5,,18,"(10.886611,-74.776708)"
2013,Enero,Guatemala,320,2,2,,4,"(12.586067,-81.702563)"
2013,Enero,Guatemala,320,70,83,,153,"(3.541112,-76.384584)"
2013,Enero,Guatemala,320,273,342,,615,"(4.697144,-74.140516)"
2013,Enero,Guatemala,320,19,27,,46,"(4.815061,-75.736532)"
2013,Enero,Guatemala,320,135,135,,270,"(6.171601,-75.427454)"
2013,Enero,Guatemala,320,8,6,,14,"(7.128456,-73.183637)"
2013,Enero,Guatemala,320,1,4,,5,"(7.927209,-72.507910)"
2013,Enero,Guyana,328,5,5,,10,"(10.886611,-74.776708)"
2013,Enero,Guyana,328,1,0,,1,"(3.541112,-76.384584)"
2013,Enero,Guyana,328,1,1,,2,"(4.697144,-74.140516)"
2013,Enero,Guyana,328,0,1,,1,"(7.128456,-73.183637)"
2013,Enero,Guinea,324,1,1,,2,"(3.541112,-76.384584)"
2013,Enero,Guinea,324,0,6,,6,"(4.697144,-74.140516)"
2013,Enero,Guinea Ecuatorial,226,1,6,,7,"(3.541112,-76.384584)"
2013,Enero,Guinea Ecuatorial,226,2,22,,24,"(4.697144,-74.140516)"
2013,Enero,Guinea Bissau,624,0,1,,1,"(4.697144,-74.140516)"
2013,Enero,Haití,332,0,2,,2,"(10.445761,-75.516429)"
2013,Enero,Haití,332,2,5,,7,"(10.886611,-74.776708)"
2013,Enero,Haití,332,1,3,,4,"(3.541112,-76.384584)"
2013,Enero,Haití,332,6,8,,14,"(4.697144,-74.140516)"
2013,Enero,Haití,332,0,1,,1,"(4.815061,-75.736532)"
2013,Enero,Haití,332,2,9,,11,"(6.171601,-75.427454)"
2013,Enero,Haití,332,0,3,,3,"(7.128456,-73.183637)"
2013,Enero,Honduras,340,1,5,,6,"(10.445761,-75.516429)"
2013,Enero,Honduras,340,5,9,,14,"(10.886611,-74.776708)"
2013,Enero,Honduras,340,0,14,,14,"(12.586067,-81.702563)"
2013,Enero,Honduras,340,18,38,,56,"(3.541112,-76.384584)"
2013,Enero,Honduras,340,80,163,,243,"(4.697144,-74.140516)"
2013,Enero,Honduras,340,3,10,,13,"(4.815061,-75.736532)"
2013,Enero,Honduras,340,45,76,,121,"(6.171601,-75.427454)"
2013,Enero,Honduras,340,3,5,,8,"(7.128456,-73.183637)"
2013,Enero,Honduras,340,0,1,,1,"(7.927209,-72.507910)"
2013,Enero,Hong Kong,344,1,0,,1,"(3.541112,-76.384584)"
2013,Enero,Hong Kong,344,26,72,,98,"(4.697144,-74.140516)"
2013,Enero,Hong Kong,344,2,1,,3,"(6.171601,-75.427454)"
2013,Enero,Hungría,348,0,1,,1,"(10.445761,-75.516429)"
2013,Enero,Hungría,348,9,4,,13,"(4.697144,-74.140516)"
2013,Enero,Hungría,348,0,1,,1,"(6.171601,-75.427454)"
2013,Enero,India,356,0,1,,1,"(10.445761,-75.516429)"
2013,Enero,India,356,0,1,,1,"(3.541112,-76.384584)"
2013,Enero,India,356,55,42,,97,"(4.697144,-74.140516)"
2013,Enero,India,356,10,4,,14,"(6.171601,-75.427454)"
2013,Enero,Indonesia,360,11,12,,23,"(4.697144,-74.140516)"
2013,Enero,Indonesia,360,1,0,,1,"(6.171601,-75.427454)"
2013,Enero,Iraq,368,0,15,,15,"(4.697144,-74.140516)"
2013,Enero,Irán,364,1,6,,7,"(4.697144,-74.140516)"
2013,Enero,República de Irlanda,372,0,1,,1,"(10.886611,-74.776708)"
2013,Enero,República de Irlanda,372,1,0,,1,"(3.541112,-76.384584)"
2013,Enero,República de Irlanda,372,13,12,,25,"(4.697144,-74.140516)"
2013,Enero,Islandia,352,3,2,,5,"(4.697144,-74.140516)"
2013,Enero,Isla de Man,833,1,1,,2,"(3.541112,-76.384584)"
2013,Enero,Isla de Man,833,1,1,,2,"(4.697144,-74.140516)"
2013,Enero,Israel,376,5,1,,6,"(3.541112,-76.384584)"
2013,Enero,Israel,376,108,86,,194,"(4.697144,-74.140516)"
2013,Enero,Israel,376,4,0,,4,"(6.171601,-75.427454)"
2013,Enero,Islas Aland/Provincia de Finlandia,248,1,0,,1,"(3.541112,-76.384584)"
2013,Enero,Italia,380,36,3,,39,"(10.445761,-75.516429)"
2013,Enero,Italia,380,1,0,,1,"(10.886611,-74.776708)"
2013,Enero,Italia,380,131,49,,180,"(3.541112,-76.384584)"
2013,Enero,Italia,380,905,499,,1404,"(4.697144,-74.140516)"
2013,Enero,Italia,380,67,36,,103,"(6.171601,-75.427454)"
2013,Enero,Italia,380,1,1,,2,"(7.128456,-73.183637)"
2013,Enero,Jamaica,388,3,5,,8,"(10.445761,-75.516429)"
2013,Enero,Jamaica,388,3,8,,11,"(10.886611,-74.776708)"
2013,Enero,Jamaica,388,0,1,,1,"(12.5744111,-81.703935)"
2013,Enero,Jamaica,388,1,3,,4,"(12.586067,-81.702563)"
2013,Enero,Jamaica,388,11,12,,23,"(3.541112,-76.384584)"
2013,Enero,Jamaica,388,61,69,,130,"(4.697144,-74.140516)"
2013,Enero,Jamaica,388,2,3,,5,"(4.815061,-75.736532)"
2013,Enero,Jamaica,388,19,17,,36,"(6.171601,-75.427454)"
2013,Enero,Jamaica,388,3,5,,8,"(7.128456,-73.183637)"
2013,Enero,Jamaica,388,1,0,,1,"(7.927209,-72.507910)"
2013,Enero,Japón,392,1,1,,2,"(10.886611,-74.776708)"
2013,Enero,Japón,392,7,5,,12,"(3.541112,-76.384584)"
2013,Enero,Japón,392,48,52,,100,"(4.697144,-74.140516)"
2013,Enero,Japón,392,2,1,,3,"(6.171601,-75.427454)"
2013,Enero,Jordania,400,0,1,,1,"(10.445761,-75.516429)"
2013,Enero,Jordania,400,0,2,,2,"(4.697144,-74.140516)"
2013,Enero,Kazajistán,398,1,0,,1,"(10.445761,-75.516429)"
2013,Enero,Kazajistán,398,4,6,,10,"(4.697144,-74.140516)"
2013,Enero,Kenia,404,4,5,,9,"(4.697144,-74.140516)"
2013,Enero,Kuwait,414,6,10,,16,"(4.697144,-74.140516)"
2013,Enero,Lituania,440,1,1,,2,"(4.697144,-74.140516)"
2013,Enero,Líbano,422,15,12,,27,"(4.697144,-74.140516)"
2013,Enero,Liberia,430,0,1,,1,"(4.697144,-74.140516)"
2013,Enero,Liechtenstein,438,1,0,,1,"(4.697144,-74.140516)"
2013,Enero,Luxemburgo,442,4,8,,12,"(4.697144,-74.140516)"
2013,Enero,Luxemburgo,442,1,0,,1,"(6.171601,-75.427454)"
2013,Enero,Madagascar,450,1,0,,1,"(3.541112,-76.384584)"
2013,Enero,Malasia,458,7,10,,17,"(4.697144,-74.140516)"
2013,Enero,Malasia,458,2,2,,4,"(7.128456,-73.183637)"
2013,Enero,Malta,470,8,4,,12,"(4.697144,-74.140516)"
2013,Enero,Marruecos,504,0,1,,1,"(3.541112,-76.384584)"
2013,Enero,Marruecos,504,7,5,,12,"(4.697144,-74.140516)"
2013,Enero,Marruecos,504,1,2,,3,"(6.171601,-75.427454)"
2013,Enero,Mauritania,478,0,2,,2,"(4.697144,-74.140516)"
2013,Enero,Martinica/Departamento de Ultramar Francés,474,1,1,,2,"(4.697144,-74.140516)"
2013,Enero,Martinica/Departamento de Ultramar Francés,474,0,1,,1,"(6.171601,-75.427454)"
2013,Enero,México,484,103,56,,159,"(10.445761,-75.516429)"
2013,Enero,México,484,121,106,,227,"(10.886611,-74.776708)"
2013,Enero,México,484,0,2,,2,"(12.586067,-81.702563)"
2013,Enero,México,484,486,432,,918,"(3.541112,-76.384584)"
2013,Enero,México,484,8708,8040,,16748,"(4.697144,-74.140516)"
2013,Enero,México,484,158,109,,267,"(4.815061,-75.736532)"
2013,Enero,México,484,1476,1215,,2691,"(6.171601,-75.427454)"
2013,Enero,México,484,0,1,,1,"(6.228046,-77.404104)"
2013,Enero,México,484,105,96,,201,"(7.128456,-73.183637)"
2013,Enero,México,484,66,50,,116,"(7.927209,-72.507910)"
2013,Enero,Mónaco,492,1,1,,2,"(4.697144,-74.140516)"
2013,Enero,Montenegro,499,1,0,,1,"(4.697144,-74.140516)"
2013,Enero,Mozambique,508,7,7,,14,"(4.697144,-74.140516)"
2013,Enero,Myanmar,104,0,4,,4,"(4.697144,-74.140516)"
2013,Enero,Nicaragua,558,5,5,,10,"(10.445761,-75.516429)"
2013,Enero,Nicaragua,558,3,6,,9,"(10.886611,-74.776708)"
2013,Enero,Nicaragua,558,1,2,,3,"(12.586067,-81.702563)"
2013,Enero,Nicaragua,558,13,29,,42,"(3.541112,-76.384584)"
2013,Enero,Nicaragua,558,45,63,,108,"(4.697144,-74.140516)"
2013,Enero,Nicaragua,558,12,23,,35,"(6.171601,-75.427454)"
2013,Enero,Nicaragua,558,0,1,,1,"(7.128456,-73.183637)"
2013,Enero,Nicaragua,558,1,3,,4,"(7.927209,-72.507910)"
2013,Enero,Nigeria,566,4,32,,36,"(4.697144,-74.140516)"
2013,Enero,Níger,562,0,1,,1,"(4.697144,-74.140516)"
2013,Enero,Noruega,578,0,2,,2,"(10.445761,-75.516429)"
2013,Enero,Noruega,578,1,0,,1,"(10.886611,-74.776708)"
2013,Enero,Noruega,578,2,3,,5,"(3.541112,-76.384584)"
2013,Enero,Noruega,578,36,36,,72,"(4.697144,-74.140516)"
2013,Enero,Noruega,578,1,0,,1,"(4.815061,-75.736532)"
2013,Enero,Noruega,578,1,2,,3,"(6.171601,-75.427454)"
2013,Enero,Nueva Caledonia/Territorio francés,540,0,2,,2,"(4.697144,-74.140516)"
2013,Enero,Nueva Zelanda,554,1,1,,2,"(10.886611,-74.776708)"
2013,Enero,Nueva Zelanda,554,0,1,,1,"(3.541112,-76.384584)"
2013,Enero,Nueva Zelanda,554,37,24,,61,"(4.697144,-74.140516)"
2013,Enero,Nueva Zelanda,554,0,1,,1,"(4.815061,-75.736532)"
2013,Enero,Nueva Zelanda,554,4,6,,10,"(6.171601,-75.427454)"
2013,Enero,Omán,512,4,5,,9,"(4.697144,-74.140516)"
2013,Enero,Papúa Nueva Guinea,598,0,3,,3,"(3.541112,-76.384584)"
2013,Enero,Papúa Nueva Guinea,598,1,11,,12,"(4.697144,-74.140516)"
2013,Enero,Papúa Nueva Guinea,598,0,1,,1,"(6.171601,-75.427454)"
2013,Enero,Pakistán,586,0,1,,1,"(10.445761,-75.516429)"
2013,Enero,Pakistán,586,0,5,,5,"(4.697144,-74.140516)"
2013,Enero,Panamá,591,81,111,,192,"(10.408582,-75.538003)"
2013,Enero,Panamá,591,550,550,,1100,"(10.445761,-75.516429)"
2013,Enero,Panamá,591,1201,1152,,2353,"(10.886611,-74.776708)"
2013,Enero,Panamá,591,0,2,,2,"(11.247723,-74.213989)"
2013,Enero,Panamá,591,1,3,,4,"(12.5744111,-81.703935)"
2013,Enero,Panamá,591,85,89,,174,"(12.586067,-81.702563)"
2013,Enero,Panamá,591,0,10,,10,"(13.3387613,-81.372937)"
2013,Enero,Panamá,591,2472,2272,,4744,"(3.541112,-76.384584)"
2013,Enero,Panamá,591,0,1,,1,"(3.893038,-77.067921)"
2013,Enero,Panamá,591,8313,8723,,17036,"(4.697144,-74.140516)"
2013,Enero,Panamá,591,662,507,,1169,"(4.815061,-75.736532)"
2013,Enero,Panamá,591,2693,2790,,5483,"(6.171601,-75.427454)"
2013,Enero,Panamá,591,8,8,,16,"(6.228046,-77.404104)"
2013,Enero,Panamá,591,200,205,,405,"(7.128456,-73.183637)"
2013,Enero,Panamá,591,176,161,,337,"(7.927209,-72.507910)"
2013,Enero,Panamá,591,1,49,,50,"(8.066966,-76.735404)"
2013,Enero,Panamá,591,103,231,,334,"(8.635765,-77.346578)"
2013,Enero,Paraguay,600,1,2,,3,"(10.445761,-75.516429)"
2013,Enero,Paraguay,600,1,1,,2,"(10.886611,-74.776708)"
2013,Enero,Paraguay,600,0,1,,1,"(12.586067,-81.702563)"
2013,Enero,Paraguay,600,10,19,,29,"(3.541112,-76.384584)"
2013,Enero,Paraguay,600,29,78,,107,"(4.697144,-74.140516)"
2013,Enero,Paraguay,600,1,2,,3,"(4.815061,-75.736532)"
2013,Enero,Paraguay,600,8,10,,18,"(6.171601,-75.427454)"
2013,Enero,Paraguay,600,0,1,,1,"(7.128456,-73.183637)"
2013,Enero,Perú,604,98,157,,255,"(-4.197703,-69.941278)"
2013,Enero,Perú,604,44,72,,116,"(0.814836,-77.662532)"
2013,Enero,Perú,604,19,12,,31,"(10.445761,-75.516429)"
2013,Enero,Perú,604,30,19,,49,"(10.886611,-74.776708)"
2013,Enero,Perú,604,265,222,,487,"(3.541112,-76.384584)"
2013,Enero,Perú,604,4351,5129,,9480,"(4.697144,-74.140516)"
2013,Enero,Perú,604,12,4,,16,"(4.815061,-75.736532)"
2013,Enero,Perú,604,380,464,,844,"(6.171601,-75.427454)"
2013,Enero,Perú,604,10,7,,17,"(7.128456,-73.183637)"
2013,Enero,Perú,604,1,1,,2,"(7.927209,-72.507910)"
2013,Enero,Palestina,99999,1,0,,1,"(4.697144,-74.140516)"
2013,Enero,Polonia,616,1,0,,1,"(3.541112,-76.384584)"
2013,Enero,Polonia,616,11,22,,33,"(4.697144,-74.140516)"
2013,Enero,Portugal,620,2,2,,4,"(3.541112,-76.384584)"
2013,Enero,Portugal,620,30,21,,51,"(4.697144,-74.140516)"
2013,Enero,Portugal,620,5,4,,9,"(6.171601,-75.427454)"
2013,Enero,Puerto Rico/Territorio de Estados Unidos,630,20,21,,41,"(10.445761,-75.516429)"
2013,Enero,Puerto Rico/Territorio de Estados Unidos,630,34,23,,57,"(10.886611,-74.776708)"
2013,Enero,Puerto Rico/Territorio de Estados Unidos,630,3,3,,6,"(12.586067,-81.702563)"
2013,Enero,Puerto Rico/Territorio de Estados Unidos,630,102,65,,167,"(3.541112,-76.384584)"
2013,Enero,Puerto Rico/Territorio de Estados Unidos,630,153,189,,342,"(4.697144,-74.140516)"
2013,Enero,Puerto Rico/Territorio de Estados Unidos,630,19,15,,34,"(4.815061,-75.736532)"
2013,Enero,Puerto Rico/Territorio de Estados Unidos,630,83,81,,164,"(6.171601,-75.427454)"
2013,Enero,Puerto Rico/Territorio de Estados Unidos,630,0,1,,1,"(6.185799,-67.483929)"
2013,Enero,Puerto Rico/Territorio de Estados Unidos,630,19,18,,37,"(7.128456,-73.183637)"
2013,Enero,Puerto Rico/Territorio de Estados Unidos,630,5,1,,6,"(7.927209,-72.507910)"
2013,Enero,Qatar,634,1,0,,1,"(10.445761,-75.516429)"
2013,Enero,Qatar,634,10,11,,21,"(4.697144,-74.140516)"
2013,Enero,Qatar,634,2,1,,3,"(6.171601,-75.427454)"
2013,Enero,Reino Unido de Gran Bretaña e Irlanda del Norte,826,8,3,,11,"(10.445761,-75.516429)"
2013,Enero,Reino Unido de Gran Bretaña e Irlanda del Norte,826,2,2,,4,"(10.886611,-74.776708)"
2013,Enero,Reino Unido de Gran Bretaña e Irlanda del Norte,826,141,134,,275,"(3.541112,-76.384584)"
2013,Enero,Reino Unido de Gran Bretaña e Irlanda del Norte,826,1528,1151,,2679,"(4.697144,-74.140516)"
2013,Enero,Reino Unido de Gran Bretaña e Irlanda del Norte,826,104,63,,167,"(6.171601,-75.427454)"
2013,Enero,Reino Unido de Gran Bretaña e Irlanda del Norte,826,2,3,,5,"(7.128456,-73.183637)"
2013,Enero,Federación de Rusia,643,15,39,,54,"(4.697144,-74.140516)"
2013,Enero,Federación de Rusia,643,2,0,,2,"(6.171601,-75.427454)"
2013,Enero,República Dominicana,214,23,31,,54,"(10.445761,-75.516429)"
2013,Enero,República Dominicana,214,37,34,,71,"(10.886611,-74.776708)"
2013,Enero,República Dominicana,214,79,74,,153,"(3.541112,-76.384584)"
2013,Enero,República Dominicana,214,1769,1648,,3417,"(4.697144,-74.140516)"
2013,Enero,República Dominicana,214,37,33,,70,"(4.815061,-75.736532)"
2013,Enero,República Dominicana,214,218,216,,434,"(6.171601,-75.427454)"
2013,Enero,República Dominicana,214,3,5,,8,"(7.128456,-73.183637)"
2013,Enero,Rumania,642,11,5,,16,"(4.697144,-74.140516)"
2013,Enero,Rwanda,646,0,3,,3,"(4.697144,-74.140516)"
2013,Enero,Senegal,686,4,3,,7,"(4.697144,-74.140516)"
2013,Enero,Singapur,702,1,0,,1,"(3.541112,-76.384584)"
2013,Enero,Singapur,702,21,20,,41,"(4.697144,-74.140516)"
2013,Enero,Sri Lanka,144,0,1,,1,"(3.541112,-76.384584)"
2013,Enero,Sri Lanka,144,0,1,,1,"(4.697144,-74.140516)"
2013,Enero,Sudáfrica,710,2,3,,5,"(3.541112,-76.384584)"
2013,Enero,Sudáfrica,710,29,32,,61,"(4.697144,-74.140516)"
2013,Enero,Suecia,752,1,0,,1,"(10.445761,-75.516429)"
2013,Enero,Suecia,752,1,0,,1,"(10.886611,-74.776708)"
2013,Enero,Suecia,752,15,15,,30,"(3.541112,-76.384584)"
2013,Enero,Suecia,752,193,158,,351,"(4.697144,-74.140516)"
2013,Enero,Suecia,752,2,1,,3,"(4.815061,-75.736532)"
2013,Enero,Suecia,752,11,7,,18,"(6.171601,-75.427454)"
2013,Enero,Suecia,752,0,1,,1,"(7.128456,-73.183637)"
2013,Enero,Suiza,756,1,2,,3,"(10.445761,-75.516429)"
2013,Enero,Suiza,756,54,36,,90,"(3.541112,-76.384584)"
2013,Enero,Suiza,756,460,282,,742,"(4.697144,-74.140516)"
2013,Enero,Suiza,756,13,10,,23,"(6.171601,-75.427454)"
2013,Enero,Surinam,740,0,1,,1,"(10.408582,-75.538003)"
2013,Enero,Surinam,740,6,4,,10,"(4.697144,-74.140516)"
2013,Enero,Surinam,740,1,0,,1,"(6.171601,-75.427454)"
2013,Enero,Taiwán,158,1,6,,7,"(4.697144,-74.140516)"
2013,Enero,Taiwán,158,2,1,,3,"(6.171601,-75.427454)"
2013,Enero,Tailandia,764,1,0,,1,"(3.541112,-76.384584)"
2013,Enero,Tailandia,764,3,6,,9,"(4.697144,-74.140516)"
2013,Enero,Tailandia,764,1,0,,1,"(6.171601,-75.427454)"
2013,Enero,Trinidad y Tobago,780,7,9,,16,"(10.445761,-75.516429)"
2013,Enero,Trinidad y Tobago,780,7,3,,10,"(10.886611,-74.776708)"
2013,Enero,Trinidad y Tobago,780,1,6,,7,"(11.247723,-74.213989)"
2013,Enero,Trinidad y Tobago,780,9,29,,38,"(3.541112,-76.384584)"
2013,Enero,Trinidad y Tobago,780,52,55,,107,"(4.697144,-74.140516)"
2013,Enero,Trinidad y Tobago,780,1,3,,4,"(4.815061,-75.736532)"
2013,Enero,Trinidad y Tobago,780,14,7,,21,"(6.171601,-75.427454)"
2013,Enero,Trinidad y Tobago,780,1,3,,4,"(7.128456,-73.183637)"
2013,Enero,Trinidad y Tobago,780,1,0,,1,"(7.927209,-72.507910)"
2013,Enero,Túnez,788,3,2,,5,"(4.697144,-74.140516)"
2013,Enero,Túnez,788,1,0,,1,"(7.818934,-72.453226)"
2013,Enero,Turquía,792,18,17,,35,"(4.697144,-74.140516)"
2013,Enero,Turquía,792,0,2,,2,"(6.171601,-75.427454)"
2013,Enero,Ucrania,804,0,1,,1,"(4.697144,-74.140516)"
2013,Enero,Uganda,800,0,1,,1,"(10.445761,-75.516429)"
2013,Enero,Uganda,800,1,0,,1,"(4.697144,-74.140516)"
2013,Enero,Uruguay,858,4,0,,4,"(10.445761,-75.516429)"
2013,Enero,Uruguay,858,2,0,,2,"(10.886611,-74.776708)"
2013,Enero,Uruguay,858,23,11,,34,"(3.541112,-76.384584)"
2013,Enero,Uruguay,858,51,82,,133,"(4.697144,-74.140516)"
2013,Enero,Uruguay,858,21,37,,58,"(6.171601,-75.427454)"
2013,Enero,Vanuatu,548,2,6,,8,"(7.818934,-72.453226)"
2013,Enero,Venezuela,862,15,17,,32,"(10.445761,-75.516429)"
2013,Enero,Venezuela,862,22,26,,48,"(10.886611,-74.776708)"
2013,Enero,Venezuela,862,0,1,,1,"(10.971302,-74.765397)"
2013,Enero,Venezuela,862,16557,13516,,30073,"(11.360009,-72.129330)"
2013,Enero,Venezuela,862,29,25,,54,"(3.541112,-76.384584)"
2013,Enero,Venezuela,862,3160,3353,,6513,"(4.697144,-74.140516)"
2013,Enero,Venezuela,862,5,6,,11,"(4.815061,-75.736532)"
2013,Enero,Venezuela,862,446,471,,917,"(6.171601,-75.427454)"
2013,Enero,Venezuela,862,479,569,,1048,"(6.185799,-67.483929)"
2013,Enero,Venezuela,862,2116,2100,,4216,"(7.088729,-70.740253)"
2013,Enero,Venezuela,862,108,94,,202,"(7.128456,-73.183637)"
2013,Enero,Venezuela,862,18173,17922,,36095,"(7.818934,-72.453226)"
2013,Enero,Venezuela,862,0,1,,1,"(7.927209,-72.507910)"
2013,Enero,Vietnam,704,5,3,,8,"(4.697144,-74.140516)"
2013,Enero,Vietnam,704,0,1,,1,"(7.818934,-72.453226)"
2013,Enero,República Árabe de Yemen,887,0,2,,2,"(4.697144,-74.140516)"
2013,Enero,Desconocido,99999,2,2,,4,"(3.541112,-76.384584)"
2013,Enero,Desconocido,99999,18,31,,49,"(4.697144,-74.140516)"
2013,Enero,Desconocido,99999,0,3,,3,"(6.171601,-75.427454)"
2013,Febrero,Afganistán,4,1,0,,1,"(10.408582,-75.538003)"
2013,Febrero,Afganistán,4,4,43,,47,"(4.697144,-74.140516)"
2013,Febrero,Alemania,276,0,1,,1,"(0.814836,-77.662532)"
2013,Febrero,Alemania,276,0,2,,2,"(10.886611,-74.776708)"
2013,Febrero,Alemania,276,21,19,,40,"(3.541112,-76.384584)"
2013,Febrero,Alemania,276,710,682,,1392,"(4.697144,-74.140516)"
2013,Febrero,Alemania,276,11,11,,22,"(6.171601,-75.427454)"
2013,Febrero,Alemania,276,1,0,,1,"(7.128456,-73.183637)"
2013,Febrero,Andorra,20,1,1,,2,"(4.697144,-74.140516)"
2013,Febrero,Andorra,20,0,1,,1,"(6.171601,-75.427454)"
2013,Febrero,Angola,24,2,9,,11,"(4.697144,-74.140516)"
2013,Febrero,Angola,24,0,1,,1,"(6.171601,-75.427454)"
2013,Febrero,Antigua y Barbuda,28,0,4,,4,"(4.697144,-74.140516)"
2013,Febrero,Países Bajos,528,225,143,,368,"(10.408582,-75.538003)"
2013,Febrero,Países Bajos,528,1,1,,2,"(10.886611,-74.776708)"
2013,Febrero,Países Bajos,528,0,6,,6,"(12.586067,-81.702563)"
2013,Febrero,Países Bajos,528,23,14,,37,"(3.541112,-76.384584)"
2013,Febrero,Países Bajos,528,135,100,,235,"(4.697144,-74.140516)"
2013,Febrero,Países Bajos,528,2,1,,3,"(4.815061,-75.736532)"
2013,Febrero,Países Bajos,528,25,13,,38,"(6.171601,-75.427454)"
2013,Febrero,Países Bajos,528,6,6,,12,"(7.128456,-73.183637)"
2013,Febrero,Países Bajos,528,0,1,,1,"(7.927209,-72.507910)"
2013,Febrero,Arabia Saudita,682,0,1,,1,"(10.445761,-75.516429)"
2013,Febrero,Arabia Saudita,682,1,1,,2,"(3.541112,-76.384584)"
2013,Febrero,Arabia Saudita,682,1,0,,1,"(4.452882,-75.766298)"
2013,Febrero,Arabia Saudita,682,9,14,,23,"(4.697144,-74.140516)"
2013,Febrero,Arabia Saudita,682,0,1,,1,"(6.171601,-75.427454)"
2013,Febrero,Argelia,12,1,0,,1,"(3.541112,-76.384584)"
2013,Febrero,Argelia,12,3,3,,6,"(4.697144,-74.140516)"
2013,Febrero,Argelia,12,1,0,,1,"(6.171601,-75.427454)"
2013,Febrero,Argentina,32,7,32,,39,"(0.814836,-77.662532)"
2013,Febrero,Argentina,32,7,5,,12,"(10.445761,-75.516429)"
2013,Febrero,Argentina,32,6,4,,10,"(10.886611,-74.776708)"
2013,Febrero,Argentina,32,1,0,,1,"(11.360009,-72.129330)"
2013,Febrero,Argentina,32,115,130,,245,"(3.541112,-76.384584)"
2013,Febrero,Argentina,32,2809,2777,,5586,"(4.697144,-74.140516)"
2013,Febrero,Argentina,32,8,9,,17,"(4.815061,-75.736532)"
2013,Febrero,Argentina,32,110,126,,236,"(6.171601,-75.427454)"
2013,Febrero,Aruba,533,1914,1266,,3180,"(10.408582,-75.538003)"
2013,Febrero,Aruba,533,15,20,,35,"(10.886611,-74.776708)"
2013,Febrero,Aruba,533,53,39,,92,"(11.528919,-72.919681)"
2013,Febrero,Aruba,533,16,9,,25,"(3.541112,-76.384584)"
2013,Febrero,Aruba,533,54,44,,98,"(4.452882,-75.766298)"
2013,Febrero,Aruba,533,535,542,,1077,"(4.697144,-74.140516)"
2013,Febrero,Aruba,533,47,22,,69,"(6.171601,-75.427454)"
2013,Febrero,Aruba,533,4,4,,8,"(7.128456,-73.183637)"
2013,Febrero,Australia,36,2,3,,5,"(10.445761,-75.516429)"
2013,Febrero,Australia,36,6,2,,8,"(10.886611,-74.776708)"
2013,Febrero,Australia,36,16,6,,22,"(3.541112,-76.384584)"
2013,Febrero,Australia,36,320,257,,577,"(4.697144,-74.140516)"
2013,Febrero,Australia,36,1,1,,2,"(4.815061,-75.736532)"
2013,Febrero,Australia,36,40,31,,71,"(6.171601,-75.427454)"
2013,Febrero,Australia,36,2,0,,2,"(7.128456,-73.183637)"
2013,Febrero,Austria,40,33,23,,56,"(4.697144,-74.140516)"
2013,Febrero,Austria,40,1,1,,2,"(6.171601,-75.427454)"
2013,Febrero,Azerbaiyán,31,1,3,,4,"(4.697144,-74.140516)"
2013,Febrero,Bahamas,44,1,0,,1,"(10.445761,-75.516429)"
2013,Febrero,Bahamas,44,4,3,,7,"(10.886611,-74.776708)"
2013,Febrero,Bahamas,44,16,9,,25,"(3.541112,-76.384584)"
2013,Febrero,Bahamas,44,20,23,,43,"(4.697144,-74.140516)"
2013,Febrero,Bahamas,44,10,6,,16,"(6.171601,-75.427454)"
2013,Febrero,Bahamas,44,3,2,,5,"(7.128456,-73.183637)"
2013,Febrero,Bahréin,48,2,4,,6,"(4.697144,-74.140516)"
2013,Febrero,Bahréin,48,1,0,,1,"(6.171601,-75.427454)"
2013,Febrero,Bangladesh,50,1,2,,3,"(4.697144,-74.140516)"
2013,Febrero,Barbados,52,2,21,,23,"(4.697144,-74.140516)"
2013,Febrero,Barbados,52,0,2,,2,"(6.171601,-75.427454)"
2013,Febrero,República de Belarús,112,5,4,,9,"(11.360009,-72.129330)"
2013,Febrero,República de Belarús,112,1,2,,3,"(4.697144,-74.140516)"
2013,Febrero,República de Belarús,112,1,0,,1,"(7.088729,-70.740253)"
2013,Febrero,Bélgica,56,4,5,,9,"(3.541112,-76.384584)"
2013,Febrero,Bélgica,56,51,44,,95,"(4.697144,-74.140516)"
2013,Febrero,Bélgica,56,7,4,,11,"(6.171601,-75.427454)"
2013,Febrero,Belice,84,0,1,,1,"(3.541112,-76.384584)"
2013,Febrero,Belice,84,3,5,,8,"(4.697144,-74.140516)"
2013,Febrero,Benín,204,1,3,,4,"(4.697144,-74.140516)"
2013,Febrero,Bermudas/Territorio Británico de Ultramar,60,1,0,,1,"(10.445761,-75.516429)"
2013,Febrero,Bolivia,68,1,5,,6,"(0.814836,-77.662532)"
2013,Febrero,Bolivia,68,1,1,,2,"(10.445761,-75.516429)"
2013,Febrero,Bolivia,68,1,5,,6,"(10.886611,-74.776708)"
2013,Febrero,Bolivia,68,17,23,,40,"(3.541112,-76.384584)"
2013,Febrero,Bolivia,68,215,309,,524,"(4.697144,-74.140516)"
2013,Febrero,Bolivia,68,0,1,,1,"(4.815061,-75.736532)"
2013,Febrero,Bolivia,68,21,30,,51,"(6.171601,-75.427454)"
2013,Febrero,Brasil,76,6,5,,11,"(-4.197703,-69.941278)"
2013,Febrero,Brasil,76,1,1,,2,"(0.814836,-77.662532)"
2013,Febrero,Brasil,76,0,2,,2,"(10.408582,-75.538003)"
2013,Febrero,Brasil,76,1,5,,6,"(10.445761,-75.516429)"
2013,Febrero,Brasil,76,1,2,,3,"(10.886611,-74.776708)"
2013,Febrero,Brasil,76,2,0,,2,"(12.586067,-81.702563)"
2013,Febrero,Brasil,76,33,59,,92,"(3.541112,-76.384584)"
2013,Febrero,Brasil,76,1972,2761,,4733,"(4.697144,-74.140516)"
2013,Febrero,Brasil,76,1,11,,12,"(4.815061,-75.736532)"
2013,Febrero,Brasil,76,50,85,,135,"(6.171601,-75.427454)"
2013,Febrero,Brasil,76,1,2,,3,"(7.128456,-73.183637)"
2013,Febrero,Brasil,76,0,1,,1,"(7.927209,-72.507910)"
2013,Febrero,Bulgaria,100,2,1,,3,"(4.697144,-74.140516)"
2013,Febrero,Burkina Faso,854,1,1,,2,"(4.697144,-74.140516)"
2013,Febrero,Cabo Verde,132,1,0,,1,"(0.814836,-77.662532)"
2013,Febrero,Cabo Verde,132,1,0,,1,"(6.171601,-75.427454)"
2013,Febrero,Islas Caimán/Territorio Británico de Ultramar,136,0,1,,1,"(10.408582,-75.538003)"
2013,Febrero,Islas Caimán/Territorio Británico de Ultramar,136,2,1,,3,"(10.445761,-75.516429)"
2013,Febrero,Islas Caimán/Territorio Británico de Ultramar,136,0,1,,1,"(3.541112,-76.384584)"
2013,Febrero,Islas Caimán/Territorio Británico de Ultramar,136,2,2,,4,"(4.697144,-74.140516)"
2013,Febrero,Islas Caimán/Territorio Británico de Ultramar,136,1,0,,1,"(6.171601,-75.427454)"
2013,Febrero,Camerún,120,0,3,,3,"(4.697144,-74.140516)"
2013,Febrero,Canadá,124,94,78,,172,"(10.445761,-75.516429)"
2013,Febrero,Canadá,124,8,6,,14,"(10.886611,-74.776708)"
2013,Febrero,Canadá,124,7,5,,12,"(12.586067,-81.702563)"
2013,Febrero,Canadá,124,56,39,,95,"(3.541112,-76.384584)"
2013,Febrero,Canadá,124,6,8,,14,"(4.452882,-75.766298)"
2013,Febrero,Canadá,124,957,988,,1945,"(4.697144,-74.140516)"
2013,Febrero,Canadá,124,2,3,,5,"(4.815061,-75.736532)"
2013,Febrero,Canadá,124,106,86,,192,"(6.171601,-75.427454)"
2013,Febrero,Canadá,124,4,2,,6,"(7.128456,-73.183637)"
2013,Febrero,Canadá,124,0,1,,1,"(7.927209,-72.507910)"
2013,Febrero,España,724,0,1,,1,"(10.445761,-75.516429)"
2013,Febrero,España,724,1852,1179,,3031,"(3.541112,-76.384584)"
2013,Febrero,España,724,5502,3977,,9479,"(4.697144,-74.140516)"
2013,Febrero,España,724,2,3,,5,"(4.815061,-75.736532)"
2013,Febrero,España,724,752,498,,1250,"(6.171601,-75.427454)"
2013,Febrero,República Democrática del Congo,180,0,6,,6,"(4.697144,-74.140516)"
2013,Febrero,República Democrática del Congo,180,1,0,,1,"(6.171601,-75.427454)"
2013,Febrero,República de Corea,410,18,23,,41,"(4.697144,-74.140516)"
2013,Febrero,República de Corea,410,3,0,,3,"(6.171601,-75.427454)"
2013,Febrero,Costa de Marfil,384,1,1,,2,"(4.697144,-74.140516)"
2013,Febrero,Costa Rica,188,19,25,,44,"(10.445761,-75.516429)"
2013,Febrero,Costa Rica,188,20,26,,46,"(10.886611,-74.776708)"
2013,Febrero,Costa Rica,188,5,3,,8,"(12.586067,-81.702563)"
2013,Febrero,Costa Rica,188,49,62,,111,"(3.541112,-76.384584)"
2013,Febrero,Costa Rica,188,707,894,,1601,"(4.697144,-74.140516)"
2013,Febrero,Costa Rica,188,12,11,,23,"(4.815061,-75.736532)"
2013,Febrero,Costa Rica,188,159,141,,300,"(6.171601,-75.427454)"
2013,Febrero,Costa Rica,188,8,2,,10,"(7.128456,-73.183637)"
2013,Febrero,Croacia,191,1,0,,1,"(3.541112,-76.384584)"
2013,Febrero,Croacia,191,2,3,,5,"(4.697144,-74.140516)"
2013,Febrero,Cuba,192,5,8,,13,"(10.445761,-75.516429)"
2013,Febrero,Cuba,192,15,10,,25,"(10.886611,-74.776708)"
2013,Febrero,Cuba,192,0,3,,3,"(12.586067,-81.702563)"
2013,Febrero,Cuba,192,58,51,,109,"(3.541112,-76.384584)"
2013,Febrero,Cuba,192,485,456,,941,"(4.697144,-74.140516)"
2013,Febrero,Cuba,192,7,7,,14,"(4.815061,-75.736532)"
2013,Febrero,Cuba,192,75,71,,146,"(6.171601,-75.427454)"
2013,Febrero,Cuba,192,8,11,,19,"(7.128456,-73.183637)"
2013,Febrero,Cuba,192,0,1,,1,"(7.927209,-72.507910)"
2013,Febrero,Curazao,99999,3,6,,9,"(10.886611,-74.776708)"
2013,Febrero,Curazao,99999,1,0,,1,"(12.586067,-81.702563)"
2013,Febrero,Curazao,99999,12,5,,17,"(3.541112,-76.384584)"
2013,Febrero,Curazao,99999,440,490,,930,"(4.697144,-74.140516)"
2013,Febrero,Curazao,99999,58,54,,112,"(6.171601,-75.427454)"
2013,Febrero,Curazao,99999,1,0,,1,"(7.927209,-72.507910)"
2013,Febrero,República Checa,203,2,1,,3,"(3.541112,-76.384584)"
2013,Febrero,República Checa,203,5,9,,14,"(4.697144,-74.140516)"
2013,Febrero,Chile,152,67,68,,135,"(0.814836,-77.662532)"
2013,Febrero,Chile,152,7,10,,17,"(10.445761,-75.516429)"
2013,Febrero,Chile,152,9,16,,25,"(10.886611,-74.776708)"
2013,Febrero,Chile,152,299,174,,473,"(3.541112,-76.384584)"
2013,Febrero,Chile,152,1967,1734,,3701,"(4.697144,-74.140516)"
2013,Febrero,Chile,152,10,5,,15,"(4.815061,-75.736532)"
2013,Febrero,Chile,152,119,94,,213,"(6.171601,-75.427454)"
2013,Febrero,Chile,152,3,0,,3,"(7.128456,-73.183637)"
2013,Febrero,China,156,1,1,,2,"(10.445761,-75.516429)"
2013,Febrero,China,156,1,2,,3,"(10.886611,-74.776708)"
2013,Febrero,China,156,4,8,,12,"(3.541112,-76.384584)"
2013,Febrero,China,156,193,419,,612,"(4.697144,-74.140516)"
2013,Febrero,China,156,9,14,,23,"(6.171601,-75.427454)"
2013,Febrero,Chipre,196,0,2,,2,"(4.697144,-74.140516)"
2013,Febrero,Dinamarca,208,1,0,,1,"(10.445761,-75.516429)"
2013,Febrero,Dinamarca,208,17,7,,24,"(4.697144,-74.140516)"
2013,Febrero,Dominica,212,1,0,,1,"(3.541112,-76.384584)"
2013,Febrero,Dominica,212,0,1,,1,"(4.697144,-74.140516)"
2013,Febrero,Ecuador,218,5140,6213,,11353,"(0.814836,-77.662532)"
2013,Febrero,Ecuador,218,115,155,,270,"(1.813928,-78.763924)"
2013,Febrero,Ecuador,218,4,3,,7,"(10.445761,-75.516429)"
2013,Febrero,Ecuador,218,7,4,,11,"(10.886611,-74.776708)"
2013,Febrero,Ecuador,218,3,6,,9,"(12.586067,-81.702563)"
2013,Febrero,Ecuador,218,429,516,,945,"(3.541112,-76.384584)"
2013,Febrero,Ecuador,218,2,8,,10,"(4.452882,-75.766298)"
2013,Febrero,Ecuador,218,1866,3536,,5402,"(4.697144,-74.140516)"
2013,Febrero,Ecuador,218,1,6,,7,"(4.815061,-75.736532)"
2013,Febrero,Ecuador,218,312,448,,760,"(6.171601,-75.427454)"
2013,Febrero,Ecuador,218,1,4,,5,"(7.128456,-73.183637)"
2013,Febrero,Ecuador,218,0,5,,5,"(7.927209,-72.507910)"
2013,Febrero,Egipto,818,42,21,,63,"(4.697144,-74.140516)"
2013,Febrero,El Salvador,222,0,2,,2,"(10.445761,-75.516429)"
2013,Febrero,El Salvador,222,1,1,,2,"(10.886611,-74.776708)"
2013,Febrero,El Salvador,222,44,49,,93,"(3.541112,-76.384584)"
2013,Febrero,El Salvador,222,534,610,,1144,"(4.697144,-74.140516)"
2013,Febrero,El Salvador,222,1,3,,4,"(4.815061,-75.736532)"
2013,Febrero,El Salvador,222,42,74,,116,"(6.171601,-75.427454)"
2013,Febrero,Emiratos Árabes,784,7,3,,10,"(3.541112,-76.384584)"
2013,Febrero,Emiratos Árabes,784,60,94,,154,"(4.697144,-74.140516)"
2013,Febrero,Emiratos Árabes,784,5,1,,6,"(6.171601,-75.427454)"
2013,Febrero,Eslovaquia,703,0,1,,1,"(3.541112,-76.384584)"
2013,Febrero,Eslovaquia,703,1,0,,1,"(4.697144,-74.140516)"
2013,Febrero,Eslovenia,705,0,1,,1,"(4.697144,-74.140516)"
2013,Febrero,Estados Unidos de América,840,1466,1279,,2745,"(10.445761,-75.516429)"
2013,Febrero,Estados Unidos de América,840,1560,1383,,2943,"(10.886611,-74.776708)"
2013,Febrero,Estados Unidos de América,840,10,16,,26,"(12.586067,-81.702563)"
2013,Febrero,Estados Unidos de América,840,3273,2506,,5779,"(3.541112,-76.384584)"
2013,Febrero,Estados Unidos de América,840,500,390,,890,"(4.452882,-75.766298)"
2013,Febrero,Estados Unidos de América,840,20238,20121,,40359,"(4.697144,-74.140516)"
2013,Febrero,Estados Unidos de América,840,207,140,,347,"(4.815061,-75.736532)"
2013,Febrero,Estados Unidos de América,840,5198,4327,,9525,"(6.171601,-75.427454)"
2013,Febrero,Estados Unidos de América,840,61,80,,141,"(7.128456,-73.183637)"
2013,Febrero,Estados Unidos de América,840,6,5,,11,"(7.927209,-72.507910)"
2013,Febrero,Estonia,233,0,1,,1,"(4.697144,-74.140516)"
2013,Febrero,Etiopia,231,0,2,,2,"(4.697144,-74.140516)"
2013,Febrero,Filipinas,608,1,0,,1,"(3.541112,-76.384584)"
2013,Febrero,Filipinas,608,7,12,,19,"(4.697144,-74.140516)"
2013,Febrero,Finlandia,246,0,1,,1,"(3.541112,-76.384584)"
2013,Febrero,Finlandia,246,7,7,,14,"(4.697144,-74.140516)"
2013,Febrero,Finlandia,246,1,1,,2,"(6.171601,-75.427454)"
2013,Febrero,Francia,250,1,0,,1,"(10.886611,-74.776708)"
2013,Febrero,Francia,250,35,29,,64,"(3.541112,-76.384584)"
2013,Febrero,Francia,250,1,0,,1,"(3.893038,-77.067921)"
2013,Febrero,Francia,250,716,646,,1362,"(4.697144,-74.140516)"
2013,Febrero,Francia,250,29,22,,51,"(6.171601,-75.427454)"
2013,Febrero,Gabón,266,0,4,,4,"(4.697144,-74.140516)"
2013,Febrero,Grecia,300,0,1,,1,"(3.541112,-76.384584)"
2013,Febrero,Grecia,300,9,3,,12,"(4.697144,-74.140516)"
2013,Febrero,Guatemala,320,4,3,,7,"(10.445761,-75.516429)"
2013,Febrero,Guatemala,320,5,18,,23,"(10.886611,-74.776708)"
2013,Febrero,Guatemala,320,29,51,,80,"(3.541112,-76.384584)"
2013,Febrero,Guatemala,320,142,250,,392,"(4.697144,-74.140516)"
2013,Febrero,Guatemala,320,1,4,,5,"(4.815061,-75.736532)"
2013,Febrero,Guatemala,320,77,65,,142,"(6.171601,-75.427454)"
2013,Febrero,Guatemala,320,1,4,,5,"(7.128456,-73.183637)"
2013,Febrero,Guyana,328,0,1,,1,"(10.886611,-74.776708)"
2013,Febrero,Guyana,328,1,1,,2,"(4.697144,-74.140516)"
2013,Febrero,Guyana,328,0,2,,2,"(6.171601,-75.427454)"
2013,Febrero,Guinea,324,1,6,,7,"(4.697144,-74.140516)"
2013,Febrero,Guinea Ecuatorial,226,2,7,,9,"(4.697144,-74.140516)"
2013,Febrero,Guadalupe/Territorio Francés,312,1,0,,1,"(4.697144,-74.140516)"
2013,Febrero,Guayana Francesa/Departamento de Ultramar Francés,254,1,0,,1,"(3.541112,-76.384584)"
2013,Febrero,Haití,332,0,4,,4,"(10.886611,-74.776708)"
2013,Febrero,Haití,332,2,2,,4,"(3.541112,-76.384584)"
2013,Febrero,Haití,332,6,8,,14,"(4.697144,-74.140516)"
2013,Febrero,Haití,332,4,4,,8,"(6.171601,-75.427454)"
2013,Febrero,Honduras,340,3,5,,8,"(10.445761,-75.516429)"
2013,Febrero,Honduras,340,3,5,,8,"(10.886611,-74.776708)"
2013,Febrero,Honduras,340,3,6,,9,"(12.586067,-81.702563)"
2013,Febrero,Honduras,340,11,17,,28,"(3.541112,-76.384584)"
2013,Febrero,Honduras,340,63,134,,197,"(4.697144,-74.140516)"
2013,Febrero,Honduras,340,2,2,,4,"(4.815061,-75.736532)"
2013,Febrero,Honduras,340,27,43,,70,"(6.171601,-75.427454)"
2013,Febrero,Honduras,340,1,3,,4,"(7.128456,-73.183637)"
2013,Febrero,Hong Kong,344,0,1,,1,"(10.886611,-74.776708)"
2013,Febrero,Hong Kong,344,39,61,,100,"(4.697144,-74.140516)"
2013,Febrero,Hong Kong,344,1,3,,4,"(6.171601,-75.427454)"
2013,Febrero,Hungría,348,0,3,,3,"(4.697144,-74.140516)"
2013,Febrero,India,356,1,0,,1,"(10.886611,-74.776708)"
2013,Febrero,India,356,4,3,,7,"(3.541112,-76.384584)"
2013,Febrero,India,356,47,42,,89,"(4.697144,-74.140516)"
2013,Febrero,India,356,0,2,,2,"(6.171601,-75.427454)"
2013,Febrero,India,356,1,0,,1,"(7.128456,-73.183637)"
2013,Febrero,Indonesia,360,0,1,,1,"(10.445761,-75.516429)"
2013,Febrero,Indonesia,360,0,1,,1,"(3.541112,-76.384584)"
2013,Febrero,Indonesia,360,1,10,,11,"(4.697144,-74.140516)"
2013,Febrero,Iraq,368,2,8,,10,"(4.697144,-74.140516)"
2013,Febrero,Irán,364,2,0,,2,"(4.697144,-74.140516)"
2013,Febrero,República de Irlanda,372,11,12,,23,"(4.697144,-74.140516)"
2013,Febrero,Islandia,352,0,1,,1,"(4.697144,-74.140516)"
2013,Febrero,Isla de Man,833,2,0,,2,"(6.171601,-75.427454)"
2013,Febrero,Israel,376,1,3,,4,"(10.886611,-74.776708)"
2013,Febrero,Israel,376,6,2,,8,"(3.541112,-76.384584)"
2013,Febrero,Israel,376,107,102,,209,"(4.697144,-74.140516)"
2013,Febrero,Israel,376,1,2,,3,"(6.171601,-75.427454)"
2013,Febrero,Italia,380,3,0,,3,"(10.445761,-75.516429)"
2013,Febrero,Italia,380,1,0,,1,"(10.886611,-74.776708)"
2013,Febrero,Italia,380,112,48,,160,"(3.541112,-76.384584)"
2013,Febrero,Italia,380,1,0,,1,"(4.452882,-75.766298)"
2013,Febrero,Italia,380,683,372,,1055,"(4.697144,-74.140516)"
2013,Febrero,Italia,380,53,27,,80,"(6.171601,-75.427454)"
2013,Febrero,Jamaica,388,1,1,,2,"(10.445761,-75.516429)"
2013,Febrero,Jamaica,388,1,3,,4,"(10.886611,-74.776708)"
2013,Febrero,Jamaica,388,1,0,,1,"(12.586067,-81.702563)"
2013,Febrero,Jamaica,388,3,9,,12,"(3.541112,-76.384584)"
2013,Febrero,Jamaica,388,29,25,,54,"(4.697144,-74.140516)"
2013,Febrero,Jamaica,388,3,8,,11,"(4.815061,-75.736532)"
2013,Febrero,Jamaica,388,8,12,,20,"(6.171601,-75.427454)"
2013,Febrero,Jamaica,388,1,1,,2,"(7.128456,-73.183637)"
2013,Febrero,Jamaica,388,1,4,,5,"(7.927209,-72.507910)"
2013,Febrero,Japón,392,4,2,,6,"(3.541112,-76.384584)"
2013,Febrero,Japón,392,32,52,,84,"(4.697144,-74.140516)"
2013,Febrero,Japón,392,1,2,,3,"(6.171601,-75.427454)"
2013,Febrero,Jordania,400,1,0,,1,"(3.541112,-76.384584)"
2013,Febrero,Jordania,400,2,5,,7,"(4.697144,-74.140516)"
2013,Febrero,Kazajistán,398,0,1,,1,"(4.697144,-74.140516)"
2013,Febrero,Kenia,404,4,5,,9,"(4.697144,-74.140516)"
2013,Febrero,Kenia,404,0,1,,1,"(6.171601,-75.427454)"
2013,Febrero,Kuwait,414,1,1,,2,"(4.697144,-74.140516)"
2013,Febrero,Letonia,428,0,1,,1,"(4.697144,-74.140516)"
2013,Febrero,Lituania,440,0,15,,15,"(4.697144,-74.140516)"
2013,Febrero,Líbano,422,1,0,,1,"(10.886611,-74.776708)"
2013,Febrero,Líbano,422,12,14,,26,"(4.697144,-74.140516)"
2013,Febrero,Luxemburgo,442,0,1,,1,"(3.541112,-76.384584)"
2013,Febrero,Luxemburgo,442,1,0,,1,"(4.697144,-74.140516)"
2013,Febrero,Malasia,458,8,12,,20,"(4.697144,-74.140516)"
2013,Febrero,Malasia,458,0,1,,1,"(6.171601,-75.427454)"
2013,Febrero,Malawi,454,1,0,,1,"(4.697144,-74.140516)"
2013,Febrero,Malí,466,2,1,,3,"(4.697144,-74.140516)"
2013,Febrero,Malta,470,1,0,,1,"(3.541112,-76.384584)"
2013,Febrero,Malta,470,3,4,,7,"(4.697144,-74.140516)"
2013,Febrero,Marruecos,504,4,2,,6,"(4.697144,-74.140516)"
2013,Febrero,México,484,21,28,,49,"(10.445761,-75.516429)"
2013,Febrero,México,484,49,40,,89,"(10.886611,-74.776708)"
2013,Febrero,México,484,1,0,,1,"(12.586067,-81.702563)"
2013,Febrero,México,484,238,236,,474,"(3.541112,-76.384584)"
2013,Febrero,México,484,4039,4475,,8514,"(4.697144,-74.140516)"
2013,Febrero,México,484,55,59,,114,"(4.815061,-75.736532)"
2013,Febrero,México,484,641,540,,1181,"(6.171601,-75.427454)"
2013,Febrero,México,484,105,72,,177,"(7.128456,-73.183637)"
2013,Febrero,México,484,8,6,,14,"(7.927209,-72.507910)"
2013,Febrero,Mayotte/Colectividad Territorial Francesa,175,0,1,,1,"(4.697144,-74.140516)"
2013,Febrero,República de Moldavia,498,1,2,,3,"(4.697144,-74.140516)"
2013,Febrero,Mónaco,492,1,2,,3,"(4.697144,-74.140516)"
2013,Febrero,Mónaco,492,1,0,,1,"(6.171601,-75.427454)"
2013,Febrero,Mozambique,508,4,0,,4,"(4.697144,-74.140516)"
2013,Febrero,Myanmar,104,0,5,,5,"(4.697144,-74.140516)"
2013,Febrero,Nepal,524,0,1,,1,"(4.697144,-74.140516)"
2013,Febrero,Nicaragua,558,1,5,,6,"(10.445761,-75.516429)"
2013,Febrero,Nicaragua,558,4,2,,6,"(10.886611,-74.776708)"
2013,Febrero,Nicaragua,558,6,8,,14,"(3.541112,-76.384584)"
2013,Febrero,Nicaragua,558,31,60,,91,"(4.697144,-74.140516)"
2013,Febrero,Nicaragua,558,9,18,,27,"(6.171601,-75.427454)"
2013,Febrero,Nicaragua,558,1,3,,4,"(7.128456,-73.183637)"
2013,Febrero,Nicaragua,558,4,3,,7,"(7.927209,-72.507910)"
2013,Febrero,Nigeria,566,1,10,,11,"(4.697144,-74.140516)"
2013,Febrero,Nigeria,566,0,1,,1,"(6.171601,-75.427454)"
2013,Febrero,Noruega,578,1,0,,1,"(3.541112,-76.384584)"
2013,Febrero,Noruega,578,36,26,,62,"(4.697144,-74.140516)"
2013,Febrero,Noruega,578,1,0,,1,"(6.171601,-75.427454)"
2013,Febrero,Noruega,578,1,0,,1,"(7.128456,-73.183637)"
2013,Febrero,Nueva Caledonia/Territorio francés,540,2,0,,2,"(4.697144,-74.140516)"
2013,Febrero,Nueva Zelanda,554,2,2,,4,"(3.541112,-76.384584)"
2013,Febrero,Nueva Zelanda,554,33,31,,64,"(4.697144,-74.140516)"
2013,Febrero,Nueva Zelanda,554,1,1,,2,"(6.171601,-75.427454)"
2013,Febrero,Omán,512,1,1,,2,"(4.697144,-74.140516)"
2013,Febrero,Papúa Nueva Guinea,598,0,4,,4,"(4.697144,-74.140516)"
2013,Febrero,Papúa Nueva Guinea,598,1,1,,2,"(6.171601,-75.427454)"
2013,Febrero,Pakistán,586,0,2,,2,"(4.697144,-74.140516)"
2013,Febrero,Panamá,591,2,2,,4,"(0.814836,-77.662532)"
2013,Febrero,Panamá,591,67,94,,161,"(10.408582,-75.538003)"
2013,Febrero,Panamá,591,311,328,,639,"(10.445761,-75.516429)"
2013,Febrero,Panamá,591,904,911,,1815,"(10.886611,-74.776708)"
2013,Febrero,Panamá,591,34,44,,78,"(12.586067,-81.702563)"
2013,Febrero,Panamá,591,1792,1601,,3393,"(3.541112,-76.384584)"
2013,Febrero,Panamá,591,5147,6142,,11289,"(4.697144,-74.140516)"
2013,Febrero,Panamá,591,631,512,,1143,"(4.815061,-75.736532)"
2013,Febrero,Panamá,591,2004,2108,,4112,"(6.171601,-75.427454)"
2013,Febrero,Panamá,591,2,11,,13,"(6.228046,-77.404104)"
2013,Febrero,Panamá,591,239,226,,465,"(7.128456,-73.183637)"
2013,Febrero,Panamá,591,111,146,,257,"(7.927209,-72.507910)"
2013,Febrero,Panamá,591,0,1,,1,"(8.635765,-77.346578)"
2013,Febrero,Paraguay,600,0,1,,1,"(10.445761,-75.516429)"
2013,Febrero,Paraguay,600,2,2,,4,"(10.886611,-74.776708)"
2013,Febrero,Paraguay,600,12,14,,26,"(3.541112,-76.384584)"
2013,Febrero,Paraguay,600,14,66,,80,"(4.697144,-74.140516)"
2013,Febrero,Paraguay,600,3,2,,5,"(4.815061,-75.736532)"
2013,Febrero,Paraguay,600,4,19,,23,"(6.171601,-75.427454)"
2013,Febrero,Paraguay,600,5,2,,7,"(7.128456,-73.183637)"
2013,Febrero,Perú,604,2,2,,4,"(-4.197703,-69.941278)"
2013,Febrero,Perú,604,24,43,,67,"(0.814836,-77.662532)"
2013,Febrero,Perú,604,4,5,,9,"(10.445761,-75.516429)"
2013,Febrero,Perú,604,15,19,,34,"(10.886611,-74.776708)"
2013,Febrero,Perú,604,208,221,,429,"(3.541112,-76.384584)"
2013,Febrero,Perú,604,2531,3363,,5894,"(4.697144,-74.140516)"
2013,Febrero,Perú,604,23,21,,44,"(4.815061,-75.736532)"
2013,Febrero,Perú,604,256,282,,538,"(6.171601,-75.427454)"
2013,Febrero,Perú,604,8,7,,15,"(7.128456,-73.183637)"
2013,Febrero,Perú,604,1,0,,1,"(7.818934,-72.453226)"
2013,Febrero,Perú,604,0,2,,2,"(7.927209,-72.507910)"
2013,Febrero,Palestina,99999,0,1,,1,"(6.171601,-75.427454)"
2013,Febrero,Polonia,616,0,1,,1,"(10.445761,-75.516429)"
2013,Febrero,Polonia,616,6,11,,17,"(4.697144,-74.140516)"
2013,Febrero,Portugal,620,0,1,,1,"(10.445761,-75.516429)"
2013,Febrero,Portugal,620,4,2,,6,"(3.541112,-76.384584)"
2013,Febrero,Portugal,620,29,14,,43,"(4.697144,-74.140516)"
2013,Febrero,Portugal,620,0,1,,1,"(6.171601,-75.427454)"
2013,Febrero,Portugal,620,1,1,,2,"(7.818934,-72.453226)"
2013,Febrero,Polinesia Francesa/Colectividad de Ultramar Francesa,258,1,3,,4,"(4.697144,-74.140516)"
2013,Febrero,Puerto Rico/Territorio de Estados Unidos,630,3,2,,5,"(10.445761,-75.516429)"
2013,Febrero,Puerto Rico/Territorio de Estados Unidos,630,6,10,,16,"(10.886611,-74.776708)"
2013,Febrero,Puerto Rico/Territorio de Estados Unidos,630,0,1,,1,"(12.586067,-81.702563)"
2013,Febrero,Puerto Rico/Territorio de Estados Unidos,630,25,18,,43,"(3.541112,-76.384584)"
2013,Febrero,Puerto Rico/Territorio de Estados Unidos,630,70,106,,176,"(4.697144,-74.140516)"
2013,Febrero,Puerto Rico/Territorio de Estados Unidos,630,6,2,,8,"(4.815061,-75.736532)"
2013,Febrero,Puerto Rico/Territorio de Estados Unidos,630,27,44,,71,"(6.171601,-75.427454)"
2013,Febrero,Puerto Rico/Territorio de Estados Unidos,630,2,4,,6,"(7.128456,-73.183637)"
2013,Febrero,Qatar,634,0,1,,1,"(3.541112,-76.384584)"
2013,Febrero,Qatar,634,5,4,,9,"(4.697144,-74.140516)"
2013,Febrero,Qatar,634,1,0,,1,"(6.171601,-75.427454)"
2013,Febrero,Reino Unido de Gran Bretaña e Irlanda del Norte,826,5,1,,6,"(10.445761,-75.516429)"
2013,Febrero,Reino Unido de Gran Bretaña e Irlanda del Norte,826,4,0,,4,"(10.886611,-74.776708)"
2013,Febrero,Reino Unido de Gran Bretaña e Irlanda del Norte,826,79,38,,117,"(3.541112,-76.384584)"
2013,Febrero,Reino Unido de Gran Bretaña e Irlanda del Norte,826,624,475,,1099,"(4.697144,-74.140516)"
2013,Febrero,Reino Unido de Gran Bretaña e Irlanda del Norte,826,45,17,,62,"(6.171601,-75.427454)"
2013,Febrero,Reino Unido de Gran Bretaña e Irlanda del Norte,826,0,2,,2,"(7.128456,-73.183637)"
2013,Febrero,Federación de Rusia,643,0,1,,1,"(10.445761,-75.516429)"
2013,Febrero,Federación de Rusia,643,1,1,,2,"(3.541112,-76.384584)"
2013,Febrero,Federación de Rusia,643,25,47,,72,"(4.697144,-74.140516)"
2013,Febrero,Federación de Rusia,643,1,2,,3,"(6.171601,-75.427454)"
2013,Febrero,República Dominicana,214,0,6,,6,"(10.408582,-75.538003)"
2013,Febrero,República Dominicana,214,5,17,,22,"(10.445761,-75.516429)"
2013,Febrero,República Dominicana,214,17,28,,45,"(10.886611,-74.776708)"
2013,Febrero,República Dominicana,214,27,31,,58,"(3.541112,-76.384584)"
2013,Febrero,República Dominicana,214,729,816,,1545,"(4.697144,-74.140516)"
2013,Febrero,República Dominicana,214,5,5,,10,"(4.815061,-75.736532)"
2013,Febrero,República Dominicana,214,67,84,,151,"(6.171601,-75.427454)"
2013,Febrero,República Dominicana,214,7,6,,13,"(7.128456,-73.183637)"
2013,Febrero,República Dominicana,214,0,1,,1,"(7.927209,-72.507910)"
2013,Febrero,Reunión,638,0,1,,1,"(4.697144,-74.140516)"
2013,Febrero,Rumania,642,0,4,,4,"(4.697144,-74.140516)"
2013,Febrero,Rumania,642,0,1,,1,"(6.171601,-75.427454)"
2013,Febrero,Rwanda,646,1,0,,1,"(4.697144,-74.140516)"
2013,Febrero,Santo Tomé y Príncipe,678,3,3,,6,"(10.886611,-74.776708)"
2013,Febrero,Senegal,686,1,1,,2,"(4.697144,-74.140516)"
2013,Febrero,Serbia,688,1,2,,3,"(4.697144,-74.140516)"
2013,Febrero,Singapur,702,22,17,,39,"(4.697144,-74.140516)"
2013,Febrero,Sri Lanka,144,0,1,,1,"(6.171601,-75.427454)"
2013,Febrero,Sudáfrica,710,1,2,,3,"(3.541112,-76.384584)"
2013,Febrero,Sudáfrica,710,18,22,,40,"(4.697144,-74.140516)"
2013,Febrero,Sudáfrica,710,1,0,,1,"(6.171601,-75.427454)"
2013,Febrero,Sudán,736,1,0,,1,"(4.697144,-74.140516)"
2013,Febrero,Suecia,752,5,7,,12,"(3.541112,-76.384584)"
2013,Febrero,Suecia,752,80,57,,137,"(4.697144,-74.140516)"
2013,Febrero,Suecia,752,4,1,,5,"(6.171601,-75.427454)"
2013,Febrero,Suiza,756,1,0,,1,"(10.445761,-75.516429)"
2013,Febrero,Suiza,756,2,1,,3,"(10.886611,-74.776708)"
2013,Febrero,Suiza,756,42,18,,60,"(3.541112,-76.384584)"
2013,Febrero,Suiza,756,259,126,,385,"(4.697144,-74.140516)"
2013,Febrero,Suiza,756,13,17,,30,"(6.171601,-75.427454)"
2013,Febrero,Surinam,740,0,3,,3,"(10.408582,-75.538003)"
2013,Febrero,Surinam,740,1,2,,3,"(4.697144,-74.140516)"
2013,Febrero,Taiwán,158,0,1,,1,"(3.541112,-76.384584)"
2013,Febrero,Taiwán,158,1,6,,7,"(4.697144,-74.140516)"
2013,Febrero,Tailandia,764,0,1,,1,"(10.886611,-74.776708)"
2013,Febrero,Tailandia,764,7,10,,17,"(4.697144,-74.140516)"
2013,Febrero,Trinidad y Tobago,780,0,1,,1,"(10.445761,-75.516429)"
2013,Febrero,Trinidad y Tobago,780,0,1,,1,"(10.886611,-74.776708)"
2013,Febrero,Trinidad y Tobago,780,10,6,,16,"(3.541112,-76.384584)"
2013,Febrero,Trinidad y Tobago,780,16,30,,46,"(4.697144,-74.140516)"
2013,Febrero,Trinidad y Tobago,780,4,1,,5,"(4.815061,-75.736532)"
2013,Febrero,Trinidad y Tobago,780,6,4,,10,"(6.171601,-75.427454)"
2013,Febrero,Trinidad y Tobago,780,3,0,,3,"(7.128456,-73.183637)"
2013,Febrero,Túnez,788,1,1,,2,"(4.697144,-74.140516)"
2013,Febrero,Turquía,792,0,1,,1,"(3.541112,-76.384584)"
2013,Febrero,Turquía,792,19,18,,37,"(4.697144,-74.140516)"
2013,Febrero,Turquía,792,2,3,,5,"(6.171601,-75.427454)"
2013,Febrero,Ucrania,804,0,3,,3,"(4.697144,-74.140516)"
2013,Febrero,Uganda,800,0,1,,1,"(4.697144,-74.140516)"
2013,Febrero,Uruguay,858,1,2,,3,"(10.445761,-75.516429)"
2013,Febrero,Uruguay,858,12,7,,19,"(3.541112,-76.384584)"
2013,Febrero,Uruguay,858,42,56,,98,"(4.697144,-74.140516)"
2013,Febrero,Uruguay,858,14,9,,23,"(6.171601,-75.427454)"
2013,Febrero,Vanuatu,548,0,1,,1,"(6.185799,-67.483929)"
2013,Febrero,Vanuatu,548,1,2,,3,"(7.818934,-72.453226)"
2013,Febrero,Venezuela,862,5,11,,16,"(10.445761,-75.516429)"
2013,Febrero,Venezuela,862,29,30,,59,"(10.886611,-74.776708)"
2013,Febrero,Venezuela,862,9357,8717,,18074,"(11.360009,-72.129330)"
2013,Febrero,Venezuela,862,1,1,,2,"(12.586067,-81.702563)"
2013,Febrero,Venezuela,862,23,19,,42,"(3.541112,-76.384584)"
2013,Febrero,Venezuela,862,2,2,,4,"(4.452882,-75.766298)"
2013,Febrero,Venezuela,862,1926,2551,,4477,"(4.697144,-74.140516)"
2013,Febrero,Venezuela,862,3,3,,6,"(4.815061,-75.736532)"
2013,Febrero,Venezuela,862,273,327,,600,"(6.171601,-75.427454)"
2013,Febrero,Venezuela,862,301,345,,646,"(6.185799,-67.483929)"
2013,Febrero,Venezuela,862,1420,1454,,2874,"(7.088729,-70.740253)"
2013,Febrero,Venezuela,862,3,4,,7,"(7.128456,-73.183637)"
2013,Febrero,Venezuela,862,8656,9720,,18376,"(7.818934,-72.453226)"
2013,Febrero,Venezuela,862,0,1,,1,"(7.927209,-72.507910)"
2013,Febrero,Vietnam,704,1,0,,1,"(3.541112,-76.384584)"
2013,Febrero,Vietnam,704,2,1,,3,"(4.697144,-74.140516)"
2013,Febrero,Desconocido,99999,1,1,,2,"(3.541112,-76.384584)"
2013,Febrero,Desconocido,99999,4,18,,22,"(4.697144,-74.140516)"
2013,Febrero,Desconocido,99999,0,1,,1,"(6.171601,-75.427454)"
2013,Marzo,Afganistán,4,4,40,,44,"(4.697144,-74.140516)"
2013,Marzo,Afganistán,4,0,1,,1,"(6.171601,-75.427454)"
2013,Marzo,Afganistán,4,0,1,,1,"(6.185799,-67.483929)"
2013,Marzo,Alemania,276,1,2,,3,"(0.814836,-77.662532)"
2013,Marzo,Alemania,276,1,0,,1,"(10.445761,-75.516429)"
2013,Marzo,Alemania,276,3,1,,4,"(10.886611,-74.776708)"
2013,Marzo,Alemania,276,21,13,,34,"(3.541112,-76.384584)"
2013,Marzo,Alemania,276,1078,1010,,2088,"(4.697144,-74.140516)"
2013,Marzo,Alemania,276,15,13,,28,"(6.171601,-75.427454)"
2013,Marzo,Angola,24,0,13,,13,"(4.697144,-74.140516)"
2013,Marzo,Antigua y Barbuda,28,1,0,,1,"(4.815061,-75.736532)"
2013,Marzo,Países Bajos,528,282,188,,470,"(10.408582,-75.538003)"
2013,Marzo,Países Bajos,528,2,1,,3,"(10.445761,-75.516429)"
2013,Marzo,Países Bajos,528,1,0,,1,"(10.886611,-74.776708)"
2013,Marzo,Países Bajos,528,46,25,,71,"(3.541112,-76.384584)"
2013,Marzo,Países Bajos,528,122,112,,234,"(4.697144,-74.140516)"
2013,Marzo,Países Bajos,528,1,1,,2,"(4.815061,-75.736532)"
2013,Marzo,Países Bajos,528,35,18,,53,"(6.171601,-75.427454)"
2013,Marzo,Países Bajos,528,2,3,,5,"(7.128456,-73.183637)"
2013,Marzo,Países Bajos,528,0,1,,1,"(7.927209,-72.507910)"
2013,Marzo,Arabia Saudita,682,1,1,,2,"(3.541112,-76.384584)"
2013,Marzo,Arabia Saudita,682,9,26,,35,"(4.697144,-74.140516)"
2013,Marzo,Arabia Saudita,682,1,1,,2,"(6.171601,-75.427454)"
2013,Marzo,Argelia,12,0,1,,1,"(0.814836,-77.662532)"
2013,Marzo,Argelia,12,1,0,,1,"(3.541112,-76.384584)"
2013,Marzo,Argelia,12,6,2,,8,"(4.697144,-74.140516)"
2013,Marzo,Argentina,32,14,29,,43,"(0.814836,-77.662532)"
2013,Marzo,Argentina,32,10,14,,24,"(10.445761,-75.516429)"
2013,Marzo,Argentina,32,17,15,,32,"(10.886611,-74.776708)"
2013,Marzo,Argentina,32,1,0,,1,"(12.586067,-81.702563)"
2013,Marzo,Argentina,32,176,167,,343,"(3.541112,-76.384584)"
2013,Marzo,Argentina,32,4316,3840,,8156,"(4.697144,-74.140516)"
2013,Marzo,Argentina,32,4,6,,10,"(4.815061,-75.736532)"
2013,Marzo,Argentina,32,199,179,,378,"(6.171601,-75.427454)"
2013,Marzo,Argentina,32,1,0,,1,"(7.128456,-73.183637)"
2013,Marzo,Argentina,32,0,1,,1,"(7.927209,-72.507910)"
2013,Marzo,República de Armenia,51,1,0,,1,"(3.541112,-76.384584)"
2013,Marzo,Aruba,533,2180,1580,,3760,"(10.408582,-75.538003)"
2013,Marzo,Aruba,533,5,6,,11,"(10.445761,-75.516429)"
2013,Marzo,Aruba,533,29,20,,49,"(10.886611,-74.776708)"
2013,Marzo,Aruba,533,84,59,,143,"(11.528919,-72.919681)"
2013,Marzo,Aruba,533,18,15,,33,"(3.541112,-76.384584)"
2013,Marzo,Aruba,533,80,54,,134,"(4.452882,-75.766298)"
2013,Marzo,Aruba,533,964,776,,1740,"(4.697144,-74.140516)"
2013,Marzo,Aruba,533,3,2,,5,"(4.815061,-75.736532)"
2013,Marzo,Aruba,533,112,80,,192,"(6.171601,-75.427454)"
2013,Marzo,Aruba,533,10,10,,20,"(7.128456,-73.183637)"
2013,Marzo,Australia,36,2,2,,4,"(10.886611,-74.776708)"
2013,Marzo,Australia,36,5,8,,13,"(3.541112,-76.384584)"
2013,Marzo,Australia,36,206,182,,388,"(4.697144,-74.140516)"
2013,Marzo,Australia,36,2,1,,3,"(4.815061,-75.736532)"
2013,Marzo,Australia,36,24,19,,43,"(6.171601,-75.427454)"
2013,Marzo,Australia,36,1,3,,4,"(7.128456,-73.183637)"
2013,Marzo,Austria,40,3,1,,4,"(3.541112,-76.384584)"
2013,Marzo,Austria,40,43,42,,85,"(4.697144,-74.140516)"
2013,Marzo,Austria,40,1,0,,1,"(6.171601,-75.427454)"
2013,Marzo,Bahamas,44,2,0,,2,"(10.445761,-75.516429)"
2013,Marzo,Bahamas,44,5,5,,10,"(10.886611,-74.776708)"
2013,Marzo,Bahamas,44,6,4,,10,"(3.541112,-76.384584)"
2013,Marzo,Bahamas,44,16,11,,27,"(4.697144,-74.140516)"
2013,Marzo,Bahamas,44,2,2,,4,"(4.815061,-75.736532)"
2013,Marzo,Bahamas,44,26,15,,41,"(6.171601,-75.427454)"
2013,Marzo,Bahamas,44,0,1,,1,"(7.128456,-73.183637)"
2013,Marzo,Bahamas,44,1,0,,1,"(7.927209,-72.507910)"
2013,Marzo,Bahréin,48,0,1,,1,"(13.3387613,-81.372937)"
2013,Marzo,Bahréin,48,1,1,,2,"(4.697144,-74.140516)"
2013,Marzo,Bangladesh,50,0,3,,3,"(4.697144,-74.140516)"
2013,Marzo,Barbados,52,5,12,,17,"(4.697144,-74.140516)"
2013,Marzo,República de Belarús,112,3,1,,4,"(11.360009,-72.129330)"
2013,Marzo,República de Belarús,112,1,0,,1,"(4.697144,-74.140516)"
2013,Marzo,República de Belarús,112,6,1,,7,"(7.818934,-72.453226)"
2013,Marzo,Bélgica,56,4,6,,10,"(3.541112,-76.384584)"
2013,Marzo,Bélgica,56,73,43,,116,"(4.697144,-74.140516)"
2013,Marzo,Bélgica,56,7,3,,10,"(6.171601,-75.427454)"
2013,Marzo,Belice,84,2,3,,5,"(4.697144,-74.140516)"
2013,Marzo,Belice,84,0,1,,1,"(6.171601,-75.427454)"
2013,Marzo,Belice,84,0,1,,1,"(7.927209,-72.507910)"
2013,Marzo,Benín,204,1,2,,3,"(4.697144,-74.140516)"
2013,Marzo,Bolivia,68,2,6,,8,"(0.814836,-77.662532)"
2013,Marzo,Bolivia,68,1,1,,2,"(10.886611,-74.776708)"
2013,Marzo,Bolivia,68,16,31,,47,"(3.541112,-76.384584)"
2013,Marzo,Bolivia,68,241,375,,616,"(4.697144,-74.140516)"
2013,Marzo,Bolivia,68,0,2,,2,"(4.815061,-75.736532)"
2013,Marzo,Bolivia,68,18,29,,47,"(6.171601,-75.427454)"
2013,Marzo,Brasil,76,64,119,,183,"(-4.197703,-69.941278)"
2013,Marzo,Brasil,76,0,1,,1,"(0.814836,-77.662532)"
2013,Marzo,Brasil,76,4,14,,18,"(10.445761,-75.516429)"
2013,Marzo,Brasil,76,13,10,,23,"(10.886611,-74.776708)"
2013,Marzo,Brasil,76,41,98,,139,"(3.541112,-76.384584)"
2013,Marzo,Brasil,76,2719,3789,,6508,"(4.697144,-74.140516)"
2013,Marzo,Brasil,76,15,17,,32,"(4.815061,-75.736532)"
2013,Marzo,Brasil,76,56,102,,158,"(6.171601,-75.427454)"
2013,Marzo,Brasil,76,4,4,,8,"(7.128456,-73.183637)"
2013,Marzo,Brasil,76,1,0,,1,"(7.927209,-72.507910)"
2013,Marzo,Cabo Verde,132,1,0,,1,"(4.697144,-74.140516)"
2013,Marzo,Islas Caimán/Territorio Británico de Ultramar,136,1,0,,1,"(10.445761,-75.516429)"
2013,Marzo,Islas Caimán/Territorio Británico de Ultramar,136,31,10,,41,"(12.586067,-81.702563)"
2013,Marzo,Islas Caimán/Territorio Británico de Ultramar,136,0,1,,1,"(4.697144,-74.140516)"
2013,Marzo,Camboya,116,6,2,,8,"(4.697144,-74.140516)"
2013,Marzo,Camerún,120,0,3,,3,"(4.697144,-74.140516)"
2013,Marzo,Canadá,124,100,53,,153,"(10.445761,-75.516429)"
2013,Marzo,Canadá,124,8,6,,14,"(10.886611,-74.776708)"
2013,Marzo,Canadá,124,4,4,,8,"(12.586067,-81.702563)"
2013,Marzo,Canadá,124,69,40,,109,"(3.541112,-76.384584)"
2013,Marzo,Canadá,124,5,6,,11,"(4.452882,-75.766298)"
2013,Marzo,Canadá,124,1263,1116,,2379,"(4.697144,-74.140516)"
2013,Marzo,Canadá,124,5,2,,7,"(4.815061,-75.736532)"
2013,Marzo,Canadá,124,155,136,,291,"(6.171601,-75.427454)"
2013,Marzo,Canadá,124,0,1,,1,"(7.128456,-73.183637)"
2013,Marzo,Chad,148,0,2,,2,"(4.697144,-74.140516)"
2013,Marzo,España,724,1,3,,4,"(10.445761,-75.516429)"
2013,Marzo,España,724,1,0,,1,"(11.360009,-72.129330)"
2013,Marzo,España,724,2006,1303,,3309,"(3.541112,-76.384584)"
2013,Marzo,España,724,5924,4864,,10788,"(4.697144,-74.140516)"
2013,Marzo,España,724,1,1,,2,"(4.815061,-75.736532)"
2013,Marzo,España,724,816,570,,1386,"(6.171601,-75.427454)"
2013,Marzo,República Democrática del Congo,180,0,4,,4,"(4.697144,-74.140516)"
2013,Marzo,República de Corea,410,1,0,,1,"(10.886611,-74.776708)"
2013,Marzo,República de Corea,410,13,20,,33,"(4.697144,-74.140516)"
2013,Marzo,Costa de Marfil,384,3,0,,3,"(4.697144,-74.140516)"
2013,Marzo,Costa Rica,188,15,14,,29,"(10.445761,-75.516429)"
2013,Marzo,Costa Rica,188,19,24,,43,"(10.886611,-74.776708)"
2013,Marzo,Costa Rica,188,0,1,,1,"(10.971302,-74.765397)"
2013,Marzo,Costa Rica,188,2,13,,15,"(12.5744111,-81.703935)"
2013,Marzo,Costa Rica,188,4,2,,6,"(12.586067,-81.702563)"
2013,Marzo,Costa Rica,188,52,39,,91,"(3.541112,-76.384584)"
2013,Marzo,Costa Rica,188,757,879,,1636,"(4.697144,-74.140516)"
2013,Marzo,Costa Rica,188,7,8,,15,"(4.815061,-75.736532)"
2013,Marzo,Costa Rica,188,136,148,,284,"(6.171601,-75.427454)"
2013,Marzo,Costa Rica,188,1,3,,4,"(7.128456,-73.183637)"
2013,Marzo,Costa Rica,188,1,0,,1,"(7.927209,-72.507910)"
2013,Marzo,Costa Rica,188,1,1,,2,"(8.635765,-77.346578)"
2013,Marzo,Croacia,191,2,0,,2,"(4.697144,-74.140516)"
2013,Marzo,Cuba,192,18,14,,32,"(10.445761,-75.516429)"
2013,Marzo,Cuba,192,25,22,,47,"(10.886611,-74.776708)"
2013,Marzo,Cuba,192,2,4,,6,"(12.586067,-81.702563)"
2013,Marzo,Cuba,192,143,98,,241,"(3.541112,-76.384584)"
2013,Marzo,Cuba,192,1062,832,,1894,"(4.697144,-74.140516)"
2013,Marzo,Cuba,192,18,14,,32,"(4.815061,-75.736532)"
2013,Marzo,Cuba,192,194,165,,359,"(6.171601,-75.427454)"
2013,Marzo,Cuba,192,8,15,,23,"(7.128456,-73.183637)"
2013,Marzo,Cuba,192,3,1,,4,"(7.927209,-72.507910)"
2013,Marzo,Curazao,99999,1,1,,2,"(10.445761,-75.516429)"
2013,Marzo,Curazao,99999,3,2,,5,"(10.886611,-74.776708)"
2013,Marzo,Curazao,99999,8,4,,12,"(3.541112,-76.384584)"
2013,Marzo,Curazao,99999,426,492,,918,"(4.697144,-74.140516)"
2013,Marzo,Curazao,99999,1,0,,1,"(4.815061,-75.736532)"
2013,Marzo,Curazao,99999,145,79,,224,"(6.171601,-75.427454)"
2013,Marzo,Curazao,99999,2,3,,5,"(7.128456,-73.183637)"
2013,Marzo,Curazao,99999,0,1,,1,"(7.927209,-72.507910)"
2013,Marzo,República Checa,203,4,9,,13,"(4.697144,-74.140516)"
2013,Marzo,Chile,152,110,117,,227,"(0.814836,-77.662532)"
2013,Marzo,Chile,152,15,17,,32,"(10.445761,-75.516429)"
2013,Marzo,Chile,152,25,27,,52,"(10.886611,-74.776708)"
2013,Marzo,Chile,152,460,379,,839,"(3.541112,-76.384584)"
2013,Marzo,Chile,152,2988,2939,,5927,"(4.697144,-74.140516)"
2013,Marzo,Chile,152,63,46,,109,"(4.815061,-75.736532)"
2013,Marzo,Chile,152,185,141,,326,"(6.171601,-75.427454)"
2013,Marzo,Chile,152,6,6,,12,"(7.128456,-73.183637)"
2013,Marzo,Chile,152,2,2,,4,"(7.927209,-72.507910)"
2013,Marzo,China,156,0,1,,1,"(10.445761,-75.516429)"
2013,Marzo,China,156,2,5,,7,"(10.886611,-74.776708)"
2013,Marzo,China,156,1,1,,2,"(12.586067,-81.702563)"
2013,Marzo,China,156,6,8,,14,"(3.541112,-76.384584)"
2013,Marzo,China,156,252,642,,894,"(4.697144,-74.140516)"
2013,Marzo,China,156,1,1,,2,"(4.815061,-75.736532)"
2013,Marzo,China,156,12,37,,49,"(6.171601,-75.427454)"
2013,Marzo,China,156,0,2,,2,"(7.128456,-73.183637)"
2013,Marzo,China,156,0,1,,1,"(7.927209,-72.507910)"
2013,Marzo,Chipre,196,1,0,,1,"(3.541112,-76.384584)"
2013,Marzo,Dinamarca,208,1,0,,1,"(3.541112,-76.384584)"
2013,Marzo,Dinamarca,208,25,16,,41,"(4.697144,-74.140516)"
2013,Marzo,Dinamarca,208,1,1,,2,"(6.171601,-75.427454)"
2013,Marzo,Ecuador,218,9373,9415,,18788,"(0.814836,-77.662532)"
2013,Marzo,Ecuador,218,148,150,,298,"(1.813928,-78.763924)"
2013,Marzo,Ecuador,218,2,3,,5,"(10.445761,-75.516429)"
2013,Marzo,Ecuador,218,8,13,,21,"(10.886611,-74.776708)"
2013,Marzo,Ecuador,218,792,756,,1548,"(3.541112,-76.384584)"
2013,Marzo,Ecuador,218,2806,4236,,7042,"(4.697144,-74.140516)"
2013,Marzo,Ecuador,218,1,2,,3,"(4.815061,-75.736532)"
2013,Marzo,Ecuador,218,421,465,,886,"(6.171601,-75.427454)"
2013,Marzo,Ecuador,218,0,3,,3,"(7.128456,-73.183637)"
2013,Marzo,Ecuador,218,1,1,,2,"(7.927209,-72.507910)"
2013,Marzo,Egipto,818,90,42,,132,"(4.697144,-74.140516)"
2013,Marzo,El Salvador,222,1,1,,2,"(10.445761,-75.516429)"
2013,Marzo,El Salvador,222,2,6,,8,"(10.886611,-74.776708)"
2013,Marzo,El Salvador,222,111,95,,206,"(3.541112,-76.384584)"
2013,Marzo,El Salvador,222,702,661,,1363,"(4.697144,-74.140516)"
2013,Marzo,El Salvador,222,3,1,,4,"(4.815061,-75.736532)"
2013,Marzo,El Salvador,222,105,83,,188,"(6.171601,-75.427454)"
2013,Marzo,El Salvador,222,1,1,,2,"(7.128456,-73.183637)"
2013,Marzo,Emiratos Árabes,784,2,1,,3,"(3.541112,-76.384584)"
2013,Marzo,Emiratos Árabes,784,119,205,,324,"(4.697144,-74.140516)"
2013,Marzo,Emiratos Árabes,784,4,2,,6,"(6.171601,-75.427454)"
2013,Marzo,Eslovaquia,703,0,1,,1,"(3.541112,-76.384584)"
2013,Marzo,Eslovenia,705,2,1,,3,"(4.697144,-74.140516)"
2013,Marzo,Estados Unidos de América,840,2022,1775,,3797,"(10.445761,-75.516429)"
2013,Marzo,Estados Unidos de América,840,1998,1665,,3663,"(10.886611,-74.776708)"
2013,Marzo,Estados Unidos de América,840,21,25,,46,"(12.586067,-81.702563)"
2013,Marzo,Estados Unidos de América,840,4716,3683,,8399,"(3.541112,-76.384584)"
2013,Marzo,Estados Unidos de América,840,583,444,,1027,"(4.452882,-75.766298)"
2013,Marzo,Estados Unidos de América,840,31292,28831,,60123,"(4.697144,-74.140516)"
2013,Marzo,Estados Unidos de América,840,473,355,,828,"(4.815061,-75.736532)"
2013,Marzo,Estados Unidos de América,840,6769,5630,,12399,"(6.171601,-75.427454)"
2013,Marzo,Estados Unidos de América,840,187,142,,329,"(7.128456,-73.183637)"
2013,Marzo,Estados Unidos de América,840,56,42,,98,"(7.927209,-72.507910)"
2013,Marzo,Estonia,233,0,2,,2,"(4.697144,-74.140516)"
2013,Marzo,Etiopia,231,1,3,,4,"(4.697144,-74.140516)"
2013,Marzo,Filipinas,608,4,11,,15,"(4.697144,-74.140516)"
2013,Marzo,Finlandia,246,1,0,,1,"(10.886611,-74.776708)"
2013,Marzo,Finlandia,246,1,0,,1,"(3.541112,-76.384584)"
2013,Marzo,Finlandia,246,7,11,,18,"(4.697144,-74.140516)"
2013,Marzo,Francia,250,2,0,,2,"(10.886611,-74.776708)"
2013,Marzo,Francia,250,52,30,,82,"(3.541112,-76.384584)"
2013,Marzo,Francia,250,1107,903,,2010,"(4.697144,-74.140516)"
2013,Marzo,Francia,250,37,23,,60,"(6.171601,-75.427454)"
2013,Marzo,Gabón,266,0,1,,1,"(4.697144,-74.140516)"
2013,Marzo,Georgia,268,1,0,,1,"(4.697144,-74.140516)"
2013,Marzo,Ghana,288,0,2,,2,"(4.697144,-74.140516)"
2013,Marzo,Grecia,300,19,9,,28,"(4.697144,-74.140516)"
2013,Marzo,Guatemala,320,3,4,,7,"(10.445761,-75.516429)"
2013,Marzo,Guatemala,320,7,11,,18,"(10.886611,-74.776708)"
2013,Marzo,Guatemala,320,34,46,,80,"(3.541112,-76.384584)"
2013,Marzo,Guatemala,320,155,251,,406,"(4.697144,-74.140516)"
2013,Marzo,Guatemala,320,11,9,,20,"(4.815061,-75.736532)"
2013,Marzo,Guatemala,320,59,95,,154,"(6.171601,-75.427454)"
2013,Marzo,Guatemala,320,1,3,,4,"(7.128456,-73.183637)"
2013,Marzo,Guatemala,320,4,1,,5,"(7.927209,-72.507910)"
2013,Marzo,Guyana,328,0,1,,1,"(10.886611,-74.776708)"
2013,Marzo,Guyana,328,2,3,,5,"(4.697144,-74.140516)"
2013,Marzo,Guyana,328,1,0,,1,"(6.171601,-75.427454)"
2013,Marzo,Guinea,324,0,3,,3,"(4.697144,-74.140516)"
2013,Marzo,Guinea Ecuatorial,226,2,8,,10,"(4.697144,-74.140516)"
2013,Marzo,Guinea Ecuatorial,226,0,1,,1,"(6.171601,-75.427454)"
2013,Marzo,Guayana Francesa/Departamento de Ultramar Francés,254,0,1,,1,"(4.697144,-74.140516)"
2013,Marzo,Guayana Francesa/Departamento de Ultramar Francés,254,3,0,,3,"(6.171601,-75.427454)"
2013,Marzo,Haití,332,0,2,,2,"(10.445761,-75.516429)"
2013,Marzo,Haití,332,1,3,,4,"(10.886611,-74.776708)"
2013,Marzo,Haití,332,1,3,,4,"(3.541112,-76.384584)"
2013,Marzo,Haití,332,6,18,,24,"(4.697144,-74.140516)"
2013,Marzo,Haití,332,7,12,,19,"(6.171601,-75.427454)"
2013,Marzo,Honduras,340,0,3,,3,"(10.445761,-75.516429)"
2013,Marzo,Honduras,340,2,10,,12,"(10.886611,-74.776708)"
2013,Marzo,Honduras,340,1,0,,1,"(12.586067,-81.702563)"
2013,Marzo,Honduras,340,18,11,,29,"(3.541112,-76.384584)"
2013,Marzo,Honduras,340,49,105,,154,"(4.697144,-74.140516)"
2013,Marzo,Honduras,340,0,3,,3,"(4.815061,-75.736532)"
2013,Marzo,Honduras,340,28,56,,84,"(6.171601,-75.427454)"
2013,Marzo,Hong Kong,344,2,2,,4,"(3.541112,-76.384584)"
2013,Marzo,Hong Kong,344,41,121,,162,"(4.697144,-74.140516)"
2013,Marzo,Hong Kong,344,3,7,,10,"(6.171601,-75.427454)"
2013,Marzo,Hungría,348,1,4,,5,"(4.697144,-74.140516)"
2013,Marzo,India,356,0,1,,1,"(10.445761,-75.516429)"
2013,Marzo,India,356,2,0,,2,"(3.541112,-76.384584)"
2013,Marzo,India,356,73,50,,123,"(4.697144,-74.140516)"
2013,Marzo,India,356,13,4,,17,"(6.171601,-75.427454)"
2013,Marzo,Indonesia,360,6,6,,12,"(4.697144,-74.140516)"
2013,Marzo,Indonesia,360,0,2,,2,"(6.171601,-75.427454)"
2013,Marzo,Iraq,368,0,10,,10,"(4.697144,-74.140516)"
2013,Marzo,Irán,364,3,4,,7,"(4.697144,-74.140516)"
2013,Marzo,República de Irlanda,372,12,10,,22,"(4.697144,-74.140516)"
2013,Marzo,Islandia,352,2,0,,2,"(10.445761,-75.516429)"
2013,Marzo,Islandia,352,1,0,,1,"(3.541112,-76.384584)"
2013,Marzo,Islandia,352,6,1,,7,"(4.697144,-74.140516)"
2013,Marzo,Isla de Man,833,1,0,,1,"(10.886611,-74.776708)"
2013,Marzo,Israel,376,4,5,,9,"(3.541112,-76.384584)"
2013,Marzo,Israel,376,146,100,,246,"(4.697144,-74.140516)"
2013,Marzo,Israel,376,1,1,,2,"(4.815061,-75.736532)"
2013,Marzo,Israel,376,3,4,,7,"(6.171601,-75.427454)"
2013,Marzo,Italia,380,1,0,,1,"(10.886611,-74.776708)"
2013,Marzo,Italia,380,120,50,,170,"(3.541112,-76.384584)"
2013,Marzo,Italia,380,610,395,,1005,"(4.697144,-74.140516)"
2013,Marzo,Italia,380,48,28,,76,"(6.171601,-75.427454)"
2013,Marzo,Jamaica,388,5,8,,13,"(10.445761,-75.516429)"
2013,Marzo,Jamaica,388,7,8,,15,"(10.886611,-74.776708)"
2013,Marzo,Jamaica,388,1,2,,3,"(12.586067,-81.702563)"
2013,Marzo,Jamaica,388,12,9,,21,"(3.541112,-76.384584)"
2013,Marzo,Jamaica,388,61,54,,115,"(4.697144,-74.140516)"
2013,Marzo,Jamaica,388,4,1,,5,"(4.815061,-75.736532)"
2013,Marzo,Jamaica,388,8,9,,17,"(6.171601,-75.427454)"
2013,Marzo,Jamaica,388,2,0,,2,"(7.128456,-73.183637)"
2013,Marzo,Jamaica,388,0,3,,3,"(7.927209,-72.507910)"
2013,Marzo,Islas Marianas del Norte,580,0,1,,1,"(3.541112,-76.384584)"
2013,Marzo,Japón,392,1,1,,2,"(10.445761,-75.516429)"
2013,Marzo,Japón,392,5,2,,7,"(3.541112,-76.384584)"
2013,Marzo,Japón,392,60,64,,124,"(4.697144,-74.140516)"
2013,Marzo,Japón,392,8,5,,13,"(6.171601,-75.427454)"
2013,Marzo,Jordania,400,0,3,,3,"(4.697144,-74.140516)"
2013,Marzo,Kazajistán,398,2,0,,2,"(4.697144,-74.140516)"
2013,Marzo,Kenia,404,0,1,,1,"(4.697144,-74.140516)"
2013,Marzo,Kuwait,414,2,1,,3,"(4.697144,-74.140516)"
2013,Marzo,Letonia,428,1,1,,2,"(4.697144,-74.140516)"
2013,Marzo,Lituania,440,0,20,,20,"(4.697144,-74.140516)"
2013,Marzo,Líbano,422,9,10,,19,"(4.697144,-74.140516)"
2013,Marzo,Libia,434,1,1,,2,"(4.697144,-74.140516)"
2013,Marzo,Luxemburgo,442,1,0,,1,"(3.541112,-76.384584)"
2013,Marzo,Luxemburgo,442,2,2,,4,"(4.697144,-74.140516)"
2013,Marzo,Macedonia,807,0,1,,1,"(4.697144,-74.140516)"
2013,Marzo,Madagascar,450,1,1,,2,"(4.697144,-74.140516)"
2013,Marzo,Malasia,458,0,1,,1,"(10.886611,-74.776708)"
2013,Marzo,Malasia,458,7,14,,21,"(4.697144,-74.140516)"
2013,Marzo,Malta,470,10,1,,11,"(4.697144,-74.140516)"
2013,Marzo,Marruecos,504,5,4,,9,"(4.697144,-74.140516)"
2013,Marzo,Mauricio,480,2,1,,3,"(6.171601,-75.427454)"
2013,Marzo,Mauritania,478,0,1,,1,"(4.697144,-74.140516)"
2013,Marzo,Mauritania,478,2,0,,2,"(6.171601,-75.427454)"
2013,Marzo,Martinica/Departamento de Ultramar Francés,474,1,1,,2,"(4.697144,-74.140516)"
2013,Marzo,México,484,1,2,,3,"(0.814836,-77.662532)"
2013,Marzo,México,484,62,67,,129,"(10.445761,-75.516429)"
2013,Marzo,México,484,143,101,,244,"(10.886611,-74.776708)"
2013,Marzo,México,484,570,507,,1077,"(3.541112,-76.384584)"
2013,Marzo,México,484,6117,5953,,12070,"(4.697144,-74.140516)"
2013,Marzo,México,484,109,91,,200,"(4.815061,-75.736532)"
2013,Marzo,México,484,949,783,,1732,"(6.171601,-75.427454)"
2013,Marzo,México,484,72,63,,135,"(7.128456,-73.183637)"
2013,Marzo,México,484,23,20,,43,"(7.927209,-72.507910)"
2013,Marzo,Mónaco,492,2,1,,3,"(4.697144,-74.140516)"
2013,Marzo,Mónaco,492,0,1,,1,"(6.171601,-75.427454)"
2013,Marzo,Mongolia,496,0,1,,1,"(4.697144,-74.140516)"
2013,Marzo,Mozambique,508,0,4,,4,"(4.697144,-74.140516)"
2013,Marzo,Nepal,524,0,2,,2,"(7.818934,-72.453226)"
2013,Marzo,Nicaragua,558,0,1,,1,"(10.445761,-75.516429)"
2013,Marzo,Nicaragua,558,1,4,,5,"(10.886611,-74.776708)"
2013,Marzo,Nicaragua,558,2,0,,2,"(12.586067,-81.702563)"
2013,Marzo,Nicaragua,558,6,4,,10,"(3.541112,-76.384584)"
2013,Marzo,Nicaragua,558,35,60,,95,"(4.697144,-74.140516)"
2013,Marzo,Nicaragua,558,1,1,,2,"(4.815061,-75.736532)"
2013,Marzo,Nicaragua,558,6,10,,16,"(6.171601,-75.427454)"
2013,Marzo,Nicaragua,558,0,1,,1,"(7.927209,-72.507910)"
2013,Marzo,Nigeria,566,1,15,,16,"(4.697144,-74.140516)"
2013,Marzo,Níger,562,1,0,,1,"(4.697144,-74.140516)"
2013,Marzo,Noruega,578,2,0,,2,"(10.445761,-75.516429)"
2013,Marzo,Noruega,578,1,0,,1,"(3.541112,-76.384584)"
2013,Marzo,Noruega,578,1,0,,1,"(4.452882,-75.766298)"
2013,Marzo,Noruega,578,17,15,,32,"(4.697144,-74.140516)"
2013,Marzo,Nueva Caledonia/Territorio francés,540,0,1,,1,"(4.697144,-74.140516)"
2013,Marzo,Nueva Zelanda,554,1,0,,1,"(10.886611,-74.776708)"
2013,Marzo,Nueva Zelanda,554,1,0,,1,"(3.541112,-76.384584)"
2013,Marzo,Nueva Zelanda,554,19,18,,37,"(4.697144,-74.140516)"
2013,Marzo,Nueva Zelanda,554,3,3,,6,"(6.171601,-75.427454)"
2013,Marzo,Omán,512,1,4,,5,"(4.697144,-74.140516)"
2013,Marzo,Papúa Nueva Guinea,598,0,6,,6,"(4.697144,-74.140516)"
2013,Marzo,Papúa Nueva Guinea,598,1,0,,1,"(6.171601,-75.427454)"
2013,Marzo,Panamá,591,39,101,,140,"(10.408582,-75.538003)"
2013,Marzo,Panamá,591,415,430,,845,"(10.445761,-75.516429)"
2013,Marzo,Panamá,591,852,796,,1648,"(10.886611,-74.776708)"
2013,Marzo,Panamá,591,0,1,,1,"(10.971302,-74.765397)"
2013,Marzo,Panamá,591,0,10,,10,"(11.247723,-74.213989)"
2013,Marzo,Panamá,591,42,60,,102,"(12.586067,-81.702563)"
2013,Marzo,Panamá,591,0,16,,16,"(13.3387613,-81.372937)"
2013,Marzo,Panamá,591,2004,1815,,3819,"(3.541112,-76.384584)"
2013,Marzo,Panamá,591,6382,6936,,13318,"(4.697144,-74.140516)"
2013,Marzo,Panamá,591,586,489,,1075,"(4.815061,-75.736532)"
2013,Marzo,Panamá,591,2129,2148,,4277,"(6.171601,-75.427454)"
2013,Marzo,Panamá,591,2,7,,9,"(6.228046,-77.404104)"
2013,Marzo,Panamá,591,180,194,,374,"(7.128456,-73.183637)"
2013,Marzo,Panamá,591,203,197,,400,"(7.927209,-72.507910)"
2013,Marzo,Panamá,591,80,151,,231,"(8.635765,-77.346578)"
2013,Marzo,Paraguay,600,0,1,,1,"(10.445761,-75.516429)"
2013,Marzo,Paraguay,600,1,3,,4,"(10.886611,-74.776708)"
2013,Marzo,Paraguay,600,10,13,,23,"(3.541112,-76.384584)"
2013,Marzo,Paraguay,600,35,129,,164,"(4.697144,-74.140516)"
2013,Marzo,Paraguay,600,0,1,,1,"(4.815061,-75.736532)"
2013,Marzo,Paraguay,600,2,6,,8,"(6.171601,-75.427454)"
2013,Marzo,Paraguay,600,2,6,,8,"(7.128456,-73.183637)"
2013,Marzo,Paraguay,600,1,0,,1,"(7.927209,-72.507910)"
2013,Marzo,Perú,604,61,106,,167,"(-4.197703,-69.941278)"
2013,Marzo,Perú,604,45,60,,105,"(0.814836,-77.662532)"
2013,Marzo,Perú,604,16,15,,31,"(10.445761,-75.516429)"
2013,Marzo,Perú,604,21,16,,37,"(10.886611,-74.776708)"
2013,Marzo,Perú,604,274,266,,540,"(3.541112,-76.384584)"
2013,Marzo,Perú,604,4030,4683,,8713,"(4.697144,-74.140516)"
2013,Marzo,Perú,604,29,20,,49,"(4.815061,-75.736532)"
2013,Marzo,Perú,604,357,383,,740,"(6.171601,-75.427454)"
2013,Marzo,Perú,604,6,10,,16,"(7.128456,-73.183637)"
2013,Marzo,Perú,604,6,1,,7,"(7.927209,-72.507910)"
2013,Marzo,Palestina,99999,0,1,,1,"(4.697144,-74.140516)"
2013,Marzo,Palestina,99999,1,0,,1,"(6.171601,-75.427454)"
2013,Marzo,Polonia,616,10,20,,30,"(4.697144,-74.140516)"
2013,Marzo,Polonia,616,1,0,,1,"(6.171601,-75.427454)"
2013,Marzo,Portugal,620,4,4,,8,"(3.541112,-76.384584)"
2013,Marzo,Portugal,620,26,24,,50,"(4.697144,-74.140516)"
2013,Marzo,Portugal,620,1,1,,2,"(6.171601,-75.427454)"
2013,Marzo,Puerto Rico/Territorio de Estados Unidos,630,6,10,,16,"(10.445761,-75.516429)"
2013,Marzo,Puerto Rico/Territorio de Estados Unidos,630,20,15,,35,"(10.886611,-74.776708)"
2013,Marzo,Puerto Rico/Territorio de Estados Unidos,630,2,0,,2,"(12.586067,-81.702563)"
2013,Marzo,Puerto Rico/Territorio de Estados Unidos,630,39,54,,93,"(3.541112,-76.384584)"
2013,Marzo,Puerto Rico/Territorio de Estados Unidos,630,113,125,,238,"(4.697144,-74.140516)"
2013,Marzo,Puerto Rico/Territorio de Estados Unidos,630,12,3,,15,"(4.815061,-75.736532)"
2013,Marzo,Puerto Rico/Territorio de Estados Unidos,630,42,41,,83,"(6.171601,-75.427454)"
2013,Marzo,Puerto Rico/Territorio de Estados Unidos,630,1,1,,2,"(7.128456,-73.183637)"
2013,Marzo,Qatar,634,4,6,,10,"(4.697144,-74.140516)"
2013,Marzo,Qatar,634,1,0,,1,"(6.171601,-75.427454)"
2013,Marzo,Reino Unido de Gran Bretaña e Irlanda del Norte,826,1,1,,2,"(10.445761,-75.516429)"
2013,Marzo,Reino Unido de Gran Bretaña e Irlanda del Norte,826,2,0,,2,"(10.886611,-74.776708)"
2013,Marzo,Reino Unido de Gran Bretaña e Irlanda del Norte,826,51,53,,104,"(3.541112,-76.384584)"
2013,Marzo,Reino Unido de Gran Bretaña e Irlanda del Norte,826,670,542,,1212,"(4.697144,-74.140516)"
2013,Marzo,Reino Unido de Gran Bretaña e Irlanda del Norte,826,1,0,,1,"(4.815061,-75.736532)"
2013,Marzo,Reino Unido de Gran Bretaña e Irlanda del Norte,826,40,20,,60,"(6.171601,-75.427454)"
2013,Marzo,Macedonia,807,0,1,,1,"(6.171601,-75.427454)"
2013,Marzo,Federación de Rusia,643,14,33,,47,"(4.697144,-74.140516)"
2013,Marzo,Federación de Rusia,643,0,2,,2,"(6.171601,-75.427454)"
2013,Marzo,República Dominicana,214,7,25,,32,"(10.445761,-75.516429)"
2013,Marzo,República Dominicana,214,40,62,,102,"(10.886611,-74.776708)"
2013,Marzo,República Dominicana,214,0,1,,1,"(12.586067,-81.702563)"
2013,Marzo,República Dominicana,214,89,64,,153,"(3.541112,-76.384584)"
2013,Marzo,República Dominicana,214,1401,1422,,2823,"(4.697144,-74.140516)"
2013,Marzo,República Dominicana,214,41,27,,68,"(4.815061,-75.736532)"
2013,Marzo,República Dominicana,214,170,162,,332,"(6.171601,-75.427454)"
2013,Marzo,República Dominicana,214,10,9,,19,"(7.128456,-73.183637)"
2013,Marzo,República Dominicana,214,6,7,,13,"(7.927209,-72.507910)"
2013,Marzo,Reunión,638,0,1,,1,"(4.697144,-74.140516)"
2013,Marzo,Rumania,642,1,6,,7,"(4.697144,-74.140516)"
2013,Marzo,Rwanda,646,0,1,,1,"(4.697144,-74.140516)"
2013,Marzo,Sahara Occidental/Desierto Sahara,732,1,0,,1,"(4.697144,-74.140516)"
2013,Marzo,San Marino,674,0,1,,1,"(6.171601,-75.427454)"
2013,Marzo,Santa Lucia,662,1,0,,1,"(4.697144,-74.140516)"
2013,Marzo,Senegal,686,5,16,,21,"(4.697144,-74.140516)"
2013,Marzo,Serbia,688,1,0,,1,"(4.697144,-74.140516)"
2013,Marzo,Sierra Leona,694,1,0,,1,"(3.541112,-76.384584)"
2013,Marzo,Singapur,702,1,0,,1,"(3.541112,-76.384584)"
2013,Marzo,Singapur,702,19,23,,42,"(4.697144,-74.140516)"
2013,Marzo,Sri Lanka,144,1,1,,2,"(4.697144,-74.140516)"
2013,Marzo,Sudáfrica,710,33,24,,57,"(4.697144,-74.140516)"
2013,Marzo,Sudáfrica,710,2,0,,2,"(4.815061,-75.736532)"
2013,Marzo,Suecia,752,5,2,,7,"(10.445761,-75.516429)"
2013,Marzo,Suecia,752,2,4,,6,"(3.541112,-76.384584)"
2013,Marzo,Suecia,752,57,40,,97,"(4.697144,-74.140516)"
2013,Marzo,Suecia,752,3,1,,4,"(6.171601,-75.427454)"
2013,Marzo,Suiza,756,27,17,,44,"(3.541112,-76.384584)"
2013,Marzo,Suiza,756,188,147,,335,"(4.697144,-74.140516)"
2013,Marzo,Suiza,756,13,5,,18,"(6.171601,-75.427454)"
2013,Marzo,Surinam,740,1,7,,8,"(10.886611,-74.776708)"
2013,Marzo,Surinam,740,1,3,,4,"(4.697144,-74.140516)"
2013,Marzo,Surinam,740,0,1,,1,"(6.171601,-75.427454)"
2013,Marzo,Taiwán,158,4,6,,10,"(4.697144,-74.140516)"
2013,Marzo,Taiwán,158,0,1,,1,"(6.171601,-75.427454)"
2013,Marzo,Tailandia,764,12,18,,30,"(4.697144,-74.140516)"
2013,Marzo,Trinidad y Tobago,780,1,3,,4,"(10.445761,-75.516429)"
2013,Marzo,Trinidad y Tobago,780,3,5,,8,"(10.886611,-74.776708)"
2013,Marzo,Trinidad y Tobago,780,7,13,,20,"(3.541112,-76.384584)"
2013,Marzo,Trinidad y Tobago,780,14,58,,72,"(4.697144,-74.140516)"
2013,Marzo,Trinidad y Tobago,780,1,2,,3,"(4.815061,-75.736532)"
2013,Marzo,Trinidad y Tobago,780,13,6,,19,"(6.171601,-75.427454)"
2013,Marzo,Trinidad y Tobago,780,4,1,,5,"(7.128456,-73.183637)"
2013,Marzo,Trinidad y Tobago,780,5,1,,6,"(7.927209,-72.507910)"
2013,Marzo,Túnez,788,1,4,,5,"(4.697144,-74.140516)"
2013,Marzo,Turquía,792,42,38,,80,"(4.697144,-74.140516)"
2013,Marzo,Turquía,792,0,1,,1,"(6.171601,-75.427454)"
2013,Marzo,Ucrania,804,0,1,,1,"(4.697144,-74.140516)"
2013,Marzo,Uruguay,858,2,0,,2,"(10.445761,-75.516429)"
2013,Marzo,Uruguay,858,2,0,,2,"(10.886611,-74.776708)"
2013,Marzo,Uruguay,858,7,7,,14,"(3.541112,-76.384584)"
2013,Marzo,Uruguay,858,64,115,,179,"(4.697144,-74.140516)"
2013,Marzo,Uruguay,858,15,15,,30,"(6.171601,-75.427454)"
2013,Marzo,Uzbekistán,860,0,1,,1,"(4.697144,-74.140516)"
2013,Marzo,Vanuatu,548,1,0,,1,"(7.818934,-72.453226)"
2013,Marzo,Venezuela,862,13,12,,25,"(10.445761,-75.516429)"
2013,Marzo,Venezuela,862,10,63,,73,"(10.886611,-74.776708)"
2013,Marzo,Venezuela,862,10271,8962,,19233,"(11.360009,-72.129330)"
2013,Marzo,Venezuela,862,0,2,,2,"(12.586067,-81.702563)"
2013,Marzo,Venezuela,862,16,21,,37,"(3.541112,-76.384584)"
2013,Marzo,Venezuela,862,0,1,,1,"(4.452882,-75.766298)"
2013,Marzo,Venezuela,862,2123,2534,,4657,"(4.697144,-74.140516)"
2013,Marzo,Venezuela,862,10,4,,14,"(4.815061,-75.736532)"
2013,Marzo,Venezuela,862,319,306,,625,"(6.171601,-75.427454)"
2013,Marzo,Venezuela,862,456,510,,966,"(6.185799,-67.483929)"
2013,Marzo,Venezuela,862,2116,2053,,4169,"(7.088729,-70.740253)"
2013,Marzo,Venezuela,862,2,3,,5,"(7.128456,-73.183637)"
2013,Marzo,Venezuela,862,10928,10687,,21615,"(7.818934,-72.453226)"
2013,Marzo,Venezuela,862,9,17,,26,"(7.927209,-72.507910)"
2013,Marzo,Vietnam,704,3,5,,8,"(4.697144,-74.140516)"
2013,Marzo,Desconocido,99999,5,17,,22,"(4.697144,-74.140516)"
2013,Abril,Afganistán,4,1,38,,39,"(4.697144,-74.140516)"
2013,Abril,Alemania,276,1,1,,2,"(0.814836,-77.662532)"
2013,Abril,Alemania,276,1,0,,1,"(10.445761,-75.516429)"
2013,Abril,Alemania,276,1,2,,3,"(10.886611,-74.776708)"
2013,Abril,Alemania,276,23,17,,40,"(3.541112,-76.384584)"
2013,Abril,Alemania,276,1032,1150,,2182,"(4.697144,-74.140516)"
2013,Abril,Alemania,276,7,3,,10,"(6.171601,-75.427454)"
2013,Abril,Angola,24,0,1,,1,"(10.886611,-74.776708)"
2013,Abril,Angola,24,1,0,,1,"(3.541112,-76.384584)"
2013,Abril,Angola,24,1,7,,8,"(4.697144,-74.140516)"
2013,Abril,Antigua y Barbuda,28,0,1,,1,"(10.445761,-75.516429)"
2013,Abril,Antigua y Barbuda,28,1,1,,2,"(4.697144,-74.140516)"
2013,Abril,Países Bajos,528,156,132,,288,"(10.408582,-75.538003)"
2013,Abril,Países Bajos,528,0,1,,1,"(10.445761,-75.516429)"
2013,Abril,Países Bajos,528,3,0,,3,"(10.886611,-74.776708)"
2013,Abril,Países Bajos,528,41,11,,52,"(3.541112,-76.384584)"
2013,Abril,Países Bajos,528,129,92,,221,"(4.697144,-74.140516)"
2013,Abril,Países Bajos,528,1,0,,1,"(4.815061,-75.736532)"
2013,Abril,Países Bajos,528,39,30,,69,"(6.171601,-75.427454)"
2013,Abril,Arabia Saudita,682,0,1,,1,"(10.408582,-75.538003)"
2013,Abril,Arabia Saudita,682,0,1,,1,"(10.445761,-75.516429)"
2013,Abril,Arabia Saudita,682,13,35,,48,"(4.697144,-74.140516)"
2013,Abril,Argelia,12,3,7,,10,"(4.697144,-74.140516)"
2013,Abril,Argelia,12,0,1,,1,"(6.171601,-75.427454)"
2013,Abril,Argentina,32,13,16,,29,"(0.814836,-77.662532)"
2013,Abril,Argentina,32,3,4,,7,"(10.445761,-75.516429)"
2013,Abril,Argentina,32,7,6,,13,"(10.886611,-74.776708)"
2013,Abril,Argentina,32,61,69,,130,"(3.541112,-76.384584)"
2013,Abril,Argentina,32,2275,2362,,4637,"(4.697144,-74.140516)"
2013,Abril,Argentina,32,1,2,,3,"(4.815061,-75.736532)"
2013,Abril,Argentina,32,142,122,,264,"(6.171601,-75.427454)"
2013,Abril,Argentina,32,2,2,,4,"(7.128456,-73.183637)"
2013,Abril,República de Armenia,51,1,0,,1,"(4.697144,-74.140516)"
2013,Abril,Aruba,533,1079,746,,1825,"(10.408582,-75.538003)"
2013,Abril,Aruba,533,4,3,,7,"(10.886611,-74.776708)"
2013,Abril,Aruba,533,67,53,,120,"(11.528919,-72.919681)"
2013,Abril,Aruba,533,13,7,,20,"(3.541112,-76.384584)"
2013,Abril,Aruba,533,62,48,,110,"(4.452882,-75.766298)"
2013,Abril,Aruba,533,680,596,,1276,"(4.697144,-74.140516)"
2013,Abril,Aruba,533,2,2,,4,"(4.815061,-75.736532)"
2013,Abril,Aruba,533,67,40,,107,"(6.171601,-75.427454)"
2013,Abril,Aruba,533,0,11,,11,"(7.128456,-73.183637)"
2013,Abril,Aruba,533,1,0,,1,"(7.927209,-72.507910)"
2013,Abril,Australia,36,4,2,,6,"(10.445761,-75.516429)"
2013,Abril,Australia,36,1,1,,2,"(10.886611,-74.776708)"
2013,Abril,Australia,36,12,6,,18,"(3.541112,-76.384584)"
2013,Abril,Australia,36,156,142,,298,"(4.697144,-74.140516)"
2013,Abril,Australia,36,1,2,,3,"(4.815061,-75.736532)"
2013,Abril,Australia,36,28,28,,56,"(6.171601,-75.427454)"
2013,Abril,Australia,36,1,0,,1,"(7.128456,-73.183637)"
2013,Abril,Austria,40,1,0,,1,"(3.541112,-76.384584)"
2013,Abril,Austria,40,29,31,,60,"(4.697144,-74.140516)"
2013,Abril,Austria,40,1,2,,3,"(6.171601,-75.427454)"
2013,Abril,Austria,40,3,0,,3,"(8.635765,-77.346578)"
2013,Abril,Azerbaiyán,31,1,2,,3,"(4.697144,-74.140516)"
2013,Abril,Bahamas,44,0,1,,1,"(10.445761,-75.516429)"
2013,Abril,Bahamas,44,1,0,,1,"(10.886611,-74.776708)"
2013,Abril,Bahamas,44,15,8,,23,"(3.541112,-76.384584)"
2013,Abril,Bahamas,44,14,15,,29,"(4.697144,-74.140516)"
2013,Abril,Bahamas,44,2,1,,3,"(4.815061,-75.736532)"
2013,Abril,Bahamas,44,8,13,,21,"(6.171601,-75.427454)"
2013,Abril,Bahréin,48,2,1,,3,"(4.697144,-74.140516)"
2013,Abril,Bangladesh,50,1,2,,3,"(4.697144,-74.140516)"
2013,Abril,Barbados,52,0,1,,1,"(10.886611,-74.776708)"
2013,Abril,Barbados,52,2,12,,14,"(4.697144,-74.140516)"
2013,Abril,República de Belarús,112,0,1,,1,"(10.445761,-75.516429)"
2013,Abril,República de Belarús,112,2,3,,5,"(11.360009,-72.129330)"
2013,Abril,República de Belarús,112,2,1,,3,"(4.697144,-74.140516)"
2013,Abril,República de Belarús,112,0,1,,1,"(7.818934,-72.453226)"
2013,Abril,Bélgica,56,11,7,,18,"(3.541112,-76.384584)"
2013,Abril,Bélgica,56,76,48,,124,"(4.697144,-74.140516)"
2013,Abril,Bélgica,56,6,6,,12,"(6.171601,-75.427454)"
2013,Abril,Belice,84,3,2,,5,"(4.697144,-74.140516)"
2013,Abril,Belice,84,2,0,,2,"(6.171601,-75.427454)"
2013,Abril,Benín,204,0,2,,2,"(4.697144,-74.140516)"
2013,Abril,Bermudas/Territorio Británico de Ultramar,60,0,1,,1,"(10.886611,-74.776708)"
2013,Abril,Bermudas/Territorio Británico de Ultramar,60,1,0,,1,"(4.697144,-74.140516)"
2013,Abril,Bolivia,68,6,5,,11,"(0.814836,-77.662532)"
2013,Abril,Bolivia,68,0,1,,1,"(1.813928,-78.763924)"
2013,Abril,Bolivia,68,1,1,,2,"(10.445761,-75.516429)"
2013,Abril,Bolivia,68,1,2,,3,"(10.886611,-74.776708)"
2013,Abril,Bolivia,68,1,1,,2,"(12.586067,-81.702563)"
2013,Abril,Bolivia,68,15,35,,50,"(3.541112,-76.384584)"
2013,Abril,Bolivia,68,192,344,,536,"(4.697144,-74.140516)"
2013,Abril,Bolivia,68,2,0,,2,"(4.815061,-75.736532)"
2013,Abril,Bolivia,68,8,24,,32,"(6.171601,-75.427454)"
2013,Abril,Bosnia y Herzegovina,70,1,0,,1,"(4.697144,-74.140516)"
2013,Abril,Brasil,76,86,174,,260,"(-4.197703,-69.941278)"
2013,Abril,Brasil,76,0,1,,1,"(0.814836,-77.662532)"
2013,Abril,Brasil,76,2,6,,8,"(10.445761,-75.516429)"
2013,Abril,Brasil,76,1,3,,4,"(10.886611,-74.776708)"
2013,Abril,Brasil,76,0,1,,1,"(12.586067,-81.702563)"
2013,Abril,Brasil,76,20,43,,63,"(3.541112,-76.384584)"
2013,Abril,Brasil,76,1996,3173,,5169,"(4.697144,-74.140516)"
2013,Abril,Brasil,76,3,6,,9,"(4.815061,-75.736532)"
2013,Abril,Brasil,76,49,88,,137,"(6.171601,-75.427454)"
2013,Abril,Brasil,76,4,0,,4,"(7.128456,-73.183637)"
2013,Abril,Brasil,76,1,1,,2,"(7.927209,-72.507910)"
2013,Abril,Brunei Darussalam,96,0,1,,1,"(4.697144,-74.140516)"
2013,Abril,Bulgaria,100,1,0,,1,"(10.886611,-74.776708)"
2013,Abril,Bulgaria,100,2,0,,2,"(4.697144,-74.140516)"
2013,Abril,Cabo Verde,132,0,1,,1,"(0.814836,-77.662532)"
2013,Abril,Cabo Verde,132,1,0,,1,"(4.697144,-74.140516)"
2013,Abril,Islas Caimán/Territorio Británico de Ultramar,136,31,16,,47,"(12.586067,-81.702563)"
2013,Abril,Islas Caimán/Territorio Británico de Ultramar,136,1,0,,1,"(3.541112,-76.384584)"
2013,Abril,Islas Caimán/Territorio Británico de Ultramar,136,1,0,,1,"(4.697144,-74.140516)"
2013,Abril,Camboya,116,0,1,,1,"(4.697144,-74.140516)"
2013,Abril,Camerún,120,2,0,,2,"(4.697144,-74.140516)"
2013,Abril,Canadá,124,25,21,,46,"(10.445761,-75.516429)"
2013,Abril,Canadá,124,7,9,,16,"(10.886611,-74.776708)"
2013,Abril,Canadá,124,2,6,,8,"(12.586067,-81.702563)"
2013,Abril,Canadá,124,61,57,,118,"(3.541112,-76.384584)"
2013,Abril,Canadá,124,8,11,,19,"(4.452882,-75.766298)"
2013,Abril,Canadá,124,1136,1082,,2218,"(4.697144,-74.140516)"
2013,Abril,Canadá,124,1,2,,3,"(4.815061,-75.736532)"
2013,Abril,Canadá,124,142,121,,263,"(6.171601,-75.427454)"
2013,Abril,Canadá,124,2,0,,2,"(7.128456,-73.183637)"
2013,Abril,Chad,148,0,1,,1,"(4.697144,-74.140516)"
2013,Abril,España,724,1,0,,1,"(0.814836,-77.662532)"
2013,Abril,España,724,1,1,,2,"(10.445761,-75.516429)"
2013,Abril,España,724,1,0,,1,"(10.886611,-74.776708)"
2013,Abril,España,724,1588,1088,,2676,"(3.541112,-76.384584)"
2013,Abril,España,724,1,0,,1,"(4.452882,-75.766298)"
2013,Abril,España,724,5155,4279,,9434,"(4.697144,-74.140516)"
2013,Abril,España,724,0,1,,1,"(4.815061,-75.736532)"
2013,Abril,España,724,701,484,,1185,"(6.171601,-75.427454)"
2013,Abril,España,724,1,0,,1,"(7.128456,-73.183637)"
2013,Abril,República Democrática del Congo,180,1,4,,5,"(4.697144,-74.140516)"
2013,Abril,República Democrática del Congo,180,0,1,,1,"(6.171601,-75.427454)"
2013,Abril,República de Corea,410,10,11,,21,"(4.697144,-74.140516)"
2013,Abril,República de Corea,410,4,2,,6,"(6.171601,-75.427454)"
2013,Abril,Costa de Marfil,384,0,1,,1,"(4.697144,-74.140516)"
2013,Abril,Costa Rica,188,6,15,,21,"(10.445761,-75.516429)"
2013,Abril,Costa Rica,188,25,22,,47,"(10.886611,-74.776708)"
2013,Abril,Costa Rica,188,4,4,,8,"(12.586067,-81.702563)"
2013,Abril,Costa Rica,188,59,68,,127,"(3.541112,-76.384584)"
2013,Abril,Costa Rica,188,741,958,,1699,"(4.697144,-74.140516)"
2013,Abril,Costa Rica,188,7,7,,14,"(4.815061,-75.736532)"
2013,Abril,Costa Rica,188,145,156,,301,"(6.171601,-75.427454)"
2013,Abril,Costa Rica,188,3,2,,5,"(7.128456,-73.183637)"
2013,Abril,Costa Rica,188,0,1,,1,"(7.927209,-72.507910)"
2013,Abril,Croacia,191,3,3,,6,"(4.697144,-74.140516)"
2013,Abril,Croacia,191,0,1,,1,"(6.171601,-75.427454)"
2013,Abril,Cuba,192,21,20,,41,"(10.445761,-75.516429)"
2013,Abril,Cuba,192,11,20,,31,"(10.886611,-74.776708)"
2013,Abril,Cuba,192,1,0,,1,"(12.586067,-81.702563)"
2013,Abril,Cuba,192,51,47,,98,"(3.541112,-76.384584)"
2013,Abril,Cuba,192,635,574,,1209,"(4.697144,-74.140516)"
2013,Abril,Cuba,192,10,6,,16,"(4.815061,-75.736532)"
2013,Abril,Cuba,192,96,79,,175,"(6.171601,-75.427454)"
2013,Abril,Cuba,192,1,4,,5,"(7.128456,-73.183637)"
2013,Abril,Cuba,192,4,4,,8,"(7.927209,-72.507910)"
2013,Abril,Curazao,99999,1,0,,1,"(10.886611,-74.776708)"
2013,Abril,Curazao,99999,0,1,,1,"(11.247723,-74.213989)"
2013,Abril,Curazao,99999,9,2,,11,"(3.541112,-76.384584)"
2013,Abril,Curazao,99999,0,1,,1,"(4.452882,-75.766298)"
2013,Abril,Curazao,99999,352,383,,735,"(4.697144,-74.140516)"
2013,Abril,Curazao,99999,2,0,,2,"(4.815061,-75.736532)"
2013,Abril,Curazao,99999,115,67,,182,"(6.171601,-75.427454)"
2013,Abril,Curazao,99999,0,2,,2,"(7.927209,-72.507910)"
2013,Abril,República Checa,203,10,8,,18,"(4.697144,-74.140516)"
2013,Abril,Chile,152,39,51,,90,"(0.814836,-77.662532)"
2013,Abril,Chile,152,3,4,,7,"(10.445761,-75.516429)"
2013,Abril,Chile,152,33,17,,50,"(10.886611,-74.776708)"
2013,Abril,Chile,152,365,299,,664,"(3.541112,-76.384584)"
2013,Abril,Chile,152,2303,2440,,4743,"(4.697144,-74.140516)"
2013,Abril,Chile,152,53,63,,116,"(4.815061,-75.736532)"
2013,Abril,Chile,152,118,112,,230,"(6.171601,-75.427454)"
2013,Abril,Chile,152,9,9,,18,"(7.128456,-73.183637)"
2013,Abril,China,156,0,1,,1,"(10.445761,-75.516429)"
2013,Abril,China,156,1,17,,18,"(10.886611,-74.776708)"
2013,Abril,China,156,11,35,,46,"(3.541112,-76.384584)"
2013,Abril,China,156,302,792,,1094,"(4.697144,-74.140516)"
2013,Abril,China,156,0,4,,4,"(4.815061,-75.736532)"
2013,Abril,China,156,26,48,,74,"(6.171601,-75.427454)"
2013,Abril,China,156,3,4,,7,"(7.128456,-73.183637)"
2013,Abril,Chipre,196,0,1,,1,"(4.697144,-74.140516)"
2013,Abril,Dinamarca,208,2,0,,2,"(3.541112,-76.384584)"
2013,Abril,Dinamarca,208,27,9,,36,"(4.697144,-74.140516)"
2013,Abril,Dinamarca,208,0,1,,1,"(6.171601,-75.427454)"
2013,Abril,Dominica,212,0,1,,1,"(4.697144,-74.140516)"
2013,Abril,Ecuador,218,295,426,,721,"(0.25129,-76.875963)"
2013,Abril,Ecuador,218,4932,5912,,10844,"(0.814836,-77.662532)"
2013,Abril,Ecuador,218,111,110,,221,"(1.813928,-78.763924)"
2013,Abril,Ecuador,218,3,7,,10,"(10.445761,-75.516429)"
2013,Abril,Ecuador,218,5,6,,11,"(10.886611,-74.776708)"
2013,Abril,Ecuador,218,494,520,,1014,"(3.541112,-76.384584)"
2013,Abril,Ecuador,218,1863,3746,,5609,"(4.697144,-74.140516)"
2013,Abril,Ecuador,218,4,7,,11,"(4.815061,-75.736532)"
2013,Abril,Ecuador,218,300,340,,640,"(6.171601,-75.427454)"
2013,Abril,Ecuador,218,2,2,,4,"(7.128456,-73.183637)"
2013,Abril,Ecuador,218,0,1,,1,"(7.927209,-72.507910)"
2013,Abril,Egipto,818,74,176,,250,"(4.697144,-74.140516)"
2013,Abril,El Salvador,222,0,6,,6,"(10.445761,-75.516429)"
2013,Abril,El Salvador,222,0,2,,2,"(10.886611,-74.776708)"
2013,Abril,El Salvador,222,83,94,,177,"(3.541112,-76.384584)"
2013,Abril,El Salvador,222,522,676,,1198,"(4.697144,-74.140516)"
2013,Abril,El Salvador,222,0,1,,1,"(4.815061,-75.736532)"
2013,Abril,El Salvador,222,107,127,,234,"(6.171601,-75.427454)"
2013,Abril,El Salvador,222,0,1,,1,"(7.128456,-73.183637)"
2013,Abril,Emiratos Árabes,784,1,1,,2,"(3.541112,-76.384584)"
2013,Abril,Emiratos Árabes,784,61,166,,227,"(4.697144,-74.140516)"
2013,Abril,Emiratos Árabes,784,2,1,,3,"(6.171601,-75.427454)"
2013,Abril,Eritrea,232,1,0,,1,"(4.697144,-74.140516)"
2013,Abril,Eslovaquia,703,1,1,,2,"(4.697144,-74.140516)"
2013,Abril,Eslovenia,705,0,1,,1,"(4.697144,-74.140516)"
2013,Abril,Estados Unidos de América,840,0,1,,1,"(10.408582,-75.538003)"
2013,Abril,Estados Unidos de América,840,1558,1331,,2889,"(10.445761,-75.516429)"
2013,Abril,Estados Unidos de América,840,1487,1234,,2721,"(10.886611,-74.776708)"
2013,Abril,Estados Unidos de América,840,17,17,,34,"(12.586067,-81.702563)"
2013,Abril,Estados Unidos de América,840,3703,2821,,6524,"(3.541112,-76.384584)"
2013,Abril,Estados Unidos de América,840,504,432,,936,"(4.452882,-75.766298)"
2013,Abril,Estados Unidos de América,840,24960,23184,,48144,"(4.697144,-74.140516)"
2013,Abril,Estados Unidos de América,840,304,256,,560,"(4.815061,-75.736532)"
2013,Abril,Estados Unidos de América,840,5875,4622,,10497,"(6.171601,-75.427454)"
2013,Abril,Estados Unidos de América,840,100,72,,172,"(7.128456,-73.183637)"
2013,Abril,Estados Unidos de América,840,24,10,,34,"(7.927209,-72.507910)"
2013,Abril,Estados Unidos de América,840,0,1,,1,"(8.635765,-77.346578)"
2013,Abril,Estonia,233,1,0,,1,"(3.541112,-76.384584)"
2013,Abril,Estonia,233,1,1,,2,"(4.697144,-74.140516)"
2013,Abril,Etiopia,231,0,3,,3,"(4.697144,-74.140516)"
2013,Abril,Filipinas,608,2,1,,3,"(4.697144,-74.140516)"
2013,Abril,Filipinas,608,0,1,,1,"(6.171601,-75.427454)"
2013,Abril,Finlandia,246,1,0,,1,"(3.541112,-76.384584)"
2013,Abril,Finlandia,246,1,3,,4,"(4.697144,-74.140516)"
2013,Abril,Francia,250,48,58,,106,"(3.541112,-76.384584)"
2013,Abril,Francia,250,922,914,,1836,"(4.697144,-74.140516)"
2013,Abril,Francia,250,14,23,,37,"(6.171601,-75.427454)"
2013,Abril,Gabón,266,0,4,,4,"(4.697144,-74.140516)"
2013,Abril,Ghana,288,0,3,,3,"(4.697144,-74.140516)"
2013,Abril,Grecia,300,27,9,,36,"(4.697144,-74.140516)"
2013,Abril,Guatemala,320,12,16,,28,"(10.445761,-75.516429)"
2013,Abril,Guatemala,320,29,25,,54,"(10.886611,-74.776708)"
2013,Abril,Guatemala,320,39,47,,86,"(3.541112,-76.384584)"
2013,Abril,Guatemala,320,208,329,,537,"(4.697144,-74.140516)"
2013,Abril,Guatemala,320,6,12,,18,"(4.815061,-75.736532)"
2013,Abril,Guatemala,320,57,98,,155,"(6.171601,-75.427454)"
2013,Abril,Guatemala,320,6,5,,11,"(7.128456,-73.183637)"
2013,Abril,Guatemala,320,1,1,,2,"(7.927209,-72.507910)"
2013,Abril,Guyana,328,0,2,,2,"(10.886611,-74.776708)"
2013,Abril,Guyana,328,1,0,,1,"(3.541112,-76.384584)"
2013,Abril,Guyana,328,2,2,,4,"(4.697144,-74.140516)"
2013,Abril,Guinea,324,0,7,,7,"(4.697144,-74.140516)"
2013,Abril,Guinea Ecuatorial,226,0,7,,7,"(4.697144,-74.140516)"
2013,Abril,Guinea Bissau,624,1,0,,1,"(4.697144,-74.140516)"
2013,Abril,Guadalupe/Territorio Francés,312,0,1,,1,"(4.697144,-74.140516)"
2013,Abril,Guayana Francesa/Departamento de Ultramar Francés,254,2,0,,2,"(4.697144,-74.140516)"
2013,Abril,Haití,332,1,4,,5,"(10.886611,-74.776708)"
2013,Abril,Haití,332,1,1,,2,"(12.586067,-81.702563)"
2013,Abril,Haití,332,2,4,,6,"(3.541112,-76.384584)"
2013,Abril,Haití,332,2,16,,18,"(4.697144,-74.140516)"
2013,Abril,Haití,332,0,1,,1,"(4.815061,-75.736532)"
2013,Abril,Haití,332,0,4,,4,"(6.171601,-75.427454)"
2013,Abril,Haití,332,1,1,,2,"(7.927209,-72.507910)"
2013,Abril,Honduras,340,4,3,,7,"(10.445761,-75.516429)"
2013,Abril,Honduras,340,1,10,,11,"(10.886611,-74.776708)"
2013,Abril,Honduras,340,0,1,,1,"(12.586067,-81.702563)"
2013,Abril,Honduras,340,12,42,,54,"(3.541112,-76.384584)"
2013,Abril,Honduras,340,48,121,,169,"(4.697144,-74.140516)"
2013,Abril,Honduras,340,4,3,,7,"(4.815061,-75.736532)"
2013,Abril,Honduras,340,28,67,,95,"(6.171601,-75.427454)"
2013,Abril,Honduras,340,0,4,,4,"(7.128456,-73.183637)"
2013,Abril,Honduras,340,0,1,,1,"(7.927209,-72.507910)"
2013,Abril,Hong Kong,344,0,2,,2,"(10.445761,-75.516429)"
2013,Abril,Hong Kong,344,1,0,,1,"(10.886611,-74.776708)"
2013,Abril,Hong Kong,344,3,6,,9,"(3.541112,-76.384584)"
2013,Abril,Hong Kong,344,47,175,,222,"(4.697144,-74.140516)"
2013,Abril,Hong Kong,344,1,6,,7,"(6.171601,-75.427454)"
2013,Abril,Hungría,348,4,4,,8,"(4.697144,-74.140516)"
2013,Abril,India,356,33,34,,67,"(4.697144,-74.140516)"
2013,Abril,India,356,1,4,,5,"(6.171601,-75.427454)"
2013,Abril,Indonesia,360,0,1,,1,"(10.445761,-75.516429)"
2013,Abril,Indonesia,360,0,1,,1,"(10.886611,-74.776708)"
2013,Abril,Indonesia,360,1,8,,9,"(4.697144,-74.140516)"
2013,Abril,Iraq,368,1,0,,1,"(3.541112,-76.384584)"
2013,Abril,Iraq,368,1,19,,20,"(4.697144,-74.140516)"
2013,Abril,Irán,364,2,0,,2,"(3.541112,-76.384584)"
2013,Abril,Irán,364,2,6,,8,"(4.697144,-74.140516)"
2013,Abril,República de Irlanda,372,0,3,,3,"(10.445761,-75.516429)"
2013,Abril,República de Irlanda,372,2,0,,2,"(3.541112,-76.384584)"
2013,Abril,República de Irlanda,372,13,7,,20,"(4.697144,-74.140516)"
2013,Abril,República de Irlanda,372,2,0,,2,"(6.171601,-75.427454)"
2013,Abril,Islandia,352,0,1,,1,"(4.697144,-74.140516)"
2013,Abril,Israel,376,8,2,,10,"(3.541112,-76.384584)"
2013,Abril,Israel,376,124,129,,253,"(4.697144,-74.140516)"
2013,Abril,Israel,376,1,0,,1,"(6.171601,-75.427454)"
2013,Abril,Italia,380,1,1,,2,"(10.445761,-75.516429)"
2013,Abril,Italia,380,1,0,,1,"(10.886611,-74.776708)"
2013,Abril,Italia,380,116,34,,150,"(3.541112,-76.384584)"
2013,Abril,Italia,380,564,400,,964,"(4.697144,-74.140516)"
2013,Abril,Italia,380,38,27,,65,"(6.171601,-75.427454)"
2013,Abril,Islas Christmas,162,1,0,,1,"(4.697144,-74.140516)"
2013,Abril,Jamaica,388,5,12,,17,"(10.445761,-75.516429)"
2013,Abril,Jamaica,388,0,3,,3,"(10.886611,-74.776708)"
2013,Abril,Jamaica,388,2,1,,3,"(12.586067,-81.702563)"
2013,Abril,Jamaica,388,4,4,,8,"(3.541112,-76.384584)"
2013,Abril,Jamaica,388,11,19,,30,"(4.697144,-74.140516)"
2013,Abril,Jamaica,388,1,4,,5,"(4.815061,-75.736532)"
2013,Abril,Jamaica,388,6,10,,16,"(6.171601,-75.427454)"
2013,Abril,Jamaica,388,2,2,,4,"(7.128456,-73.183637)"
2013,Abril,Japón,392,5,9,,14,"(3.541112,-76.384584)"
2013,Abril,Japón,392,47,48,,95,"(4.697144,-74.140516)"
2013,Abril,Japón,392,2,1,,3,"(4.815061,-75.736532)"
2013,Abril,Japón,392,6,8,,14,"(6.171601,-75.427454)"
2013,Abril,Jordania,400,7,5,,12,"(4.697144,-74.140516)"
2013,Abril,Kazajistán,398,0,1,,1,"(4.697144,-74.140516)"
2013,Abril,Kenia,404,1,8,,9,"(4.697144,-74.140516)"
2013,Abril,Kenia,404,0,2,,2,"(6.171601,-75.427454)"
2013,Abril,Kuwait,414,0,2,,2,"(4.697144,-74.140516)"
2013,Abril,Letonia,428,1,0,,1,"(4.697144,-74.140516)"
2013,Abril,Lituania,440,0,9,,9,"(4.697144,-74.140516)"
2013,Abril,Lituania,440,0,1,,1,"(6.171601,-75.427454)"
2013,Abril,Líbano,422,11,20,,31,"(4.697144,-74.140516)"
2013,Abril,Luxemburgo,442,5,5,,10,"(4.697144,-74.140516)"
2013,Abril,Malasia,458,8,14,,22,"(4.697144,-74.140516)"
2013,Abril,Malasia,458,1,2,,3,"(6.171601,-75.427454)"
2013,Abril,Malta,470,4,1,,5,"(4.697144,-74.140516)"
2013,Abril,Marruecos,504,10,6,,16,"(4.697144,-74.140516)"
2013,Abril,Mauricio,480,0,1,,1,"(4.697144,-74.140516)"
2013,Abril,Mauritania,478,0,1,,1,"(4.697144,-74.140516)"
2013,Abril,México,484,1,0,,1,"(0.814836,-77.662532)"
2013,Abril,México,484,27,27,,54,"(10.445761,-75.516429)"
2013,Abril,México,484,54,70,,124,"(10.886611,-74.776708)"
2013,Abril,México,484,8,3,,11,"(12.586067,-81.702563)"
2013,Abril,México,484,367,356,,723,"(3.541112,-76.384584)"
2013,Abril,México,484,4728,4987,,9715,"(4.697144,-74.140516)"
2013,Abril,México,484,72,59,,131,"(4.815061,-75.736532)"
2013,Abril,México,484,847,669,,1516,"(6.171601,-75.427454)"
2013,Abril,México,484,1,1,,2,"(7.088729,-70.740253)"
2013,Abril,México,484,62,54,,116,"(7.128456,-73.183637)"
2013,Abril,México,484,13,14,,27,"(7.927209,-72.507910)"
2013,Abril,Mónaco,492,1,2,,3,"(4.697144,-74.140516)"
2013,Abril,Mozambique,508,1,3,,4,"(4.697144,-74.140516)"
2013,Abril,Namibia,516,1,0,,1,"(4.697144,-74.140516)"
2013,Abril,Nicaragua,558,2,4,,6,"(10.445761,-75.516429)"
2013,Abril,Nicaragua,558,1,9,,10,"(10.886611,-74.776708)"
2013,Abril,Nicaragua,558,0,1,,1,"(12.586067,-81.702563)"
2013,Abril,Nicaragua,558,11,20,,31,"(3.541112,-76.384584)"
2013,Abril,Nicaragua,558,32,51,,83,"(4.697144,-74.140516)"
2013,Abril,Nicaragua,558,1,5,,6,"(4.815061,-75.736532)"
2013,Abril,Nicaragua,558,14,28,,42,"(6.171601,-75.427454)"
2013,Abril,Nicaragua,558,1,1,,2,"(7.128456,-73.183637)"
2013,Abril,Nigeria,566,3,15,,18,"(4.697144,-74.140516)"
2013,Abril,Nigeria,566,0,1,,1,"(6.171601,-75.427454)"
2013,Abril,Noruega,578,17,17,,34,"(4.697144,-74.140516)"
2013,Abril,Noruega,578,3,3,,6,"(6.171601,-75.427454)"
2013,Abril,Nueva Zelanda,554,17,14,,31,"(4.697144,-74.140516)"
2013,Abril,Nueva Zelanda,554,0,2,,2,"(6.171601,-75.427454)"
2013,Abril,Omán,512,1,2,,3,"(4.697144,-74.140516)"
2013,Abril,Papúa Nueva Guinea,598,2,7,,9,"(4.697144,-74.140516)"
2013,Abril,Pakistán,586,0,6,,6,"(4.697144,-74.140516)"
2013,Abril,Panamá,591,6,28,,34,"(10.408582,-75.538003)"
2013,Abril,Panamá,591,247,276,,523,"(10.445761,-75.516429)"
2013,Abril,Panamá,591,712,828,,1540,"(10.886611,-74.776708)"
2013,Abril,Panamá,591,0,2,,2,"(11.247723,-74.213989)"
2013,Abril,Panamá,591,57,62,,119,"(12.586067,-81.702563)"
2013,Abril,Panamá,591,1568,1644,,3212,"(3.541112,-76.384584)"
2013,Abril,Panamá,591,5294,6268,,11562,"(4.697144,-74.140516)"
2013,Abril,Panamá,591,483,448,,931,"(4.815061,-75.736532)"
2013,Abril,Panamá,591,1841,2004,,3845,"(6.171601,-75.427454)"
2013,Abril,Panamá,591,0,2,,2,"(6.228046,-77.404104)"
2013,Abril,Panamá,591,217,260,,477,"(7.128456,-73.183637)"
2013,Abril,Panamá,591,104,130,,234,"(7.927209,-72.507910)"
2013,Abril,Panamá,591,3,61,,64,"(8.066966,-76.735404)"
2013,Abril,Panamá,591,82,130,,212,"(8.635765,-77.346578)"
2013,Abril,Paraguay,600,0,1,,1,"(10.445761,-75.516429)"
2013,Abril,Paraguay,600,2,0,,2,"(10.886611,-74.776708)"
2013,Abril,Paraguay,600,2,13,,15,"(3.541112,-76.384584)"
2013,Abril,Paraguay,600,44,116,,160,"(4.697144,-74.140516)"
2013,Abril,Paraguay,600,1,0,,1,"(4.815061,-75.736532)"
2013,Abril,Paraguay,600,5,8,,13,"(6.171601,-75.427454)"
2013,Abril,Paraguay,600,0,1,,1,"(7.128456,-73.183637)"
2013,Abril,Perú,604,42,93,,135,"(-4.197703,-69.941278)"
2013,Abril,Perú,604,34,30,,64,"(0.814836,-77.662532)"
2013,Abril,Perú,604,5,12,,17,"(10.445761,-75.516429)"
2013,Abril,Perú,604,10,18,,28,"(10.886611,-74.776708)"
2013,Abril,Perú,604,1,0,,1,"(12.586067,-81.702563)"
2013,Abril,Perú,604,173,221,,394,"(3.541112,-76.384584)"
2013,Abril,Perú,604,2831,3867,,6698,"(4.697144,-74.140516)"
2013,Abril,Perú,604,13,20,,33,"(4.815061,-75.736532)"
2013,Abril,Perú,604,274,286,,560,"(6.171601,-75.427454)"
2013,Abril,Perú,604,2,3,,5,"(7.128456,-73.183637)"
2013,Abril,Perú,604,1,1,,2,"(7.927209,-72.507910)"
2013,Abril,Palestina,99999,0,1,,1,"(4.697144,-74.140516)"
2013,Abril,Palestina,99999,0,1,,1,"(6.171601,-75.427454)"
2013,Abril,Polonia,616,4,8,,12,"(4.697144,-74.140516)"
2013,Abril,Portugal,620,4,1,,5,"(3.541112,-76.384584)"
2013,Abril,Portugal,620,26,36,,62,"(4.697144,-74.140516)"
2013,Abril,Portugal,620,2,1,,3,"(6.171601,-75.427454)"
2013,Abril,Puerto Rico/Territorio de Estados Unidos,630,4,3,,7,"(10.445761,-75.516429)"
2013,Abril,Puerto Rico/Territorio de Estados Unidos,630,11,7,,18,"(10.886611,-74.776708)"
2013,Abril,Puerto Rico/Territorio de Estados Unidos,630,1,0,,1,"(12.586067,-81.702563)"
2013,Abril,Puerto Rico/Territorio de Estados Unidos,630,32,27,,59,"(3.541112,-76.384584)"
2013,Abril,Puerto Rico/Territorio de Estados Unidos,630,124,160,,284,"(4.697144,-74.140516)"
2013,Abril,Puerto Rico/Territorio de Estados Unidos,630,14,9,,23,"(4.815061,-75.736532)"
2013,Abril,Puerto Rico/Territorio de Estados Unidos,630,33,44,,77,"(6.171601,-75.427454)"
2013,Abril,Puerto Rico/Territorio de Estados Unidos,630,7,6,,13,"(7.128456,-73.183637)"
2013,Abril,Puerto Rico/Territorio de Estados Unidos,630,1,0,,1,"(7.927209,-72.507910)"
2013,Abril,Qatar,634,5,4,,9,"(4.697144,-74.140516)"
2013,Abril,Qatar,634,0,1,,1,"(6.171601,-75.427454)"
2013,Abril,Reino Unido de Gran Bretaña e Irlanda del Norte,826,0,1,,1,"(10.886611,-74.776708)"
2013,Abril,Reino Unido de Gran Bretaña e Irlanda del Norte,826,61,37,,98,"(3.541112,-76.384584)"
2013,Abril,Reino Unido de Gran Bretaña e Irlanda del Norte,826,762,603,,1365,"(4.697144,-74.140516)"
2013,Abril,Reino Unido de Gran Bretaña e Irlanda del Norte,826,0,1,,1,"(4.815061,-75.736532)"
2013,Abril,Reino Unido de Gran Bretaña e Irlanda del Norte,826,34,18,,52,"(6.171601,-75.427454)"
2013,Abril,Federación de Rusia,643,20,55,,75,"(4.697144,-74.140516)"
2013,Abril,Federación de Rusia,643,1,2,,3,"(6.171601,-75.427454)"
2013,Abril,República Dominicana,214,7,22,,29,"(10.445761,-75.516429)"
2013,Abril,República Dominicana,214,16,30,,46,"(10.886611,-74.776708)"
2013,Abril,República Dominicana,214,1,0,,1,"(12.586067,-81.702563)"
2013,Abril,República Dominicana,214,54,54,,108,"(3.541112,-76.384584)"
2013,Abril,República Dominicana,214,871,1037,,1908,"(4.697144,-74.140516)"
2013,Abril,República Dominicana,214,6,7,,13,"(4.815061,-75.736532)"
2013,Abril,República Dominicana,214,111,126,,237,"(6.171601,-75.427454)"
2013,Abril,República Dominicana,214,15,14,,29,"(7.128456,-73.183637)"
2013,Abril,República Dominicana,214,1,1,,2,"(7.927209,-72.507910)"
2013,Abril,Rumania,642,0,1,,1,"(3.541112,-76.384584)"
2013,Abril,Rumania,642,3,7,,10,"(4.697144,-74.140516)"
2013,Abril,Rumania,642,1,0,,1,"(6.171601,-75.427454)"
2013,Abril,San Marino,674,1,0,,1,"(4.697144,-74.140516)"
2013,Abril,Santa Elena/Territorio Británico de Ultramar,654,0,1,,1,"(4.697144,-74.140516)"
2013,Abril,Santa Lucia,662,1,0,,1,"(4.697144,-74.140516)"
2013,Abril,Senegal,686,15,69,,84,"(4.697144,-74.140516)"
2013,Abril,Senegal,686,0,1,,1,"(6.171601,-75.427454)"
2013,Abril,Serbia,688,2,0,,2,"(4.697144,-74.140516)"
2013,Abril,Sierra Leona,694,2,0,,2,"(10.445761,-75.516429)"
2013,Abril,Singapur,702,14,25,,39,"(4.697144,-74.140516)"
2013,Abril,Sudáfrica,710,16,16,,32,"(4.697144,-74.140516)"
2013,Abril,Sudán,736,1,0,,1,"(4.697144,-74.140516)"
2013,Abril,Suecia,752,4,5,,9,"(3.541112,-76.384584)"
2013,Abril,Suecia,752,64,43,,107,"(4.697144,-74.140516)"
2013,Abril,Suecia,752,1,3,,4,"(6.171601,-75.427454)"
2013,Abril,Suiza,756,1,0,,1,"(10.445761,-75.516429)"
2013,Abril,Suiza,756,1,1,,2,"(10.886611,-74.776708)"
2013,Abril,Suiza,756,46,27,,73,"(3.541112,-76.384584)"
2013,Abril,Suiza,756,239,175,,414,"(4.697144,-74.140516)"
2013,Abril,Suiza,756,14,4,,18,"(6.171601,-75.427454)"
2013,Abril,Surinam,740,2,7,,9,"(10.886611,-74.776708)"
2013,Abril,Surinam,740,2,19,,21,"(4.697144,-74.140516)"
2013,Abril,Surinam,740,1,0,,1,"(6.171601,-75.427454)"
2013,Abril,Taiwán,158,1,7,,8,"(4.697144,-74.140516)"
2013,Abril,Taiwán,158,1,0,,1,"(4.815061,-75.736532)"
2013,Abril,Tailandia,764,14,12,,26,"(4.697144,-74.140516)"
2013,Abril,Togo,768,0,1,,1,"(3.541112,-76.384584)"
2013,Abril,Trinidad y Tobago,780,1,3,,4,"(10.445761,-75.516429)"
2013,Abril,Trinidad y Tobago,780,1,1,,2,"(10.886611,-74.776708)"
2013,Abril,Trinidad y Tobago,780,10,9,,19,"(3.541112,-76.384584)"
2013,Abril,Trinidad y Tobago,780,23,44,,67,"(4.697144,-74.140516)"
2013,Abril,Trinidad y Tobago,780,2,1,,3,"(4.815061,-75.736532)"
2013,Abril,Trinidad y Tobago,780,9,8,,17,"(6.171601,-75.427454)"
2013,Abril,Trinidad y Tobago,780,4,4,,8,"(7.128456,-73.183637)"
2013,Abril,Turquía,792,5,2,,7,"(3.541112,-76.384584)"
2013,Abril,Turquía,792,59,52,,111,"(4.697144,-74.140516)"
2013,Abril,Turquía,792,1,1,,2,"(6.171601,-75.427454)"
2013,Abril,Ucrania,804,2,1,,3,"(4.697144,-74.140516)"
2013,Abril,Uganda,800,0,2,,2,"(4.697144,-74.140516)"
2013,Abril,Uganda,800,1,0,,1,"(6.171601,-75.427454)"
2013,Abril,Uruguay,858,2,1,,3,"(10.445761,-75.516429)"
2013,Abril,Uruguay,858,2,2,,4,"(10.886611,-74.776708)"
2013,Abril,Uruguay,858,4,3,,7,"(3.541112,-76.384584)"
2013,Abril,Uruguay,858,130,139,,269,"(4.697144,-74.140516)"
2013,Abril,Uruguay,858,0,1,,1,"(4.815061,-75.736532)"
2013,Abril,Uruguay,858,18,29,,47,"(6.171601,-75.427454)"
2013,Abril,Uruguay,858,1,1,,2,"(7.128456,-73.183637)"
2013,Abril,Uzbekistán,860,3,4,,7,"(4.697144,-74.140516)"
2013,Abril,Vanuatu,548,0,1,,1,"(6.171601,-75.427454)"
2013,Abril,Vanuatu,548,1,1,,2,"(7.818934,-72.453226)"
2013,Abril,Venezuela,862,1,2,,3,"(10.433609,-73.247863)"
2013,Abril,Venezuela,862,13,12,,25,"(10.445761,-75.516429)"
2013,Abril,Venezuela,862,15,27,,42,"(10.886611,-74.776708)"
2013,Abril,Venezuela,862,8829,7889,,16718,"(11.360009,-72.129330)"
2013,Abril,Venezuela,862,0,1,,1,"(11.528919,-72.919681)"
2013,Abril,Venezuela,862,1,2,,3,"(12.586067,-81.702563)"
2013,Abril,Venezuela,862,13,22,,35,"(3.541112,-76.384584)"
2013,Abril,Venezuela,862,1831,2386,,4217,"(4.697144,-74.140516)"
2013,Abril,Venezuela,862,4,5,,9,"(4.815061,-75.736532)"
2013,Abril,Venezuela,862,251,311,,562,"(6.171601,-75.427454)"
2013,Abril,Venezuela,862,335,434,,769,"(6.185799,-67.483929)"
2013,Abril,Venezuela,862,895,939,,1834,"(7.088729,-70.740253)"
2013,Abril,Venezuela,862,1,3,,4,"(7.128456,-73.183637)"
2013,Abril,Venezuela,862,5015,5908,,10923,"(7.818934,-72.453226)"
2013,Abril,Venezuela,862,0,3,,3,"(7.927209,-72.507910)"
2013,Abril,Vietnam,704,1,0,,1,"(3.541112,-76.384584)"
2013,Abril,Vietnam,704,5,7,,12,"(4.697144,-74.140516)"
2013,Abril,República Árabe de Yemen,887,1,1,,2,"(4.697144,-74.140516)"
2013,Abril,Desconocido,99999,0,1,,1,"(3.541112,-76.384584)"
2013,Abril,Desconocido,99999,7,29,,36,"(4.697144,-74.140516)"
2013,Mayo,Afganistán,4,0,1,,1,"(10.886611,-74.776708)"
2013,Mayo,Afganistán,4,0,1,,1,"(3.541112,-76.384584)"
2013,Mayo,Afganistán,4,4,37,,41,"(4.697144,-74.140516)"
2013,Mayo,Afganistán,4,0,1,,1,"(6.171601,-75.427454)"
2013,Mayo,Alemania,276,1,0,,1,"(0.814836,-77.662532)"
2013,Mayo,Alemania,276,1,1,,2,"(10.445761,-75.516429)"
2013,Mayo,Alemania,276,1,1,,2,"(10.886611,-74.776708)"
2013,Mayo,Alemania,276,26,12,,38,"(3.541112,-76.384584)"
2013,Mayo,Alemania,276,1199,1213,,2412,"(4.697144,-74.140516)"
2013,Mayo,Alemania,276,12,13,,25,"(6.171601,-75.427454)"
2013,Mayo,Andorra,20,4,2,,6,"(4.697144,-74.140516)"
2013,Mayo,Angola,24,0,1,,1,"(10.445761,-75.516429)"
2013,Mayo,Angola,24,0,8,,8,"(4.697144,-74.140516)"
2013,Mayo,Antigua y Barbuda,28,0,2,,2,"(4.697144,-74.140516)"
2013,Mayo,Países Bajos,528,221,135,,356,"(10.408582,-75.538003)"
2013,Mayo,Países Bajos,528,1,1,,2,"(10.445761,-75.516429)"
2013,Mayo,Países Bajos,528,5,1,,6,"(10.886611,-74.776708)"
2013,Mayo,Países Bajos,528,44,17,,61,"(3.541112,-76.384584)"
2013,Mayo,Países Bajos,528,159,121,,280,"(4.697144,-74.140516)"
2013,Mayo,Países Bajos,528,0,1,,1,"(4.815061,-75.736532)"
2013,Mayo,Países Bajos,528,36,24,,60,"(6.171601,-75.427454)"
2013,Mayo,Arabia Saudita,682,0,1,,1,"(3.541112,-76.384584)"
2013,Mayo,Arabia Saudita,682,9,33,,42,"(4.697144,-74.140516)"
2013,Mayo,Arabia Saudita,682,0,1,,1,"(6.171601,-75.427454)"
2013,Mayo,Argelia,12,0,1,,1,"(3.541112,-76.384584)"
2013,Mayo,Argelia,12,2,5,,7,"(4.697144,-74.140516)"
2013,Mayo,Argelia,12,0,1,,1,"(6.171601,-75.427454)"
2013,Mayo,Argentina,32,3,12,,15,"(0.814836,-77.662532)"
2013,Mayo,Argentina,32,0,1,,1,"(1.813928,-78.763924)"
2013,Mayo,Argentina,32,5,4,,9,"(10.445761,-75.516429)"
2013,Mayo,Argentina,32,14,12,,26,"(10.886611,-74.776708)"
2013,Mayo,Argentina,32,1,2,,3,"(11.360009,-72.129330)"
2013,Mayo,Argentina,32,77,93,,170,"(3.541112,-76.384584)"
2013,Mayo,Argentina,32,2322,2504,,4826,"(4.697144,-74.140516)"
2013,Mayo,Argentina,32,11,9,,20,"(4.815061,-75.736532)"
2013,Mayo,Argentina,32,147,162,,309,"(6.171601,-75.427454)"
2013,Mayo,Argentina,32,4,2,,6,"(7.128456,-73.183637)"
2013,Mayo,Argentina,32,1,3,,4,"(7.927209,-72.507910)"
2013,Mayo,Aruba,533,1378,997,,2375,"(10.408582,-75.538003)"
2013,Mayo,Aruba,533,8,7,,15,"(10.886611,-74.776708)"
2013,Mayo,Aruba,533,0,2,,2,"(11.247723,-74.213989)"
2013,Mayo,Aruba,533,63,65,,128,"(11.528919,-72.919681)"
2013,Mayo,Aruba,533,26,19,,45,"(3.541112,-76.384584)"
2013,Mayo,Aruba,533,1148,991,,2139,"(4.697144,-74.140516)"
2013,Mayo,Aruba,533,17,12,,29,"(4.815061,-75.736532)"
2013,Mayo,Aruba,533,44,35,,79,"(6.171601,-75.427454)"
2013,Mayo,Aruba,533,7,4,,11,"(7.128456,-73.183637)"
2013,Mayo,Aruba,533,0,1,,1,"(7.818934,-72.453226)"
2013,Mayo,Australia,36,1,1,,2,"(10.445761,-75.516429)"
2013,Mayo,Australia,36,0,1,,1,"(10.886611,-74.776708)"
2013,Mayo,Australia,36,12,14,,26,"(3.541112,-76.384584)"
2013,Mayo,Australia,36,165,134,,299,"(4.697144,-74.140516)"
2013,Mayo,Australia,36,2,1,,3,"(4.815061,-75.736532)"
2013,Mayo,Australia,36,23,14,,37,"(6.171601,-75.427454)"
2013,Mayo,Australia,36,2,4,,6,"(7.128456,-73.183637)"
2013,Mayo,Austria,40,1,0,,1,"(3.541112,-76.384584)"
2013,Mayo,Austria,40,26,21,,47,"(4.697144,-74.140516)"
2013,Mayo,Austria,40,0,2,,2,"(6.171601,-75.427454)"
2013,Mayo,Azerbaiyán,31,0,2,,2,"(4.697144,-74.140516)"
2013,Mayo,Bahamas,44,0,5,,5,"(10.445761,-75.516429)"
2013,Mayo,Bahamas,44,57,47,,104,"(10.886611,-74.776708)"
2013,Mayo,Bahamas,44,11,7,,18,"(3.541112,-76.384584)"
2013,Mayo,Bahamas,44,118,105,,223,"(4.697144,-74.140516)"
2013,Mayo,Bahamas,44,1,0,,1,"(4.815061,-75.736532)"
2013,Mayo,Bahamas,44,8,8,,16,"(6.171601,-75.427454)"
2013,Mayo,Bahamas,44,0,1,,1,"(7.128456,-73.183637)"
2013,Mayo,Bahréin,48,0,1,,1,"(10.886611,-74.776708)"
2013,Mayo,Bahréin,48,0,1,,1,"(11.360009,-72.129330)"
2013,Mayo,Bahréin,48,1,2,,3,"(4.697144,-74.140516)"
2013,Mayo,Bahréin,48,1,0,,1,"(6.171601,-75.427454)"
2013,Mayo,Bangladesh,50,0,2,,2,"(4.697144,-74.140516)"
2013,Mayo,Barbados,52,1,2,,3,"(3.541112,-76.384584)"
2013,Mayo,Barbados,52,4,18,,22,"(4.697144,-74.140516)"
2013,Mayo,República de Belarús,112,4,0,,4,"(11.360009,-72.129330)"
2013,Mayo,República de Belarús,112,1,0,,1,"(4.697144,-74.140516)"
2013,Mayo,República de Belarús,112,1,0,,1,"(6.171601,-75.427454)"
2013,Mayo,República de Belarús,112,1,0,,1,"(7.088729,-70.740253)"
2013,Mayo,República de Belarús,112,3,1,,4,"(7.818934,-72.453226)"
2013,Mayo,Bélgica,56,5,4,,9,"(3.541112,-76.384584)"
2013,Mayo,Bélgica,56,68,40,,108,"(4.697144,-74.140516)"
2013,Mayo,Bélgica,56,14,6,,20,"(6.171601,-75.427454)"
2013,Mayo,Belice,84,5,7,,12,"(4.697144,-74.140516)"
2013,Mayo,Bermudas/Territorio Británico de Ultramar,60,2,1,,3,"(4.697144,-74.140516)"
2013,Mayo,Bolivia,68,4,2,,6,"(0.814836,-77.662532)"
2013,Mayo,Bolivia,68,0,2,,2,"(10.445761,-75.516429)"
2013,Mayo,Bolivia,68,1,5,,6,"(10.886611,-74.776708)"
2013,Mayo,Bolivia,68,8,27,,35,"(3.541112,-76.384584)"
2013,Mayo,Bolivia,68,209,335,,544,"(4.697144,-74.140516)"
2013,Mayo,Bolivia,68,1,2,,3,"(4.815061,-75.736532)"
2013,Mayo,Bolivia,68,33,21,,54,"(6.171601,-75.427454)"
2013,Mayo,Bolivia,68,2,3,,5,"(7.128456,-73.183637)"
2013,Mayo,Bosnia y Herzegovina,70,1,0,,1,"(4.697144,-74.140516)"
2013,Mayo,Brasil,76,100,164,,264,"(-4.197703,-69.941278)"
2013,Mayo,Brasil,76,0,1,,1,"(0.814836,-77.662532)"
2013,Mayo,Brasil,76,8,8,,16,"(10.445761,-75.516429)"
2013,Mayo,Brasil,76,3,5,,8,"(10.886611,-74.776708)"
2013,Mayo,Brasil,76,1,0,,1,"(12.586067,-81.702563)"
2013,Mayo,Brasil,76,26,36,,62,"(3.541112,-76.384584)"
2013,Mayo,Brasil,76,2441,3452,,5893,"(4.697144,-74.140516)"
2013,Mayo,Brasil,76,3,4,,7,"(4.815061,-75.736532)"
2013,Mayo,Brasil,76,38,60,,98,"(6.171601,-75.427454)"
2013,Mayo,Brasil,76,0,4,,4,"(7.128456,-73.183637)"
2013,Mayo,Bulgaria,100,2,1,,3,"(4.697144,-74.140516)"
2013,Mayo,Cabo Verde,132,0,1,,1,"(4.697144,-74.140516)"
2013,Mayo,Islas Caimán/Territorio Británico de Ultramar,136,1,2,,3,"(10.445761,-75.516429)"
2013,Mayo,Camboya,116,1,0,,1,"(4.697144,-74.140516)"
2013,Mayo,Camerún,120,0,1,,1,"(4.697144,-74.140516)"
2013,Mayo,Canadá,124,27,19,,46,"(10.445761,-75.516429)"
2013,Mayo,Canadá,124,13,109,,122,"(10.886611,-74.776708)"
2013,Mayo,Canadá,124,2,0,,2,"(12.586067,-81.702563)"
2013,Mayo,Canadá,124,80,49,,129,"(3.541112,-76.384584)"
2013,Mayo,Canadá,124,2,2,,4,"(4.452882,-75.766298)"
2013,Mayo,Canadá,124,1445,1195,,2640,"(4.697144,-74.140516)"
2013,Mayo,Canadá,124,6,6,,12,"(4.815061,-75.736532)"
2013,Mayo,Canadá,124,173,139,,312,"(6.171601,-75.427454)"
2013,Mayo,Canadá,124,5,3,,8,"(7.128456,-73.183637)"
2013,Mayo,Canadá,124,0,1,,1,"(7.927209,-72.507910)"
2013,Mayo,Chad,148,0,2,,2,"(4.697144,-74.140516)"
2013,Mayo,España,724,4,1,,5,"(10.445761,-75.516429)"
2013,Mayo,España,724,1,0,,1,"(10.886611,-74.776708)"
2013,Mayo,España,724,1796,1205,,3001,"(3.541112,-76.384584)"
2013,Mayo,España,724,6936,5586,,12522,"(4.697144,-74.140516)"
2013,Mayo,España,724,3,0,,3,"(4.815061,-75.736532)"
2013,Mayo,España,724,819,646,,1465,"(6.171601,-75.427454)"
2013,Mayo,República Democrática del Congo,180,0,1,,1,"(3.541112,-76.384584)"
2013,Mayo,República Democrática del Congo,180,0,3,,3,"(4.697144,-74.140516)"
2013,Mayo,República Democrática del Congo,180,1,1,,2,"(6.171601,-75.427454)"
2013,Mayo,República de Corea,410,31,58,,89,"(4.697144,-74.140516)"
2013,Mayo,República de Corea,410,1,4,,5,"(6.171601,-75.427454)"
2013,Mayo,Costa de Marfil,384,0,1,,1,"(4.697144,-74.140516)"
2013,Mayo,Costa Rica,188,9,30,,39,"(10.445761,-75.516429)"
2013,Mayo,Costa Rica,188,21,18,,39,"(10.886611,-74.776708)"
2013,Mayo,Costa Rica,188,5,7,,12,"(12.586067,-81.702563)"
2013,Mayo,Costa Rica,188,0,9,,9,"(13.3387613,-81.372937)"
2013,Mayo,Costa Rica,188,48,65,,113,"(3.541112,-76.384584)"
2013,Mayo,Costa Rica,188,694,851,,1545,"(4.697144,-74.140516)"
2013,Mayo,Costa Rica,188,12,15,,27,"(4.815061,-75.736532)"
2013,Mayo,Costa Rica,188,111,150,,261,"(6.171601,-75.427454)"
2013,Mayo,Costa Rica,188,4,5,,9,"(7.128456,-73.183637)"
2013,Mayo,Costa Rica,188,1,2,,3,"(7.927209,-72.507910)"
2013,Mayo,Croacia,191,3,3,,6,"(4.697144,-74.140516)"
2013,Mayo,Croacia,191,1,0,,1,"(6.171601,-75.427454)"
2013,Mayo,Cuba,192,32,37,,69,"(10.445761,-75.516429)"
2013,Mayo,Cuba,192,18,16,,34,"(10.886611,-74.776708)"
2013,Mayo,Cuba,192,1,1,,2,"(12.586067,-81.702563)"
2013,Mayo,Cuba,192,151,88,,239,"(3.541112,-76.384584)"
2013,Mayo,Cuba,192,788,726,,1514,"(4.697144,-74.140516)"
2013,Mayo,Cuba,192,21,15,,36,"(4.815061,-75.736532)"
2013,Mayo,Cuba,192,199,160,,359,"(6.171601,-75.427454)"
2013,Mayo,Cuba,192,10,6,,16,"(7.128456,-73.183637)"
2013,Mayo,Cuba,192,2,2,,4,"(7.927209,-72.507910)"
2013,Mayo,Curazao,99999,6,6,,12,"(10.886611,-74.776708)"
2013,Mayo,Curazao,99999,5,3,,8,"(3.541112,-76.384584)"
2013,Mayo,Curazao,99999,479,495,,974,"(4.697144,-74.140516)"
2013,Mayo,Curazao,99999,1,1,,2,"(4.815061,-75.736532)"
2013,Mayo,Curazao,99999,112,66,,178,"(6.171601,-75.427454)"
2013,Mayo,Curazao,99999,1,3,,4,"(7.128456,-73.183637)"
2013,Mayo,República Checa,203,11,7,,18,"(4.697144,-74.140516)"
2013,Mayo,Chile,152,39,35,,74,"(0.814836,-77.662532)"
2013,Mayo,Chile,152,0,1,,1,"(10.408582,-75.538003)"
2013,Mayo,Chile,152,14,11,,25,"(10.445761,-75.516429)"
2013,Mayo,Chile,152,6,5,,11,"(10.886611,-74.776708)"
2013,Mayo,Chile,152,1,1,,2,"(12.586067,-81.702563)"
2013,Mayo,Chile,152,398,318,,716,"(3.541112,-76.384584)"
2013,Mayo,Chile,152,2046,1961,,4007,"(4.697144,-74.140516)"
2013,Mayo,Chile,152,43,41,,84,"(4.815061,-75.736532)"
2013,Mayo,Chile,152,118,89,,207,"(6.171601,-75.427454)"
2013,Mayo,Chile,152,5,2,,7,"(7.128456,-73.183637)"
2013,Mayo,Chile,152,1,0,,1,"(7.927209,-72.507910)"
2013,Mayo,China,156,0,3,,3,"(10.886611,-74.776708)"
2013,Mayo,China,156,2,1,,3,"(3.541112,-76.384584)"
2013,Mayo,China,156,209,432,,641,"(4.697144,-74.140516)"
2013,Mayo,China,156,13,28,,41,"(6.171601,-75.427454)"
2013,Mayo,China,156,1,4,,5,"(7.128456,-73.183637)"
2013,Mayo,Chipre,196,0,2,,2,"(4.697144,-74.140516)"
2013,Mayo,Dinamarca,208,0,1,,1,"(10.445761,-75.516429)"
2013,Mayo,Dinamarca,208,23,34,,57,"(4.697144,-74.140516)"
2013,Mayo,Dinamarca,208,2,0,,2,"(6.171601,-75.427454)"
2013,Mayo,Dominica,212,4,2,,6,"(4.697144,-74.140516)"
2013,Mayo,Dominica,212,1,2,,3,"(7.927209,-72.507910)"
2013,Mayo,Ecuador,218,353,421,,774,"(0.25129,-76.875963)"
2013,Mayo,Ecuador,218,5792,6582,,12374,"(0.814836,-77.662532)"
2013,Mayo,Ecuador,218,168,134,,302,"(1.813928,-78.763924)"
2013,Mayo,Ecuador,218,3,9,,12,"(10.445761,-75.516429)"
2013,Mayo,Ecuador,218,5,8,,13,"(10.886611,-74.776708)"
2013,Mayo,Ecuador,218,590,618,,1208,"(3.541112,-76.384584)"
2013,Mayo,Ecuador,218,2110,3962,,6072,"(4.697144,-74.140516)"
2013,Mayo,Ecuador,218,0,1,,1,"(4.815061,-75.736532)"
2013,Mayo,Ecuador,218,328,377,,705,"(6.171601,-75.427454)"
2013,Mayo,Ecuador,218,2,3,,5,"(7.128456,-73.183637)"
2013,Mayo,Ecuador,218,0,2,,2,"(7.927209,-72.507910)"
2013,Mayo,Egipto,818,97,48,,145,"(4.697144,-74.140516)"
2013,Mayo,El Salvador,222,1,1,,2,"(10.445761,-75.516429)"
2013,Mayo,El Salvador,222,1,1,,2,"(10.886611,-74.776708)"
2013,Mayo,El Salvador,222,151,123,,274,"(3.541112,-76.384584)"
2013,Mayo,El Salvador,222,604,753,,1357,"(4.697144,-74.140516)"
2013,Mayo,El Salvador,222,3,4,,7,"(4.815061,-75.736532)"
2013,Mayo,El Salvador,222,103,118,,221,"(6.171601,-75.427454)"
2013,Mayo,El Salvador,222,2,1,,3,"(7.128456,-73.183637)"
2013,Mayo,Emiratos Árabes,784,1,2,,3,"(3.541112,-76.384584)"
2013,Mayo,Emiratos Árabes,784,123,159,,282,"(4.697144,-74.140516)"
2013,Mayo,Emiratos Árabes,784,0,1,,1,"(6.171601,-75.427454)"
2013,Mayo,Eritrea,232,0,1,,1,"(3.541112,-76.384584)"
2013,Mayo,Eritrea,232,1,3,,4,"(4.697144,-74.140516)"
2013,Mayo,Eslovaquia,703,6,2,,8,"(4.697144,-74.140516)"
2013,Mayo,Eslovenia,705,2,1,,3,"(4.697144,-74.140516)"
2013,Mayo,Estados Unidos de América,840,0,1,,1,"(0.814836,-77.662532)"
2013,Mayo,Estados Unidos de América,840,15,144,,159,"(10.408582,-75.538003)"
2013,Mayo,Estados Unidos de América,840,1738,1421,,3159,"(10.445761,-75.516429)"
2013,Mayo,Estados Unidos de América,840,1709,1438,,3147,"(10.886611,-74.776708)"
2013,Mayo,Estados Unidos de América,840,22,22,,44,"(12.586067,-81.702563)"
2013,Mayo,Estados Unidos de América,840,4469,3152,,7621,"(3.541112,-76.384584)"
2013,Mayo,Estados Unidos de América,840,536,414,,950,"(4.452882,-75.766298)"
2013,Mayo,Estados Unidos de América,840,30832,27558,,58390,"(4.697144,-74.140516)"
2013,Mayo,Estados Unidos de América,840,456,384,,840,"(4.815061,-75.736532)"
2013,Mayo,Estados Unidos de América,840,6494,5175,,11669,"(6.171601,-75.427454)"
2013,Mayo,Estados Unidos de América,840,112,112,,224,"(7.128456,-73.183637)"
2013,Mayo,Estados Unidos de América,840,28,22,,50,"(7.927209,-72.507910)"
2013,Mayo,Estonia,233,5,0,,5,"(4.697144,-74.140516)"
2013,Mayo,Etiopia,231,1,1,,2,"(4.697144,-74.140516)"
2013,Mayo,Filipinas,608,5,7,,12,"(4.697144,-74.140516)"
2013,Mayo,Finlandia,246,4,1,,5,"(3.541112,-76.384584)"
2013,Mayo,Finlandia,246,18,18,,36,"(4.697144,-74.140516)"
2013,Mayo,Francia,250,0,1,,1,"(10.445761,-75.516429)"
2013,Mayo,Francia,250,3,0,,3,"(10.886611,-74.776708)"
2013,Mayo,Francia,250,51,51,,102,"(3.541112,-76.384584)"
2013,Mayo,Francia,250,1242,1082,,2324,"(4.697144,-74.140516)"
2013,Mayo,Francia,250,50,25,,75,"(6.171601,-75.427454)"
2013,Mayo,Gabón,266,1,4,,5,"(4.697144,-74.140516)"
2013,Mayo,Ghana,288,0,2,,2,"(4.697144,-74.140516)"
2013,Mayo,Grecia,300,29,24,,53,"(4.697144,-74.140516)"
2013,Mayo,Grecia,300,1,1,,2,"(6.171601,-75.427454)"
2013,Mayo,Groenlandia,304,1,0,,1,"(3.541112,-76.384584)"
2013,Mayo,Guatemala,320,3,3,,6,"(10.445761,-75.516429)"
2013,Mayo,Guatemala,320,4,12,,16,"(10.886611,-74.776708)"
2013,Mayo,Guatemala,320,27,46,,73,"(3.541112,-76.384584)"
2013,Mayo,Guatemala,320,174,308,,482,"(4.697144,-74.140516)"
2013,Mayo,Guatemala,320,1,9,,10,"(4.815061,-75.736532)"
2013,Mayo,Guatemala,320,72,83,,155,"(6.171601,-75.427454)"
2013,Mayo,Guatemala,320,2,3,,5,"(7.128456,-73.183637)"
2013,Mayo,Guatemala,320,1,0,,1,"(7.927209,-72.507910)"
2013,Mayo,Guyana,328,1,1,,2,"(10.886611,-74.776708)"
2013,Mayo,Guyana,328,4,5,,9,"(4.697144,-74.140516)"
2013,Mayo,Guyana,328,0,3,,3,"(6.171601,-75.427454)"
2013,Mayo,Guinea,324,0,1,,1,"(4.697144,-74.140516)"
2013,Mayo,Guinea Ecuatorial,226,0,5,,5,"(4.697144,-74.140516)"
2013,Mayo,Guinea Ecuatorial,226,0,1,,1,"(6.171601,-75.427454)"
2013,Mayo,Guadalupe/Territorio Francés,312,1,0,,1,"(4.697144,-74.140516)"
2013,Mayo,Haití,332,0,3,,3,"(10.886611,-74.776708)"
2013,Mayo,Haití,332,0,5,,5,"(3.541112,-76.384584)"
2013,Mayo,Haití,332,0,6,,6,"(4.697144,-74.140516)"
2013,Mayo,Haití,332,0,4,,4,"(6.171601,-75.427454)"
2013,Mayo,Honduras,340,3,4,,7,"(10.445761,-75.516429)"
2013,Mayo,Honduras,340,4,6,,10,"(10.886611,-74.776708)"
2013,Mayo,Honduras,340,0,2,,2,"(12.586067,-81.702563)"
2013,Mayo,Honduras,340,9,19,,28,"(3.541112,-76.384584)"
2013,Mayo,Honduras,340,58,121,,179,"(4.697144,-74.140516)"
2013,Mayo,Honduras,340,3,4,,7,"(4.815061,-75.736532)"
2013,Mayo,Honduras,340,24,47,,71,"(6.171601,-75.427454)"
2013,Mayo,Honduras,340,1,1,,2,"(7.128456,-73.183637)"
2013,Mayo,Honduras,340,0,1,,1,"(7.927209,-72.507910)"
2013,Mayo,Hong Kong,344,0,1,,1,"(3.541112,-76.384584)"
2013,Mayo,Hong Kong,344,24,72,,96,"(4.697144,-74.140516)"
2013,Mayo,Hong Kong,344,1,4,,5,"(6.171601,-75.427454)"
2013,Mayo,Hungría,348,4,8,,12,"(4.697144,-74.140516)"
2013,Mayo,Hungría,348,1,1,,2,"(6.171601,-75.427454)"
2013,Mayo,India,356,0,3,,3,"(3.541112,-76.384584)"
2013,Mayo,India,356,25,18,,43,"(4.697144,-74.140516)"
2013,Mayo,India,356,5,1,,6,"(6.171601,-75.427454)"
2013,Mayo,Indonesia,360,0,1,,1,"(3.541112,-76.384584)"
2013,Mayo,Indonesia,360,2,3,,5,"(4.697144,-74.140516)"
2013,Mayo,Iraq,368,4,17,,21,"(4.697144,-74.140516)"
2013,Mayo,Irán,364,2,1,,3,"(4.697144,-74.140516)"
2013,Mayo,República de Irlanda,372,1,0,,1,"(3.541112,-76.384584)"
2013,Mayo,República de Irlanda,372,10,15,,25,"(4.697144,-74.140516)"
2013,Mayo,Islandia,352,3,2,,5,"(4.697144,-74.140516)"
2013,Mayo,Israel,376,4,2,,6,"(3.541112,-76.384584)"
2013,Mayo,Israel,376,148,125,,273,"(4.697144,-74.140516)"
2013,Mayo,Israel,376,3,6,,9,"(6.171601,-75.427454)"
2013,Mayo,Italia,380,1,1,,2,"(10.445761,-75.516429)"
2013,Mayo,Italia,380,0,1,,1,"(10.886611,-74.776708)"
2013,Mayo,Italia,380,118,51,,169,"(3.541112,-76.384584)"
2013,Mayo,Italia,380,726,486,,1212,"(4.697144,-74.140516)"
2013,Mayo,Italia,380,56,37,,93,"(6.171601,-75.427454)"
2013,Mayo,Jamaica,388,3,5,,8,"(10.445761,-75.516429)"
2013,Mayo,Jamaica,388,1,2,,3,"(10.886611,-74.776708)"
2013,Mayo,Jamaica,388,84,104,,188,"(3.541112,-76.384584)"
2013,Mayo,Jamaica,388,44,43,,87,"(4.697144,-74.140516)"
2013,Mayo,Jamaica,388,5,5,,10,"(4.815061,-75.736532)"
2013,Mayo,Jamaica,388,19,10,,29,"(6.171601,-75.427454)"
2013,Mayo,Jamaica,388,0,1,,1,"(7.128456,-73.183637)"
2013,Mayo,Japón,392,4,2,,6,"(3.541112,-76.384584)"
2013,Mayo,Japón,392,42,60,,102,"(4.697144,-74.140516)"
2013,Mayo,Japón,392,1,5,,6,"(6.171601,-75.427454)"
2013,Mayo,Japón,392,2,1,,3,"(7.128456,-73.183637)"
2013,Mayo,Jordania,400,16,10,,26,"(4.697144,-74.140516)"
2013,Mayo,Kazajistán,398,0,2,,2,"(4.697144,-74.140516)"
2013,Mayo,Kazajistán,398,0,1,,1,"(7.128456,-73.183637)"
2013,Mayo,Kenia,404,1,0,,1,"(3.541112,-76.384584)"
2013,Mayo,Kenia,404,0,3,,3,"(4.697144,-74.140516)"
2013,Mayo,Kuwait,414,3,6,,9,"(4.697144,-74.140516)"
2013,Mayo,Lituania,440,1,15,,16,"(4.697144,-74.140516)"
2013,Mayo,Líbano,422,20,28,,48,"(4.697144,-74.140516)"
2013,Mayo,Libia,434,0,1,,1,"(4.697144,-74.140516)"
2013,Mayo,Luxemburgo,442,1,0,,1,"(3.541112,-76.384584)"
2013,Mayo,Luxemburgo,442,1,3,,4,"(4.697144,-74.140516)"
2013,Mayo,Malasia,458,7,6,,13,"(4.697144,-74.140516)"
2013,Mayo,Malasia,458,3,3,,6,"(6.171601,-75.427454)"
2013,Mayo,Malta,470,9,2,,11,"(4.697144,-74.140516)"
2013,Mayo,Marruecos,504,4,5,,9,"(4.697144,-74.140516)"
2013,Mayo,Marruecos,504,2,0,,2,"(6.171601,-75.427454)"
2013,Mayo,Mauricio,480,0,1,,1,"(4.697144,-74.140516)"
2013,Mayo,Mauritania,478,0,3,,3,"(4.697144,-74.140516)"
2013,Mayo,México,484,49,32,,81,"(10.445761,-75.516429)"
2013,Mayo,México,484,114,106,,220,"(10.886611,-74.776708)"
2013,Mayo,México,484,5,1,,6,"(12.586067,-81.702563)"
2013,Mayo,México,484,491,385,,876,"(3.541112,-76.384584)"
2013,Mayo,México,484,5801,5612,,11413,"(4.697144,-74.140516)"
2013,Mayo,México,484,97,88,,185,"(4.815061,-75.736532)"
2013,Mayo,México,484,987,720,,1707,"(6.171601,-75.427454)"
2013,Mayo,México,484,95,56,,151,"(7.128456,-73.183637)"
2013,Mayo,México,484,9,10,,19,"(7.927209,-72.507910)"
2013,Mayo,República de Moldavia,498,0,1,,1,"(4.697144,-74.140516)"
2013,Mayo,República de Moldavia,498,2,0,,2,"(7.128456,-73.183637)"
2013,Mayo,Mónaco,492,2,0,,2,"(4.697144,-74.140516)"
2013,Mayo,Mongolia,496,0,1,,1,"(4.697144,-74.140516)"
2013,Mayo,Nicaragua,558,1,0,,1,"(10.445761,-75.516429)"
2013,Mayo,Nicaragua,558,2,6,,8,"(10.886611,-74.776708)"
2013,Mayo,Nicaragua,558,6,14,,20,"(3.541112,-76.384584)"
2013,Mayo,Nicaragua,558,24,58,,82,"(4.697144,-74.140516)"
2013,Mayo,Nicaragua,558,1,0,,1,"(4.815061,-75.736532)"
2013,Mayo,Nicaragua,558,4,15,,19,"(6.171601,-75.427454)"
2013,Mayo,Nigeria,566,2,9,,11,"(4.697144,-74.140516)"
2013,Mayo,Noruega,578,1,0,,1,"(3.541112,-76.384584)"
2013,Mayo,Noruega,578,29,29,,58,"(4.697144,-74.140516)"
2013,Mayo,Noruega,578,1,0,,1,"(4.815061,-75.736532)"
2013,Mayo,Noruega,578,1,5,,6,"(6.171601,-75.427454)"
2013,Mayo,Nueva Zelanda,554,14,6,,20,"(4.697144,-74.140516)"
2013,Mayo,Nueva Zelanda,554,2,2,,4,"(6.171601,-75.427454)"
2013,Mayo,Omán,512,0,6,,6,"(4.697144,-74.140516)"
2013,Mayo,Papúa Nueva Guinea,598,1,0,,1,"(3.541112,-76.384584)"
2013,Mayo,Papúa Nueva Guinea,598,0,15,,15,"(4.697144,-74.140516)"
2013,Mayo,Papúa Nueva Guinea,598,0,1,,1,"(6.171601,-75.427454)"
2013,Mayo,Pakistán,586,0,1,,1,"(4.697144,-74.140516)"
2013,Mayo,Palau,585,0,1,,1,"(6.171601,-75.427454)"
2013,Mayo,Panamá,591,13,11,,24,"(10.408582,-75.538003)"
2013,Mayo,Panamá,591,298,348,,646,"(10.445761,-75.516429)"
2013,Mayo,Panamá,591,793,912,,1705,"(10.886611,-74.776708)"
2013,Mayo,Panamá,591,0,2,,2,"(10.971302,-74.765397)"
2013,Mayo,Panamá,591,0,7,,7,"(11.247723,-74.213989)"
2013,Mayo,Panamá,591,55,50,,105,"(12.586067,-81.702563)"
2013,Mayo,Panamá,591,1991,1769,,3760,"(3.541112,-76.384584)"
2013,Mayo,Panamá,591,6480,7079,,13559,"(4.697144,-74.140516)"
2013,Mayo,Panamá,591,604,527,,1131,"(4.815061,-75.736532)"
2013,Mayo,Panamá,591,2442,2184,,4626,"(6.171601,-75.427454)"
2013,Mayo,Panamá,591,278,257,,535,"(7.128456,-73.183637)"
2013,Mayo,Panamá,591,147,170,,317,"(7.927209,-72.507910)"
2013,Mayo,Panamá,591,4,51,,55,"(8.066966,-76.735404)"
2013,Mayo,Panamá,591,70,149,,219,"(8.635765,-77.346578)"
2013,Mayo,Paraguay,600,0,1,,1,"(10.445761,-75.516429)"
2013,Mayo,Paraguay,600,5,15,,20,"(3.541112,-76.384584)"
2013,Mayo,Paraguay,600,35,111,,146,"(4.697144,-74.140516)"
2013,Mayo,Paraguay,600,0,1,,1,"(4.815061,-75.736532)"
2013,Mayo,Paraguay,600,3,7,,10,"(6.171601,-75.427454)"
2013,Mayo,Perú,604,66,115,,181,"(-4.197703,-69.941278)"
2013,Mayo,Perú,604,33,37,,70,"(0.814836,-77.662532)"
2013,Mayo,Perú,604,7,4,,11,"(10.445761,-75.516429)"
2013,Mayo,Perú,604,12,17,,29,"(10.886611,-74.776708)"
2013,Mayo,Perú,604,0,1,,1,"(12.586067,-81.702563)"
2013,Mayo,Perú,604,159,188,,347,"(3.541112,-76.384584)"
2013,Mayo,Perú,604,2824,3860,,6684,"(4.697144,-74.140516)"
2013,Mayo,Perú,604,13,13,,26,"(4.815061,-75.736532)"
2013,Mayo,Perú,604,294,402,,696,"(6.171601,-75.427454)"
2013,Mayo,Perú,604,7,10,,17,"(7.128456,-73.183637)"
2013,Mayo,Perú,604,1,1,,2,"(7.927209,-72.507910)"
2013,Mayo,Palestina,99999,1,0,,1,"(3.541112,-76.384584)"
2013,Mayo,Polonia,616,0,1,,1,"(3.541112,-76.384584)"
2013,Mayo,Polonia,616,22,34,,56,"(4.697144,-74.140516)"
2013,Mayo,Polonia,616,1,0,,1,"(6.171601,-75.427454)"
2013,Mayo,Portugal,620,2,2,,4,"(3.541112,-76.384584)"
2013,Mayo,Portugal,620,40,39,,79,"(4.697144,-74.140516)"
2013,Mayo,Portugal,620,1,0,,1,"(6.171601,-75.427454)"
2013,Mayo,Puerto Rico/Territorio de Estados Unidos,630,4,4,,8,"(10.445761,-75.516429)"
2013,Mayo,Puerto Rico/Territorio de Estados Unidos,630,7,14,,21,"(10.886611,-74.776708)"
2013,Mayo,Puerto Rico/Territorio de Estados Unidos,630,2,0,,2,"(12.586067,-81.702563)"
2013,Mayo,Puerto Rico/Territorio de Estados Unidos,630,22,28,,50,"(3.541112,-76.384584)"
2013,Mayo,Puerto Rico/Territorio de Estados Unidos,630,121,135,,256,"(4.697144,-74.140516)"
2013,Mayo,Puerto Rico/Territorio de Estados Unidos,630,4,4,,8,"(4.815061,-75.736532)"
2013,Mayo,Puerto Rico/Territorio de Estados Unidos,630,37,32,,69,"(6.171601,-75.427454)"
2013,Mayo,Puerto Rico/Territorio de Estados Unidos,630,4,5,,9,"(7.128456,-73.183637)"
2013,Mayo,Puerto Rico/Territorio de Estados Unidos,630,1,1,,2,"(7.927209,-72.507910)"
2013,Mayo,Qatar,634,1,1,,2,"(3.541112,-76.384584)"
2013,Mayo,Qatar,634,3,5,,8,"(4.697144,-74.140516)"
2013,Mayo,Reino Unido de Gran Bretaña e Irlanda del Norte,826,2,3,,5,"(10.445761,-75.516429)"
2013,Mayo,Reino Unido de Gran Bretaña e Irlanda del Norte,826,2,1,,3,"(10.886611,-74.776708)"
2013,Mayo,Reino Unido de Gran Bretaña e Irlanda del Norte,826,54,34,,88,"(3.541112,-76.384584)"
2013,Mayo,Reino Unido de Gran Bretaña e Irlanda del Norte,826,600,530,,1130,"(4.697144,-74.140516)"
2013,Mayo,Reino Unido de Gran Bretaña e Irlanda del Norte,826,0,2,,2,"(4.815061,-75.736532)"
2013,Mayo,Reino Unido de Gran Bretaña e Irlanda del Norte,826,31,26,,57,"(6.171601,-75.427454)"
2013,Mayo,Federación de Rusia,643,2,2,,4,"(3.541112,-76.384584)"
2013,Mayo,Federación de Rusia,643,47,69,,116,"(4.697144,-74.140516)"
2013,Mayo,Federación de Rusia,643,0,1,,1,"(6.171601,-75.427454)"
2013,Mayo,República Dominicana,214,12,17,,29,"(10.445761,-75.516429)"
2013,Mayo,República Dominicana,214,25,37,,62,"(10.886611,-74.776708)"
2013,Mayo,República Dominicana,214,0,1,,1,"(12.586067,-81.702563)"
2013,Mayo,República Dominicana,214,74,76,,150,"(3.541112,-76.384584)"
2013,Mayo,República Dominicana,214,1293,1270,,2563,"(4.697144,-74.140516)"
2013,Mayo,República Dominicana,214,9,11,,20,"(4.815061,-75.736532)"
2013,Mayo,República Dominicana,214,132,120,,252,"(6.171601,-75.427454)"
2013,Mayo,República Dominicana,214,7,2,,9,"(7.128456,-73.183637)"
2013,Mayo,República Dominicana,214,0,1,,1,"(7.927209,-72.507910)"
2013,Mayo,Reunión,638,1,1,,2,"(4.697144,-74.140516)"
2013,Mayo,Rumania,642,5,7,,12,"(4.697144,-74.140516)"
2013,Mayo,San  Vicente y las Granadinas,670,4,5,,9,"(4.697144,-74.140516)"
2013,Mayo,Santa Lucia,662,0,1,,1,"(4.697144,-74.140516)"
2013,Mayo,Senegal,686,0,1,,1,"(4.697144,-74.140516)"
2013,Mayo,Serbia,688,1,1,,2,"(4.697144,-74.140516)"
2013,Mayo,Singapur,702,0,2,,2,"(3.541112,-76.384584)"
2013,Mayo,Singapur,702,13,15,,28,"(4.697144,-74.140516)"
2013,Mayo,Singapur,702,1,0,,1,"(6.171601,-75.427454)"
2013,Mayo,Sudáfrica,710,11,10,,21,"(4.697144,-74.140516)"
2013,Mayo,Sudáfrica,710,1,0,,1,"(6.171601,-75.427454)"
2013,Mayo,Sudán,736,0,1,,1,"(6.171601,-75.427454)"
2013,Mayo,Suecia,752,1,0,,1,"(10.445761,-75.516429)"
2013,Mayo,Suecia,752,1,0,,1,"(12.586067,-81.702563)"
2013,Mayo,Suecia,752,4,0,,4,"(3.541112,-76.384584)"
2013,Mayo,Suecia,752,80,54,,134,"(4.697144,-74.140516)"
2013,Mayo,Suecia,752,9,1,,10,"(6.171601,-75.427454)"
2013,Mayo,Suiza,756,29,10,,39,"(3.541112,-76.384584)"
2013,Mayo,Suiza,756,223,133,,356,"(4.697144,-74.140516)"
2013,Mayo,Suiza,756,23,8,,31,"(6.171601,-75.427454)"
2013,Mayo,Surinam,740,0,1,,1,"(10.886611,-74.776708)"
2013,Mayo,Surinam,740,4,21,,25,"(4.697144,-74.140516)"
2013,Mayo,Surinam,740,3,0,,3,"(6.171601,-75.427454)"
2013,Mayo,Taiwán,158,0,1,,1,"(3.541112,-76.384584)"
2013,Mayo,Taiwán,158,0,3,,3,"(4.697144,-74.140516)"
2013,Mayo,Taiwán,158,1,0,,1,"(6.171601,-75.427454)"
2013,Mayo,Tailandia,764,4,8,,12,"(4.697144,-74.140516)"
2013,Mayo,Trinidad y Tobago,780,5,4,,9,"(10.445761,-75.516429)"
2013,Mayo,Trinidad y Tobago,780,4,4,,8,"(10.886611,-74.776708)"
2013,Mayo,Trinidad y Tobago,780,5,5,,10,"(3.541112,-76.384584)"
2013,Mayo,Trinidad y Tobago,780,27,54,,81,"(4.697144,-74.140516)"
2013,Mayo,Trinidad y Tobago,780,4,1,,5,"(4.815061,-75.736532)"
2013,Mayo,Trinidad y Tobago,780,9,5,,14,"(6.171601,-75.427454)"
2013,Mayo,Trinidad y Tobago,780,7,3,,10,"(7.128456,-73.183637)"
2013,Mayo,Túnez,788,0,1,,1,"(4.697144,-74.140516)"
2013,Mayo,Turquía,792,1,1,,2,"(3.541112,-76.384584)"
2013,Mayo,Turquía,792,128,96,,224,"(4.697144,-74.140516)"
2013,Mayo,Turquía,792,4,2,,6,"(6.171601,-75.427454)"
2013,Mayo,Ucrania,804,1,3,,4,"(4.697144,-74.140516)"
2013,Mayo,Uganda,800,0,1,,1,"(3.541112,-76.384584)"
2013,Mayo,Uganda,800,2,5,,7,"(4.697144,-74.140516)"
2013,Mayo,Uruguay,858,8,5,,13,"(3.541112,-76.384584)"
2013,Mayo,Uruguay,858,36,53,,89,"(4.697144,-74.140516)"
2013,Mayo,Uruguay,858,5,7,,12,"(6.171601,-75.427454)"
2013,Mayo,Venezuela,862,11,8,,19,"(10.445761,-75.516429)"
2013,Mayo,Venezuela,862,13,34,,47,"(10.886611,-74.776708)"
2013,Mayo,Venezuela,862,9868,9212,,19080,"(11.360009,-72.129330)"
2013,Mayo,Venezuela,862,19,23,,42,"(3.541112,-76.384584)"
2013,Mayo,Venezuela,862,1954,2760,,4714,"(4.697144,-74.140516)"
2013,Mayo,Venezuela,862,2,4,,6,"(4.815061,-75.736532)"
2013,Mayo,Venezuela,862,252,318,,570,"(6.171601,-75.427454)"
2013,Mayo,Venezuela,862,471,536,,1007,"(6.185799,-67.483929)"
2013,Mayo,Venezuela,862,1175,1256,,2431,"(7.088729,-70.740253)"
2013,Mayo,Venezuela,862,0,3,,3,"(7.128456,-73.183637)"
2013,Mayo,Venezuela,862,4834,5504,,10338,"(7.818934,-72.453226)"
2013,Mayo,Vietnam,704,1,1,,2,"(4.697144,-74.140516)"
2013,Mayo,Islas Vírgenes Británicas/Territorio Británico de Ultramar,92,1,0,,1,"(4.697144,-74.140516)"
2013,Mayo,Islas Vírgenes Estadounidenses/Territorio de Estados Unidos,850,0,1,,1,"(4.697144,-74.140516)"
2013,Mayo,Zimbabue,716,0,1,,1,"(4.697144,-74.140516)"
2013,Mayo,Zimbabue,716,0,1,,1,"(4.815061,-75.736532)"
2013,Mayo,Albania,8,0,1,,1,"(4.697144,-74.140516)"
2013,Mayo,Desconocido,99999,0,1,,1,"(3.541112,-76.384584)"
2013,Mayo,Desconocido,99999,3,18,,21,"(4.697144,-74.140516)"
2013,Junio,Afganistán,4,1,2,,3,"(10.408582,-75.538003)"
2013,Junio,Afganistán,4,0,1,,1,"(3.541112,-76.384584)"
2013,Junio,Afganistán,4,3,34,,37,"(4.697144,-74.140516)"
2013,Junio,Afganistán,4,1,1,,2,"(6.171601,-75.427454)"
2013,Junio,Albania,8,2,1,,3,"(4.697144,-74.140516)"
2013,Junio,Alemania,276,1,0,,1,"(0.814836,-77.662532)"
2013,Junio,Alemania,276,2,1,,3,"(10.445761,-75.516429)"
2013,Junio,Alemania,276,2,2,,4,"(10.886611,-74.776708)"
2013,Junio,Alemania,276,27,14,,41,"(3.541112,-76.384584)"
2013,Junio,Alemania,276,1751,1543,,3294,"(4.697144,-74.140516)"
2013,Junio,Alemania,276,21,10,,31,"(6.171601,-75.427454)"
2013,Junio,Alemania,276,1,1,,2,"(7.128456,-73.183637)"
2013,Junio,Andorra,20,0,1,,1,"(3.541112,-76.384584)"
2013,Junio,Andorra,20,1,0,,1,"(4.697144,-74.140516)"
2013,Junio,Angola,24,3,9,,12,"(4.697144,-74.140516)"
2013,Junio,Antigua y Barbuda,28,2,0,,2,"(4.697144,-74.140516)"
2013,Junio,Países Bajos,528,283,203,,486,"(10.408582,-75.538003)"
2013,Junio,Países Bajos,528,5,5,,10,"(10.445761,-75.516429)"
2013,Junio,Países Bajos,528,8,2,,10,"(10.886611,-74.776708)"
2013,Junio,Países Bajos,528,41,27,,68,"(3.541112,-76.384584)"
2013,Junio,Países Bajos,528,236,165,,401,"(4.697144,-74.140516)"
2013,Junio,Países Bajos,528,3,2,,5,"(4.815061,-75.736532)"
2013,Junio,Países Bajos,528,44,34,,78,"(6.171601,-75.427454)"
2013,Junio,Países Bajos,528,3,0,,3,"(7.128456,-73.183637)"
2013,Junio,Arabia Saudita,682,1,0,,1,"(3.541112,-76.384584)"
2013,Junio,Arabia Saudita,682,4,19,,23,"(4.697144,-74.140516)"
2013,Junio,Argelia,12,1,0,,1,"(3.541112,-76.384584)"
2013,Junio,Argelia,12,0,7,,7,"(4.697144,-74.140516)"
2013,Junio,Argentina,32,1,0,,1,"(0.25129,-76.875963)"
2013,Junio,Argentina,32,2,7,,9,"(0.814836,-77.662532)"
2013,Junio,Argentina,32,18,33,,51,"(10.445761,-75.516429)"
2013,Junio,Argentina,32,32,43,,75,"(10.886611,-74.776708)"
2013,Junio,Argentina,32,0,3,,3,"(12.586067,-81.702563)"
2013,Junio,Argentina,32,117,189,,306,"(3.541112,-76.384584)"
2013,Junio,Argentina,32,3370,4529,,7899,"(4.697144,-74.140516)"
2013,Junio,Argentina,32,7,20,,27,"(4.815061,-75.736532)"
2013,Junio,Argentina,32,217,314,,531,"(6.171601,-75.427454)"
2013,Junio,Argentina,32,5,5,,10,"(7.128456,-73.183637)"
2013,Junio,Argentina,32,1,4,,5,"(7.818934,-72.453226)"
2013,Junio,Argentina,32,0,1,,1,"(7.927209,-72.507910)"
2013,Junio,Aruba,533,1877,1411,,3288,"(10.408582,-75.538003)"
2013,Junio,Aruba,533,2,1,,3,"(10.445761,-75.516429)"
2013,Junio,Aruba,533,18,14,,32,"(10.886611,-74.776708)"
2013,Junio,Aruba,533,1,2,,3,"(11.247723,-74.213989)"
2013,Junio,Aruba,533,72,56,,128,"(11.528919,-72.919681)"
2013,Junio,Aruba,533,39,32,,71,"(3.541112,-76.384584)"
2013,Junio,Aruba,533,1429,1164,,2593,"(4.697144,-74.140516)"
2013,Junio,Aruba,533,11,6,,17,"(4.815061,-75.736532)"
2013,Junio,Aruba,533,145,92,,237,"(6.171601,-75.427454)"
2013,Junio,Aruba,533,5,7,,12,"(7.128456,-73.183637)"
2013,Junio,Aruba,533,1,1,,2,"(7.927209,-72.507910)"
2013,Junio,Australia,36,0,1,,1,"(10.445761,-75.516429)"
2013,Junio,Australia,36,1,2,,3,"(10.886611,-74.776708)"
2013,Junio,Australia,36,6,7,,13,"(3.541112,-76.384584)"
2013,Junio,Australia,36,172,139,,311,"(4.697144,-74.140516)"
2013,Junio,Australia,36,23,16,,39,"(6.171601,-75.427454)"
2013,Junio,Austria,40,1,0,,1,"(3.541112,-76.384584)"
2013,Junio,Austria,40,46,31,,77,"(4.697144,-74.140516)"
2013,Junio,Austria,40,2,0,,2,"(6.171601,-75.427454)"
2013,Junio,Azerbaiyán,31,0,2,,2,"(4.697144,-74.140516)"
2013,Junio,Bahamas,44,7,3,,10,"(10.445761,-75.516429)"
2013,Junio,Bahamas,44,2,1,,3,"(10.886611,-74.776708)"
2013,Junio,Bahamas,44,9,8,,17,"(3.541112,-76.384584)"
2013,Junio,Bahamas,44,27,24,,51,"(4.697144,-74.140516)"
2013,Junio,Bahamas,44,4,0,,4,"(4.815061,-75.736532)"
2013,Junio,Bahamas,44,20,23,,43,"(6.171601,-75.427454)"
2013,Junio,Bahamas,44,15,5,,20,"(7.128456,-73.183637)"
2013,Junio,Bahréin,48,2,3,,5,"(4.697144,-74.140516)"
2013,Junio,Barbados,52,6,16,,22,"(4.697144,-74.140516)"
2013,Junio,Barbados,52,0,1,,1,"(6.171601,-75.427454)"
2013,Junio,República de Belarús,112,3,0,,3,"(11.360009,-72.129330)"
2013,Junio,República de Belarús,112,0,1,,1,"(3.541112,-76.384584)"
2013,Junio,República de Belarús,112,3,5,,8,"(4.697144,-74.140516)"
2013,Junio,República de Belarús,112,5,3,,8,"(7.818934,-72.453226)"
2013,Junio,Bélgica,56,10,5,,15,"(3.541112,-76.384584)"
2013,Junio,Bélgica,56,99,93,,192,"(4.697144,-74.140516)"
2013,Junio,Bélgica,56,16,5,,21,"(6.171601,-75.427454)"
2013,Junio,Belice,84,0,1,,1,"(10.886611,-74.776708)"
2013,Junio,Belice,84,2,1,,3,"(4.697144,-74.140516)"
2013,Junio,Benín,204,0,1,,1,"(4.697144,-74.140516)"
2013,Junio,Bermudas/Territorio Británico de Ultramar,60,2,1,,3,"(4.697144,-74.140516)"
2013,Junio,Bolivia,68,3,2,,5,"(10.886611,-74.776708)"
2013,Junio,Bolivia,68,14,31,,45,"(3.541112,-76.384584)"
2013,Junio,Bolivia,68,257,363,,620,"(4.697144,-74.140516)"
2013,Junio,Bolivia,68,2,4,,6,"(4.815061,-75.736532)"
2013,Junio,Bolivia,68,17,23,,40,"(6.171601,-75.427454)"
2013,Junio,Bosnia y Herzegovina,70,1,0,,1,"(4.697144,-74.140516)"
2013,Junio,Brasil,76,123,236,,359,"(-4.197703,-69.941278)"
2013,Junio,Brasil,76,0,2,,2,"(0.814836,-77.662532)"
2013,Junio,Brasil,76,8,5,,13,"(10.445761,-75.516429)"
2013,Junio,Brasil,76,3,3,,6,"(10.886611,-74.776708)"
2013,Junio,Brasil,76,47,62,,109,"(3.541112,-76.384584)"
2013,Junio,Brasil,76,3365,4181,,7546,"(4.697144,-74.140516)"
2013,Junio,Brasil,76,1,1,,2,"(4.815061,-75.736532)"
2013,Junio,Brasil,76,74,89,,163,"(6.171601,-75.427454)"
2013,Junio,Brasil,76,1,4,,5,"(7.128456,-73.183637)"
2013,Junio,Brasil,76,0,1,,1,"(7.927209,-72.507910)"
2013,Junio,Brunei Darussalam,96,0,1,,1,"(4.697144,-74.140516)"
2013,Junio,Bulgaria,100,16,9,,25,"(4.697144,-74.140516)"
2013,Junio,Islas Caimán/Territorio Británico de Ultramar,136,0,1,,1,"(10.445761,-75.516429)"
2013,Junio,Islas Caimán/Territorio Británico de Ultramar,136,28,20,,48,"(12.586067,-81.702563)"
2013,Junio,Islas Caimán/Territorio Británico de Ultramar,136,2,0,,2,"(4.697144,-74.140516)"
2013,Junio,Camboya,116,3,2,,5,"(4.697144,-74.140516)"
2013,Junio,Canadá,124,27,17,,44,"(10.445761,-75.516429)"
2013,Junio,Canadá,124,28,24,,52,"(10.886611,-74.776708)"
2013,Junio,Canadá,124,73,65,,138,"(3.541112,-76.384584)"
2013,Junio,Canadá,124,1,3,,4,"(4.452882,-75.766298)"
2013,Junio,Canadá,124,1805,1497,,3302,"(4.697144,-74.140516)"
2013,Junio,Canadá,124,5,3,,8,"(4.815061,-75.736532)"
2013,Junio,Canadá,124,166,137,,303,"(6.171601,-75.427454)"
2013,Junio,Canadá,124,1,0,,1,"(7.128456,-73.183637)"
2013,Junio,Canadá,124,3,2,,5,"(7.927209,-72.507910)"
2013,Junio,España,724,13,8,,21,"(10.445761,-75.516429)"
2013,Junio,España,724,2,7,,9,"(10.886611,-74.776708)"
2013,Junio,España,724,2103,1480,,3583,"(3.541112,-76.384584)"
2013,Junio,España,724,9246,7164,,16410,"(4.697144,-74.140516)"
2013,Junio,España,724,3,0,,3,"(4.815061,-75.736532)"
2013,Junio,España,724,872,713,,1585,"(6.171601,-75.427454)"
2013,Junio,República Democrática del Congo,180,1,1,,2,"(4.697144,-74.140516)"
2013,Junio,República de Corea,410,24,30,,54,"(4.697144,-74.140516)"
2013,Junio,República de Corea,410,0,2,,2,"(6.171601,-75.427454)"
2013,Junio,Costa Rica,188,8,17,,25,"(10.445761,-75.516429)"
2013,Junio,Costa Rica,188,21,20,,41,"(10.886611,-74.776708)"
2013,Junio,Costa Rica,188,1,15,,16,"(12.5744111,-81.703935)"
2013,Junio,Costa Rica,188,4,6,,10,"(12.586067,-81.702563)"
2013,Junio,Costa Rica,188,1,10,,11,"(13.3387613,-81.372937)"
2013,Junio,Costa Rica,188,45,54,,99,"(3.541112,-76.384584)"
2013,Junio,Costa Rica,188,850,1041,,1891,"(4.697144,-74.140516)"
2013,Junio,Costa Rica,188,4,7,,11,"(4.815061,-75.736532)"
2013,Junio,Costa Rica,188,98,126,,224,"(6.171601,-75.427454)"
2013,Junio,Costa Rica,188,1,0,,1,"(7.128456,-73.183637)"
2013,Junio,Costa Rica,188,5,3,,8,"(7.927209,-72.507910)"
2013,Junio,Costa Rica,188,0,1,,1,"(8.635765,-77.346578)"
2013,Junio,Croacia,191,0,1,,1,"(3.541112,-76.384584)"
2013,Junio,Croacia,191,5,6,,11,"(4.697144,-74.140516)"
2013,Junio,Cuba,192,34,24,,58,"(10.445761,-75.516429)"
2013,Junio,Cuba,192,46,26,,72,"(10.886611,-74.776708)"
2013,Junio,Cuba,192,1,2,,3,"(12.586067,-81.702563)"
2013,Junio,Cuba,192,86,69,,155,"(3.541112,-76.384584)"
2013,Junio,Cuba,192,1548,1217,,2765,"(4.697144,-74.140516)"
2013,Junio,Cuba,192,15,14,,29,"(4.815061,-75.736532)"
2013,Junio,Cuba,192,176,133,,309,"(6.171601,-75.427454)"
2013,Junio,Cuba,192,3,2,,5,"(7.128456,-73.183637)"
2013,Junio,Cuba,192,6,5,,11,"(7.927209,-72.507910)"
2013,Junio,Curazao,99999,0,6,,6,"(10.408582,-75.538003)"
2013,Junio,Curazao,99999,8,2,,10,"(3.541112,-76.384584)"
2013,Junio,Curazao,99999,655,552,,1207,"(4.697144,-74.140516)"
2013,Junio,Curazao,99999,2,0,,2,"(4.815061,-75.736532)"
2013,Junio,Curazao,99999,144,85,,229,"(6.171601,-75.427454)"
2013,Junio,República Checa,203,16,12,,28,"(4.697144,-74.140516)"
2013,Junio,Chile,152,26,24,,50,"(0.814836,-77.662532)"
2013,Junio,Chile,152,11,6,,17,"(10.445761,-75.516429)"
2013,Junio,Chile,152,8,7,,15,"(10.886611,-74.776708)"
2013,Junio,Chile,152,388,289,,677,"(3.541112,-76.384584)"
2013,Junio,Chile,152,2423,2466,,4889,"(4.697144,-74.140516)"
2013,Junio,Chile,152,20,21,,41,"(4.815061,-75.736532)"
2013,Junio,Chile,152,132,114,,246,"(6.171601,-75.427454)"
2013,Junio,Chile,152,1,4,,5,"(7.128456,-73.183637)"
2013,Junio,Chile,152,0,1,,1,"(7.927209,-72.507910)"
2013,Junio,China,156,0,2,,2,"(10.886611,-74.776708)"
2013,Junio,China,156,6,7,,13,"(3.541112,-76.384584)"
2013,Junio,China,156,330,385,,715,"(4.697144,-74.140516)"
2013,Junio,China,156,9,17,,26,"(6.171601,-75.427454)"
2013,Junio,Chipre,196,1,2,,3,"(4.697144,-74.140516)"
2013,Junio,Dinamarca,208,0,2,,2,"(3.541112,-76.384584)"
2013,Junio,Dinamarca,208,39,37,,76,"(4.697144,-74.140516)"
2013,Junio,Dinamarca,208,1,0,,1,"(6.171601,-75.427454)"
2013,Junio,Dominica,212,0,1,,1,"(4.697144,-74.140516)"
2013,Junio,Ecuador,218,659,636,,1295,"(0.25129,-76.875963)"
2013,Junio,Ecuador,218,9250,9287,,18537,"(0.814836,-77.662532)"
2013,Junio,Ecuador,218,133,134,,267,"(1.813928,-78.763924)"
2013,Junio,Ecuador,218,0,1,,1,"(10.445761,-75.516429)"
2013,Junio,Ecuador,218,5,9,,14,"(10.886611,-74.776708)"
2013,Junio,Ecuador,218,0,1,,1,"(12.586067,-81.702563)"
2013,Junio,Ecuador,218,947,866,,1813,"(3.541112,-76.384584)"
2013,Junio,Ecuador,218,2378,4058,,6436,"(4.697144,-74.140516)"
2013,Junio,Ecuador,218,2,5,,7,"(4.815061,-75.736532)"
2013,Junio,Ecuador,218,544,487,,1031,"(6.171601,-75.427454)"
2013,Junio,Ecuador,218,1,8,,9,"(7.128456,-73.183637)"
2013,Junio,Ecuador,218,1,0,,1,"(7.927209,-72.507910)"
2013,Junio,Egipto,818,132,67,,199,"(4.697144,-74.140516)"
2013,Junio,El Salvador,222,0,7,,7,"(10.445761,-75.516429)"
2013,Junio,El Salvador,222,5,9,,14,"(10.886611,-74.776708)"
2013,Junio,El Salvador,222,116,114,,230,"(3.541112,-76.384584)"
2013,Junio,El Salvador,222,931,884,,1815,"(4.697144,-74.140516)"
2013,Junio,El Salvador,222,0,2,,2,"(4.815061,-75.736532)"
2013,Junio,El Salvador,222,103,110,,213,"(6.171601,-75.427454)"
2013,Junio,Emiratos Árabes,784,0,1,,1,"(10.886611,-74.776708)"
2013,Junio,Emiratos Árabes,784,84,197,,281,"(4.697144,-74.140516)"
2013,Junio,Eritrea,232,3,0,,3,"(4.697144,-74.140516)"
2013,Junio,Eslovaquia,703,1,3,,4,"(4.697144,-74.140516)"
2013,Junio,Eslovenia,705,1,0,,1,"(10.445761,-75.516429)"
2013,Junio,Eslovenia,705,2,1,,3,"(4.697144,-74.140516)"
2013,Junio,Eslovenia,705,1,0,,1,"(6.171601,-75.427454)"
2013,Junio,Estados Unidos de América,840,2681,2251,,4932,"(10.445761,-75.516429)"
2013,Junio,Estados Unidos de América,840,2725,2117,,4842,"(10.886611,-74.776708)"
2013,Junio,Estados Unidos de América,840,29,28,,57,"(12.586067,-81.702563)"
2013,Junio,Estados Unidos de América,840,5844,4359,,10203,"(3.541112,-76.384584)"
2013,Junio,Estados Unidos de América,840,499,415,,914,"(4.452882,-75.766298)"
2013,Junio,Estados Unidos de América,840,41730,35399,,77129,"(4.697144,-74.140516)"
2013,Junio,Estados Unidos de América,840,581,462,,1043,"(4.815061,-75.736532)"
2013,Junio,Estados Unidos de América,840,10330,7866,,18196,"(6.171601,-75.427454)"
2013,Junio,Estados Unidos de América,840,309,217,,526,"(7.128456,-73.183637)"
2013,Junio,Estados Unidos de América,840,3,1,,4,"(7.818934,-72.453226)"
2013,Junio,Estados Unidos de América,840,69,59,,128,"(7.927209,-72.507910)"
2013,Junio,Estonia,233,2,0,,2,"(4.697144,-74.140516)"
2013,Junio,Etiopia,231,0,1,,1,"(4.697144,-74.140516)"
2013,Junio,Filipinas,608,1,2,,3,"(4.697144,-74.140516)"
2013,Junio,Filipinas,608,3,2,,5,"(6.171601,-75.427454)"
2013,Junio,Finlandia,246,1,1,,2,"(10.445761,-75.516429)"
2013,Junio,Finlandia,246,11,11,,22,"(4.697144,-74.140516)"
2013,Junio,Finlandia,246,1,0,,1,"(6.171601,-75.427454)"
2013,Junio,Francia,250,1,0,,1,"(10.445761,-75.516429)"
2013,Junio,Francia,250,2,2,,4,"(10.886611,-74.776708)"
2013,Junio,Francia,250,77,47,,124,"(3.541112,-76.384584)"
2013,Junio,Francia,250,2205,1660,,3865,"(4.697144,-74.140516)"
2013,Junio,Francia,250,36,32,,68,"(6.171601,-75.427454)"
2013,Junio,Gabón,266,0,2,,2,"(4.697144,-74.140516)"
2013,Junio,Ghana,288,1,0,,1,"(4.697144,-74.140516)"
2013,Junio,Granada,308,1,0,,1,"(10.445761,-75.516429)"
2013,Junio,Granada,308,1,1,,2,"(4.697144,-74.140516)"
2013,Junio,Granada,308,0,1,,1,"(6.171601,-75.427454)"
2013,Junio,Grecia,300,1,0,,1,"(3.541112,-76.384584)"
2013,Junio,Grecia,300,28,21,,49,"(4.697144,-74.140516)"
2013,Junio,Guatemala,320,4,7,,11,"(10.445761,-75.516429)"
2013,Junio,Guatemala,320,3,10,,13,"(10.886611,-74.776708)"
2013,Junio,Guatemala,320,43,83,,126,"(3.541112,-76.384584)"
2013,Junio,Guatemala,320,157,293,,450,"(4.697144,-74.140516)"
2013,Junio,Guatemala,320,9,9,,18,"(4.815061,-75.736532)"
2013,Junio,Guatemala,320,56,80,,136,"(6.171601,-75.427454)"
2013,Junio,Guatemala,320,3,6,,9,"(7.128456,-73.183637)"
2013,Junio,Guatemala,320,0,1,,1,"(7.927209,-72.507910)"
2013,Junio,Guyana,328,1,1,,2,"(10.886611,-74.776708)"
2013,Junio,Guyana,328,3,5,,8,"(4.697144,-74.140516)"
2013,Junio,Guyana,328,1,0,,1,"(6.171601,-75.427454)"
2013,Junio,Guinea,324,0,4,,4,"(4.697144,-74.140516)"
2013,Junio,Guinea Ecuatorial,226,0,1,,1,"(3.541112,-76.384584)"
2013,Junio,Guinea Ecuatorial,226,3,8,,11,"(4.697144,-74.140516)"
2013,Junio,Guayana Francesa/Departamento de Ultramar Francés,254,1,0,,1,"(4.697144,-74.140516)"
2013,Junio,Haití,332,1,1,,2,"(10.445761,-75.516429)"
2013,Junio,Haití,332,0,5,,5,"(10.886611,-74.776708)"
2013,Junio,Haití,332,0,1,,1,"(3.541112,-76.384584)"
2013,Junio,Haití,332,3,8,,11,"(4.697144,-74.140516)"
2013,Junio,Haití,332,6,10,,16,"(6.171601,-75.427454)"
2013,Junio,Honduras,340,1,20,,21,"(10.445761,-75.516429)"
2013,Junio,Honduras,340,5,12,,17,"(10.886611,-74.776708)"
2013,Junio,Honduras,340,3,0,,3,"(12.586067,-81.702563)"
2013,Junio,Honduras,340,10,32,,42,"(3.541112,-76.384584)"
2013,Junio,Honduras,340,77,159,,236,"(4.697144,-74.140516)"
2013,Junio,Honduras,340,2,4,,6,"(4.815061,-75.736532)"
2013,Junio,Honduras,340,36,42,,78,"(6.171601,-75.427454)"
2013,Junio,Honduras,340,3,1,,4,"(7.128456,-73.183637)"
2013,Junio,Honduras,340,1,0,,1,"(7.927209,-72.507910)"
2013,Junio,Hong Kong,344,1,2,,3,"(3.541112,-76.384584)"
2013,Junio,Hong Kong,344,41,51,,92,"(4.697144,-74.140516)"
2013,Junio,Hong Kong,344,0,1,,1,"(6.171601,-75.427454)"
2013,Junio,Hungría,348,0,1,,1,"(3.541112,-76.384584)"
2013,Junio,Hungría,348,10,8,,18,"(4.697144,-74.140516)"
2013,Junio,India,356,1,1,,2,"(3.541112,-76.384584)"
2013,Junio,India,356,30,37,,67,"(4.697144,-74.140516)"
2013,Junio,India,356,2,5,,7,"(6.171601,-75.427454)"
2013,Junio,Indonesia,360,1,0,,1,"(10.886611,-74.776708)"
2013,Junio,Indonesia,360,1,0,,1,"(3.541112,-76.384584)"
2013,Junio,Indonesia,360,13,12,,25,"(4.697144,-74.140516)"
2013,Junio,Indonesia,360,1,2,,3,"(6.171601,-75.427454)"
2013,Junio,Iraq,368,0,17,,17,"(4.697144,-74.140516)"
2013,Junio,Irán,364,1,4,,5,"(4.697144,-74.140516)"
2013,Junio,República de Irlanda,372,1,1,,2,"(3.541112,-76.384584)"
2013,Junio,República de Irlanda,372,18,9,,27,"(4.697144,-74.140516)"
2013,Junio,República de Irlanda,372,1,0,,1,"(6.171601,-75.427454)"
2013,Junio,Islandia,352,2,2,,4,"(4.697144,-74.140516)"
2013,Junio,Israel,376,7,6,,13,"(3.541112,-76.384584)"
2013,Junio,Israel,376,226,155,,381,"(4.697144,-74.140516)"
2013,Junio,Israel,376,10,5,,15,"(6.171601,-75.427454)"
2013,Junio,Italia,380,6,1,,7,"(10.445761,-75.516429)"
2013,Junio,Italia,380,2,6,,8,"(10.886611,-74.776708)"
2013,Junio,Italia,380,95,46,,141,"(3.541112,-76.384584)"
2013,Junio,Italia,380,765,521,,1286,"(4.697144,-74.140516)"
2013,Junio,Italia,380,0,1,,1,"(4.815061,-75.736532)"
2013,Junio,Italia,380,48,46,,94,"(6.171601,-75.427454)"
2013,Junio,Jamaica,388,4,3,,7,"(10.445761,-75.516429)"
2013,Junio,Jamaica,388,1,3,,4,"(10.886611,-74.776708)"
2013,Junio,Jamaica,388,4,4,,8,"(3.541112,-76.384584)"
2013,Junio,Jamaica,388,51,37,,88,"(4.697144,-74.140516)"
2013,Junio,Jamaica,388,4,2,,6,"(4.815061,-75.736532)"
2013,Junio,Jamaica,388,27,25,,52,"(6.171601,-75.427454)"
2013,Junio,Jamaica,388,1,0,,1,"(7.128456,-73.183637)"
2013,Junio,Japón,392,0,1,,1,"(10.886611,-74.776708)"
2013,Junio,Japón,392,2,1,,3,"(3.541112,-76.384584)"
2013,Junio,Japón,392,58,71,,129,"(4.697144,-74.140516)"
2013,Junio,Japón,392,5,2,,7,"(6.171601,-75.427454)"
2013,Junio,Jordania,400,9,12,,21,"(4.697144,-74.140516)"
2013,Junio,Kazajistán,398,0,1,,1,"(7.128456,-73.183637)"
2013,Junio,Kenia,404,4,4,,8,"(4.697144,-74.140516)"
2013,Junio,Letonia,428,0,2,,2,"(4.697144,-74.140516)"
2013,Junio,Lituania,440,1,19,,20,"(4.697144,-74.140516)"
2013,Junio,Líbano,422,43,38,,81,"(4.697144,-74.140516)"
2013,Junio,Luxemburgo,442,5,5,,10,"(4.697144,-74.140516)"
2013,Junio,Malasia,458,10,17,,27,"(4.697144,-74.140516)"
2013,Junio,Malasia,458,1,3,,4,"(6.171601,-75.427454)"
2013,Junio,Malawi,454,0,1,,1,"(4.697144,-74.140516)"
2013,Junio,Maldivas,462,0,1,,1,"(4.697144,-74.140516)"
2013,Junio,Malí,466,1,2,,3,"(4.697144,-74.140516)"
2013,Junio,Malta,470,3,6,,9,"(4.697144,-74.140516)"
2013,Junio,Marruecos,504,0,1,,1,"(3.541112,-76.384584)"
2013,Junio,Marruecos,504,24,10,,34,"(4.697144,-74.140516)"
2013,Junio,Marruecos,504,0,2,,2,"(6.171601,-75.427454)"
2013,Junio,México,484,5,6,,11,"(0.814836,-77.662532)"
2013,Junio,México,484,70,79,,149,"(10.445761,-75.516429)"
2013,Junio,México,484,136,102,,238,"(10.886611,-74.776708)"
2013,Junio,México,484,1,3,,4,"(12.586067,-81.702563)"
2013,Junio,México,484,656,543,,1199,"(3.541112,-76.384584)"
2013,Junio,México,484,8532,7321,,15853,"(4.697144,-74.140516)"
2013,Junio,México,484,143,113,,256,"(4.815061,-75.736532)"
2013,Junio,México,484,1790,1394,,3184,"(6.171601,-75.427454)"
2013,Junio,México,484,145,148,,293,"(7.128456,-73.183637)"
2013,Junio,México,484,38,40,,78,"(7.927209,-72.507910)"
2013,Junio,Mónaco,492,1,0,,1,"(3.541112,-76.384584)"
2013,Junio,Mónaco,492,1,3,,4,"(4.697144,-74.140516)"
2013,Junio,Mozambique,508,2,3,,5,"(4.697144,-74.140516)"
2013,Junio,Myanmar,104,0,1,,1,"(4.697144,-74.140516)"
2013,Junio,Nepal,524,1,0,,1,"(4.697144,-74.140516)"
2013,Junio,Nicaragua,558,1,1,,2,"(10.445761,-75.516429)"
2013,Junio,Nicaragua,558,2,1,,3,"(10.886611,-74.776708)"
2013,Junio,Nicaragua,558,1,2,,3,"(12.586067,-81.702563)"
2013,Junio,Nicaragua,558,6,10,,16,"(3.541112,-76.384584)"
2013,Junio,Nicaragua,558,36,70,,106,"(4.697144,-74.140516)"
2013,Junio,Nicaragua,558,12,41,,53,"(6.171601,-75.427454)"
2013,Junio,Nicaragua,558,1,1,,2,"(7.128456,-73.183637)"
2013,Junio,Nigeria,566,2,9,,11,"(4.697144,-74.140516)"
2013,Junio,Noruega,578,0,1,,1,"(10.886611,-74.776708)"
2013,Junio,Noruega,578,2,1,,3,"(3.541112,-76.384584)"
2013,Junio,Noruega,578,46,36,,82,"(4.697144,-74.140516)"
2013,Junio,Noruega,578,6,3,,9,"(6.171601,-75.427454)"
2013,Junio,Noruega,578,0,1,,1,"(7.128456,-73.183637)"
2013,Junio,Nueva Zelanda,554,15,10,,25,"(4.697144,-74.140516)"
2013,Junio,Nueva Zelanda,554,1,2,,3,"(6.171601,-75.427454)"
2013,Junio,Omán,512,1,6,,7,"(4.697144,-74.140516)"
2013,Junio,Papúa Nueva Guinea,598,0,1,,1,"(3.541112,-76.384584)"
2013,Junio,Papúa Nueva Guinea,598,0,14,,14,"(4.697144,-74.140516)"
2013,Junio,Pakistán,586,0,1,,1,"(4.697144,-74.140516)"
2013,Junio,Palau,585,1,0,,1,"(6.171601,-75.427454)"
2013,Junio,Panamá,591,33,94,,127,"(10.408582,-75.538003)"
2013,Junio,Panamá,591,428,425,,853,"(10.445761,-75.516429)"
2013,Junio,Panamá,591,837,895,,1732,"(10.886611,-74.776708)"
2013,Junio,Panamá,591,0,2,,2,"(10.971302,-74.765397)"
2013,Junio,Panamá,591,0,8,,8,"(11.247723,-74.213989)"
2013,Junio,Panamá,591,1,4,,5,"(12.5744111,-81.703935)"
2013,Junio,Panamá,591,76,72,,148,"(12.586067,-81.702563)"
2013,Junio,Panamá,591,2104,1866,,3970,"(3.541112,-76.384584)"
2013,Junio,Panamá,591,7445,7680,,15125,"(4.697144,-74.140516)"
2013,Junio,Panamá,591,447,412,,859,"(4.815061,-75.736532)"
2013,Junio,Panamá,591,2584,2344,,4928,"(6.171601,-75.427454)"
2013,Junio,Panamá,591,226,197,,423,"(7.128456,-73.183637)"
2013,Junio,Panamá,591,232,206,,438,"(7.927209,-72.507910)"
2013,Junio,Panamá,591,1,24,,25,"(8.066966,-76.735404)"
2013,Junio,Panamá,591,77,163,,240,"(8.635765,-77.346578)"
2013,Junio,Paraguay,600,1,1,,2,"(0.814836,-77.662532)"
2013,Junio,Paraguay,600,1,2,,3,"(10.445761,-75.516429)"
2013,Junio,Paraguay,600,0,5,,5,"(10.886611,-74.776708)"
2013,Junio,Paraguay,600,2,7,,9,"(3.541112,-76.384584)"
2013,Junio,Paraguay,600,39,156,,195,"(4.697144,-74.140516)"
2013,Junio,Paraguay,600,0,1,,1,"(4.815061,-75.736532)"
2013,Junio,Paraguay,600,4,8,,12,"(6.171601,-75.427454)"
2013,Junio,Paraguay,600,3,0,,3,"(7.128456,-73.183637)"
2013,Junio,Perú,604,107,187,,294,"(-4.197703,-69.941278)"
2013,Junio,Perú,604,1,1,,2,"(0.25129,-76.875963)"
2013,Junio,Perú,604,18,34,,52,"(0.814836,-77.662532)"
2013,Junio,Perú,604,5,13,,18,"(10.445761,-75.516429)"
2013,Junio,Perú,604,13,24,,37,"(10.886611,-74.776708)"
2013,Junio,Perú,604,223,232,,455,"(3.541112,-76.384584)"
2013,Junio,Perú,604,3693,4363,,8056,"(4.697144,-74.140516)"
2013,Junio,Perú,604,5,11,,16,"(4.815061,-75.736532)"
2013,Junio,Perú,604,432,455,,887,"(6.171601,-75.427454)"
2013,Junio,Perú,604,2,2,,4,"(7.128456,-73.183637)"
2013,Junio,Palestina,99999,1,1,,2,"(4.697144,-74.140516)"
2013,Junio,Palestina,99999,0,1,,1,"(6.171601,-75.427454)"
2013,Junio,Polonia,616,1,0,,1,"(10.445761,-75.516429)"
2013,Junio,Polonia,616,0,1,,1,"(3.541112,-76.384584)"
2013,Junio,Polonia,616,30,35,,65,"(4.697144,-74.140516)"
2013,Junio,Polonia,616,2,1,,3,"(6.171601,-75.427454)"
2013,Junio,Portugal,620,10,9,,19,"(3.541112,-76.384584)"
2013,Junio,Portugal,620,62,61,,123,"(4.697144,-74.140516)"
2013,Junio,Portugal,620,0,2,,2,"(6.171601,-75.427454)"
2013,Junio,Puerto Rico/Territorio de Estados Unidos,630,16,8,,24,"(10.445761,-75.516429)"
2013,Junio,Puerto Rico/Territorio de Estados Unidos,630,16,17,,33,"(10.886611,-74.776708)"
2013,Junio,Puerto Rico/Territorio de Estados Unidos,630,42,42,,84,"(3.541112,-76.384584)"
2013,Junio,Puerto Rico/Territorio de Estados Unidos,630,105,118,,223,"(4.697144,-74.140516)"
2013,Junio,Puerto Rico/Territorio de Estados Unidos,630,12,11,,23,"(4.815061,-75.736532)"
2013,Junio,Puerto Rico/Territorio de Estados Unidos,630,45,35,,80,"(6.171601,-75.427454)"
2013,Junio,Puerto Rico/Territorio de Estados Unidos,630,5,6,,11,"(7.128456,-73.183637)"
2013,Junio,Qatar,634,3,4,,7,"(4.697144,-74.140516)"
2013,Junio,Qatar,634,1,0,,1,"(6.171601,-75.427454)"
2013,Junio,Reino Unido de Gran Bretaña e Irlanda del Norte,826,0,2,,2,"(10.445761,-75.516429)"
2013,Junio,Reino Unido de Gran Bretaña e Irlanda del Norte,826,3,2,,5,"(10.886611,-74.776708)"
2013,Junio,Reino Unido de Gran Bretaña e Irlanda del Norte,826,66,37,,103,"(3.541112,-76.384584)"
2013,Junio,Reino Unido de Gran Bretaña e Irlanda del Norte,826,1088,729,,1817,"(4.697144,-74.140516)"
2013,Junio,Reino Unido de Gran Bretaña e Irlanda del Norte,826,58,44,,102,"(6.171601,-75.427454)"
2013,Junio,Federación de Rusia,643,0,1,,1,"(10.445761,-75.516429)"
2013,Junio,Federación de Rusia,643,3,1,,4,"(10.886611,-74.776708)"
2013,Junio,Federación de Rusia,643,1,0,,1,"(3.541112,-76.384584)"
2013,Junio,Federación de Rusia,643,124,163,,287,"(4.697144,-74.140516)"
2013,Junio,Federación de Rusia,643,3,1,,4,"(6.171601,-75.427454)"
2013,Junio,República Dominicana,214,0,9,,9,"(10.408582,-75.538003)"
2013,Junio,República Dominicana,214,6,13,,19,"(10.445761,-75.516429)"
2013,Junio,República Dominicana,214,13,18,,31,"(10.886611,-74.776708)"
2013,Junio,República Dominicana,214,194,190,,384,"(3.541112,-76.384584)"
2013,Junio,República Dominicana,214,1627,1585,,3212,"(4.697144,-74.140516)"
2013,Junio,República Dominicana,214,6,3,,9,"(4.815061,-75.736532)"
2013,Junio,República Dominicana,214,205,194,,399,"(6.171601,-75.427454)"
2013,Junio,República Dominicana,214,4,3,,7,"(7.128456,-73.183637)"
2013,Junio,República Dominicana,214,2,3,,5,"(7.927209,-72.507910)"
2013,Junio,Rumania,642,6,7,,13,"(4.697144,-74.140516)"
2013,Junio,Rwanda,646,0,1,,1,"(4.697144,-74.140516)"
2013,Junio,Sahara Occidental/Desierto Sahara,732,0,1,,1,"(4.697144,-74.140516)"
2013,Junio,San  Vicente y las Granadinas,670,1,1,,2,"(4.697144,-74.140516)"
2013,Junio,San  Vicente y las Granadinas,670,2,0,,2,"(6.171601,-75.427454)"
2013,Junio,Senegal,686,0,1,,1,"(4.697144,-74.140516)"
2013,Junio,Islas Svalbard,744,0,1,,1,"(4.697144,-74.140516)"
2013,Junio,Singapur,702,1,0,,1,"(3.541112,-76.384584)"
2013,Junio,Singapur,702,13,23,,36,"(4.697144,-74.140516)"
2013,Junio,Singapur,702,3,0,,3,"(6.171601,-75.427454)"
2013,Junio,Sri Lanka,144,1,1,,2,"(4.697144,-74.140516)"
2013,Junio,Sudáfrica,710,19,27,,46,"(4.697144,-74.140516)"
2013,Junio,Suecia,752,4,2,,6,"(10.445761,-75.516429)"
2013,Junio,Suecia,752,4,2,,6,"(10.886611,-74.776708)"
2013,Junio,Suecia,752,7,3,,10,"(3.541112,-76.384584)"
2013,Junio,Suecia,752,84,75,,159,"(4.697144,-74.140516)"
2013,Junio,Suecia,752,6,2,,8,"(6.171601,-75.427454)"
2013,Junio,Suiza,756,6,3,,9,"(10.445761,-75.516429)"
2013,Junio,Suiza,756,31,17,,48,"(3.541112,-76.384584)"
2013,Junio,Suiza,756,255,239,,494,"(4.697144,-74.140516)"
2013,Junio,Suiza,756,19,6,,25,"(6.171601,-75.427454)"
2013,Junio,Surinam,740,5,5,,10,"(4.697144,-74.140516)"
2013,Junio,Taiwán,158,4,7,,11,"(4.697144,-74.140516)"
2013,Junio,Tailandia,764,31,20,,51,"(4.697144,-74.140516)"
2013,Junio,Togo,768,0,1,,1,"(4.697144,-74.140516)"
2013,Junio,Trinidad y Tobago,780,1,2,,3,"(10.445761,-75.516429)"
2013,Junio,Trinidad y Tobago,780,1,1,,2,"(10.886611,-74.776708)"
2013,Junio,Trinidad y Tobago,780,6,4,,10,"(3.541112,-76.384584)"
2013,Junio,Trinidad y Tobago,780,20,34,,54,"(4.697144,-74.140516)"
2013,Junio,Trinidad y Tobago,780,0,1,,1,"(4.815061,-75.736532)"
2013,Junio,Trinidad y Tobago,780,11,8,,19,"(6.171601,-75.427454)"
2013,Junio,Trinidad y Tobago,780,1,4,,5,"(7.128456,-73.183637)"
2013,Junio,Trinidad y Tobago,780,4,0,,4,"(7.927209,-72.507910)"
2013,Junio,Túnez,788,1,2,,3,"(4.697144,-74.140516)"
2013,Junio,Turquía,792,5,3,,8,"(3.541112,-76.384584)"
2013,Junio,Turquía,792,107,145,,252,"(4.697144,-74.140516)"
2013,Junio,Turquía,792,1,2,,3,"(6.171601,-75.427454)"
2013,Junio,Turquía,792,0,1,,1,"(7.818934,-72.453226)"
2013,Junio,Ucrania,804,3,12,,15,"(4.697144,-74.140516)"
2013,Junio,Uganda,800,0,1,,1,"(10.445761,-75.516429)"
2013,Junio,Uganda,800,2,1,,3,"(4.697144,-74.140516)"
2013,Junio,Uruguay,858,1,1,,2,"(10.445761,-75.516429)"
2013,Junio,Uruguay,858,1,3,,4,"(10.886611,-74.776708)"
2013,Junio,Uruguay,858,1,0,,1,"(12.586067,-81.702563)"
2013,Junio,Uruguay,858,7,0,,7,"(3.541112,-76.384584)"
2013,Junio,Uruguay,858,40,53,,93,"(4.697144,-74.140516)"
2013,Junio,Uruguay,858,10,6,,16,"(6.171601,-75.427454)"
2013,Junio,Uruguay,858,1,0,,1,"(7.128456,-73.183637)"
2013,Junio,Venezuela,862,6,8,,14,"(10.445761,-75.516429)"
2013,Junio,Venezuela,862,11,24,,35,"(10.886611,-74.776708)"
2013,Junio,Venezuela,862,12701,10224,,22925,"(11.360009,-72.129330)"
2013,Junio,Venezuela,862,11,11,,22,"(3.541112,-76.384584)"
2013,Junio,Venezuela,862,2480,3049,,5529,"(4.697144,-74.140516)"
2013,Junio,Venezuela,862,2,5,,7,"(4.815061,-75.736532)"
2013,Junio,Venezuela,862,308,331,,639,"(6.171601,-75.427454)"
2013,Junio,Venezuela,862,484,567,,1051,"(6.185799,-67.483929)"
2013,Junio,Venezuela,862,1672,1372,,3044,"(7.088729,-70.740253)"
2013,Junio,Venezuela,862,0,1,,1,"(7.128456,-73.183637)"
2013,Junio,Venezuela,862,9238,8444,,17682,"(7.818934,-72.453226)"
2013,Junio,Venezuela,862,2,1,,3,"(7.927209,-72.507910)"
2013,Junio,Vietnam,704,2,3,,5,"(4.697144,-74.140516)"
2013,Junio,Islas Vírgenes Británicas/Territorio Británico de Ultramar,92,1,0,,1,"(3.541112,-76.384584)"
2013,Junio,Islas Vírgenes Británicas/Territorio Británico de Ultramar,92,1,0,,1,"(4.697144,-74.140516)"
2013,Junio,Desconocido,99999,0,1,,1,"(10.886611,-74.776708)"
2013,Junio,Desconocido,99999,6,24,,30,"(4.697144,-74.140516)"
2013,Julio,Afganistán,4,2,38,,40,"(4.697144,-74.140516)"
2013,Julio,Afganistán,4,0,1,,1,"(6.171601,-75.427454)"
2013,Julio,Alemania,276,25,12,,37,"(3.541112,-76.384584)"
2013,Julio,Alemania,276,1258,1103,,2361,"(4.697144,-74.140516)"
2013,Julio,Alemania,276,9,9,,18,"(6.171601,-75.427454)"
2013,Julio,Andorra,20,2,0,,2,"(4.697144,-74.140516)"
2013,Julio,Angola,24,0,1,,1,"(3.541112,-76.384584)"
2013,Julio,Angola,24,3,13,,16,"(4.697144,-74.140516)"
2013,Julio,Antigua y Barbuda,28,1,4,,5,"(10.445761,-75.516429)"
2013,Julio,Antigua y Barbuda,28,0,2,,2,"(4.697144,-74.140516)"
2013,Julio,Países Bajos,528,159,125,,284,"(10.408582,-75.538003)"
2013,Julio,Países Bajos,528,2,3,,5,"(10.445761,-75.516429)"
2013,Julio,Países Bajos,528,3,3,,6,"(10.886611,-74.776708)"
2013,Julio,Países Bajos,528,43,23,,66,"(3.541112,-76.384584)"
2013,Julio,Países Bajos,528,201,178,,379,"(4.697144,-74.140516)"
2013,Julio,Países Bajos,528,1,0,,1,"(4.815061,-75.736532)"
2013,Julio,Países Bajos,528,54,54,,108,"(6.171601,-75.427454)"
2013,Julio,Países Bajos,528,1,0,,1,"(7.128456,-73.183637)"
2013,Julio,Países Bajos,528,2,0,,2,"(7.927209,-72.507910)"
2013,Julio,Arabia Saudita,682,0,2,,2,"(3.541112,-76.384584)"
2013,Julio,Arabia Saudita,682,6,27,,33,"(4.697144,-74.140516)"
2013,Julio,Arabia Saudita,682,0,1,,1,"(4.815061,-75.736532)"
2013,Julio,Arabia Saudita,682,0,1,,1,"(6.171601,-75.427454)"
2013,Julio,Argelia,12,0,3,,3,"(4.697144,-74.140516)"
2013,Julio,Argelia,12,0,1,,1,"(6.171601,-75.427454)"
2013,Julio,Argentina,32,7,8,,15,"(0.814836,-77.662532)"
2013,Julio,Argentina,32,0,1,,1,"(10.408582,-75.538003)"
2013,Julio,Argentina,32,9,5,,14,"(10.445761,-75.516429)"
2013,Julio,Argentina,32,21,8,,29,"(10.886611,-74.776708)"
2013,Julio,Argentina,32,124,115,,239,"(3.541112,-76.384584)"
2013,Julio,Argentina,32,2200,2405,,4605,"(4.697144,-74.140516)"
2013,Julio,Argentina,32,8,4,,12,"(4.815061,-75.736532)"
2013,Julio,Argentina,32,203,140,,343,"(6.171601,-75.427454)"
2013,Julio,Argentina,32,5,6,,11,"(7.128456,-73.183637)"
2013,Julio,Argentina,32,1,2,,3,"(7.818934,-72.453226)"
2013,Julio,Argentina,32,1,1,,2,"(7.927209,-72.507910)"
2013,Julio,Aruba,533,1319,977,,2296,"(10.408582,-75.538003)"
2013,Julio,Aruba,533,4,17,,21,"(10.445761,-75.516429)"
2013,Julio,Aruba,533,14,8,,22,"(10.886611,-74.776708)"
2013,Julio,Aruba,533,84,62,,146,"(11.528919,-72.919681)"
2013,Julio,Aruba,533,58,51,,109,"(3.541112,-76.384584)"
2013,Julio,Aruba,533,1019,847,,1866,"(4.697144,-74.140516)"
2013,Julio,Aruba,533,14,9,,23,"(4.815061,-75.736532)"
2013,Julio,Aruba,533,63,39,,102,"(6.171601,-75.427454)"
2013,Julio,Aruba,533,4,11,,15,"(7.128456,-73.183637)"
2013,Julio,Australia,36,1,1,,2,"(10.445761,-75.516429)"
2013,Julio,Australia,36,1,3,,4,"(10.886611,-74.776708)"
2013,Julio,Australia,36,8,11,,19,"(3.541112,-76.384584)"
2013,Julio,Australia,36,211,236,,447,"(4.697144,-74.140516)"
2013,Julio,Australia,36,24,26,,50,"(6.171601,-75.427454)"
2013,Julio,Australia,36,1,1,,2,"(7.128456,-73.183637)"
2013,Julio,Austria,40,0,1,,1,"(3.541112,-76.384584)"
2013,Julio,Austria,40,46,36,,82,"(4.697144,-74.140516)"
2013,Julio,Austria,40,1,3,,4,"(6.171601,-75.427454)"
2013,Julio,Azerbaiyán,31,3,4,,7,"(4.697144,-74.140516)"
2013,Julio,Bahamas,44,1,3,,4,"(10.445761,-75.516429)"
2013,Julio,Bahamas,44,2,5,,7,"(10.886611,-74.776708)"
2013,Julio,Bahamas,44,3,4,,7,"(3.541112,-76.384584)"
2013,Julio,Bahamas,44,17,20,,37,"(4.697144,-74.140516)"
2013,Julio,Bahamas,44,6,4,,10,"(4.815061,-75.736532)"
2013,Julio,Bahamas,44,21,17,,38,"(6.171601,-75.427454)"
2013,Julio,Bahréin,48,0,1,,1,"(3.541112,-76.384584)"
2013,Julio,Bahréin,48,3,4,,7,"(4.697144,-74.140516)"
2013,Julio,Bahréin,48,1,0,,1,"(7.818934,-72.453226)"
2013,Julio,Bangladesh,50,0,1,,1,"(4.697144,-74.140516)"
2013,Julio,Barbados,52,0,15,,15,"(4.697144,-74.140516)"
2013,Julio,Barbados,52,2,0,,2,"(6.171601,-75.427454)"
2013,Julio,República de Belarús,112,2,1,,3,"(3.541112,-76.384584)"
2013,Julio,República de Belarús,112,4,2,,6,"(4.697144,-74.140516)"
2013,Julio,República de Belarús,112,1,0,,1,"(7.818934,-72.453226)"
2013,Julio,Bélgica,56,1,0,,1,"(10.445761,-75.516429)"
2013,Julio,Bélgica,56,1,0,,1,"(10.886611,-74.776708)"
2013,Julio,Bélgica,56,18,7,,25,"(3.541112,-76.384584)"
2013,Julio,Bélgica,56,106,81,,187,"(4.697144,-74.140516)"
2013,Julio,Bélgica,56,15,6,,21,"(6.171601,-75.427454)"
2013,Julio,Belice,84,0,5,,5,"(4.697144,-74.140516)"
2013,Julio,Benín,204,1,1,,2,"(4.697144,-74.140516)"
2013,Julio,Bermudas/Territorio Británico de Ultramar,60,1,3,,4,"(4.697144,-74.140516)"
2013,Julio,Bermudas/Territorio Británico de Ultramar,60,0,1,,1,"(7.927209,-72.507910)"
2013,Julio,Bolivia,68,5,5,,10,"(0.814836,-77.662532)"
2013,Julio,Bolivia,68,3,7,,10,"(10.886611,-74.776708)"
2013,Julio,Bolivia,68,12,14,,26,"(3.541112,-76.384584)"
2013,Julio,Bolivia,68,286,388,,674,"(4.697144,-74.140516)"
2013,Julio,Bolivia,68,2,1,,3,"(4.815061,-75.736532)"
2013,Julio,Bolivia,68,21,37,,58,"(6.171601,-75.427454)"
2013,Julio,Bolivia,68,0,2,,2,"(7.128456,-73.183637)"
2013,Julio,Bosnia y Herzegovina,70,1,0,,1,"(4.697144,-74.140516)"
2013,Julio,Brasil,76,88,155,,243,"(-4.197703,-69.941278)"
2013,Julio,Brasil,76,1,1,,2,"(0.814836,-77.662532)"
2013,Julio,Brasil,76,30,7,,37,"(10.445761,-75.516429)"
2013,Julio,Brasil,76,33,30,,63,"(10.886611,-74.776708)"
2013,Julio,Brasil,76,0,3,,3,"(12.586067,-81.702563)"
2013,Julio,Brasil,76,28,40,,68,"(3.541112,-76.384584)"
2013,Julio,Brasil,76,4069,4313,,8382,"(4.697144,-74.140516)"
2013,Julio,Brasil,76,4,14,,18,"(4.815061,-75.736532)"
2013,Julio,Brasil,76,84,89,,173,"(6.171601,-75.427454)"
2013,Julio,Brasil,76,2,3,,5,"(7.128456,-73.183637)"
2013,Julio,Bulgaria,100,2,3,,5,"(4.697144,-74.140516)"
2013,Julio,Islas Caimán/Territorio Británico de Ultramar,136,2,2,,4,"(10.445761,-75.516429)"
2013,Julio,Islas Caimán/Territorio Británico de Ultramar,136,6,7,,13,"(12.586067,-81.702563)"
2013,Julio,Islas Caimán/Territorio Británico de Ultramar,136,1,0,,1,"(3.541112,-76.384584)"
2013,Julio,Islas Caimán/Territorio Británico de Ultramar,136,1,0,,1,"(6.171601,-75.427454)"
2013,Julio,Camboya,116,1,0,,1,"(4.697144,-74.140516)"
2013,Julio,Canadá,124,21,22,,43,"(10.445761,-75.516429)"
2013,Julio,Canadá,124,10,8,,18,"(10.886611,-74.776708)"
2013,Julio,Canadá,124,0,1,,1,"(12.586067,-81.702563)"
2013,Julio,Canadá,124,57,41,,98,"(3.541112,-76.384584)"
2013,Julio,Canadá,124,2,2,,4,"(4.452882,-75.766298)"
2013,Julio,Canadá,124,1751,1529,,3280,"(4.697144,-74.140516)"
2013,Julio,Canadá,124,4,4,,8,"(4.815061,-75.736532)"
2013,Julio,Canadá,124,162,164,,326,"(6.171601,-75.427454)"
2013,Julio,Canadá,124,5,2,,7,"(7.128456,-73.183637)"
2013,Julio,Canadá,124,0,1,,1,"(7.927209,-72.507910)"
2013,Julio,Chad,148,0,2,,2,"(4.697144,-74.140516)"
2013,Julio,España,724,12,9,,21,"(10.445761,-75.516429)"
2013,Julio,España,724,3,0,,3,"(10.886611,-74.776708)"
2013,Julio,España,724,0,2,,2,"(12.586067,-81.702563)"
2013,Julio,España,724,2011,1255,,3266,"(3.541112,-76.384584)"
2013,Julio,España,724,6255,4899,,11154,"(4.697144,-74.140516)"
2013,Julio,España,724,2,1,,3,"(4.815061,-75.736532)"
2013,Julio,España,724,812,593,,1405,"(6.171601,-75.427454)"
2013,Julio,España,724,0,2,,2,"(7.128456,-73.183637)"
2013,Julio,España,724,0,2,,2,"(7.818934,-72.453226)"
2013,Julio,República Democrática del Congo,180,2,4,,6,"(4.697144,-74.140516)"
2013,Julio,República de Corea,410,28,36,,64,"(4.697144,-74.140516)"
2013,Julio,República de Corea,410,2,3,,5,"(6.171601,-75.427454)"
2013,Julio,Costa de Marfil,384,0,2,,2,"(4.697144,-74.140516)"
2013,Julio,Costa Rica,188,13,10,,23,"(10.445761,-75.516429)"
2013,Julio,Costa Rica,188,14,23,,37,"(10.886611,-74.776708)"
2013,Julio,Costa Rica,188,4,1,,5,"(12.586067,-81.702563)"
2013,Julio,Costa Rica,188,60,70,,130,"(3.541112,-76.384584)"
2013,Julio,Costa Rica,188,795,966,,1761,"(4.697144,-74.140516)"
2013,Julio,Costa Rica,188,12,5,,17,"(4.815061,-75.736532)"
2013,Julio,Costa Rica,188,156,125,,281,"(6.171601,-75.427454)"
2013,Julio,Costa Rica,188,7,6,,13,"(7.128456,-73.183637)"
2013,Julio,Costa Rica,188,0,2,,2,"(7.927209,-72.507910)"
2013,Julio,Croacia,191,0,1,,1,"(4.697144,-74.140516)"
2013,Julio,Cuba,192,29,40,,69,"(10.445761,-75.516429)"
2013,Julio,Cuba,192,38,45,,83,"(10.886611,-74.776708)"
2013,Julio,Cuba,192,12,13,,25,"(12.586067,-81.702563)"
2013,Julio,Cuba,192,142,120,,262,"(3.541112,-76.384584)"
2013,Julio,Cuba,192,1187,1001,,2188,"(4.697144,-74.140516)"
2013,Julio,Cuba,192,7,6,,13,"(4.815061,-75.736532)"
2013,Julio,Cuba,192,101,91,,192,"(6.171601,-75.427454)"
2013,Julio,Cuba,192,8,5,,13,"(7.128456,-73.183637)"
2013,Julio,Cuba,192,1,3,,4,"(7.927209,-72.507910)"
2013,Julio,Curazao,99999,1,0,,1,"(10.445761,-75.516429)"
2013,Julio,Curazao,99999,0,1,,1,"(10.886611,-74.776708)"
2013,Julio,Curazao,99999,4,1,,5,"(3.541112,-76.384584)"
2013,Julio,Curazao,99999,595,613,,1208,"(4.697144,-74.140516)"
2013,Julio,Curazao,99999,131,71,,202,"(6.171601,-75.427454)"
2013,Julio,Curazao,99999,1,1,,2,"(7.927209,-72.507910)"
2013,Julio,República Checa,203,1,0,,1,"(3.541112,-76.384584)"
2013,Julio,República Checa,203,23,15,,38,"(4.697144,-74.140516)"
2013,Julio,República Checa,203,1,0,,1,"(6.171601,-75.427454)"
2013,Julio,Chile,152,38,32,,70,"(0.814836,-77.662532)"
2013,Julio,Chile,152,8,3,,11,"(10.445761,-75.516429)"
2013,Julio,Chile,152,12,10,,22,"(10.886611,-74.776708)"
2013,Julio,Chile,152,301,257,,558,"(3.541112,-76.384584)"
2013,Julio,Chile,152,2136,2084,,4220,"(4.697144,-74.140516)"
2013,Julio,Chile,152,34,37,,71,"(4.815061,-75.736532)"
2013,Julio,Chile,152,110,115,,225,"(6.171601,-75.427454)"
2013,Julio,Chile,152,2,2,,4,"(7.128456,-73.183637)"
2013,Julio,China,156,0,1,,1,"(10.445761,-75.516429)"
2013,Julio,China,156,0,2,,2,"(10.886611,-74.776708)"
2013,Julio,China,156,1,9,,10,"(3.541112,-76.384584)"
2013,Julio,China,156,147,336,,483,"(4.697144,-74.140516)"
2013,Julio,China,156,4,21,,25,"(6.171601,-75.427454)"
2013,Julio,Chipre,196,3,2,,5,"(4.697144,-74.140516)"
2013,Julio,Dinamarca,208,0,1,,1,"(10.886611,-74.776708)"
2013,Julio,Dinamarca,208,31,22,,53,"(4.697144,-74.140516)"
2013,Julio,Dinamarca,208,0,1,,1,"(6.171601,-75.427454)"
2013,Julio,Ecuador,218,533,653,,1186,"(0.25129,-76.875963)"
2013,Julio,Ecuador,218,10923,11336,,22259,"(0.814836,-77.662532)"
2013,Julio,Ecuador,218,175,206,,381,"(1.813928,-78.763924)"
2013,Julio,Ecuador,218,0,16,,16,"(10.408582,-75.538003)"
2013,Julio,Ecuador,218,5,23,,28,"(10.445761,-75.516429)"
2013,Julio,Ecuador,218,4,9,,13,"(10.886611,-74.776708)"
2013,Julio,Ecuador,218,768,707,,1475,"(3.541112,-76.384584)"
2013,Julio,Ecuador,218,2285,4093,,6378,"(4.697144,-74.140516)"
2013,Julio,Ecuador,218,1,3,,4,"(4.815061,-75.736532)"
2013,Julio,Ecuador,218,423,477,,900,"(6.171601,-75.427454)"
2013,Julio,Ecuador,218,1,2,,3,"(7.128456,-73.183637)"
2013,Julio,Ecuador,218,0,1,,1,"(7.927209,-72.507910)"
2013,Julio,Egipto,818,18,120,,138,"(4.697144,-74.140516)"
2013,Julio,El Salvador,222,3,2,,5,"(10.445761,-75.516429)"
2013,Julio,El Salvador,222,2,2,,4,"(10.886611,-74.776708)"
2013,Julio,El Salvador,222,105,130,,235,"(3.541112,-76.384584)"
2013,Julio,El Salvador,222,768,910,,1678,"(4.697144,-74.140516)"
2013,Julio,El Salvador,222,2,3,,5,"(4.815061,-75.736532)"
2013,Julio,El Salvador,222,103,126,,229,"(6.171601,-75.427454)"
2013,Julio,Emiratos Árabes,784,2,1,,3,"(3.541112,-76.384584)"
2013,Julio,Emiratos Árabes,784,51,205,,256,"(4.697144,-74.140516)"
2013,Julio,Emiratos Árabes,784,0,2,,2,"(6.171601,-75.427454)"
2013,Julio,Eritrea,232,2,1,,3,"(4.697144,-74.140516)"
2013,Julio,Eslovaquia,703,2,0,,2,"(4.697144,-74.140516)"
2013,Julio,Eslovenia,705,1,0,,1,"(10.886611,-74.776708)"
2013,Julio,Eslovenia,705,3,1,,4,"(4.697144,-74.140516)"
2013,Julio,Estados Unidos de América,840,0,4,,4,"(10.408582,-75.538003)"
2013,Julio,Estados Unidos de América,840,2253,1811,,4064,"(10.445761,-75.516429)"
2013,Julio,Estados Unidos de América,840,2515,2189,,4704,"(10.886611,-74.776708)"
2013,Julio,Estados Unidos de América,840,30,22,,52,"(12.586067,-81.702563)"
2013,Julio,Estados Unidos de América,840,6301,4535,,10836,"(3.541112,-76.384584)"
2013,Julio,Estados Unidos de América,840,518,346,,864,"(4.452882,-75.766298)"
2013,Julio,Estados Unidos de América,840,34556,30489,,65045,"(4.697144,-74.140516)"
2013,Julio,Estados Unidos de América,840,695,473,,1168,"(4.815061,-75.736532)"
2013,Julio,Estados Unidos de América,840,8279,6387,,14666,"(6.171601,-75.427454)"
2013,Julio,Estados Unidos de América,840,194,149,,343,"(7.128456,-73.183637)"
2013,Julio,Estados Unidos de América,840,70,44,,114,"(7.927209,-72.507910)"
2013,Julio,Estonia,233,0,1,,1,"(4.697144,-74.140516)"
2013,Julio,Etiopia,231,0,1,,1,"(0.814836,-77.662532)"
2013,Julio,Etiopia,231,0,2,,2,"(4.697144,-74.140516)"
2013,Julio,Filipinas,608,1,0,,1,"(3.541112,-76.384584)"
2013,Julio,Filipinas,608,3,2,,5,"(4.697144,-74.140516)"
2013,Julio,Filipinas,608,1,4,,5,"(6.171601,-75.427454)"
2013,Julio,Finlandia,246,0,1,,1,"(10.886611,-74.776708)"
2013,Julio,Finlandia,246,0,1,,1,"(3.541112,-76.384584)"
2013,Julio,Finlandia,246,10,4,,14,"(4.697144,-74.140516)"
2013,Julio,Francia,250,3,0,,3,"(10.445761,-75.516429)"
2013,Julio,Francia,250,1,0,,1,"(12.586067,-81.702563)"
2013,Julio,Francia,250,74,39,,113,"(3.541112,-76.384584)"
2013,Julio,Francia,250,1706,1365,,3071,"(4.697144,-74.140516)"
2013,Julio,Francia,250,1,0,,1,"(4.815061,-75.736532)"
2013,Julio,Francia,250,40,30,,70,"(6.171601,-75.427454)"
2013,Julio,Gabón,266,1,7,,8,"(4.697144,-74.140516)"
2013,Julio,Ghana,288,0,2,,2,"(4.697144,-74.140516)"
2013,Julio,Ghana,288,0,1,,1,"(6.171601,-75.427454)"
2013,Julio,Gibraltar/Territorio Británico de Ultramar,292,3,0,,3,"(4.697144,-74.140516)"
2013,Julio,Granada,308,1,0,,1,"(4.697144,-74.140516)"
2013,Julio,Granada,308,1,0,,1,"(6.171601,-75.427454)"
2013,Julio,Grecia,300,5,3,,8,"(3.541112,-76.384584)"
2013,Julio,Grecia,300,36,33,,69,"(4.697144,-74.140516)"
2013,Julio,Grecia,300,1,0,,1,"(6.171601,-75.427454)"
2013,Julio,Guatemala,320,1,4,,5,"(10.445761,-75.516429)"
2013,Julio,Guatemala,320,10,14,,24,"(10.886611,-74.776708)"
2013,Julio,Guatemala,320,1,2,,3,"(12.586067,-81.702563)"
2013,Julio,Guatemala,320,59,69,,128,"(3.541112,-76.384584)"
2013,Julio,Guatemala,320,216,317,,533,"(4.697144,-74.140516)"
2013,Julio,Guatemala,320,7,4,,11,"(4.815061,-75.736532)"
2013,Julio,Guatemala,320,79,118,,197,"(6.171601,-75.427454)"
2013,Julio,Guatemala,320,1,5,,6,"(7.128456,-73.183637)"
2013,Julio,Guatemala,320,1,1,,2,"(7.927209,-72.507910)"
2013,Julio,Guyana,328,2,0,,2,"(4.697144,-74.140516)"
2013,Julio,Guyana,328,2,1,,3,"(6.171601,-75.427454)"
2013,Julio,Guinea,324,1,0,,1,"(3.541112,-76.384584)"
2013,Julio,Guinea,324,0,5,,5,"(4.697144,-74.140516)"
2013,Julio,Guinea Ecuatorial,226,4,17,,21,"(4.697144,-74.140516)"
2013,Julio,Guinea Bissau,624,1,0,,1,"(3.541112,-76.384584)"
2013,Julio,Guadalupe/Territorio Francés,312,0,4,,4,"(4.697144,-74.140516)"
2013,Julio,Guayana Francesa/Departamento de Ultramar Francés,254,3,7,,10,"(6.171601,-75.427454)"
2013,Julio,Haití,332,1,2,,3,"(10.445761,-75.516429)"
2013,Julio,Haití,332,0,5,,5,"(10.886611,-74.776708)"
2013,Julio,Haití,332,0,2,,2,"(3.541112,-76.384584)"
2013,Julio,Haití,332,3,9,,12,"(4.697144,-74.140516)"
2013,Julio,Haití,332,0,1,,1,"(4.815061,-75.736532)"
2013,Julio,Haití,332,4,6,,10,"(6.171601,-75.427454)"
2013,Julio,Honduras,340,3,6,,9,"(10.445761,-75.516429)"
2013,Julio,Honduras,340,0,6,,6,"(10.886611,-74.776708)"
2013,Julio,Honduras,340,5,4,,9,"(12.586067,-81.702563)"
2013,Julio,Honduras,340,8,19,,27,"(3.541112,-76.384584)"
2013,Julio,Honduras,340,65,151,,216,"(4.697144,-74.140516)"
2013,Julio,Honduras,340,1,2,,3,"(4.815061,-75.736532)"
2013,Julio,Honduras,340,27,56,,83,"(6.171601,-75.427454)"
2013,Julio,Honduras,340,1,3,,4,"(7.128456,-73.183637)"
2013,Julio,Hong Kong,344,0,1,,1,"(10.886611,-74.776708)"
2013,Julio,Hong Kong,344,1,1,,2,"(3.541112,-76.384584)"
2013,Julio,Hong Kong,344,29,53,,82,"(4.697144,-74.140516)"
2013,Julio,Hong Kong,344,2,4,,6,"(6.171601,-75.427454)"
2013,Julio,Hungría,348,0,1,,1,"(10.886611,-74.776708)"
2013,Julio,Hungría,348,0,1,,1,"(3.541112,-76.384584)"
2013,Julio,Hungría,348,17,9,,26,"(4.697144,-74.140516)"
2013,Julio,India,356,41,35,,76,"(4.697144,-74.140516)"
2013,Julio,India,356,1,0,,1,"(4.815061,-75.736532)"
2013,Julio,India,356,4,5,,9,"(6.171601,-75.427454)"
2013,Julio,Indonesia,360,7,5,,12,"(4.697144,-74.140516)"
2013,Julio,Iraq,368,3,18,,21,"(4.697144,-74.140516)"
2013,Julio,Iraq,368,1,0,,1,"(6.171601,-75.427454)"
2013,Julio,Irán,364,0,3,,3,"(4.697144,-74.140516)"
2013,Julio,República de Irlanda,372,1,0,,1,"(10.445761,-75.516429)"
2013,Julio,República de Irlanda,372,1,0,,1,"(3.541112,-76.384584)"
2013,Julio,República de Irlanda,372,12,7,,19,"(4.697144,-74.140516)"
2013,Julio,Islandia,352,1,1,,2,"(4.697144,-74.140516)"
2013,Julio,Israel,376,10,6,,16,"(3.541112,-76.384584)"
2013,Julio,Israel,376,104,106,,210,"(4.697144,-74.140516)"
2013,Julio,Israel,376,1,2,,3,"(6.171601,-75.427454)"
2013,Julio,Italia,380,7,3,,10,"(10.445761,-75.516429)"
2013,Julio,Italia,380,2,1,,3,"(10.886611,-74.776708)"
2013,Julio,Italia,380,99,46,,145,"(3.541112,-76.384584)"
2013,Julio,Italia,380,597,384,,981,"(4.697144,-74.140516)"
2013,Julio,Italia,380,27,25,,52,"(6.171601,-75.427454)"
2013,Julio,Jamaica,388,10,17,,27,"(10.445761,-75.516429)"
2013,Julio,Jamaica,388,3,4,,7,"(10.886611,-74.776708)"
2013,Julio,Jamaica,388,0,1,,1,"(10.971302,-74.765397)"
2013,Julio,Jamaica,388,4,0,,4,"(12.586067,-81.702563)"
2013,Julio,Jamaica,388,11,15,,26,"(3.541112,-76.384584)"
2013,Julio,Jamaica,388,46,46,,92,"(4.697144,-74.140516)"
2013,Julio,Jamaica,388,1,1,,2,"(4.815061,-75.736532)"
2013,Julio,Jamaica,388,22,15,,37,"(6.171601,-75.427454)"
2013,Julio,Japón,392,4,3,,7,"(3.541112,-76.384584)"
2013,Julio,Japón,392,43,55,,98,"(4.697144,-74.140516)"
2013,Julio,Japón,392,0,1,,1,"(6.171601,-75.427454)"
2013,Julio,Jordania,400,5,5,,10,"(4.697144,-74.140516)"
2013,Julio,Kazajistán,398,3,1,,4,"(4.697144,-74.140516)"
2013,Julio,Kenia,404,0,3,,3,"(4.697144,-74.140516)"
2013,Julio,Kenia,404,0,1,,1,"(6.171601,-75.427454)"
2013,Julio,Kuwait,414,1,9,,10,"(4.697144,-74.140516)"
2013,Julio,República de Kosovo,901,1,0,,1,"(10.886611,-74.776708)"
2013,Julio,Lesoto,426,0,1,,1,"(6.171601,-75.427454)"
2013,Julio,Letonia,428,1,0,,1,"(4.697144,-74.140516)"
2013,Julio,Lituania,440,2,8,,10,"(4.697144,-74.140516)"
2013,Julio,Líbano,422,23,27,,50,"(4.697144,-74.140516)"
2013,Julio,Luxemburgo,442,5,4,,9,"(4.697144,-74.140516)"
2013,Julio,Madagascar,450,1,1,,2,"(3.541112,-76.384584)"
2013,Julio,Madagascar,450,0,1,,1,"(4.697144,-74.140516)"
2013,Julio,Malasia,458,1,0,,1,"(10.886611,-74.776708)"
2013,Julio,Malasia,458,14,12,,26,"(4.697144,-74.140516)"
2013,Julio,Malawi,454,0,1,,1,"(4.697144,-74.140516)"
2013,Julio,Malí,466,1,7,,8,"(4.697144,-74.140516)"
2013,Julio,Malta,470,3,1,,4,"(4.697144,-74.140516)"
2013,Julio,Marruecos,504,9,1,,10,"(4.697144,-74.140516)"
2013,Julio,Marruecos,504,2,2,,4,"(6.171601,-75.427454)"
2013,Julio,Mauritania,478,1,1,,2,"(4.697144,-74.140516)"
2013,Julio,México,484,20,3,,23,"(0.814836,-77.662532)"
2013,Julio,México,484,64,37,,101,"(10.445761,-75.516429)"
2013,Julio,México,484,95,94,,189,"(10.886611,-74.776708)"
2013,Julio,México,484,3,0,,3,"(12.586067,-81.702563)"
2013,Julio,México,484,749,622,,1371,"(3.541112,-76.384584)"
2013,Julio,México,484,7067,6669,,13736,"(4.697144,-74.140516)"
2013,Julio,México,484,141,86,,227,"(4.815061,-75.736532)"
2013,Julio,México,484,1341,1001,,2342,"(6.171601,-75.427454)"
2013,Julio,México,484,115,78,,193,"(7.128456,-73.183637)"
2013,Julio,México,484,35,37,,72,"(7.927209,-72.507910)"
2013,Julio,República de Moldavia,498,1,0,,1,"(4.697144,-74.140516)"
2013,Julio,Montenegro,499,2,0,,2,"(4.697144,-74.140516)"
2013,Julio,Mozambique,508,1,0,,1,"(4.697144,-74.140516)"
2013,Julio,Namibia,516,0,1,,1,"(4.697144,-74.140516)"
2013,Julio,Nicaragua,558,4,2,,6,"(10.445761,-75.516429)"
2013,Julio,Nicaragua,558,1,4,,5,"(10.886611,-74.776708)"
2013,Julio,Nicaragua,558,10,10,,20,"(3.541112,-76.384584)"
2013,Julio,Nicaragua,558,29,59,,88,"(4.697144,-74.140516)"
2013,Julio,Nicaragua,558,1,1,,2,"(4.815061,-75.736532)"
2013,Julio,Nicaragua,558,14,22,,36,"(6.171601,-75.427454)"
2013,Julio,Nicaragua,558,3,2,,5,"(7.128456,-73.183637)"
2013,Julio,Nigeria,566,0,1,,1,"(10.445761,-75.516429)"
2013,Julio,Nigeria,566,3,10,,13,"(4.697144,-74.140516)"
2013,Julio,Noruega,578,1,0,,1,"(10.886611,-74.776708)"
2013,Julio,Noruega,578,1,1,,2,"(3.541112,-76.384584)"
2013,Julio,Noruega,578,41,23,,64,"(4.697144,-74.140516)"
2013,Julio,Noruega,578,0,2,,2,"(6.171601,-75.427454)"
2013,Julio,Nueva Caledonia/Territorio francés,540,1,0,,1,"(3.541112,-76.384584)"
2013,Julio,Nueva Caledonia/Territorio francés,540,1,2,,3,"(4.697144,-74.140516)"
2013,Julio,Nueva Caledonia/Territorio francés,540,1,0,,1,"(6.171601,-75.427454)"
2013,Julio,Nueva Zelanda,554,0,2,,2,"(10.886611,-74.776708)"
2013,Julio,Nueva Zelanda,554,0,2,,2,"(3.541112,-76.384584)"
2013,Julio,Nueva Zelanda,554,22,34,,56,"(4.697144,-74.140516)"
2013,Julio,Nueva Zelanda,554,11,17,,28,"(6.171601,-75.427454)"
2013,Julio,Omán,512,2,5,,7,"(4.697144,-74.140516)"
2013,Julio,Papúa Nueva Guinea,598,2,5,,7,"(4.697144,-74.140516)"
2013,Julio,Papúa Nueva Guinea,598,0,1,,1,"(6.171601,-75.427454)"
2013,Julio,Pakistán,586,1,3,,4,"(4.697144,-74.140516)"
2013,Julio,Palau,585,0,1,,1,"(4.697144,-74.140516)"
2013,Julio,Panamá,591,19,92,,111,"(10.408582,-75.538003)"
2013,Julio,Panamá,591,329,380,,709,"(10.445761,-75.516429)"
2013,Julio,Panamá,591,884,960,,1844,"(10.886611,-74.776708)"
2013,Julio,Panamá,591,96,93,,189,"(12.586067,-81.702563)"
2013,Julio,Panamá,591,2613,2192,,4805,"(3.541112,-76.384584)"
2013,Julio,Panamá,591,6605,7483,,14088,"(4.697144,-74.140516)"
2013,Julio,Panamá,591,498,471,,969,"(4.815061,-75.736532)"
2013,Julio,Panamá,591,1836,1936,,3772,"(6.171601,-75.427454)"
2013,Julio,Panamá,591,191,220,,411,"(7.128456,-73.183637)"
2013,Julio,Panamá,591,212,221,,433,"(7.927209,-72.507910)"
2013,Julio,Panamá,591,4,96,,100,"(8.066966,-76.735404)"
2013,Julio,Panamá,591,110,209,,319,"(8.635765,-77.346578)"
2013,Julio,Paraguay,600,0,1,,1,"(10.445761,-75.516429)"
2013,Julio,Paraguay,600,0,1,,1,"(10.886611,-74.776708)"
2013,Julio,Paraguay,600,3,7,,10,"(3.541112,-76.384584)"
2013,Julio,Paraguay,600,23,93,,116,"(4.697144,-74.140516)"
2013,Julio,Paraguay,600,11,19,,30,"(6.171601,-75.427454)"
2013,Julio,Perú,604,87,127,,214,"(-4.197703,-69.941278)"
2013,Julio,Perú,604,27,36,,63,"(0.814836,-77.662532)"
2013,Julio,Perú,604,5,3,,8,"(10.445761,-75.516429)"
2013,Julio,Perú,604,13,19,,32,"(10.886611,-74.776708)"
2013,Julio,Perú,604,222,231,,453,"(3.541112,-76.384584)"
2013,Julio,Perú,604,2842,3713,,6555,"(4.697144,-74.140516)"
2013,Julio,Perú,604,5,16,,21,"(4.815061,-75.736532)"
2013,Julio,Perú,604,256,349,,605,"(6.171601,-75.427454)"
2013,Julio,Perú,604,7,6,,13,"(7.128456,-73.183637)"
2013,Julio,Perú,604,0,1,,1,"(7.927209,-72.507910)"
2013,Julio,Palestina,99999,1,1,,2,"(4.697144,-74.140516)"
2013,Julio,Polonia,616,20,23,,43,"(4.697144,-74.140516)"
2013,Julio,Polonia,616,1,1,,2,"(6.171601,-75.427454)"
2013,Julio,Portugal,620,5,4,,9,"(3.541112,-76.384584)"
2013,Julio,Portugal,620,37,25,,62,"(4.697144,-74.140516)"
2013,Julio,Portugal,620,2,1,,3,"(6.171601,-75.427454)"
2013,Julio,Polinesia Francesa/Colectividad de Ultramar Francesa,258,1,0,,1,"(4.697144,-74.140516)"
2013,Julio,Puerto Rico/Territorio de Estados Unidos,630,6,9,,15,"(10.445761,-75.516429)"
2013,Julio,Puerto Rico/Territorio de Estados Unidos,630,16,9,,25,"(10.886611,-74.776708)"
2013,Julio,Puerto Rico/Territorio de Estados Unidos,630,1,1,,2,"(12.586067,-81.702563)"
2013,Julio,Puerto Rico/Territorio de Estados Unidos,630,49,39,,88,"(3.541112,-76.384584)"
2013,Julio,Puerto Rico/Territorio de Estados Unidos,630,320,257,,577,"(4.697144,-74.140516)"
2013,Julio,Puerto Rico/Territorio de Estados Unidos,630,19,5,,24,"(4.815061,-75.736532)"
2013,Julio,Puerto Rico/Territorio de Estados Unidos,630,39,43,,82,"(6.171601,-75.427454)"
2013,Julio,Puerto Rico/Territorio de Estados Unidos,630,5,8,,13,"(7.128456,-73.183637)"
2013,Julio,Puerto Rico/Territorio de Estados Unidos,630,1,1,,2,"(7.927209,-72.507910)"
2013,Julio,Qatar,634,5,6,,11,"(4.697144,-74.140516)"
2013,Julio,Qatar,634,0,1,,1,"(6.171601,-75.427454)"
2013,Julio,Reino Unido de Gran Bretaña e Irlanda del Norte,826,5,0,,5,"(10.886611,-74.776708)"
2013,Julio,Reino Unido de Gran Bretaña e Irlanda del Norte,826,98,72,,170,"(3.541112,-76.384584)"
2013,Julio,Reino Unido de Gran Bretaña e Irlanda del Norte,826,843,668,,1511,"(4.697144,-74.140516)"
2013,Julio,Reino Unido de Gran Bretaña e Irlanda del Norte,826,0,1,,1,"(4.815061,-75.736532)"
2013,Julio,Reino Unido de Gran Bretaña e Irlanda del Norte,826,44,37,,81,"(6.171601,-75.427454)"
2013,Julio,Federación de Rusia,643,1,0,,1,"(10.886611,-74.776708)"
2013,Julio,Federación de Rusia,643,1,4,,5,"(3.541112,-76.384584)"
2013,Julio,Federación de Rusia,643,68,89,,157,"(4.697144,-74.140516)"
2013,Julio,Federación de Rusia,643,3,0,,3,"(6.171601,-75.427454)"
2013,Julio,República Dominicana,214,10,37,,47,"(10.445761,-75.516429)"
2013,Julio,República Dominicana,214,32,34,,66,"(10.886611,-74.776708)"
2013,Julio,República Dominicana,214,103,74,,177,"(3.541112,-76.384584)"
2013,Julio,República Dominicana,214,1316,1354,,2670,"(4.697144,-74.140516)"
2013,Julio,República Dominicana,214,5,7,,12,"(4.815061,-75.736532)"
2013,Julio,República Dominicana,214,130,134,,264,"(6.171601,-75.427454)"
2013,Julio,República Dominicana,214,6,5,,11,"(7.128456,-73.183637)"
2013,Julio,Reunión,638,0,2,,2,"(4.697144,-74.140516)"
2013,Julio,República Democrática Popular de Corea,408,0,1,,1,"(4.697144,-74.140516)"
2013,Julio,Rumania,642,0,1,,1,"(3.541112,-76.384584)"
2013,Julio,Rumania,642,4,9,,13,"(4.697144,-74.140516)"
2013,Julio,San Pedro y Miquelón/territorio de Ultramar de La Unión Europea,666,1,0,,1,"(4.697144,-74.140516)"
2013,Julio,Serbia,688,1,0,,1,"(4.697144,-74.140516)"
2013,Julio,Singapur,702,13,24,,37,"(4.697144,-74.140516)"
2013,Julio,Sudáfrica,710,0,1,,1,"(3.541112,-76.384584)"
2013,Julio,Sudáfrica,710,11,18,,29,"(4.697144,-74.140516)"
2013,Julio,Sudán,736,0,1,,1,"(10.886611,-74.776708)"
2013,Julio,Suecia,752,2,0,,2,"(10.886611,-74.776708)"
2013,Julio,Suecia,752,4,4,,8,"(3.541112,-76.384584)"
2013,Julio,Suecia,752,135,120,,255,"(4.697144,-74.140516)"
2013,Julio,Suecia,752,12,7,,19,"(6.171601,-75.427454)"
2013,Julio,Suiza,756,1,2,,3,"(10.445761,-75.516429)"
2013,Julio,Suiza,756,42,15,,57,"(3.541112,-76.384584)"
2013,Julio,Suiza,756,305,214,,519,"(4.697144,-74.140516)"
2013,Julio,Suiza,756,26,16,,42,"(6.171601,-75.427454)"
2013,Julio,Surinam,740,6,23,,29,"(4.697144,-74.140516)"
2013,Julio,Surinam,740,1,9,,10,"(6.171601,-75.427454)"
2013,Julio,Suazilandia,748,0,1,,1,"(4.697144,-74.140516)"
2013,Julio,Taiwán,158,1,0,,1,"(3.541112,-76.384584)"
2013,Julio,Taiwán,158,1,2,,3,"(4.697144,-74.140516)"
2013,Julio,Taiwán,158,0,1,,1,"(6.171601,-75.427454)"
2013,Julio,Tailandia,764,1,0,,1,"(3.541112,-76.384584)"
2013,Julio,Tailandia,764,15,20,,35,"(4.697144,-74.140516)"
2013,Julio,Trinidad y Tobago,780,3,2,,5,"(10.445761,-75.516429)"
2013,Julio,Trinidad y Tobago,780,2,3,,5,"(10.886611,-74.776708)"
2013,Julio,Trinidad y Tobago,780,3,0,,3,"(12.586067,-81.702563)"
2013,Julio,Trinidad y Tobago,780,9,17,,26,"(3.541112,-76.384584)"
2013,Julio,Trinidad y Tobago,780,29,44,,73,"(4.697144,-74.140516)"
2013,Julio,Trinidad y Tobago,780,2,3,,5,"(4.815061,-75.736532)"
2013,Julio,Trinidad y Tobago,780,7,7,,14,"(6.171601,-75.427454)"
2013,Julio,Trinidad y Tobago,780,4,5,,9,"(7.128456,-73.183637)"
2013,Julio,Trinidad y Tobago,780,1,2,,3,"(7.927209,-72.507910)"
2013,Julio,Turquía,792,36,26,,62,"(4.697144,-74.140516)"
2013,Julio,Turquía,792,1,5,,6,"(6.171601,-75.427454)"
2013,Julio,Turkmenistán,795,1,0,,1,"(10.445761,-75.516429)"
2013,Julio,Ucrania,804,0,1,,1,"(3.541112,-76.384584)"
2013,Julio,Ucrania,804,7,10,,17,"(4.697144,-74.140516)"
2013,Julio,Uganda,800,2,0,,2,"(3.541112,-76.384584)"
2013,Julio,Uganda,800,0,2,,2,"(4.697144,-74.140516)"
2013,Julio,Uruguay,858,1,0,,1,"(10.886611,-74.776708)"
2013,Julio,Uruguay,858,5,6,,11,"(3.541112,-76.384584)"
2013,Julio,Uruguay,858,52,62,,114,"(4.697144,-74.140516)"
2013,Julio,Uruguay,858,1,1,,2,"(4.815061,-75.736532)"
2013,Julio,Uruguay,858,7,10,,17,"(6.171601,-75.427454)"
2013,Julio,Venezuela,862,7,6,,13,"(10.445761,-75.516429)"
2013,Julio,Venezuela,862,12,41,,53,"(10.886611,-74.776708)"
2013,Julio,Venezuela,862,12076,10717,,22793,"(11.360009,-72.129330)"
2013,Julio,Venezuela,862,0,1,,1,"(11.528919,-72.919681)"
2013,Julio,Venezuela,862,11,17,,28,"(3.541112,-76.384584)"
2013,Julio,Venezuela,862,1857,2507,,4364,"(4.697144,-74.140516)"
2013,Julio,Venezuela,862,5,4,,9,"(4.815061,-75.736532)"
2013,Julio,Venezuela,862,230,283,,513,"(6.171601,-75.427454)"
2013,Julio,Venezuela,862,441,502,,943,"(6.185799,-67.483929)"
2013,Julio,Venezuela,862,1473,1419,,2892,"(7.088729,-70.740253)"
2013,Julio,Venezuela,862,2,6,,8,"(7.128456,-73.183637)"
2013,Julio,Venezuela,862,6912,6915,,13827,"(7.818934,-72.453226)"
2013,Julio,Vietnam,704,2,2,,4,"(4.697144,-74.140516)"
2013,Julio,República Árabe de Yemen,887,0,1,,1,"(3.541112,-76.384584)"
2013,Julio,Zambia,894,1,0,,1,"(4.697144,-74.140516)"
2013,Julio,Desconocido,99999,2,1,,3,"(3.541112,-76.384584)"
2013,Julio,Desconocido,99999,5,15,,20,"(4.697144,-74.140516)"
2013,Julio,Desconocido,99999,0,1,,1,"(6.171601,-75.427454)"
2013,Agosto,Afganistán,4,0,1,,1,"(3.541112,-76.384584)"
2013,Agosto,Afganistán,4,2,38,,40,"(4.697144,-74.140516)"
2013,Agosto,Afganistán,4,0,1,,1,"(6.171601,-75.427454)"
2013,Agosto,Afganistán,4,1,0,,1,"(6.185799,-67.483929)"
2013,Agosto,Alemania,276,1,1,,2,"(10.445761,-75.516429)"
2013,Agosto,Alemania,276,1,2,,3,"(10.886611,-74.776708)"
2013,Agosto,Alemania,276,37,31,,68,"(3.541112,-76.384584)"
2013,Agosto,Alemania,276,1055,907,,1962,"(4.697144,-74.140516)"
2013,Agosto,Alemania,276,27,22,,49,"(6.171601,-75.427454)"
2013,Agosto,Andorra,20,1,0,,1,"(4.697144,-74.140516)"
2013,Agosto,Angola,24,4,10,,14,"(4.697144,-74.140516)"
2013,Agosto,Antigua y Barbuda,28,1,0,,1,"(4.697144,-74.140516)"
2013,Agosto,Países Bajos,528,0,1,,1,"(10.408582,-75.538003)"
2013,Agosto,Países Bajos,528,3,5,,8,"(10.445761,-75.516429)"
2013,Agosto,Países Bajos,528,3,1,,4,"(10.886611,-74.776708)"
2013,Agosto,Países Bajos,528,70,30,,100,"(3.541112,-76.384584)"
2013,Agosto,Países Bajos,528,260,180,,440,"(4.697144,-74.140516)"
2013,Agosto,Países Bajos,528,2,3,,5,"(4.815061,-75.736532)"
2013,Agosto,Países Bajos,528,83,46,,129,"(6.171601,-75.427454)"
2013,Agosto,Países Bajos,528,6,1,,7,"(7.128456,-73.183637)"
2013,Agosto,Arabia Saudita,682,0,1,,1,"(10.886611,-74.776708)"
2013,Agosto,Arabia Saudita,682,1,1,,2,"(3.541112,-76.384584)"
2013,Agosto,Arabia Saudita,682,31,46,,77,"(4.697144,-74.140516)"
2013,Agosto,Argelia,12,1,0,,1,"(3.541112,-76.384584)"
2013,Agosto,Argelia,12,2,4,,6,"(4.697144,-74.140516)"
2013,Agosto,Argentina,32,2,2,,4,"(0.814836,-77.662532)"
2013,Agosto,Argentina,32,7,7,,14,"(10.445761,-75.516429)"
2013,Agosto,Argentina,32,31,14,,45,"(10.886611,-74.776708)"
2013,Agosto,Argentina,32,3,3,,6,"(12.586067,-81.702563)"
2013,Agosto,Argentina,32,169,169,,338,"(3.541112,-76.384584)"
2013,Agosto,Argentina,32,2525,2437,,4962,"(4.697144,-74.140516)"
2013,Agosto,Argentina,32,17,18,,35,"(4.815061,-75.736532)"
2013,Agosto,Argentina,32,147,153,,300,"(6.171601,-75.427454)"
2013,Agosto,Argentina,32,5,6,,11,"(7.128456,-73.183637)"
2013,Agosto,Argentina,32,1,3,,4,"(7.927209,-72.507910)"
2013,Agosto,Aruba,533,1468,1131,,2599,"(10.408582,-75.538003)"
2013,Agosto,Aruba,533,3,4,,7,"(10.445761,-75.516429)"
2013,Agosto,Aruba,533,21,14,,35,"(10.886611,-74.776708)"
2013,Agosto,Aruba,533,64,41,,105,"(11.528919,-72.919681)"
2013,Agosto,Aruba,533,41,32,,73,"(3.541112,-76.384584)"
2013,Agosto,Aruba,533,1198,951,,2149,"(4.697144,-74.140516)"
2013,Agosto,Aruba,533,23,11,,34,"(4.815061,-75.736532)"
2013,Agosto,Aruba,533,75,46,,121,"(6.171601,-75.427454)"
2013,Agosto,Aruba,533,12,6,,18,"(7.128456,-73.183637)"
2013,Agosto,Aruba,533,2,0,,2,"(7.927209,-72.507910)"
2013,Agosto,Australia,36,1,0,,1,"(10.445761,-75.516429)"
2013,Agosto,Australia,36,13,13,,26,"(3.541112,-76.384584)"
2013,Agosto,Australia,36,213,172,,385,"(4.697144,-74.140516)"
2013,Agosto,Australia,36,0,2,,2,"(4.815061,-75.736532)"
2013,Agosto,Australia,36,25,23,,48,"(6.171601,-75.427454)"
2013,Agosto,Australia,36,1,2,,3,"(7.128456,-73.183637)"
2013,Agosto,Australia,36,0,1,,1,"(7.818934,-72.453226)"
2013,Agosto,Australia,36,1,1,,2,"(7.927209,-72.507910)"
2013,Agosto,Austria,40,25,26,,51,"(4.697144,-74.140516)"
2013,Agosto,Austria,40,2,0,,2,"(6.171601,-75.427454)"
2013,Agosto,Azerbaiyán,31,9,13,,22,"(4.697144,-74.140516)"
2013,Agosto,Bahamas,44,2,1,,3,"(10.445761,-75.516429)"
2013,Agosto,Bahamas,44,0,1,,1,"(10.886611,-74.776708)"
2013,Agosto,Bahamas,44,21,16,,37,"(3.541112,-76.384584)"
2013,Agosto,Bahamas,44,30,31,,61,"(4.697144,-74.140516)"
2013,Agosto,Bahamas,44,4,0,,4,"(4.815061,-75.736532)"
2013,Agosto,Bahamas,44,14,23,,37,"(6.171601,-75.427454)"
2013,Agosto,Bahamas,44,2,1,,3,"(7.128456,-73.183637)"
2013,Agosto,Bahréin,48,4,2,,6,"(4.697144,-74.140516)"
2013,Agosto,Barbados,52,1,0,,1,"(10.445761,-75.516429)"
2013,Agosto,Barbados,52,3,1,,4,"(10.886611,-74.776708)"
2013,Agosto,Barbados,52,0,2,,2,"(3.541112,-76.384584)"
2013,Agosto,Barbados,52,1,9,,10,"(4.697144,-74.140516)"
2013,Agosto,Barbados,52,0,2,,2,"(6.171601,-75.427454)"
2013,Agosto,República de Belarús,112,1,2,,3,"(11.360009,-72.129330)"
2013,Agosto,República de Belarús,112,1,0,,1,"(3.541112,-76.384584)"
2013,Agosto,República de Belarús,112,3,3,,6,"(4.697144,-74.140516)"
2013,Agosto,República de Belarús,112,0,1,,1,"(6.171601,-75.427454)"
2013,Agosto,República de Belarús,112,3,3,,6,"(7.818934,-72.453226)"
2013,Agosto,Bélgica,56,1,0,,1,"(10.886611,-74.776708)"
2013,Agosto,Bélgica,56,27,16,,43,"(3.541112,-76.384584)"
2013,Agosto,Bélgica,56,158,122,,280,"(4.697144,-74.140516)"
2013,Agosto,Bélgica,56,41,22,,63,"(6.171601,-75.427454)"
2013,Agosto,Belice,84,1,0,,1,"(10.445761,-75.516429)"
2013,Agosto,Belice,84,5,6,,11,"(4.697144,-74.140516)"
2013,Agosto,Belice,84,1,0,,1,"(6.171601,-75.427454)"
2013,Agosto,Benín,204,1,1,,2,"(4.697144,-74.140516)"
2013,Agosto,Bermudas/Territorio Británico de Ultramar,60,3,0,,3,"(4.697144,-74.140516)"
2013,Agosto,Bolivia,68,0,1,,1,"(0.814836,-77.662532)"
2013,Agosto,Bolivia,68,3,5,,8,"(10.886611,-74.776708)"
2013,Agosto,Bolivia,68,7,22,,29,"(3.541112,-76.384584)"
2013,Agosto,Bolivia,68,249,432,,681,"(4.697144,-74.140516)"
2013,Agosto,Bolivia,68,3,1,,4,"(4.815061,-75.736532)"
2013,Agosto,Bolivia,68,17,28,,45,"(6.171601,-75.427454)"
2013,Agosto,Bolivia,68,1,0,,1,"(7.128456,-73.183637)"
2013,Agosto,Brasil,76,105,164,,269,"(-4.197703,-69.941278)"
2013,Agosto,Brasil,76,0,1,,1,"(0.814836,-77.662532)"
2013,Agosto,Brasil,76,7,12,,19,"(10.445761,-75.516429)"
2013,Agosto,Brasil,76,9,12,,21,"(10.886611,-74.776708)"
2013,Agosto,Brasil,76,36,54,,90,"(3.541112,-76.384584)"
2013,Agosto,Brasil,76,3414,4396,,7810,"(4.697144,-74.140516)"
2013,Agosto,Brasil,76,6,12,,18,"(4.815061,-75.736532)"
2013,Agosto,Brasil,76,49,84,,133,"(6.171601,-75.427454)"
2013,Agosto,Brasil,76,4,3,,7,"(7.128456,-73.183637)"
2013,Agosto,Brasil,76,1,0,,1,"(7.927209,-72.507910)"
2013,Agosto,Brunei Darussalam,96,3,0,,3,"(4.697144,-74.140516)"
2013,Agosto,Bulgaria,100,0,2,,2,"(4.697144,-74.140516)"
2013,Agosto,Cabo Verde,132,0,1,,1,"(4.697144,-74.140516)"
2013,Agosto,Islas Caimán/Territorio Británico de Ultramar,136,1,0,,1,"(10.445761,-75.516429)"
2013,Agosto,Islas Caimán/Territorio Británico de Ultramar,136,2,0,,2,"(10.886611,-74.776708)"
2013,Agosto,Islas Caimán/Territorio Británico de Ultramar,136,13,4,,17,"(12.586067,-81.702563)"
2013,Agosto,Islas Caimán/Territorio Británico de Ultramar,136,2,0,,2,"(3.541112,-76.384584)"
2013,Agosto,Islas Caimán/Territorio Británico de Ultramar,136,2,1,,3,"(4.697144,-74.140516)"
2013,Agosto,Islas Caimán/Territorio Británico de Ultramar,136,1,1,,2,"(6.171601,-75.427454)"
2013,Agosto,Camerún,120,0,3,,3,"(4.697144,-74.140516)"
2013,Agosto,Camerún,120,1,0,,1,"(6.171601,-75.427454)"
2013,Agosto,Canadá,124,38,21,,59,"(10.445761,-75.516429)"
2013,Agosto,Canadá,124,19,7,,26,"(10.886611,-74.776708)"
2013,Agosto,Canadá,124,104,63,,167,"(3.541112,-76.384584)"
2013,Agosto,Canadá,124,2,1,,3,"(4.452882,-75.766298)"
2013,Agosto,Canadá,124,2127,1796,,3923,"(4.697144,-74.140516)"
2013,Agosto,Canadá,124,8,7,,15,"(4.815061,-75.736532)"
2013,Agosto,Canadá,124,207,171,,378,"(6.171601,-75.427454)"
2013,Agosto,Canadá,124,13,12,,25,"(7.128456,-73.183637)"
2013,Agosto,Chad,148,0,4,,4,"(4.697144,-74.140516)"
2013,Agosto,España,724,8,7,,15,"(10.445761,-75.516429)"
2013,Agosto,España,724,1,0,,1,"(10.886611,-74.776708)"
2013,Agosto,España,724,1670,1008,,2678,"(3.541112,-76.384584)"
2013,Agosto,España,724,6271,4456,,10727,"(4.697144,-74.140516)"
2013,Agosto,España,724,1,0,,1,"(4.815061,-75.736532)"
2013,Agosto,España,724,748,466,,1214,"(6.171601,-75.427454)"
2013,Agosto,España,724,0,2,,2,"(7.818934,-72.453226)"
2013,Agosto,República Democrática del Congo,180,3,5,,8,"(4.697144,-74.140516)"
2013,Agosto,República de Corea,410,0,1,,1,"(10.445761,-75.516429)"
2013,Agosto,República de Corea,410,1,2,,3,"(3.541112,-76.384584)"
2013,Agosto,República de Corea,410,25,38,,63,"(4.697144,-74.140516)"
2013,Agosto,República de Corea,410,4,7,,11,"(6.171601,-75.427454)"
2013,Agosto,Costa de Marfil,384,0,1,,1,"(10.886611,-74.776708)"
2013,Agosto,Costa Rica,188,8,12,,20,"(10.445761,-75.516429)"
2013,Agosto,Costa Rica,188,10,17,,27,"(10.886611,-74.776708)"
2013,Agosto,Costa Rica,188,0,5,,5,"(12.5744111,-81.703935)"
2013,Agosto,Costa Rica,188,6,4,,10,"(12.586067,-81.702563)"
2013,Agosto,Costa Rica,188,46,77,,123,"(3.541112,-76.384584)"
2013,Agosto,Costa Rica,188,845,969,,1814,"(4.697144,-74.140516)"
2013,Agosto,Costa Rica,188,8,5,,13,"(4.815061,-75.736532)"
2013,Agosto,Costa Rica,188,119,142,,261,"(6.171601,-75.427454)"
2013,Agosto,Costa Rica,188,7,10,,17,"(7.128456,-73.183637)"
2013,Agosto,Costa Rica,188,4,4,,8,"(7.927209,-72.507910)"
2013,Agosto,Costa Rica,188,0,1,,1,"(8.635765,-77.346578)"
2013,Agosto,Croacia,191,0,1,,1,"(4.697144,-74.140516)"
2013,Agosto,Cuba,192,16,9,,25,"(10.445761,-75.516429)"
2013,Agosto,Cuba,192,11,18,,29,"(10.886611,-74.776708)"
2013,Agosto,Cuba,192,55,54,,109,"(3.541112,-76.384584)"
2013,Agosto,Cuba,192,1094,982,,2076,"(4.697144,-74.140516)"
2013,Agosto,Cuba,192,15,14,,29,"(4.815061,-75.736532)"
2013,Agosto,Cuba,192,151,101,,252,"(6.171601,-75.427454)"
2013,Agosto,Cuba,192,21,30,,51,"(7.128456,-73.183637)"
2013,Agosto,Cuba,192,10,8,,18,"(7.927209,-72.507910)"
2013,Agosto,Curazao,99999,3,1,,4,"(10.445761,-75.516429)"
2013,Agosto,Curazao,99999,12,13,,25,"(10.886611,-74.776708)"
2013,Agosto,Curazao,99999,5,6,,11,"(3.541112,-76.384584)"
2013,Agosto,Curazao,99999,622,624,,1246,"(4.697144,-74.140516)"
2013,Agosto,Curazao,99999,110,71,,181,"(6.171601,-75.427454)"
2013,Agosto,Curazao,99999,1,2,,3,"(7.128456,-73.183637)"
2013,Agosto,Curazao,99999,2,1,,3,"(7.927209,-72.507910)"
2013,Agosto,República Checa,203,0,1,,1,"(3.541112,-76.384584)"
2013,Agosto,República Checa,203,7,7,,14,"(4.697144,-74.140516)"
2013,Agosto,Chile,152,6,4,,10,"(0.814836,-77.662532)"
2013,Agosto,Chile,152,8,7,,15,"(10.445761,-75.516429)"
2013,Agosto,Chile,152,21,19,,40,"(10.886611,-74.776708)"
2013,Agosto,Chile,152,0,2,,2,"(12.586067,-81.702563)"
2013,Agosto,Chile,152,391,331,,722,"(3.541112,-76.384584)"
2013,Agosto,Chile,152,2409,2320,,4729,"(4.697144,-74.140516)"
2013,Agosto,Chile,152,28,33,,61,"(4.815061,-75.736532)"
2013,Agosto,Chile,152,173,160,,333,"(6.171601,-75.427454)"
2013,Agosto,Chile,152,17,7,,24,"(7.128456,-73.183637)"
2013,Agosto,Chile,152,1,2,,3,"(7.927209,-72.507910)"
2013,Agosto,China,156,1,12,,13,"(10.445761,-75.516429)"
2013,Agosto,China,156,4,9,,13,"(10.886611,-74.776708)"
2013,Agosto,China,156,5,31,,36,"(3.541112,-76.384584)"
2013,Agosto,China,156,177,397,,574,"(4.697144,-74.140516)"
2013,Agosto,China,156,0,2,,2,"(4.815061,-75.736532)"
2013,Agosto,China,156,16,22,,38,"(6.171601,-75.427454)"
2013,Agosto,China,156,2,1,,3,"(7.128456,-73.183637)"
2013,Agosto,Chipre,196,2,2,,4,"(4.697144,-74.140516)"
2013,Agosto,Dinamarca,208,57,41,,98,"(4.697144,-74.140516)"
2013,Agosto,Dinamarca,208,2,1,,3,"(6.171601,-75.427454)"
2013,Agosto,República de Yibuti,262,1,0,,1,"(0.814836,-77.662532)"
2013,Agosto,Dominica,212,0,1,,1,"(4.697144,-74.140516)"
2013,Agosto,Ecuador,218,360,437,,797,"(0.25129,-76.875963)"
2013,Agosto,Ecuador,218,5200,5527,,10727,"(0.814836,-77.662532)"
2013,Agosto,Ecuador,218,115,185,,300,"(1.813928,-78.763924)"
2013,Agosto,Ecuador,218,0,1,,1,"(10.408582,-75.538003)"
2013,Agosto,Ecuador,218,0,1,,1,"(10.445761,-75.516429)"
2013,Agosto,Ecuador,218,2,3,,5,"(10.886611,-74.776708)"
2013,Agosto,Ecuador,218,757,787,,1544,"(3.541112,-76.384584)"
2013,Agosto,Ecuador,218,2103,3510,,5613,"(4.697144,-74.140516)"
2013,Agosto,Ecuador,218,2,5,,7,"(4.815061,-75.736532)"
2013,Agosto,Ecuador,218,461,523,,984,"(6.171601,-75.427454)"
2013,Agosto,Ecuador,218,3,1,,4,"(7.128456,-73.183637)"
2013,Agosto,Ecuador,218,1,0,,1,"(7.927209,-72.507910)"
2013,Agosto,Egipto,818,2,2,,4,"(10.886611,-74.776708)"
2013,Agosto,Egipto,818,14,23,,37,"(4.697144,-74.140516)"
2013,Agosto,El Salvador,222,2,3,,5,"(10.445761,-75.516429)"
2013,Agosto,El Salvador,222,2,5,,7,"(10.886611,-74.776708)"
2013,Agosto,El Salvador,222,0,1,,1,"(12.586067,-81.702563)"
2013,Agosto,El Salvador,222,88,100,,188,"(3.541112,-76.384584)"
2013,Agosto,El Salvador,222,747,795,,1542,"(4.697144,-74.140516)"
2013,Agosto,El Salvador,222,4,2,,6,"(4.815061,-75.736532)"
2013,Agosto,El Salvador,222,133,140,,273,"(6.171601,-75.427454)"
2013,Agosto,El Salvador,222,2,1,,3,"(7.128456,-73.183637)"
2013,Agosto,El Salvador,222,0,1,,1,"(7.927209,-72.507910)"
2013,Agosto,Emiratos Árabes,784,2,2,,4,"(10.445761,-75.516429)"
2013,Agosto,Emiratos Árabes,784,2,1,,3,"(10.886611,-74.776708)"
2013,Agosto,Emiratos Árabes,784,2,4,,6,"(3.541112,-76.384584)"
2013,Agosto,Emiratos Árabes,784,158,285,,443,"(4.697144,-74.140516)"
2013,Agosto,Emiratos Árabes,784,14,8,,22,"(6.171601,-75.427454)"
2013,Agosto,Eritrea,232,1,1,,2,"(4.697144,-74.140516)"
2013,Agosto,Eslovaquia,703,2,0,,2,"(4.697144,-74.140516)"
2013,Agosto,Eslovenia,705,1,0,,1,"(4.697144,-74.140516)"
2013,Agosto,Estados Unidos de América,840,2345,1789,,4134,"(10.445761,-75.516429)"
2013,Agosto,Estados Unidos de América,840,2085,1650,,3735,"(10.886611,-74.776708)"
2013,Agosto,Estados Unidos de América,840,0,2,,2,"(10.971302,-74.765397)"
2013,Agosto,Estados Unidos de América,840,29,15,,44,"(12.586067,-81.702563)"
2013,Agosto,Estados Unidos de América,840,5955,4151,,10106,"(3.541112,-76.384584)"
2013,Agosto,Estados Unidos de América,840,531,395,,926,"(4.452882,-75.766298)"
2013,Agosto,Estados Unidos de América,840,33005,28337,,61342,"(4.697144,-74.140516)"
2013,Agosto,Estados Unidos de América,840,652,467,,1119,"(4.815061,-75.736532)"
2013,Agosto,Estados Unidos de América,840,9362,6912,,16274,"(6.171601,-75.427454)"
2013,Agosto,Estados Unidos de América,840,190,154,,344,"(7.128456,-73.183637)"
2013,Agosto,Estados Unidos de América,840,88,60,,148,"(7.927209,-72.507910)"
2013,Agosto,Estados Unidos de América,840,1,0,,1,"(8.635765,-77.346578)"
2013,Agosto,Estonia,233,0,2,,2,"(4.697144,-74.140516)"
2013,Agosto,Estonia,233,1,0,,1,"(6.171601,-75.427454)"
2013,Agosto,Etiopia,231,0,1,,1,"(4.697144,-74.140516)"
2013,Agosto,Islas Fiji,242,0,2,,2,"(4.697144,-74.140516)"
2013,Agosto,Filipinas,608,1,1,,2,"(4.697144,-74.140516)"
2013,Agosto,Finlandia,246,1,0,,1,"(10.886611,-74.776708)"
2013,Agosto,Finlandia,246,1,1,,2,"(3.541112,-76.384584)"
2013,Agosto,Finlandia,246,13,13,,26,"(4.697144,-74.140516)"
2013,Agosto,Francia,250,4,0,,4,"(10.445761,-75.516429)"
2013,Agosto,Francia,250,1,1,,2,"(10.886611,-74.776708)"
2013,Agosto,Francia,250,121,69,,190,"(3.541112,-76.384584)"
2013,Agosto,Francia,250,1900,1330,,3230,"(4.697144,-74.140516)"
2013,Agosto,Francia,250,3,0,,3,"(4.815061,-75.736532)"
2013,Agosto,Francia,250,58,46,,104,"(6.171601,-75.427454)"
2013,Agosto,Gabón,266,0,8,,8,"(4.697144,-74.140516)"
2013,Agosto,Ghana,288,5,2,,7,"(4.697144,-74.140516)"
2013,Agosto,Ghana,288,0,1,,1,"(6.171601,-75.427454)"
2013,Agosto,Granada,308,2,0,,2,"(4.697144,-74.140516)"
2013,Agosto,Grecia,300,0,3,,3,"(3.541112,-76.384584)"
2013,Agosto,Grecia,300,25,23,,48,"(4.697144,-74.140516)"
2013,Agosto,Grecia,300,0,1,,1,"(6.171601,-75.427454)"
2013,Agosto,Guatemala,320,4,4,,8,"(10.445761,-75.516429)"
2013,Agosto,Guatemala,320,11,8,,19,"(10.886611,-74.776708)"
2013,Agosto,Guatemala,320,58,61,,119,"(3.541112,-76.384584)"
2013,Agosto,Guatemala,320,216,338,,554,"(4.697144,-74.140516)"
2013,Agosto,Guatemala,320,9,11,,20,"(4.815061,-75.736532)"
2013,Agosto,Guatemala,320,92,105,,197,"(6.171601,-75.427454)"
2013,Agosto,Guatemala,320,4,3,,7,"(7.128456,-73.183637)"
2013,Agosto,Guatemala,320,1,2,,3,"(7.927209,-72.507910)"
2013,Agosto,Guyana,328,4,6,,10,"(10.886611,-74.776708)"
2013,Agosto,Guyana,328,4,4,,8,"(4.697144,-74.140516)"
2013,Agosto,Guyana,328,2,1,,3,"(6.171601,-75.427454)"
2013,Agosto,Guinea,324,0,1,,1,"(0.814836,-77.662532)"
2013,Agosto,Guinea,324,0,8,,8,"(4.697144,-74.140516)"
2013,Agosto,Guinea Ecuatorial,226,0,1,,1,"(3.541112,-76.384584)"
2013,Agosto,Guinea Ecuatorial,226,3,6,,9,"(4.697144,-74.140516)"
2013,Agosto,Guadalupe/Territorio Francés,312,1,1,,2,"(3.541112,-76.384584)"
2013,Agosto,Guayana Francesa/Departamento de Ultramar Francés,254,1,0,,1,"(4.697144,-74.140516)"
2013,Agosto,Haití,332,1,5,,6,"(10.886611,-74.776708)"
2013,Agosto,Haití,332,1,0,,1,"(3.541112,-76.384584)"
2013,Agosto,Haití,332,6,11,,17,"(4.697144,-74.140516)"
2013,Agosto,Haití,332,2,5,,7,"(6.171601,-75.427454)"
2013,Agosto,Honduras,340,0,6,,6,"(10.445761,-75.516429)"
2013,Agosto,Honduras,340,4,2,,6,"(10.886611,-74.776708)"
2013,Agosto,Honduras,340,5,25,,30,"(3.541112,-76.384584)"
2013,Agosto,Honduras,340,88,191,,279,"(4.697144,-74.140516)"
2013,Agosto,Honduras,340,3,5,,8,"(4.815061,-75.736532)"
2013,Agosto,Honduras,340,33,62,,95,"(6.171601,-75.427454)"
2013,Agosto,Honduras,340,1,4,,5,"(7.128456,-73.183637)"
2013,Agosto,Honduras,340,0,2,,2,"(7.927209,-72.507910)"
2013,Agosto,Hong Kong,344,13,76,,89,"(10.445761,-75.516429)"
2013,Agosto,Hong Kong,344,0,1,,1,"(3.541112,-76.384584)"
2013,Agosto,Hong Kong,344,25,57,,82,"(4.697144,-74.140516)"
2013,Agosto,Hong Kong,344,2,3,,5,"(6.171601,-75.427454)"
2013,Agosto,Hungría,348,0,1,,1,"(10.445761,-75.516429)"
2013,Agosto,Hungría,348,2,1,,3,"(3.541112,-76.384584)"
2013,Agosto,Hungría,348,36,32,,68,"(4.697144,-74.140516)"
2013,Agosto,Hungría,348,0,1,,1,"(6.171601,-75.427454)"
2013,Agosto,India,356,0,1,,1,"(10.445761,-75.516429)"
2013,Agosto,India,356,2,1,,3,"(3.541112,-76.384584)"
2013,Agosto,India,356,29,33,,62,"(4.697144,-74.140516)"
2013,Agosto,India,356,3,3,,6,"(6.171601,-75.427454)"
2013,Agosto,Indonesia,360,0,1,,1,"(10.445761,-75.516429)"
2013,Agosto,Indonesia,360,1,1,,2,"(3.541112,-76.384584)"
2013,Agosto,Indonesia,360,11,14,,25,"(4.697144,-74.140516)"
2013,Agosto,Indonesia,360,3,2,,5,"(6.171601,-75.427454)"
2013,Agosto,Iraq,368,0,2,,2,"(3.541112,-76.384584)"
2013,Agosto,Iraq,368,0,9,,9,"(4.697144,-74.140516)"
2013,Agosto,Irán,364,1,1,,2,"(4.697144,-74.140516)"
2013,Agosto,República de Irlanda,372,2,4,,6,"(10.445761,-75.516429)"
2013,Agosto,República de Irlanda,372,1,0,,1,"(3.541112,-76.384584)"
2013,Agosto,República de Irlanda,372,16,7,,23,"(4.697144,-74.140516)"
2013,Agosto,República de Irlanda,372,2,1,,3,"(6.171601,-75.427454)"
2013,Agosto,Islandia,352,2,0,,2,"(3.541112,-76.384584)"
2013,Agosto,Islandia,352,7,0,,7,"(4.697144,-74.140516)"
2013,Agosto,Islas Pitcairn/Territorio Británico de Ultramar,612,1,0,,1,"(4.697144,-74.140516)"
2013,Agosto,Israel,376,7,4,,11,"(3.541112,-76.384584)"
2013,Agosto,Israel,376,97,88,,185,"(4.697144,-74.140516)"
2013,Agosto,Israel,376,3,2,,5,"(6.171601,-75.427454)"
2013,Agosto,Italia,380,3,1,,4,"(10.445761,-75.516429)"
2013,Agosto,Italia,380,2,1,,3,"(10.886611,-74.776708)"
2013,Agosto,Italia,380,86,29,,115,"(3.541112,-76.384584)"
2013,Agosto,Italia,380,561,388,,949,"(4.697144,-74.140516)"
2013,Agosto,Italia,380,33,31,,64,"(6.171601,-75.427454)"
2013,Agosto,Jamaica,388,2,5,,7,"(10.445761,-75.516429)"
2013,Agosto,Jamaica,388,4,2,,6,"(10.886611,-74.776708)"
2013,Agosto,Jamaica,388,1,0,,1,"(12.586067,-81.702563)"
2013,Agosto,Jamaica,388,16,11,,27,"(3.541112,-76.384584)"
2013,Agosto,Jamaica,388,131,147,,278,"(4.697144,-74.140516)"
2013,Agosto,Jamaica,388,1,4,,5,"(4.815061,-75.736532)"
2013,Agosto,Jamaica,388,35,23,,58,"(6.171601,-75.427454)"
2013,Agosto,Jamaica,388,2,2,,4,"(7.128456,-73.183637)"
2013,Agosto,Japón,392,1,0,,1,"(10.886611,-74.776708)"
2013,Agosto,Japón,392,6,4,,10,"(3.541112,-76.384584)"
2013,Agosto,Japón,392,54,48,,102,"(4.697144,-74.140516)"
2013,Agosto,Japón,392,6,4,,10,"(6.171601,-75.427454)"
2013,Agosto,Japón,392,0,1,,1,"(7.128456,-73.183637)"
2013,Agosto,Jordania,400,1,5,,6,"(4.697144,-74.140516)"
2013,Agosto,Kazajistán,398,1,1,,2,"(4.697144,-74.140516)"
2013,Agosto,Kenia,404,3,2,,5,"(4.697144,-74.140516)"
2013,Agosto,Kenia,404,1,1,,2,"(6.171601,-75.427454)"
2013,Agosto,Kirguistán,417,0,1,,1,"(4.697144,-74.140516)"
2013,Agosto,Kuwait,414,1,0,,1,"(10.445761,-75.516429)"
2013,Agosto,Kuwait,414,3,4,,7,"(4.697144,-74.140516)"
2013,Agosto,Lituania,440,2,0,,2,"(3.541112,-76.384584)"
2013,Agosto,Lituania,440,1,1,,2,"(4.697144,-74.140516)"
2013,Agosto,Líbano,422,0,2,,2,"(12.586067,-81.702563)"
2013,Agosto,Líbano,422,18,24,,42,"(4.697144,-74.140516)"
2013,Agosto,Luxemburgo,442,2,1,,3,"(4.697144,-74.140516)"
2013,Agosto,Luxemburgo,442,0,1,,1,"(6.171601,-75.427454)"
2013,Agosto,Malasia,458,1,0,,1,"(3.541112,-76.384584)"
2013,Agosto,Malasia,458,8,11,,19,"(4.697144,-74.140516)"
2013,Agosto,Malasia,458,1,1,,2,"(6.171601,-75.427454)"
2013,Agosto,Malasia,458,1,2,,3,"(7.128456,-73.183637)"
2013,Agosto,Maldivas,462,1,0,,1,"(4.697144,-74.140516)"
2013,Agosto,Malta,470,7,6,,13,"(4.697144,-74.140516)"
2013,Agosto,Marruecos,504,1,0,,1,"(3.541112,-76.384584)"
2013,Agosto,Marruecos,504,8,2,,10,"(4.697144,-74.140516)"
2013,Agosto,Mauritania,478,0,2,,2,"(4.697144,-74.140516)"
2013,Agosto,Martinica/Departamento de Ultramar Francés,474,0,1,,1,"(3.541112,-76.384584)"
2013,Agosto,México,484,0,1,,1,"(0.814836,-77.662532)"
2013,Agosto,México,484,40,37,,77,"(10.445761,-75.516429)"
2013,Agosto,México,484,113,81,,194,"(10.886611,-74.776708)"
2013,Agosto,México,484,3,2,,5,"(12.586067,-81.702563)"
2013,Agosto,México,484,793,678,,1471,"(3.541112,-76.384584)"
2013,Agosto,México,484,8131,7359,,15490,"(4.697144,-74.140516)"
2013,Agosto,México,484,193,119,,312,"(4.815061,-75.736532)"
2013,Agosto,México,484,1652,1301,,2953,"(6.171601,-75.427454)"
2013,Agosto,México,484,130,84,,214,"(7.128456,-73.183637)"
2013,Agosto,México,484,77,62,,139,"(7.927209,-72.507910)"
2013,Agosto,Mónaco,492,2,3,,5,"(4.697144,-74.140516)"
2013,Agosto,Mónaco,492,1,0,,1,"(6.171601,-75.427454)"
2013,Agosto,Myanmar,104,0,3,,3,"(4.697144,-74.140516)"
2013,Agosto,Nepal,524,0,1,,1,"(4.697144,-74.140516)"
2013,Agosto,Nicaragua,558,1,1,,2,"(10.445761,-75.516429)"
2013,Agosto,Nicaragua,558,4,4,,8,"(10.886611,-74.776708)"
2013,Agosto,Nicaragua,558,0,1,,1,"(12.586067,-81.702563)"
2013,Agosto,Nicaragua,558,5,9,,14,"(3.541112,-76.384584)"
2013,Agosto,Nicaragua,558,25,54,,79,"(4.697144,-74.140516)"
2013,Agosto,Nicaragua,558,1,3,,4,"(4.815061,-75.736532)"
2013,Agosto,Nicaragua,558,18,29,,47,"(6.171601,-75.427454)"
2013,Agosto,Nicaragua,558,1,1,,2,"(7.128456,-73.183637)"
2013,Agosto,Nicaragua,558,0,1,,1,"(7.927209,-72.507910)"
2013,Agosto,Nigeria,566,0,2,,2,"(3.541112,-76.384584)"
2013,Agosto,Nigeria,566,0,7,,7,"(4.697144,-74.140516)"
2013,Agosto,Nigeria,566,0,2,,2,"(6.171601,-75.427454)"
2013,Agosto,Noruega,578,2,0,,2,"(10.886611,-74.776708)"
2013,Agosto,Noruega,578,4,4,,8,"(3.541112,-76.384584)"
2013,Agosto,Noruega,578,29,28,,57,"(4.697144,-74.140516)"
2013,Agosto,Noruega,578,1,0,,1,"(6.171601,-75.427454)"
2013,Agosto,Nueva Caledonia/Territorio francés,540,0,1,,1,"(4.697144,-74.140516)"
2013,Agosto,Nueva Zelanda,554,15,14,,29,"(4.697144,-74.140516)"
2013,Agosto,Nueva Zelanda,554,3,0,,3,"(4.815061,-75.736532)"
2013,Agosto,Nueva Zelanda,554,3,0,,3,"(6.171601,-75.427454)"
2013,Agosto,Omán,512,2,1,,3,"(10.445761,-75.516429)"
2013,Agosto,Omán,512,8,12,,20,"(4.697144,-74.140516)"
2013,Agosto,Omán,512,1,3,,4,"(6.171601,-75.427454)"
2013,Agosto,Papúa Nueva Guinea,598,0,14,,14,"(4.697144,-74.140516)"
2013,Agosto,Papúa Nueva Guinea,598,0,1,,1,"(6.171601,-75.427454)"
2013,Agosto,Pakistán,586,0,4,,4,"(4.697144,-74.140516)"
2013,Agosto,Panamá,591,133,158,,291,"(10.408582,-75.538003)"
2013,Agosto,Panamá,591,375,417,,792,"(10.445761,-75.516429)"
2013,Agosto,Panamá,591,972,1001,,1973,"(10.886611,-74.776708)"
2013,Agosto,Panamá,591,0,5,,5,"(10.971302,-74.765397)"
2013,Agosto,Panamá,591,1,8,,9,"(12.5744111,-81.703935)"
2013,Agosto,Panamá,591,76,106,,182,"(12.586067,-81.702563)"
2013,Agosto,Panamá,591,2515,2099,,4614,"(3.541112,-76.384584)"
2013,Agosto,Panamá,591,7443,7993,,15436,"(4.697144,-74.140516)"
2013,Agosto,Panamá,591,563,445,,1008,"(4.815061,-75.736532)"
2013,Agosto,Panamá,591,1996,2037,,4033,"(6.171601,-75.427454)"
2013,Agosto,Panamá,591,287,240,,527,"(7.128456,-73.183637)"
2013,Agosto,Panamá,591,250,283,,533,"(7.927209,-72.507910)"
2013,Agosto,Panamá,591,4,75,,79,"(8.066966,-76.735404)"
2013,Agosto,Panamá,591,95,181,,276,"(8.635765,-77.346578)"
2013,Agosto,Paraguay,600,0,1,,1,"(10.445761,-75.516429)"
2013,Agosto,Paraguay,600,2,2,,4,"(10.886611,-74.776708)"
2013,Agosto,Paraguay,600,4,14,,18,"(3.541112,-76.384584)"
2013,Agosto,Paraguay,600,42,123,,165,"(4.697144,-74.140516)"
2013,Agosto,Paraguay,600,1,0,,1,"(4.815061,-75.736532)"
2013,Agosto,Paraguay,600,8,62,,70,"(6.171601,-75.427454)"
2013,Agosto,Perú,604,42,94,,136,"(-4.197703,-69.941278)"
2013,Agosto,Perú,604,3,17,,20,"(0.814836,-77.662532)"
2013,Agosto,Perú,604,9,7,,16,"(10.445761,-75.516429)"
2013,Agosto,Perú,604,19,24,,43,"(10.886611,-74.776708)"
2013,Agosto,Perú,604,156,187,,343,"(3.541112,-76.384584)"
2013,Agosto,Perú,604,3010,3888,,6898,"(4.697144,-74.140516)"
2013,Agosto,Perú,604,9,8,,17,"(4.815061,-75.736532)"
2013,Agosto,Perú,604,291,354,,645,"(6.171601,-75.427454)"
2013,Agosto,Perú,604,7,5,,12,"(7.128456,-73.183637)"
2013,Agosto,Perú,604,1,1,,2,"(7.927209,-72.507910)"
2013,Agosto,Palestina,99999,0,1,,1,"(6.171601,-75.427454)"
2013,Agosto,Polonia,616,0,1,,1,"(3.541112,-76.384584)"
2013,Agosto,Polonia,616,13,11,,24,"(4.697144,-74.140516)"
2013,Agosto,Polonia,616,1,2,,3,"(6.171601,-75.427454)"
2013,Agosto,Portugal,620,4,4,,8,"(3.541112,-76.384584)"
2013,Agosto,Portugal,620,18,26,,44,"(4.697144,-74.140516)"
2013,Agosto,Portugal,620,4,2,,6,"(6.171601,-75.427454)"
2013,Agosto,Puerto Rico/Territorio de Estados Unidos,630,9,14,,23,"(10.445761,-75.516429)"
2013,Agosto,Puerto Rico/Territorio de Estados Unidos,630,17,9,,26,"(10.886611,-74.776708)"
2013,Agosto,Puerto Rico/Territorio de Estados Unidos,630,48,28,,76,"(3.541112,-76.384584)"
2013,Agosto,Puerto Rico/Territorio de Estados Unidos,630,428,416,,844,"(4.697144,-74.140516)"
2013,Agosto,Puerto Rico/Territorio de Estados Unidos,630,14,15,,29,"(4.815061,-75.736532)"
2013,Agosto,Puerto Rico/Territorio de Estados Unidos,630,96,78,,174,"(6.171601,-75.427454)"
2013,Agosto,Puerto Rico/Territorio de Estados Unidos,630,8,4,,12,"(7.128456,-73.183637)"
2013,Agosto,Qatar,634,2,0,,2,"(3.541112,-76.384584)"
2013,Agosto,Qatar,634,25,24,,49,"(4.697144,-74.140516)"
2013,Agosto,Qatar,634,2,4,,6,"(6.171601,-75.427454)"
2013,Agosto,Reino Unido de Gran Bretaña e Irlanda del Norte,826,1,0,,1,"(10.886611,-74.776708)"
2013,Agosto,Reino Unido de Gran Bretaña e Irlanda del Norte,826,1,0,,1,"(12.586067,-81.702563)"
2013,Agosto,Reino Unido de Gran Bretaña e Irlanda del Norte,826,152,92,,244,"(3.541112,-76.384584)"
2013,Agosto,Reino Unido de Gran Bretaña e Irlanda del Norte,826,861,530,,1391,"(4.697144,-74.140516)"
2013,Agosto,Reino Unido de Gran Bretaña e Irlanda del Norte,826,1,1,,2,"(4.815061,-75.736532)"
2013,Agosto,Reino Unido de Gran Bretaña e Irlanda del Norte,826,89,48,,137,"(6.171601,-75.427454)"
2013,Agosto,Reino Unido de Gran Bretaña e Irlanda del Norte,826,1,0,,1,"(7.128456,-73.183637)"
2013,Agosto,República CentroÁfricana,140,0,1,,1,"(4.697144,-74.140516)"
2013,Agosto,Federación de Rusia,643,0,1,,1,"(3.541112,-76.384584)"
2013,Agosto,Federación de Rusia,643,79,115,,194,"(4.697144,-74.140516)"
2013,Agosto,República Dominicana,214,0,1,,1,"(10.408582,-75.538003)"
2013,Agosto,República Dominicana,214,11,6,,17,"(10.445761,-75.516429)"
2013,Agosto,República Dominicana,214,19,30,,49,"(10.886611,-74.776708)"
2013,Agosto,República Dominicana,214,70,68,,138,"(3.541112,-76.384584)"
2013,Agosto,República Dominicana,214,1558,1531,,3089,"(4.697144,-74.140516)"
2013,Agosto,República Dominicana,214,18,17,,35,"(4.815061,-75.736532)"
2013,Agosto,República Dominicana,214,121,142,,263,"(6.171601,-75.427454)"
2013,Agosto,República Dominicana,214,16,8,,24,"(7.128456,-73.183637)"
2013,Agosto,República Dominicana,214,0,1,,1,"(8.635765,-77.346578)"
2013,Agosto,Reunión,638,1,0,,1,"(6.171601,-75.427454)"
2013,Agosto,Rumania,642,11,12,,23,"(4.697144,-74.140516)"
2013,Agosto,Sahara Occidental/Desierto Sahara,732,0,1,,1,"(4.697144,-74.140516)"
2013,Agosto,San Pedro y Miquelón/territorio de Ultramar de La Unión Europea,666,1,0,,1,"(4.697144,-74.140516)"
2013,Agosto,San Cristóbal y Nevis,659,0,1,,1,"(1.813928,-78.763924)"
2013,Agosto,San Cristóbal y Nevis,659,1,0,,1,"(12.586067,-81.702563)"
2013,Agosto,San Cristóbal y Nevis,659,0,1,,1,"(4.697144,-74.140516)"
2013,Agosto,Senegal,686,5,4,,9,"(4.697144,-74.140516)"
2013,Agosto,Serbia,688,0,1,,1,"(4.697144,-74.140516)"
2013,Agosto,Serbia,688,2,0,,2,"(6.171601,-75.427454)"
2013,Agosto,Singapur,702,17,29,,46,"(4.697144,-74.140516)"
2013,Agosto,Singapur,702,1,0,,1,"(6.171601,-75.427454)"
2013,Agosto,Sudáfrica,710,0,1,,1,"(3.541112,-76.384584)"
2013,Agosto,Sudáfrica,710,17,35,,52,"(4.697144,-74.140516)"
2013,Agosto,Sudáfrica,710,2,0,,2,"(4.815061,-75.736532)"
2013,Agosto,Sudáfrica,710,2,1,,3,"(6.171601,-75.427454)"
2013,Agosto,Sudán,736,1,0,,1,"(4.697144,-74.140516)"
2013,Agosto,Sudán,736,0,1,,1,"(6.171601,-75.427454)"
2013,Agosto,Suecia,752,16,9,,25,"(3.541112,-76.384584)"
2013,Agosto,Suecia,752,103,77,,180,"(4.697144,-74.140516)"
2013,Agosto,Suecia,752,1,2,,3,"(4.815061,-75.736532)"
2013,Agosto,Suecia,752,13,8,,21,"(6.171601,-75.427454)"
2013,Agosto,Suiza,756,6,1,,7,"(10.445761,-75.516429)"
2013,Agosto,Suiza,756,1,2,,3,"(10.886611,-74.776708)"
2013,Agosto,Suiza,756,60,26,,86,"(3.541112,-76.384584)"
2013,Agosto,Suiza,756,434,261,,695,"(4.697144,-74.140516)"
2013,Agosto,Suiza,756,26,14,,40,"(6.171601,-75.427454)"
2013,Agosto,Surinam,740,7,14,,21,"(4.697144,-74.140516)"
2013,Agosto,Surinam,740,2,2,,4,"(6.171601,-75.427454)"
2013,Agosto,Taiwán,158,0,2,,2,"(10.445761,-75.516429)"
2013,Agosto,Taiwán,158,0,1,,1,"(3.541112,-76.384584)"
2013,Agosto,Taiwán,158,4,5,,9,"(4.697144,-74.140516)"
2013,Agosto,Taiwán,158,0,1,,1,"(4.815061,-75.736532)"
2013,Agosto,Taiwán,158,0,1,,1,"(6.171601,-75.427454)"
2013,Agosto,Tailandia,764,13,19,,32,"(4.697144,-74.140516)"
2013,Agosto,Tanzania,834,1,1,,2,"(4.697144,-74.140516)"
2013,Agosto,Trinidad y Tobago,780,3,2,,5,"(10.445761,-75.516429)"
2013,Agosto,Trinidad y Tobago,780,2,2,,4,"(10.886611,-74.776708)"
2013,Agosto,Trinidad y Tobago,780,6,15,,21,"(3.541112,-76.384584)"
2013,Agosto,Trinidad y Tobago,780,37,46,,83,"(4.697144,-74.140516)"
2013,Agosto,Trinidad y Tobago,780,3,1,,4,"(4.815061,-75.736532)"
2013,Agosto,Trinidad y Tobago,780,7,7,,14,"(6.171601,-75.427454)"
2013,Agosto,Trinidad y Tobago,780,2,1,,3,"(7.128456,-73.183637)"
2013,Agosto,Trinidad y Tobago,780,1,2,,3,"(7.927209,-72.507910)"
2013,Agosto,Túnez,788,1,0,,1,"(4.697144,-74.140516)"
2013,Agosto,Turquía,792,0,1,,1,"(10.886611,-74.776708)"
2013,Agosto,Turquía,792,6,5,,11,"(3.541112,-76.384584)"
2013,Agosto,Turquía,792,79,71,,150,"(4.697144,-74.140516)"
2013,Agosto,Turquía,792,5,0,,5,"(6.171601,-75.427454)"
2013,Agosto,Ucrania,804,1,2,,3,"(4.697144,-74.140516)"
2013,Agosto,Uganda,800,0,2,,2,"(4.697144,-74.140516)"
2013,Agosto,Uganda,800,1,0,,1,"(6.171601,-75.427454)"
2013,Agosto,Uruguay,858,1,2,,3,"(10.445761,-75.516429)"
2013,Agosto,Uruguay,858,2,14,,16,"(10.886611,-74.776708)"
2013,Agosto,Uruguay,858,4,14,,18,"(3.541112,-76.384584)"
2013,Agosto,Uruguay,858,62,69,,131,"(4.697144,-74.140516)"
2013,Agosto,Uruguay,858,1,0,,1,"(4.815061,-75.736532)"
2013,Agosto,Uruguay,858,12,7,,19,"(6.171601,-75.427454)"
2013,Agosto,Uruguay,858,5,1,,6,"(7.128456,-73.183637)"
2013,Agosto,Uruguay,858,1,1,,2,"(7.927209,-72.507910)"
2013,Agosto,Vanuatu,548,0,1,,1,"(7.818934,-72.453226)"
2013,Agosto,Venezuela,862,0,6,,6,"(10.408582,-75.538003)"
2013,Agosto,Venezuela,862,11,6,,17,"(10.445761,-75.516429)"
2013,Agosto,Venezuela,862,12,22,,34,"(10.886611,-74.776708)"
2013,Agosto,Venezuela,862,10553,8651,,19204,"(11.360009,-72.129330)"
2013,Agosto,Venezuela,862,1,1,,2,"(12.586067,-81.702563)"
2013,Agosto,Venezuela,862,6,20,,26,"(3.541112,-76.384584)"
2013,Agosto,Venezuela,862,1699,2018,,3717,"(4.697144,-74.140516)"
2013,Agosto,Venezuela,862,3,9,,12,"(4.815061,-75.736532)"
2013,Agosto,Venezuela,862,261,251,,512,"(6.171601,-75.427454)"
2013,Agosto,Venezuela,862,364,382,,746,"(6.185799,-67.483929)"
2013,Agosto,Venezuela,862,1769,1649,,3418,"(7.088729,-70.740253)"
2013,Agosto,Venezuela,862,1,3,,4,"(7.128456,-73.183637)"
2013,Agosto,Venezuela,862,5715,5654,,11369,"(7.818934,-72.453226)"
2013,Agosto,Venezuela,862,1,0,,1,"(7.927209,-72.507910)"
2013,Agosto,Vietnam,704,2,3,,5,"(4.697144,-74.140516)"
2013,Agosto,República Árabe de Yemen,887,0,1,,1,"(4.697144,-74.140516)"
2013,Agosto,Zambia,894,5,2,,7,"(4.697144,-74.140516)"
2013,Agosto,Zimbabue,716,0,1,,1,"(4.697144,-74.140516)"
2013,Agosto,Desconocido,99999,1,2,,3,"(3.541112,-76.384584)"
2013,Agosto,Desconocido,99999,10,34,,44,"(4.697144,-74.140516)"
2013,Septiembre,Afganistán,4,2,46,,48,"(4.697144,-74.140516)"
2013,Septiembre,Afganistán,4,0,1,,1,"(6.171601,-75.427454)"
2013,Septiembre,Alemania,276,1,2,,3,"(0.814836,-77.662532)"
2013,Septiembre,Alemania,276,1,1,,2,"(10.445761,-75.516429)"
2013,Septiembre,Alemania,276,4,4,,8,"(10.886611,-74.776708)"
2013,Septiembre,Alemania,276,26,17,,43,"(3.541112,-76.384584)"
2013,Septiembre,Alemania,276,1380,1442,,2822,"(4.697144,-74.140516)"
2013,Septiembre,Alemania,276,21,11,,32,"(6.171601,-75.427454)"
2013,Septiembre,Andorra,20,1,1,,2,"(4.697144,-74.140516)"
2013,Septiembre,Angola,24,0,8,,8,"(4.697144,-74.140516)"
2013,Septiembre,Antigua y Barbuda,28,1,1,,2,"(4.697144,-74.140516)"
2013,Septiembre,Antigua y Barbuda,28,0,1,,1,"(7.927209,-72.507910)"
2013,Septiembre,Países Bajos,528,3,3,,6,"(10.445761,-75.516429)"
2013,Septiembre,Países Bajos,528,2,1,,3,"(10.886611,-74.776708)"
2013,Septiembre,Países Bajos,528,43,12,,55,"(3.541112,-76.384584)"
2013,Septiembre,Países Bajos,528,149,123,,272,"(4.697144,-74.140516)"
2013,Septiembre,Países Bajos,528,2,3,,5,"(4.815061,-75.736532)"
2013,Septiembre,Países Bajos,528,42,36,,78,"(6.171601,-75.427454)"
2013,Septiembre,Países Bajos,528,2,1,,3,"(7.927209,-72.507910)"
2013,Septiembre,Arabia Saudita,682,13,29,,42,"(4.697144,-74.140516)"
2013,Septiembre,Argelia,12,4,7,,11,"(4.697144,-74.140516)"
2013,Septiembre,Argentina,32,13,13,,26,"(0.814836,-77.662532)"
2013,Septiembre,Argentina,32,12,12,,24,"(10.445761,-75.516429)"
2013,Septiembre,Argentina,32,32,29,,61,"(10.886611,-74.776708)"
2013,Septiembre,Argentina,32,1,0,,1,"(11.360009,-72.129330)"
2013,Septiembre,Argentina,32,2,3,,5,"(12.586067,-81.702563)"
2013,Septiembre,Argentina,32,102,135,,237,"(3.541112,-76.384584)"
2013,Septiembre,Argentina,32,2405,2505,,4910,"(4.697144,-74.140516)"
2013,Septiembre,Argentina,32,13,18,,31,"(4.815061,-75.736532)"
2013,Septiembre,Argentina,32,194,204,,398,"(6.171601,-75.427454)"
2013,Septiembre,Argentina,32,4,4,,8,"(7.128456,-73.183637)"
2013,Septiembre,Argentina,32,2,1,,3,"(7.927209,-72.507910)"
2013,Septiembre,Aruba,533,1170,759,,1929,"(10.408582,-75.538003)"
2013,Septiembre,Aruba,533,3,3,,6,"(10.445761,-75.516429)"
2013,Septiembre,Aruba,533,8,14,,22,"(10.886611,-74.776708)"
2013,Septiembre,Aruba,533,70,39,,109,"(11.528919,-72.919681)"
2013,Septiembre,Aruba,533,30,20,,50,"(3.541112,-76.384584)"
2013,Septiembre,Aruba,533,978,748,,1726,"(4.697144,-74.140516)"
2013,Septiembre,Aruba,533,5,1,,6,"(4.815061,-75.736532)"
2013,Septiembre,Aruba,533,44,29,,73,"(6.171601,-75.427454)"
2013,Septiembre,Aruba,533,3,15,,18,"(7.128456,-73.183637)"
2013,Septiembre,Australia,36,1,0,,1,"(10.886611,-74.776708)"
2013,Septiembre,Australia,36,12,8,,20,"(3.541112,-76.384584)"
2013,Septiembre,Australia,36,175,157,,332,"(4.697144,-74.140516)"
2013,Septiembre,Australia,36,33,31,,64,"(6.171601,-75.427454)"
2013,Septiembre,Australia,36,2,3,,5,"(7.128456,-73.183637)"
2013,Septiembre,Austria,40,2,1,,3,"(3.541112,-76.384584)"
2013,Septiembre,Austria,40,39,54,,93,"(4.697144,-74.140516)"
2013,Septiembre,Austria,40,2,2,,4,"(6.171601,-75.427454)"
2013,Septiembre,Azerbaiyán,31,2,3,,5,"(4.697144,-74.140516)"
2013,Septiembre,Bahamas,44,5,4,,9,"(10.886611,-74.776708)"
2013,Septiembre,Bahamas,44,0,1,,1,"(12.586067,-81.702563)"
2013,Septiembre,Bahamas,44,3,4,,7,"(3.541112,-76.384584)"
2013,Septiembre,Bahamas,44,10,10,,20,"(4.697144,-74.140516)"
2013,Septiembre,Bahamas,44,7,3,,10,"(4.815061,-75.736532)"
2013,Septiembre,Bahamas,44,24,15,,39,"(6.171601,-75.427454)"
2013,Septiembre,Bahréin,48,1,5,,6,"(4.697144,-74.140516)"
2013,Septiembre,Barbados,52,0,1,,1,"(3.541112,-76.384584)"
2013,Septiembre,Barbados,52,2,16,,18,"(4.697144,-74.140516)"
2013,Septiembre,Barbados,52,0,1,,1,"(6.171601,-75.427454)"
2013,Septiembre,República de Belarús,112,2,0,,2,"(3.541112,-76.384584)"
2013,Septiembre,República de Belarús,112,2,0,,2,"(6.171601,-75.427454)"
2013,Septiembre,República de Belarús,112,1,1,,2,"(7.818934,-72.453226)"
2013,Septiembre,Bélgica,56,11,14,,25,"(3.541112,-76.384584)"
2013,Septiembre,Bélgica,56,88,74,,162,"(4.697144,-74.140516)"
2013,Septiembre,Bélgica,56,8,8,,16,"(6.171601,-75.427454)"
2013,Septiembre,Belice,84,7,4,,11,"(4.697144,-74.140516)"
2013,Septiembre,Benín,204,1,0,,1,"(4.697144,-74.140516)"
2013,Septiembre,Bermudas/Territorio Británico de Ultramar,60,1,2,,3,"(4.697144,-74.140516)"
2013,Septiembre,Bermudas/Territorio Británico de Ultramar,60,2,1,,3,"(6.171601,-75.427454)"
2013,Septiembre,Bolivia,68,5,4,,9,"(0.814836,-77.662532)"
2013,Septiembre,Bolivia,68,1,2,,3,"(10.445761,-75.516429)"
2013,Septiembre,Bolivia,68,1,3,,4,"(10.886611,-74.776708)"
2013,Septiembre,Bolivia,68,15,18,,33,"(3.541112,-76.384584)"
2013,Septiembre,Bolivia,68,238,351,,589,"(4.697144,-74.140516)"
2013,Septiembre,Bolivia,68,3,4,,7,"(4.815061,-75.736532)"
2013,Septiembre,Bolivia,68,15,36,,51,"(6.171601,-75.427454)"
2013,Septiembre,Brasil,76,62,130,,192,"(-4.197703,-69.941278)"
2013,Septiembre,Brasil,76,0,5,,5,"(0.814836,-77.662532)"
2013,Septiembre,Brasil,76,5,11,,16,"(10.445761,-75.516429)"
2013,Septiembre,Brasil,76,3,12,,15,"(10.886611,-74.776708)"
2013,Septiembre,Brasil,76,1,0,,1,"(12.586067,-81.702563)"
2013,Septiembre,Brasil,76,30,53,,83,"(3.541112,-76.384584)"
2013,Septiembre,Brasil,76,2831,4015,,6846,"(4.697144,-74.140516)"
2013,Septiembre,Brasil,76,6,17,,23,"(4.815061,-75.736532)"
2013,Septiembre,Brasil,76,46,83,,129,"(6.171601,-75.427454)"
2013,Septiembre,Brasil,76,1,2,,3,"(7.128456,-73.183637)"
2013,Septiembre,Bulgaria,100,4,6,,10,"(4.697144,-74.140516)"
2013,Septiembre,Bulgaria,100,1,2,,3,"(6.171601,-75.427454)"
2013,Septiembre,Cabo Verde,132,3,0,,3,"(4.697144,-74.140516)"
2013,Septiembre,Islas Caimán/Territorio Británico de Ultramar,136,1,0,,1,"(10.408582,-75.538003)"
2013,Septiembre,Islas Caimán/Territorio Británico de Ultramar,136,1,0,,1,"(10.445761,-75.516429)"
2013,Septiembre,Islas Caimán/Territorio Británico de Ultramar,136,2,1,,3,"(12.586067,-81.702563)"
2013,Septiembre,Islas Caimán/Territorio Británico de Ultramar,136,1,0,,1,"(3.541112,-76.384584)"
2013,Septiembre,Islas Caimán/Territorio Británico de Ultramar,136,1,2,,3,"(4.697144,-74.140516)"
2013,Septiembre,Camboya,116,0,2,,2,"(6.171601,-75.427454)"
2013,Septiembre,Canadá,124,22,15,,37,"(10.445761,-75.516429)"
2013,Septiembre,Canadá,124,13,9,,22,"(10.886611,-74.776708)"
2013,Septiembre,Canadá,124,71,53,,124,"(3.541112,-76.384584)"
2013,Septiembre,Canadá,124,9,6,,15,"(4.452882,-75.766298)"
2013,Septiembre,Canadá,124,1607,1387,,2994,"(4.697144,-74.140516)"
2013,Septiembre,Canadá,124,4,5,,9,"(4.815061,-75.736532)"
2013,Septiembre,Canadá,124,164,127,,291,"(6.171601,-75.427454)"
2013,Septiembre,Canadá,124,2,4,,6,"(7.128456,-73.183637)"
2013,Septiembre,Chad,148,0,1,,1,"(4.697144,-74.140516)"
2013,Septiembre,España,724,6,6,,12,"(10.445761,-75.516429)"
2013,Septiembre,España,724,0,3,,3,"(10.886611,-74.776708)"
2013,Septiembre,España,724,0,1,,1,"(12.586067,-81.702563)"
2013,Septiembre,España,724,1996,1298,,3294,"(3.541112,-76.384584)"
2013,Septiembre,España,724,7766,5902,,13668,"(4.697144,-74.140516)"
2013,Septiembre,España,724,2,1,,3,"(4.815061,-75.736532)"
2013,Septiembre,España,724,845,614,,1459,"(6.171601,-75.427454)"
2013,Septiembre,España,724,0,1,,1,"(7.818934,-72.453226)"
2013,Septiembre,República Democrática del Congo,180,0,5,,5,"(4.697144,-74.140516)"
2013,Septiembre,República de Corea,410,0,1,,1,"(10.445761,-75.516429)"
2013,Septiembre,República de Corea,410,1,1,,2,"(3.541112,-76.384584)"
2013,Septiembre,República de Corea,410,16,34,,50,"(4.697144,-74.140516)"
2013,Septiembre,República de Corea,410,0,2,,2,"(6.171601,-75.427454)"
2013,Septiembre,Costa de Marfil,384,0,1,,1,"(10.886611,-74.776708)"
2013,Septiembre,Costa de Marfil,384,3,4,,7,"(4.697144,-74.140516)"
2013,Septiembre,Costa Rica,188,0,6,,6,"(10.408582,-75.538003)"
2013,Septiembre,Costa Rica,188,9,16,,25,"(10.445761,-75.516429)"
2013,Septiembre,Costa Rica,188,15,24,,39,"(10.886611,-74.776708)"
2013,Septiembre,Costa Rica,188,4,36,,40,"(12.5744111,-81.703935)"
2013,Septiembre,Costa Rica,188,9,6,,15,"(12.586067,-81.702563)"
2013,Septiembre,Costa Rica,188,1,9,,10,"(13.3387613,-81.372937)"
2013,Septiembre,Costa Rica,188,31,56,,87,"(3.541112,-76.384584)"
2013,Septiembre,Costa Rica,188,0,1,,1,"(3.893038,-77.067921)"
2013,Septiembre,Costa Rica,188,645,813,,1458,"(4.697144,-74.140516)"
2013,Septiembre,Costa Rica,188,12,10,,22,"(4.815061,-75.736532)"
2013,Septiembre,Costa Rica,188,85,119,,204,"(6.171601,-75.427454)"
2013,Septiembre,Costa Rica,188,2,4,,6,"(7.128456,-73.183637)"
2013,Septiembre,Costa Rica,188,0,1,,1,"(7.927209,-72.507910)"
2013,Septiembre,Costa Rica,188,1,0,,1,"(8.635765,-77.346578)"
2013,Septiembre,Croacia,191,3,2,,5,"(4.697144,-74.140516)"
2013,Septiembre,Cuba,192,29,39,,68,"(10.445761,-75.516429)"
2013,Septiembre,Cuba,192,7,11,,18,"(10.886611,-74.776708)"
2013,Septiembre,Cuba,192,0,1,,1,"(12.586067,-81.702563)"
2013,Septiembre,Cuba,192,109,105,,214,"(3.541112,-76.384584)"
2013,Septiembre,Cuba,192,1078,939,,2017,"(4.697144,-74.140516)"
2013,Septiembre,Cuba,192,13,14,,27,"(4.815061,-75.736532)"
2013,Septiembre,Cuba,192,149,146,,295,"(6.171601,-75.427454)"
2013,Septiembre,Cuba,192,6,7,,13,"(7.128456,-73.183637)"
2013,Septiembre,Cuba,192,2,4,,6,"(7.927209,-72.507910)"
2013,Septiembre,Curazao,99999,1,1,,2,"(10.445761,-75.516429)"
2013,Septiembre,Curazao,99999,1,1,,2,"(10.886611,-74.776708)"
2013,Septiembre,Curazao,99999,7,1,,8,"(3.541112,-76.384584)"
2013,Septiembre,Curazao,99999,287,327,,614,"(4.697144,-74.140516)"
2013,Septiembre,Curazao,99999,95,51,,146,"(6.171601,-75.427454)"
2013,Septiembre,República Checa,203,13,8,,21,"(4.697144,-74.140516)"
2013,Septiembre,República Checa,203,0,1,,1,"(6.171601,-75.427454)"
2013,Septiembre,Chile,152,36,39,,75,"(0.814836,-77.662532)"
2013,Septiembre,Chile,152,8,11,,19,"(10.445761,-75.516429)"
2013,Septiembre,Chile,152,17,16,,33,"(10.886611,-74.776708)"
2013,Septiembre,Chile,152,408,343,,751,"(3.541112,-76.384584)"
2013,Septiembre,Chile,152,2127,2023,,4150,"(4.697144,-74.140516)"
2013,Septiembre,Chile,152,11,13,,24,"(4.815061,-75.736532)"
2013,Septiembre,Chile,152,177,162,,339,"(6.171601,-75.427454)"
2013,Septiembre,Chile,152,8,6,,14,"(7.128456,-73.183637)"
2013,Septiembre,China,156,2,6,,8,"(10.886611,-74.776708)"
2013,Septiembre,China,156,18,14,,32,"(3.541112,-76.384584)"
2013,Septiembre,China,156,199,370,,569,"(4.697144,-74.140516)"
2013,Septiembre,China,156,1,0,,1,"(4.815061,-75.736532)"
2013,Septiembre,China,156,11,23,,34,"(6.171601,-75.427454)"
2013,Septiembre,China,156,0,1,,1,"(7.128456,-73.183637)"
2013,Septiembre,China,156,1,0,,1,"(7.818934,-72.453226)"
2013,Septiembre,Dinamarca,208,0,2,,2,"(12.586067,-81.702563)"
2013,Septiembre,Dinamarca,208,0,1,,1,"(3.541112,-76.384584)"
2013,Septiembre,Dinamarca,208,27,40,,67,"(4.697144,-74.140516)"
2013,Septiembre,Dinamarca,208,0,1,,1,"(6.171601,-75.427454)"
2013,Septiembre,República de Yibuti,262,0,1,,1,"(0.814836,-77.662532)"
2013,Septiembre,Dominica,212,2,2,,4,"(4.697144,-74.140516)"
2013,Septiembre,Ecuador,218,368,483,,851,"(0.25129,-76.875963)"
2013,Septiembre,Ecuador,218,4978,5974,,10952,"(0.814836,-77.662532)"
2013,Septiembre,Ecuador,218,112,132,,244,"(1.813928,-78.763924)"
2013,Septiembre,Ecuador,218,5,8,,13,"(10.445761,-75.516429)"
2013,Septiembre,Ecuador,218,18,44,,62,"(10.886611,-74.776708)"
2013,Septiembre,Ecuador,218,1,1,,2,"(12.586067,-81.702563)"
2013,Septiembre,Ecuador,218,590,729,,1319,"(3.541112,-76.384584)"
2013,Septiembre,Ecuador,218,1929,3886,,5815,"(4.697144,-74.140516)"
2013,Septiembre,Ecuador,218,0,2,,2,"(4.815061,-75.736532)"
2013,Septiembre,Ecuador,218,394,442,,836,"(6.171601,-75.427454)"
2013,Septiembre,Ecuador,218,2,1,,3,"(7.128456,-73.183637)"
2013,Septiembre,Egipto,818,60,35,,95,"(4.697144,-74.140516)"
2013,Septiembre,El Salvador,222,1,1,,2,"(10.445761,-75.516429)"
2013,Septiembre,El Salvador,222,2,2,,4,"(10.886611,-74.776708)"
2013,Septiembre,El Salvador,222,57,63,,120,"(3.541112,-76.384584)"
2013,Septiembre,El Salvador,222,709,878,,1587,"(4.697144,-74.140516)"
2013,Septiembre,El Salvador,222,1,3,,4,"(4.815061,-75.736532)"
2013,Septiembre,El Salvador,222,94,91,,185,"(6.171601,-75.427454)"
2013,Septiembre,El Salvador,222,0,1,,1,"(7.128456,-73.183637)"
2013,Septiembre,Emiratos Árabes,784,6,2,,8,"(3.541112,-76.384584)"
2013,Septiembre,Emiratos Árabes,784,100,140,,240,"(4.697144,-74.140516)"
2013,Septiembre,Emiratos Árabes,784,9,6,,15,"(6.171601,-75.427454)"
2013,Septiembre,Eritrea,232,0,3,,3,"(4.697144,-74.140516)"
2013,Septiembre,Eslovaquia,703,1,1,,2,"(4.697144,-74.140516)"
2013,Septiembre,Eslovenia,705,5,4,,9,"(4.697144,-74.140516)"
2013,Septiembre,Estados Unidos de América,840,1860,1690,,3550,"(10.445761,-75.516429)"
2013,Septiembre,Estados Unidos de América,840,1517,1416,,2933,"(10.886611,-74.776708)"
2013,Septiembre,Estados Unidos de América,840,0,2,,2,"(11.117806,-74.232622)"
2013,Septiembre,Estados Unidos de América,840,17,12,,29,"(12.586067,-81.702563)"
2013,Septiembre,Estados Unidos de América,840,4429,3357,,7786,"(3.541112,-76.384584)"
2013,Septiembre,Estados Unidos de América,840,500,386,,886,"(4.452882,-75.766298)"
2013,Septiembre,Estados Unidos de América,840,27473,25374,,52847,"(4.697144,-74.140516)"
2013,Septiembre,Estados Unidos de América,840,568,393,,961,"(4.815061,-75.736532)"
2013,Septiembre,Estados Unidos de América,840,7576,6160,,13736,"(6.171601,-75.427454)"
2013,Septiembre,Estados Unidos de América,840,66,73,,139,"(7.128456,-73.183637)"
2013,Septiembre,Estados Unidos de América,840,0,1,,1,"(7.818934,-72.453226)"
2013,Septiembre,Estados Unidos de América,840,76,75,,151,"(7.927209,-72.507910)"
2013,Septiembre,Estados Unidos de América,840,1,2,,3,"(8.635765,-77.346578)"
2013,Septiembre,Filipinas,608,0,1,,1,"(10.445761,-75.516429)"
2013,Septiembre,Filipinas,608,1,0,,1,"(3.541112,-76.384584)"
2013,Septiembre,Filipinas,608,1,3,,4,"(4.697144,-74.140516)"
2013,Septiembre,Finlandia,246,4,3,,7,"(4.697144,-74.140516)"
2013,Septiembre,Francia,250,1,0,,1,"(10.445761,-75.516429)"
2013,Septiembre,Francia,250,3,3,,6,"(10.886611,-74.776708)"
2013,Septiembre,Francia,250,83,71,,154,"(3.541112,-76.384584)"
2013,Septiembre,Francia,250,1880,1436,,3316,"(4.697144,-74.140516)"
2013,Septiembre,Francia,250,55,42,,97,"(6.171601,-75.427454)"
2013,Septiembre,Gabón,266,0,3,,3,"(4.697144,-74.140516)"
2013,Septiembre,Ghana,288,2,3,,5,"(3.541112,-76.384584)"
2013,Septiembre,Ghana,288,1,3,,4,"(4.697144,-74.140516)"
2013,Septiembre,Gibraltar/Territorio Británico de Ultramar,292,0,1,,1,"(4.697144,-74.140516)"
2013,Septiembre,Granada,308,2,0,,2,"(4.697144,-74.140516)"
2013,Septiembre,Grecia,300,1,0,,1,"(3.541112,-76.384584)"
2013,Septiembre,Grecia,300,46,22,,68,"(4.697144,-74.140516)"
2013,Septiembre,Grecia,300,1,1,,2,"(6.171601,-75.427454)"
2013,Septiembre,Guatemala,320,4,11,,15,"(10.445761,-75.516429)"
2013,Septiembre,Guatemala,320,4,6,,10,"(10.886611,-74.776708)"
2013,Septiembre,Guatemala,320,39,75,,114,"(3.541112,-76.384584)"
2013,Septiembre,Guatemala,320,155,290,,445,"(4.697144,-74.140516)"
2013,Septiembre,Guatemala,320,5,8,,13,"(4.815061,-75.736532)"
2013,Septiembre,Guatemala,320,90,114,,204,"(6.171601,-75.427454)"
2013,Septiembre,Guatemala,320,3,1,,4,"(7.128456,-73.183637)"
2013,Septiembre,Guatemala,320,2,0,,2,"(7.927209,-72.507910)"
2013,Septiembre,Guyana,328,1,3,,4,"(10.886611,-74.776708)"
2013,Septiembre,Guyana,328,0,1,,1,"(4.697144,-74.140516)"
2013,Septiembre,Guinea,324,0,5,,5,"(4.697144,-74.140516)"
2013,Septiembre,Guinea,324,0,1,,1,"(6.171601,-75.427454)"
2013,Septiembre,Guinea Ecuatorial,226,1,6,,7,"(4.697144,-74.140516)"
2013,Septiembre,Guadalupe/Territorio Francés,312,0,1,,1,"(4.697144,-74.140516)"
2013,Septiembre,Haití,332,0,6,,6,"(10.886611,-74.776708)"
2013,Septiembre,Haití,332,0,3,,3,"(3.541112,-76.384584)"
2013,Septiembre,Haití,332,6,14,,20,"(4.697144,-74.140516)"
2013,Septiembre,Haití,332,1,0,,1,"(4.815061,-75.736532)"
2013,Septiembre,Haití,332,1,9,,10,"(6.171601,-75.427454)"
2013,Septiembre,Honduras,340,24,12,,36,"(10.445761,-75.516429)"
2013,Septiembre,Honduras,340,8,21,,29,"(10.886611,-74.776708)"
2013,Septiembre,Honduras,340,8,25,,33,"(3.541112,-76.384584)"
2013,Septiembre,Honduras,340,68,144,,212,"(4.697144,-74.140516)"
2013,Septiembre,Honduras,340,4,2,,6,"(4.815061,-75.736532)"
2013,Septiembre,Honduras,340,30,71,,101,"(6.171601,-75.427454)"
2013,Septiembre,Honduras,340,0,1,,1,"(7.128456,-73.183637)"
2013,Septiembre,Hong Kong,344,0,1,,1,"(10.886611,-74.776708)"
2013,Septiembre,Hong Kong,344,1,1,,2,"(3.541112,-76.384584)"
2013,Septiembre,Hong Kong,344,25,69,,94,"(4.697144,-74.140516)"
2013,Septiembre,Hong Kong,344,1,4,,5,"(6.171601,-75.427454)"
2013,Septiembre,Hungría,348,1,2,,3,"(3.541112,-76.384584)"
2013,Septiembre,Hungría,348,10,4,,14,"(4.697144,-74.140516)"
2013,Septiembre,Hungría,348,0,2,,2,"(6.171601,-75.427454)"
2013,Septiembre,India,356,0,2,,2,"(3.541112,-76.384584)"
2013,Septiembre,India,356,41,30,,71,"(4.697144,-74.140516)"
2013,Septiembre,India,356,4,1,,5,"(6.171601,-75.427454)"
2013,Septiembre,Indonesia,360,0,1,,1,"(3.541112,-76.384584)"
2013,Septiembre,Indonesia,360,4,8,,12,"(4.697144,-74.140516)"
2013,Septiembre,Iraq,368,3,13,,16,"(4.697144,-74.140516)"
2013,Septiembre,Irán,364,6,5,,11,"(4.697144,-74.140516)"
2013,Septiembre,República de Irlanda,372,14,6,,20,"(4.697144,-74.140516)"
2013,Septiembre,República de Irlanda,372,0,1,,1,"(6.171601,-75.427454)"
2013,Septiembre,Islandia,352,1,2,,3,"(3.541112,-76.384584)"
2013,Septiembre,Islandia,352,0,1,,1,"(4.697144,-74.140516)"
2013,Septiembre,Israel,376,0,2,,2,"(10.886611,-74.776708)"
2013,Septiembre,Israel,376,7,3,,10,"(3.541112,-76.384584)"
2013,Septiembre,Israel,376,403,251,,654,"(4.697144,-74.140516)"
2013,Septiembre,Israel,376,4,0,,4,"(6.171601,-75.427454)"
2013,Septiembre,Israel,376,1,0,,1,"(7.818934,-72.453226)"
2013,Septiembre,Islas Aland/Provincia de Finlandia,248,0,1,,1,"(4.697144,-74.140516)"
2013,Septiembre,Italia,380,3,2,,5,"(10.445761,-75.516429)"
2013,Septiembre,Italia,380,1,1,,2,"(10.886611,-74.776708)"
2013,Septiembre,Italia,380,1,0,,1,"(12.586067,-81.702563)"
2013,Septiembre,Italia,380,101,55,,156,"(3.541112,-76.384584)"
2013,Septiembre,Italia,380,798,547,,1345,"(4.697144,-74.140516)"
2013,Septiembre,Italia,380,37,37,,74,"(6.171601,-75.427454)"
2013,Septiembre,Jamaica,388,3,0,,3,"(10.445761,-75.516429)"
2013,Septiembre,Jamaica,388,2,6,,8,"(10.886611,-74.776708)"
2013,Septiembre,Jamaica,388,0,3,,3,"(12.5744111,-81.703935)"
2013,Septiembre,Jamaica,388,0,1,,1,"(12.586067,-81.702563)"
2013,Septiembre,Jamaica,388,3,2,,5,"(3.541112,-76.384584)"
2013,Septiembre,Jamaica,388,26,41,,67,"(4.697144,-74.140516)"
2013,Septiembre,Jamaica,388,2,2,,4,"(4.815061,-75.736532)"
2013,Septiembre,Jamaica,388,7,5,,12,"(6.171601,-75.427454)"
2013,Septiembre,Japón,392,0,1,,1,"(10.886611,-74.776708)"
2013,Septiembre,Japón,392,9,10,,19,"(3.541112,-76.384584)"
2013,Septiembre,Japón,392,51,62,,113,"(4.697144,-74.140516)"
2013,Septiembre,Japón,392,1,3,,4,"(6.171601,-75.427454)"
2013,Septiembre,Jordania,400,9,5,,14,"(4.697144,-74.140516)"
2013,Septiembre,Jordania,400,0,1,,1,"(6.171601,-75.427454)"
2013,Septiembre,Kazajistán,398,0,2,,2,"(4.697144,-74.140516)"
2013,Septiembre,Kazajistán,398,0,1,,1,"(7.128456,-73.183637)"
2013,Septiembre,Kenia,404,2,4,,6,"(4.697144,-74.140516)"
2013,Septiembre,Kenia,404,0,1,,1,"(6.171601,-75.427454)"
2013,Septiembre,Kuwait,414,0,2,,2,"(4.697144,-74.140516)"
2013,Septiembre,Lesoto,426,1,0,,1,"(6.171601,-75.427454)"
2013,Septiembre,Lituania,440,1,0,,1,"(4.697144,-74.140516)"
2013,Septiembre,Líbano,422,25,18,,43,"(4.697144,-74.140516)"
2013,Septiembre,Liberia,430,0,1,,1,"(4.697144,-74.140516)"
2013,Septiembre,Libia,434,1,0,,1,"(4.697144,-74.140516)"
2013,Septiembre,Luxemburgo,442,4,6,,10,"(4.697144,-74.140516)"
2013,Septiembre,Macao,446,3,0,,3,"(4.697144,-74.140516)"
2013,Septiembre,Malasia,458,1,0,,1,"(10.886611,-74.776708)"
2013,Septiembre,Malasia,458,0,1,,1,"(3.541112,-76.384584)"
2013,Septiembre,Malasia,458,6,3,,9,"(4.697144,-74.140516)"
2013,Septiembre,Malasia,458,0,2,,2,"(6.171601,-75.427454)"
2013,Septiembre,Malí,466,3,1,,4,"(4.697144,-74.140516)"
2013,Septiembre,Malta,470,5,4,,9,"(4.697144,-74.140516)"
2013,Septiembre,Marruecos,504,15,10,,25,"(4.697144,-74.140516)"
2013,Septiembre,Marruecos,504,3,1,,4,"(6.171601,-75.427454)"
2013,Septiembre,Mauritania,478,0,1,,1,"(4.697144,-74.140516)"
2013,Septiembre,Martinica/Departamento de Ultramar Francés,474,1,0,,1,"(4.815061,-75.736532)"
2013,Septiembre,México,484,1,0,,1,"(0.814836,-77.662532)"
2013,Septiembre,México,484,30,18,,48,"(10.445761,-75.516429)"
2013,Septiembre,México,484,135,133,,268,"(10.886611,-74.776708)"
2013,Septiembre,México,484,1,6,,7,"(12.586067,-81.702563)"
2013,Septiembre,México,484,486,411,,897,"(3.541112,-76.384584)"
2013,Septiembre,México,484,6907,6728,,13635,"(4.697144,-74.140516)"
2013,Septiembre,México,484,136,91,,227,"(4.815061,-75.736532)"
2013,Septiembre,México,484,1289,957,,2246,"(6.171601,-75.427454)"
2013,Septiembre,México,484,40,23,,63,"(7.128456,-73.183637)"
2013,Septiembre,México,484,34,23,,57,"(7.927209,-72.507910)"
2013,Septiembre,Mónaco,492,0,1,,1,"(6.171601,-75.427454)"
2013,Septiembre,Montenegro,499,1,1,,2,"(4.697144,-74.140516)"
2013,Septiembre,Mozambique,508,0,4,,4,"(4.697144,-74.140516)"
2013,Septiembre,Myanmar,104,0,1,,1,"(4.697144,-74.140516)"
2013,Septiembre,Nauru,520,1,0,,1,"(4.697144,-74.140516)"
2013,Septiembre,Namibia,516,1,1,,2,"(4.697144,-74.140516)"
2013,Septiembre,Nicaragua,558,3,1,,4,"(10.445761,-75.516429)"
2013,Septiembre,Nicaragua,558,0,3,,3,"(10.886611,-74.776708)"
2013,Septiembre,Nicaragua,558,0,2,,2,"(12.5744111,-81.703935)"
2013,Septiembre,Nicaragua,558,0,1,,1,"(12.586067,-81.702563)"
2013,Septiembre,Nicaragua,558,9,17,,26,"(3.541112,-76.384584)"
2013,Septiembre,Nicaragua,558,23,50,,73,"(4.697144,-74.140516)"
2013,Septiembre,Nicaragua,558,1,0,,1,"(4.815061,-75.736532)"
2013,Septiembre,Nicaragua,558,17,27,,44,"(6.171601,-75.427454)"
2013,Septiembre,Nigeria,566,1,10,,11,"(4.697144,-74.140516)"
2013,Septiembre,Noruega,578,0,1,,1,"(10.886611,-74.776708)"
2013,Septiembre,Noruega,578,12,13,,25,"(4.697144,-74.140516)"
2013,Septiembre,Noruega,578,10,7,,17,"(6.171601,-75.427454)"
2013,Septiembre,Nueva Caledonia/Territorio francés,540,0,1,,1,"(4.697144,-74.140516)"
2013,Septiembre,Nueva Zelanda,554,11,9,,20,"(4.697144,-74.140516)"
2013,Septiembre,Nueva Zelanda,554,0,3,,3,"(6.171601,-75.427454)"
2013,Septiembre,Omán,512,4,7,,11,"(4.697144,-74.140516)"
2013,Septiembre,Omán,512,1,0,,1,"(6.171601,-75.427454)"
2013,Septiembre,Papúa Nueva Guinea,598,0,3,,3,"(4.697144,-74.140516)"
2013,Septiembre,Pakistán,586,1,3,,4,"(4.697144,-74.140516)"
2013,Septiembre,Palau,585,0,1,,1,"(6.171601,-75.427454)"
2013,Septiembre,Panamá,591,206,247,,453,"(10.408582,-75.538003)"
2013,Septiembre,Panamá,591,282,339,,621,"(10.445761,-75.516429)"
2013,Septiembre,Panamá,591,758,899,,1657,"(10.886611,-74.776708)"
2013,Septiembre,Panamá,591,0,2,,2,"(10.971302,-74.765397)"
2013,Septiembre,Panamá,591,0,1,,1,"(11.247723,-74.213989)"
2013,Septiembre,Panamá,591,6,38,,44,"(12.5744111,-81.703935)"
2013,Septiembre,Panamá,591,54,75,,129,"(12.586067,-81.702563)"
2013,Septiembre,Panamá,591,2011,1693,,3704,"(3.541112,-76.384584)"
2013,Septiembre,Panamá,591,0,8,,8,"(3.893038,-77.067921)"
2013,Septiembre,Panamá,591,6247,7038,,13285,"(4.697144,-74.140516)"
2013,Septiembre,Panamá,591,789,604,,1393,"(4.815061,-75.736532)"
2013,Septiembre,Panamá,591,1826,1849,,3675,"(6.171601,-75.427454)"
2013,Septiembre,Panamá,591,2,4,,6,"(6.228046,-77.404104)"
2013,Septiembre,Panamá,591,11,6,,17,"(7.102626,-77.762647)"
2013,Septiembre,Panamá,591,416,416,,832,"(7.128456,-73.183637)"
2013,Septiembre,Panamá,591,240,237,,477,"(7.927209,-72.507910)"
2013,Septiembre,Panamá,591,3,86,,89,"(8.066966,-76.735404)"
2013,Septiembre,Panamá,591,96,160,,256,"(8.635765,-77.346578)"
2013,Septiembre,Paraguay,600,1,0,,1,"(10.445761,-75.516429)"
2013,Septiembre,Paraguay,600,4,2,,6,"(10.886611,-74.776708)"
2013,Septiembre,Paraguay,600,9,4,,13,"(3.541112,-76.384584)"
2013,Septiembre,Paraguay,600,48,110,,158,"(4.697144,-74.140516)"
2013,Septiembre,Paraguay,600,7,4,,11,"(4.815061,-75.736532)"
2013,Septiembre,Paraguay,600,11,16,,27,"(6.171601,-75.427454)"
2013,Septiembre,Paraguay,600,1,0,,1,"(7.927209,-72.507910)"
2013,Septiembre,Perú,604,36,109,,145,"(-4.197703,-69.941278)"
2013,Septiembre,Perú,604,26,21,,47,"(0.814836,-77.662532)"
2013,Septiembre,Perú,604,4,11,,15,"(10.445761,-75.516429)"
2013,Septiembre,Perú,604,38,48,,86,"(10.886611,-74.776708)"
2013,Septiembre,Perú,604,242,249,,491,"(3.541112,-76.384584)"
2013,Septiembre,Perú,604,2876,4052,,6928,"(4.697144,-74.140516)"
2013,Septiembre,Perú,604,9,17,,26,"(4.815061,-75.736532)"
2013,Septiembre,Perú,604,337,444,,781,"(6.171601,-75.427454)"
2013,Septiembre,Perú,604,4,3,,7,"(7.128456,-73.183637)"
2013,Septiembre,Perú,604,2,0,,2,"(7.927209,-72.507910)"
2013,Septiembre,Polonia,616,2,0,,2,"(3.541112,-76.384584)"
2013,Septiembre,Polonia,616,14,17,,31,"(4.697144,-74.140516)"
2013,Septiembre,Polonia,616,0,2,,2,"(6.171601,-75.427454)"
2013,Septiembre,Portugal,620,5,1,,6,"(3.541112,-76.384584)"
2013,Septiembre,Portugal,620,33,22,,55,"(4.697144,-74.140516)"
2013,Septiembre,Portugal,620,0,1,,1,"(6.171601,-75.427454)"
2013,Septiembre,Puerto Rico/Territorio de Estados Unidos,630,2,6,,8,"(10.445761,-75.516429)"
2013,Septiembre,Puerto Rico/Territorio de Estados Unidos,630,6,10,,16,"(10.886611,-74.776708)"
2013,Septiembre,Puerto Rico/Territorio de Estados Unidos,630,23,17,,40,"(3.541112,-76.384584)"
2013,Septiembre,Puerto Rico/Territorio de Estados Unidos,630,279,294,,573,"(4.697144,-74.140516)"
2013,Septiembre,Puerto Rico/Territorio de Estados Unidos,630,5,3,,8,"(4.815061,-75.736532)"
2013,Septiembre,Puerto Rico/Territorio de Estados Unidos,630,38,33,,71,"(6.171601,-75.427454)"
2013,Septiembre,Puerto Rico/Territorio de Estados Unidos,630,1,2,,3,"(7.128456,-73.183637)"
2013,Septiembre,Qatar,634,6,7,,13,"(4.697144,-74.140516)"
2013,Septiembre,Qatar,634,1,0,,1,"(6.171601,-75.427454)"
2013,Septiembre,Reino Unido de Gran Bretaña e Irlanda del Norte,826,1,2,,3,"(10.445761,-75.516429)"
2013,Septiembre,Reino Unido de Gran Bretaña e Irlanda del Norte,826,2,1,,3,"(10.886611,-74.776708)"
2013,Septiembre,Reino Unido de Gran Bretaña e Irlanda del Norte,826,0,2,,2,"(12.586067,-81.702563)"
2013,Septiembre,Reino Unido de Gran Bretaña e Irlanda del Norte,826,128,87,,215,"(3.541112,-76.384584)"
2013,Septiembre,Reino Unido de Gran Bretaña e Irlanda del Norte,826,915,671,,1586,"(4.697144,-74.140516)"
2013,Septiembre,Reino Unido de Gran Bretaña e Irlanda del Norte,826,5,1,,6,"(4.815061,-75.736532)"
2013,Septiembre,Reino Unido de Gran Bretaña e Irlanda del Norte,826,68,50,,118,"(6.171601,-75.427454)"
2013,Septiembre,Macedonia,807,0,1,,1,"(6.171601,-75.427454)"
2013,Septiembre,Federación de Rusia,643,1,0,,1,"(10.886611,-74.776708)"
2013,Septiembre,Federación de Rusia,643,0,2,,2,"(3.541112,-76.384584)"
2013,Septiembre,Federación de Rusia,643,57,74,,131,"(4.697144,-74.140516)"
2013,Septiembre,Federación de Rusia,643,0,1,,1,"(6.171601,-75.427454)"
2013,Septiembre,República Dominicana,214,10,16,,26,"(10.445761,-75.516429)"
2013,Septiembre,República Dominicana,214,19,45,,64,"(10.886611,-74.776708)"
2013,Septiembre,República Dominicana,214,37,47,,84,"(3.541112,-76.384584)"
2013,Septiembre,República Dominicana,214,1070,1186,,2256,"(4.697144,-74.140516)"
2013,Septiembre,República Dominicana,214,10,12,,22,"(4.815061,-75.736532)"
2013,Septiembre,República Dominicana,214,98,102,,200,"(6.171601,-75.427454)"
2013,Septiembre,República Dominicana,214,5,3,,8,"(7.128456,-73.183637)"
2013,Septiembre,República Dominicana,214,0,1,,1,"(7.927209,-72.507910)"
2013,Septiembre,Reunión,638,1,0,,1,"(4.697144,-74.140516)"
2013,Septiembre,República Democrática Popular de Corea,408,0,1,,1,"(4.697144,-74.140516)"
2013,Septiembre,Rumania,642,6,3,,9,"(4.697144,-74.140516)"
2013,Septiembre,Sahara Occidental/Desierto Sahara,732,2,0,,2,"(4.697144,-74.140516)"
2013,Septiembre,San Pedro y Miquelón/territorio de Ultramar de La Unión Europea,666,0,1,,1,"(4.697144,-74.140516)"
2013,Septiembre,San Marino,674,1,1,,2,"(4.697144,-74.140516)"
2013,Septiembre,Senegal,686,2,1,,3,"(4.697144,-74.140516)"
2013,Septiembre,Serbia,688,2,0,,2,"(4.697144,-74.140516)"
2013,Septiembre,Singapur,702,10,20,,30,"(4.697144,-74.140516)"
2013,Septiembre,Singapur,702,1,2,,3,"(6.171601,-75.427454)"
2013,Septiembre,República Árabe Siria,760,1,0,,1,"(4.697144,-74.140516)"
2013,Septiembre,Sri Lanka,144,0,1,,1,"(4.697144,-74.140516)"
2013,Septiembre,Sudáfrica,710,1,0,,1,"(3.541112,-76.384584)"
2013,Septiembre,Sudáfrica,710,23,24,,47,"(4.697144,-74.140516)"
2013,Septiembre,Sudáfrica,710,1,0,,1,"(6.171601,-75.427454)"
2013,Septiembre,Sudán,736,2,0,,2,"(4.697144,-74.140516)"
2013,Septiembre,Suecia,752,1,0,,1,"(10.886611,-74.776708)"
2013,Septiembre,Suecia,752,4,3,,7,"(3.541112,-76.384584)"
2013,Septiembre,Suecia,752,50,61,,111,"(4.697144,-74.140516)"
2013,Septiembre,Suecia,752,1,0,,1,"(4.815061,-75.736532)"
2013,Septiembre,Suecia,752,8,7,,15,"(6.171601,-75.427454)"
2013,Septiembre,Suiza,756,28,12,,40,"(3.541112,-76.384584)"
2013,Septiembre,Suiza,756,175,136,,311,"(4.697144,-74.140516)"
2013,Septiembre,Suiza,756,4,2,,6,"(6.171601,-75.427454)"
2013,Septiembre,Surinam,740,1,5,,6,"(10.886611,-74.776708)"
2013,Septiembre,Surinam,740,2,4,,6,"(4.697144,-74.140516)"
2013,Septiembre,Surinam,740,3,2,,5,"(6.171601,-75.427454)"
2013,Septiembre,Suazilandia,748,0,1,,1,"(4.697144,-74.140516)"
2013,Septiembre,Taiwán,158,2,6,,8,"(4.697144,-74.140516)"
2013,Septiembre,Tailandia,764,8,10,,18,"(4.697144,-74.140516)"
2013,Septiembre,Tailandia,764,1,0,,1,"(6.171601,-75.427454)"
2013,Septiembre,Tanzania,834,1,1,,2,"(4.697144,-74.140516)"
2013,Septiembre,Trinidad y Tobago,780,4,8,,12,"(10.445761,-75.516429)"
2013,Septiembre,Trinidad y Tobago,780,0,3,,3,"(10.886611,-74.776708)"
2013,Septiembre,Trinidad y Tobago,780,14,10,,24,"(3.541112,-76.384584)"
2013,Septiembre,Trinidad y Tobago,780,27,47,,74,"(4.697144,-74.140516)"
2013,Septiembre,Trinidad y Tobago,780,1,0,,1,"(4.815061,-75.736532)"
2013,Septiembre,Trinidad y Tobago,780,11,11,,22,"(6.171601,-75.427454)"
2013,Septiembre,Trinidad y Tobago,780,2,1,,3,"(7.128456,-73.183637)"
2013,Septiembre,Túnez,788,0,1,,1,"(4.697144,-74.140516)"
2013,Septiembre,Turquía,792,7,6,,13,"(3.541112,-76.384584)"
2013,Septiembre,Turquía,792,146,90,,236,"(4.697144,-74.140516)"
2013,Septiembre,Turquía,792,6,2,,8,"(6.171601,-75.427454)"
2013,Septiembre,Turkmenistán,795,1,0,,1,"(4.697144,-74.140516)"
2013,Septiembre,Ucrania,804,3,3,,6,"(4.697144,-74.140516)"
2013,Septiembre,Uganda,800,1,0,,1,"(3.541112,-76.384584)"
2013,Septiembre,Uganda,800,1,0,,1,"(4.697144,-74.140516)"
2013,Septiembre,Uruguay,858,1,3,,4,"(10.445761,-75.516429)"
2013,Septiembre,Uruguay,858,11,59,,70,"(10.886611,-74.776708)"
2013,Septiembre,Uruguay,858,6,10,,16,"(3.541112,-76.384584)"
2013,Septiembre,Uruguay,858,101,179,,280,"(4.697144,-74.140516)"
2013,Septiembre,Uruguay,858,1,5,,6,"(4.815061,-75.736532)"
2013,Septiembre,Uruguay,858,10,13,,23,"(6.171601,-75.427454)"
2013,Septiembre,Uruguay,858,3,0,,3,"(7.128456,-73.183637)"
2013,Septiembre,Venezuela,862,11,12,,23,"(10.445761,-75.516429)"
2013,Septiembre,Venezuela,862,1,18,,19,"(10.886611,-74.776708)"
2013,Septiembre,Venezuela,862,12081,9910,,21991,"(11.360009,-72.129330)"
2013,Septiembre,Venezuela,862,7,15,,22,"(3.541112,-76.384584)"
2013,Septiembre,Venezuela,862,1528,1927,,3455,"(4.697144,-74.140516)"
2013,Septiembre,Venezuela,862,3,4,,7,"(4.815061,-75.736532)"
2013,Septiembre,Venezuela,862,227,214,,441,"(6.171601,-75.427454)"
2013,Septiembre,Venezuela,862,325,391,,716,"(6.185799,-67.483929)"
2013,Septiembre,Venezuela,862,1486,1488,,2974,"(7.088729,-70.740253)"
2013,Septiembre,Venezuela,862,1,1,,2,"(7.128456,-73.183637)"
2013,Septiembre,Venezuela,862,5579,5659,,11238,"(7.818934,-72.453226)"
2013,Septiembre,Vietnam,704,5,1,,6,"(4.697144,-74.140516)"
2013,Septiembre,Vietnam,704,0,1,,1,"(6.171601,-75.427454)"
2013,Septiembre,Zambia,894,1,0,,1,"(4.697144,-74.140516)"
2013,Septiembre,Desconocido,99999,1,2,,3,"(3.541112,-76.384584)"
2013,Septiembre,Desconocido,99999,1,6,,7,"(4.697144,-74.140516)"
2013,Octubre,Afganistán,4,3,33,,36,"(4.697144,-74.140516)"
2013,Octubre,Albania,8,1,0,,1,"(4.697144,-74.140516)"
2013,Octubre,Alemania,276,1,0,,1,"(10.445761,-75.516429)"
2013,Octubre,Alemania,276,2,1,,3,"(10.886611,-74.776708)"
2013,Octubre,Alemania,276,15,15,,30,"(3.541112,-76.384584)"
2013,Octubre,Alemania,276,1205,1413,,2618,"(4.697144,-74.140516)"
2013,Octubre,Alemania,276,9,9,,18,"(6.171601,-75.427454)"
2013,Octubre,Andorra,20,0,1,,1,"(10.408582,-75.538003)"
2013,Octubre,Andorra,20,0,1,,1,"(3.541112,-76.384584)"
2013,Octubre,Andorra,20,0,1,,1,"(4.697144,-74.140516)"
2013,Octubre,Angola,24,2,10,,12,"(4.697144,-74.140516)"
2013,Octubre,Antigua y Barbuda,28,3,1,,4,"(4.697144,-74.140516)"
2013,Octubre,Antigua y Barbuda,28,0,1,,1,"(4.815061,-75.736532)"
2013,Octubre,Antigua y Barbuda,28,0,1,,1,"(6.171601,-75.427454)"
2013,Octubre,Países Bajos,528,2,4,,6,"(10.445761,-75.516429)"
2013,Octubre,Países Bajos,528,5,5,,10,"(10.886611,-74.776708)"
2013,Octubre,Países Bajos,528,28,14,,42,"(3.541112,-76.384584)"
2013,Octubre,Países Bajos,528,117,106,,223,"(4.697144,-74.140516)"
2013,Octubre,Países Bajos,528,4,3,,7,"(4.815061,-75.736532)"
2013,Octubre,Países Bajos,528,45,31,,76,"(6.171601,-75.427454)"
2013,Octubre,Arabia Saudita,682,8,20,,28,"(4.697144,-74.140516)"
2013,Octubre,Arabia Saudita,682,3,0,,3,"(6.171601,-75.427454)"
2013,Octubre,Argelia,12,3,3,,6,"(4.697144,-74.140516)"
2013,Octubre,Argelia,12,1,0,,1,"(6.171601,-75.427454)"
2013,Octubre,Argentina,32,7,7,,14,"(0.814836,-77.662532)"
2013,Octubre,Argentina,32,18,20,,38,"(10.445761,-75.516429)"
2013,Octubre,Argentina,32,20,31,,51,"(10.886611,-74.776708)"
2013,Octubre,Argentina,32,0,1,,1,"(12.586067,-81.702563)"
2013,Octubre,Argentina,32,147,149,,296,"(3.541112,-76.384584)"
2013,Octubre,Argentina,32,2973,2984,,5957,"(4.697144,-74.140516)"
2013,Octubre,Argentina,32,10,9,,19,"(4.815061,-75.736532)"
2013,Octubre,Argentina,32,229,187,,416,"(6.171601,-75.427454)"
2013,Octubre,Argentina,32,5,5,,10,"(7.128456,-73.183637)"
2013,Octubre,Argentina,32,1,5,,6,"(7.927209,-72.507910)"
2013,Octubre,República de Armenia,51,0,1,,1,"(4.697144,-74.140516)"
2013,Octubre,Aruba,533,1618,1167,,2785,"(10.408582,-75.538003)"
2013,Octubre,Aruba,533,3,1,,4,"(10.445761,-75.516429)"
2013,Octubre,Aruba,533,29,27,,56,"(10.886611,-74.776708)"
2013,Octubre,Aruba,533,73,54,,127,"(11.528919,-72.919681)"
2013,Octubre,Aruba,533,0,1,,1,"(12.586067,-81.702563)"
2013,Octubre,Aruba,533,19,27,,46,"(3.541112,-76.384584)"
2013,Octubre,Aruba,533,1226,1064,,2290,"(4.697144,-74.140516)"
2013,Octubre,Aruba,533,1,0,,1,"(4.815061,-75.736532)"
2013,Octubre,Aruba,533,59,36,,95,"(6.171601,-75.427454)"
2013,Octubre,Aruba,533,3,6,,9,"(7.128456,-73.183637)"
2013,Octubre,Australia,36,2,0,,2,"(10.445761,-75.516429)"
2013,Octubre,Australia,36,1,3,,4,"(10.886611,-74.776708)"
2013,Octubre,Australia,36,8,7,,15,"(3.541112,-76.384584)"
2013,Octubre,Australia,36,130,116,,246,"(4.697144,-74.140516)"
2013,Octubre,Australia,36,3,2,,5,"(4.815061,-75.736532)"
2013,Octubre,Australia,36,18,13,,31,"(6.171601,-75.427454)"
2013,Octubre,Australia,36,1,1,,2,"(7.128456,-73.183637)"
2013,Octubre,Austria,40,1,2,,3,"(3.541112,-76.384584)"
2013,Octubre,Austria,40,23,21,,44,"(4.697144,-74.140516)"
2013,Octubre,Austria,40,1,1,,2,"(6.171601,-75.427454)"
2013,Octubre,Azerbaiyán,31,0,1,,1,"(4.697144,-74.140516)"
2013,Octubre,Bahamas,44,1,0,,1,"(10.445761,-75.516429)"
2013,Octubre,Bahamas,44,7,5,,12,"(10.886611,-74.776708)"
2013,Octubre,Bahamas,44,19,8,,27,"(3.541112,-76.384584)"
2013,Octubre,Bahamas,44,53,49,,102,"(4.697144,-74.140516)"
2013,Octubre,Bahamas,44,0,2,,2,"(4.815061,-75.736532)"
2013,Octubre,Bahamas,44,24,26,,50,"(6.171601,-75.427454)"
2013,Octubre,Bahréin,48,1,0,,1,"(11.360009,-72.129330)"
2013,Octubre,Bahréin,48,1,1,,2,"(4.697144,-74.140516)"
2013,Octubre,Bahréin,48,0,1,,1,"(7.818934,-72.453226)"
2013,Octubre,Bangladesh,50,0,1,,1,"(4.697144,-74.140516)"
2013,Octubre,Barbados,52,2,10,,12,"(4.697144,-74.140516)"
2013,Octubre,Barbados,52,1,0,,1,"(4.815061,-75.736532)"
2013,Octubre,Barbados,52,1,2,,3,"(6.171601,-75.427454)"
2013,Octubre,República de Belarús,112,0,1,,1,"(11.360009,-72.129330)"
2013,Octubre,República de Belarús,112,2,1,,3,"(4.697144,-74.140516)"
2013,Octubre,República de Belarús,112,4,6,,10,"(7.818934,-72.453226)"
2013,Octubre,Bélgica,56,0,1,,1,"(10.886611,-74.776708)"
2013,Octubre,Bélgica,56,8,3,,11,"(3.541112,-76.384584)"
2013,Octubre,Bélgica,56,62,54,,116,"(4.697144,-74.140516)"
2013,Octubre,Bélgica,56,5,2,,7,"(6.171601,-75.427454)"
2013,Octubre,Belice,84,1,0,,1,"(3.541112,-76.384584)"
2013,Octubre,Belice,84,2,4,,6,"(4.697144,-74.140516)"
2013,Octubre,Benín,204,0,1,,1,"(4.697144,-74.140516)"
2013,Octubre,Bermudas/Territorio Británico de Ultramar,60,3,0,,3,"(4.697144,-74.140516)"
2013,Octubre,Bermudas/Territorio Británico de Ultramar,60,0,1,,1,"(6.171601,-75.427454)"
2013,Octubre,Bermudas/Territorio Británico de Ultramar,60,1,0,,1,"(7.818934,-72.453226)"
2013,Octubre,Bolivia,68,1,3,,4,"(0.814836,-77.662532)"
2013,Octubre,Bolivia,68,0,1,,1,"(10.445761,-75.516429)"
2013,Octubre,Bolivia,68,0,10,,10,"(10.886611,-74.776708)"
2013,Octubre,Bolivia,68,18,18,,36,"(3.541112,-76.384584)"
2013,Octubre,Bolivia,68,316,411,,727,"(4.697144,-74.140516)"
2013,Octubre,Bolivia,68,2,3,,5,"(4.815061,-75.736532)"
2013,Octubre,Bolivia,68,24,37,,61,"(6.171601,-75.427454)"
2013,Octubre,Bosnia y Herzegovina,70,1,0,,1,"(4.697144,-74.140516)"
2013,Octubre,Brasil,76,92,182,,274,"(-4.197703,-69.941278)"
2013,Octubre,Brasil,76,7,16,,23,"(10.445761,-75.516429)"
2013,Octubre,Brasil,76,12,96,,108,"(10.886611,-74.776708)"
2013,Octubre,Brasil,76,42,70,,112,"(3.541112,-76.384584)"
2013,Octubre,Brasil,76,3392,4251,,7643,"(4.697144,-74.140516)"
2013,Octubre,Brasil,76,4,13,,17,"(4.815061,-75.736532)"
2013,Octubre,Brasil,76,54,99,,153,"(6.171601,-75.427454)"
2013,Octubre,Brasil,76,1,6,,7,"(7.927209,-72.507910)"
2013,Octubre,Bulgaria,100,1,1,,2,"(4.697144,-74.140516)"
2013,Octubre,Bulgaria,100,1,1,,2,"(6.171601,-75.427454)"
2013,Octubre,Burkina Faso,854,1,0,,1,"(4.697144,-74.140516)"
2013,Octubre,Islas Caimán/Territorio Británico de Ultramar,136,1,0,,1,"(10.445761,-75.516429)"
2013,Octubre,Islas Caimán/Territorio Británico de Ultramar,136,2,2,,4,"(12.586067,-81.702563)"
2013,Octubre,Islas Caimán/Territorio Británico de Ultramar,136,0,1,,1,"(3.541112,-76.384584)"
2013,Octubre,Islas Caimán/Territorio Británico de Ultramar,136,1,1,,2,"(4.697144,-74.140516)"
2013,Octubre,Islas Caimán/Territorio Británico de Ultramar,136,2,0,,2,"(6.171601,-75.427454)"
2013,Octubre,Canadá,124,9,6,,15,"(10.445761,-75.516429)"
2013,Octubre,Canadá,124,7,3,,10,"(10.886611,-74.776708)"
2013,Octubre,Canadá,124,42,33,,75,"(3.541112,-76.384584)"
2013,Octubre,Canadá,124,1,1,,2,"(4.452882,-75.766298)"
2013,Octubre,Canadá,124,947,838,,1785,"(4.697144,-74.140516)"
2013,Octubre,Canadá,124,4,2,,6,"(4.815061,-75.736532)"
2013,Octubre,Canadá,124,108,87,,195,"(6.171601,-75.427454)"
2013,Octubre,Canadá,124,1,1,,2,"(7.128456,-73.183637)"
2013,Octubre,Canadá,124,0,2,,2,"(7.927209,-72.507910)"
2013,Octubre,Chad,148,0,2,,2,"(4.697144,-74.140516)"
2013,Octubre,España,724,1,2,,3,"(10.445761,-75.516429)"
2013,Octubre,España,724,0,1,,1,"(12.586067,-81.702563)"
2013,Octubre,España,724,1290,839,,2129,"(3.541112,-76.384584)"
2013,Octubre,España,724,6559,5277,,11836,"(4.697144,-74.140516)"
2013,Octubre,España,724,1,0,,1,"(4.815061,-75.736532)"
2013,Octubre,España,724,789,566,,1355,"(6.171601,-75.427454)"
2013,Octubre,República Democrática del Congo,180,1,7,,8,"(4.697144,-74.140516)"
2013,Octubre,República de Corea,410,1,1,,2,"(3.541112,-76.384584)"
2013,Octubre,República de Corea,410,44,57,,101,"(4.697144,-74.140516)"
2013,Octubre,República de Corea,410,1,1,,2,"(6.171601,-75.427454)"
2013,Octubre,Costa de Marfil,384,2,0,,2,"(3.541112,-76.384584)"
2013,Octubre,Costa de Marfil,384,1,8,,9,"(4.697144,-74.140516)"
2013,Octubre,Costa de Marfil,384,1,1,,2,"(6.171601,-75.427454)"
2013,Octubre,Costa Rica,188,4,12,,16,"(10.445761,-75.516429)"
2013,Octubre,Costa Rica,188,21,36,,57,"(10.886611,-74.776708)"
2013,Octubre,Costa Rica,188,6,58,,64,"(12.5744111,-81.703935)"
2013,Octubre,Costa Rica,188,4,4,,8,"(12.586067,-81.702563)"
2013,Octubre,Costa Rica,188,44,89,,133,"(3.541112,-76.384584)"
2013,Octubre,Costa Rica,188,725,928,,1653,"(4.697144,-74.140516)"
2013,Octubre,Costa Rica,188,2,10,,12,"(4.815061,-75.736532)"
2013,Octubre,Costa Rica,188,78,93,,171,"(6.171601,-75.427454)"
2013,Octubre,Costa Rica,188,1,0,,1,"(7.102626,-77.762647)"
2013,Octubre,Costa Rica,188,3,2,,5,"(7.128456,-73.183637)"
2013,Octubre,Costa Rica,188,1,3,,4,"(7.927209,-72.507910)"
2013,Octubre,Croacia,191,3,2,,5,"(4.697144,-74.140516)"
2013,Octubre,Cuba,192,13,12,,25,"(10.445761,-75.516429)"
2013,Octubre,Cuba,192,10,11,,21,"(10.886611,-74.776708)"
2013,Octubre,Cuba,192,4,1,,5,"(12.586067,-81.702563)"
2013,Octubre,Cuba,192,77,64,,141,"(3.541112,-76.384584)"
2013,Octubre,Cuba,192,1127,971,,2098,"(4.697144,-74.140516)"
2013,Octubre,Cuba,192,15,10,,25,"(4.815061,-75.736532)"
2013,Octubre,Cuba,192,162,114,,276,"(6.171601,-75.427454)"
2013,Octubre,Cuba,192,3,1,,4,"(7.128456,-73.183637)"
2013,Octubre,Cuba,192,1,1,,2,"(7.927209,-72.507910)"
2013,Octubre,Curazao,99999,0,7,,7,"(10.408582,-75.538003)"
2013,Octubre,Curazao,99999,0,1,,1,"(10.886611,-74.776708)"
2013,Octubre,Curazao,99999,0,6,,6,"(11.247723,-74.213989)"
2013,Octubre,Curazao,99999,4,2,,6,"(3.541112,-76.384584)"
2013,Octubre,Curazao,99999,331,458,,789,"(4.697144,-74.140516)"
2013,Octubre,Curazao,99999,100,63,,163,"(6.171601,-75.427454)"
2013,Octubre,República Checa,203,1,6,,7,"(4.697144,-74.140516)"
2013,Octubre,Chile,152,29,14,,43,"(0.814836,-77.662532)"
2013,Octubre,Chile,152,10,13,,23,"(10.445761,-75.516429)"
2013,Octubre,Chile,152,29,21,,50,"(10.886611,-74.776708)"
2013,Octubre,Chile,152,2,1,,3,"(12.586067,-81.702563)"
2013,Octubre,Chile,152,543,421,,964,"(3.541112,-76.384584)"
2013,Octubre,Chile,152,2601,2532,,5133,"(4.697144,-74.140516)"
2013,Octubre,Chile,152,17,14,,31,"(4.815061,-75.736532)"
2013,Octubre,Chile,152,188,184,,372,"(6.171601,-75.427454)"
2013,Octubre,Chile,152,3,2,,5,"(7.927209,-72.507910)"
2013,Octubre,China,156,4,1,,5,"(10.445761,-75.516429)"
2013,Octubre,China,156,3,9,,12,"(10.886611,-74.776708)"
2013,Octubre,China,156,10,13,,23,"(3.541112,-76.384584)"
2013,Octubre,China,156,283,560,,843,"(4.697144,-74.140516)"
2013,Octubre,China,156,0,4,,4,"(4.815061,-75.736532)"
2013,Octubre,China,156,21,54,,75,"(6.171601,-75.427454)"
2013,Octubre,China,156,2,4,,6,"(7.128456,-73.183637)"
2013,Octubre,Chipre,196,2,1,,3,"(4.697144,-74.140516)"
2013,Octubre,Dinamarca,208,1,1,,2,"(3.541112,-76.384584)"
2013,Octubre,Dinamarca,208,10,12,,22,"(4.697144,-74.140516)"
2013,Octubre,Dominica,212,1,0,,1,"(4.697144,-74.140516)"
2013,Octubre,Ecuador,218,559,612,,1171,"(0.25129,-76.875963)"
2013,Octubre,Ecuador,218,6596,7190,,13786,"(0.814836,-77.662532)"
2013,Octubre,Ecuador,218,97,104,,201,"(1.813928,-78.763924)"
2013,Octubre,Ecuador,218,1,6,,7,"(10.445761,-75.516429)"
2013,Octubre,Ecuador,218,2,9,,11,"(10.886611,-74.776708)"
2013,Octubre,Ecuador,218,702,835,,1537,"(3.541112,-76.384584)"
2013,Octubre,Ecuador,218,2325,4067,,6392,"(4.697144,-74.140516)"
2013,Octubre,Ecuador,218,4,1,,5,"(4.815061,-75.736532)"
2013,Octubre,Ecuador,218,369,361,,730,"(6.171601,-75.427454)"
2013,Octubre,Ecuador,218,0,1,,1,"(7.128456,-73.183637)"
2013,Octubre,Egipto,818,39,30,,69,"(4.697144,-74.140516)"
2013,Octubre,El Salvador,222,6,4,,10,"(10.445761,-75.516429)"
2013,Octubre,El Salvador,222,1,1,,2,"(10.886611,-74.776708)"
2013,Octubre,El Salvador,222,81,86,,167,"(3.541112,-76.384584)"
2013,Octubre,El Salvador,222,958,1091,,2049,"(4.697144,-74.140516)"
2013,Octubre,El Salvador,222,1,0,,1,"(4.815061,-75.736532)"
2013,Octubre,El Salvador,222,159,148,,307,"(6.171601,-75.427454)"
2013,Octubre,Emiratos Árabes,784,0,1,,1,"(3.541112,-76.384584)"
2013,Octubre,Emiratos Árabes,784,106,178,,284,"(4.697144,-74.140516)"
2013,Octubre,Emiratos Árabes,784,1,2,,3,"(6.171601,-75.427454)"
2013,Octubre,Eritrea,232,0,3,,3,"(4.697144,-74.140516)"
2013,Octubre,Eslovaquia,703,0,1,,1,"(4.697144,-74.140516)"
2013,Octubre,Eslovenia,705,2,1,,3,"(4.697144,-74.140516)"
2013,Octubre,Estados Unidos de América,840,1,1,,2,"(10.408582,-75.538003)"
2013,Octubre,Estados Unidos de América,840,2148,1836,,3984,"(10.445761,-75.516429)"
2013,Octubre,Estados Unidos de América,840,1964,1727,,3691,"(10.886611,-74.776708)"
2013,Octubre,Estados Unidos de América,840,20,12,,32,"(12.586067,-81.702563)"
2013,Octubre,Estados Unidos de América,840,4555,3526,,8081,"(3.541112,-76.384584)"
2013,Octubre,Estados Unidos de América,840,577,455,,1032,"(4.452882,-75.766298)"
2013,Octubre,Estados Unidos de América,840,31675,28933,,60608,"(4.697144,-74.140516)"
2013,Octubre,Estados Unidos de América,840,439,320,,759,"(4.815061,-75.736532)"
2013,Octubre,Estados Unidos de América,840,8139,6900,,15039,"(6.171601,-75.427454)"
2013,Octubre,Estados Unidos de América,840,60,60,,120,"(7.128456,-73.183637)"
2013,Octubre,Estados Unidos de América,840,182,130,,312,"(7.927209,-72.507910)"
2013,Octubre,Estonia,233,1,0,,1,"(3.541112,-76.384584)"
2013,Octubre,Estonia,233,2,0,,2,"(4.697144,-74.140516)"
2013,Octubre,Etiopia,231,0,1,,1,"(3.541112,-76.384584)"
2013,Octubre,Etiopia,231,0,5,,5,"(4.697144,-74.140516)"
2013,Octubre,Filipinas,608,2,0,,2,"(10.445761,-75.516429)"
2013,Octubre,Filipinas,608,1,4,,5,"(4.697144,-74.140516)"
2013,Octubre,Finlandia,246,1,0,,1,"(3.541112,-76.384584)"
2013,Octubre,Finlandia,246,6,2,,8,"(4.697144,-74.140516)"
2013,Octubre,Finlandia,246,1,0,,1,"(6.171601,-75.427454)"
2013,Octubre,Francia,250,1,0,,1,"(10.445761,-75.516429)"
2013,Octubre,Francia,250,24,20,,44,"(3.541112,-76.384584)"
2013,Octubre,Francia,250,1128,1065,,2193,"(4.697144,-74.140516)"
2013,Octubre,Francia,250,22,16,,38,"(6.171601,-75.427454)"
2013,Octubre,Francia,250,0,1,,1,"(7.128456,-73.183637)"
2013,Octubre,Gabón,266,0,7,,7,"(4.697144,-74.140516)"
2013,Octubre,Ghana,288,3,1,,4,"(4.697144,-74.140516)"
2013,Octubre,Gibraltar/Territorio Británico de Ultramar,292,1,0,,1,"(0.814836,-77.662532)"
2013,Octubre,Gibraltar/Territorio Británico de Ultramar,292,0,1,,1,"(4.697144,-74.140516)"
2013,Octubre,Grecia,300,18,10,,28,"(4.697144,-74.140516)"
2013,Octubre,Guatemala,320,6,7,,13,"(10.445761,-75.516429)"
2013,Octubre,Guatemala,320,6,11,,17,"(10.886611,-74.776708)"
2013,Octubre,Guatemala,320,0,6,,6,"(12.586067,-81.702563)"
2013,Octubre,Guatemala,320,75,72,,147,"(3.541112,-76.384584)"
2013,Octubre,Guatemala,320,171,320,,491,"(4.697144,-74.140516)"
2013,Octubre,Guatemala,320,5,6,,11,"(4.815061,-75.736532)"
2013,Octubre,Guatemala,320,71,80,,151,"(6.171601,-75.427454)"
2013,Octubre,Guatemala,320,1,1,,2,"(7.128456,-73.183637)"
2013,Octubre,Guatemala,320,1,2,,3,"(7.927209,-72.507910)"
2013,Octubre,Guyana,328,1,3,,4,"(10.886611,-74.776708)"
2013,Octubre,Guyana,328,1,4,,5,"(4.697144,-74.140516)"
2013,Octubre,Guinea,324,0,4,,4,"(4.697144,-74.140516)"
2013,Octubre,Guinea Ecuatorial,226,0,8,,8,"(4.697144,-74.140516)"
2013,Octubre,Guadalupe/Territorio Francés,312,0,1,,1,"(3.541112,-76.384584)"
2013,Octubre,Guadalupe/Territorio Francés,312,1,1,,2,"(4.697144,-74.140516)"
2013,Octubre,Guadalupe/Territorio Francés,312,0,1,,1,"(6.171601,-75.427454)"
2013,Octubre,Guayana Francesa/Departamento de Ultramar Francés,254,2,0,,2,"(6.171601,-75.427454)"
2013,Octubre,Haití,332,0,1,,1,"(10.886611,-74.776708)"
2013,Octubre,Haití,332,1,1,,2,"(3.541112,-76.384584)"
2013,Octubre,Haití,332,6,6,,12,"(4.697144,-74.140516)"
2013,Octubre,Haití,332,2,6,,8,"(6.171601,-75.427454)"
2013,Octubre,Honduras,340,2,6,,8,"(10.445761,-75.516429)"
2013,Octubre,Honduras,340,4,9,,13,"(10.886611,-74.776708)"
2013,Octubre,Honduras,340,0,4,,4,"(12.586067,-81.702563)"
2013,Octubre,Honduras,340,16,21,,37,"(3.541112,-76.384584)"
2013,Octubre,Honduras,340,44,106,,150,"(4.697144,-74.140516)"
2013,Octubre,Honduras,340,1,4,,5,"(4.815061,-75.736532)"
2013,Octubre,Honduras,340,27,48,,75,"(6.171601,-75.427454)"
2013,Octubre,Honduras,340,0,2,,2,"(7.128456,-73.183637)"
2013,Octubre,Hong Kong,344,3,0,,3,"(3.541112,-76.384584)"
2013,Octubre,Hong Kong,344,48,98,,146,"(4.697144,-74.140516)"
2013,Octubre,Hong Kong,344,3,3,,6,"(6.171601,-75.427454)"
2013,Octubre,Hungría,348,2,3,,5,"(4.697144,-74.140516)"
2013,Octubre,India,356,0,2,,2,"(3.541112,-76.384584)"
2013,Octubre,India,356,56,38,,94,"(4.697144,-74.140516)"
2013,Octubre,India,356,4,2,,6,"(6.171601,-75.427454)"
2013,Octubre,Indonesia,360,5,13,,18,"(4.697144,-74.140516)"
2013,Octubre,Indonesia,360,2,1,,3,"(6.171601,-75.427454)"
2013,Octubre,Iraq,368,0,11,,11,"(4.697144,-74.140516)"
2013,Octubre,Irán,364,2,6,,8,"(4.697144,-74.140516)"
2013,Octubre,República de Irlanda,372,0,1,,1,"(10.445761,-75.516429)"
2013,Octubre,República de Irlanda,372,1,0,,1,"(3.541112,-76.384584)"
2013,Octubre,República de Irlanda,372,8,9,,17,"(4.697144,-74.140516)"
2013,Octubre,Israel,376,2,0,,2,"(10.445761,-75.516429)"
2013,Octubre,Israel,376,1,4,,5,"(3.541112,-76.384584)"
2013,Octubre,Israel,376,268,202,,470,"(4.697144,-74.140516)"
2013,Octubre,Israel,376,4,3,,7,"(6.171601,-75.427454)"
2013,Octubre,Islas Aland/Provincia de Finlandia,248,1,0,,1,"(4.697144,-74.140516)"
2013,Octubre,Italia,380,3,1,,4,"(10.445761,-75.516429)"
2013,Octubre,Italia,380,70,27,,97,"(3.541112,-76.384584)"
2013,Octubre,Italia,380,512,436,,948,"(4.697144,-74.140516)"
2013,Octubre,Italia,380,28,10,,38,"(6.171601,-75.427454)"
2013,Octubre,Jamaica,388,2,7,,9,"(10.445761,-75.516429)"
2013,Octubre,Jamaica,388,2,6,,8,"(10.886611,-74.776708)"
2013,Octubre,Jamaica,388,2,10,,12,"(3.541112,-76.384584)"
2013,Octubre,Jamaica,388,37,37,,74,"(4.697144,-74.140516)"
2013,Octubre,Jamaica,388,5,4,,9,"(4.815061,-75.736532)"
2013,Octubre,Jamaica,388,12,12,,24,"(6.171601,-75.427454)"
2013,Octubre,Japón,392,0,1,,1,"(3.541112,-76.384584)"
2013,Octubre,Japón,392,76,74,,150,"(4.697144,-74.140516)"
2013,Octubre,Japón,392,2,0,,2,"(6.171601,-75.427454)"
2013,Octubre,Jordania,400,39,31,,70,"(4.697144,-74.140516)"
2013,Octubre,Kazajistán,398,1,3,,4,"(4.697144,-74.140516)"
2013,Octubre,Kenia,404,2,5,,7,"(4.697144,-74.140516)"
2013,Octubre,Kenia,404,1,2,,3,"(6.171601,-75.427454)"
2013,Octubre,Kuwait,414,0,5,,5,"(4.697144,-74.140516)"
2013,Octubre,Letonia,428,0,1,,1,"(4.697144,-74.140516)"
2013,Octubre,Lituania,440,0,1,,1,"(4.697144,-74.140516)"
2013,Octubre,Líbano,422,6,12,,18,"(4.697144,-74.140516)"
2013,Octubre,Liberia,430,0,1,,1,"(4.697144,-74.140516)"
2013,Octubre,Luxemburgo,442,2,0,,2,"(4.697144,-74.140516)"
2013,Octubre,Luxemburgo,442,1,0,,1,"(6.171601,-75.427454)"
2013,Octubre,Malasia,458,5,9,,14,"(4.697144,-74.140516)"
2013,Octubre,Malasia,458,0,1,,1,"(6.171601,-75.427454)"
2013,Octubre,Malta,470,4,1,,5,"(4.697144,-74.140516)"
2013,Octubre,Marruecos,504,0,1,,1,"(3.541112,-76.384584)"
2013,Octubre,Marruecos,504,7,8,,15,"(4.697144,-74.140516)"
2013,Octubre,Mauricio,480,0,1,,1,"(4.697144,-74.140516)"
2013,Octubre,México,484,0,1,,1,"(0.814836,-77.662532)"
2013,Octubre,México,484,71,54,,125,"(10.445761,-75.516429)"
2013,Octubre,México,484,116,117,,233,"(10.886611,-74.776708)"
2013,Octubre,México,484,640,472,,1112,"(3.541112,-76.384584)"
2013,Octubre,México,484,10018,8929,,18947,"(4.697144,-74.140516)"
2013,Octubre,México,484,147,102,,249,"(4.815061,-75.736532)"
2013,Octubre,México,484,1439,1151,,2590,"(6.171601,-75.427454)"
2013,Octubre,México,484,31,20,,51,"(7.128456,-73.183637)"
2013,Octubre,México,484,192,136,,328,"(7.927209,-72.507910)"
2013,Octubre,Mónaco,492,1,1,,2,"(4.697144,-74.140516)"
2013,Octubre,Mozambique,508,1,2,,3,"(4.697144,-74.140516)"
2013,Octubre,Nauru,520,1,0,,1,"(4.697144,-74.140516)"
2013,Octubre,Nicaragua,558,4,2,,6,"(10.445761,-75.516429)"
2013,Octubre,Nicaragua,558,2,5,,7,"(10.886611,-74.776708)"
2013,Octubre,Nicaragua,558,11,14,,25,"(3.541112,-76.384584)"
2013,Octubre,Nicaragua,558,14,37,,51,"(4.697144,-74.140516)"
2013,Octubre,Nicaragua,558,12,35,,47,"(6.171601,-75.427454)"
2013,Octubre,Nicaragua,558,0,1,,1,"(7.927209,-72.507910)"
2013,Octubre,Nigeria,566,2,9,,11,"(4.697144,-74.140516)"
2013,Octubre,Níger,562,0,2,,2,"(4.697144,-74.140516)"
2013,Octubre,Noruega,578,1,1,,2,"(3.541112,-76.384584)"
2013,Octubre,Noruega,578,12,15,,27,"(4.697144,-74.140516)"
2013,Octubre,Noruega,578,0,1,,1,"(6.171601,-75.427454)"
2013,Octubre,Nueva Zelanda,554,29,45,,74,"(4.697144,-74.140516)"
2013,Octubre,Nueva Zelanda,554,1,1,,2,"(6.171601,-75.427454)"
2013,Octubre,Omán,512,0,4,,4,"(4.697144,-74.140516)"
2013,Octubre,Papúa Nueva Guinea,598,0,8,,8,"(4.697144,-74.140516)"
2013,Octubre,Papúa Nueva Guinea,598,0,1,,1,"(6.171601,-75.427454)"
2013,Octubre,Pakistán,586,2,2,,4,"(4.697144,-74.140516)"
2013,Octubre,Palau,585,0,1,,1,"(7.102626,-77.762647)"
2013,Octubre,Panamá,591,184,150,,334,"(10.408582,-75.538003)"
2013,Octubre,Panamá,591,343,393,,736,"(10.445761,-75.516429)"
2013,Octubre,Panamá,591,921,950,,1871,"(10.886611,-74.776708)"
2013,Octubre,Panamá,591,0,8,,8,"(10.971302,-74.765397)"
2013,Octubre,Panamá,591,4,29,,33,"(12.5744111,-81.703935)"
2013,Octubre,Panamá,591,88,65,,153,"(12.586067,-81.702563)"
2013,Octubre,Panamá,591,1852,1701,,3553,"(3.541112,-76.384584)"
2013,Octubre,Panamá,591,0,1,,1,"(3.893038,-77.067921)"
2013,Octubre,Panamá,591,7336,7973,,15309,"(4.697144,-74.140516)"
2013,Octubre,Panamá,591,996,826,,1822,"(4.815061,-75.736532)"
2013,Octubre,Panamá,591,2438,2324,,4762,"(6.171601,-75.427454)"
2013,Octubre,Panamá,591,11,18,,29,"(7.102626,-77.762647)"
2013,Octubre,Panamá,591,517,498,,1015,"(7.128456,-73.183637)"
2013,Octubre,Panamá,591,219,239,,458,"(7.927209,-72.507910)"
2013,Octubre,Panamá,591,4,113,,117,"(8.066966,-76.735404)"
2013,Octubre,Panamá,591,13,17,,30,"(8.635765,-77.346578)"
2013,Octubre,Paraguay,600,0,1,,1,"(0.814836,-77.662532)"
2013,Octubre,Paraguay,600,5,5,,10,"(10.445761,-75.516429)"
2013,Octubre,Paraguay,600,7,64,,71,"(10.886611,-74.776708)"
2013,Octubre,Paraguay,600,8,24,,32,"(3.541112,-76.384584)"
2013,Octubre,Paraguay,600,76,189,,265,"(4.697144,-74.140516)"
2013,Octubre,Paraguay,600,1,0,,1,"(4.815061,-75.736532)"
2013,Octubre,Paraguay,600,14,59,,73,"(6.171601,-75.427454)"
2013,Octubre,Paraguay,600,0,1,,1,"(7.927209,-72.507910)"
2013,Octubre,Perú,604,40,106,,146,"(-4.197703,-69.941278)"
2013,Octubre,Perú,604,23,31,,54,"(0.814836,-77.662532)"
2013,Octubre,Perú,604,3,10,,13,"(10.445761,-75.516429)"
2013,Octubre,Perú,604,23,38,,61,"(10.886611,-74.776708)"
2013,Octubre,Perú,604,1,3,,4,"(12.586067,-81.702563)"
2013,Octubre,Perú,604,244,294,,538,"(3.541112,-76.384584)"
2013,Octubre,Perú,604,3494,4227,,7721,"(4.697144,-74.140516)"
2013,Octubre,Perú,604,7,7,,14,"(4.815061,-75.736532)"
2013,Octubre,Perú,604,405,494,,899,"(6.171601,-75.427454)"
2013,Octubre,Perú,604,3,4,,7,"(7.128456,-73.183637)"
2013,Octubre,Perú,604,2,2,,4,"(7.927209,-72.507910)"
2013,Octubre,Palestina,99999,1,1,,2,"(4.697144,-74.140516)"
2013,Octubre,Polonia,616,12,22,,34,"(4.697144,-74.140516)"
2013,Octubre,Portugal,620,3,2,,5,"(3.541112,-76.384584)"
2013,Octubre,Portugal,620,77,72,,149,"(4.697144,-74.140516)"
2013,Octubre,Portugal,620,0,3,,3,"(6.171601,-75.427454)"
2013,Octubre,Puerto Rico/Territorio de Estados Unidos,630,5,6,,11,"(10.445761,-75.516429)"
2013,Octubre,Puerto Rico/Territorio de Estados Unidos,630,21,16,,37,"(10.886611,-74.776708)"
2013,Octubre,Puerto Rico/Territorio de Estados Unidos,630,2,0,,2,"(12.586067,-81.702563)"
2013,Octubre,Puerto Rico/Territorio de Estados Unidos,630,56,47,,103,"(3.541112,-76.384584)"
2013,Octubre,Puerto Rico/Territorio de Estados Unidos,630,380,378,,758,"(4.697144,-74.140516)"
2013,Octubre,Puerto Rico/Territorio de Estados Unidos,630,9,8,,17,"(4.815061,-75.736532)"
2013,Octubre,Puerto Rico/Territorio de Estados Unidos,630,47,44,,91,"(6.171601,-75.427454)"
2013,Octubre,Qatar,634,3,6,,9,"(4.697144,-74.140516)"
2013,Octubre,Reino Unido de Gran Bretaña e Irlanda del Norte,826,0,3,,3,"(10.445761,-75.516429)"
2013,Octubre,Reino Unido de Gran Bretaña e Irlanda del Norte,826,33,23,,56,"(3.541112,-76.384584)"
2013,Octubre,Reino Unido de Gran Bretaña e Irlanda del Norte,826,515,448,,963,"(4.697144,-74.140516)"
2013,Octubre,Reino Unido de Gran Bretaña e Irlanda del Norte,826,30,15,,45,"(6.171601,-75.427454)"
2013,Octubre,República CentroÁfricana,140,1,5,,6,"(4.697144,-74.140516)"
2013,Octubre,Macedonia,807,1,0,,1,"(4.697144,-74.140516)"
2013,Octubre,Federación de Rusia,643,39,66,,105,"(4.697144,-74.140516)"
2013,Octubre,Federación de Rusia,643,0,4,,4,"(6.171601,-75.427454)"
2013,Octubre,República Dominicana,214,7,32,,39,"(10.445761,-75.516429)"
2013,Octubre,República Dominicana,214,41,25,,66,"(10.886611,-74.776708)"
2013,Octubre,República Dominicana,214,0,2,,2,"(12.586067,-81.702563)"
2013,Octubre,República Dominicana,214,66,63,,129,"(3.541112,-76.384584)"
2013,Octubre,República Dominicana,214,1602,1571,,3173,"(4.697144,-74.140516)"
2013,Octubre,República Dominicana,214,22,12,,34,"(4.815061,-75.736532)"
2013,Octubre,República Dominicana,214,113,116,,229,"(6.171601,-75.427454)"
2013,Octubre,República Dominicana,214,11,4,,15,"(7.128456,-73.183637)"
2013,Octubre,República Dominicana,214,0,2,,2,"(7.927209,-72.507910)"
2013,Octubre,Reunión,638,1,1,,2,"(4.697144,-74.140516)"
2013,Octubre,República Democrática Popular de Corea,408,0,1,,1,"(4.697144,-74.140516)"
2013,Octubre,Rumania,642,2,3,,5,"(4.697144,-74.140516)"
2013,Octubre,Santa Elena/Territorio Británico de Ultramar,654,0,1,,1,"(4.697144,-74.140516)"
2013,Octubre,Senegal,686,0,1,,1,"(6.171601,-75.427454)"
2013,Octubre,Singapur,702,18,28,,46,"(4.697144,-74.140516)"
2013,Octubre,Singapur,702,0,1,,1,"(6.171601,-75.427454)"
2013,Octubre,Sri Lanka,144,1,0,,1,"(4.697144,-74.140516)"
2013,Octubre,Sudáfrica,710,0,1,,1,"(3.541112,-76.384584)"
2013,Octubre,Sudáfrica,710,22,28,,50,"(4.697144,-74.140516)"
2013,Octubre,Suecia,752,2,0,,2,"(3.541112,-76.384584)"
2013,Octubre,Suecia,752,39,34,,73,"(4.697144,-74.140516)"
2013,Octubre,Suecia,752,4,4,,8,"(6.171601,-75.427454)"
2013,Octubre,Suiza,756,0,1,,1,"(10.445761,-75.516429)"
2013,Octubre,Suiza,756,1,0,,1,"(10.886611,-74.776708)"
2013,Octubre,Suiza,756,1,1,,2,"(12.586067,-81.702563)"
2013,Octubre,Suiza,756,20,17,,37,"(3.541112,-76.384584)"
2013,Octubre,Suiza,756,178,112,,290,"(4.697144,-74.140516)"
2013,Octubre,Suiza,756,7,2,,9,"(6.171601,-75.427454)"
2013,Octubre,Surinam,740,4,9,,13,"(4.697144,-74.140516)"
2013,Octubre,Surinam,740,7,0,,7,"(6.171601,-75.427454)"
2013,Octubre,Taiwán,158,1,9,,10,"(4.697144,-74.140516)"
2013,Octubre,Tailandia,764,31,31,,62,"(4.697144,-74.140516)"
2013,Octubre,Tanzania,834,0,2,,2,"(4.697144,-74.140516)"
2013,Octubre,Tanzania,834,0,1,,1,"(6.171601,-75.427454)"
2013,Octubre,Trinidad y Tobago,780,1,2,,3,"(10.445761,-75.516429)"
2013,Octubre,Trinidad y Tobago,780,0,1,,1,"(10.886611,-74.776708)"
2013,Octubre,Trinidad y Tobago,780,13,21,,34,"(3.541112,-76.384584)"
2013,Octubre,Trinidad y Tobago,780,24,47,,71,"(4.697144,-74.140516)"
2013,Octubre,Trinidad y Tobago,780,1,0,,1,"(4.815061,-75.736532)"
2013,Octubre,Trinidad y Tobago,780,8,9,,17,"(6.171601,-75.427454)"
2013,Octubre,Trinidad y Tobago,780,1,1,,2,"(7.128456,-73.183637)"
2013,Octubre,Trinidad y Tobago,780,0,1,,1,"(7.927209,-72.507910)"
2013,Octubre,Túnez,788,2,0,,2,"(4.697144,-74.140516)"
2013,Octubre,Turquía,792,0,2,,2,"(3.541112,-76.384584)"
2013,Octubre,Turquía,792,148,74,,222,"(4.697144,-74.140516)"
2013,Octubre,Turquía,792,1,2,,3,"(6.171601,-75.427454)"
2013,Octubre,Tuvalu,798,1,0,,1,"(4.697144,-74.140516)"
2013,Octubre,Ucrania,804,3,10,,13,"(4.697144,-74.140516)"
2013,Octubre,Uganda,800,0,3,,3,"(4.697144,-74.140516)"
2013,Octubre,Uruguay,858,1,0,,1,"(0.814836,-77.662532)"
2013,Octubre,Uruguay,858,2,2,,4,"(10.886611,-74.776708)"
2013,Octubre,Uruguay,858,11,13,,24,"(3.541112,-76.384584)"
2013,Octubre,Uruguay,858,89,84,,173,"(4.697144,-74.140516)"
2013,Octubre,Uruguay,858,1,0,,1,"(4.815061,-75.736532)"
2013,Octubre,Uruguay,858,12,13,,25,"(6.171601,-75.427454)"
2013,Octubre,Uruguay,858,1,0,,1,"(7.128456,-73.183637)"
2013,Octubre,Vanuatu,548,0,1,,1,"(7.818934,-72.453226)"
2013,Octubre,Venezuela,862,8,9,,17,"(10.445761,-75.516429)"
2013,Octubre,Venezuela,862,8,25,,33,"(10.886611,-74.776708)"
2013,Octubre,Venezuela,862,14476,12161,,26637,"(11.360009,-72.129330)"
2013,Octubre,Venezuela,862,9,13,,22,"(3.541112,-76.384584)"
2013,Octubre,Venezuela,862,1586,1977,,3563,"(4.697144,-74.140516)"
2013,Octubre,Venezuela,862,2,0,,2,"(4.815061,-75.736532)"
2013,Octubre,Venezuela,862,163,174,,337,"(6.171601,-75.427454)"
2013,Octubre,Venezuela,862,439,525,,964,"(6.185799,-67.483929)"
2013,Octubre,Venezuela,862,2469,2166,,4635,"(7.088729,-70.740253)"
2013,Octubre,Venezuela,862,1,5,,6,"(7.128456,-73.183637)"
2013,Octubre,Venezuela,862,9604,8891,,18495,"(7.818934,-72.453226)"
2013,Octubre,Vietnam,704,1,2,,3,"(4.697144,-74.140516)"
2013,Octubre,Desconocido,99999,1,0,,1,"(3.541112,-76.384584)"
2013,Octubre,Desconocido,99999,0,1,,1,"(4.697144,-74.140516)"
2013,Noviembre,Afganistán,4,0,2,,2,"(10.886611,-74.776708)"
2013,Noviembre,Afganistán,4,2,32,,34,"(4.697144,-74.140516)"
2013,Noviembre,Albania,8,0,1,,1,"(4.697144,-74.140516)"
2013,Noviembre,Alemania,276,1,0,,1,"(10.445761,-75.516429)"
2013,Noviembre,Alemania,276,0,1,,1,"(10.886611,-74.776708)"
2013,Noviembre,Alemania,276,11,7,,18,"(3.541112,-76.384584)"
2013,Noviembre,Alemania,276,750,967,,1717,"(4.697144,-74.140516)"
2013,Noviembre,Alemania,276,8,10,,18,"(6.171601,-75.427454)"
2013,Noviembre,Andorra,20,1,0,,1,"(3.541112,-76.384584)"
2013,Noviembre,Angola,24,0,1,,1,"(3.541112,-76.384584)"
2013,Noviembre,Angola,24,1,13,,14,"(4.697144,-74.140516)"
2013,Noviembre,Antigua y Barbuda,28,0,2,,2,"(4.697144,-74.140516)"
2013,Noviembre,Países Bajos,528,3,1,,4,"(10.445761,-75.516429)"
2013,Noviembre,Países Bajos,528,1,1,,2,"(10.886611,-74.776708)"
2013,Noviembre,Países Bajos,528,20,20,,40,"(3.541112,-76.384584)"
2013,Noviembre,Países Bajos,528,103,118,,221,"(4.697144,-74.140516)"
2013,Noviembre,Países Bajos,528,3,3,,6,"(4.815061,-75.736532)"
2013,Noviembre,Países Bajos,528,62,36,,98,"(6.171601,-75.427454)"
2013,Noviembre,Arabia Saudita,682,0,1,,1,"(3.541112,-76.384584)"
2013,Noviembre,Arabia Saudita,682,8,28,,36,"(4.697144,-74.140516)"
2013,Noviembre,Argelia,12,4,9,,13,"(4.697144,-74.140516)"
2013,Noviembre,Argentina,32,1,0,,1,"(0.25129,-76.875963)"
2013,Noviembre,Argentina,32,13,12,,25,"(0.814836,-77.662532)"
2013,Noviembre,Argentina,32,33,32,,65,"(10.445761,-75.516429)"
2013,Noviembre,Argentina,32,26,22,,48,"(10.886611,-74.776708)"
2013,Noviembre,Argentina,32,0,1,,1,"(12.586067,-81.702563)"
2013,Noviembre,Argentina,32,177,161,,338,"(3.541112,-76.384584)"
2013,Noviembre,Argentina,32,2900,3017,,5917,"(4.697144,-74.140516)"
2013,Noviembre,Argentina,32,15,8,,23,"(4.815061,-75.736532)"
2013,Noviembre,Argentina,32,233,245,,478,"(6.171601,-75.427454)"
2013,Noviembre,Argentina,32,2,8,,10,"(7.128456,-73.183637)"
2013,Noviembre,Argentina,32,3,3,,6,"(7.927209,-72.507910)"
2013,Noviembre,República de Armenia,51,0,1,,1,"(4.697144,-74.140516)"
2013,Noviembre,Aruba,533,2289,1657,,3946,"(10.408582,-75.538003)"
2013,Noviembre,Aruba,533,1,1,,2,"(10.445761,-75.516429)"
2013,Noviembre,Aruba,533,7,4,,11,"(10.886611,-74.776708)"
2013,Noviembre,Aruba,533,66,40,,106,"(11.528919,-72.919681)"
2013,Noviembre,Aruba,533,9,12,,21,"(3.541112,-76.384584)"
2013,Noviembre,Aruba,533,1155,901,,2056,"(4.697144,-74.140516)"
2013,Noviembre,Aruba,533,1,1,,2,"(4.815061,-75.736532)"
2013,Noviembre,Aruba,533,49,39,,88,"(6.171601,-75.427454)"
2013,Noviembre,Aruba,533,5,2,,7,"(7.128456,-73.183637)"
2013,Noviembre,Aruba,533,0,1,,1,"(7.927209,-72.507910)"
2013,Noviembre,Australia,36,1,2,,3,"(10.445761,-75.516429)"
2013,Noviembre,Australia,36,1,0,,1,"(10.886611,-74.776708)"
2013,Noviembre,Australia,36,10,9,,19,"(3.541112,-76.384584)"
2013,Noviembre,Australia,36,203,158,,361,"(4.697144,-74.140516)"
2013,Noviembre,Australia,36,2,0,,2,"(4.815061,-75.736532)"
2013,Noviembre,Australia,36,29,17,,46,"(6.171601,-75.427454)"
2013,Noviembre,Australia,36,1,0,,1,"(7.128456,-73.183637)"
2013,Noviembre,Austria,40,14,18,,32,"(4.697144,-74.140516)"
2013,Noviembre,Austria,40,0,1,,1,"(6.171601,-75.427454)"
2013,Noviembre,Azerbaiyán,31,1,0,,1,"(10.445761,-75.516429)"
2013,Noviembre,Bahamas,44,1,0,,1,"(10.445761,-75.516429)"
2013,Noviembre,Bahamas,44,7,4,,11,"(10.886611,-74.776708)"
2013,Noviembre,Bahamas,44,5,4,,9,"(3.541112,-76.384584)"
2013,Noviembre,Bahamas,44,10,12,,22,"(4.697144,-74.140516)"
2013,Noviembre,Bahamas,44,2,0,,2,"(4.815061,-75.736532)"
2013,Noviembre,Bahamas,44,31,39,,70,"(6.171601,-75.427454)"
2013,Noviembre,Bahréin,48,4,2,,6,"(4.697144,-74.140516)"
2013,Noviembre,Bahréin,48,0,1,,1,"(6.171601,-75.427454)"
2013,Noviembre,Barbados,52,0,11,,11,"(11.247723,-74.213989)"
2013,Noviembre,Barbados,52,1,0,,1,"(3.541112,-76.384584)"
2013,Noviembre,Barbados,52,0,19,,19,"(4.697144,-74.140516)"
2013,Noviembre,República de Belarús,112,18,15,,33,"(7.818934,-72.453226)"
2013,Noviembre,Bélgica,56,7,3,,10,"(3.541112,-76.384584)"
2013,Noviembre,Bélgica,56,51,59,,110,"(4.697144,-74.140516)"
2013,Noviembre,Bélgica,56,9,6,,15,"(6.171601,-75.427454)"
2013,Noviembre,Belice,84,1,2,,3,"(4.697144,-74.140516)"
2013,Noviembre,Benín,204,0,4,,4,"(4.697144,-74.140516)"
2013,Noviembre,Bermudas/Territorio Británico de Ultramar,60,1,0,,1,"(4.697144,-74.140516)"
2013,Noviembre,Bermudas/Territorio Británico de Ultramar,60,0,4,,4,"(6.171601,-75.427454)"
2013,Noviembre,Bolivia,68,0,3,,3,"(0.814836,-77.662532)"
2013,Noviembre,Bolivia,68,3,5,,8,"(10.886611,-74.776708)"
2013,Noviembre,Bolivia,68,20,31,,51,"(3.541112,-76.384584)"
2013,Noviembre,Bolivia,68,286,404,,690,"(4.697144,-74.140516)"
2013,Noviembre,Bolivia,68,1,3,,4,"(4.815061,-75.736532)"
2013,Noviembre,Bolivia,68,17,25,,42,"(6.171601,-75.427454)"
2013,Noviembre,Brasil,76,134,171,,305,"(-4.197703,-69.941278)"
2013,Noviembre,Brasil,76,0,1,,1,"(0.814836,-77.662532)"
2013,Noviembre,Brasil,76,6,4,,10,"(10.445761,-75.516429)"
2013,Noviembre,Brasil,76,4,14,,18,"(10.886611,-74.776708)"
2013,Noviembre,Brasil,76,65,96,,161,"(3.541112,-76.384584)"
2013,Noviembre,Brasil,76,3055,4045,,7100,"(4.697144,-74.140516)"
2013,Noviembre,Brasil,76,4,11,,15,"(4.815061,-75.736532)"
2013,Noviembre,Brasil,76,66,139,,205,"(6.171601,-75.427454)"
2013,Noviembre,Brasil,76,3,2,,5,"(7.128456,-73.183637)"
2013,Noviembre,Brasil,76,1,0,,1,"(7.927209,-72.507910)"
2013,Noviembre,Bulgaria,100,1,0,,1,"(4.697144,-74.140516)"
2013,Noviembre,Burundi,108,0,1,,1,"(4.697144,-74.140516)"
2013,Noviembre,Cabo Verde,132,0,1,,1,"(4.697144,-74.140516)"
2013,Noviembre,Islas Caimán/Territorio Británico de Ultramar,136,1,0,,1,"(10.886611,-74.776708)"
2013,Noviembre,Islas Caimán/Territorio Británico de Ultramar,136,4,0,,4,"(12.586067,-81.702563)"
2013,Noviembre,Islas Caimán/Territorio Británico de Ultramar,136,3,2,,5,"(4.697144,-74.140516)"
2013,Noviembre,Camboya,116,3,0,,3,"(4.697144,-74.140516)"
2013,Noviembre,Camerún,120,1,1,,2,"(4.697144,-74.140516)"
2013,Noviembre,Canadá,124,19,9,,28,"(10.445761,-75.516429)"
2013,Noviembre,Canadá,124,12,4,,16,"(10.886611,-74.776708)"
2013,Noviembre,Canadá,124,3,1,,4,"(12.586067,-81.702563)"
2013,Noviembre,Canadá,124,36,31,,67,"(3.541112,-76.384584)"
2013,Noviembre,Canadá,124,2,0,,2,"(4.452882,-75.766298)"
2013,Noviembre,Canadá,124,806,638,,1444,"(4.697144,-74.140516)"
2013,Noviembre,Canadá,124,3,5,,8,"(4.815061,-75.736532)"
2013,Noviembre,Canadá,124,76,54,,130,"(6.171601,-75.427454)"
2013,Noviembre,Canadá,124,3,0,,3,"(7.128456,-73.183637)"
2013,Noviembre,Canadá,124,1,1,,2,"(7.927209,-72.507910)"
2013,Noviembre,Chad,148,0,1,,1,"(4.697144,-74.140516)"
2013,Noviembre,España,724,2,2,,4,"(10.445761,-75.516429)"
2013,Noviembre,España,724,892,537,,1429,"(3.541112,-76.384584)"
2013,Noviembre,España,724,4679,3853,,8532,"(4.697144,-74.140516)"
2013,Noviembre,España,724,1,0,,1,"(4.815061,-75.736532)"
2013,Noviembre,España,724,518,376,,894,"(6.171601,-75.427454)"
2013,Noviembre,República Democrática del Congo,180,1,3,,4,"(4.697144,-74.140516)"
2013,Noviembre,República Democrática del Congo,180,1,0,,1,"(7.927209,-72.507910)"
2013,Noviembre,República de Corea,410,0,4,,4,"(3.541112,-76.384584)"
2013,Noviembre,República de Corea,410,23,38,,61,"(4.697144,-74.140516)"
2013,Noviembre,República de Corea,410,3,0,,3,"(6.171601,-75.427454)"
2013,Noviembre,Costa de Marfil,384,1,2,,3,"(4.697144,-74.140516)"
2013,Noviembre,Costa de Marfil,384,4,3,,7,"(6.171601,-75.427454)"
2013,Noviembre,Costa Rica,188,10,12,,22,"(10.445761,-75.516429)"
2013,Noviembre,Costa Rica,188,16,21,,37,"(10.886611,-74.776708)"
2013,Noviembre,Costa Rica,188,4,42,,46,"(12.5744111,-81.703935)"
2013,Noviembre,Costa Rica,188,1,0,,1,"(12.586067,-81.702563)"
2013,Noviembre,Costa Rica,188,39,66,,105,"(3.541112,-76.384584)"
2013,Noviembre,Costa Rica,188,735,964,,1699,"(4.697144,-74.140516)"
2013,Noviembre,Costa Rica,188,1,3,,4,"(4.815061,-75.736532)"
2013,Noviembre,Costa Rica,188,79,94,,173,"(6.171601,-75.427454)"
2013,Noviembre,Costa Rica,188,1,2,,3,"(7.128456,-73.183637)"
2013,Noviembre,Costa Rica,188,0,1,,1,"(7.927209,-72.507910)"
2013,Noviembre,Croacia,191,0,1,,1,"(12.5744111,-81.703935)"
2013,Noviembre,Croacia,191,1,0,,1,"(4.697144,-74.140516)"
2013,Noviembre,Cuba,192,25,29,,54,"(10.445761,-75.516429)"
2013,Noviembre,Cuba,192,20,22,,42,"(10.886611,-74.776708)"
2013,Noviembre,Cuba,192,1,0,,1,"(12.586067,-81.702563)"
2013,Noviembre,Cuba,192,136,107,,243,"(3.541112,-76.384584)"
2013,Noviembre,Cuba,192,1051,877,,1928,"(4.697144,-74.140516)"
2013,Noviembre,Cuba,192,13,13,,26,"(4.815061,-75.736532)"
2013,Noviembre,Cuba,192,134,140,,274,"(6.171601,-75.427454)"
2013,Noviembre,Cuba,192,7,5,,12,"(7.128456,-73.183637)"
2013,Noviembre,Cuba,192,2,1,,3,"(7.927209,-72.507910)"
2013,Noviembre,Curazao,99999,13,10,,23,"(10.408582,-75.538003)"
2013,Noviembre,Curazao,99999,2,2,,4,"(10.445761,-75.516429)"
2013,Noviembre,Curazao,99999,2,0,,2,"(10.886611,-74.776708)"
2013,Noviembre,Curazao,99999,6,2,,8,"(3.541112,-76.384584)"
2013,Noviembre,Curazao,99999,320,327,,647,"(4.697144,-74.140516)"
2013,Noviembre,Curazao,99999,101,50,,151,"(6.171601,-75.427454)"
2013,Noviembre,Curazao,99999,1,1,,2,"(7.128456,-73.183637)"
2013,Noviembre,República Checa,203,10,10,,20,"(4.697144,-74.140516)"
2013,Noviembre,Chile,152,19,21,,40,"(0.814836,-77.662532)"
2013,Noviembre,Chile,152,22,22,,44,"(10.445761,-75.516429)"
2013,Noviembre,Chile,152,22,12,,34,"(10.886611,-74.776708)"
2013,Noviembre,Chile,152,0,1,,1,"(12.586067,-81.702563)"
2013,Noviembre,Chile,152,463,349,,812,"(3.541112,-76.384584)"
2013,Noviembre,Chile,152,2832,2749,,5581,"(4.697144,-74.140516)"
2013,Noviembre,Chile,152,4,7,,11,"(4.815061,-75.736532)"
2013,Noviembre,Chile,152,151,143,,294,"(6.171601,-75.427454)"
2013,Noviembre,Chile,152,7,6,,13,"(7.128456,-73.183637)"
2013,Noviembre,Chile,152,2,2,,4,"(7.927209,-72.507910)"
2013,Noviembre,China,156,1,0,,1,"(10.886611,-74.776708)"
2013,Noviembre,China,156,1,8,,9,"(3.541112,-76.384584)"
2013,Noviembre,China,156,108,334,,442,"(4.697144,-74.140516)"
2013,Noviembre,China,156,0,1,,1,"(4.815061,-75.736532)"
2013,Noviembre,China,156,5,19,,24,"(6.171601,-75.427454)"
2013,Noviembre,Dinamarca,208,10,18,,28,"(4.697144,-74.140516)"
2013,Noviembre,Dinamarca,208,1,1,,2,"(6.171601,-75.427454)"
2013,Noviembre,Dominica,212,0,1,,1,"(4.697144,-74.140516)"
2013,Noviembre,Ecuador,218,457,582,,1039,"(0.25129,-76.875963)"
2013,Noviembre,Ecuador,218,6481,6779,,13260,"(0.814836,-77.662532)"
2013,Noviembre,Ecuador,218,120,137,,257,"(1.813928,-78.763924)"
2013,Noviembre,Ecuador,218,4,4,,8,"(10.445761,-75.516429)"
2013,Noviembre,Ecuador,218,4,14,,18,"(10.886611,-74.776708)"
2013,Noviembre,Ecuador,218,808,692,,1500,"(3.541112,-76.384584)"
2013,Noviembre,Ecuador,218,2174,3951,,6125,"(4.697144,-74.140516)"
2013,Noviembre,Ecuador,218,4,2,,6,"(4.815061,-75.736532)"
2013,Noviembre,Ecuador,218,398,449,,847,"(6.171601,-75.427454)"
2013,Noviembre,Ecuador,218,5,4,,9,"(7.128456,-73.183637)"
2013,Noviembre,Ecuador,218,1,1,,2,"(7.927209,-72.507910)"
2013,Noviembre,Egipto,818,1,0,,1,"(3.541112,-76.384584)"
2013,Noviembre,Egipto,818,33,18,,51,"(4.697144,-74.140516)"
2013,Noviembre,El Salvador,222,1,1,,2,"(10.886611,-74.776708)"
2013,Noviembre,El Salvador,222,113,140,,253,"(3.541112,-76.384584)"
2013,Noviembre,El Salvador,222,968,1110,,2078,"(4.697144,-74.140516)"
2013,Noviembre,El Salvador,222,5,5,,10,"(4.815061,-75.736532)"
2013,Noviembre,El Salvador,222,128,123,,251,"(6.171601,-75.427454)"
2013,Noviembre,El Salvador,222,2,1,,3,"(7.128456,-73.183637)"
2013,Noviembre,Emiratos Árabes,784,0,1,,1,"(3.541112,-76.384584)"
2013,Noviembre,Emiratos Árabes,784,143,210,,353,"(4.697144,-74.140516)"
2013,Noviembre,Emiratos Árabes,784,1,2,,3,"(6.171601,-75.427454)"
2013,Noviembre,Eritrea,232,1,0,,1,"(4.697144,-74.140516)"
2013,Noviembre,Eslovaquia,703,1,0,,1,"(4.697144,-74.140516)"
2013,Noviembre,Eslovenia,705,1,2,,3,"(4.697144,-74.140516)"
2013,Noviembre,Estados Unidos de América,840,1,1,,2,"(10.408582,-75.538003)"
2013,Noviembre,Estados Unidos de América,840,2349,1912,,4261,"(10.445761,-75.516429)"
2013,Noviembre,Estados Unidos de América,840,2017,1584,,3601,"(10.886611,-74.776708)"
2013,Noviembre,Estados Unidos de América,840,20,12,,32,"(12.586067,-81.702563)"
2013,Noviembre,Estados Unidos de América,840,4576,3274,,7850,"(3.541112,-76.384584)"
2013,Noviembre,Estados Unidos de América,840,597,405,,1002,"(4.452882,-75.766298)"
2013,Noviembre,Estados Unidos de América,840,31529,27915,,59444,"(4.697144,-74.140516)"
2013,Noviembre,Estados Unidos de América,840,322,218,,540,"(4.815061,-75.736532)"
2013,Noviembre,Estados Unidos de América,840,9047,6990,,16037,"(6.171601,-75.427454)"
2013,Noviembre,Estados Unidos de América,840,146,107,,253,"(7.128456,-73.183637)"
2013,Noviembre,Estados Unidos de América,840,125,105,,230,"(7.927209,-72.507910)"
2013,Noviembre,Etiopia,231,4,6,,10,"(4.697144,-74.140516)"
2013,Noviembre,Filipinas,608,2,4,,6,"(4.697144,-74.140516)"
2013,Noviembre,Filipinas,608,0,1,,1,"(6.171601,-75.427454)"
2013,Noviembre,Finlandia,246,7,11,,18,"(4.697144,-74.140516)"
2013,Noviembre,Francia,250,18,11,,29,"(3.541112,-76.384584)"
2013,Noviembre,Francia,250,822,789,,1611,"(4.697144,-74.140516)"
2013,Noviembre,Francia,250,15,5,,20,"(6.171601,-75.427454)"
2013,Noviembre,Gabón,266,0,6,,6,"(4.697144,-74.140516)"
2013,Noviembre,Ghana,288,0,3,,3,"(4.697144,-74.140516)"
2013,Noviembre,Gibraltar/Territorio Británico de Ultramar,292,1,0,,1,"(4.697144,-74.140516)"
2013,Noviembre,Grecia,300,7,2,,9,"(4.697144,-74.140516)"
2013,Noviembre,Guatemala,320,4,5,,9,"(10.445761,-75.516429)"
2013,Noviembre,Guatemala,320,3,3,,6,"(10.886611,-74.776708)"
2013,Noviembre,Guatemala,320,35,50,,85,"(3.541112,-76.384584)"
2013,Noviembre,Guatemala,320,421,596,,1017,"(4.697144,-74.140516)"
2013,Noviembre,Guatemala,320,3,3,,6,"(4.815061,-75.736532)"
2013,Noviembre,Guatemala,320,67,86,,153,"(6.171601,-75.427454)"
2013,Noviembre,Guatemala,320,0,3,,3,"(7.128456,-73.183637)"
2013,Noviembre,Guatemala,320,3,3,,6,"(7.927209,-72.507910)"
2013,Noviembre,Guyana,328,1,0,,1,"(3.541112,-76.384584)"
2013,Noviembre,Guyana,328,2,0,,2,"(4.697144,-74.140516)"
2013,Noviembre,Guinea,324,0,3,,3,"(4.697144,-74.140516)"
2013,Noviembre,Guinea Ecuatorial,226,0,2,,2,"(3.541112,-76.384584)"
2013,Noviembre,Guinea Ecuatorial,226,2,9,,11,"(4.697144,-74.140516)"
2013,Noviembre,Guadalupe/Territorio Francés,312,0,1,,1,"(3.541112,-76.384584)"
2013,Noviembre,Guadalupe/Territorio Francés,312,2,1,,3,"(4.697144,-74.140516)"
2013,Noviembre,Haití,332,4,0,,4,"(10.445761,-75.516429)"
2013,Noviembre,Haití,332,1,3,,4,"(10.886611,-74.776708)"
2013,Noviembre,Haití,332,0,1,,1,"(3.541112,-76.384584)"
2013,Noviembre,Haití,332,5,15,,20,"(4.697144,-74.140516)"
2013,Noviembre,Haití,332,6,9,,15,"(6.171601,-75.427454)"
2013,Noviembre,Honduras,340,4,7,,11,"(10.445761,-75.516429)"
2013,Noviembre,Honduras,340,5,1,,6,"(10.886611,-74.776708)"
2013,Noviembre,Honduras,340,9,28,,37,"(3.541112,-76.384584)"
2013,Noviembre,Honduras,340,44,121,,165,"(4.697144,-74.140516)"
2013,Noviembre,Honduras,340,1,5,,6,"(4.815061,-75.736532)"
2013,Noviembre,Honduras,340,29,37,,66,"(6.171601,-75.427454)"
2013,Noviembre,Honduras,340,1,0,,1,"(7.128456,-73.183637)"
2013,Noviembre,Honduras,340,0,1,,1,"(7.927209,-72.507910)"
2013,Noviembre,Hong Kong,344,1,3,,4,"(3.541112,-76.384584)"
2013,Noviembre,Hong Kong,344,16,57,,73,"(4.697144,-74.140516)"
2013,Noviembre,Hong Kong,344,1,1,,2,"(6.171601,-75.427454)"
2013,Noviembre,Hungría,348,3,3,,6,"(4.697144,-74.140516)"
2013,Noviembre,India,356,0,1,,1,"(10.445761,-75.516429)"
2013,Noviembre,India,356,10,4,,14,"(10.886611,-74.776708)"
2013,Noviembre,India,356,2,8,,10,"(3.541112,-76.384584)"
2013,Noviembre,India,356,61,68,,129,"(4.697144,-74.140516)"
2013,Noviembre,India,356,4,5,,9,"(6.171601,-75.427454)"
2013,Noviembre,Indonesia,360,1,0,,1,"(3.541112,-76.384584)"
2013,Noviembre,Indonesia,360,7,9,,16,"(4.697144,-74.140516)"
2013,Noviembre,Indonesia,360,3,0,,3,"(6.171601,-75.427454)"
2013,Noviembre,Iraq,368,0,10,,10,"(4.697144,-74.140516)"
2013,Noviembre,Irán,364,2,2,,4,"(4.697144,-74.140516)"
2013,Noviembre,Irán,364,2,0,,2,"(6.171601,-75.427454)"
2013,Noviembre,República de Irlanda,372,1,1,,2,"(3.541112,-76.384584)"
2013,Noviembre,República de Irlanda,372,11,4,,15,"(4.697144,-74.140516)"
2013,Noviembre,República de Irlanda,372,1,1,,2,"(6.171601,-75.427454)"
2013,Noviembre,Islandia,352,0,1,,1,"(4.697144,-74.140516)"
2013,Noviembre,Israel,376,3,1,,4,"(3.541112,-76.384584)"
2013,Noviembre,Israel,376,237,143,,380,"(4.697144,-74.140516)"
2013,Noviembre,Israel,376,1,0,,1,"(6.171601,-75.427454)"
2013,Noviembre,Italia,380,1,0,,1,"(10.445761,-75.516429)"
2013,Noviembre,Italia,380,38,20,,58,"(3.541112,-76.384584)"
2013,Noviembre,Italia,380,320,249,,569,"(4.697144,-74.140516)"
2013,Noviembre,Italia,380,13,10,,23,"(6.171601,-75.427454)"
2013,Noviembre,Jamaica,388,4,4,,8,"(10.445761,-75.516429)"
2013,Noviembre,Jamaica,388,9,3,,12,"(10.886611,-74.776708)"
2013,Noviembre,Jamaica,388,1,5,,6,"(12.586067,-81.702563)"
2013,Noviembre,Jamaica,388,12,15,,27,"(3.541112,-76.384584)"
2013,Noviembre,Jamaica,388,28,24,,52,"(4.697144,-74.140516)"
2013,Noviembre,Jamaica,388,3,3,,6,"(4.815061,-75.736532)"
2013,Noviembre,Jamaica,388,15,18,,33,"(6.171601,-75.427454)"
2013,Noviembre,Jamaica,388,7,3,,10,"(7.128456,-73.183637)"
2013,Noviembre,Japón,392,2,2,,4,"(10.445761,-75.516429)"
2013,Noviembre,Japón,392,3,4,,7,"(3.541112,-76.384584)"
2013,Noviembre,Japón,392,39,64,,103,"(4.697144,-74.140516)"
2013,Noviembre,Japón,392,6,7,,13,"(6.171601,-75.427454)"
2013,Noviembre,Jordania,400,7,8,,15,"(4.697144,-74.140516)"
2013,Noviembre,Kazajistán,398,1,1,,2,"(4.697144,-74.140516)"
2013,Noviembre,Kenia,404,1,0,,1,"(10.886611,-74.776708)"
2013,Noviembre,Kenia,404,0,1,,1,"(3.541112,-76.384584)"
2013,Noviembre,Kenia,404,2,7,,9,"(4.697144,-74.140516)"
2013,Noviembre,Kuwait,414,1,3,,4,"(4.697144,-74.140516)"
2013,Noviembre,República Democrática Popular  Lao,418,1,0,,1,"(4.697144,-74.140516)"
2013,Noviembre,Lituania,440,1,3,,4,"(4.697144,-74.140516)"
2013,Noviembre,Líbano,422,9,4,,13,"(4.697144,-74.140516)"
2013,Noviembre,Liberia,430,0,1,,1,"(4.697144,-74.140516)"
2013,Noviembre,Luxemburgo,442,0,1,,1,"(3.541112,-76.384584)"
2013,Noviembre,Luxemburgo,442,5,6,,11,"(4.697144,-74.140516)"
2013,Noviembre,Luxemburgo,442,0,1,,1,"(6.171601,-75.427454)"
2013,Noviembre,Macedonia,807,0,1,,1,"(4.697144,-74.140516)"
2013,Noviembre,Madagascar,450,0,1,,1,"(4.697144,-74.140516)"
2013,Noviembre,Malasia,458,0,5,,5,"(10.886611,-74.776708)"
2013,Noviembre,Malasia,458,4,16,,20,"(4.697144,-74.140516)"
2013,Noviembre,Malta,470,4,1,,5,"(4.697144,-74.140516)"
2013,Noviembre,Marruecos,504,3,3,,6,"(4.697144,-74.140516)"
2013,Noviembre,Marruecos,504,1,1,,2,"(6.171601,-75.427454)"
2013,Noviembre,Mauricio,480,1,1,,2,"(4.697144,-74.140516)"
2013,Noviembre,Martinica/Departamento de Ultramar Francés,474,0,2,,2,"(4.697144,-74.140516)"
2013,Noviembre,Martinica/Departamento de Ultramar Francés,474,1,0,,1,"(6.171601,-75.427454)"
2013,Noviembre,México,484,1,1,,2,"(0.814836,-77.662532)"
2013,Noviembre,México,484,1,6,,7,"(10.408582,-75.538003)"
2013,Noviembre,México,484,59,69,,128,"(10.445761,-75.516429)"
2013,Noviembre,México,484,105,94,,199,"(10.886611,-74.776708)"
2013,Noviembre,México,484,0,3,,3,"(12.586067,-81.702563)"
2013,Noviembre,México,484,428,396,,824,"(3.541112,-76.384584)"
2013,Noviembre,México,484,8002,7696,,15698,"(4.697144,-74.140516)"
2013,Noviembre,México,484,74,51,,125,"(4.815061,-75.736532)"
2013,Noviembre,México,484,1248,1008,,2256,"(6.171601,-75.427454)"
2013,Noviembre,México,484,51,47,,98,"(7.128456,-73.183637)"
2013,Noviembre,México,484,110,91,,201,"(7.927209,-72.507910)"
2013,Noviembre,Mónaco,492,2,3,,5,"(4.697144,-74.140516)"
2013,Noviembre,Mozambique,508,1,0,,1,"(4.697144,-74.140516)"
2013,Noviembre,Myanmar,104,0,1,,1,"(4.697144,-74.140516)"
2013,Noviembre,Nicaragua,558,0,1,,1,"(10.445761,-75.516429)"
2013,Noviembre,Nicaragua,558,3,1,,4,"(10.886611,-74.776708)"
2013,Noviembre,Nicaragua,558,13,14,,27,"(3.541112,-76.384584)"
2013,Noviembre,Nicaragua,558,27,57,,84,"(4.697144,-74.140516)"
2013,Noviembre,Nicaragua,558,9,29,,38,"(6.171601,-75.427454)"
2013,Noviembre,Nicaragua,558,0,1,,1,"(7.128456,-73.183637)"
2013,Noviembre,Nicaragua,558,2,0,,2,"(7.927209,-72.507910)"
2013,Noviembre,Nigeria,566,0,4,,4,"(4.697144,-74.140516)"
2013,Noviembre,Nigeria,566,0,1,,1,"(6.171601,-75.427454)"
2013,Noviembre,Niue,570,0,1,,1,"(4.697144,-74.140516)"
2013,Noviembre,Noruega,578,2,0,,2,"(3.541112,-76.384584)"
2013,Noviembre,Noruega,578,16,11,,27,"(4.697144,-74.140516)"
2013,Noviembre,Noruega,578,1,0,,1,"(6.171601,-75.427454)"
2013,Noviembre,Nueva Zelanda,554,1,0,,1,"(3.541112,-76.384584)"
2013,Noviembre,Nueva Zelanda,554,8,11,,19,"(4.697144,-74.140516)"
2013,Noviembre,Nueva Zelanda,554,2,2,,4,"(6.171601,-75.427454)"
2013,Noviembre,Omán,512,4,2,,6,"(4.697144,-74.140516)"
2013,Noviembre,Papúa Nueva Guinea,598,2,4,,6,"(4.697144,-74.140516)"
2013,Noviembre,Pakistán,586,1,0,,1,"(4.697144,-74.140516)"
2013,Noviembre,Panamá,591,0,1,,1,"(0.814836,-77.662532)"
2013,Noviembre,Panamá,591,29,52,,81,"(10.408582,-75.538003)"
2013,Noviembre,Panamá,591,518,436,,954,"(10.445761,-75.516429)"
2013,Noviembre,Panamá,591,929,943,,1872,"(10.886611,-74.776708)"
2013,Noviembre,Panamá,591,3,23,,26,"(12.5744111,-81.703935)"
2013,Noviembre,Panamá,591,40,65,,105,"(12.586067,-81.702563)"
2013,Noviembre,Panamá,591,2347,1910,,4257,"(3.541112,-76.384584)"
2013,Noviembre,Panamá,591,7697,7978,,15675,"(4.697144,-74.140516)"
2013,Noviembre,Panamá,591,844,541,,1385,"(4.815061,-75.736532)"
2013,Noviembre,Panamá,591,2645,2327,,4972,"(6.171601,-75.427454)"
2013,Noviembre,Panamá,591,557,494,,1051,"(7.128456,-73.183637)"
2013,Noviembre,Panamá,591,254,250,,504,"(7.927209,-72.507910)"
2013,Noviembre,Panamá,591,2,77,,79,"(8.066966,-76.735404)"
2013,Noviembre,Panamá,591,30,78,,108,"(8.635765,-77.346578)"
2013,Noviembre,Paraguay,600,3,0,,3,"(10.445761,-75.516429)"
2013,Noviembre,Paraguay,600,2,10,,12,"(10.886611,-74.776708)"
2013,Noviembre,Paraguay,600,10,10,,20,"(3.541112,-76.384584)"
2013,Noviembre,Paraguay,600,58,93,,151,"(4.697144,-74.140516)"
2013,Noviembre,Paraguay,600,1,0,,1,"(4.815061,-75.736532)"
2013,Noviembre,Paraguay,600,7,7,,14,"(6.171601,-75.427454)"
2013,Noviembre,Perú,604,52,117,,169,"(-4.197703,-69.941278)"
2013,Noviembre,Perú,604,1,2,,3,"(0.25129,-76.875963)"
2013,Noviembre,Perú,604,25,47,,72,"(0.814836,-77.662532)"
2013,Noviembre,Perú,604,11,6,,17,"(10.445761,-75.516429)"
2013,Noviembre,Perú,604,29,39,,68,"(10.886611,-74.776708)"
2013,Noviembre,Perú,604,303,371,,674,"(3.541112,-76.384584)"
2013,Noviembre,Perú,604,3539,4518,,8057,"(4.697144,-74.140516)"
2013,Noviembre,Perú,604,6,5,,11,"(4.815061,-75.736532)"
2013,Noviembre,Perú,604,390,503,,893,"(6.171601,-75.427454)"
2013,Noviembre,Perú,604,6,1,,7,"(7.128456,-73.183637)"
2013,Noviembre,Perú,604,3,1,,4,"(7.927209,-72.507910)"
2013,Noviembre,Palestina,99999,0,1,,1,"(4.697144,-74.140516)"
2013,Noviembre,Polonia,616,17,25,,42,"(4.697144,-74.140516)"
2013,Noviembre,Portugal,620,16,14,,30,"(4.697144,-74.140516)"
2013,Noviembre,Portugal,620,1,0,,1,"(6.171601,-75.427454)"
2013,Noviembre,Puerto Rico/Territorio de Estados Unidos,630,12,10,,22,"(10.445761,-75.516429)"
2013,Noviembre,Puerto Rico/Territorio de Estados Unidos,630,15,21,,36,"(10.886611,-74.776708)"
2013,Noviembre,Puerto Rico/Territorio de Estados Unidos,630,27,24,,51,"(3.541112,-76.384584)"
2013,Noviembre,Puerto Rico/Territorio de Estados Unidos,630,355,377,,732,"(4.697144,-74.140516)"
2013,Noviembre,Puerto Rico/Territorio de Estados Unidos,630,4,4,,8,"(4.815061,-75.736532)"
2013,Noviembre,Puerto Rico/Territorio de Estados Unidos,630,39,24,,63,"(6.171601,-75.427454)"
2013,Noviembre,Puerto Rico/Territorio de Estados Unidos,630,1,3,,4,"(7.128456,-73.183637)"
2013,Noviembre,Puerto Rico/Territorio de Estados Unidos,630,0,1,,1,"(7.927209,-72.507910)"
2013,Noviembre,Qatar,634,2,1,,3,"(4.697144,-74.140516)"
2013,Noviembre,Reino Unido de Gran Bretaña e Irlanda del Norte,826,1,2,,3,"(10.445761,-75.516429)"
2013,Noviembre,Reino Unido de Gran Bretaña e Irlanda del Norte,826,1,0,,1,"(10.886611,-74.776708)"
2013,Noviembre,Reino Unido de Gran Bretaña e Irlanda del Norte,826,26,11,,37,"(3.541112,-76.384584)"
2013,Noviembre,Reino Unido de Gran Bretaña e Irlanda del Norte,826,376,325,,701,"(4.697144,-74.140516)"
2013,Noviembre,Reino Unido de Gran Bretaña e Irlanda del Norte,826,23,17,,40,"(6.171601,-75.427454)"
2013,Noviembre,República CentroÁfricana,140,0,2,,2,"(4.697144,-74.140516)"
2013,Noviembre,Federación de Rusia,643,16,39,,55,"(4.697144,-74.140516)"
2013,Noviembre,República Dominicana,214,1,4,,5,"(10.408582,-75.538003)"
2013,Noviembre,República Dominicana,214,12,12,,24,"(10.445761,-75.516429)"
2013,Noviembre,República Dominicana,214,19,25,,44,"(10.886611,-74.776708)"
2013,Noviembre,República Dominicana,214,37,50,,87,"(3.541112,-76.384584)"
2013,Noviembre,República Dominicana,214,1278,1258,,2536,"(4.697144,-74.140516)"
2013,Noviembre,República Dominicana,214,11,11,,22,"(4.815061,-75.736532)"
2013,Noviembre,República Dominicana,214,149,145,,294,"(6.171601,-75.427454)"
2013,Noviembre,República Dominicana,214,4,6,,10,"(7.128456,-73.183637)"
2013,Noviembre,República Dominicana,214,1,0,,1,"(7.927209,-72.507910)"
2013,Noviembre,República Democrática Popular de Corea,408,1,0,,1,"(4.697144,-74.140516)"
2013,Noviembre,Rumania,642,4,11,,15,"(4.697144,-74.140516)"
2013,Noviembre,Rwanda,646,0,1,,1,"(4.697144,-74.140516)"
2013,Noviembre,San Cristóbal y Nevis,659,1,0,,1,"(4.697144,-74.140516)"
2013,Noviembre,San Marino,674,2,1,,3,"(4.697144,-74.140516)"
2013,Noviembre,Senegal,686,2,1,,3,"(4.697144,-74.140516)"
2013,Noviembre,Serbia,688,3,1,,4,"(4.697144,-74.140516)"
2013,Noviembre,Singapur,702,16,26,,42,"(4.697144,-74.140516)"
2013,Noviembre,República Árabe Siria,760,0,1,,1,"(4.697144,-74.140516)"
2013,Noviembre,Sudáfrica,710,9,24,,33,"(4.697144,-74.140516)"
2013,Noviembre,Sudán,736,1,0,,1,"(4.697144,-74.140516)"
2013,Noviembre,Suecia,752,6,2,,8,"(3.541112,-76.384584)"
2013,Noviembre,Suecia,752,42,44,,86,"(4.697144,-74.140516)"
2013,Noviembre,Suecia,752,4,0,,4,"(6.171601,-75.427454)"
2013,Noviembre,Suiza,756,11,5,,16,"(3.541112,-76.384584)"
2013,Noviembre,Suiza,756,136,116,,252,"(4.697144,-74.140516)"
2013,Noviembre,Suiza,756,12,4,,16,"(6.171601,-75.427454)"
2013,Noviembre,Surinam,740,2,5,,7,"(10.886611,-74.776708)"
2013,Noviembre,Surinam,740,5,25,,30,"(4.697144,-74.140516)"
2013,Noviembre,Surinam,740,2,2,,4,"(6.171601,-75.427454)"
2013,Noviembre,Surinam,740,0,2,,2,"(7.128456,-73.183637)"
2013,Noviembre,Taiwán,158,1,0,,1,"(10.445761,-75.516429)"
2013,Noviembre,Taiwán,158,10,7,,17,"(4.697144,-74.140516)"
2013,Noviembre,Tailandia,764,0,1,,1,"(3.541112,-76.384584)"
2013,Noviembre,Tailandia,764,26,23,,49,"(4.697144,-74.140516)"
2013,Noviembre,Tailandia,764,2,2,,4,"(6.171601,-75.427454)"
2013,Noviembre,Tanzania,834,2,1,,3,"(4.697144,-74.140516)"
2013,Noviembre,Trinidad y Tobago,780,0,1,,1,"(10.886611,-74.776708)"
2013,Noviembre,Trinidad y Tobago,780,9,11,,20,"(3.541112,-76.384584)"
2013,Noviembre,Trinidad y Tobago,780,21,39,,60,"(4.697144,-74.140516)"
2013,Noviembre,Trinidad y Tobago,780,1,0,,1,"(4.815061,-75.736532)"
2013,Noviembre,Trinidad y Tobago,780,5,3,,8,"(6.171601,-75.427454)"
2013,Noviembre,Trinidad y Tobago,780,1,1,,2,"(7.128456,-73.183637)"
2013,Noviembre,Trinidad y Tobago,780,1,3,,4,"(7.927209,-72.507910)"
2013,Noviembre,Túnez,788,1,0,,1,"(11.360009,-72.129330)"
2013,Noviembre,Túnez,788,1,1,,2,"(4.697144,-74.140516)"
2013,Noviembre,Turquía,792,90,54,,144,"(4.697144,-74.140516)"
2013,Noviembre,Turquía,792,0,1,,1,"(6.171601,-75.427454)"
2013,Noviembre,Ucrania,804,0,6,,6,"(4.697144,-74.140516)"
2013,Noviembre,Uganda,800,0,1,,1,"(4.697144,-74.140516)"
2013,Noviembre,Uruguay,858,0,3,,3,"(10.445761,-75.516429)"
2013,Noviembre,Uruguay,858,3,2,,5,"(10.886611,-74.776708)"
2013,Noviembre,Uruguay,858,9,10,,19,"(3.541112,-76.384584)"
2013,Noviembre,Uruguay,858,48,84,,132,"(4.697144,-74.140516)"
2013,Noviembre,Uruguay,858,1,0,,1,"(4.815061,-75.736532)"
2013,Noviembre,Uruguay,858,19,20,,39,"(6.171601,-75.427454)"
2013,Noviembre,Vanuatu,548,1,1,,2,"(7.818934,-72.453226)"
2013,Noviembre,Venezuela,862,0,1,,1,"(10.408582,-75.538003)"
2013,Noviembre,Venezuela,862,4,15,,19,"(10.445761,-75.516429)"
2013,Noviembre,Venezuela,862,8,22,,30,"(10.886611,-74.776708)"
2013,Noviembre,Venezuela,862,18705,14850,,33555,"(11.360009,-72.129330)"
2013,Noviembre,Venezuela,862,2,6,,8,"(3.541112,-76.384584)"
2013,Noviembre,Venezuela,862,1195,1402,,2597,"(4.697144,-74.140516)"
2013,Noviembre,Venezuela,862,1,1,,2,"(4.815061,-75.736532)"
2013,Noviembre,Venezuela,862,139,119,,258,"(6.171601,-75.427454)"
2013,Noviembre,Venezuela,862,631,586,,1217,"(6.185799,-67.483929)"
2013,Noviembre,Venezuela,862,2837,2287,,5124,"(7.088729,-70.740253)"
2013,Noviembre,Venezuela,862,0,7,,7,"(7.128456,-73.183637)"
2013,Noviembre,Venezuela,862,10961,9918,,20879,"(7.818934,-72.453226)"
2013,Noviembre,Venezuela,862,1,1,,2,"(7.927209,-72.507910)"
2013,Noviembre,Vietnam,704,0,5,,5,"(4.697144,-74.140516)"
2013,Noviembre,Islas Vírgenes Británicas/Territorio Británico de Ultramar,92,1,0,,1,"(4.697144,-74.140516)"
2013,Noviembre,República Árabe de Yemen,887,0,2,,2,"(4.697144,-74.140516)"
2013,Diciembre,Afganistán,4,2,26,,28,"(4.697144,-74.140516)"
2013,Diciembre,Alemania,276,3,2,,5,"(10.886611,-74.776708)"
2013,Diciembre,Alemania,276,25,28,,53,"(3.541112,-76.384584)"
2013,Diciembre,Alemania,276,1009,821,,1830,"(4.697144,-74.140516)"
2013,Diciembre,Alemania,276,1,0,,1,"(4.815061,-75.736532)"
2013,Diciembre,Alemania,276,15,10,,25,"(6.171601,-75.427454)"
2013,Diciembre,Andorra,20,1,1,,2,"(4.697144,-74.140516)"
2013,Diciembre,Angola,24,1,5,,6,"(4.697144,-74.140516)"
2013,Diciembre,Antigua y Barbuda,28,1,1,,2,"(4.697144,-74.140516)"
2013,Diciembre,Países Bajos,528,169,141,,310,"(10.408582,-75.538003)"
2013,Diciembre,Países Bajos,528,0,1,,1,"(10.445761,-75.516429)"
2013,Diciembre,Países Bajos,528,4,1,,5,"(10.886611,-74.776708)"
2013,Diciembre,Países Bajos,528,38,15,,53,"(3.541112,-76.384584)"
2013,Diciembre,Países Bajos,528,156,97,,253,"(4.697144,-74.140516)"
2013,Diciembre,Países Bajos,528,4,0,,4,"(4.815061,-75.736532)"
2013,Diciembre,Países Bajos,528,60,38,,98,"(6.171601,-75.427454)"
2013,Diciembre,Arabia Saudita,682,0,1,,1,"(3.541112,-76.384584)"
2013,Diciembre,Arabia Saudita,682,13,15,,28,"(4.697144,-74.140516)"
2013,Diciembre,Arabia Saudita,682,0,1,,1,"(6.171601,-75.427454)"
2013,Diciembre,Argelia,12,4,2,,6,"(4.697144,-74.140516)"
2013,Diciembre,Argentina,32,13,23,,36,"(0.814836,-77.662532)"
2013,Diciembre,Argentina,32,23,18,,41,"(10.445761,-75.516429)"
2013,Diciembre,Argentina,32,30,23,,53,"(10.886611,-74.776708)"
2013,Diciembre,Argentina,32,1,0,,1,"(11.360009,-72.129330)"
2013,Diciembre,Argentina,32,246,162,,408,"(3.541112,-76.384584)"
2013,Diciembre,Argentina,32,4079,3469,,7548,"(4.697144,-74.140516)"
2013,Diciembre,Argentina,32,24,10,,34,"(4.815061,-75.736532)"
2013,Diciembre,Argentina,32,294,219,,513,"(6.171601,-75.427454)"
2013,Diciembre,Argentina,32,9,4,,13,"(7.128456,-73.183637)"
2013,Diciembre,Argentina,32,2,0,,2,"(7.927209,-72.507910)"
2013,Diciembre,Aruba,533,2774,1829,,4603,"(10.408582,-75.538003)"
2013,Diciembre,Aruba,533,3,2,,5,"(10.445761,-75.516429)"
2013,Diciembre,Aruba,533,8,8,,16,"(10.886611,-74.776708)"
2013,Diciembre,Aruba,533,119,60,,179,"(11.528919,-72.919681)"
2013,Diciembre,Aruba,533,43,38,,81,"(3.541112,-76.384584)"
2013,Diciembre,Aruba,533,1904,1572,,3476,"(4.697144,-74.140516)"
2013,Diciembre,Aruba,533,5,4,,9,"(4.815061,-75.736532)"
2013,Diciembre,Aruba,533,47,43,,90,"(6.171601,-75.427454)"
2013,Diciembre,Aruba,533,12,13,,25,"(7.128456,-73.183637)"
2013,Diciembre,Aruba,533,1,0,,1,"(7.927209,-72.507910)"
2013,Diciembre,Australia,36,1,1,,2,"(10.445761,-75.516429)"
2013,Diciembre,Australia,36,3,1,,4,"(10.886611,-74.776708)"
2013,Diciembre,Australia,36,15,8,,23,"(3.541112,-76.384584)"
2013,Diciembre,Australia,36,247,191,,438,"(4.697144,-74.140516)"
2013,Diciembre,Australia,36,6,0,,6,"(4.815061,-75.736532)"
2013,Diciembre,Australia,36,29,19,,48,"(6.171601,-75.427454)"
2013,Diciembre,Australia,36,1,2,,3,"(7.128456,-73.183637)"
2013,Diciembre,Austria,40,1,0,,1,"(10.886611,-74.776708)"
2013,Diciembre,Austria,40,1,0,,1,"(3.541112,-76.384584)"
2013,Diciembre,Austria,40,34,22,,56,"(4.697144,-74.140516)"
2013,Diciembre,Austria,40,0,1,,1,"(6.171601,-75.427454)"
2013,Diciembre,Azerbaiyán,31,3,5,,8,"(4.697144,-74.140516)"
2013,Diciembre,Bahamas,44,5,2,,7,"(10.445761,-75.516429)"
2013,Diciembre,Bahamas,44,4,2,,6,"(10.886611,-74.776708)"
2013,Diciembre,Bahamas,44,3,2,,5,"(3.541112,-76.384584)"
2013,Diciembre,Bahamas,44,30,29,,59,"(4.697144,-74.140516)"
2013,Diciembre,Bahamas,44,2,1,,3,"(4.815061,-75.736532)"
2013,Diciembre,Bahamas,44,46,41,,87,"(6.171601,-75.427454)"
2013,Diciembre,Bahréin,48,2,3,,5,"(4.697144,-74.140516)"
2013,Diciembre,Bahréin,48,2,0,,2,"(6.171601,-75.427454)"
2013,Diciembre,Barbados,52,2,20,,22,"(4.697144,-74.140516)"
2013,Diciembre,Barbados,52,1,1,,2,"(6.171601,-75.427454)"
2013,Diciembre,Bélgica,56,8,2,,10,"(3.541112,-76.384584)"
2013,Diciembre,Bélgica,56,78,59,,137,"(4.697144,-74.140516)"
2013,Diciembre,Bélgica,56,5,5,,10,"(6.171601,-75.427454)"
2013,Diciembre,Belice,84,1,1,,2,"(3.541112,-76.384584)"
2013,Diciembre,Belice,84,5,5,,10,"(4.697144,-74.140516)"
2013,Diciembre,Benín,204,0,2,,2,"(4.697144,-74.140516)"
2013,Diciembre,Bolivia,68,2,12,,14,"(0.814836,-77.662532)"
2013,Diciembre,Bolivia,68,0,2,,2,"(10.445761,-75.516429)"
2013,Diciembre,Bolivia,68,4,3,,7,"(10.886611,-74.776708)"
2013,Diciembre,Bolivia,68,2,1,,3,"(12.586067,-81.702563)"
2013,Diciembre,Bolivia,68,29,21,,50,"(3.541112,-76.384584)"
2013,Diciembre,Bolivia,68,310,362,,672,"(4.697144,-74.140516)"
2013,Diciembre,Bolivia,68,1,1,,2,"(4.815061,-75.736532)"
2013,Diciembre,Bolivia,68,21,26,,47,"(6.171601,-75.427454)"
2013,Diciembre,Bosnia y Herzegovina,70,0,2,,2,"(4.697144,-74.140516)"
2013,Diciembre,Brasil,76,148,196,,344,"(-4.197703,-69.941278)"
2013,Diciembre,Brasil,76,4,3,,7,"(0.814836,-77.662532)"
2013,Diciembre,Brasil,76,7,13,,20,"(10.445761,-75.516429)"
2013,Diciembre,Brasil,76,9,9,,18,"(10.886611,-74.776708)"
2013,Diciembre,Brasil,76,84,72,,156,"(3.541112,-76.384584)"
2013,Diciembre,Brasil,76,3433,3699,,7132,"(4.697144,-74.140516)"
2013,Diciembre,Brasil,76,4,6,,10,"(4.815061,-75.736532)"
2013,Diciembre,Brasil,76,93,126,,219,"(6.171601,-75.427454)"
2013,Diciembre,Brasil,76,1,3,,4,"(7.128456,-73.183637)"
2013,Diciembre,Bulgaria,100,5,1,,6,"(4.697144,-74.140516)"
2013,Diciembre,Islas Caimán/Territorio Británico de Ultramar,136,80,48,,128,"(12.586067,-81.702563)"
2013,Diciembre,Islas Caimán/Territorio Británico de Ultramar,136,0,2,,2,"(3.541112,-76.384584)"
2013,Diciembre,Islas Caimán/Territorio Británico de Ultramar,136,4,1,,5,"(4.697144,-74.140516)"
2013,Diciembre,Islas Caimán/Territorio Británico de Ultramar,136,2,1,,3,"(6.171601,-75.427454)"
2013,Diciembre,Canadá,124,18,24,,42,"(10.445761,-75.516429)"
2013,Diciembre,Canadá,124,7,7,,14,"(10.886611,-74.776708)"
2013,Diciembre,Canadá,124,1,2,,3,"(12.586067,-81.702563)"
2013,Diciembre,Canadá,124,76,50,,126,"(3.541112,-76.384584)"
2013,Diciembre,Canadá,124,9,6,,15,"(4.452882,-75.766298)"
2013,Diciembre,Canadá,124,1152,949,,2101,"(4.697144,-74.140516)"
2013,Diciembre,Canadá,124,6,5,,11,"(4.815061,-75.736532)"
2013,Diciembre,Canadá,124,114,79,,193,"(6.171601,-75.427454)"
2013,Diciembre,Canadá,124,3,3,,6,"(7.128456,-73.183637)"
2013,Diciembre,Canadá,124,1,0,,1,"(7.927209,-72.507910)"
2013,Diciembre,España,724,1,0,,1,"(0.814836,-77.662532)"
2013,Diciembre,España,724,0,1,,1,"(10.445761,-75.516429)"
2013,Diciembre,España,724,1,0,,1,"(10.886611,-74.776708)"
2013,Diciembre,España,724,1090,707,,1797,"(3.541112,-76.384584)"
2013,Diciembre,España,724,7075,5119,,12194,"(4.697144,-74.140516)"
2013,Diciembre,España,724,664,478,,1142,"(6.171601,-75.427454)"
2013,Diciembre,Comoras,174,1,0,,1,"(4.697144,-74.140516)"
2013,Diciembre,República Democrática del Congo,180,1,5,,6,"(4.697144,-74.140516)"
2013,Diciembre,República de Corea,410,1,0,,1,"(3.541112,-76.384584)"
2013,Diciembre,República de Corea,410,10,8,,18,"(4.697144,-74.140516)"
2013,Diciembre,República de Corea,410,1,1,,2,"(6.171601,-75.427454)"
2013,Diciembre,Costa de Marfil,384,0,1,,1,"(3.541112,-76.384584)"
2013,Diciembre,Costa de Marfil,384,3,3,,6,"(4.697144,-74.140516)"
2013,Diciembre,Costa de Marfil,384,3,2,,5,"(6.171601,-75.427454)"
2013,Diciembre,Costa Rica,188,1,1,,2,"(10.408582,-75.538003)"
2013,Diciembre,Costa Rica,188,11,12,,23,"(10.445761,-75.516429)"
2013,Diciembre,Costa Rica,188,21,41,,62,"(10.886611,-74.776708)"
2013,Diciembre,Costa Rica,188,8,0,,8,"(12.586067,-81.702563)"
2013,Diciembre,Costa Rica,188,64,64,,128,"(3.541112,-76.384584)"
2013,Diciembre,Costa Rica,188,957,969,,1926,"(4.697144,-74.140516)"
2013,Diciembre,Costa Rica,188,10,9,,19,"(4.815061,-75.736532)"
2013,Diciembre,Costa Rica,188,84,104,,188,"(6.171601,-75.427454)"
2013,Diciembre,Costa Rica,188,1,0,,1,"(7.128456,-73.183637)"
2013,Diciembre,Costa Rica,188,1,1,,2,"(7.927209,-72.507910)"
2013,Diciembre,Croacia,191,2,2,,4,"(4.697144,-74.140516)"
2013,Diciembre,Cuba,192,27,22,,49,"(10.445761,-75.516429)"
2013,Diciembre,Cuba,192,30,19,,49,"(10.886611,-74.776708)"
2013,Diciembre,Cuba,192,134,96,,230,"(3.541112,-76.384584)"
2013,Diciembre,Cuba,192,1587,1348,,2935,"(4.697144,-74.140516)"
2013,Diciembre,Cuba,192,23,19,,42,"(4.815061,-75.736532)"
2013,Diciembre,Cuba,192,211,158,,369,"(6.171601,-75.427454)"
2013,Diciembre,Cuba,192,14,10,,24,"(7.128456,-73.183637)"
2013,Diciembre,Cuba,192,30,13,,43,"(7.927209,-72.507910)"
2013,Diciembre,Curazao,99999,0,5,,5,"(10.445761,-75.516429)"
2013,Diciembre,Curazao,99999,6,1,,7,"(10.886611,-74.776708)"
2013,Diciembre,Curazao,99999,11,5,,16,"(3.541112,-76.384584)"
2013,Diciembre,Curazao,99999,430,498,,928,"(4.697144,-74.140516)"
2013,Diciembre,Curazao,99999,164,109,,273,"(6.171601,-75.427454)"
2013,Diciembre,República Checa,203,1,0,,1,"(10.445761,-75.516429)"
2013,Diciembre,República Checa,203,0,1,,1,"(10.886611,-74.776708)"
2013,Diciembre,República Checa,203,1,0,,1,"(3.541112,-76.384584)"
2013,Diciembre,República Checa,203,1,2,,3,"(4.697144,-74.140516)"
2013,Diciembre,Chile,152,39,46,,85,"(0.814836,-77.662532)"
2013,Diciembre,Chile,152,15,15,,30,"(10.445761,-75.516429)"
2013,Diciembre,Chile,152,39,14,,53,"(10.886611,-74.776708)"
2013,Diciembre,Chile,152,611,427,,1038,"(3.541112,-76.384584)"
2013,Diciembre,Chile,152,4071,3084,,7155,"(4.697144,-74.140516)"
2013,Diciembre,Chile,152,13,9,,22,"(4.815061,-75.736532)"
2013,Diciembre,Chile,152,255,169,,424,"(6.171601,-75.427454)"
2013,Diciembre,Chile,152,5,2,,7,"(7.128456,-73.183637)"
2013,Diciembre,Chile,152,1,1,,2,"(7.927209,-72.507910)"
2013,Diciembre,China,156,2,0,,2,"(11.360009,-72.129330)"
2013,Diciembre,China,156,2,2,,4,"(3.541112,-76.384584)"
2013,Diciembre,China,156,118,138,,256,"(4.697144,-74.140516)"
2013,Diciembre,China,156,5,3,,8,"(6.171601,-75.427454)"
2013,Diciembre,Chipre,196,1,0,,1,"(4.697144,-74.140516)"
2013,Diciembre,Dinamarca,208,2,1,,3,"(10.445761,-75.516429)"
2013,Diciembre,Dinamarca,208,3,1,,4,"(3.541112,-76.384584)"
2013,Diciembre,Dinamarca,208,20,8,,28,"(4.697144,-74.140516)"
2013,Diciembre,Dinamarca,208,1,1,,2,"(6.171601,-75.427454)"
2013,Diciembre,Dominica,212,1,5,,6,"(4.697144,-74.140516)"
2013,Diciembre,Ecuador,218,684,642,,1326,"(0.25129,-76.875963)"
2013,Diciembre,Ecuador,218,12173,11795,,23968,"(0.814836,-77.662532)"
2013,Diciembre,Ecuador,218,165,156,,321,"(1.813928,-78.763924)"
2013,Diciembre,Ecuador,218,2,4,,6,"(10.445761,-75.516429)"
2013,Diciembre,Ecuador,218,1,7,,8,"(10.886611,-74.776708)"
2013,Diciembre,Ecuador,218,1115,888,,2003,"(3.541112,-76.384584)"
2013,Diciembre,Ecuador,218,3712,4370,,8082,"(4.697144,-74.140516)"
2013,Diciembre,Ecuador,218,1,0,,1,"(4.815061,-75.736532)"
2013,Diciembre,Ecuador,218,647,545,,1192,"(6.171601,-75.427454)"
2013,Diciembre,Ecuador,218,2,3,,5,"(7.128456,-73.183637)"
2013,Diciembre,Ecuador,218,1,0,,1,"(7.927209,-72.507910)"
2013,Diciembre,Egipto,818,0,1,,1,"(10.445761,-75.516429)"
2013,Diciembre,Egipto,818,2,2,,4,"(3.541112,-76.384584)"
2013,Diciembre,Egipto,818,58,43,,101,"(4.697144,-74.140516)"
2013,Diciembre,Egipto,818,0,1,,1,"(6.171601,-75.427454)"
2013,Diciembre,El Salvador,222,1,0,,1,"(10.445761,-75.516429)"
2013,Diciembre,El Salvador,222,1,2,,3,"(10.886611,-74.776708)"
2013,Diciembre,El Salvador,222,104,94,,198,"(3.541112,-76.384584)"
2013,Diciembre,El Salvador,222,1089,1059,,2148,"(4.697144,-74.140516)"
2013,Diciembre,El Salvador,222,115,137,,252,"(6.171601,-75.427454)"
2013,Diciembre,Emiratos Árabes,784,0,1,,1,"(10.445761,-75.516429)"
2013,Diciembre,Emiratos Árabes,784,1,1,,2,"(10.886611,-74.776708)"
2013,Diciembre,Emiratos Árabes,784,135,233,,368,"(4.697144,-74.140516)"
2013,Diciembre,Emiratos Árabes,784,4,1,,5,"(6.171601,-75.427454)"
2013,Diciembre,Eritrea,232,1,0,,1,"(4.697144,-74.140516)"
2013,Diciembre,Eslovaquia,703,1,1,,2,"(4.697144,-74.140516)"
2013,Diciembre,Eslovenia,705,0,1,,1,"(4.697144,-74.140516)"
2013,Diciembre,Estados Unidos de América,840,1,0,,1,"(10.408582,-75.538003)"
2013,Diciembre,Estados Unidos de América,840,3170,2672,,5842,"(10.445761,-75.516429)"
2013,Diciembre,Estados Unidos de América,840,3001,2384,,5385,"(10.886611,-74.776708)"
2013,Diciembre,Estados Unidos de América,840,26,20,,46,"(12.586067,-81.702563)"
2013,Diciembre,Estados Unidos de América,840,6486,4960,,11446,"(3.541112,-76.384584)"
2013,Diciembre,Estados Unidos de América,840,601,444,,1045,"(4.452882,-75.766298)"
2013,Diciembre,Estados Unidos de América,840,43443,36866,,80309,"(4.697144,-74.140516)"
2013,Diciembre,Estados Unidos de América,840,742,490,,1232,"(4.815061,-75.736532)"
2013,Diciembre,Estados Unidos de América,840,12017,9378,,21395,"(6.171601,-75.427454)"
2013,Diciembre,Estados Unidos de América,840,223,184,,407,"(7.128456,-73.183637)"
2013,Diciembre,Estados Unidos de América,840,183,139,,322,"(7.927209,-72.507910)"
2013,Diciembre,Estonia,233,0,1,,1,"(4.697144,-74.140516)"
2013,Diciembre,Etiopia,231,0,2,,2,"(4.697144,-74.140516)"
2013,Diciembre,Filipinas,608,2,5,,7,"(10.408582,-75.538003)"
2013,Diciembre,Filipinas,608,1,1,,2,"(4.697144,-74.140516)"
2013,Diciembre,Filipinas,608,0,1,,1,"(6.171601,-75.427454)"
2013,Diciembre,Finlandia,246,5,4,,9,"(4.697144,-74.140516)"
2013,Diciembre,Finlandia,246,1,0,,1,"(6.171601,-75.427454)"
2013,Diciembre,Francia,250,3,3,,6,"(10.445761,-75.516429)"
2013,Diciembre,Francia,250,2,1,,3,"(10.886611,-74.776708)"
2013,Diciembre,Francia,250,31,15,,46,"(3.541112,-76.384584)"
2013,Diciembre,Francia,250,1482,1137,,2619,"(4.697144,-74.140516)"
2013,Diciembre,Francia,250,1,2,,3,"(4.815061,-75.736532)"
2013,Diciembre,Francia,250,43,22,,65,"(6.171601,-75.427454)"
2013,Diciembre,Gabón,266,0,4,,4,"(4.697144,-74.140516)"
2013,Diciembre,Gibraltar/Territorio Británico de Ultramar,292,1,0,,1,"(4.697144,-74.140516)"
2013,Diciembre,Granada,308,0,1,,1,"(4.697144,-74.140516)"
2013,Diciembre,Grecia,300,8,2,,10,"(4.697144,-74.140516)"
2013,Diciembre,Guatemala,320,6,2,,8,"(10.445761,-75.516429)"
2013,Diciembre,Guatemala,320,3,1,,4,"(10.886611,-74.776708)"
2013,Diciembre,Guatemala,320,1,3,,4,"(12.586067,-81.702563)"
2013,Diciembre,Guatemala,320,47,45,,92,"(3.541112,-76.384584)"
2013,Diciembre,Guatemala,320,461,516,,977,"(4.697144,-74.140516)"
2013,Diciembre,Guatemala,320,10,4,,14,"(4.815061,-75.736532)"
2013,Diciembre,Guatemala,320,81,71,,152,"(6.171601,-75.427454)"
2013,Diciembre,Guatemala,320,1,2,,3,"(7.128456,-73.183637)"
2013,Diciembre,Guatemala,320,1,0,,1,"(7.927209,-72.507910)"
2013,Diciembre,Guyana,328,1,2,,3,"(10.886611,-74.776708)"
2013,Diciembre,Guyana,328,1,0,,1,"(3.541112,-76.384584)"
2013,Diciembre,Guyana,328,0,3,,3,"(4.697144,-74.140516)"
2013,Diciembre,Guyana,328,0,1,,1,"(4.815061,-75.736532)"
2013,Diciembre,Guinea Ecuatorial,226,0,9,,9,"(4.697144,-74.140516)"
2013,Diciembre,Guadalupe/Territorio Francés,312,2,0,,2,"(4.697144,-74.140516)"
2013,Diciembre,Haití,332,0,5,,5,"(10.886611,-74.776708)"
2013,Diciembre,Haití,332,3,19,,22,"(4.697144,-74.140516)"
2013,Diciembre,Haití,332,0,2,,2,"(6.171601,-75.427454)"
2013,Diciembre,Honduras,340,2,10,,12,"(10.445761,-75.516429)"
2013,Diciembre,Honduras,340,4,3,,7,"(10.886611,-74.776708)"
2013,Diciembre,Honduras,340,25,15,,40,"(3.541112,-76.384584)"
2013,Diciembre,Honduras,340,60,104,,164,"(4.697144,-74.140516)"
2013,Diciembre,Honduras,340,2,2,,4,"(4.815061,-75.736532)"
2013,Diciembre,Honduras,340,40,44,,84,"(6.171601,-75.427454)"
2013,Diciembre,Honduras,340,2,5,,7,"(7.128456,-73.183637)"
2013,Diciembre,Honduras,340,1,0,,1,"(7.927209,-72.507910)"
2013,Diciembre,Hong Kong,344,0,1,,1,"(3.541112,-76.384584)"
2013,Diciembre,Hong Kong,344,32,36,,68,"(4.697144,-74.140516)"
2013,Diciembre,Hong Kong,344,2,1,,3,"(6.171601,-75.427454)"
2013,Diciembre,Hungría,348,1,1,,2,"(3.541112,-76.384584)"
2013,Diciembre,Hungría,348,4,6,,10,"(4.697144,-74.140516)"
2013,Diciembre,Hungría,348,0,1,,1,"(7.128456,-73.183637)"
2013,Diciembre,India,356,1,3,,4,"(3.541112,-76.384584)"
2013,Diciembre,India,356,75,42,,117,"(4.697144,-74.140516)"
2013,Diciembre,India,356,7,5,,12,"(6.171601,-75.427454)"
2013,Diciembre,India,356,0,1,,1,"(7.128456,-73.183637)"
2013,Diciembre,Indonesia,360,4,9,,13,"(4.697144,-74.140516)"
2013,Diciembre,Iraq,368,3,10,,13,"(4.697144,-74.140516)"
2013,Diciembre,Iraq,368,0,1,,1,"(6.171601,-75.427454)"
2013,Diciembre,Irán,364,7,7,,14,"(4.697144,-74.140516)"
2013,Diciembre,República de Irlanda,372,11,6,,17,"(4.697144,-74.140516)"
2013,Diciembre,República de Irlanda,372,1,0,,1,"(6.171601,-75.427454)"
2013,Diciembre,Islandia,352,1,0,,1,"(3.541112,-76.384584)"
2013,Diciembre,Islandia,352,2,0,,2,"(4.697144,-74.140516)"
2013,Diciembre,Islandia,352,1,0,,1,"(6.171601,-75.427454)"
2013,Diciembre,Israel,376,2,1,,3,"(10.445761,-75.516429)"
2013,Diciembre,Israel,376,1,1,,2,"(10.886611,-74.776708)"
2013,Diciembre,Israel,376,3,2,,5,"(3.541112,-76.384584)"
2013,Diciembre,Israel,376,151,103,,254,"(4.697144,-74.140516)"
2013,Diciembre,Israel,376,11,3,,14,"(6.171601,-75.427454)"
2013,Diciembre,Italia,380,2,0,,2,"(10.445761,-75.516429)"
2013,Diciembre,Italia,380,2,0,,2,"(10.886611,-74.776708)"
2013,Diciembre,Italia,380,28,15,,43,"(3.541112,-76.384584)"
2013,Diciembre,Italia,380,562,328,,890,"(4.697144,-74.140516)"
2013,Diciembre,Italia,380,22,17,,39,"(6.171601,-75.427454)"
2013,Diciembre,Jamaica,388,1,7,,8,"(10.445761,-75.516429)"
2013,Diciembre,Jamaica,388,1,1,,2,"(10.886611,-74.776708)"
2013,Diciembre,Jamaica,388,14,21,,35,"(12.586067,-81.702563)"
2013,Diciembre,Jamaica,388,17,12,,29,"(3.541112,-76.384584)"
2013,Diciembre,Jamaica,388,41,46,,87,"(4.697144,-74.140516)"
2013,Diciembre,Jamaica,388,3,3,,6,"(4.815061,-75.736532)"
2013,Diciembre,Jamaica,388,26,24,,50,"(6.171601,-75.427454)"
2013,Diciembre,Jamaica,388,9,9,,18,"(7.128456,-73.183637)"
2013,Diciembre,Jamaica,388,1,5,,6,"(7.927209,-72.507910)"
2013,Diciembre,Japón,392,2,2,,4,"(3.541112,-76.384584)"
2013,Diciembre,Japón,392,47,43,,90,"(4.697144,-74.140516)"
2013,Diciembre,Japón,392,3,2,,5,"(6.171601,-75.427454)"
2013,Diciembre,Jordania,400,6,7,,13,"(4.697144,-74.140516)"
2013,Diciembre,Kazajistán,398,0,1,,1,"(4.697144,-74.140516)"
2013,Diciembre,Kenia,404,4,4,,8,"(4.697144,-74.140516)"
2013,Diciembre,Kenia,404,1,1,,2,"(6.171601,-75.427454)"
2013,Diciembre,Kuwait,414,1,4,,5,"(4.697144,-74.140516)"
2013,Diciembre,Lituania,440,0,1,,1,"(4.697144,-74.140516)"
2013,Diciembre,Líbano,422,6,9,,15,"(4.697144,-74.140516)"
2013,Diciembre,Libia,434,0,1,,1,"(4.697144,-74.140516)"
2013,Diciembre,Luxemburgo,442,1,2,,3,"(4.697144,-74.140516)"
2013,Diciembre,Macedonia,807,1,0,,1,"(4.697144,-74.140516)"
2013,Diciembre,Malasia,458,0,1,,1,"(3.541112,-76.384584)"
2013,Diciembre,Malasia,458,10,3,,13,"(4.697144,-74.140516)"
2013,Diciembre,Malasia,458,0,3,,3,"(6.171601,-75.427454)"
2013,Diciembre,Malta,470,2,1,,3,"(4.697144,-74.140516)"
2013,Diciembre,Marruecos,504,10,14,,24,"(4.697144,-74.140516)"
2013,Diciembre,Islas Marshall,584,1,0,,1,"(4.697144,-74.140516)"
2013,Diciembre,Mauricio,480,1,0,,1,"(4.697144,-74.140516)"
2013,Diciembre,México,484,5,2,,7,"(0.814836,-77.662532)"
2013,Diciembre,México,484,0,3,,3,"(10.408582,-75.538003)"
2013,Diciembre,México,484,61,49,,110,"(10.445761,-75.516429)"
2013,Diciembre,México,484,120,96,,216,"(10.886611,-74.776708)"
2013,Diciembre,México,484,2,6,,8,"(12.586067,-81.702563)"
2013,Diciembre,México,484,572,480,,1052,"(3.541112,-76.384584)"
2013,Diciembre,México,484,10351,8794,,19145,"(4.697144,-74.140516)"
2013,Diciembre,México,484,138,76,,214,"(4.815061,-75.736532)"
2013,Diciembre,México,484,1928,1344,,3272,"(6.171601,-75.427454)"
2013,Diciembre,México,484,67,57,,124,"(7.128456,-73.183637)"
2013,Diciembre,México,484,149,113,,262,"(7.927209,-72.507910)"
2013,Diciembre,Mónaco,492,1,0,,1,"(6.171601,-75.427454)"
2013,Diciembre,Mozambique,508,1,0,,1,"(4.697144,-74.140516)"
2013,Diciembre,Nauru,520,1,0,,1,"(4.697144,-74.140516)"
2013,Diciembre,Namibia,516,1,1,,2,"(4.697144,-74.140516)"
2013,Diciembre,Nepal,524,0,1,,1,"(4.697144,-74.140516)"
2013,Diciembre,Nicaragua,558,3,0,,3,"(10.445761,-75.516429)"
2013,Diciembre,Nicaragua,558,0,2,,2,"(10.886611,-74.776708)"
2013,Diciembre,Nicaragua,558,8,15,,23,"(3.541112,-76.384584)"
2013,Diciembre,Nicaragua,558,18,36,,54,"(4.697144,-74.140516)"
2013,Diciembre,Nicaragua,558,2,1,,3,"(4.815061,-75.736532)"
2013,Diciembre,Nicaragua,558,13,15,,28,"(6.171601,-75.427454)"
2013,Diciembre,Nicaragua,558,0,1,,1,"(7.927209,-72.507910)"
2013,Diciembre,Nigeria,566,0,1,,1,"(10.445761,-75.516429)"
2013,Diciembre,Nigeria,566,0,4,,4,"(4.697144,-74.140516)"
2013,Diciembre,Níger,562,0,3,,3,"(4.697144,-74.140516)"
2013,Diciembre,Noruega,578,1,0,,1,"(10.445761,-75.516429)"
2013,Diciembre,Noruega,578,0,1,,1,"(10.886611,-74.776708)"
2013,Diciembre,Noruega,578,2,0,,2,"(3.541112,-76.384584)"
2013,Diciembre,Noruega,578,20,17,,37,"(4.697144,-74.140516)"
2013,Diciembre,Noruega,578,5,1,,6,"(6.171601,-75.427454)"
2013,Diciembre,Nueva Zelanda,554,17,17,,34,"(4.697144,-74.140516)"
2013,Diciembre,Nueva Zelanda,554,2,0,,2,"(6.171601,-75.427454)"
2013,Diciembre,Omán,512,1,4,,5,"(4.697144,-74.140516)"
2013,Diciembre,Omán,512,1,0,,1,"(6.171601,-75.427454)"
2013,Diciembre,Papúa Nueva Guinea,598,0,5,,5,"(4.697144,-74.140516)"
2013,Diciembre,Pakistán,586,1,2,,3,"(4.697144,-74.140516)"
2013,Diciembre,Panamá,591,306,305,,611,"(10.408582,-75.538003)"
2013,Diciembre,Panamá,591,517,498,,1015,"(10.445761,-75.516429)"
2013,Diciembre,Panamá,591,1062,991,,2053,"(10.886611,-74.776708)"
2013,Diciembre,Panamá,591,0,2,,2,"(10.971302,-74.765397)"
2013,Diciembre,Panamá,591,159,125,,284,"(12.586067,-81.702563)"
2013,Diciembre,Panamá,591,2417,2089,,4506,"(3.541112,-76.384584)"
2013,Diciembre,Panamá,591,9289,8555,,17844,"(4.697144,-74.140516)"
2013,Diciembre,Panamá,591,739,509,,1248,"(4.815061,-75.736532)"
2013,Diciembre,Panamá,591,3124,2508,,5632,"(6.171601,-75.427454)"
2013,Diciembre,Panamá,591,543,497,,1040,"(7.128456,-73.183637)"
2013,Diciembre,Panamá,591,227,198,,425,"(7.927209,-72.507910)"
2013,Diciembre,Panamá,591,2,56,,58,"(8.066966,-76.735404)"
2013,Diciembre,Panamá,591,71,105,,176,"(8.635765,-77.346578)"
2013,Diciembre,Paraguay,600,4,1,,5,"(10.445761,-75.516429)"
2013,Diciembre,Paraguay,600,1,5,,6,"(10.886611,-74.776708)"
2013,Diciembre,Paraguay,600,16,10,,26,"(3.541112,-76.384584)"
2013,Diciembre,Paraguay,600,59,104,,163,"(4.697144,-74.140516)"
2013,Diciembre,Paraguay,600,2,1,,3,"(4.815061,-75.736532)"
2013,Diciembre,Paraguay,600,3,8,,11,"(6.171601,-75.427454)"
2013,Diciembre,Paraguay,600,0,1,,1,"(7.927209,-72.507910)"
2013,Diciembre,Perú,604,167,157,,324,"(-4.197703,-69.941278)"
2013,Diciembre,Perú,604,77,75,,152,"(0.814836,-77.662532)"
2013,Diciembre,Perú,604,12,17,,29,"(10.445761,-75.516429)"
2013,Diciembre,Perú,604,26,23,,49,"(10.886611,-74.776708)"
2013,Diciembre,Perú,604,371,328,,699,"(3.541112,-76.384584)"
2013,Diciembre,Perú,604,4349,4179,,8528,"(4.697144,-74.140516)"
2013,Diciembre,Perú,604,9,4,,13,"(4.815061,-75.736532)"
2013,Diciembre,Perú,604,573,600,,1173,"(6.171601,-75.427454)"
2013,Diciembre,Perú,604,1,1,,2,"(7.128456,-73.183637)"
2013,Diciembre,Perú,604,3,12,,15,"(7.927209,-72.507910)"
2013,Diciembre,Palestina,99999,1,0,,1,"(10.445761,-75.516429)"
2013,Diciembre,Palestina,99999,0,1,,1,"(4.697144,-74.140516)"
2013,Diciembre,Polonia,616,9,12,,21,"(4.697144,-74.140516)"
2013,Diciembre,Portugal,620,2,0,,2,"(3.541112,-76.384584)"
2013,Diciembre,Portugal,620,35,29,,64,"(4.697144,-74.140516)"
2013,Diciembre,Portugal,620,1,2,,3,"(6.171601,-75.427454)"
2013,Diciembre,Puerto Rico/Territorio de Estados Unidos,630,8,4,,12,"(10.445761,-75.516429)"
2013,Diciembre,Puerto Rico/Territorio de Estados Unidos,630,19,18,,37,"(10.886611,-74.776708)"
2013,Diciembre,Puerto Rico/Territorio de Estados Unidos,630,1,1,,2,"(12.586067,-81.702563)"
2013,Diciembre,Puerto Rico/Territorio de Estados Unidos,630,68,47,,115,"(3.541112,-76.384584)"
2013,Diciembre,Puerto Rico/Territorio de Estados Unidos,630,572,487,,1059,"(4.697144,-74.140516)"
2013,Diciembre,Puerto Rico/Territorio de Estados Unidos,630,10,0,,10,"(4.815061,-75.736532)"
2013,Diciembre,Puerto Rico/Territorio de Estados Unidos,630,83,63,,146,"(6.171601,-75.427454)"
2013,Diciembre,Puerto Rico/Territorio de Estados Unidos,630,12,6,,18,"(7.128456,-73.183637)"
2013,Diciembre,Qatar,634,9,6,,15,"(4.697144,-74.140516)"
2013,Diciembre,Reino Unido de Gran Bretaña e Irlanda del Norte,826,0,1,,1,"(10.445761,-75.516429)"
2013,Diciembre,Reino Unido de Gran Bretaña e Irlanda del Norte,826,2,0,,2,"(10.886611,-74.776708)"
2013,Diciembre,Reino Unido de Gran Bretaña e Irlanda del Norte,826,31,17,,48,"(3.541112,-76.384584)"
2013,Diciembre,Reino Unido de Gran Bretaña e Irlanda del Norte,826,518,366,,884,"(4.697144,-74.140516)"
2013,Diciembre,Reino Unido de Gran Bretaña e Irlanda del Norte,826,1,0,,1,"(4.815061,-75.736532)"
2013,Diciembre,Reino Unido de Gran Bretaña e Irlanda del Norte,826,26,13,,39,"(6.171601,-75.427454)"
2013,Diciembre,Federación de Rusia,643,0,1,,1,"(3.541112,-76.384584)"
2013,Diciembre,Federación de Rusia,643,29,46,,75,"(4.697144,-74.140516)"
2013,Diciembre,República Dominicana,214,1,2,,3,"(10.408582,-75.538003)"
2013,Diciembre,República Dominicana,214,19,25,,44,"(10.445761,-75.516429)"
2013,Diciembre,República Dominicana,214,39,27,,66,"(10.886611,-74.776708)"
2013,Diciembre,República Dominicana,214,107,89,,196,"(3.541112,-76.384584)"
2013,Diciembre,República Dominicana,214,1937,1825,,3762,"(4.697144,-74.140516)"
2013,Diciembre,República Dominicana,214,25,18,,43,"(4.815061,-75.736532)"
2013,Diciembre,República Dominicana,214,197,155,,352,"(6.171601,-75.427454)"
2013,Diciembre,República Dominicana,214,15,12,,27,"(7.128456,-73.183637)"
2013,Diciembre,República Dominicana,214,7,17,,24,"(7.927209,-72.507910)"
2013,Diciembre,República Democrática Popular de Corea,408,0,1,,1,"(4.697144,-74.140516)"
2013,Diciembre,Rumania,642,4,5,,9,"(4.697144,-74.140516)"
2013,Diciembre,Rwanda,646,1,0,,1,"(4.697144,-74.140516)"
2013,Diciembre,San Cristóbal y Nevis,659,0,1,,1,"(4.697144,-74.140516)"
2013,Diciembre,San  Vicente y las Granadinas,670,1,0,,1,"(6.171601,-75.427454)"
2013,Diciembre,Santa Sede/Ciudad del Vaticano,336,1,1,,2,"(4.697144,-74.140516)"
2013,Diciembre,Senegal,686,0,2,,2,"(4.697144,-74.140516)"
2013,Diciembre,Singapur,702,1,0,,1,"(3.541112,-76.384584)"
2013,Diciembre,Singapur,702,14,13,,27,"(4.697144,-74.140516)"
2013,Diciembre,Singapur,702,1,0,,1,"(6.171601,-75.427454)"
2013,Diciembre,Somalia,706,0,1,,1,"(10.886611,-74.776708)"
2013,Diciembre,Sudáfrica,710,24,28,,52,"(4.697144,-74.140516)"
2013,Diciembre,Sudáfrica,710,1,0,,1,"(6.171601,-75.427454)"
2013,Diciembre,Sudán,736,0,1,,1,"(6.171601,-75.427454)"
2013,Diciembre,Suecia,752,0,1,,1,"(10.445761,-75.516429)"
2013,Diciembre,Suecia,752,3,0,,3,"(10.886611,-74.776708)"
2013,Diciembre,Suecia,752,5,5,,10,"(3.541112,-76.384584)"
2013,Diciembre,Suecia,752,49,27,,76,"(4.697144,-74.140516)"
2013,Diciembre,Suecia,752,2,1,,3,"(6.171601,-75.427454)"
2013,Diciembre,Suiza,756,0,1,,1,"(10.445761,-75.516429)"
2013,Diciembre,Suiza,756,15,6,,21,"(3.541112,-76.384584)"
2013,Diciembre,Suiza,756,231,174,,405,"(4.697144,-74.140516)"
2013,Diciembre,Suiza,756,10,5,,15,"(6.171601,-75.427454)"
2013,Diciembre,Surinam,740,12,27,,39,"(4.697144,-74.140516)"
2013,Diciembre,Surinam,740,5,0,,5,"(6.171601,-75.427454)"
2013,Diciembre,Taiwán,158,5,3,,8,"(4.697144,-74.140516)"
2013,Diciembre,Tailandia,764,44,46,,90,"(4.697144,-74.140516)"
2013,Diciembre,Tanzania,834,0,1,,1,"(4.697144,-74.140516)"
2013,Diciembre,Trinidad y Tobago,780,1,1,,2,"(10.445761,-75.516429)"
2013,Diciembre,Trinidad y Tobago,780,1,3,,4,"(10.886611,-74.776708)"
2013,Diciembre,Trinidad y Tobago,780,6,6,,12,"(3.541112,-76.384584)"
2013,Diciembre,Trinidad y Tobago,780,28,33,,61,"(4.697144,-74.140516)"
2013,Diciembre,Trinidad y Tobago,780,3,6,,9,"(4.815061,-75.736532)"
2013,Diciembre,Trinidad y Tobago,780,8,9,,17,"(6.171601,-75.427454)"
2013,Diciembre,Trinidad y Tobago,780,2,0,,2,"(7.128456,-73.183637)"
2013,Diciembre,Trinidad y Tobago,780,2,0,,2,"(7.927209,-72.507910)"
2013,Diciembre,Túnez,788,1,0,,1,"(4.697144,-74.140516)"
2013,Diciembre,Turquía,792,3,3,,6,"(3.541112,-76.384584)"
2013,Diciembre,Turquía,792,83,54,,137,"(4.697144,-74.140516)"
2013,Diciembre,Turkmenistán,795,1,0,,1,"(4.697144,-74.140516)"
2013,Diciembre,Ucrania,804,7,6,,13,"(4.697144,-74.140516)"
2013,Diciembre,Uruguay,858,1,1,,2,"(10.445761,-75.516429)"
2013,Diciembre,Uruguay,858,5,1,,6,"(10.886611,-74.776708)"
2013,Diciembre,Uruguay,858,16,4,,20,"(3.541112,-76.384584)"
2013,Diciembre,Uruguay,858,79,69,,148,"(4.697144,-74.140516)"
2013,Diciembre,Uruguay,858,3,0,,3,"(4.815061,-75.736532)"
2013,Diciembre,Uruguay,858,24,18,,42,"(6.171601,-75.427454)"
2013,Diciembre,Venezuela,862,0,1,,1,"(10.408582,-75.538003)"
2013,Diciembre,Venezuela,862,10,5,,15,"(10.445761,-75.516429)"
2013,Diciembre,Venezuela,862,6,11,,17,"(10.886611,-74.776708)"
2013,Diciembre,Venezuela,862,0,7,,7,"(10.971302,-74.765397)"
2013,Diciembre,Venezuela,862,16207,12724,,28931,"(11.360009,-72.129330)"
2013,Diciembre,Venezuela,862,1,0,,1,"(12.586067,-81.702563)"
2013,Diciembre,Venezuela,862,8,5,,13,"(3.541112,-76.384584)"
2013,Diciembre,Venezuela,862,1967,1902,,3869,"(4.697144,-74.140516)"
2013,Diciembre,Venezuela,862,2,1,,3,"(4.815061,-75.736532)"
2013,Diciembre,Venezuela,862,193,163,,356,"(6.171601,-75.427454)"
2013,Diciembre,Venezuela,862,799,717,,1516,"(6.185799,-67.483929)"
2013,Diciembre,Venezuela,862,2872,2492,,5364,"(7.088729,-70.740253)"
2013,Diciembre,Venezuela,862,95,86,,181,"(7.128456,-73.183637)"
2013,Diciembre,Venezuela,862,12192,10369,,22561,"(7.818934,-72.453226)"
2013,Diciembre,Venezuela,862,0,6,,6,"(7.927209,-72.507910)"
2013,Diciembre,Vietnam,704,2,5,,7,"(4.697144,-74.140516)"
2013,Diciembre,Islas Vírgenes Británicas/Territorio Británico de Ultramar,92,1,0,,1,"(4.697144,-74.140516)"
2013,Diciembre,República Árabe de Yemen,887,1,0,,1,"(4.697144,-74.140516)"
2014,Enero,Afganistán,4,3,28,,31,"(4.697144,-74.140516)"
2014,Enero,Alemania,276,2,1,,3,"(0.814836,-77.662532)"
2014,Enero,Alemania,276,1,2,,3,"(10.445761,-75.516429)"
2014,Enero,Alemania,276,3,7,,10,"(10.886611,-74.776708)"
2014,Enero,Alemania,276,26,23,,49,"(3.541112,-76.384584)"
2014,Enero,Alemania,276,1223,1042,,2265,"(4.697144,-74.140516)"
2014,Enero,Alemania,276,1,0,,1,"(4.815061,-75.736532)"
2014,Enero,Alemania,276,26,20,,46,"(6.171601,-75.427454)"
2014,Enero,Alemania,276,0,1,,1,"(7.128456,-73.183637)"
2014,Enero,Andorra,20,4,4,,8,"(4.697144,-74.140516)"
2014,Enero,Angola,24,0,1,,1,"(10.445761,-75.516429)"
2014,Enero,Angola,24,11,27,,38,"(4.697144,-74.140516)"
2014,Enero,Angola,24,1,1,,2,"(6.171601,-75.427454)"
2014,Enero,Antigua y Barbuda,28,1,0,,1,"(4.697144,-74.140516)"
2014,Enero,Antigua y Barbuda,28,0,1,,1,"(6.171601,-75.427454)"
2014,Enero,Países Bajos,528,72,58,,130,"(10.408582,-75.538003)"
2014,Enero,Países Bajos,528,8,3,,11,"(10.445761,-75.516429)"
2014,Enero,Países Bajos,528,4,1,,5,"(10.886611,-74.776708)"
2014,Enero,Países Bajos,528,59,21,,80,"(3.541112,-76.384584)"
2014,Enero,Países Bajos,528,228,140,,368,"(4.697144,-74.140516)"
2014,Enero,Países Bajos,528,6,2,,8,"(4.815061,-75.736532)"
2014,Enero,Países Bajos,528,68,59,,127,"(6.171601,-75.427454)"
2014,Enero,Países Bajos,528,4,1,,5,"(7.128456,-73.183637)"
2014,Enero,Arabia Saudita,682,1,2,,3,"(10.445761,-75.516429)"
2014,Enero,Arabia Saudita,682,1,0,,1,"(3.541112,-76.384584)"
2014,Enero,Arabia Saudita,682,15,61,,76,"(4.697144,-74.140516)"
2014,Enero,Arabia Saudita,682,0,3,,3,"(6.171601,-75.427454)"
2014,Enero,Arabia Saudita,682,2,1,,3,"(7.128456,-73.183637)"
2014,Enero,Argelia,12,1,0,,1,"(3.541112,-76.384584)"
2014,Enero,Argelia,12,0,6,,6,"(4.697144,-74.140516)"
2014,Enero,Argelia,12,0,1,,1,"(6.171601,-75.427454)"
2014,Enero,Argentina,32,9,15,,24,"(0.814836,-77.662532)"
2014,Enero,Argentina,32,24,33,,57,"(10.445761,-75.516429)"
2014,Enero,Argentina,32,23,20,,43,"(10.886611,-74.776708)"
2014,Enero,Argentina,32,0,1,,1,"(12.586067,-81.702563)"
2014,Enero,Argentina,32,180,203,,383,"(3.541112,-76.384584)"
2014,Enero,Argentina,32,3367,3168,,6535,"(4.697144,-74.140516)"
2014,Enero,Argentina,32,4,3,,7,"(4.815061,-75.736532)"
2014,Enero,Argentina,32,204,185,,389,"(6.171601,-75.427454)"
2014,Enero,Argentina,32,1,3,,4,"(7.128456,-73.183637)"
2014,Enero,Argentina,32,2,2,,4,"(7.927209,-72.507910)"
2014,Enero,Aruba,533,2615,2063,,4678,"(10.408582,-75.538003)"
2014,Enero,Aruba,533,2,3,,5,"(10.445761,-75.516429)"
2014,Enero,Aruba,533,32,25,,57,"(10.886611,-74.776708)"
2014,Enero,Aruba,533,0,1,,1,"(10.971302,-74.765397)"
2014,Enero,Aruba,533,98,65,,163,"(11.528919,-72.919681)"
2014,Enero,Aruba,533,35,28,,63,"(3.541112,-76.384584)"
2014,Enero,Aruba,533,1818,1554,,3372,"(4.697144,-74.140516)"
2014,Enero,Aruba,533,2,2,,4,"(4.815061,-75.736532)"
2014,Enero,Aruba,533,55,38,,93,"(6.171601,-75.427454)"
2014,Enero,Aruba,533,2,8,,10,"(7.128456,-73.183637)"
2014,Enero,Australia,36,3,0,,3,"(10.445761,-75.516429)"
2014,Enero,Australia,36,0,2,,2,"(10.886611,-74.776708)"
2014,Enero,Australia,36,35,22,,57,"(3.541112,-76.384584)"
2014,Enero,Australia,36,481,386,,867,"(4.697144,-74.140516)"
2014,Enero,Australia,36,3,2,,5,"(4.815061,-75.736532)"
2014,Enero,Australia,36,81,62,,143,"(6.171601,-75.427454)"
2014,Enero,Australia,36,7,5,,12,"(7.128456,-73.183637)"
2014,Enero,Austria,40,32,24,,56,"(4.697144,-74.140516)"
2014,Enero,Austria,40,2,1,,3,"(6.171601,-75.427454)"
2014,Enero,Azerbaiyán,31,2,4,,6,"(4.697144,-74.140516)"
2014,Enero,Bahamas,44,2,1,,3,"(10.408582,-75.538003)"
2014,Enero,Bahamas,44,5,4,,9,"(10.445761,-75.516429)"
2014,Enero,Bahamas,44,3,5,,8,"(10.886611,-74.776708)"
2014,Enero,Bahamas,44,13,6,,19,"(3.541112,-76.384584)"
2014,Enero,Bahamas,44,18,23,,41,"(4.697144,-74.140516)"
2014,Enero,Bahamas,44,1,2,,3,"(4.815061,-75.736532)"
2014,Enero,Bahamas,44,30,41,,71,"(6.171601,-75.427454)"
2014,Enero,Bahamas,44,2,3,,5,"(7.128456,-73.183637)"
2014,Enero,Bahamas,44,3,0,,3,"(7.927209,-72.507910)"
2014,Enero,Bahréin,48,3,5,,8,"(4.697144,-74.140516)"
2014,Enero,Bahréin,48,1,1,,2,"(6.171601,-75.427454)"
2014,Enero,Bangladesh,50,2,0,,2,"(4.697144,-74.140516)"
2014,Enero,Barbados,52,0,1,,1,"(3.541112,-76.384584)"
2014,Enero,Barbados,52,2,16,,18,"(4.697144,-74.140516)"
2014,Enero,República de Belarús,112,7,4,,11,"(11.360009,-72.129330)"
2014,Enero,República de Belarús,112,0,1,,1,"(4.697144,-74.140516)"
2014,Enero,Bélgica,56,0,1,,1,"(10.886611,-74.776708)"
2014,Enero,Bélgica,56,16,8,,24,"(3.541112,-76.384584)"
2014,Enero,Bélgica,56,128,83,,211,"(4.697144,-74.140516)"
2014,Enero,Bélgica,56,14,11,,25,"(6.171601,-75.427454)"
2014,Enero,Belice,84,5,4,,9,"(4.697144,-74.140516)"
2014,Enero,Benín,204,0,4,,4,"(4.697144,-74.140516)"
2014,Enero,Bermudas/Territorio Británico de Ultramar,60,1,0,,1,"(4.697144,-74.140516)"
2014,Enero,Bermudas/Territorio Británico de Ultramar,60,1,2,,3,"(6.171601,-75.427454)"
2014,Enero,Bolivia,68,5,10,,15,"(0.814836,-77.662532)"
2014,Enero,Bolivia,68,0,1,,1,"(10.445761,-75.516429)"
2014,Enero,Bolivia,68,3,5,,8,"(10.886611,-74.776708)"
2014,Enero,Bolivia,68,25,54,,79,"(3.541112,-76.384584)"
2014,Enero,Bolivia,68,348,530,,878,"(4.697144,-74.140516)"
2014,Enero,Bolivia,68,1,2,,3,"(4.815061,-75.736532)"
2014,Enero,Bolivia,68,33,54,,87,"(6.171601,-75.427454)"
2014,Enero,Botsuana,72,1,0,,1,"(4.697144,-74.140516)"
2014,Enero,Brasil,76,108,238,,346,"(-4.197703,-69.941278)"
2014,Enero,Brasil,76,1,5,,6,"(0.814836,-77.662532)"
2014,Enero,Brasil,76,14,152,,166,"(10.408582,-75.538003)"
2014,Enero,Brasil,76,3,19,,22,"(10.445761,-75.516429)"
2014,Enero,Brasil,76,4,11,,15,"(10.886611,-74.776708)"
2014,Enero,Brasil,76,1,1,,2,"(11.360009,-72.129330)"
2014,Enero,Brasil,76,73,104,,177,"(3.541112,-76.384584)"
2014,Enero,Brasil,76,3276,3793,,7069,"(4.697144,-74.140516)"
2014,Enero,Brasil,76,0,6,,6,"(4.815061,-75.736532)"
2014,Enero,Brasil,76,79,110,,189,"(6.171601,-75.427454)"
2014,Enero,Brasil,76,1,0,,1,"(7.088729,-70.740253)"
2014,Enero,Brasil,76,1,2,,3,"(7.128456,-73.183637)"
2014,Enero,Brasil,76,0,2,,2,"(7.927209,-72.507910)"
2014,Enero,Bulgaria,100,2,6,,8,"(4.697144,-74.140516)"
2014,Enero,Burundi,108,0,1,,1,"(4.697144,-74.140516)"
2014,Enero,Cabo Verde,132,1,1,,2,"(4.697144,-74.140516)"
2014,Enero,Islas Caimán/Territorio Británico de Ultramar,136,0,2,,2,"(10.445761,-75.516429)"
2014,Enero,Islas Caimán/Territorio Británico de Ultramar,136,1,0,,1,"(10.886611,-74.776708)"
2014,Enero,Islas Caimán/Territorio Británico de Ultramar,136,20,19,,39,"(12.586067,-81.702563)"
2014,Enero,Islas Caimán/Territorio Británico de Ultramar,136,3,0,,3,"(3.541112,-76.384584)"
2014,Enero,Islas Caimán/Territorio Británico de Ultramar,136,0,3,,3,"(4.697144,-74.140516)"
2014,Enero,Islas Caimán/Territorio Británico de Ultramar,136,2,0,,2,"(6.171601,-75.427454)"
2014,Enero,Camboya,116,0,7,,7,"(4.697144,-74.140516)"
2014,Enero,Camerún,120,0,1,,1,"(4.697144,-74.140516)"
2014,Enero,Camerún,120,3,2,,5,"(6.171601,-75.427454)"
2014,Enero,Canadá,124,246,214,,460,"(10.445761,-75.516429)"
2014,Enero,Canadá,124,31,36,,67,"(10.886611,-74.776708)"
2014,Enero,Canadá,124,15,16,,31,"(12.586067,-81.702563)"
2014,Enero,Canadá,124,179,172,,351,"(3.541112,-76.384584)"
2014,Enero,Canadá,124,30,21,,51,"(4.452882,-75.766298)"
2014,Enero,Canadá,124,2808,2616,,5424,"(4.697144,-74.140516)"
2014,Enero,Canadá,124,32,25,,57,"(4.815061,-75.736532)"
2014,Enero,Canadá,124,448,408,,856,"(6.171601,-75.427454)"
2014,Enero,Canadá,124,12,7,,19,"(7.128456,-73.183637)"
2014,Enero,Canadá,124,5,7,,12,"(7.927209,-72.507910)"
2014,Enero,Chad,148,0,2,,2,"(4.697144,-74.140516)"
2014,Enero,España,724,15,6,,21,"(10.445761,-75.516429)"
2014,Enero,España,724,7,4,,11,"(10.886611,-74.776708)"
2014,Enero,España,724,4,0,,4,"(12.586067,-81.702563)"
2014,Enero,España,724,1675,982,,2657,"(3.541112,-76.384584)"
2014,Enero,España,724,8671,6006,,14677,"(4.697144,-74.140516)"
2014,Enero,España,724,6,10,,16,"(4.815061,-75.736532)"
2014,Enero,España,724,847,640,,1487,"(6.171601,-75.427454)"
2014,Enero,España,724,0,1,,1,"(7.128456,-73.183637)"
2014,Enero,República Democrática del Congo,180,0,7,,7,"(4.697144,-74.140516)"
2014,Enero,República de Corea,410,7,9,,16,"(4.697144,-74.140516)"
2014,Enero,República de Corea,410,0,2,,2,"(6.171601,-75.427454)"
2014,Enero,Costa de Marfil,384,1,3,,4,"(3.541112,-76.384584)"
2014,Enero,Costa de Marfil,384,4,5,,9,"(4.697144,-74.140516)"
2014,Enero,Costa de Marfil,384,1,1,,2,"(6.171601,-75.427454)"
2014,Enero,Costa Rica,188,1,1,,2,"(10.408582,-75.538003)"
2014,Enero,Costa Rica,188,19,27,,46,"(10.445761,-75.516429)"
2014,Enero,Costa Rica,188,45,31,,76,"(10.886611,-74.776708)"
2014,Enero,Costa Rica,188,6,10,,16,"(12.586067,-81.702563)"
2014,Enero,Costa Rica,188,0,19,,19,"(13.3387613,-81.372937)"
2014,Enero,Costa Rica,188,103,84,,187,"(3.541112,-76.384584)"
2014,Enero,Costa Rica,188,1250,1203,,2453,"(4.697144,-74.140516)"
2014,Enero,Costa Rica,188,13,16,,29,"(4.815061,-75.736532)"
2014,Enero,Costa Rica,188,151,141,,292,"(6.171601,-75.427454)"
2014,Enero,Costa Rica,188,3,2,,5,"(7.128456,-73.183637)"
2014,Enero,Costa Rica,188,6,6,,12,"(7.927209,-72.507910)"
2014,Enero,Croacia,191,1,2,,3,"(4.697144,-74.140516)"
2014,Enero,Cuba,192,1,0,,1,"(0.814836,-77.662532)"
2014,Enero,Cuba,192,18,23,,41,"(10.445761,-75.516429)"
2014,Enero,Cuba,192,47,29,,76,"(10.886611,-74.776708)"
2014,Enero,Cuba,192,112,92,,204,"(3.541112,-76.384584)"
2014,Enero,Cuba,192,1331,1162,,2493,"(4.697144,-74.140516)"
2014,Enero,Cuba,192,23,18,,41,"(4.815061,-75.736532)"
2014,Enero,Cuba,192,157,120,,277,"(6.171601,-75.427454)"
2014,Enero,Cuba,192,24,17,,41,"(7.128456,-73.183637)"
2014,Enero,Cuba,192,24,31,,55,"(7.927209,-72.507910)"
2014,Enero,Curazao,99999,3,3,,6,"(10.445761,-75.516429)"
2014,Enero,Curazao,99999,5,3,,8,"(10.886611,-74.776708)"
2014,Enero,Curazao,99999,2,3,,5,"(3.541112,-76.384584)"
2014,Enero,Curazao,99999,499,542,,1041,"(4.697144,-74.140516)"
2014,Enero,Curazao,99999,168,132,,300,"(6.171601,-75.427454)"
2014,Enero,Curazao,99999,1,2,,3,"(7.128456,-73.183637)"
2014,Enero,República Checa,203,6,4,,10,"(4.697144,-74.140516)"
2014,Enero,Chile,152,131,158,,289,"(0.814836,-77.662532)"
2014,Enero,Chile,152,1,0,,1,"(1.813928,-78.763924)"
2014,Enero,Chile,152,17,14,,31,"(10.445761,-75.516429)"
2014,Enero,Chile,152,19,11,,30,"(10.886611,-74.776708)"
2014,Enero,Chile,152,4,2,,6,"(12.586067,-81.702563)"
2014,Enero,Chile,152,833,579,,1412,"(3.541112,-76.384584)"
2014,Enero,Chile,152,3883,3220,,7103,"(4.697144,-74.140516)"
2014,Enero,Chile,152,6,11,,17,"(4.815061,-75.736532)"
2014,Enero,Chile,152,249,245,,494,"(6.171601,-75.427454)"
2014,Enero,Chile,152,2,0,,2,"(7.128456,-73.183637)"
2014,Enero,Chile,152,3,2,,5,"(7.927209,-72.507910)"
2014,Enero,China,156,1,1,,2,"(10.886611,-74.776708)"
2014,Enero,China,156,1,3,,4,"(3.541112,-76.384584)"
2014,Enero,China,156,108,183,,291,"(4.697144,-74.140516)"
2014,Enero,China,156,2,1,,3,"(4.815061,-75.736532)"
2014,Enero,China,156,9,7,,16,"(6.171601,-75.427454)"
2014,Enero,Dinamarca,208,1,0,,1,"(10.886611,-74.776708)"
2014,Enero,Dinamarca,208,2,0,,2,"(3.541112,-76.384584)"
2014,Enero,Dinamarca,208,30,25,,55,"(4.697144,-74.140516)"
2014,Enero,Dinamarca,208,0,1,,1,"(6.171601,-75.427454)"
2014,Enero,Ecuador,218,1113,1204,,2317,"(0.25129,-76.875963)"
2014,Enero,Ecuador,218,19067,19093,,38160,"(0.814836,-77.662532)"
2014,Enero,Ecuador,218,260,251,,511,"(1.813928,-78.763924)"
2014,Enero,Ecuador,218,0,10,,10,"(10.408582,-75.538003)"
2014,Enero,Ecuador,218,0,3,,3,"(10.445761,-75.516429)"
2014,Enero,Ecuador,218,6,17,,23,"(10.886611,-74.776708)"
2014,Enero,Ecuador,218,0,2,,2,"(12.586067,-81.702563)"
2014,Enero,Ecuador,218,978,902,,1880,"(3.541112,-76.384584)"
2014,Enero,Ecuador,218,3247,4661,,7908,"(4.697144,-74.140516)"
2014,Enero,Ecuador,218,0,3,,3,"(4.815061,-75.736532)"
2014,Enero,Ecuador,218,526,528,,1054,"(6.171601,-75.427454)"
2014,Enero,Ecuador,218,2,1,,3,"(7.128456,-73.183637)"
2014,Enero,Egipto,818,0,1,,1,"(3.541112,-76.384584)"
2014,Enero,Egipto,818,14,13,,27,"(4.697144,-74.140516)"
2014,Enero,El Salvador,222,3,7,,10,"(10.445761,-75.516429)"
2014,Enero,El Salvador,222,4,8,,12,"(10.886611,-74.776708)"
2014,Enero,El Salvador,222,90,116,,206,"(3.541112,-76.384584)"
2014,Enero,El Salvador,222,934,1010,,1944,"(4.697144,-74.140516)"
2014,Enero,El Salvador,222,2,0,,2,"(4.815061,-75.736532)"
2014,Enero,El Salvador,222,131,164,,295,"(6.171601,-75.427454)"
2014,Enero,El Salvador,222,1,2,,3,"(7.927209,-72.507910)"
2014,Enero,Emiratos Árabes,784,1,1,,2,"(10.445761,-75.516429)"
2014,Enero,Emiratos Árabes,784,0,1,,1,"(10.886611,-74.776708)"
2014,Enero,Emiratos Árabes,784,3,1,,4,"(3.541112,-76.384584)"
2014,Enero,Emiratos Árabes,784,129,338,,467,"(4.697144,-74.140516)"
2014,Enero,Emiratos Árabes,784,6,7,,13,"(6.171601,-75.427454)"
2014,Enero,Eslovaquia,703,2,1,,3,"(4.697144,-74.140516)"
2014,Enero,Eslovaquia,703,0,1,,1,"(6.171601,-75.427454)"
2014,Enero,Estados Unidos de América,840,0,1,,1,"(0.814836,-77.662532)"
2014,Enero,Estados Unidos de América,840,2778,2386,,5164,"(10.445761,-75.516429)"
2014,Enero,Estados Unidos de América,840,2153,1794,,3947,"(10.886611,-74.776708)"
2014,Enero,Estados Unidos de América,840,43,41,,84,"(12.586067,-81.702563)"
2014,Enero,Estados Unidos de América,840,5551,4536,,10087,"(3.541112,-76.384584)"
2014,Enero,Estados Unidos de América,840,490,415,,905,"(4.452882,-75.766298)"
2014,Enero,Estados Unidos de América,840,35090,31876,,66966,"(4.697144,-74.140516)"
2014,Enero,Estados Unidos de América,840,861,677,,1538,"(4.815061,-75.736532)"
2014,Enero,Estados Unidos de América,840,10054,8680,,18734,"(6.171601,-75.427454)"
2014,Enero,Estados Unidos de América,840,158,125,,283,"(7.128456,-73.183637)"
2014,Enero,Estados Unidos de América,840,173,172,,345,"(7.927209,-72.507910)"
2014,Enero,Estonia,233,1,1,,2,"(4.697144,-74.140516)"
2014,Enero,Etiopia,231,1,5,,6,"(4.697144,-74.140516)"
2014,Enero,Islas Fiji,242,1,0,,1,"(4.697144,-74.140516)"
2014,Enero,Filipinas,608,5,0,,5,"(10.408582,-75.538003)"
2014,Enero,Filipinas,608,2,1,,3,"(10.886611,-74.776708)"
2014,Enero,Filipinas,608,4,6,,10,"(4.697144,-74.140516)"
2014,Enero,Finlandia,246,0,1,,1,"(10.886611,-74.776708)"
2014,Enero,Finlandia,246,1,1,,2,"(3.541112,-76.384584)"
2014,Enero,Finlandia,246,8,13,,21,"(4.697144,-74.140516)"
2014,Enero,Finlandia,246,1,0,,1,"(6.171601,-75.427454)"
2014,Enero,Francia,250,6,0,,6,"(10.445761,-75.516429)"
2014,Enero,Francia,250,2,0,,2,"(10.886611,-74.776708)"
2014,Enero,Francia,250,53,39,,92,"(3.541112,-76.384584)"
2014,Enero,Francia,250,1456,1103,,2559,"(4.697144,-74.140516)"
2014,Enero,Francia,250,3,1,,4,"(4.815061,-75.736532)"
2014,Enero,Francia,250,45,28,,73,"(6.171601,-75.427454)"
2014,Enero,Francia,250,1,0,,1,"(7.128456,-73.183637)"
2014,Enero,Gabón,266,0,5,,5,"(4.697144,-74.140516)"
2014,Enero,Ghana,288,4,4,,8,"(4.697144,-74.140516)"
2014,Enero,Gibraltar/Territorio Británico de Ultramar,292,1,1,,2,"(0.814836,-77.662532)"
2014,Enero,Grecia,300,6,10,,16,"(4.697144,-74.140516)"
2014,Enero,Grecia,300,1,0,,1,"(6.171601,-75.427454)"
2014,Enero,Guatemala,320,6,5,,11,"(10.445761,-75.516429)"
2014,Enero,Guatemala,320,8,10,,18,"(10.886611,-74.776708)"
2014,Enero,Guatemala,320,0,1,,1,"(12.586067,-81.702563)"
2014,Enero,Guatemala,320,74,88,,162,"(3.541112,-76.384584)"
2014,Enero,Guatemala,320,512,592,,1104,"(4.697144,-74.140516)"
2014,Enero,Guatemala,320,11,11,,22,"(4.815061,-75.736532)"
2014,Enero,Guatemala,320,91,123,,214,"(6.171601,-75.427454)"
2014,Enero,Guatemala,320,7,4,,11,"(7.128456,-73.183637)"
2014,Enero,Guatemala,320,1,4,,5,"(7.927209,-72.507910)"
2014,Enero,Guyana,328,0,1,,1,"(10.445761,-75.516429)"
2014,Enero,Guyana,328,1,2,,3,"(10.886611,-74.776708)"
2014,Enero,Guyana,328,2,5,,7,"(4.697144,-74.140516)"
2014,Enero,Guyana,328,0,1,,1,"(6.171601,-75.427454)"
2014,Enero,Guinea,324,0,6,,6,"(4.697144,-74.140516)"
2014,Enero,Guinea Ecuatorial,226,0,1,,1,"(3.541112,-76.384584)"
2014,Enero,Guinea Ecuatorial,226,11,32,,43,"(4.697144,-74.140516)"
2014,Enero,Guinea Ecuatorial,226,1,1,,2,"(6.171601,-75.427454)"
2014,Enero,Guinea Bissau,624,0,3,,3,"(4.697144,-74.140516)"
2014,Enero,Guadalupe/Territorio Francés,312,1,1,,2,"(4.697144,-74.140516)"
2014,Enero,Guadalupe/Territorio Francés,312,1,0,,1,"(6.171601,-75.427454)"
2014,Enero,Guayana Francesa/Departamento de Ultramar Francés,254,1,1,,2,"(10.886611,-74.776708)"
2014,Enero,Guayana Francesa/Departamento de Ultramar Francés,254,3,1,,4,"(4.697144,-74.140516)"
2014,Enero,Haití,332,0,4,,4,"(10.886611,-74.776708)"
2014,Enero,Haití,332,2,1,,3,"(3.541112,-76.384584)"
2014,Enero,Haití,332,6,8,,14,"(4.697144,-74.140516)"
2014,Enero,Haití,332,2,7,,9,"(6.171601,-75.427454)"
2014,Enero,Haití,332,0,1,,1,"(7.927209,-72.507910)"
2014,Enero,Honduras,340,5,17,,22,"(10.445761,-75.516429)"
2014,Enero,Honduras,340,8,14,,22,"(10.886611,-74.776708)"
2014,Enero,Honduras,340,10,29,,39,"(3.541112,-76.384584)"
2014,Enero,Honduras,340,81,147,,228,"(4.697144,-74.140516)"
2014,Enero,Honduras,340,6,11,,17,"(4.815061,-75.736532)"
2014,Enero,Honduras,340,32,84,,116,"(6.171601,-75.427454)"
2014,Enero,Honduras,340,2,5,,7,"(7.128456,-73.183637)"
2014,Enero,Honduras,340,1,3,,4,"(7.927209,-72.507910)"
2014,Enero,Hong Kong,344,0,1,,1,"(10.886611,-74.776708)"
2014,Enero,Hong Kong,344,0,2,,2,"(3.541112,-76.384584)"
2014,Enero,Hong Kong,344,29,42,,71,"(4.697144,-74.140516)"
2014,Enero,Hong Kong,344,2,2,,4,"(6.171601,-75.427454)"
2014,Enero,Hungría,348,2,1,,3,"(4.697144,-74.140516)"
2014,Enero,India,356,1,1,,2,"(3.541112,-76.384584)"
2014,Enero,India,356,33,30,,63,"(4.697144,-74.140516)"
2014,Enero,India,356,2,1,,3,"(6.171601,-75.427454)"
2014,Enero,Indonesia,360,2,1,,3,"(3.541112,-76.384584)"
2014,Enero,Indonesia,360,7,9,,16,"(4.697144,-74.140516)"
2014,Enero,Indonesia,360,0,1,,1,"(6.171601,-75.427454)"
2014,Enero,Iraq,368,4,17,,21,"(4.697144,-74.140516)"
2014,Enero,Irán,364,0,1,,1,"(4.697144,-74.140516)"
2014,Enero,República de Irlanda,372,0,2,,2,"(3.541112,-76.384584)"
2014,Enero,República de Irlanda,372,17,13,,30,"(4.697144,-74.140516)"
2014,Enero,República de Irlanda,372,1,1,,2,"(6.171601,-75.427454)"
2014,Enero,Islandia,352,3,0,,3,"(4.697144,-74.140516)"
2014,Enero,Israel,376,1,1,,2,"(10.445761,-75.516429)"
2014,Enero,Israel,376,2,2,,4,"(10.886611,-74.776708)"
2014,Enero,Israel,376,0,1,,1,"(3.541112,-76.384584)"
2014,Enero,Israel,376,111,95,,206,"(4.697144,-74.140516)"
2014,Enero,Israel,376,4,2,,6,"(6.171601,-75.427454)"
2014,Enero,Israel,376,1,0,,1,"(7.128456,-73.183637)"
2014,Enero,Italia,380,16,3,,19,"(10.445761,-75.516429)"
2014,Enero,Italia,380,3,3,,6,"(10.886611,-74.776708)"
2014,Enero,Italia,380,100,45,,145,"(3.541112,-76.384584)"
2014,Enero,Italia,380,772,474,,1246,"(4.697144,-74.140516)"
2014,Enero,Italia,380,2,1,,3,"(4.815061,-75.736532)"
2014,Enero,Italia,380,48,33,,81,"(6.171601,-75.427454)"
2014,Enero,Italia,380,0,1,,1,"(7.128456,-73.183637)"
2014,Enero,Jamaica,388,9,6,,15,"(10.445761,-75.516429)"
2014,Enero,Jamaica,388,7,5,,12,"(10.886611,-74.776708)"
2014,Enero,Jamaica,388,10,8,,18,"(3.541112,-76.384584)"
2014,Enero,Jamaica,388,40,56,,96,"(4.697144,-74.140516)"
2014,Enero,Jamaica,388,1,2,,3,"(4.815061,-75.736532)"
2014,Enero,Jamaica,388,36,35,,71,"(6.171601,-75.427454)"
2014,Enero,Jamaica,388,7,5,,12,"(7.128456,-73.183637)"
2014,Enero,Japón,392,7,4,,11,"(3.541112,-76.384584)"
2014,Enero,Japón,392,43,42,,85,"(4.697144,-74.140516)"
2014,Enero,Japón,392,1,0,,1,"(4.815061,-75.736532)"
2014,Enero,Japón,392,2,2,,4,"(6.171601,-75.427454)"
2014,Enero,Japón,392,1,0,,1,"(7.128456,-73.183637)"
2014,Enero,Jordania,400,3,6,,9,"(4.697144,-74.140516)"
2014,Enero,Kazajistán,398,3,5,,8,"(4.697144,-74.140516)"
2014,Enero,Kenia,404,1,0,,1,"(10.886611,-74.776708)"
2014,Enero,Kenia,404,6,6,,12,"(4.697144,-74.140516)"
2014,Enero,Kenia,404,0,1,,1,"(6.171601,-75.427454)"
2014,Enero,Kirguistán,417,1,0,,1,"(6.171601,-75.427454)"
2014,Enero,Kuwait,414,4,2,,6,"(4.697144,-74.140516)"
2014,Enero,Letonia,428,0,1,,1,"(4.697144,-74.140516)"
2014,Enero,Lituania,440,0,1,,1,"(4.697144,-74.140516)"
2014,Enero,Líbano,422,22,18,,40,"(4.697144,-74.140516)"
2014,Enero,Líbano,422,2,0,,2,"(6.171601,-75.427454)"
2014,Enero,Liberia,430,0,1,,1,"(4.697144,-74.140516)"
2014,Enero,Luxemburgo,442,4,11,,15,"(4.697144,-74.140516)"
2014,Enero,Macao,446,1,0,,1,"(4.697144,-74.140516)"
2014,Enero,Malasia,458,2,2,,4,"(3.541112,-76.384584)"
2014,Enero,Malasia,458,20,25,,45,"(4.697144,-74.140516)"
2014,Enero,Malasia,458,3,3,,6,"(6.171601,-75.427454)"
2014,Enero,Malí,466,0,2,,2,"(4.697144,-74.140516)"
2014,Enero,Malí,466,0,1,,1,"(6.171601,-75.427454)"
2014,Enero,Malta,470,9,10,,19,"(4.697144,-74.140516)"
2014,Enero,Malta,470,2,0,,2,"(6.171601,-75.427454)"
2014,Enero,Marruecos,504,7,4,,11,"(4.697144,-74.140516)"
2014,Enero,Mauricio,480,1,0,,1,"(4.697144,-74.140516)"
2014,Enero,Mauritania,478,1,1,,2,"(4.697144,-74.140516)"
2014,Enero,Martinica/Departamento de Ultramar Francés,474,1,0,,1,"(6.171601,-75.427454)"
2014,Enero,México,484,1,1,,2,"(0.814836,-77.662532)"
2014,Enero,México,484,1,0,,1,"(10.408582,-75.538003)"
2014,Enero,México,484,59,86,,145,"(10.445761,-75.516429)"
2014,Enero,México,484,105,96,,201,"(10.886611,-74.776708)"
2014,Enero,México,484,2,1,,3,"(12.586067,-81.702563)"
2014,Enero,México,484,575,550,,1125,"(3.541112,-76.384584)"
2014,Enero,México,484,10465,9592,,20057,"(4.697144,-74.140516)"
2014,Enero,México,484,85,74,,159,"(4.815061,-75.736532)"
2014,Enero,México,484,1536,1243,,2779,"(6.171601,-75.427454)"
2014,Enero,México,484,85,85,,170,"(7.128456,-73.183637)"
2014,Enero,México,484,123,112,,235,"(7.927209,-72.507910)"
2014,Enero,Mónaco,492,1,0,,1,"(3.541112,-76.384584)"
2014,Enero,Mónaco,492,2,1,,3,"(4.697144,-74.140516)"
2014,Enero,Mozambique,508,1,2,,3,"(4.697144,-74.140516)"
2014,Enero,Myanmar,104,0,1,,1,"(4.697144,-74.140516)"
2014,Enero,Namibia,516,0,1,,1,"(4.697144,-74.140516)"
2014,Enero,Nepal,524,1,0,,1,"(4.697144,-74.140516)"
2014,Enero,Nicaragua,558,1,6,,7,"(10.445761,-75.516429)"
2014,Enero,Nicaragua,558,6,6,,12,"(10.886611,-74.776708)"
2014,Enero,Nicaragua,558,9,21,,30,"(3.541112,-76.384584)"
2014,Enero,Nicaragua,558,41,74,,115,"(4.697144,-74.140516)"
2014,Enero,Nicaragua,558,0,2,,2,"(4.815061,-75.736532)"
2014,Enero,Nicaragua,558,12,33,,45,"(6.171601,-75.427454)"
2014,Enero,Nicaragua,558,1,0,,1,"(7.128456,-73.183637)"
2014,Enero,Nicaragua,558,1,1,,2,"(7.927209,-72.507910)"
2014,Enero,Nigeria,566,0,1,,1,"(10.886611,-74.776708)"
2014,Enero,Nigeria,566,3,19,,22,"(4.697144,-74.140516)"
2014,Enero,Noruega,578,3,0,,3,"(10.445761,-75.516429)"
2014,Enero,Noruega,578,1,0,,1,"(10.886611,-74.776708)"
2014,Enero,Noruega,578,2,1,,3,"(3.541112,-76.384584)"
2014,Enero,Noruega,578,43,42,,85,"(4.697144,-74.140516)"
2014,Enero,Noruega,578,7,5,,12,"(6.171601,-75.427454)"
2014,Enero,Noruega,578,1,0,,1,"(7.128456,-73.183637)"
2014,Enero,Nueva Caledonia/Territorio francés,540,0,2,,2,"(4.697144,-74.140516)"
2014,Enero,Nueva Zelanda,554,0,2,,2,"(3.541112,-76.384584)"
2014,Enero,Nueva Zelanda,554,24,28,,52,"(4.697144,-74.140516)"
2014,Enero,Nueva Zelanda,554,0,1,,1,"(4.815061,-75.736532)"
2014,Enero,Nueva Zelanda,554,8,6,,14,"(6.171601,-75.427454)"
2014,Enero,Omán,512,5,9,,14,"(4.697144,-74.140516)"
2014,Enero,Papúa Nueva Guinea,598,0,7,,7,"(4.697144,-74.140516)"
2014,Enero,Pakistán,586,0,3,,3,"(4.697144,-74.140516)"
2014,Enero,Panamá,591,0,2,,2,"(0.814836,-77.662532)"
2014,Enero,Panamá,591,125,156,,281,"(10.408582,-75.538003)"
2014,Enero,Panamá,591,646,617,,1263,"(10.445761,-75.516429)"
2014,Enero,Panamá,591,1301,1232,,2533,"(10.886611,-74.776708)"
2014,Enero,Panamá,591,0,2,,2,"(10.971302,-74.765397)"
2014,Enero,Panamá,591,172,172,,344,"(12.586067,-81.702563)"
2014,Enero,Panamá,591,2545,2273,,4818,"(3.541112,-76.384584)"
2014,Enero,Panamá,591,9715,9803,,19518,"(4.697144,-74.140516)"
2014,Enero,Panamá,591,971,781,,1752,"(4.815061,-75.736532)"
2014,Enero,Panamá,591,3199,2995,,6194,"(6.171601,-75.427454)"
2014,Enero,Panamá,591,9,8,,17,"(6.228046,-77.404104)"
2014,Enero,Panamá,591,9,11,,20,"(7.102626,-77.762647)"
2014,Enero,Panamá,591,386,391,,777,"(7.128456,-73.183637)"
2014,Enero,Panamá,591,354,368,,722,"(7.927209,-72.507910)"
2014,Enero,Panamá,591,0,53,,53,"(8.066966,-76.735404)"
2014,Enero,Panamá,591,119,218,,337,"(8.635765,-77.346578)"
2014,Enero,Paraguay,600,0,1,,1,"(10.445761,-75.516429)"
2014,Enero,Paraguay,600,3,1,,4,"(10.886611,-74.776708)"
2014,Enero,Paraguay,600,9,13,,22,"(3.541112,-76.384584)"
2014,Enero,Paraguay,600,35,82,,117,"(4.697144,-74.140516)"
2014,Enero,Paraguay,600,4,2,,6,"(4.815061,-75.736532)"
2014,Enero,Paraguay,600,8,13,,21,"(6.171601,-75.427454)"
2014,Enero,Perú,604,96,153,,249,"(-4.197703,-69.941278)"
2014,Enero,Perú,604,0,4,,4,"(0.25129,-76.875963)"
2014,Enero,Perú,604,82,89,,171,"(0.814836,-77.662532)"
2014,Enero,Perú,604,15,13,,28,"(10.445761,-75.516429)"
2014,Enero,Perú,604,35,22,,57,"(10.886611,-74.776708)"
2014,Enero,Perú,604,2,2,,4,"(12.586067,-81.702563)"
2014,Enero,Perú,604,289,314,,603,"(3.541112,-76.384584)"
2014,Enero,Perú,604,3632,4315,,7947,"(4.697144,-74.140516)"
2014,Enero,Perú,604,13,6,,19,"(4.815061,-75.736532)"
2014,Enero,Perú,604,687,645,,1332,"(6.171601,-75.427454)"
2014,Enero,Perú,604,7,8,,15,"(7.128456,-73.183637)"
2014,Enero,Perú,604,1,2,,3,"(7.927209,-72.507910)"
2014,Enero,Palestina,99999,2,0,,2,"(4.697144,-74.140516)"
2014,Enero,Polonia,616,0,1,,1,"(10.445761,-75.516429)"
2014,Enero,Polonia,616,6,6,,12,"(4.697144,-74.140516)"
2014,Enero,Portugal,620,2,0,,2,"(10.445761,-75.516429)"
2014,Enero,Portugal,620,3,2,,5,"(3.541112,-76.384584)"
2014,Enero,Portugal,620,35,28,,63,"(4.697144,-74.140516)"
2014,Enero,Polinesia Francesa/Colectividad de Ultramar Francesa,258,0,1,,1,"(4.697144,-74.140516)"
2014,Enero,Puerto Rico/Territorio de Estados Unidos,630,19,24,,43,"(10.445761,-75.516429)"
2014,Enero,Puerto Rico/Territorio de Estados Unidos,630,15,10,,25,"(10.886611,-74.776708)"
2014,Enero,Puerto Rico/Territorio de Estados Unidos,630,1,1,,2,"(12.586067,-81.702563)"
2014,Enero,Puerto Rico/Territorio de Estados Unidos,630,95,63,,158,"(3.541112,-76.384584)"
2014,Enero,Puerto Rico/Territorio de Estados Unidos,630,492,444,,936,"(4.697144,-74.140516)"
2014,Enero,Puerto Rico/Territorio de Estados Unidos,630,13,12,,25,"(4.815061,-75.736532)"
2014,Enero,Puerto Rico/Territorio de Estados Unidos,630,83,58,,141,"(6.171601,-75.427454)"
2014,Enero,Puerto Rico/Territorio de Estados Unidos,630,11,12,,23,"(7.128456,-73.183637)"
2014,Enero,Puerto Rico/Territorio de Estados Unidos,630,0,1,,1,"(7.927209,-72.507910)"
2014,Enero,Qatar,634,0,1,,1,"(10.445761,-75.516429)"
2014,Enero,Qatar,634,11,10,,21,"(4.697144,-74.140516)"
2014,Enero,Qatar,634,2,2,,4,"(6.171601,-75.427454)"
2014,Enero,Reino Unido de Gran Bretaña e Irlanda del Norte,826,0,1,,1,"(0.814836,-77.662532)"
2014,Enero,Reino Unido de Gran Bretaña e Irlanda del Norte,826,3,2,,5,"(10.445761,-75.516429)"
2014,Enero,Reino Unido de Gran Bretaña e Irlanda del Norte,826,2,1,,3,"(10.886611,-74.776708)"
2014,Enero,Reino Unido de Gran Bretaña e Irlanda del Norte,826,138,108,,246,"(3.541112,-76.384584)"
2014,Enero,Reino Unido de Gran Bretaña e Irlanda del Norte,826,1354,1002,,2356,"(4.697144,-74.140516)"
2014,Enero,Reino Unido de Gran Bretaña e Irlanda del Norte,826,0,3,,3,"(4.815061,-75.736532)"
2014,Enero,Reino Unido de Gran Bretaña e Irlanda del Norte,826,68,67,,135,"(6.171601,-75.427454)"
2014,Enero,Reino Unido de Gran Bretaña e Irlanda del Norte,826,1,1,,2,"(7.128456,-73.183637)"
2014,Enero,República CentroÁfricana,140,1,0,,1,"(4.697144,-74.140516)"
2014,Enero,Federación de Rusia,643,13,38,,51,"(4.697144,-74.140516)"
2014,Enero,Federación de Rusia,643,0,5,,5,"(6.171601,-75.427454)"
2014,Enero,República Dominicana,214,15,39,,54,"(10.445761,-75.516429)"
2014,Enero,República Dominicana,214,33,32,,65,"(10.886611,-74.776708)"
2014,Enero,República Dominicana,214,0,2,,2,"(11.117806,-74.232622)"
2014,Enero,República Dominicana,214,3,3,,6,"(12.586067,-81.702563)"
2014,Enero,República Dominicana,214,77,70,,147,"(3.541112,-76.384584)"
2014,Enero,República Dominicana,214,1626,1585,,3211,"(4.697144,-74.140516)"
2014,Enero,República Dominicana,214,35,24,,59,"(4.815061,-75.736532)"
2014,Enero,República Dominicana,214,221,211,,432,"(6.171601,-75.427454)"
2014,Enero,República Dominicana,214,11,10,,21,"(7.128456,-73.183637)"
2014,Enero,Rumania,642,2,6,,8,"(4.697144,-74.140516)"
2014,Enero,Rumania,642,0,1,,1,"(6.171601,-75.427454)"
2014,Enero,Rwanda,646,0,1,,1,"(4.697144,-74.140516)"
2014,Enero,San  Vicente y las Granadinas,670,2,0,,2,"(4.697144,-74.140516)"
2014,Enero,San  Vicente y las Granadinas,670,1,0,,1,"(4.815061,-75.736532)"
2014,Enero,Senegal,686,0,7,,7,"(4.697144,-74.140516)"
2014,Enero,Serbia,688,1,0,,1,"(3.541112,-76.384584)"
2014,Enero,Sierra Leona,694,1,1,,2,"(3.541112,-76.384584)"
2014,Enero,Sierra Leona,694,4,0,,4,"(4.697144,-74.140516)"
2014,Enero,Singapur,702,22,17,,39,"(4.697144,-74.140516)"
2014,Enero,República Árabe Siria,760,1,1,,2,"(4.697144,-74.140516)"
2014,Enero,Sri Lanka,144,1,0,,1,"(11.360009,-72.129330)"
2014,Enero,Sri Lanka,144,0,1,,1,"(6.171601,-75.427454)"
2014,Enero,Sudáfrica,710,1,2,,3,"(3.541112,-76.384584)"
2014,Enero,Sudáfrica,710,24,32,,56,"(4.697144,-74.140516)"
2014,Enero,Sudáfrica,710,0,1,,1,"(6.171601,-75.427454)"
2014,Enero,Sudán,736,2,1,,3,"(4.697144,-74.140516)"
2014,Enero,Suecia,752,2,1,,3,"(10.445761,-75.516429)"
2014,Enero,Suecia,752,3,1,,4,"(10.886611,-74.776708)"
2014,Enero,Suecia,752,16,20,,36,"(3.541112,-76.384584)"
2014,Enero,Suecia,752,213,131,,344,"(4.697144,-74.140516)"
2014,Enero,Suecia,752,3,1,,4,"(4.815061,-75.736532)"
2014,Enero,Suecia,752,15,15,,30,"(6.171601,-75.427454)"
2014,Enero,Suecia,752,3,1,,4,"(7.128456,-73.183637)"
2014,Enero,Suiza,756,2,1,,3,"(10.445761,-75.516429)"
2014,Enero,Suiza,756,57,23,,80,"(3.541112,-76.384584)"
2014,Enero,Suiza,756,424,271,,695,"(4.697144,-74.140516)"
2014,Enero,Suiza,756,19,17,,36,"(6.171601,-75.427454)"
2014,Enero,Surinam,740,5,9,,14,"(4.697144,-74.140516)"
2014,Enero,Surinam,740,3,0,,3,"(6.171601,-75.427454)"
2014,Enero,Taiwán,158,3,4,,7,"(4.697144,-74.140516)"
2014,Enero,Tailandia,764,2,1,,3,"(10.445761,-75.516429)"
2014,Enero,Tailandia,764,1,0,,1,"(3.541112,-76.384584)"
2014,Enero,Tailandia,764,14,18,,32,"(4.697144,-74.140516)"
2014,Enero,Tailandia,764,1,0,,1,"(6.171601,-75.427454)"
2014,Enero,Tanzania,834,1,2,,3,"(4.697144,-74.140516)"
2014,Enero,Trinidad y Tobago,780,4,7,,11,"(10.445761,-75.516429)"
2014,Enero,Trinidad y Tobago,780,3,2,,5,"(10.886611,-74.776708)"
2014,Enero,Trinidad y Tobago,780,1,0,,1,"(12.586067,-81.702563)"
2014,Enero,Trinidad y Tobago,780,13,48,,61,"(3.541112,-76.384584)"
2014,Enero,Trinidad y Tobago,780,38,41,,79,"(4.697144,-74.140516)"
2014,Enero,Trinidad y Tobago,780,2,3,,5,"(4.815061,-75.736532)"
2014,Enero,Trinidad y Tobago,780,15,13,,28,"(6.171601,-75.427454)"
2014,Enero,Trinidad y Tobago,780,5,3,,8,"(7.128456,-73.183637)"
2014,Enero,Trinidad y Tobago,780,2,0,,2,"(7.927209,-72.507910)"
2014,Enero,Turquía,792,21,32,,53,"(4.697144,-74.140516)"
2014,Enero,Turquía,792,3,2,,5,"(6.171601,-75.427454)"
2014,Enero,Turkmenistán,795,1,1,,2,"(4.697144,-74.140516)"
2014,Enero,Ucrania,804,0,1,,1,"(4.697144,-74.140516)"
2014,Enero,Uganda,800,0,1,,1,"(3.541112,-76.384584)"
2014,Enero,Uganda,800,2,3,,5,"(4.697144,-74.140516)"
2014,Enero,Uruguay,858,0,1,,1,"(0.814836,-77.662532)"
2014,Enero,Uruguay,858,4,2,,6,"(10.445761,-75.516429)"
2014,Enero,Uruguay,858,0,2,,2,"(10.886611,-74.776708)"
2014,Enero,Uruguay,858,9,19,,28,"(3.541112,-76.384584)"
2014,Enero,Uruguay,858,95,91,,186,"(4.697144,-74.140516)"
2014,Enero,Uruguay,858,0,2,,2,"(4.815061,-75.736532)"
2014,Enero,Uruguay,858,22,19,,41,"(6.171601,-75.427454)"
2014,Enero,Venezuela,862,26,22,,48,"(10.445761,-75.516429)"
2014,Enero,Venezuela,862,17,39,,56,"(10.886611,-74.776708)"
2014,Enero,Venezuela,862,0,1,,1,"(10.971302,-74.765397)"
2014,Enero,Venezuela,862,25516,19620,,45136,"(11.360009,-72.129330)"
2014,Enero,Venezuela,862,19,21,,40,"(3.541112,-76.384584)"
2014,Enero,Venezuela,862,2630,2694,,5324,"(4.697144,-74.140516)"
2014,Enero,Venezuela,862,11,9,,20,"(4.815061,-75.736532)"
2014,Enero,Venezuela,862,454,464,,918,"(6.171601,-75.427454)"
2014,Enero,Venezuela,862,809,775,,1584,"(6.185799,-67.483929)"
2014,Enero,Venezuela,862,3200,3053,,6253,"(7.088729,-70.740253)"
2014,Enero,Venezuela,862,133,111,,244,"(7.128456,-73.183637)"
2014,Enero,Venezuela,862,18324,17269,,35593,"(7.818934,-72.453226)"
2014,Enero,Venezuela,862,3,7,,10,"(7.927209,-72.507910)"
2014,Enero,Vietnam,704,4,3,,7,"(4.697144,-74.140516)"
2014,Enero,Islas Vírgenes Británicas/Territorio Británico de Ultramar,92,1,0,,1,"(4.697144,-74.140516)"
2014,Enero,República Árabe de Yemen,887,1,0,,1,"(11.360009,-72.129330)"
2014,Enero,Desconocido,99999,0,1,,1,"(1.813928,-78.763924)"
2014,Enero,Desconocido,99999,10,14,,24,"(4.697144,-74.140516)"
2014,Enero,Desconocido,99999,2,1,,3,"(6.185799,-67.483929)"
2014,Enero,Desconocido,99999,1,3,,4,"(8.635765,-77.346578)"
2014,Febrero,Desconocido,99999,0,1,,1,"(1.813928,-78.763924)"
2014,Febrero,Desconocido,99999,2,25,,27,"(12.5744111,-81.703935)"
2014,Febrero,Desconocido,99999,3,2,,5,"(6.185799,-67.483929)"
2014,Febrero,Afganistán,4,2,19,,21,"(4.697144,-74.140516)"
2014,Febrero,Alemania,276,14,11,,25,"(3.541112,-76.384584)"
2014,Febrero,Alemania,276,820,722,,1542,"(4.697144,-74.140516)"
2014,Febrero,Alemania,276,28,21,,49,"(6.171601,-75.427454)"
2014,Febrero,Andorra,20,1,1,,2,"(3.541112,-76.384584)"
2014,Febrero,Andorra,20,1,0,,1,"(4.697144,-74.140516)"
2014,Febrero,Angola,24,0,1,,1,"(3.541112,-76.384584)"
2014,Febrero,Angola,24,1,3,,4,"(4.697144,-74.140516)"
2014,Febrero,Países Bajos,528,40,28,,68,"(10.408582,-75.538003)"
2014,Febrero,Países Bajos,528,1,1,,2,"(10.445761,-75.516429)"
2014,Febrero,Países Bajos,528,1,0,,1,"(10.886611,-74.776708)"
2014,Febrero,Países Bajos,528,30,15,,45,"(3.541112,-76.384584)"
2014,Febrero,Países Bajos,528,77,62,,139,"(4.697144,-74.140516)"
2014,Febrero,Países Bajos,528,2,2,,4,"(4.815061,-75.736532)"
2014,Febrero,Países Bajos,528,41,21,,62,"(6.171601,-75.427454)"
2014,Febrero,Países Bajos,528,4,3,,7,"(7.128456,-73.183637)"
2014,Febrero,Arabia Saudita,682,8,12,,20,"(4.697144,-74.140516)"
2014,Febrero,Argelia,12,2,1,,3,"(4.697144,-74.140516)"
2014,Febrero,Argentina,32,19,32,,51,"(0.814836,-77.662532)"
2014,Febrero,Argentina,32,8,7,,15,"(10.445761,-75.516429)"
2014,Febrero,Argentina,32,14,3,,17,"(10.886611,-74.776708)"
2014,Febrero,Argentina,32,200,216,,416,"(3.541112,-76.384584)"
2014,Febrero,Argentina,32,2456,2574,,5030,"(4.697144,-74.140516)"
2014,Febrero,Argentina,32,8,5,,13,"(4.815061,-75.736532)"
2014,Febrero,Argentina,32,180,156,,336,"(6.171601,-75.427454)"
2014,Febrero,Argentina,32,2,5,,7,"(7.128456,-73.183637)"
2014,Febrero,Argentina,32,1,2,,3,"(7.927209,-72.507910)"
2014,Febrero,Aruba,533,2115,1402,,3517,"(10.408582,-75.538003)"
2014,Febrero,Aruba,533,5,3,,8,"(10.445761,-75.516429)"
2014,Febrero,Aruba,533,8,11,,19,"(10.886611,-74.776708)"
2014,Febrero,Aruba,533,57,39,,96,"(11.528919,-72.919681)"
2014,Febrero,Aruba,533,15,8,,23,"(3.541112,-76.384584)"
2014,Febrero,Aruba,533,889,798,,1687,"(4.697144,-74.140516)"
2014,Febrero,Aruba,533,30,20,,50,"(6.171601,-75.427454)"
2014,Febrero,Aruba,533,7,16,,23,"(7.128456,-73.183637)"
2014,Febrero,Aruba,533,1,1,,2,"(7.927209,-72.507910)"
2014,Febrero,Australia,36,2,1,,3,"(10.445761,-75.516429)"
2014,Febrero,Australia,36,6,2,,8,"(10.886611,-74.776708)"
2014,Febrero,Australia,36,23,22,,45,"(3.541112,-76.384584)"
2014,Febrero,Australia,36,242,174,,416,"(4.697144,-74.140516)"
2014,Febrero,Australia,36,2,2,,4,"(4.815061,-75.736532)"
2014,Febrero,Australia,36,39,25,,64,"(6.171601,-75.427454)"
2014,Febrero,Australia,36,1,1,,2,"(7.128456,-73.183637)"
2014,Febrero,Australia,36,3,1,,4,"(7.927209,-72.507910)"
2014,Febrero,Austria,40,2,0,,2,"(3.541112,-76.384584)"
2014,Febrero,Austria,40,41,29,,70,"(4.697144,-74.140516)"
2014,Febrero,Austria,40,1,1,,2,"(6.171601,-75.427454)"
2014,Febrero,Azerbaiyán,31,0,1,,1,"(4.697144,-74.140516)"
2014,Febrero,Bahamas,44,0,2,,2,"(10.445761,-75.516429)"
2014,Febrero,Bahamas,44,3,1,,4,"(10.886611,-74.776708)"
2014,Febrero,Bahamas,44,8,4,,12,"(3.541112,-76.384584)"
2014,Febrero,Bahamas,44,10,15,,25,"(4.697144,-74.140516)"
2014,Febrero,Bahamas,44,0,2,,2,"(4.815061,-75.736532)"
2014,Febrero,Bahamas,44,6,9,,15,"(6.171601,-75.427454)"
2014,Febrero,Bahamas,44,1,0,,1,"(7.128456,-73.183637)"
2014,Febrero,Bahréin,48,1,3,,4,"(4.697144,-74.140516)"
2014,Febrero,Bahréin,48,0,1,,1,"(6.171601,-75.427454)"
2014,Febrero,Bangladesh,50,0,1,,1,"(4.697144,-74.140516)"
2014,Febrero,Barbados,52,1,16,,17,"(4.697144,-74.140516)"
2014,Febrero,Barbados,52,1,1,,2,"(6.171601,-75.427454)"
2014,Febrero,República de Belarús,112,6,2,,8,"(11.360009,-72.129330)"
2014,Febrero,República de Belarús,112,0,3,,3,"(4.697144,-74.140516)"
2014,Febrero,República de Belarús,112,1,0,,1,"(7.818934,-72.453226)"
2014,Febrero,Bélgica,56,4,4,,8,"(3.541112,-76.384584)"
2014,Febrero,Bélgica,56,52,40,,92,"(4.697144,-74.140516)"
2014,Febrero,Bélgica,56,13,5,,18,"(6.171601,-75.427454)"
2014,Febrero,Belice,84,2,6,,8,"(4.697144,-74.140516)"
2014,Febrero,Benín,204,1,0,,1,"(4.697144,-74.140516)"
2014,Febrero,Bolivia,68,2,3,,5,"(0.814836,-77.662532)"
2014,Febrero,Bolivia,68,2,4,,6,"(10.886611,-74.776708)"
2014,Febrero,Bolivia,68,10,24,,34,"(3.541112,-76.384584)"
2014,Febrero,Bolivia,68,250,370,,620,"(4.697144,-74.140516)"
2014,Febrero,Bolivia,68,4,2,,6,"(4.815061,-75.736532)"
2014,Febrero,Bolivia,68,20,24,,44,"(6.171601,-75.427454)"
2014,Febrero,Bolivia,68,0,2,,2,"(7.128456,-73.183637)"
2014,Febrero,Brasil,76,120,203,,323,"(-4.197703,-69.941278)"
2014,Febrero,Brasil,76,1,4,,5,"(0.814836,-77.662532)"
2014,Febrero,Brasil,76,5,15,,20,"(10.445761,-75.516429)"
2014,Febrero,Brasil,76,6,10,,16,"(10.886611,-74.776708)"
2014,Febrero,Brasil,76,1,0,,1,"(12.586067,-81.702563)"
2014,Febrero,Brasil,76,52,113,,165,"(3.541112,-76.384584)"
2014,Febrero,Brasil,76,2730,3560,,6290,"(4.697144,-74.140516)"
2014,Febrero,Brasil,76,9,19,,28,"(4.815061,-75.736532)"
2014,Febrero,Brasil,76,73,131,,204,"(6.171601,-75.427454)"
2014,Febrero,Brasil,76,1,1,,2,"(7.128456,-73.183637)"
2014,Febrero,Brasil,76,0,3,,3,"(7.927209,-72.507910)"
2014,Febrero,Brunei Darussalam,96,1,0,,1,"(4.697144,-74.140516)"
2014,Febrero,Bulgaria,100,1,0,,1,"(4.697144,-74.140516)"
2014,Febrero,Burundi,108,0,1,,1,"(4.697144,-74.140516)"
2014,Febrero,Islas Caimán/Territorio Británico de Ultramar,136,1,3,,4,"(10.445761,-75.516429)"
2014,Febrero,Islas Caimán/Territorio Británico de Ultramar,136,3,0,,3,"(12.586067,-81.702563)"
2014,Febrero,Islas Caimán/Territorio Británico de Ultramar,136,3,0,,3,"(4.697144,-74.140516)"
2014,Febrero,Islas Caimán/Territorio Británico de Ultramar,136,1,1,,2,"(7.128456,-73.183637)"
2014,Febrero,Camboya,116,1,0,,1,"(4.697144,-74.140516)"
2014,Febrero,Camerún,120,1,0,,1,"(4.697144,-74.140516)"
2014,Febrero,Camerún,120,0,1,,1,"(6.171601,-75.427454)"
2014,Febrero,Canadá,124,69,35,,104,"(10.445761,-75.516429)"
2014,Febrero,Canadá,124,10,5,,15,"(10.886611,-74.776708)"
2014,Febrero,Canadá,124,7,5,,12,"(12.586067,-81.702563)"
2014,Febrero,Canadá,124,76,50,,126,"(3.541112,-76.384584)"
2014,Febrero,Canadá,124,13,21,,34,"(4.452882,-75.766298)"
2014,Febrero,Canadá,124,1075,975,,2050,"(4.697144,-74.140516)"
2014,Febrero,Canadá,124,6,7,,13,"(4.815061,-75.736532)"
2014,Febrero,Canadá,124,138,107,,245,"(6.171601,-75.427454)"
2014,Febrero,Canadá,124,3,9,,12,"(7.128456,-73.183637)"
2014,Febrero,Chad,148,0,3,,3,"(4.697144,-74.140516)"
2014,Febrero,España,724,2,2,,4,"(10.445761,-75.516429)"
2014,Febrero,España,724,1,0,,1,"(10.886611,-74.776708)"
2014,Febrero,España,724,0,1,,1,"(12.586067,-81.702563)"
2014,Febrero,España,724,1351,698,,2049,"(3.541112,-76.384584)"
2014,Febrero,España,724,6677,5070,,11747,"(4.697144,-74.140516)"
2014,Febrero,España,724,3,4,,7,"(4.815061,-75.736532)"
2014,Febrero,España,724,731,508,,1239,"(6.171601,-75.427454)"
2014,Febrero,República Democrática del Congo,180,0,8,,8,"(4.697144,-74.140516)"
2014,Febrero,República Democrática del Congo,180,0,1,,1,"(6.171601,-75.427454)"
2014,Febrero,República de Corea,410,1,0,,1,"(3.541112,-76.384584)"
2014,Febrero,República de Corea,410,10,19,,29,"(4.697144,-74.140516)"
2014,Febrero,República de Corea,410,1,5,,6,"(6.171601,-75.427454)"
2014,Febrero,Costa de Marfil,384,1,0,,1,"(3.541112,-76.384584)"
2014,Febrero,Costa de Marfil,384,3,6,,9,"(4.697144,-74.140516)"
2014,Febrero,Costa de Marfil,384,2,3,,5,"(6.171601,-75.427454)"
2014,Febrero,Costa Rica,188,5,11,,16,"(10.445761,-75.516429)"
2014,Febrero,Costa Rica,188,19,18,,37,"(10.886611,-74.776708)"
2014,Febrero,Costa Rica,188,0,6,,6,"(12.5744111,-81.703935)"
2014,Febrero,Costa Rica,188,2,4,,6,"(12.586067,-81.702563)"
2014,Febrero,Costa Rica,188,0,14,,14,"(13.3387613,-81.372937)"
2014,Febrero,Costa Rica,188,47,51,,98,"(3.541112,-76.384584)"
2014,Febrero,Costa Rica,188,676,826,,1502,"(4.697144,-74.140516)"
2014,Febrero,Costa Rica,188,13,7,,20,"(4.815061,-75.736532)"
2014,Febrero,Costa Rica,188,99,115,,214,"(6.171601,-75.427454)"
2014,Febrero,Costa Rica,188,3,3,,6,"(7.128456,-73.183637)"
2014,Febrero,Costa Rica,188,2,2,,4,"(7.927209,-72.507910)"
2014,Febrero,Croacia,191,2,1,,3,"(4.697144,-74.140516)"
2014,Febrero,Cuba,192,17,15,,32,"(10.445761,-75.516429)"
2014,Febrero,Cuba,192,14,22,,36,"(10.886611,-74.776708)"
2014,Febrero,Cuba,192,1,4,,5,"(12.586067,-81.702563)"
2014,Febrero,Cuba,192,70,79,,149,"(3.541112,-76.384584)"
2014,Febrero,Cuba,192,646,674,,1320,"(4.697144,-74.140516)"
2014,Febrero,Cuba,192,9,11,,20,"(4.815061,-75.736532)"
2014,Febrero,Cuba,192,96,65,,161,"(6.171601,-75.427454)"
2014,Febrero,Cuba,192,3,2,,5,"(7.128456,-73.183637)"
2014,Febrero,Cuba,192,3,3,,6,"(7.927209,-72.507910)"
2014,Febrero,Curazao,99999,1,2,,3,"(10.408582,-75.538003)"
2014,Febrero,Curazao,99999,4,5,,9,"(10.886611,-74.776708)"
2014,Febrero,Curazao,99999,9,5,,14,"(3.541112,-76.384584)"
2014,Febrero,Curazao,99999,261,398,,659,"(4.697144,-74.140516)"
2014,Febrero,Curazao,99999,63,42,,105,"(6.171601,-75.427454)"
2014,Febrero,República Checa,203,1,0,,1,"(3.541112,-76.384584)"
2014,Febrero,República Checa,203,4,6,,10,"(4.697144,-74.140516)"
2014,Febrero,Chile,152,112,115,,227,"(0.814836,-77.662532)"
2014,Febrero,Chile,152,5,1,,6,"(10.445761,-75.516429)"
2014,Febrero,Chile,152,13,4,,17,"(10.886611,-74.776708)"
2014,Febrero,Chile,152,2,1,,3,"(12.586067,-81.702563)"
2014,Febrero,Chile,152,518,363,,881,"(3.541112,-76.384584)"
2014,Febrero,Chile,152,2101,1786,,3887,"(4.697144,-74.140516)"
2014,Febrero,Chile,152,13,11,,24,"(4.815061,-75.736532)"
2014,Febrero,Chile,152,146,98,,244,"(6.171601,-75.427454)"
2014,Febrero,Chile,152,2,1,,3,"(7.128456,-73.183637)"
2014,Febrero,Chile,152,2,0,,2,"(7.927209,-72.507910)"
2014,Febrero,China,156,1,9,,10,"(10.886611,-74.776708)"
2014,Febrero,China,156,2,12,,14,"(3.541112,-76.384584)"
2014,Febrero,China,156,205,561,,766,"(4.697144,-74.140516)"
2014,Febrero,China,156,1,5,,6,"(4.815061,-75.736532)"
2014,Febrero,China,156,13,39,,52,"(6.171601,-75.427454)"
2014,Febrero,China,156,2,2,,4,"(7.128456,-73.183637)"
2014,Febrero,Chipre,196,1,0,,1,"(4.697144,-74.140516)"
2014,Febrero,Dinamarca,208,1,0,,1,"(3.541112,-76.384584)"
2014,Febrero,Dinamarca,208,24,14,,38,"(4.697144,-74.140516)"
2014,Febrero,Dinamarca,208,1,0,,1,"(6.171601,-75.427454)"
2014,Febrero,Dominica,212,0,1,,1,"(4.815061,-75.736532)"
2014,Febrero,Ecuador,218,421,587,,1008,"(0.25129,-76.875963)"
2014,Febrero,Ecuador,218,6997,7712,,14709,"(0.814836,-77.662532)"
2014,Febrero,Ecuador,218,101,130,,231,"(1.813928,-78.763924)"
2014,Febrero,Ecuador,218,0,1,,1,"(10.408582,-75.538003)"
2014,Febrero,Ecuador,218,6,14,,20,"(10.445761,-75.516429)"
2014,Febrero,Ecuador,218,20,23,,43,"(10.886611,-74.776708)"
2014,Febrero,Ecuador,218,700,713,,1413,"(3.541112,-76.384584)"
2014,Febrero,Ecuador,218,2666,4105,,6771,"(4.697144,-74.140516)"
2014,Febrero,Ecuador,218,18,9,,27,"(4.815061,-75.736532)"
2014,Febrero,Ecuador,218,380,332,,712,"(6.171601,-75.427454)"
2014,Febrero,Ecuador,218,4,3,,7,"(7.128456,-73.183637)"
2014,Febrero,Ecuador,218,4,3,,7,"(7.927209,-72.507910)"
2014,Febrero,Egipto,818,9,118,,127,"(4.697144,-74.140516)"
2014,Febrero,El Salvador,222,2,3,,5,"(10.445761,-75.516429)"
2014,Febrero,El Salvador,222,3,5,,8,"(10.886611,-74.776708)"
2014,Febrero,El Salvador,222,0,1,,1,"(12.586067,-81.702563)"
2014,Febrero,El Salvador,222,100,94,,194,"(3.541112,-76.384584)"
2014,Febrero,El Salvador,222,636,894,,1530,"(4.697144,-74.140516)"
2014,Febrero,El Salvador,222,0,1,,1,"(4.815061,-75.736532)"
2014,Febrero,El Salvador,222,101,120,,221,"(6.171601,-75.427454)"
2014,Febrero,Emiratos Árabes,784,1,4,,5,"(3.541112,-76.384584)"
2014,Febrero,Emiratos Árabes,784,70,322,,392,"(4.697144,-74.140516)"
2014,Febrero,Emiratos Árabes,784,3,3,,6,"(6.171601,-75.427454)"
2014,Febrero,Eritrea,232,2,1,,3,"(4.697144,-74.140516)"
2014,Febrero,Eslovaquia,703,1,0,,1,"(3.541112,-76.384584)"
2014,Febrero,Eslovenia,705,2,4,,6,"(4.697144,-74.140516)"
2014,Febrero,Estados Unidos de América,840,1371,1249,,2620,"(10.445761,-75.516429)"
2014,Febrero,Estados Unidos de América,840,1189,1087,,2276,"(10.886611,-74.776708)"
2014,Febrero,Estados Unidos de América,840,14,5,,19,"(12.586067,-81.702563)"
2014,Febrero,Estados Unidos de América,840,3502,2682,,6184,"(3.541112,-76.384584)"
2014,Febrero,Estados Unidos de América,840,463,376,,839,"(4.452882,-75.766298)"
2014,Febrero,Estados Unidos de América,840,21121,20879,,42000,"(4.697144,-74.140516)"
2014,Febrero,Estados Unidos de América,840,359,247,,606,"(4.815061,-75.736532)"
2014,Febrero,Estados Unidos de América,840,5915,5059,,10974,"(6.171601,-75.427454)"
2014,Febrero,Estados Unidos de América,840,79,69,,148,"(7.128456,-73.183637)"
2014,Febrero,Estados Unidos de América,840,33,34,,67,"(7.927209,-72.507910)"
2014,Febrero,Etiopia,231,0,5,,5,"(4.697144,-74.140516)"
2014,Febrero,Islas Fiji,242,0,1,,1,"(4.697144,-74.140516)"
2014,Febrero,Filipinas,608,2,1,,3,"(4.697144,-74.140516)"
2014,Febrero,Finlandia,246,1,0,,1,"(3.541112,-76.384584)"
2014,Febrero,Finlandia,246,10,4,,14,"(4.697144,-74.140516)"
2014,Febrero,Finlandia,246,0,1,,1,"(6.171601,-75.427454)"
2014,Febrero,Francia,250,1,0,,1,"(10.445761,-75.516429)"
2014,Febrero,Francia,250,24,21,,45,"(3.541112,-76.384584)"
2014,Febrero,Francia,250,871,730,,1601,"(4.697144,-74.140516)"
2014,Febrero,Francia,250,33,13,,46,"(6.171601,-75.427454)"
2014,Febrero,Gabón,266,1,8,,9,"(4.697144,-74.140516)"
2014,Febrero,Georgia,268,1,0,,1,"(4.697144,-74.140516)"
2014,Febrero,Gibraltar/Territorio Británico de Ultramar,292,1,0,,1,"(4.697144,-74.140516)"
2014,Febrero,Grecia,300,1,1,,2,"(3.541112,-76.384584)"
2014,Febrero,Grecia,300,10,2,,12,"(4.697144,-74.140516)"
2014,Febrero,Guatemala,320,0,3,,3,"(10.445761,-75.516429)"
2014,Febrero,Guatemala,320,4,7,,11,"(10.886611,-74.776708)"
2014,Febrero,Guatemala,320,1,1,,2,"(12.586067,-81.702563)"
2014,Febrero,Guatemala,320,35,64,,99,"(3.541112,-76.384584)"
2014,Febrero,Guatemala,320,318,462,,780,"(4.697144,-74.140516)"
2014,Febrero,Guatemala,320,3,3,,6,"(4.815061,-75.736532)"
2014,Febrero,Guatemala,320,52,81,,133,"(6.171601,-75.427454)"
2014,Febrero,Guatemala,320,0,2,,2,"(7.128456,-73.183637)"
2014,Febrero,Guatemala,320,1,2,,3,"(7.927209,-72.507910)"
2014,Febrero,Guyana,328,1,0,,1,"(4.697144,-74.140516)"
2014,Febrero,Guyana,328,1,0,,1,"(6.171601,-75.427454)"
2014,Febrero,Guinea,324,0,1,,1,"(0.814836,-77.662532)"
2014,Febrero,Guinea,324,1,1,,2,"(4.697144,-74.140516)"
2014,Febrero,Guinea Ecuatorial,226,0,2,,2,"(3.541112,-76.384584)"
2014,Febrero,Guinea Ecuatorial,226,1,10,,11,"(4.697144,-74.140516)"
2014,Febrero,Guadalupe/Territorio Francés,312,0,2,,2,"(4.697144,-74.140516)"
2014,Febrero,Haití,332,0,2,,2,"(10.886611,-74.776708)"
2014,Febrero,Haití,332,0,2,,2,"(3.541112,-76.384584)"
2014,Febrero,Haití,332,1,2,,3,"(4.697144,-74.140516)"
2014,Febrero,Haití,332,3,7,,10,"(6.171601,-75.427454)"
2014,Febrero,Honduras,340,3,13,,16,"(10.445761,-75.516429)"
2014,Febrero,Honduras,340,6,1,,7,"(10.886611,-74.776708)"
2014,Febrero,Honduras,340,0,1,,1,"(12.586067,-81.702563)"
2014,Febrero,Honduras,340,9,13,,22,"(3.541112,-76.384584)"
2014,Febrero,Honduras,340,45,113,,158,"(4.697144,-74.140516)"
2014,Febrero,Honduras,340,3,2,,5,"(4.815061,-75.736532)"
2014,Febrero,Honduras,340,31,46,,77,"(6.171601,-75.427454)"
2014,Febrero,Honduras,340,0,1,,1,"(7.128456,-73.183637)"
2014,Febrero,Hong Kong,344,0,1,,1,"(0.814836,-77.662532)"
2014,Febrero,Hong Kong,344,0,1,,1,"(3.541112,-76.384584)"
2014,Febrero,Hong Kong,344,29,75,,104,"(4.697144,-74.140516)"
2014,Febrero,Hong Kong,344,0,1,,1,"(4.815061,-75.736532)"
2014,Febrero,Hong Kong,344,0,3,,3,"(6.171601,-75.427454)"
2014,Febrero,Hungría,348,2,2,,4,"(4.697144,-74.140516)"
2014,Febrero,Hungría,348,0,1,,1,"(6.171601,-75.427454)"
2014,Febrero,India,356,2,0,,2,"(10.886611,-74.776708)"
2014,Febrero,India,356,1,1,,2,"(3.541112,-76.384584)"
2014,Febrero,India,356,46,48,,94,"(4.697144,-74.140516)"
2014,Febrero,India,356,2,0,,2,"(4.815061,-75.736532)"
2014,Febrero,India,356,1,2,,3,"(6.171601,-75.427454)"
2014,Febrero,Indonesia,360,4,5,,9,"(4.697144,-74.140516)"
2014,Febrero,Iraq,368,0,8,,8,"(4.697144,-74.140516)"
2014,Febrero,Iraq,368,0,1,,1,"(7.128456,-73.183637)"
2014,Febrero,Irán,364,3,0,,3,"(4.697144,-74.140516)"
2014,Febrero,República de Irlanda,372,13,6,,19,"(4.697144,-74.140516)"
2014,Febrero,Islandia,352,1,1,,2,"(4.697144,-74.140516)"
2014,Febrero,Israel,376,1,3,,4,"(3.541112,-76.384584)"
2014,Febrero,Israel,376,133,108,,241,"(4.697144,-74.140516)"
2014,Febrero,Israel,376,3,0,,3,"(6.171601,-75.427454)"
2014,Febrero,Italia,380,4,1,,5,"(10.445761,-75.516429)"
2014,Febrero,Italia,380,1,1,,2,"(10.886611,-74.776708)"
2014,Febrero,Italia,380,49,24,,73,"(3.541112,-76.384584)"
2014,Febrero,Italia,380,647,338,,985,"(4.697144,-74.140516)"
2014,Febrero,Italia,380,1,0,,1,"(4.815061,-75.736532)"
2014,Febrero,Italia,380,28,21,,49,"(6.171601,-75.427454)"
2014,Febrero,Jamaica,388,1,2,,3,"(10.445761,-75.516429)"
2014,Febrero,Jamaica,388,1,1,,2,"(10.886611,-74.776708)"
2014,Febrero,Jamaica,388,1,0,,1,"(12.586067,-81.702563)"
2014,Febrero,Jamaica,388,4,8,,12,"(3.541112,-76.384584)"
2014,Febrero,Jamaica,388,9,8,,17,"(4.697144,-74.140516)"
2014,Febrero,Jamaica,388,1,2,,3,"(4.815061,-75.736532)"
2014,Febrero,Jamaica,388,8,8,,16,"(6.171601,-75.427454)"
2014,Febrero,Japón,392,1,0,,1,"(10.886611,-74.776708)"
2014,Febrero,Japón,392,4,2,,6,"(3.541112,-76.384584)"
2014,Febrero,Japón,392,38,37,,75,"(4.697144,-74.140516)"
2014,Febrero,Japón,392,2,1,,3,"(6.171601,-75.427454)"
2014,Febrero,Jordania,400,0,2,,2,"(10.408582,-75.538003)"
2014,Febrero,Jordania,400,5,8,,13,"(4.697144,-74.140516)"
2014,Febrero,Kazajistán,398,1,0,,1,"(10.886611,-74.776708)"
2014,Febrero,Kazajistán,398,0,2,,2,"(4.697144,-74.140516)"
2014,Febrero,Kenia,404,0,1,,1,"(3.541112,-76.384584)"
2014,Febrero,Kenia,404,4,10,,14,"(4.697144,-74.140516)"
2014,Febrero,Kuwait,414,0,1,,1,"(4.697144,-74.140516)"
2014,Febrero,Lituania,440,0,15,,15,"(4.697144,-74.140516)"
2014,Febrero,Líbano,422,4,16,,20,"(4.697144,-74.140516)"
2014,Febrero,Líbano,422,0,1,,1,"(6.171601,-75.427454)"
2014,Febrero,Liberia,430,1,0,,1,"(4.697144,-74.140516)"
2014,Febrero,Libia,434,1,2,,3,"(4.697144,-74.140516)"
2014,Febrero,Luxemburgo,442,1,1,,2,"(4.697144,-74.140516)"
2014,Febrero,Luxemburgo,442,0,1,,1,"(6.171601,-75.427454)"
2014,Febrero,Malasia,458,1,1,,2,"(3.541112,-76.384584)"
2014,Febrero,Malasia,458,6,8,,14,"(4.697144,-74.140516)"
2014,Febrero,Malasia,458,2,7,,9,"(6.171601,-75.427454)"
2014,Febrero,Malta,470,3,1,,4,"(4.697144,-74.140516)"
2014,Febrero,Marruecos,504,1,1,,2,"(4.697144,-74.140516)"
2014,Febrero,Marruecos,504,1,0,,1,"(6.171601,-75.427454)"
2014,Febrero,Martinica/Departamento de Ultramar Francés,474,1,0,,1,"(6.171601,-75.427454)"
2014,Febrero,México,484,0,1,,1,"(10.408582,-75.538003)"
2014,Febrero,México,484,21,16,,37,"(10.445761,-75.516429)"
2014,Febrero,México,484,52,53,,105,"(10.886611,-74.776708)"
2014,Febrero,México,484,321,321,,642,"(3.541112,-76.384584)"
2014,Febrero,México,484,5953,6001,,11954,"(4.697144,-74.140516)"
2014,Febrero,México,484,52,50,,102,"(4.815061,-75.736532)"
2014,Febrero,México,484,676,600,,1276,"(6.171601,-75.427454)"
2014,Febrero,México,484,39,38,,77,"(7.128456,-73.183637)"
2014,Febrero,México,484,63,36,,99,"(7.927209,-72.507910)"
2014,Febrero,Mónaco,492,2,0,,2,"(4.697144,-74.140516)"
2014,Febrero,Mozambique,508,0,3,,3,"(4.697144,-74.140516)"
2014,Febrero,Myanmar,104,1,1,,2,"(4.697144,-74.140516)"
2014,Febrero,Nicaragua,558,3,0,,3,"(10.445761,-75.516429)"
2014,Febrero,Nicaragua,558,2,0,,2,"(10.886611,-74.776708)"
2014,Febrero,Nicaragua,558,11,22,,33,"(3.541112,-76.384584)"
2014,Febrero,Nicaragua,558,31,76,,107,"(4.697144,-74.140516)"
2014,Febrero,Nicaragua,558,0,3,,3,"(4.815061,-75.736532)"
2014,Febrero,Nicaragua,558,8,20,,28,"(6.171601,-75.427454)"
2014,Febrero,Nicaragua,558,1,1,,2,"(7.128456,-73.183637)"
2014,Febrero,Nicaragua,558,2,1,,3,"(7.927209,-72.507910)"
2014,Febrero,Nigeria,566,0,1,,1,"(10.445761,-75.516429)"
2014,Febrero,Nigeria,566,0,1,,1,"(10.886611,-74.776708)"
2014,Febrero,Nigeria,566,0,11,,11,"(4.697144,-74.140516)"
2014,Febrero,Noruega,578,0,1,,1,"(10.445761,-75.516429)"
2014,Febrero,Noruega,578,3,2,,5,"(3.541112,-76.384584)"
2014,Febrero,Noruega,578,19,15,,34,"(4.697144,-74.140516)"
2014,Febrero,Noruega,578,3,0,,3,"(6.171601,-75.427454)"
2014,Febrero,Nueva Zelanda,554,0,1,,1,"(10.886611,-74.776708)"
2014,Febrero,Nueva Zelanda,554,1,0,,1,"(3.541112,-76.384584)"
2014,Febrero,Nueva Zelanda,554,25,10,,35,"(4.697144,-74.140516)"
2014,Febrero,Nueva Zelanda,554,1,7,,8,"(6.171601,-75.427454)"
2014,Febrero,Omán,512,0,1,,1,"(4.697144,-74.140516)"
2014,Febrero,Papúa Nueva Guinea,598,0,5,,5,"(4.697144,-74.140516)"
2014,Febrero,Papúa Nueva Guinea,598,0,1,,1,"(6.171601,-75.427454)"
2014,Febrero,Pakistán,586,0,1,,1,"(4.697144,-74.140516)"
2014,Febrero,Panamá,591,57,96,,153,"(10.408582,-75.538003)"
2014,Febrero,Panamá,591,328,327,,655,"(10.445761,-75.516429)"
2014,Febrero,Panamá,591,819,909,,1728,"(10.886611,-74.776708)"
2014,Febrero,Panamá,591,59,75,,134,"(12.586067,-81.702563)"
2014,Febrero,Panamá,591,0,8,,8,"(13.3387613,-81.372937)"
2014,Febrero,Panamá,591,2126,1873,,3999,"(3.541112,-76.384584)"
2014,Febrero,Panamá,591,6333,7222,,13555,"(4.697144,-74.140516)"
2014,Febrero,Panamá,591,732,662,,1394,"(4.815061,-75.736532)"
2014,Febrero,Panamá,591,1976,2028,,4004,"(6.171601,-75.427454)"
2014,Febrero,Panamá,591,2,5,,7,"(6.228046,-77.404104)"
2014,Febrero,Panamá,591,12,23,,35,"(7.102626,-77.762647)"
2014,Febrero,Panamá,591,275,304,,579,"(7.128456,-73.183637)"
2014,Febrero,Panamá,591,166,209,,375,"(7.927209,-72.507910)"
2014,Febrero,Panamá,591,0,63,,63,"(8.066966,-76.735404)"
2014,Febrero,Panamá,591,129,164,,293,"(8.635765,-77.346578)"
2014,Febrero,Paraguay,600,0,1,,1,"(0.814836,-77.662532)"
2014,Febrero,Paraguay,600,0,4,,4,"(10.445761,-75.516429)"
2014,Febrero,Paraguay,600,1,0,,1,"(10.886611,-74.776708)"
2014,Febrero,Paraguay,600,10,16,,26,"(3.541112,-76.384584)"
2014,Febrero,Paraguay,600,29,97,,126,"(4.697144,-74.140516)"
2014,Febrero,Paraguay,600,1,1,,2,"(4.815061,-75.736532)"
2014,Febrero,Paraguay,600,6,10,,16,"(6.171601,-75.427454)"
2014,Febrero,Perú,604,79,121,,200,"(-4.197703,-69.941278)"
2014,Febrero,Perú,604,43,53,,96,"(0.814836,-77.662532)"
2014,Febrero,Perú,604,9,4,,13,"(10.445761,-75.516429)"
2014,Febrero,Perú,604,25,33,,58,"(10.886611,-74.776708)"
2014,Febrero,Perú,604,285,339,,624,"(3.541112,-76.384584)"
2014,Febrero,Perú,604,0,3,,3,"(3.893038,-77.067921)"
2014,Febrero,Perú,604,2551,3242,,5793,"(4.697144,-74.140516)"
2014,Febrero,Perú,604,16,28,,44,"(4.815061,-75.736532)"
2014,Febrero,Perú,604,328,395,,723,"(6.171601,-75.427454)"
2014,Febrero,Perú,604,10,13,,23,"(7.128456,-73.183637)"
2014,Febrero,Perú,604,3,3,,6,"(7.927209,-72.507910)"
2014,Febrero,Polonia,616,8,8,,16,"(4.697144,-74.140516)"
2014,Febrero,Polonia,616,1,0,,1,"(6.171601,-75.427454)"
2014,Febrero,Portugal,620,0,1,,1,"(10.886611,-74.776708)"
2014,Febrero,Portugal,620,1,0,,1,"(3.541112,-76.384584)"
2014,Febrero,Portugal,620,20,21,,41,"(4.697144,-74.140516)"
2014,Febrero,Portugal,620,1,2,,3,"(6.171601,-75.427454)"
2014,Febrero,Polinesia Francesa/Colectividad de Ultramar Francesa,258,1,1,,2,"(4.697144,-74.140516)"
2014,Febrero,Puerto Rico/Territorio de Estados Unidos,630,7,3,,10,"(10.445761,-75.516429)"
2014,Febrero,Puerto Rico/Territorio de Estados Unidos,630,6,11,,17,"(10.886611,-74.776708)"
2014,Febrero,Puerto Rico/Territorio de Estados Unidos,630,16,15,,31,"(3.541112,-76.384584)"
2014,Febrero,Puerto Rico/Territorio de Estados Unidos,630,274,302,,576,"(4.697144,-74.140516)"
2014,Febrero,Puerto Rico/Territorio de Estados Unidos,630,2,3,,5,"(4.815061,-75.736532)"
2014,Febrero,Puerto Rico/Territorio de Estados Unidos,630,37,37,,74,"(6.171601,-75.427454)"
2014,Febrero,Puerto Rico/Territorio de Estados Unidos,630,3,4,,7,"(7.128456,-73.183637)"
2014,Febrero,Puerto Rico/Territorio de Estados Unidos,630,1,1,,2,"(7.927209,-72.507910)"
2014,Febrero,Qatar,634,3,6,,9,"(4.697144,-74.140516)"
2014,Febrero,Qatar,634,0,1,,1,"(6.171601,-75.427454)"
2014,Febrero,Reino Unido de Gran Bretaña e Irlanda del Norte,826,3,1,,4,"(10.445761,-75.516429)"
2014,Febrero,Reino Unido de Gran Bretaña e Irlanda del Norte,826,1,0,,1,"(10.886611,-74.776708)"
2014,Febrero,Reino Unido de Gran Bretaña e Irlanda del Norte,826,20,14,,34,"(3.541112,-76.384584)"
2014,Febrero,Reino Unido de Gran Bretaña e Irlanda del Norte,826,549,455,,1004,"(4.697144,-74.140516)"
2014,Febrero,Reino Unido de Gran Bretaña e Irlanda del Norte,826,28,19,,47,"(6.171601,-75.427454)"
2014,Febrero,República CentroÁfricana,140,1,0,,1,"(4.697144,-74.140516)"
2014,Febrero,Federación de Rusia,643,11,26,,37,"(4.697144,-74.140516)"
2014,Febrero,Federación de Rusia,643,2,2,,4,"(6.171601,-75.427454)"
2014,Febrero,República Dominicana,214,5,14,,19,"(10.445761,-75.516429)"
2014,Febrero,República Dominicana,214,12,22,,34,"(10.886611,-74.776708)"
2014,Febrero,República Dominicana,214,0,1,,1,"(12.586067,-81.702563)"
2014,Febrero,República Dominicana,214,26,33,,59,"(3.541112,-76.384584)"
2014,Febrero,República Dominicana,214,762,835,,1597,"(4.697144,-74.140516)"
2014,Febrero,República Dominicana,214,11,21,,32,"(4.815061,-75.736532)"
2014,Febrero,República Dominicana,214,79,87,,166,"(6.171601,-75.427454)"
2014,Febrero,República Dominicana,214,19,17,,36,"(7.128456,-73.183637)"
2014,Febrero,República Dominicana,214,1,3,,4,"(7.927209,-72.507910)"
2014,Febrero,República Democrática Popular de Corea,408,1,1,,2,"(4.697144,-74.140516)"
2014,Febrero,Rumania,642,1,3,,4,"(4.697144,-74.140516)"
2014,Febrero,Rwanda,646,1,0,,1,"(4.697144,-74.140516)"
2014,Febrero,San Cristóbal y Nevis,659,0,1,,1,"(4.697144,-74.140516)"
2014,Febrero,San Marino,674,0,1,,1,"(10.886611,-74.776708)"
2014,Febrero,Santo Tomé y Príncipe,678,1,0,,1,"(4.697144,-74.140516)"
2014,Febrero,Senegal,686,1,0,,1,"(4.697144,-74.140516)"
2014,Febrero,Singapur,702,0,1,,1,"(10.445761,-75.516429)"
2014,Febrero,Singapur,702,10,15,,25,"(4.697144,-74.140516)"
2014,Febrero,Sri Lanka,144,1,0,,1,"(6.171601,-75.427454)"
2014,Febrero,Sudáfrica,710,10,21,,31,"(4.697144,-74.140516)"
2014,Febrero,Sudáfrica,710,1,0,,1,"(6.171601,-75.427454)"
2014,Febrero,Sudán,736,0,2,,2,"(4.697144,-74.140516)"
2014,Febrero,Suecia,752,9,7,,16,"(3.541112,-76.384584)"
2014,Febrero,Suecia,752,59,69,,128,"(4.697144,-74.140516)"
2014,Febrero,Suecia,752,2,2,,4,"(6.171601,-75.427454)"
2014,Febrero,Suiza,756,0,1,,1,"(10.445761,-75.516429)"
2014,Febrero,Suiza,756,1,1,,2,"(10.886611,-74.776708)"
2014,Febrero,Suiza,756,19,8,,27,"(3.541112,-76.384584)"
2014,Febrero,Suiza,756,210,109,,319,"(4.697144,-74.140516)"
2014,Febrero,Suiza,756,15,12,,27,"(6.171601,-75.427454)"
2014,Febrero,Surinam,740,0,2,,2,"(3.541112,-76.384584)"
2014,Febrero,Surinam,740,5,36,,41,"(4.697144,-74.140516)"
2014,Febrero,Suazilandia,748,0,1,,1,"(4.697144,-74.140516)"
2014,Febrero,Taiwán,158,0,1,,1,"(3.541112,-76.384584)"
2014,Febrero,Taiwán,158,0,4,,4,"(4.697144,-74.140516)"
2014,Febrero,Taiwán,158,0,3,,3,"(6.171601,-75.427454)"
2014,Febrero,Tailandia,764,1,1,,2,"(10.886611,-74.776708)"
2014,Febrero,Tailandia,764,1,0,,1,"(3.541112,-76.384584)"
2014,Febrero,Tailandia,764,16,23,,39,"(4.697144,-74.140516)"
2014,Febrero,Tailandia,764,4,2,,6,"(6.171601,-75.427454)"
2014,Febrero,Togo,768,0,1,,1,"(4.697144,-74.140516)"
2014,Febrero,Tonga,776,0,1,,1,"(11.360009,-72.129330)"
2014,Febrero,Tokelau,772,1,0,,1,"(11.360009,-72.129330)"
2014,Febrero,Trinidad y Tobago,780,2,5,,7,"(10.445761,-75.516429)"
2014,Febrero,Trinidad y Tobago,780,5,7,,12,"(10.886611,-74.776708)"
2014,Febrero,Trinidad y Tobago,780,3,8,,11,"(3.541112,-76.384584)"
2014,Febrero,Trinidad y Tobago,780,12,24,,36,"(4.697144,-74.140516)"
2014,Febrero,Trinidad y Tobago,780,0,1,,1,"(4.815061,-75.736532)"
2014,Febrero,Trinidad y Tobago,780,6,14,,20,"(6.171601,-75.427454)"
2014,Febrero,Trinidad y Tobago,780,4,0,,4,"(7.128456,-73.183637)"
2014,Febrero,Trinidad y Tobago,780,1,1,,2,"(7.927209,-72.507910)"
2014,Febrero,Túnez,788,0,1,,1,"(11.360009,-72.129330)"
2014,Febrero,Túnez,788,0,1,,1,"(4.697144,-74.140516)"
2014,Febrero,Turquía,792,1,0,,1,"(3.541112,-76.384584)"
2014,Febrero,Turquía,792,103,81,,184,"(4.697144,-74.140516)"
2014,Febrero,Turkmenistán,795,2,0,,2,"(4.697144,-74.140516)"
2014,Febrero,Ucrania,804,1,3,,4,"(4.697144,-74.140516)"
2014,Febrero,Uganda,800,3,0,,3,"(4.697144,-74.140516)"
2014,Febrero,Uruguay,858,1,1,,2,"(0.814836,-77.662532)"
2014,Febrero,Uruguay,858,3,1,,4,"(10.445761,-75.516429)"
2014,Febrero,Uruguay,858,1,1,,2,"(10.886611,-74.776708)"
2014,Febrero,Uruguay,858,15,7,,22,"(3.541112,-76.384584)"
2014,Febrero,Uruguay,858,38,44,,82,"(4.697144,-74.140516)"
2014,Febrero,Uruguay,858,13,18,,31,"(6.171601,-75.427454)"
2014,Febrero,Venezuela,862,1,0,,1,"(10.408582,-75.538003)"
2014,Febrero,Venezuela,862,5,7,,12,"(10.445761,-75.516429)"
2014,Febrero,Venezuela,862,15,21,,36,"(10.886611,-74.776708)"
2014,Febrero,Venezuela,862,7249,6364,,13613,"(11.360009,-72.129330)"
2014,Febrero,Venezuela,862,1,1,,2,"(11.528919,-72.919681)"
2014,Febrero,Venezuela,862,0,1,,1,"(12.586067,-81.702563)"
2014,Febrero,Venezuela,862,7,4,,11,"(3.541112,-76.384584)"
2014,Febrero,Venezuela,862,1265,1616,,2881,"(4.697144,-74.140516)"
2014,Febrero,Venezuela,862,2,5,,7,"(4.815061,-75.736532)"
2014,Febrero,Venezuela,862,168,166,,334,"(6.171601,-75.427454)"
2014,Febrero,Venezuela,862,258,321,,579,"(6.185799,-67.483929)"
2014,Febrero,Venezuela,862,1655,1661,,3316,"(7.088729,-70.740253)"
2014,Febrero,Venezuela,862,2,13,,15,"(7.128456,-73.183637)"
2014,Febrero,Venezuela,862,5654,5644,,11298,"(7.818934,-72.453226)"
2014,Febrero,Venezuela,862,0,5,,5,"(7.927209,-72.507910)"
2014,Febrero,Vietnam,704,3,4,,7,"(4.697144,-74.140516)"
2014,Febrero,Islas Vírgenes Británicas/Territorio Británico de Ultramar,92,0,1,,1,"(3.541112,-76.384584)"
2014,Febrero,Zambia,894,2,0,,2,"(4.697144,-74.140516)"
2014,Febrero,Desconocido,99999,1,8,,9,"(12.5744111,-81.703935)"
2014,Febrero,Desconocido,99999,203,248,,451,"(4.697144,-74.140516)"
2014,Marzo,Desconocido,99999,7,47,,54,"(12.5744111,-81.703935)"
2014,Marzo,Desconocido,99999,493,445,,938,"(4.697144,-74.140516)"
2014,Marzo,Afganistán,4,1,25,,26,"(4.697144,-74.140516)"
2014,Marzo,Alemania,276,1,1,,2,"(10.445761,-75.516429)"
2014,Marzo,Alemania,276,3,2,,5,"(10.886611,-74.776708)"
2014,Marzo,Alemania,276,13,11,,24,"(3.541112,-76.384584)"
2014,Marzo,Alemania,276,1014,989,,2003,"(4.697144,-74.140516)"
2014,Marzo,Alemania,276,22,17,,39,"(6.171601,-75.427454)"
2014,Marzo,Alemania,276,0,1,,1,"(7.128456,-73.183637)"
2014,Marzo,Andorra,20,3,0,,3,"(4.697144,-74.140516)"
2014,Marzo,Angola,24,2,8,,10,"(4.697144,-74.140516)"
2014,Marzo,Antigua y Barbuda,28,3,0,,3,"(4.697144,-74.140516)"
2014,Marzo,Países Bajos,528,3,1,,4,"(10.886611,-74.776708)"
2014,Marzo,Países Bajos,528,32,16,,48,"(3.541112,-76.384584)"
2014,Marzo,Países Bajos,528,138,67,,205,"(4.697144,-74.140516)"
2014,Marzo,Países Bajos,528,2,0,,2,"(4.815061,-75.736532)"
2014,Marzo,Países Bajos,528,49,32,,81,"(6.171601,-75.427454)"
2014,Marzo,Países Bajos,528,7,10,,17,"(7.128456,-73.183637)"
2014,Marzo,Arabia Saudita,682,1,15,,16,"(4.697144,-74.140516)"
2014,Marzo,Argelia,12,1,2,,3,"(3.541112,-76.384584)"
2014,Marzo,Argelia,12,0,2,,2,"(4.697144,-74.140516)"
2014,Marzo,Argentina,32,17,22,,39,"(0.814836,-77.662532)"
2014,Marzo,Argentina,32,15,10,,25,"(10.445761,-75.516429)"
2014,Marzo,Argentina,32,19,10,,29,"(10.886611,-74.776708)"
2014,Marzo,Argentina,32,0,1,,1,"(12.586067,-81.702563)"
2014,Marzo,Argentina,32,189,169,,358,"(3.541112,-76.384584)"
2014,Marzo,Argentina,32,3051,3042,,6093,"(4.697144,-74.140516)"
2014,Marzo,Argentina,32,12,5,,17,"(4.815061,-75.736532)"
2014,Marzo,Argentina,32,212,211,,423,"(6.171601,-75.427454)"
2014,Marzo,Argentina,32,1,1,,2,"(7.128456,-73.183637)"
2014,Marzo,Aruba,533,2973,2054,,5027,"(10.408582,-75.538003)"
2014,Marzo,Aruba,533,2,4,,6,"(10.445761,-75.516429)"
2014,Marzo,Aruba,533,9,4,,13,"(10.886611,-74.776708)"
2014,Marzo,Aruba,533,1,0,,1,"(11.360009,-72.129330)"
2014,Marzo,Aruba,533,31,25,,56,"(11.528919,-72.919681)"
2014,Marzo,Aruba,533,14,12,,26,"(3.541112,-76.384584)"
2014,Marzo,Aruba,533,1008,915,,1923,"(4.697144,-74.140516)"
2014,Marzo,Aruba,533,2,1,,3,"(4.815061,-75.736532)"
2014,Marzo,Aruba,533,26,14,,40,"(6.171601,-75.427454)"
2014,Marzo,Aruba,533,12,11,,23,"(7.128456,-73.183637)"
2014,Marzo,Aruba,533,2,2,,4,"(7.927209,-72.507910)"
2014,Marzo,Australia,36,2,2,,4,"(10.445761,-75.516429)"
2014,Marzo,Australia,36,4,6,,10,"(10.886611,-74.776708)"
2014,Marzo,Australia,36,12,13,,25,"(3.541112,-76.384584)"
2014,Marzo,Australia,36,1,1,,2,"(4.452882,-75.766298)"
2014,Marzo,Australia,36,157,112,,269,"(4.697144,-74.140516)"
2014,Marzo,Australia,36,1,1,,2,"(4.815061,-75.736532)"
2014,Marzo,Australia,36,39,16,,55,"(6.171601,-75.427454)"
2014,Marzo,Austria,40,2,2,,4,"(3.541112,-76.384584)"
2014,Marzo,Austria,40,46,38,,84,"(4.697144,-74.140516)"
2014,Marzo,Azerbaiyán,31,1,2,,3,"(4.697144,-74.140516)"
2014,Marzo,Bahamas,44,5,2,,7,"(10.445761,-75.516429)"
2014,Marzo,Bahamas,44,3,1,,4,"(3.541112,-76.384584)"
2014,Marzo,Bahamas,44,14,11,,25,"(4.697144,-74.140516)"
2014,Marzo,Bahamas,44,1,3,,4,"(4.815061,-75.736532)"
2014,Marzo,Bahamas,44,15,13,,28,"(6.171601,-75.427454)"
2014,Marzo,Bahréin,48,1,0,,1,"(11.360009,-72.129330)"
2014,Marzo,Bahréin,48,0,2,,2,"(4.697144,-74.140516)"
2014,Marzo,Barbados,52,1,0,,1,"(3.541112,-76.384584)"
2014,Marzo,Barbados,52,5,17,,22,"(4.697144,-74.140516)"
2014,Marzo,Barbados,52,0,1,,1,"(6.171601,-75.427454)"
2014,Marzo,República de Belarús,112,1,0,,1,"(11.360009,-72.129330)"
2014,Marzo,República de Belarús,112,2,0,,2,"(4.697144,-74.140516)"
2014,Marzo,Bélgica,56,9,6,,15,"(3.541112,-76.384584)"
2014,Marzo,Bélgica,56,75,65,,140,"(4.697144,-74.140516)"
2014,Marzo,Bélgica,56,8,6,,14,"(6.171601,-75.427454)"
2014,Marzo,Belice,84,4,6,,10,"(4.697144,-74.140516)"
2014,Marzo,Belice,84,1,0,,1,"(6.171601,-75.427454)"
2014,Marzo,Benín,204,0,1,,1,"(4.697144,-74.140516)"
2014,Marzo,Bermudas/Territorio Británico de Ultramar,60,3,2,,5,"(4.697144,-74.140516)"
2014,Marzo,Bermudas/Territorio Británico de Ultramar,60,0,1,,1,"(6.171601,-75.427454)"
2014,Marzo,Bolivia,68,4,5,,9,"(0.814836,-77.662532)"
2014,Marzo,Bolivia,68,1,1,,2,"(10.445761,-75.516429)"
2014,Marzo,Bolivia,68,0,1,,1,"(10.886611,-74.776708)"
2014,Marzo,Bolivia,68,18,31,,49,"(3.541112,-76.384584)"
2014,Marzo,Bolivia,68,224,372,,596,"(4.697144,-74.140516)"
2014,Marzo,Bolivia,68,1,3,,4,"(4.815061,-75.736532)"
2014,Marzo,Bolivia,68,15,36,,51,"(6.171601,-75.427454)"
2014,Marzo,Brasil,76,97,226,,323,"(-4.197703,-69.941278)"
2014,Marzo,Brasil,76,1,4,,5,"(0.814836,-77.662532)"
2014,Marzo,Brasil,76,3,7,,10,"(10.445761,-75.516429)"
2014,Marzo,Brasil,76,4,7,,11,"(10.886611,-74.776708)"
2014,Marzo,Brasil,76,1,0,,1,"(12.586067,-81.702563)"
2014,Marzo,Brasil,76,54,70,,124,"(3.541112,-76.384584)"
2014,Marzo,Brasil,76,2682,3725,,6407,"(4.697144,-74.140516)"
2014,Marzo,Brasil,76,10,4,,14,"(4.815061,-75.736532)"
2014,Marzo,Brasil,76,76,191,,267,"(6.171601,-75.427454)"
2014,Marzo,Brasil,76,0,1,,1,"(7.128456,-73.183637)"
2014,Marzo,Bulgaria,100,0,2,,2,"(4.697144,-74.140516)"
2014,Marzo,Islas Caimán/Territorio Británico de Ultramar,136,0,1,,1,"(10.445761,-75.516429)"
2014,Marzo,Islas Caimán/Territorio Británico de Ultramar,136,4,1,,5,"(12.586067,-81.702563)"
2014,Marzo,Camboya,116,1,0,,1,"(4.697144,-74.140516)"
2014,Marzo,Camerún,120,0,1,,1,"(4.697144,-74.140516)"
2014,Marzo,Camerún,120,2,0,,2,"(6.171601,-75.427454)"
2014,Marzo,Canadá,124,89,55,,144,"(10.445761,-75.516429)"
2014,Marzo,Canadá,124,10,11,,21,"(10.886611,-74.776708)"
2014,Marzo,Canadá,124,7,10,,17,"(12.586067,-81.702563)"
2014,Marzo,Canadá,124,83,57,,140,"(3.541112,-76.384584)"
2014,Marzo,Canadá,124,7,5,,12,"(4.452882,-75.766298)"
2014,Marzo,Canadá,124,1133,1084,,2217,"(4.697144,-74.140516)"
2014,Marzo,Canadá,124,12,6,,18,"(4.815061,-75.736532)"
2014,Marzo,Canadá,124,144,125,,269,"(6.171601,-75.427454)"
2014,Marzo,Canadá,124,2,0,,2,"(7.128456,-73.183637)"
2014,Marzo,Canadá,124,1,0,,1,"(7.927209,-72.507910)"
2014,Marzo,Chad,148,0,1,,1,"(4.697144,-74.140516)"
2014,Marzo,España,724,0,3,,3,"(10.445761,-75.516429)"
2014,Marzo,España,724,0,2,,2,"(10.886611,-74.776708)"
2014,Marzo,España,724,1104,620,,1724,"(3.541112,-76.384584)"
2014,Marzo,España,724,6303,4926,,11229,"(4.697144,-74.140516)"
2014,Marzo,España,724,0,1,,1,"(4.815061,-75.736532)"
2014,Marzo,España,724,819,585,,1404,"(6.171601,-75.427454)"
2014,Marzo,República Democrática del Congo,180,0,5,,5,"(4.697144,-74.140516)"
2014,Marzo,República de Corea,410,22,30,,52,"(4.697144,-74.140516)"
2014,Marzo,República de Corea,410,1,2,,3,"(6.171601,-75.427454)"
2014,Marzo,Costa de Marfil,384,6,10,,16,"(4.697144,-74.140516)"
2014,Marzo,Costa de Marfil,384,1,0,,1,"(6.171601,-75.427454)"
2014,Marzo,Costa Rica,188,9,15,,24,"(10.445761,-75.516429)"
2014,Marzo,Costa Rica,188,14,25,,39,"(10.886611,-74.776708)"
2014,Marzo,Costa Rica,188,0,6,,6,"(11.247723,-74.213989)"
2014,Marzo,Costa Rica,188,2,1,,3,"(12.586067,-81.702563)"
2014,Marzo,Costa Rica,188,6,0,,6,"(13.3387613,-81.372937)"
2014,Marzo,Costa Rica,188,59,66,,125,"(3.541112,-76.384584)"
2014,Marzo,Costa Rica,188,778,918,,1696,"(4.697144,-74.140516)"
2014,Marzo,Costa Rica,188,8,5,,13,"(4.815061,-75.736532)"
2014,Marzo,Costa Rica,188,78,125,,203,"(6.171601,-75.427454)"
2014,Marzo,Costa Rica,188,3,1,,4,"(7.128456,-73.183637)"
2014,Marzo,Croacia,191,3,0,,3,"(4.697144,-74.140516)"
2014,Marzo,Cuba,192,11,9,,20,"(10.445761,-75.516429)"
2014,Marzo,Cuba,192,11,9,,20,"(10.886611,-74.776708)"
2014,Marzo,Cuba,192,79,77,,156,"(3.541112,-76.384584)"
2014,Marzo,Cuba,192,820,685,,1505,"(4.697144,-74.140516)"
2014,Marzo,Cuba,192,8,10,,18,"(4.815061,-75.736532)"
2014,Marzo,Cuba,192,144,99,,243,"(6.171601,-75.427454)"
2014,Marzo,Cuba,192,3,4,,7,"(7.128456,-73.183637)"
2014,Marzo,Curazao,99999,70,53,,123,"(10.408582,-75.538003)"
2014,Marzo,Curazao,99999,0,2,,2,"(10.445761,-75.516429)"
2014,Marzo,Curazao,99999,1,4,,5,"(10.886611,-74.776708)"
2014,Marzo,Curazao,99999,5,1,,6,"(3.541112,-76.384584)"
2014,Marzo,Curazao,99999,345,335,,680,"(4.697144,-74.140516)"
2014,Marzo,Curazao,99999,76,55,,131,"(6.171601,-75.427454)"
2014,Marzo,Curazao,99999,2,2,,4,"(7.128456,-73.183637)"
2014,Marzo,Curazao,99999,2,3,,5,"(7.927209,-72.507910)"
2014,Marzo,República Checa,203,6,7,,13,"(4.697144,-74.140516)"
2014,Marzo,Chile,152,62,67,,129,"(0.814836,-77.662532)"
2014,Marzo,Chile,152,8,4,,12,"(10.445761,-75.516429)"
2014,Marzo,Chile,152,21,13,,34,"(10.886611,-74.776708)"
2014,Marzo,Chile,152,0,1,,1,"(12.586067,-81.702563)"
2014,Marzo,Chile,152,593,454,,1047,"(3.541112,-76.384584)"
2014,Marzo,Chile,152,2803,2887,,5690,"(4.697144,-74.140516)"
2014,Marzo,Chile,152,28,20,,48,"(4.815061,-75.736532)"
2014,Marzo,Chile,152,225,174,,399,"(6.171601,-75.427454)"
2014,Marzo,Chile,152,6,6,,12,"(7.128456,-73.183637)"
2014,Marzo,Chile,152,2,2,,4,"(7.927209,-72.507910)"
2014,Marzo,China,156,0,2,,2,"(10.445761,-75.516429)"
2014,Marzo,China,156,3,4,,7,"(10.886611,-74.776708)"
2014,Marzo,China,156,0,1,,1,"(12.586067,-81.702563)"
2014,Marzo,China,156,14,31,,45,"(3.541112,-76.384584)"
2014,Marzo,China,156,258,632,,890,"(4.697144,-74.140516)"
2014,Marzo,China,156,1,7,,8,"(4.815061,-75.736532)"
2014,Marzo,China,156,13,53,,66,"(6.171601,-75.427454)"
2014,Marzo,China,156,1,1,,2,"(7.128456,-73.183637)"
2014,Marzo,Chipre,196,1,0,,1,"(3.541112,-76.384584)"
2014,Marzo,Chipre,196,1,2,,3,"(4.697144,-74.140516)"
2014,Marzo,Dinamarca,208,1,0,,1,"(10.886611,-74.776708)"
2014,Marzo,Dinamarca,208,9,15,,24,"(4.697144,-74.140516)"
2014,Marzo,Dinamarca,208,1,0,,1,"(6.171601,-75.427454)"
2014,Marzo,Dominica,212,0,1,,1,"(4.815061,-75.736532)"
2014,Marzo,Ecuador,218,512,618,,1130,"(0.25129,-76.875963)"
2014,Marzo,Ecuador,218,5517,6668,,12185,"(0.814836,-77.662532)"
2014,Marzo,Ecuador,218,166,144,,310,"(1.813928,-78.763924)"
2014,Marzo,Ecuador,218,2,5,,7,"(10.445761,-75.516429)"
2014,Marzo,Ecuador,218,8,12,,20,"(10.886611,-74.776708)"
2014,Marzo,Ecuador,218,3,2,,5,"(12.586067,-81.702563)"
2014,Marzo,Ecuador,218,478,565,,1043,"(3.541112,-76.384584)"
2014,Marzo,Ecuador,218,2036,4026,,6062,"(4.697144,-74.140516)"
2014,Marzo,Ecuador,218,2,5,,7,"(4.815061,-75.736532)"
2014,Marzo,Ecuador,218,257,260,,517,"(6.171601,-75.427454)"
2014,Marzo,Ecuador,218,2,1,,3,"(7.128456,-73.183637)"
2014,Marzo,Egipto,818,14,8,,22,"(4.697144,-74.140516)"
2014,Marzo,El Salvador,222,0,2,,2,"(10.445761,-75.516429)"
2014,Marzo,El Salvador,222,0,1,,1,"(10.886611,-74.776708)"
2014,Marzo,El Salvador,222,1,0,,1,"(12.586067,-81.702563)"
2014,Marzo,El Salvador,222,101,145,,246,"(3.541112,-76.384584)"
2014,Marzo,El Salvador,222,795,1000,,1795,"(4.697144,-74.140516)"
2014,Marzo,El Salvador,222,112,113,,225,"(6.171601,-75.427454)"
2014,Marzo,El Salvador,222,1,0,,1,"(7.927209,-72.507910)"
2014,Marzo,Emiratos Árabes,784,1,0,,1,"(10.886611,-74.776708)"
2014,Marzo,Emiratos Árabes,784,54,148,,202,"(4.697144,-74.140516)"
2014,Marzo,Emiratos Árabes,784,3,1,,4,"(6.171601,-75.427454)"
2014,Marzo,Eritrea,232,0,1,,1,"(4.697144,-74.140516)"
2014,Marzo,Eslovenia,705,1,2,,3,"(4.697144,-74.140516)"
2014,Marzo,Estados Unidos de América,840,1941,1675,,3616,"(10.445761,-75.516429)"
2014,Marzo,Estados Unidos de América,840,1779,1560,,3339,"(10.886611,-74.776708)"
2014,Marzo,Estados Unidos de América,840,1,3,,4,"(11.117806,-74.232622)"
2014,Marzo,Estados Unidos de América,840,38,31,,69,"(12.586067,-81.702563)"
2014,Marzo,Estados Unidos de América,840,4727,3480,,8207,"(3.541112,-76.384584)"
2014,Marzo,Estados Unidos de América,840,479,370,,849,"(4.452882,-75.766298)"
2014,Marzo,Estados Unidos de América,840,27682,26181,,53863,"(4.697144,-74.140516)"
2014,Marzo,Estados Unidos de América,840,389,320,,709,"(4.815061,-75.736532)"
2014,Marzo,Estados Unidos de América,840,8107,6828,,14935,"(6.171601,-75.427454)"
2014,Marzo,Estados Unidos de América,840,62,44,,106,"(7.128456,-73.183637)"
2014,Marzo,Estados Unidos de América,840,57,44,,101,"(7.927209,-72.507910)"
2014,Marzo,Estonia,233,0,3,,3,"(4.697144,-74.140516)"
2014,Marzo,Etiopia,231,1,6,,7,"(4.697144,-74.140516)"
2014,Marzo,Filipinas,608,4,4,,8,"(4.697144,-74.140516)"
2014,Marzo,Filipinas,608,1,0,,1,"(6.171601,-75.427454)"
2014,Marzo,Finlandia,246,7,6,,13,"(4.697144,-74.140516)"
2014,Marzo,Finlandia,246,1,0,,1,"(6.171601,-75.427454)"
2014,Marzo,Francia,250,2,1,,3,"(10.445761,-75.516429)"
2014,Marzo,Francia,250,3,1,,4,"(10.886611,-74.776708)"
2014,Marzo,Francia,250,12,14,,26,"(3.541112,-76.384584)"
2014,Marzo,Francia,250,962,853,,1815,"(4.697144,-74.140516)"
2014,Marzo,Francia,250,1,0,,1,"(4.815061,-75.736532)"
2014,Marzo,Francia,250,26,12,,38,"(6.171601,-75.427454)"
2014,Marzo,Gabón,266,0,6,,6,"(4.697144,-74.140516)"
2014,Marzo,Ghana,288,0,1,,1,"(4.697144,-74.140516)"
2014,Marzo,Grecia,300,11,8,,19,"(4.697144,-74.140516)"
2014,Marzo,Guatemala,320,1,3,,4,"(10.445761,-75.516429)"
2014,Marzo,Guatemala,320,6,7,,13,"(10.886611,-74.776708)"
2014,Marzo,Guatemala,320,60,65,,125,"(3.541112,-76.384584)"
2014,Marzo,Guatemala,320,332,496,,828,"(4.697144,-74.140516)"
2014,Marzo,Guatemala,320,3,6,,9,"(4.815061,-75.736532)"
2014,Marzo,Guatemala,320,60,88,,148,"(6.171601,-75.427454)"
2014,Marzo,Guatemala,320,0,2,,2,"(7.128456,-73.183637)"
2014,Marzo,Guatemala,320,1,2,,3,"(7.927209,-72.507910)"
2014,Marzo,Guyana,328,1,0,,1,"(10.886611,-74.776708)"
2014,Marzo,Guyana,328,0,1,,1,"(4.697144,-74.140516)"
2014,Marzo,Guinea,324,0,2,,2,"(4.697144,-74.140516)"
2014,Marzo,Guinea Ecuatorial,226,0,1,,1,"(3.541112,-76.384584)"
2014,Marzo,Guinea Ecuatorial,226,2,6,,8,"(4.697144,-74.140516)"
2014,Marzo,Guadalupe/Territorio Francés,312,2,0,,2,"(3.541112,-76.384584)"
2014,Marzo,Guadalupe/Territorio Francés,312,3,2,,5,"(4.697144,-74.140516)"
2014,Marzo,Guayana Francesa/Departamento de Ultramar Francés,254,1,1,,2,"(4.697144,-74.140516)"
2014,Marzo,Guayana Francesa/Departamento de Ultramar Francés,254,1,0,,1,"(6.171601,-75.427454)"
2014,Marzo,Haití,332,1,1,,2,"(10.445761,-75.516429)"
2014,Marzo,Haití,332,0,1,,1,"(10.886611,-74.776708)"
2014,Marzo,Haití,332,0,1,,1,"(3.541112,-76.384584)"
2014,Marzo,Haití,332,7,13,,20,"(4.697144,-74.140516)"
2014,Marzo,Haití,332,0,1,,1,"(4.815061,-75.736532)"
2014,Marzo,Haití,332,6,23,,29,"(6.171601,-75.427454)"
2014,Marzo,Honduras,340,1,12,,13,"(10.445761,-75.516429)"
2014,Marzo,Honduras,340,4,15,,19,"(10.886611,-74.776708)"
2014,Marzo,Honduras,340,0,2,,2,"(12.586067,-81.702563)"
2014,Marzo,Honduras,340,14,21,,35,"(3.541112,-76.384584)"
2014,Marzo,Honduras,340,62,145,,207,"(4.697144,-74.140516)"
2014,Marzo,Honduras,340,1,4,,5,"(4.815061,-75.736532)"
2014,Marzo,Honduras,340,27,54,,81,"(6.171601,-75.427454)"
2014,Marzo,Honduras,340,1,1,,2,"(7.128456,-73.183637)"
2014,Marzo,Honduras,340,2,0,,2,"(7.927209,-72.507910)"
2014,Marzo,Hong Kong,344,1,1,,2,"(10.445761,-75.516429)"
2014,Marzo,Hong Kong,344,1,4,,5,"(10.886611,-74.776708)"
2014,Marzo,Hong Kong,344,1,0,,1,"(3.541112,-76.384584)"
2014,Marzo,Hong Kong,344,27,70,,97,"(4.697144,-74.140516)"
2014,Marzo,Hong Kong,344,1,6,,7,"(6.171601,-75.427454)"
2014,Marzo,Hong Kong,344,0,1,,1,"(7.128456,-73.183637)"
2014,Marzo,Hungría,348,0,3,,3,"(4.697144,-74.140516)"
2014,Marzo,India,356,1,4,,5,"(10.886611,-74.776708)"
2014,Marzo,India,356,1,0,,1,"(3.541112,-76.384584)"
2014,Marzo,India,356,46,32,,78,"(4.697144,-74.140516)"
2014,Marzo,India,356,2,2,,4,"(6.171601,-75.427454)"
2014,Marzo,India,356,5,1,,6,"(7.128456,-73.183637)"
2014,Marzo,Indonesia,360,6,3,,9,"(4.697144,-74.140516)"
2014,Marzo,Iraq,368,0,15,,15,"(4.697144,-74.140516)"
2014,Marzo,Irán,364,0,5,,5,"(4.697144,-74.140516)"
2014,Marzo,República de Irlanda,372,0,1,,1,"(10.886611,-74.776708)"
2014,Marzo,República de Irlanda,372,12,11,,23,"(4.697144,-74.140516)"
2014,Marzo,Islandia,352,0,1,,1,"(10.886611,-74.776708)"
2014,Marzo,Islandia,352,0,1,,1,"(4.452882,-75.766298)"
2014,Marzo,Islandia,352,4,4,,8,"(4.697144,-74.140516)"
2014,Marzo,Israel,376,1,0,,1,"(10.886611,-74.776708)"
2014,Marzo,Israel,376,1,0,,1,"(3.541112,-76.384584)"
2014,Marzo,Israel,376,198,143,,341,"(4.697144,-74.140516)"
2014,Marzo,Israel,376,1,2,,3,"(6.171601,-75.427454)"
2014,Marzo,Italia,380,5,1,,6,"(10.445761,-75.516429)"
2014,Marzo,Italia,380,1,0,,1,"(10.886611,-74.776708)"
2014,Marzo,Italia,380,51,14,,65,"(3.541112,-76.384584)"
2014,Marzo,Italia,380,662,367,,1029,"(4.697144,-74.140516)"
2014,Marzo,Italia,380,50,23,,73,"(6.171601,-75.427454)"
2014,Marzo,Islas Cook,184,1,0,,1,"(4.697144,-74.140516)"
2014,Marzo,Jamaica,388,2,4,,6,"(10.445761,-75.516429)"
2014,Marzo,Jamaica,388,2,3,,5,"(10.886611,-74.776708)"
2014,Marzo,Jamaica,388,1,0,,1,"(12.586067,-81.702563)"
2014,Marzo,Jamaica,388,4,4,,8,"(3.541112,-76.384584)"
2014,Marzo,Jamaica,388,33,19,,52,"(4.697144,-74.140516)"
2014,Marzo,Jamaica,388,3,3,,6,"(4.815061,-75.736532)"
2014,Marzo,Jamaica,388,9,17,,26,"(6.171601,-75.427454)"
2014,Marzo,Japón,392,1,0,,1,"(0.814836,-77.662532)"
2014,Marzo,Japón,392,1,1,,2,"(10.886611,-74.776708)"
2014,Marzo,Japón,392,3,0,,3,"(3.541112,-76.384584)"
2014,Marzo,Japón,392,65,62,,127,"(4.697144,-74.140516)"
2014,Marzo,Japón,392,9,9,,18,"(6.171601,-75.427454)"
2014,Marzo,Jordania,400,2,2,,4,"(4.697144,-74.140516)"
2014,Marzo,Kazajistán,398,1,2,,3,"(4.697144,-74.140516)"
2014,Marzo,Kenia,404,1,2,,3,"(4.697144,-74.140516)"
2014,Marzo,Kenia,404,0,2,,2,"(6.171601,-75.427454)"
2014,Marzo,Kuwait,414,0,3,,3,"(4.697144,-74.140516)"
2014,Marzo,Lituania,440,0,16,,16,"(4.697144,-74.140516)"
2014,Marzo,Líbano,422,12,15,,27,"(4.697144,-74.140516)"
2014,Marzo,Luxemburgo,442,2,5,,7,"(4.697144,-74.140516)"
2014,Marzo,Malasia,458,10,14,,24,"(4.697144,-74.140516)"
2014,Marzo,Malasia,458,1,2,,3,"(6.171601,-75.427454)"
2014,Marzo,Malí,466,0,1,,1,"(4.697144,-74.140516)"
2014,Marzo,Malta,470,6,4,,10,"(4.697144,-74.140516)"
2014,Marzo,Malta,470,1,0,,1,"(6.171601,-75.427454)"
2014,Marzo,Marruecos,504,1,0,,1,"(3.541112,-76.384584)"
2014,Marzo,Marruecos,504,37,98,,135,"(4.697144,-74.140516)"
2014,Marzo,Marruecos,504,1,0,,1,"(6.171601,-75.427454)"
2014,Marzo,Islas Marshall,584,0,1,,1,"(3.541112,-76.384584)"
2014,Marzo,Mauritania,478,0,1,,1,"(4.697144,-74.140516)"
2014,Marzo,Martinica/Departamento de Ultramar Francés,474,1,0,,1,"(3.541112,-76.384584)"
2014,Marzo,México,484,1,11,,12,"(0.814836,-77.662532)"
2014,Marzo,México,484,34,29,,63,"(10.445761,-75.516429)"
2014,Marzo,México,484,84,88,,172,"(10.886611,-74.776708)"
2014,Marzo,México,484,2,2,,4,"(12.586067,-81.702563)"
2014,Marzo,México,484,349,323,,672,"(3.541112,-76.384584)"
2014,Marzo,México,484,6705,6948,,13653,"(4.697144,-74.140516)"
2014,Marzo,México,484,95,85,,180,"(4.815061,-75.736532)"
2014,Marzo,México,484,870,744,,1614,"(6.171601,-75.427454)"
2014,Marzo,México,484,42,24,,66,"(7.128456,-73.183637)"
2014,Marzo,México,484,38,21,,59,"(7.927209,-72.507910)"
2014,Marzo,Mónaco,492,0,1,,1,"(4.697144,-74.140516)"
2014,Marzo,Mónaco,492,1,0,,1,"(6.171601,-75.427454)"
2014,Marzo,Myanmar,104,2,0,,2,"(4.697144,-74.140516)"
2014,Marzo,Namibia,516,0,1,,1,"(4.697144,-74.140516)"
2014,Marzo,Nicaragua,558,1,3,,4,"(10.445761,-75.516429)"
2014,Marzo,Nicaragua,558,1,4,,5,"(10.886611,-74.776708)"
2014,Marzo,Nicaragua,558,1,0,,1,"(12.586067,-81.702563)"
2014,Marzo,Nicaragua,558,4,11,,15,"(3.541112,-76.384584)"
2014,Marzo,Nicaragua,558,35,70,,105,"(4.697144,-74.140516)"
2014,Marzo,Nicaragua,558,0,2,,2,"(4.815061,-75.736532)"
2014,Marzo,Nicaragua,558,8,41,,49,"(6.171601,-75.427454)"
2014,Marzo,Nicaragua,558,1,1,,2,"(7.927209,-72.507910)"
2014,Marzo,Nigeria,566,3,9,,12,"(4.697144,-74.140516)"
2014,Marzo,Noruega,578,1,0,,1,"(3.541112,-76.384584)"
2014,Marzo,Noruega,578,21,24,,45,"(4.697144,-74.140516)"
2014,Marzo,Noruega,578,2,1,,3,"(6.171601,-75.427454)"
2014,Marzo,Nueva Zelanda,554,1,0,,1,"(10.886611,-74.776708)"
2014,Marzo,Nueva Zelanda,554,1,0,,1,"(3.541112,-76.384584)"
2014,Marzo,Nueva Zelanda,554,13,6,,19,"(4.697144,-74.140516)"
2014,Marzo,Nueva Zelanda,554,1,0,,1,"(6.171601,-75.427454)"
2014,Marzo,Omán,512,0,4,,4,"(4.697144,-74.140516)"
2014,Marzo,Papúa Nueva Guinea,598,0,4,,4,"(4.697144,-74.140516)"
2014,Marzo,Pakistán,586,0,1,,1,"(4.697144,-74.140516)"
2014,Marzo,Panamá,591,223,190,,413,"(10.408582,-75.538003)"
2014,Marzo,Panamá,591,400,419,,819,"(10.445761,-75.516429)"
2014,Marzo,Panamá,591,1073,1116,,2189,"(10.886611,-74.776708)"
2014,Marzo,Panamá,591,0,1,,1,"(11.117806,-74.232622)"
2014,Marzo,Panamá,591,123,131,,254,"(12.586067,-81.702563)"
2014,Marzo,Panamá,591,1997,1906,,3903,"(3.541112,-76.384584)"
2014,Marzo,Panamá,591,0,2,,2,"(3.893038,-77.067921)"
2014,Marzo,Panamá,591,6478,7584,,14062,"(4.697144,-74.140516)"
2014,Marzo,Panamá,591,908,839,,1747,"(4.815061,-75.736532)"
2014,Marzo,Panamá,591,2016,2165,,4181,"(6.171601,-75.427454)"
2014,Marzo,Panamá,591,3,9,,12,"(6.228046,-77.404104)"
2014,Marzo,Panamá,591,7,11,,18,"(7.102626,-77.762647)"
2014,Marzo,Panamá,591,388,380,,768,"(7.128456,-73.183637)"
2014,Marzo,Panamá,591,146,183,,329,"(7.927209,-72.507910)"
2014,Marzo,Panamá,591,1,53,,54,"(8.066966,-76.735404)"
2014,Marzo,Panamá,591,97,179,,276,"(8.635765,-77.346578)"
2014,Marzo,Paraguay,600,0,1,,1,"(0.814836,-77.662532)"
2014,Marzo,Paraguay,600,0,1,,1,"(10.445761,-75.516429)"
2014,Marzo,Paraguay,600,0,6,,6,"(10.886611,-74.776708)"
2014,Marzo,Paraguay,600,14,21,,35,"(3.541112,-76.384584)"
2014,Marzo,Paraguay,600,45,109,,154,"(4.697144,-74.140516)"
2014,Marzo,Paraguay,600,7,10,,17,"(6.171601,-75.427454)"
2014,Marzo,Paraguay,600,1,0,,1,"(7.128456,-73.183637)"
2014,Marzo,Perú,604,69,130,,199,"(-4.197703,-69.941278)"
2014,Marzo,Perú,604,38,46,,84,"(0.814836,-77.662532)"
2014,Marzo,Perú,604,3,15,,18,"(10.445761,-75.516429)"
2014,Marzo,Perú,604,33,24,,57,"(10.886611,-74.776708)"
2014,Marzo,Perú,604,1,2,,3,"(12.586067,-81.702563)"
2014,Marzo,Perú,604,314,327,,641,"(3.541112,-76.384584)"
2014,Marzo,Perú,604,3018,4012,,7030,"(4.697144,-74.140516)"
2014,Marzo,Perú,604,10,14,,24,"(4.815061,-75.736532)"
2014,Marzo,Perú,604,407,478,,885,"(6.171601,-75.427454)"
2014,Marzo,Perú,604,4,2,,6,"(7.128456,-73.183637)"
2014,Marzo,Perú,604,2,2,,4,"(7.927209,-72.507910)"
2014,Marzo,Polonia,616,4,17,,21,"(4.697144,-74.140516)"
2014,Marzo,Polonia,616,1,0,,1,"(6.171601,-75.427454)"
2014,Marzo,Portugal,620,1,3,,4,"(3.541112,-76.384584)"
2014,Marzo,Portugal,620,29,26,,55,"(4.697144,-74.140516)"
2014,Marzo,Portugal,620,1,1,,2,"(6.171601,-75.427454)"
2014,Marzo,Polinesia Francesa/Colectividad de Ultramar Francesa,258,0,1,,1,"(4.697144,-74.140516)"
2014,Marzo,Puerto Rico/Territorio de Estados Unidos,630,3,3,,6,"(10.445761,-75.516429)"
2014,Marzo,Puerto Rico/Territorio de Estados Unidos,630,5,7,,12,"(10.886611,-74.776708)"
2014,Marzo,Puerto Rico/Territorio de Estados Unidos,630,24,34,,58,"(3.541112,-76.384584)"
2014,Marzo,Puerto Rico/Territorio de Estados Unidos,630,298,331,,629,"(4.697144,-74.140516)"
2014,Marzo,Puerto Rico/Territorio de Estados Unidos,630,2,2,,4,"(4.815061,-75.736532)"
2014,Marzo,Puerto Rico/Territorio de Estados Unidos,630,27,33,,60,"(6.171601,-75.427454)"
2014,Marzo,Puerto Rico/Territorio de Estados Unidos,630,2,1,,3,"(7.128456,-73.183637)"
2014,Marzo,Qatar,634,3,3,,6,"(4.697144,-74.140516)"
2014,Marzo,Qatar,634,0,1,,1,"(6.171601,-75.427454)"
2014,Marzo,Reino Unido de Gran Bretaña e Irlanda del Norte,826,0,2,,2,"(10.886611,-74.776708)"
2014,Marzo,Reino Unido de Gran Bretaña e Irlanda del Norte,826,40,28,,68,"(3.541112,-76.384584)"
2014,Marzo,Reino Unido de Gran Bretaña e Irlanda del Norte,826,622,443,,1065,"(4.697144,-74.140516)"
2014,Marzo,Reino Unido de Gran Bretaña e Irlanda del Norte,826,34,12,,46,"(6.171601,-75.427454)"
2014,Marzo,Reino Unido de Gran Bretaña e Irlanda del Norte,826,1,0,,1,"(7.128456,-73.183637)"
2014,Marzo,República CentroÁfricana,140,1,0,,1,"(4.697144,-74.140516)"
2014,Marzo,Federación de Rusia,643,31,37,,68,"(4.697144,-74.140516)"
2014,Marzo,República Dominicana,214,4,14,,18,"(10.445761,-75.516429)"
2014,Marzo,República Dominicana,214,25,33,,58,"(10.886611,-74.776708)"
2014,Marzo,República Dominicana,214,0,1,,1,"(11.117806,-74.232622)"
2014,Marzo,República Dominicana,214,44,60,,104,"(3.541112,-76.384584)"
2014,Marzo,República Dominicana,214,1101,1140,,2241,"(4.697144,-74.140516)"
2014,Marzo,República Dominicana,214,6,8,,14,"(4.815061,-75.736532)"
2014,Marzo,República Dominicana,214,76,88,,164,"(6.171601,-75.427454)"
2014,Marzo,República Dominicana,214,23,10,,33,"(7.128456,-73.183637)"
2014,Marzo,República Dominicana,214,5,1,,6,"(7.927209,-72.507910)"
2014,Marzo,Rumania,642,1,5,,6,"(4.697144,-74.140516)"
2014,Marzo,Rwanda,646,0,1,,1,"(4.697144,-74.140516)"
2014,Marzo,Sahara Occidental/Desierto Sahara,732,2,2,,4,"(3.541112,-76.384584)"
2014,Marzo,Sahara Occidental/Desierto Sahara,732,0,1,,1,"(4.697144,-74.140516)"
2014,Marzo,San Cristóbal y Nevis,659,1,0,,1,"(4.697144,-74.140516)"
2014,Marzo,San  Vicente y las Granadinas,670,1,0,,1,"(6.171601,-75.427454)"
2014,Marzo,Santa Lucia,662,1,3,,4,"(4.697144,-74.140516)"
2014,Marzo,Senegal,686,0,1,,1,"(4.697144,-74.140516)"
2014,Marzo,Senegal,686,0,1,,1,"(6.171601,-75.427454)"
2014,Marzo,Seychelles,690,1,0,,1,"(4.697144,-74.140516)"
2014,Marzo,Singapur,702,22,18,,40,"(4.697144,-74.140516)"
2014,Marzo,Singapur,702,1,0,,1,"(4.815061,-75.736532)"
2014,Marzo,Sudáfrica,710,16,17,,33,"(4.697144,-74.140516)"
2014,Marzo,Sudáfrica,710,0,1,,1,"(6.171601,-75.427454)"
2014,Marzo,Sudán,736,1,0,,1,"(4.697144,-74.140516)"
2014,Marzo,Suecia,752,2,0,,2,"(10.445761,-75.516429)"
2014,Marzo,Suecia,752,1,0,,1,"(10.886611,-74.776708)"
2014,Marzo,Suecia,752,6,5,,11,"(3.541112,-76.384584)"
2014,Marzo,Suecia,752,58,43,,101,"(4.697144,-74.140516)"
2014,Marzo,Suecia,752,4,5,,9,"(6.171601,-75.427454)"
2014,Marzo,Suiza,756,2,0,,2,"(10.886611,-74.776708)"
2014,Marzo,Suiza,756,15,4,,19,"(3.541112,-76.384584)"
2014,Marzo,Suiza,756,192,141,,333,"(4.697144,-74.140516)"
2014,Marzo,Suiza,756,12,7,,19,"(6.171601,-75.427454)"
2014,Marzo,Surinam,740,2,8,,10,"(10.886611,-74.776708)"
2014,Marzo,Surinam,740,11,24,,35,"(4.697144,-74.140516)"
2014,Marzo,Surinam,740,0,2,,2,"(6.171601,-75.427454)"
2014,Marzo,Surinam,740,1,0,,1,"(7.927209,-72.507910)"
2014,Marzo,Taiwán,158,4,4,,8,"(4.697144,-74.140516)"
2014,Marzo,Taiwán,158,0,1,,1,"(4.815061,-75.736532)"
2014,Marzo,Taiwán,158,0,1,,1,"(6.171601,-75.427454)"
2014,Marzo,Tailandia,764,1,1,,2,"(3.541112,-76.384584)"
2014,Marzo,Tailandia,764,16,12,,28,"(4.697144,-74.140516)"
2014,Marzo,Tailandia,764,0,2,,2,"(6.171601,-75.427454)"
2014,Marzo,Tanzania,834,1,0,,1,"(4.697144,-74.140516)"
2014,Marzo,Trinidad y Tobago,780,1,3,,4,"(10.445761,-75.516429)"
2014,Marzo,Trinidad y Tobago,780,0,3,,3,"(10.886611,-74.776708)"
2014,Marzo,Trinidad y Tobago,780,0,1,,1,"(12.586067,-81.702563)"
2014,Marzo,Trinidad y Tobago,780,7,22,,29,"(3.541112,-76.384584)"
2014,Marzo,Trinidad y Tobago,780,22,38,,60,"(4.697144,-74.140516)"
2014,Marzo,Trinidad y Tobago,780,4,7,,11,"(4.815061,-75.736532)"
2014,Marzo,Trinidad y Tobago,780,12,21,,33,"(6.171601,-75.427454)"
2014,Marzo,Trinidad y Tobago,780,2,2,,4,"(7.128456,-73.183637)"
2014,Marzo,Trinidad y Tobago,780,0,1,,1,"(7.927209,-72.507910)"
2014,Marzo,Túnez,788,2,0,,2,"(4.697144,-74.140516)"
2014,Marzo,Turquía,792,35,43,,78,"(4.697144,-74.140516)"
2014,Marzo,Turquía,792,1,0,,1,"(6.171601,-75.427454)"
2014,Marzo,Turkmenistán,795,1,0,,1,"(4.697144,-74.140516)"
2014,Marzo,Ucrania,804,0,1,,1,"(4.697144,-74.140516)"
2014,Marzo,Uruguay,858,1,3,,4,"(0.814836,-77.662532)"
2014,Marzo,Uruguay,858,1,2,,3,"(10.445761,-75.516429)"
2014,Marzo,Uruguay,858,1,0,,1,"(12.586067,-81.702563)"
2014,Marzo,Uruguay,858,10,23,,33,"(3.541112,-76.384584)"
2014,Marzo,Uruguay,858,84,111,,195,"(4.697144,-74.140516)"
2014,Marzo,Uruguay,858,21,52,,73,"(6.171601,-75.427454)"
2014,Marzo,Venezuela,862,36,26,,62,"(10.408582,-75.538003)"
2014,Marzo,Venezuela,862,16,12,,28,"(10.445761,-75.516429)"
2014,Marzo,Venezuela,862,17,50,,67,"(10.886611,-74.776708)"
2014,Marzo,Venezuela,862,6775,5886,,12661,"(11.360009,-72.129330)"
2014,Marzo,Venezuela,862,1,1,,2,"(12.586067,-81.702563)"
2014,Marzo,Venezuela,862,12,11,,23,"(3.541112,-76.384584)"
2014,Marzo,Venezuela,862,1058,1444,,2502,"(4.697144,-74.140516)"
2014,Marzo,Venezuela,862,2,5,,7,"(4.815061,-75.736532)"
2014,Marzo,Venezuela,862,195,259,,454,"(6.171601,-75.427454)"
2014,Marzo,Venezuela,862,135,137,,272,"(6.185799,-67.483929)"
2014,Marzo,Venezuela,862,1203,1221,,2424,"(7.088729,-70.740253)"
2014,Marzo,Venezuela,862,6,2,,8,"(7.128456,-73.183637)"
2014,Marzo,Venezuela,862,3176,3304,,6480,"(7.818934,-72.453226)"
2014,Marzo,Venezuela,862,1,1,,2,"(7.927209,-72.507910)"
2014,Marzo,Vietnam,704,1,1,,2,"(10.886611,-74.776708)"
2014,Marzo,Vietnam,704,1,4,,5,"(4.697144,-74.140516)"
2014,Marzo,República Árabe de Yemen,887,0,1,,1,"(4.697144,-74.140516)"
2014,Abril,Desconocido,99999,523,446,,969,"(4.697144,-74.140516)"
2014,Abril,Afganistán,4,2,9,,11,"(4.697144,-74.140516)"
2014,Abril,Afganistán,4,0,1,,1,"(6.171601,-75.427454)"
2014,Abril,Afganistán,4,0,1,,1,"(7.818934,-72.453226)"
2014,Abril,Albania,8,1,1,,2,"(4.697144,-74.140516)"
2014,Abril,Alemania,276,1,3,,4,"(0.814836,-77.662532)"
2014,Abril,Alemania,276,1,0,,1,"(10.445761,-75.516429)"
2014,Abril,Alemania,276,1,0,,1,"(10.886611,-74.776708)"
2014,Abril,Alemania,276,17,11,,28,"(3.541112,-76.384584)"
2014,Abril,Alemania,276,1173,995,,2168,"(4.697144,-74.140516)"
2014,Abril,Alemania,276,2,0,,2,"(4.815061,-75.736532)"
2014,Abril,Alemania,276,18,11,,29,"(6.171601,-75.427454)"
2014,Abril,Andorra,20,2,1,,3,"(4.697144,-74.140516)"
2014,Abril,Angola,24,2,5,,7,"(4.697144,-74.140516)"
2014,Abril,Angola,24,0,1,,1,"(6.171601,-75.427454)"
2014,Abril,Antigua y Barbuda,28,0,2,,2,"(4.697144,-74.140516)"
2014,Abril,Países Bajos,528,1,1,,2,"(10.445761,-75.516429)"
2014,Abril,Países Bajos,528,3,1,,4,"(10.886611,-74.776708)"
2014,Abril,Países Bajos,528,44,20,,64,"(3.541112,-76.384584)"
2014,Abril,Países Bajos,528,151,74,,225,"(4.697144,-74.140516)"
2014,Abril,Países Bajos,528,1,0,,1,"(4.815061,-75.736532)"
2014,Abril,Países Bajos,528,52,28,,80,"(6.171601,-75.427454)"
2014,Abril,Países Bajos,528,8,4,,12,"(7.128456,-73.183637)"
2014,Abril,Arabia Saudita,682,2,1,,3,"(10.445761,-75.516429)"
2014,Abril,Arabia Saudita,682,5,38,,43,"(4.697144,-74.140516)"
2014,Abril,Arabia Saudita,682,1,1,,2,"(6.171601,-75.427454)"
2014,Abril,Argelia,12,1,0,,1,"(3.541112,-76.384584)"
2014,Abril,Argelia,12,4,9,,13,"(4.697144,-74.140516)"
2014,Abril,Argelia,12,0,1,,1,"(6.171601,-75.427454)"
2014,Abril,Argentina,32,12,12,,24,"(0.814836,-77.662532)"
2014,Abril,Argentina,32,13,11,,24,"(10.445761,-75.516429)"
2014,Abril,Argentina,32,16,13,,29,"(10.886611,-74.776708)"
2014,Abril,Argentina,32,4,2,,6,"(12.586067,-81.702563)"
2014,Abril,Argentina,32,171,165,,336,"(3.541112,-76.384584)"
2014,Abril,Argentina,32,2772,2600,,5372,"(4.697144,-74.140516)"
2014,Abril,Argentina,32,12,12,,24,"(4.815061,-75.736532)"
2014,Abril,Argentina,32,246,272,,518,"(6.171601,-75.427454)"
2014,Abril,Argentina,32,8,5,,13,"(7.128456,-73.183637)"
2014,Abril,Argentina,32,2,3,,5,"(7.927209,-72.507910)"
2014,Abril,Aruba,533,1599,1215,,2814,"(10.408582,-75.538003)"
2014,Abril,Aruba,533,6,1,,7,"(10.445761,-75.516429)"
2014,Abril,Aruba,533,33,37,,70,"(10.886611,-74.776708)"
2014,Abril,Aruba,533,23,16,,39,"(11.528919,-72.919681)"
2014,Abril,Aruba,533,3,0,,3,"(12.586067,-81.702563)"
2014,Abril,Aruba,533,19,20,,39,"(3.541112,-76.384584)"
2014,Abril,Aruba,533,1512,1224,,2736,"(4.697144,-74.140516)"
2014,Abril,Aruba,533,3,2,,5,"(4.815061,-75.736532)"
2014,Abril,Aruba,533,58,43,,101,"(6.171601,-75.427454)"
2014,Abril,Aruba,533,8,17,,25,"(7.128456,-73.183637)"
2014,Abril,Australia,36,4,0,,4,"(10.445761,-75.516429)"
2014,Abril,Australia,36,3,1,,4,"(10.886611,-74.776708)"
2014,Abril,Australia,36,7,11,,18,"(3.541112,-76.384584)"
2014,Abril,Australia,36,128,125,,253,"(4.697144,-74.140516)"
2014,Abril,Australia,36,5,0,,5,"(4.815061,-75.736532)"
2014,Abril,Australia,36,22,26,,48,"(6.171601,-75.427454)"
2014,Abril,Austria,40,3,1,,4,"(3.541112,-76.384584)"
2014,Abril,Austria,40,24,19,,43,"(4.697144,-74.140516)"
2014,Abril,Austria,40,1,3,,4,"(6.171601,-75.427454)"
2014,Abril,Azerbaiyán,31,0,3,,3,"(4.697144,-74.140516)"
2014,Abril,Bahamas,44,3,0,,3,"(10.886611,-74.776708)"
2014,Abril,Bahamas,44,0,1,,1,"(12.586067,-81.702563)"
2014,Abril,Bahamas,44,7,14,,21,"(3.541112,-76.384584)"
2014,Abril,Bahamas,44,35,21,,56,"(4.697144,-74.140516)"
2014,Abril,Bahamas,44,5,1,,6,"(4.815061,-75.736532)"
2014,Abril,Bahamas,44,10,15,,25,"(6.171601,-75.427454)"
2014,Abril,Bahamas,44,12,5,,17,"(7.128456,-73.183637)"
2014,Abril,Bahréin,48,0,1,,1,"(11.360009,-72.129330)"
2014,Abril,Bangladesh,50,1,1,,2,"(4.697144,-74.140516)"
2014,Abril,Barbados,52,0,1,,1,"(3.541112,-76.384584)"
2014,Abril,Barbados,52,3,10,,13,"(4.697144,-74.140516)"
2014,Abril,República de Belarús,112,5,4,,9,"(11.360009,-72.129330)"
2014,Abril,República de Belarús,112,0,1,,1,"(4.697144,-74.140516)"
2014,Abril,Bélgica,56,3,4,,7,"(3.541112,-76.384584)"
2014,Abril,Bélgica,56,67,39,,106,"(4.697144,-74.140516)"
2014,Abril,Bélgica,56,0,1,,1,"(4.815061,-75.736532)"
2014,Abril,Bélgica,56,9,6,,15,"(6.171601,-75.427454)"
2014,Abril,Belice,84,0,1,,1,"(4.697144,-74.140516)"
2014,Abril,Benín,204,0,1,,1,"(4.697144,-74.140516)"
2014,Abril,Bermudas/Territorio Británico de Ultramar,60,4,0,,4,"(4.697144,-74.140516)"
2014,Abril,Bermudas/Territorio Británico de Ultramar,60,0,1,,1,"(6.171601,-75.427454)"
2014,Abril,Bolivia,68,4,1,,5,"(0.814836,-77.662532)"
2014,Abril,Bolivia,68,7,4,,11,"(10.445761,-75.516429)"
2014,Abril,Bolivia,68,3,0,,3,"(10.886611,-74.776708)"
2014,Abril,Bolivia,68,10,42,,52,"(3.541112,-76.384584)"
2014,Abril,Bolivia,68,269,377,,646,"(4.697144,-74.140516)"
2014,Abril,Bolivia,68,7,4,,11,"(4.815061,-75.736532)"
2014,Abril,Bolivia,68,19,36,,55,"(6.171601,-75.427454)"
2014,Abril,Brasil,76,93,202,,295,"(-4.197703,-69.941278)"
2014,Abril,Brasil,76,0,1,,1,"(0.814836,-77.662532)"
2014,Abril,Brasil,76,4,12,,16,"(10.445761,-75.516429)"
2014,Abril,Brasil,76,3,9,,12,"(10.886611,-74.776708)"
2014,Abril,Brasil,76,1,5,,6,"(12.586067,-81.702563)"
2014,Abril,Brasil,76,51,70,,121,"(3.541112,-76.384584)"
2014,Abril,Brasil,76,2972,3739,,6711,"(4.697144,-74.140516)"
2014,Abril,Brasil,76,6,14,,20,"(4.815061,-75.736532)"
2014,Abril,Brasil,76,112,225,,337,"(6.171601,-75.427454)"
2014,Abril,Brasil,76,1,3,,4,"(7.128456,-73.183637)"
2014,Abril,Brasil,76,1,0,,1,"(7.927209,-72.507910)"
2014,Abril,Bulgaria,100,3,7,,10,"(4.697144,-74.140516)"
2014,Abril,Cabo Verde,132,0,1,,1,"(4.697144,-74.140516)"
2014,Abril,Islas Caimán/Territorio Británico de Ultramar,136,65,44,,109,"(12.586067,-81.702563)"
2014,Abril,Islas Caimán/Territorio Británico de Ultramar,136,1,0,,1,"(6.171601,-75.427454)"
2014,Abril,Camerún,120,0,2,,2,"(4.697144,-74.140516)"
2014,Abril,Canadá,124,30,16,,46,"(10.445761,-75.516429)"
2014,Abril,Canadá,124,10,5,,15,"(10.886611,-74.776708)"
2014,Abril,Canadá,124,2,2,,4,"(12.586067,-81.702563)"
2014,Abril,Canadá,124,80,57,,137,"(3.541112,-76.384584)"
2014,Abril,Canadá,124,13,12,,25,"(4.452882,-75.766298)"
2014,Abril,Canadá,124,1269,1128,,2397,"(4.697144,-74.140516)"
2014,Abril,Canadá,124,11,11,,22,"(4.815061,-75.736532)"
2014,Abril,Canadá,124,190,158,,348,"(6.171601,-75.427454)"
2014,Abril,Canadá,124,1,0,,1,"(7.128456,-73.183637)"
2014,Abril,Canadá,124,2,1,,3,"(7.927209,-72.507910)"
2014,Abril,Chad,148,1,5,,6,"(4.697144,-74.140516)"
2014,Abril,España,724,1,3,,4,"(10.445761,-75.516429)"
2014,Abril,España,724,1212,747,,1959,"(3.541112,-76.384584)"
2014,Abril,España,724,6792,5652,,12444,"(4.697144,-74.140516)"
2014,Abril,España,724,0,1,,1,"(4.815061,-75.736532)"
2014,Abril,España,724,793,585,,1378,"(6.171601,-75.427454)"
2014,Abril,República Democrática del Congo,180,0,2,,2,"(4.697144,-74.140516)"
2014,Abril,República de Corea,410,0,1,,1,"(10.445761,-75.516429)"
2014,Abril,República de Corea,410,9,19,,28,"(4.697144,-74.140516)"
2014,Abril,República de Corea,410,2,4,,6,"(6.171601,-75.427454)"
2014,Abril,Costa de Marfil,384,1,1,,2,"(4.697144,-74.140516)"
2014,Abril,Costa Rica,188,1,8,,9,"(10.408582,-75.538003)"
2014,Abril,Costa Rica,188,6,9,,15,"(10.445761,-75.516429)"
2014,Abril,Costa Rica,188,33,28,,61,"(10.886611,-74.776708)"
2014,Abril,Costa Rica,188,12,10,,22,"(12.586067,-81.702563)"
2014,Abril,Costa Rica,188,1,7,,8,"(13.3387613,-81.372937)"
2014,Abril,Costa Rica,188,34,42,,76,"(3.541112,-76.384584)"
2014,Abril,Costa Rica,188,795,889,,1684,"(4.697144,-74.140516)"
2014,Abril,Costa Rica,188,6,10,,16,"(4.815061,-75.736532)"
2014,Abril,Costa Rica,188,101,101,,202,"(6.171601,-75.427454)"
2014,Abril,Costa Rica,188,0,3,,3,"(7.128456,-73.183637)"
2014,Abril,Costa Rica,188,5,1,,6,"(7.927209,-72.507910)"
2014,Abril,Croacia,191,4,2,,6,"(4.697144,-74.140516)"
2014,Abril,Cuba,192,29,19,,48,"(10.445761,-75.516429)"
2014,Abril,Cuba,192,33,25,,58,"(10.886611,-74.776708)"
2014,Abril,Cuba,192,181,148,,329,"(3.541112,-76.384584)"
2014,Abril,Cuba,192,1327,1101,,2428,"(4.697144,-74.140516)"
2014,Abril,Cuba,192,27,24,,51,"(4.815061,-75.736532)"
2014,Abril,Cuba,192,201,154,,355,"(6.171601,-75.427454)"
2014,Abril,Cuba,192,15,9,,24,"(7.128456,-73.183637)"
2014,Abril,Cuba,192,6,23,,29,"(7.927209,-72.507910)"
2014,Abril,Curazao,99999,6,2,,8,"(10.886611,-74.776708)"
2014,Abril,Curazao,99999,9,7,,16,"(3.541112,-76.384584)"
2014,Abril,Curazao,99999,382,340,,722,"(4.697144,-74.140516)"
2014,Abril,Curazao,99999,112,61,,173,"(6.171601,-75.427454)"
2014,Abril,Curazao,99999,3,2,,5,"(7.128456,-73.183637)"
2014,Abril,República Checa,203,8,9,,17,"(4.697144,-74.140516)"
2014,Abril,República Checa,203,0,2,,2,"(6.171601,-75.427454)"
2014,Abril,Chile,152,63,44,,107,"(0.814836,-77.662532)"
2014,Abril,Chile,152,11,17,,28,"(10.445761,-75.516429)"
2014,Abril,Chile,152,32,19,,51,"(10.886611,-74.776708)"
2014,Abril,Chile,152,4,0,,4,"(12.586067,-81.702563)"
2014,Abril,Chile,152,740,531,,1271,"(3.541112,-76.384584)"
2014,Abril,Chile,152,2445,2261,,4706,"(4.697144,-74.140516)"
2014,Abril,Chile,152,91,89,,180,"(4.815061,-75.736532)"
2014,Abril,Chile,152,250,224,,474,"(6.171601,-75.427454)"
2014,Abril,Chile,152,4,4,,8,"(7.128456,-73.183637)"
2014,Abril,Chile,152,1,3,,4,"(7.927209,-72.507910)"
2014,Abril,China,156,1,2,,3,"(10.445761,-75.516429)"
2014,Abril,China,156,3,19,,22,"(10.886611,-74.776708)"
2014,Abril,China,156,11,32,,43,"(3.541112,-76.384584)"
2014,Abril,China,156,277,711,,988,"(4.697144,-74.140516)"
2014,Abril,China,156,2,6,,8,"(4.815061,-75.736532)"
2014,Abril,China,156,32,67,,99,"(6.171601,-75.427454)"
2014,Abril,China,156,1,3,,4,"(7.128456,-73.183637)"
2014,Abril,Chipre,196,1,1,,2,"(4.697144,-74.140516)"
2014,Abril,Dinamarca,208,1,0,,1,"(3.541112,-76.384584)"
2014,Abril,Dinamarca,208,16,14,,30,"(4.697144,-74.140516)"
2014,Abril,Ecuador,218,802,827,,1629,"(0.25129,-76.875963)"
2014,Abril,Ecuador,218,10910,11341,,22251,"(0.814836,-77.662532)"
2014,Abril,Ecuador,218,210,200,,410,"(1.813928,-78.763924)"
2014,Abril,Ecuador,218,5,3,,8,"(10.445761,-75.516429)"
2014,Abril,Ecuador,218,1,14,,15,"(10.886611,-74.776708)"
2014,Abril,Ecuador,218,2,5,,7,"(12.586067,-81.702563)"
2014,Abril,Ecuador,218,868,783,,1651,"(3.541112,-76.384584)"
2014,Abril,Ecuador,218,2792,3952,,6744,"(4.697144,-74.140516)"
2014,Abril,Ecuador,218,4,6,,10,"(4.815061,-75.736532)"
2014,Abril,Ecuador,218,434,365,,799,"(6.171601,-75.427454)"
2014,Abril,Ecuador,218,3,12,,15,"(7.128456,-73.183637)"
2014,Abril,Ecuador,218,0,1,,1,"(7.927209,-72.507910)"
2014,Abril,Egipto,818,0,1,,1,"(3.541112,-76.384584)"
2014,Abril,Egipto,818,110,40,,150,"(4.697144,-74.140516)"
2014,Abril,Egipto,818,2,1,,3,"(6.171601,-75.427454)"
2014,Abril,El Salvador,222,0,2,,2,"(10.445761,-75.516429)"
2014,Abril,El Salvador,222,3,6,,9,"(10.886611,-74.776708)"
2014,Abril,El Salvador,222,67,56,,123,"(3.541112,-76.384584)"
2014,Abril,El Salvador,222,724,815,,1539,"(4.697144,-74.140516)"
2014,Abril,El Salvador,222,1,2,,3,"(4.815061,-75.736532)"
2014,Abril,El Salvador,222,96,110,,206,"(6.171601,-75.427454)"
2014,Abril,Emiratos Árabes,784,126,312,,438,"(4.697144,-74.140516)"
2014,Abril,Emiratos Árabes,784,0,1,,1,"(6.171601,-75.427454)"
2014,Abril,Eritrea,232,2,0,,2,"(4.697144,-74.140516)"
2014,Abril,Eslovaquia,703,1,7,,8,"(4.697144,-74.140516)"
2014,Abril,Eslovenia,705,1,1,,2,"(4.697144,-74.140516)"
2014,Abril,Estados Unidos de América,840,1,1,,2,"(0.814836,-77.662532)"
2014,Abril,Estados Unidos de América,840,0,4,,4,"(10.408582,-75.538003)"
2014,Abril,Estados Unidos de América,840,2448,2070,,4518,"(10.445761,-75.516429)"
2014,Abril,Estados Unidos de América,840,1846,1469,,3315,"(10.886611,-74.776708)"
2014,Abril,Estados Unidos de América,840,68,47,,115,"(12.586067,-81.702563)"
2014,Abril,Estados Unidos de América,840,5289,3926,,9215,"(3.541112,-76.384584)"
2014,Abril,Estados Unidos de América,840,578,446,,1024,"(4.452882,-75.766298)"
2014,Abril,Estados Unidos de América,840,34297,30356,,64653,"(4.697144,-74.140516)"
2014,Abril,Estados Unidos de América,840,543,400,,943,"(4.815061,-75.736532)"
2014,Abril,Estados Unidos de América,840,9682,7714,,17396,"(6.171601,-75.427454)"
2014,Abril,Estados Unidos de América,840,121,97,,218,"(7.128456,-73.183637)"
2014,Abril,Estados Unidos de América,840,124,93,,217,"(7.927209,-72.507910)"
2014,Abril,Estonia,233,0,1,,1,"(4.697144,-74.140516)"
2014,Abril,Etiopia,231,0,3,,3,"(4.697144,-74.140516)"
2014,Abril,Filipinas,608,0,2,,2,"(10.886611,-74.776708)"
2014,Abril,Filipinas,608,0,1,,1,"(4.697144,-74.140516)"
2014,Abril,Filipinas,608,1,0,,1,"(6.171601,-75.427454)"
2014,Abril,Finlandia,246,0,1,,1,"(10.886611,-74.776708)"
2014,Abril,Finlandia,246,0,1,,1,"(3.541112,-76.384584)"
2014,Abril,Finlandia,246,8,3,,11,"(4.697144,-74.140516)"
2014,Abril,Finlandia,246,1,0,,1,"(6.171601,-75.427454)"
2014,Abril,Francia,250,1,0,,1,"(10.445761,-75.516429)"
2014,Abril,Francia,250,2,1,,3,"(10.886611,-74.776708)"
2014,Abril,Francia,250,28,15,,43,"(3.541112,-76.384584)"
2014,Abril,Francia,250,1150,970,,2120,"(4.697144,-74.140516)"
2014,Abril,Francia,250,40,22,,62,"(6.171601,-75.427454)"
2014,Abril,Gabón,266,1,9,,10,"(4.697144,-74.140516)"
2014,Abril,Ghana,288,0,1,,1,"(4.697144,-74.140516)"
2014,Abril,Gibraltar/Territorio Británico de Ultramar,292,1,0,,1,"(0.814836,-77.662532)"
2014,Abril,Grecia,300,21,14,,35,"(4.697144,-74.140516)"
2014,Abril,Guatemala,320,8,12,,20,"(10.445761,-75.516429)"
2014,Abril,Guatemala,320,2,4,,6,"(10.886611,-74.776708)"
2014,Abril,Guatemala,320,2,2,,4,"(12.586067,-81.702563)"
2014,Abril,Guatemala,320,25,46,,71,"(3.541112,-76.384584)"
2014,Abril,Guatemala,320,341,498,,839,"(4.697144,-74.140516)"
2014,Abril,Guatemala,320,7,4,,11,"(4.815061,-75.736532)"
2014,Abril,Guatemala,320,89,77,,166,"(6.171601,-75.427454)"
2014,Abril,Guatemala,320,0,2,,2,"(7.128456,-73.183637)"
2014,Abril,Guyana,328,1,6,,7,"(10.886611,-74.776708)"
2014,Abril,Guyana,328,1,1,,2,"(3.541112,-76.384584)"
2014,Abril,Guyana,328,1,2,,3,"(4.697144,-74.140516)"
2014,Abril,Guinea,324,1,0,,1,"(0.814836,-77.662532)"
2014,Abril,Guinea,324,1,1,,2,"(4.697144,-74.140516)"
2014,Abril,Guinea Ecuatorial,226,2,15,,17,"(4.697144,-74.140516)"
2014,Abril,Guadalupe/Territorio Francés,312,2,0,,2,"(4.697144,-74.140516)"
2014,Abril,Guayana Francesa/Departamento de Ultramar Francés,254,0,1,,1,"(10.886611,-74.776708)"
2014,Abril,Haití,332,0,7,,7,"(10.886611,-74.776708)"
2014,Abril,Haití,332,5,9,,14,"(4.697144,-74.140516)"
2014,Abril,Haití,332,0,2,,2,"(4.815061,-75.736532)"
2014,Abril,Haití,332,3,3,,6,"(6.171601,-75.427454)"
2014,Abril,Honduras,340,2,8,,10,"(10.445761,-75.516429)"
2014,Abril,Honduras,340,6,7,,13,"(10.886611,-74.776708)"
2014,Abril,Honduras,340,13,26,,39,"(3.541112,-76.384584)"
2014,Abril,Honduras,340,77,122,,199,"(4.697144,-74.140516)"
2014,Abril,Honduras,340,1,2,,3,"(4.815061,-75.736532)"
2014,Abril,Honduras,340,27,56,,83,"(6.171601,-75.427454)"
2014,Abril,Honduras,340,1,1,,2,"(7.128456,-73.183637)"
2014,Abril,Hong Kong,344,0,2,,2,"(10.445761,-75.516429)"
2014,Abril,Hong Kong,344,0,1,,1,"(10.886611,-74.776708)"
2014,Abril,Hong Kong,344,0,2,,2,"(3.541112,-76.384584)"
2014,Abril,Hong Kong,344,50,96,,146,"(4.697144,-74.140516)"
2014,Abril,Hong Kong,344,0,1,,1,"(4.815061,-75.736532)"
2014,Abril,Hong Kong,344,8,8,,16,"(6.171601,-75.427454)"
2014,Abril,Hungría,348,2,1,,3,"(4.697144,-74.140516)"
2014,Abril,India,356,39,33,,72,"(4.697144,-74.140516)"
2014,Abril,India,356,3,3,,6,"(6.171601,-75.427454)"
2014,Abril,Indonesia,360,0,1,,1,"(10.886611,-74.776708)"
2014,Abril,Indonesia,360,8,5,,13,"(4.697144,-74.140516)"
2014,Abril,Iraq,368,2,11,,13,"(4.697144,-74.140516)"
2014,Abril,Irán,364,2,7,,9,"(4.697144,-74.140516)"
2014,Abril,República de Irlanda,372,22,7,,29,"(4.697144,-74.140516)"
2014,Abril,Israel,376,5,1,,6,"(3.541112,-76.384584)"
2014,Abril,Israel,376,200,120,,320,"(4.697144,-74.140516)"
2014,Abril,Israel,376,1,1,,2,"(6.171601,-75.427454)"
2014,Abril,Italia,380,1,1,,2,"(10.445761,-75.516429)"
2014,Abril,Italia,380,41,10,,51,"(3.541112,-76.384584)"
2014,Abril,Italia,380,871,587,,1458,"(4.697144,-74.140516)"
2014,Abril,Italia,380,28,14,,42,"(6.171601,-75.427454)"
2014,Abril,Jamaica,388,3,6,,9,"(10.445761,-75.516429)"
2014,Abril,Jamaica,388,0,1,,1,"(10.886611,-74.776708)"
2014,Abril,Jamaica,388,1,1,,2,"(12.586067,-81.702563)"
2014,Abril,Jamaica,388,17,24,,41,"(3.541112,-76.384584)"
2014,Abril,Jamaica,388,40,42,,82,"(4.697144,-74.140516)"
2014,Abril,Jamaica,388,4,4,,8,"(4.815061,-75.736532)"
2014,Abril,Jamaica,388,22,22,,44,"(6.171601,-75.427454)"
2014,Abril,Japón,392,0,1,,1,"(10.886611,-74.776708)"
2014,Abril,Japón,392,8,3,,11,"(3.541112,-76.384584)"
2014,Abril,Japón,392,78,92,,170,"(4.697144,-74.140516)"
2014,Abril,Japón,392,3,2,,5,"(4.815061,-75.736532)"
2014,Abril,Japón,392,4,3,,7,"(6.171601,-75.427454)"
2014,Abril,Jordania,400,9,5,,14,"(4.697144,-74.140516)"
2014,Abril,Kazajistán,398,1,1,,2,"(4.697144,-74.140516)"
2014,Abril,Kenia,404,0,1,,1,"(3.541112,-76.384584)"
2014,Abril,Kenia,404,4,3,,7,"(4.697144,-74.140516)"
2014,Abril,Kuwait,414,4,2,,6,"(4.697144,-74.140516)"
2014,Abril,Lituania,440,0,2,,2,"(4.697144,-74.140516)"
2014,Abril,Lituania,440,0,1,,1,"(6.171601,-75.427454)"
2014,Abril,Líbano,422,1,1,,2,"(10.886611,-74.776708)"
2014,Abril,Líbano,422,15,16,,31,"(4.697144,-74.140516)"
2014,Abril,Libia,434,0,1,,1,"(4.697144,-74.140516)"
2014,Abril,Luxemburgo,442,2,4,,6,"(4.697144,-74.140516)"
2014,Abril,Madagascar,450,1,0,,1,"(3.541112,-76.384584)"
2014,Abril,Madagascar,450,1,0,,1,"(4.697144,-74.140516)"
2014,Abril,Malasia,458,1,0,,1,"(3.541112,-76.384584)"
2014,Abril,Malasia,458,6,3,,9,"(4.697144,-74.140516)"
2014,Abril,Malasia,458,2,2,,4,"(6.171601,-75.427454)"
2014,Abril,Maldivas,462,1,1,,2,"(4.697144,-74.140516)"
2014,Abril,Malí,466,0,1,,1,"(4.697144,-74.140516)"
2014,Abril,Malí,466,0,1,,1,"(6.171601,-75.427454)"
2014,Abril,Malta,470,4,5,,9,"(4.697144,-74.140516)"
2014,Abril,Marruecos,504,7,17,,24,"(4.697144,-74.140516)"
2014,Abril,Marruecos,504,2,1,,3,"(6.171601,-75.427454)"
2014,Abril,Martinica/Departamento de Ultramar Francés,474,1,0,,1,"(3.541112,-76.384584)"
2014,Abril,México,484,46,44,,90,"(10.445761,-75.516429)"
2014,Abril,México,484,79,82,,161,"(10.886611,-74.776708)"
2014,Abril,México,484,2,1,,3,"(12.586067,-81.702563)"
2014,Abril,México,484,445,391,,836,"(3.541112,-76.384584)"
2014,Abril,México,484,8449,7841,,16290,"(4.697144,-74.140516)"
2014,Abril,México,484,99,87,,186,"(4.815061,-75.736532)"
2014,Abril,México,484,1142,944,,2086,"(6.171601,-75.427454)"
2014,Abril,México,484,49,38,,87,"(7.128456,-73.183637)"
2014,Abril,México,484,66,79,,145,"(7.927209,-72.507910)"
2014,Abril,Mónaco,492,1,2,,3,"(4.697144,-74.140516)"
2014,Abril,Mozambique,508,1,1,,2,"(4.697144,-74.140516)"
2014,Abril,Namibia,516,0,1,,1,"(10.886611,-74.776708)"
2014,Abril,Nepal,524,3,1,,4,"(4.697144,-74.140516)"
2014,Abril,Nicaragua,558,2,1,,3,"(10.445761,-75.516429)"
2014,Abril,Nicaragua,558,2,5,,7,"(10.886611,-74.776708)"
2014,Abril,Nicaragua,558,0,1,,1,"(12.586067,-81.702563)"
2014,Abril,Nicaragua,558,7,10,,17,"(3.541112,-76.384584)"
2014,Abril,Nicaragua,558,28,40,,68,"(4.697144,-74.140516)"
2014,Abril,Nicaragua,558,4,2,,6,"(4.815061,-75.736532)"
2014,Abril,Nicaragua,558,8,16,,24,"(6.171601,-75.427454)"
2014,Abril,Nigeria,566,0,13,,13,"(4.697144,-74.140516)"
2014,Abril,Níger,562,0,1,,1,"(4.697144,-74.140516)"
2014,Abril,Noruega,578,1,0,,1,"(10.886611,-74.776708)"
2014,Abril,Noruega,578,1,0,,1,"(3.541112,-76.384584)"
2014,Abril,Noruega,578,16,15,,31,"(4.697144,-74.140516)"
2014,Abril,Noruega,578,0,1,,1,"(4.815061,-75.736532)"
2014,Abril,Noruega,578,2,1,,3,"(6.171601,-75.427454)"
2014,Abril,Nueva Zelanda,554,1,1,,2,"(10.886611,-74.776708)"
2014,Abril,Nueva Zelanda,554,0,1,,1,"(3.541112,-76.384584)"
2014,Abril,Nueva Zelanda,554,16,13,,29,"(4.697144,-74.140516)"
2014,Abril,Nueva Zelanda,554,1,3,,4,"(6.171601,-75.427454)"
2014,Abril,Omán,512,2,5,,7,"(4.697144,-74.140516)"
2014,Abril,Papúa Nueva Guinea,598,0,1,,1,"(4.697144,-74.140516)"
2014,Abril,Papúa Nueva Guinea,598,0,1,,1,"(6.171601,-75.427454)"
2014,Abril,Pakistán,586,2,1,,3,"(3.541112,-76.384584)"
2014,Abril,Pakistán,586,0,3,,3,"(4.697144,-74.140516)"
2014,Abril,Panamá,591,117,133,,250,"(10.408582,-75.538003)"
2014,Abril,Panamá,591,420,459,,879,"(10.445761,-75.516429)"
2014,Abril,Panamá,591,965,967,,1932,"(10.886611,-74.776708)"
2014,Abril,Panamá,591,0,7,,7,"(10.971302,-74.765397)"
2014,Abril,Panamá,591,239,244,,483,"(12.586067,-81.702563)"
2014,Abril,Panamá,591,2157,1997,,4154,"(3.541112,-76.384584)"
2014,Abril,Panamá,591,0,1,,1,"(3.893038,-77.067921)"
2014,Abril,Panamá,591,6928,7242,,14170,"(4.697144,-74.140516)"
2014,Abril,Panamá,591,886,789,,1675,"(4.815061,-75.736532)"
2014,Abril,Panamá,591,2105,2145,,4250,"(6.171601,-75.427454)"
2014,Abril,Panamá,591,4,9,,13,"(6.228046,-77.404104)"
2014,Abril,Panamá,591,20,11,,31,"(7.102626,-77.762647)"
2014,Abril,Panamá,591,513,483,,996,"(7.128456,-73.183637)"
2014,Abril,Panamá,591,221,242,,463,"(7.927209,-72.507910)"
2014,Abril,Panamá,591,0,60,,60,"(8.066966,-76.735404)"
2014,Abril,Panamá,591,0,5,,5,"(8.635765,-77.346578)"
2014,Abril,Paraguay,600,0,1,,1,"(0.814836,-77.662532)"
2014,Abril,Paraguay,600,0,1,,1,"(10.445761,-75.516429)"
2014,Abril,Paraguay,600,0,3,,3,"(10.886611,-74.776708)"
2014,Abril,Paraguay,600,1,2,,3,"(12.586067,-81.702563)"
2014,Abril,Paraguay,600,8,40,,48,"(3.541112,-76.384584)"
2014,Abril,Paraguay,600,57,167,,224,"(4.697144,-74.140516)"
2014,Abril,Paraguay,600,1,0,,1,"(4.815061,-75.736532)"
2014,Abril,Paraguay,600,8,12,,20,"(6.171601,-75.427454)"
2014,Abril,Perú,604,64,130,,194,"(-4.197703,-69.941278)"
2014,Abril,Perú,604,28,37,,65,"(0.814836,-77.662532)"
2014,Abril,Perú,604,7,5,,12,"(10.445761,-75.516429)"
2014,Abril,Perú,604,35,43,,78,"(10.886611,-74.776708)"
2014,Abril,Perú,604,2,6,,8,"(12.586067,-81.702563)"
2014,Abril,Perú,604,362,386,,748,"(3.541112,-76.384584)"
2014,Abril,Perú,604,3760,4323,,8083,"(4.697144,-74.140516)"
2014,Abril,Perú,604,18,8,,26,"(4.815061,-75.736532)"
2014,Abril,Perú,604,554,586,,1140,"(6.171601,-75.427454)"
2014,Abril,Perú,604,3,3,,6,"(7.128456,-73.183637)"
2014,Abril,Perú,604,3,3,,6,"(7.927209,-72.507910)"
2014,Abril,Polonia,616,17,19,,36,"(4.697144,-74.140516)"
2014,Abril,Polonia,616,0,1,,1,"(6.171601,-75.427454)"
2014,Abril,Portugal,620,1,0,,1,"(3.541112,-76.384584)"
2014,Abril,Portugal,620,56,40,,96,"(4.697144,-74.140516)"
2014,Abril,Portugal,620,0,2,,2,"(4.815061,-75.736532)"
2014,Abril,Portugal,620,1,1,,2,"(6.171601,-75.427454)"
2014,Abril,Polinesia Francesa/Colectividad de Ultramar Francesa,258,1,1,,2,"(4.697144,-74.140516)"
2014,Abril,Puerto Rico/Territorio de Estados Unidos,630,5,1,,6,"(10.445761,-75.516429)"
2014,Abril,Puerto Rico/Territorio de Estados Unidos,630,8,8,,16,"(10.886611,-74.776708)"
2014,Abril,Puerto Rico/Territorio de Estados Unidos,630,1,0,,1,"(12.586067,-81.702563)"
2014,Abril,Puerto Rico/Territorio de Estados Unidos,630,31,28,,59,"(3.541112,-76.384584)"
2014,Abril,Puerto Rico/Territorio de Estados Unidos,630,467,445,,912,"(4.697144,-74.140516)"
2014,Abril,Puerto Rico/Territorio de Estados Unidos,630,6,6,,12,"(4.815061,-75.736532)"
2014,Abril,Puerto Rico/Territorio de Estados Unidos,630,46,46,,92,"(6.171601,-75.427454)"
2014,Abril,Puerto Rico/Territorio de Estados Unidos,630,3,3,,6,"(7.128456,-73.183637)"
2014,Abril,Puerto Rico/Territorio de Estados Unidos,630,0,1,,1,"(7.927209,-72.507910)"
2014,Abril,Qatar,634,10,5,,15,"(4.697144,-74.140516)"
2014,Abril,Qatar,634,0,1,,1,"(6.171601,-75.427454)"
2014,Abril,Reino Unido de Gran Bretaña e Irlanda del Norte,826,1,0,,1,"(10.445761,-75.516429)"
2014,Abril,Reino Unido de Gran Bretaña e Irlanda del Norte,826,1,0,,1,"(10.886611,-74.776708)"
2014,Abril,Reino Unido de Gran Bretaña e Irlanda del Norte,826,39,16,,55,"(3.541112,-76.384584)"
2014,Abril,Reino Unido de Gran Bretaña e Irlanda del Norte,826,844,563,,1407,"(4.697144,-74.140516)"
2014,Abril,Reino Unido de Gran Bretaña e Irlanda del Norte,826,42,20,,62,"(6.171601,-75.427454)"
2014,Abril,Reino Unido de Gran Bretaña e Irlanda del Norte,826,0,2,,2,"(7.818934,-72.453226)"
2014,Abril,República CentroÁfricana,140,1,1,,2,"(4.697144,-74.140516)"
2014,Abril,Federación de Rusia,643,17,38,,55,"(4.697144,-74.140516)"
2014,Abril,Federación de Rusia,643,1,1,,2,"(6.171601,-75.427454)"
2014,Abril,República Dominicana,214,15,17,,32,"(10.445761,-75.516429)"
2014,Abril,República Dominicana,214,45,33,,78,"(10.886611,-74.776708)"
2014,Abril,República Dominicana,214,14,23,,37,"(11.117806,-74.232622)"
2014,Abril,República Dominicana,214,0,2,,2,"(11.247723,-74.213989)"
2014,Abril,República Dominicana,214,1,2,,3,"(12.586067,-81.702563)"
2014,Abril,República Dominicana,214,60,61,,121,"(3.541112,-76.384584)"
2014,Abril,República Dominicana,214,1914,1893,,3807,"(4.697144,-74.140516)"
2014,Abril,República Dominicana,214,11,13,,24,"(4.815061,-75.736532)"
2014,Abril,República Dominicana,214,143,138,,281,"(6.171601,-75.427454)"
2014,Abril,República Dominicana,214,4,3,,7,"(7.128456,-73.183637)"
2014,Abril,República Dominicana,214,1,0,,1,"(7.927209,-72.507910)"
2014,Abril,Rumania,642,3,2,,5,"(4.697144,-74.140516)"
2014,Abril,San Marino,674,1,0,,1,"(3.541112,-76.384584)"
2014,Abril,San Marino,674,0,2,,2,"(4.697144,-74.140516)"
2014,Abril,San  Vicente y las Granadinas,670,1,0,,1,"(3.541112,-76.384584)"
2014,Abril,San  Vicente y las Granadinas,670,0,1,,1,"(6.171601,-75.427454)"
2014,Abril,Santa Sede/Ciudad del Vaticano,336,1,0,,1,"(4.697144,-74.140516)"
2014,Abril,Santo Tomé y Príncipe,678,1,0,,1,"(4.815061,-75.736532)"
2014,Abril,Senegal,686,1,0,,1,"(4.697144,-74.140516)"
2014,Abril,Serbia,688,1,0,,1,"(4.697144,-74.140516)"
2014,Abril,Serbia,688,1,0,,1,"(6.171601,-75.427454)"
2014,Abril,Singapur,702,0,2,,2,"(10.886611,-74.776708)"
2014,Abril,Singapur,702,20,16,,36,"(4.697144,-74.140516)"
2014,Abril,Singapur,702,0,1,,1,"(6.171601,-75.427454)"
2014,Abril,Sri Lanka,144,2,0,,2,"(4.697144,-74.140516)"
2014,Abril,Sudáfrica,710,7,16,,23,"(4.697144,-74.140516)"
2014,Abril,Sudáfrica,710,2,1,,3,"(6.171601,-75.427454)"
2014,Abril,Sudán,736,1,2,,3,"(4.697144,-74.140516)"
2014,Abril,Suecia,752,1,0,,1,"(10.445761,-75.516429)"
2014,Abril,Suecia,752,2,3,,5,"(3.541112,-76.384584)"
2014,Abril,Suecia,752,76,71,,147,"(4.697144,-74.140516)"
2014,Abril,Suecia,752,1,0,,1,"(4.815061,-75.736532)"
2014,Abril,Suecia,752,3,2,,5,"(6.171601,-75.427454)"
2014,Abril,Suiza,756,1,0,,1,"(10.886611,-74.776708)"
2014,Abril,Suiza,756,14,3,,17,"(3.541112,-76.384584)"
2014,Abril,Suiza,756,200,131,,331,"(4.697144,-74.140516)"
2014,Abril,Suiza,756,12,7,,19,"(6.171601,-75.427454)"
2014,Abril,Surinam,740,3,0,,3,"(10.886611,-74.776708)"
2014,Abril,Surinam,740,5,10,,15,"(4.697144,-74.140516)"
2014,Abril,Taiwán,158,0,1,,1,"(3.541112,-76.384584)"
2014,Abril,Taiwán,158,3,8,,11,"(4.697144,-74.140516)"
2014,Abril,Taiwán,158,0,1,,1,"(6.171601,-75.427454)"
2014,Abril,Tailandia,764,2,0,,2,"(3.541112,-76.384584)"
2014,Abril,Tailandia,764,19,11,,30,"(4.697144,-74.140516)"
2014,Abril,Trinidad y Tobago,780,6,4,,10,"(10.445761,-75.516429)"
2014,Abril,Trinidad y Tobago,780,2,1,,3,"(10.886611,-74.776708)"
2014,Abril,Trinidad y Tobago,780,4,5,,9,"(3.541112,-76.384584)"
2014,Abril,Trinidad y Tobago,780,36,47,,83,"(4.697144,-74.140516)"
2014,Abril,Trinidad y Tobago,780,2,4,,6,"(4.815061,-75.736532)"
2014,Abril,Trinidad y Tobago,780,13,11,,24,"(6.171601,-75.427454)"
2014,Abril,Trinidad y Tobago,780,1,0,,1,"(7.128456,-73.183637)"
2014,Abril,Túnez,788,0,2,,2,"(4.697144,-74.140516)"
2014,Abril,Turquía,792,3,4,,7,"(3.541112,-76.384584)"
2014,Abril,Turquía,792,76,73,,149,"(4.697144,-74.140516)"
2014,Abril,Turquía,792,2,1,,3,"(6.171601,-75.427454)"
2014,Abril,Uganda,800,1,1,,2,"(4.697144,-74.140516)"
2014,Abril,Uruguay,858,4,2,,6,"(10.445761,-75.516429)"
2014,Abril,Uruguay,858,1,0,,1,"(10.886611,-74.776708)"
2014,Abril,Uruguay,858,7,8,,15,"(3.541112,-76.384584)"
2014,Abril,Uruguay,858,47,61,,108,"(4.697144,-74.140516)"
2014,Abril,Uruguay,858,1,0,,1,"(4.815061,-75.736532)"
2014,Abril,Uruguay,858,16,21,,37,"(6.171601,-75.427454)"
2014,Abril,Venezuela,862,5,12,,17,"(10.445761,-75.516429)"
2014,Abril,Venezuela,862,10,32,,42,"(10.886611,-74.776708)"
2014,Abril,Venezuela,862,0,5,,5,"(10.971302,-74.765397)"
2014,Abril,Venezuela,862,1,0,,1,"(11.117806,-74.232622)"
2014,Abril,Venezuela,862,10475,8684,,19159,"(11.360009,-72.129330)"
2014,Abril,Venezuela,862,2,0,,2,"(12.586067,-81.702563)"
2014,Abril,Venezuela,862,5,19,,24,"(3.541112,-76.384584)"
2014,Abril,Venezuela,862,1111,1371,,2482,"(4.697144,-74.140516)"
2014,Abril,Venezuela,862,2,4,,6,"(4.815061,-75.736532)"
2014,Abril,Venezuela,862,228,296,,524,"(6.171601,-75.427454)"
2014,Abril,Venezuela,862,132,174,,306,"(6.185799,-67.483929)"
2014,Abril,Venezuela,862,1885,1826,,3711,"(7.088729,-70.740253)"
2014,Abril,Venezuela,862,2,10,,12,"(7.128456,-73.183637)"
2014,Abril,Venezuela,862,5932,5478,,11410,"(7.818934,-72.453226)"
2014,Abril,Venezuela,862,62,54,,116,"(7.927209,-72.507910)"
2014,Abril,Vietnam,704,7,7,,14,"(4.697144,-74.140516)"
2014,Abril,Islas Vírgenes Británicas/Territorio Británico de Ultramar,92,1,0,,1,"(10.886611,-74.776708)"
2014,Abril,Islas Vírgenes Estadounidenses/Territorio de Estados Unidos,850,0,1,,1,"(10.408582,-75.538003)"
2014,Abril,Islas Vírgenes Estadounidenses/Territorio de Estados Unidos,850,0,1,,1,"(6.171601,-75.427454)"
2014,Abril,República Árabe de Yemen,887,0,1,,1,"(4.697144,-74.140516)"
2014,Abril,Desconocido,99999,5,55,,60,"(12.5744111,-81.703935)"
2014,Abril,Desconocido,99999,0,1,,1,"(3.893038,-77.067921)"
2014,Abril,Desconocido,99999,129,122,,251,"(4.697144,-74.140516)"
2014,Mayo,Afganistán,4,2,33,,35,"(4.697144,-74.140516)"
2014,Mayo,Afganistán,4,1,0,,1,"(6.171601,-75.427454)"
2014,Mayo,Albania,8,1,0,,1,"(4.697144,-74.140516)"
2014,Mayo,Alemania,276,1,1,,2,"(10.445761,-75.516429)"
2014,Mayo,Alemania,276,10,12,,22,"(3.541112,-76.384584)"
2014,Mayo,Alemania,276,1404,1465,,2869,"(4.697144,-74.140516)"
2014,Mayo,Alemania,276,17,22,,39,"(6.171601,-75.427454)"
2014,Mayo,Andorra,20,1,1,,2,"(4.697144,-74.140516)"
2014,Mayo,Angola,24,2,9,,11,"(4.697144,-74.140516)"
2014,Mayo,Antigua y Barbuda,28,0,1,,1,"(4.697144,-74.140516)"
2014,Mayo,Países Bajos,528,5,0,,5,"(10.445761,-75.516429)"
2014,Mayo,Países Bajos,528,1,2,,3,"(10.886611,-74.776708)"
2014,Mayo,Países Bajos,528,28,18,,46,"(3.541112,-76.384584)"
2014,Mayo,Países Bajos,528,148,108,,256,"(4.697144,-74.140516)"
2014,Mayo,Países Bajos,528,1,0,,1,"(4.815061,-75.736532)"
2014,Mayo,Países Bajos,528,44,35,,79,"(6.171601,-75.427454)"
2014,Mayo,Arabia Saudita,682,3,20,,23,"(4.697144,-74.140516)"
2014,Mayo,Arabia Saudita,682,0,1,,1,"(6.171601,-75.427454)"
2014,Mayo,Argelia,12,1,1,,2,"(4.697144,-74.140516)"
2014,Mayo,Argentina,32,5,3,,8,"(0.814836,-77.662532)"
2014,Mayo,Argentina,32,9,8,,17,"(10.445761,-75.516429)"
2014,Mayo,Argentina,32,13,12,,25,"(10.886611,-74.776708)"
2014,Mayo,Argentina,32,100,133,,233,"(3.541112,-76.384584)"
2014,Mayo,Argentina,32,2155,2276,,4431,"(4.697144,-74.140516)"
2014,Mayo,Argentina,32,11,3,,14,"(4.815061,-75.736532)"
2014,Mayo,Argentina,32,123,136,,259,"(6.171601,-75.427454)"
2014,Mayo,Argentina,32,1,2,,3,"(7.128456,-73.183637)"
2014,Mayo,Aruba,533,1714,1185,,2899,"(10.408582,-75.538003)"
2014,Mayo,Aruba,533,3,4,,7,"(10.886611,-74.776708)"
2014,Mayo,Aruba,533,0,4,,4,"(10.971302,-74.765397)"
2014,Mayo,Aruba,533,13,13,,26,"(3.541112,-76.384584)"
2014,Mayo,Aruba,533,1422,1113,,2535,"(4.697144,-74.140516)"
2014,Mayo,Aruba,533,36,34,,70,"(6.171601,-75.427454)"
2014,Mayo,Aruba,533,5,8,,13,"(7.128456,-73.183637)"
2014,Mayo,Australia,36,3,2,,5,"(10.886611,-74.776708)"
2014,Mayo,Australia,36,8,12,,20,"(3.541112,-76.384584)"
2014,Mayo,Australia,36,147,99,,246,"(4.697144,-74.140516)"
2014,Mayo,Australia,36,5,0,,5,"(4.815061,-75.736532)"
2014,Mayo,Australia,36,32,24,,56,"(6.171601,-75.427454)"
2014,Mayo,Australia,36,1,0,,1,"(7.128456,-73.183637)"
2014,Mayo,Austria,40,43,29,,72,"(4.697144,-74.140516)"
2014,Mayo,Azerbaiyán,31,0,4,,4,"(4.697144,-74.140516)"
2014,Mayo,Bahamas,44,4,0,,4,"(10.445761,-75.516429)"
2014,Mayo,Bahamas,44,2,0,,2,"(10.886611,-74.776708)"
2014,Mayo,Bahamas,44,4,4,,8,"(3.541112,-76.384584)"
2014,Mayo,Bahamas,44,15,17,,32,"(4.697144,-74.140516)"
2014,Mayo,Bahamas,44,10,19,,29,"(6.171601,-75.427454)"
2014,Mayo,Bahréin,48,0,1,,1,"(4.697144,-74.140516)"
2014,Mayo,Barbados,52,1,7,,8,"(4.697144,-74.140516)"
2014,Mayo,Barbados,52,0,1,,1,"(6.171601,-75.427454)"
2014,Mayo,República de Belarús,112,0,2,,2,"(11.360009,-72.129330)"
2014,Mayo,República de Belarús,112,0,1,,1,"(4.697144,-74.140516)"
2014,Mayo,República de Belarús,112,0,1,,1,"(6.171601,-75.427454)"
2014,Mayo,Bélgica,56,1,4,,5,"(3.541112,-76.384584)"
2014,Mayo,Bélgica,56,78,52,,130,"(4.697144,-74.140516)"
2014,Mayo,Bélgica,56,13,4,,17,"(6.171601,-75.427454)"
2014,Mayo,Belice,84,0,1,,1,"(10.886611,-74.776708)"
2014,Mayo,Belice,84,2,5,,7,"(4.697144,-74.140516)"
2014,Mayo,Benín,204,0,1,,1,"(4.697144,-74.140516)"
2014,Mayo,Bolivia,68,3,3,,6,"(0.814836,-77.662532)"
2014,Mayo,Bolivia,68,0,1,,1,"(10.445761,-75.516429)"
2014,Mayo,Bolivia,68,2,10,,12,"(10.886611,-74.776708)"
2014,Mayo,Bolivia,68,17,26,,43,"(3.541112,-76.384584)"
2014,Mayo,Bolivia,68,210,371,,581,"(4.697144,-74.140516)"
2014,Mayo,Bolivia,68,2,4,,6,"(4.815061,-75.736532)"
2014,Mayo,Bolivia,68,10,26,,36,"(6.171601,-75.427454)"
2014,Mayo,Bolivia,68,0,2,,2,"(7.927209,-72.507910)"
2014,Mayo,Brasil,76,162,326,,488,"(-4.197703,-69.941278)"
2014,Mayo,Brasil,76,0,13,,13,"(0.814836,-77.662532)"
2014,Mayo,Brasil,76,1,5,,6,"(10.445761,-75.516429)"
2014,Mayo,Brasil,76,7,8,,15,"(10.886611,-74.776708)"
2014,Mayo,Brasil,76,49,64,,113,"(3.541112,-76.384584)"
2014,Mayo,Brasil,76,2621,3695,,6316,"(4.697144,-74.140516)"
2014,Mayo,Brasil,76,4,10,,14,"(4.815061,-75.736532)"
2014,Mayo,Brasil,76,75,134,,209,"(6.171601,-75.427454)"
2014,Mayo,Brasil,76,1,3,,4,"(7.128456,-73.183637)"
2014,Mayo,Bulgaria,100,0,2,,2,"(4.697144,-74.140516)"
2014,Mayo,Cabo Verde,132,2,0,,2,"(4.697144,-74.140516)"
2014,Mayo,Islas Caimán/Territorio Británico de Ultramar,136,1,1,,2,"(10.445761,-75.516429)"
2014,Mayo,Islas Caimán/Territorio Británico de Ultramar,136,3,0,,3,"(12.586067,-81.702563)"
2014,Mayo,Islas Caimán/Territorio Británico de Ultramar,136,1,0,,1,"(3.541112,-76.384584)"
2014,Mayo,Islas Caimán/Territorio Británico de Ultramar,136,1,2,,3,"(4.697144,-74.140516)"
2014,Mayo,Islas Caimán/Territorio Británico de Ultramar,136,1,0,,1,"(4.815061,-75.736532)"
2014,Mayo,Camboya,116,1,0,,1,"(4.697144,-74.140516)"
2014,Mayo,Camerún,120,1,0,,1,"(6.171601,-75.427454)"
2014,Mayo,Canadá,124,13,11,,24,"(10.445761,-75.516429)"
2014,Mayo,Canadá,124,12,12,,24,"(10.886611,-74.776708)"
2014,Mayo,Canadá,124,0,1,,1,"(12.586067,-81.702563)"
2014,Mayo,Canadá,124,81,57,,138,"(3.541112,-76.384584)"
2014,Mayo,Canadá,124,4,2,,6,"(4.452882,-75.766298)"
2014,Mayo,Canadá,124,1278,1092,,2370,"(4.697144,-74.140516)"
2014,Mayo,Canadá,124,7,7,,14,"(4.815061,-75.736532)"
2014,Mayo,Canadá,124,187,143,,330,"(6.171601,-75.427454)"
2014,Mayo,Canadá,124,4,4,,8,"(7.128456,-73.183637)"
2014,Mayo,Canadá,124,0,4,,4,"(7.927209,-72.507910)"
2014,Mayo,Chad,148,0,3,,3,"(4.697144,-74.140516)"
2014,Mayo,España,724,4,9,,13,"(10.445761,-75.516429)"
2014,Mayo,España,724,0,1,,1,"(10.886611,-74.776708)"
2014,Mayo,España,724,1442,866,,2308,"(3.541112,-76.384584)"
2014,Mayo,España,724,7161,5870,,13031,"(4.697144,-74.140516)"
2014,Mayo,España,724,5,0,,5,"(4.815061,-75.736532)"
2014,Mayo,España,724,916,697,,1613,"(6.171601,-75.427454)"
2014,Mayo,República Democrática del Congo,180,0,1,,1,"(3.541112,-76.384584)"
2014,Mayo,República Democrática del Congo,180,0,1,,1,"(4.697144,-74.140516)"
2014,Mayo,República Democrática del Congo,180,0,1,,1,"(6.171601,-75.427454)"
2014,Mayo,República de Corea,410,0,1,,1,"(3.541112,-76.384584)"
2014,Mayo,República de Corea,410,17,29,,46,"(4.697144,-74.140516)"
2014,Mayo,República de Corea,410,2,1,,3,"(6.171601,-75.427454)"
2014,Mayo,Costa de Marfil,384,1,5,,6,"(4.697144,-74.140516)"
2014,Mayo,Costa Rica,188,0,1,,1,"(10.408582,-75.538003)"
2014,Mayo,Costa Rica,188,12,18,,30,"(10.445761,-75.516429)"
2014,Mayo,Costa Rica,188,16,27,,43,"(10.886611,-74.776708)"
2014,Mayo,Costa Rica,188,2,1,,3,"(12.586067,-81.702563)"
2014,Mayo,Costa Rica,188,34,61,,95,"(3.541112,-76.384584)"
2014,Mayo,Costa Rica,188,676,881,,1557,"(4.697144,-74.140516)"
2014,Mayo,Costa Rica,188,8,8,,16,"(4.815061,-75.736532)"
2014,Mayo,Costa Rica,188,88,99,,187,"(6.171601,-75.427454)"
2014,Mayo,Costa Rica,188,4,3,,7,"(7.128456,-73.183637)"
2014,Mayo,Costa Rica,188,1,2,,3,"(7.927209,-72.507910)"
2014,Mayo,Croacia,191,1,0,,1,"(3.541112,-76.384584)"
2014,Mayo,Croacia,191,1,1,,2,"(4.697144,-74.140516)"
2014,Mayo,Cuba,192,12,14,,26,"(10.445761,-75.516429)"
2014,Mayo,Cuba,192,9,16,,25,"(10.886611,-74.776708)"
2014,Mayo,Cuba,192,118,87,,205,"(3.541112,-76.384584)"
2014,Mayo,Cuba,192,830,720,,1550,"(4.697144,-74.140516)"
2014,Mayo,Cuba,192,25,14,,39,"(4.815061,-75.736532)"
2014,Mayo,Cuba,192,178,150,,328,"(6.171601,-75.427454)"
2014,Mayo,Cuba,192,9,6,,15,"(7.128456,-73.183637)"
2014,Mayo,Cuba,192,4,3,,7,"(7.927209,-72.507910)"
2014,Mayo,Curazao,99999,1,1,,2,"(10.408582,-75.538003)"
2014,Mayo,Curazao,99999,0,1,,1,"(10.886611,-74.776708)"
2014,Mayo,Curazao,99999,1,1,,2,"(3.541112,-76.384584)"
2014,Mayo,Curazao,99999,533,450,,983,"(4.697144,-74.140516)"
2014,Mayo,Curazao,99999,124,65,,189,"(6.171601,-75.427454)"
2014,Mayo,Curazao,99999,1,1,,2,"(7.128456,-73.183637)"
2014,Mayo,Curazao,99999,1,1,,2,"(7.927209,-72.507910)"
2014,Mayo,República Checa,203,9,6,,15,"(4.697144,-74.140516)"
2014,Mayo,Chile,152,36,43,,79,"(0.814836,-77.662532)"
2014,Mayo,Chile,152,14,3,,17,"(10.445761,-75.516429)"
2014,Mayo,Chile,152,13,8,,21,"(10.886611,-74.776708)"
2014,Mayo,Chile,152,1,0,,1,"(12.586067,-81.702563)"
2014,Mayo,Chile,152,400,361,,761,"(3.541112,-76.384584)"
2014,Mayo,Chile,152,2243,2187,,4430,"(4.697144,-74.140516)"
2014,Mayo,Chile,152,33,25,,58,"(4.815061,-75.736532)"
2014,Mayo,Chile,152,241,204,,445,"(6.171601,-75.427454)"
2014,Mayo,Chile,152,9,5,,14,"(7.128456,-73.183637)"
2014,Mayo,Chile,152,1,1,,2,"(7.927209,-72.507910)"
2014,Mayo,China,156,0,1,,1,"(10.445761,-75.516429)"
2014,Mayo,China,156,2,7,,9,"(10.886611,-74.776708)"
2014,Mayo,China,156,6,13,,19,"(3.541112,-76.384584)"
2014,Mayo,China,156,176,433,,609,"(4.697144,-74.140516)"
2014,Mayo,China,156,2,1,,3,"(4.815061,-75.736532)"
2014,Mayo,China,156,4,18,,22,"(6.171601,-75.427454)"
2014,Mayo,Chipre,196,0,1,,1,"(4.697144,-74.140516)"
2014,Mayo,Dinamarca,208,1,0,,1,"(10.445761,-75.516429)"
2014,Mayo,Dinamarca,208,1,0,,1,"(3.541112,-76.384584)"
2014,Mayo,Dinamarca,208,48,26,,74,"(4.697144,-74.140516)"
2014,Mayo,Dinamarca,208,1,0,,1,"(6.171601,-75.427454)"
2014,Mayo,Ecuador,218,513,499,,1012,"(0.25129,-76.875963)"
2014,Mayo,Ecuador,218,5508,6337,,11845,"(0.814836,-77.662532)"
2014,Mayo,Ecuador,218,146,156,,302,"(1.813928,-78.763924)"
2014,Mayo,Ecuador,218,0,4,,4,"(10.408582,-75.538003)"
2014,Mayo,Ecuador,218,1,5,,6,"(10.445761,-75.516429)"
2014,Mayo,Ecuador,218,3,14,,17,"(10.886611,-74.776708)"
2014,Mayo,Ecuador,218,3,3,,6,"(12.586067,-81.702563)"
2014,Mayo,Ecuador,218,606,713,,1319,"(3.541112,-76.384584)"
2014,Mayo,Ecuador,218,2222,3965,,6187,"(4.697144,-74.140516)"
2014,Mayo,Ecuador,218,3,3,,6,"(4.815061,-75.736532)"
2014,Mayo,Ecuador,218,360,385,,745,"(6.171601,-75.427454)"
2014,Mayo,Ecuador,218,2,2,,4,"(7.128456,-73.183637)"
2014,Mayo,Ecuador,218,1,0,,1,"(7.927209,-72.507910)"
2014,Mayo,Egipto,818,43,155,,198,"(4.697144,-74.140516)"
2014,Mayo,El Salvador,222,0,2,,2,"(10.445761,-75.516429)"
2014,Mayo,El Salvador,222,1,10,,11,"(10.886611,-74.776708)"
2014,Mayo,El Salvador,222,94,116,,210,"(3.541112,-76.384584)"
2014,Mayo,El Salvador,222,841,1007,,1848,"(4.697144,-74.140516)"
2014,Mayo,El Salvador,222,103,114,,217,"(6.171601,-75.427454)"
2014,Mayo,Emiratos Árabes,784,1,0,,1,"(10.445761,-75.516429)"
2014,Mayo,Emiratos Árabes,784,1,1,,2,"(3.541112,-76.384584)"
2014,Mayo,Emiratos Árabes,784,81,299,,380,"(4.697144,-74.140516)"
2014,Mayo,Emiratos Árabes,784,2,6,,8,"(6.171601,-75.427454)"
2014,Mayo,Eritrea,232,1,0,,1,"(4.697144,-74.140516)"
2014,Mayo,Eslovaquia,703,3,1,,4,"(4.697144,-74.140516)"
2014,Mayo,Eslovenia,705,0,3,,3,"(4.697144,-74.140516)"
2014,Mayo,Estados Unidos de América,840,1923,1436,,3359,"(10.445761,-75.516429)"
2014,Mayo,Estados Unidos de América,840,1771,1452,,3223,"(10.886611,-74.776708)"
2014,Mayo,Estados Unidos de América,840,52,34,,86,"(12.586067,-81.702563)"
2014,Mayo,Estados Unidos de América,840,5279,3740,,9019,"(3.541112,-76.384584)"
2014,Mayo,Estados Unidos de América,840,589,409,,998,"(4.452882,-75.766298)"
2014,Mayo,Estados Unidos de América,840,31583,28116,,59699,"(4.697144,-74.140516)"
2014,Mayo,Estados Unidos de América,840,627,406,,1033,"(4.815061,-75.736532)"
2014,Mayo,Estados Unidos de América,840,9321,7188,,16509,"(6.171601,-75.427454)"
2014,Mayo,Estados Unidos de América,840,183,139,,322,"(7.128456,-73.183637)"
2014,Mayo,Estados Unidos de América,840,94,71,,165,"(7.927209,-72.507910)"
2014,Mayo,Estonia,233,0,2,,2,"(4.697144,-74.140516)"
2014,Mayo,Etiopia,231,0,15,,15,"(4.697144,-74.140516)"
2014,Mayo,Filipinas,608,1,0,,1,"(10.886611,-74.776708)"
2014,Mayo,Filipinas,608,1,3,,4,"(4.697144,-74.140516)"
2014,Mayo,Filipinas,608,1,0,,1,"(6.171601,-75.427454)"
2014,Mayo,Finlandia,246,6,4,,10,"(4.697144,-74.140516)"
2014,Mayo,Francia,250,0,2,,2,"(10.445761,-75.516429)"
2014,Mayo,Francia,250,1,1,,2,"(10.886611,-74.776708)"
2014,Mayo,Francia,250,26,17,,43,"(3.541112,-76.384584)"
2014,Mayo,Francia,250,1427,1258,,2685,"(4.697144,-74.140516)"
2014,Mayo,Francia,250,29,26,,55,"(6.171601,-75.427454)"
2014,Mayo,Francia,250,1,0,,1,"(7.927209,-72.507910)"
2014,Mayo,Gabón,266,0,5,,5,"(4.697144,-74.140516)"
2014,Mayo,Gambia,270,1,0,,1,"(4.697144,-74.140516)"
2014,Mayo,Georgia,268,2,0,,2,"(4.697144,-74.140516)"
2014,Mayo,Ghana,288,0,1,,1,"(3.541112,-76.384584)"
2014,Mayo,Ghana,288,0,1,,1,"(4.815061,-75.736532)"
2014,Mayo,Grecia,300,1,1,,2,"(3.541112,-76.384584)"
2014,Mayo,Grecia,300,24,22,,46,"(4.697144,-74.140516)"
2014,Mayo,Grecia,300,3,1,,4,"(6.171601,-75.427454)"
2014,Mayo,Guatemala,320,1,2,,3,"(10.445761,-75.516429)"
2014,Mayo,Guatemala,320,2,2,,4,"(10.886611,-74.776708)"
2014,Mayo,Guatemala,320,1,0,,1,"(12.586067,-81.702563)"
2014,Mayo,Guatemala,320,44,45,,89,"(3.541112,-76.384584)"
2014,Mayo,Guatemala,320,335,500,,835,"(4.697144,-74.140516)"
2014,Mayo,Guatemala,320,5,7,,12,"(4.815061,-75.736532)"
2014,Mayo,Guatemala,320,69,105,,174,"(6.171601,-75.427454)"
2014,Mayo,Guatemala,320,3,1,,4,"(7.128456,-73.183637)"
2014,Mayo,Guyana,328,1,1,,2,"(10.886611,-74.776708)"
2014,Mayo,Guyana,328,0,1,,1,"(4.697144,-74.140516)"
2014,Mayo,Guyana,328,1,0,,1,"(6.171601,-75.427454)"
2014,Mayo,Guinea Ecuatorial,226,0,1,,1,"(3.541112,-76.384584)"
2014,Mayo,Guinea Ecuatorial,226,0,15,,15,"(4.697144,-74.140516)"
2014,Mayo,Guinea Ecuatorial,226,0,1,,1,"(6.171601,-75.427454)"
2014,Mayo,Guinea Bissau,624,0,1,,1,"(4.697144,-74.140516)"
2014,Mayo,Guadalupe/Territorio Francés,312,0,1,,1,"(6.171601,-75.427454)"
2014,Mayo,Guayana Francesa/Departamento de Ultramar Francés,254,1,0,,1,"(3.541112,-76.384584)"
2014,Mayo,Haití,332,1,2,,3,"(10.886611,-74.776708)"
2014,Mayo,Haití,332,1,0,,1,"(3.541112,-76.384584)"
2014,Mayo,Haití,332,1,6,,7,"(4.697144,-74.140516)"
2014,Mayo,Haití,332,3,8,,11,"(6.171601,-75.427454)"
2014,Mayo,Haití,332,0,1,,1,"(7.128456,-73.183637)"
2014,Mayo,Honduras,340,1,5,,6,"(10.445761,-75.516429)"
2014,Mayo,Honduras,340,4,8,,12,"(10.886611,-74.776708)"
2014,Mayo,Honduras,340,1,4,,5,"(12.586067,-81.702563)"
2014,Mayo,Honduras,340,4,16,,20,"(3.541112,-76.384584)"
2014,Mayo,Honduras,340,59,138,,197,"(4.697144,-74.140516)"
2014,Mayo,Honduras,340,1,4,,5,"(4.815061,-75.736532)"
2014,Mayo,Honduras,340,21,40,,61,"(6.171601,-75.427454)"
2014,Mayo,Honduras,340,1,1,,2,"(7.128456,-73.183637)"
2014,Mayo,Hong Kong,344,28,67,,95,"(4.697144,-74.140516)"
2014,Mayo,Hong Kong,344,1,2,,3,"(6.171601,-75.427454)"
2014,Mayo,Hungría,348,2,4,,6,"(4.697144,-74.140516)"
2014,Mayo,India,356,1,0,,1,"(3.541112,-76.384584)"
2014,Mayo,India,356,26,31,,57,"(4.697144,-74.140516)"
2014,Mayo,India,356,2,2,,4,"(6.171601,-75.427454)"
2014,Mayo,Indonesia,360,5,9,,14,"(4.697144,-74.140516)"
2014,Mayo,Indonesia,360,1,0,,1,"(6.171601,-75.427454)"
2014,Mayo,Iraq,368,1,16,,17,"(4.697144,-74.140516)"
2014,Mayo,Irán,364,3,1,,4,"(3.541112,-76.384584)"
2014,Mayo,Irán,364,0,2,,2,"(4.697144,-74.140516)"
2014,Mayo,República de Irlanda,372,1,0,,1,"(3.541112,-76.384584)"
2014,Mayo,República de Irlanda,372,16,5,,21,"(4.697144,-74.140516)"
2014,Mayo,Islandia,352,1,0,,1,"(10.886611,-74.776708)"
2014,Mayo,Islandia,352,1,0,,1,"(4.697144,-74.140516)"
2014,Mayo,Israel,376,2,0,,2,"(3.541112,-76.384584)"
2014,Mayo,Israel,376,221,149,,370,"(4.697144,-74.140516)"
2014,Mayo,Israel,376,3,2,,5,"(6.171601,-75.427454)"
2014,Mayo,Italia,380,2,0,,2,"(10.445761,-75.516429)"
2014,Mayo,Italia,380,2,1,,3,"(10.886611,-74.776708)"
2014,Mayo,Italia,380,40,17,,57,"(3.541112,-76.384584)"
2014,Mayo,Italia,380,709,444,,1153,"(4.697144,-74.140516)"
2014,Mayo,Italia,380,40,24,,64,"(6.171601,-75.427454)"
2014,Mayo,Jamaica,388,8,11,,19,"(10.445761,-75.516429)"
2014,Mayo,Jamaica,388,15,13,,28,"(10.886611,-74.776708)"
2014,Mayo,Jamaica,388,11,13,,24,"(3.541112,-76.384584)"
2014,Mayo,Jamaica,388,61,58,,119,"(4.697144,-74.140516)"
2014,Mayo,Jamaica,388,1,1,,2,"(4.815061,-75.736532)"
2014,Mayo,Jamaica,388,36,31,,67,"(6.171601,-75.427454)"
2014,Mayo,Jamaica,388,2,1,,3,"(7.128456,-73.183637)"
2014,Mayo,Japón,392,1,0,,1,"(10.445761,-75.516429)"
2014,Mayo,Japón,392,1,1,,2,"(3.541112,-76.384584)"
2014,Mayo,Japón,392,90,84,,174,"(4.697144,-74.140516)"
2014,Mayo,Japón,392,4,3,,7,"(6.171601,-75.427454)"
2014,Mayo,Jordania,400,1,0,,1,"(3.541112,-76.384584)"
2014,Mayo,Jordania,400,1,3,,4,"(4.697144,-74.140516)"
2014,Mayo,Kazajistán,398,0,3,,3,"(4.697144,-74.140516)"
2014,Mayo,Kazajistán,398,0,1,,1,"(6.171601,-75.427454)"
2014,Mayo,Kenia,404,1,4,,5,"(4.697144,-74.140516)"
2014,Mayo,Kenia,404,1,0,,1,"(6.171601,-75.427454)"
2014,Mayo,Kuwait,414,1,1,,2,"(4.697144,-74.140516)"
2014,Mayo,Letonia,428,0,1,,1,"(4.697144,-74.140516)"
2014,Mayo,Lituania,440,5,6,,11,"(4.697144,-74.140516)"
2014,Mayo,Líbano,422,0,2,,2,"(10.886611,-74.776708)"
2014,Mayo,Líbano,422,22,37,,59,"(4.697144,-74.140516)"
2014,Mayo,Liberia,430,0,1,,1,"(4.697144,-74.140516)"
2014,Mayo,Liechtenstein,438,1,0,,1,"(4.697144,-74.140516)"
2014,Mayo,Luxemburgo,442,0,1,,1,"(3.541112,-76.384584)"
2014,Mayo,Luxemburgo,442,2,4,,6,"(4.697144,-74.140516)"
2014,Mayo,Macao,446,0,1,,1,"(4.697144,-74.140516)"
2014,Mayo,Malasia,458,1,8,,9,"(4.697144,-74.140516)"
2014,Mayo,Malta,470,6,5,,11,"(4.697144,-74.140516)"
2014,Mayo,Malta,470,1,1,,2,"(6.171601,-75.427454)"
2014,Mayo,Marruecos,504,27,22,,49,"(4.697144,-74.140516)"
2014,Mayo,Marruecos,504,1,0,,1,"(6.171601,-75.427454)"
2014,Mayo,Mauricio,480,0,1,,1,"(4.697144,-74.140516)"
2014,Mayo,Martinica/Departamento de Ultramar Francés,474,1,0,,1,"(3.541112,-76.384584)"
2014,Mayo,México,484,25,30,,55,"(10.445761,-75.516429)"
2014,Mayo,México,484,83,72,,155,"(10.886611,-74.776708)"
2014,Mayo,México,484,407,334,,741,"(3.541112,-76.384584)"
2014,Mayo,México,484,8658,7917,,16575,"(4.697144,-74.140516)"
2014,Mayo,México,484,76,64,,140,"(4.815061,-75.736532)"
2014,Mayo,México,484,1301,936,,2237,"(6.171601,-75.427454)"
2014,Mayo,México,484,86,62,,148,"(7.128456,-73.183637)"
2014,Mayo,México,484,62,55,,117,"(7.927209,-72.507910)"
2014,Mayo,Mónaco,492,2,2,,4,"(4.697144,-74.140516)"
2014,Mayo,Mongolia,496,1,0,,1,"(4.697144,-74.140516)"
2014,Mayo,Mozambique,508,1,2,,3,"(4.697144,-74.140516)"
2014,Mayo,Myanmar,104,2,3,,5,"(4.697144,-74.140516)"
2014,Mayo,Nauru,520,0,2,,2,"(4.697144,-74.140516)"
2014,Mayo,Namibia,516,0,5,,5,"(4.697144,-74.140516)"
2014,Mayo,Nepal,524,1,0,,1,"(4.697144,-74.140516)"
2014,Mayo,Nicaragua,558,0,3,,3,"(10.445761,-75.516429)"
2014,Mayo,Nicaragua,558,2,2,,4,"(10.886611,-74.776708)"
2014,Mayo,Nicaragua,558,0,1,,1,"(10.971302,-74.765397)"
2014,Mayo,Nicaragua,558,3,2,,5,"(12.586067,-81.702563)"
2014,Mayo,Nicaragua,558,10,16,,26,"(3.541112,-76.384584)"
2014,Mayo,Nicaragua,558,23,49,,72,"(4.697144,-74.140516)"
2014,Mayo,Nicaragua,558,2,1,,3,"(4.815061,-75.736532)"
2014,Mayo,Nicaragua,558,11,26,,37,"(6.171601,-75.427454)"
2014,Mayo,Nicaragua,558,1,0,,1,"(7.128456,-73.183637)"
2014,Mayo,Nicaragua,558,1,1,,2,"(7.927209,-72.507910)"
2014,Mayo,Nigeria,566,1,14,,15,"(4.697144,-74.140516)"
2014,Mayo,Nigeria,566,1,0,,1,"(6.171601,-75.427454)"
2014,Mayo,Níger,562,0,1,,1,"(4.697144,-74.140516)"
2014,Mayo,Noruega,578,23,23,,46,"(4.697144,-74.140516)"
2014,Mayo,Noruega,578,4,0,,4,"(6.171601,-75.427454)"
2014,Mayo,Nueva Zelanda,554,1,0,,1,"(3.541112,-76.384584)"
2014,Mayo,Nueva Zelanda,554,19,17,,36,"(4.697144,-74.140516)"
2014,Mayo,Nueva Zelanda,554,0,2,,2,"(6.171601,-75.427454)"
2014,Mayo,Omán,512,2,5,,7,"(4.697144,-74.140516)"
2014,Mayo,Papúa Nueva Guinea,598,0,1,,1,"(4.697144,-74.140516)"
2014,Mayo,Papúa Nueva Guinea,598,0,1,,1,"(6.171601,-75.427454)"
2014,Mayo,Pakistán,586,0,1,,1,"(4.697144,-74.140516)"
2014,Mayo,Pakistán,586,0,1,,1,"(6.171601,-75.427454)"
2014,Mayo,Panamá,591,122,262,,384,"(10.408582,-75.538003)"
2014,Mayo,Panamá,591,0,2,,2,"(10.433609,-73.247863)"
2014,Mayo,Panamá,591,319,362,,681,"(10.445761,-75.516429)"
2014,Mayo,Panamá,591,863,967,,1830,"(10.886611,-74.776708)"
2014,Mayo,Panamá,591,0,1,,1,"(10.971302,-74.765397)"
2014,Mayo,Panamá,591,204,226,,430,"(12.586067,-81.702563)"
2014,Mayo,Panamá,591,1919,1807,,3726,"(3.541112,-76.384584)"
2014,Mayo,Panamá,591,6333,7063,,13396,"(4.697144,-74.140516)"
2014,Mayo,Panamá,591,903,737,,1640,"(4.815061,-75.736532)"
2014,Mayo,Panamá,591,1910,1972,,3882,"(6.171601,-75.427454)"
2014,Mayo,Panamá,591,3,4,,7,"(6.228046,-77.404104)"
2014,Mayo,Panamá,591,4,12,,16,"(7.102626,-77.762647)"
2014,Mayo,Panamá,591,436,425,,861,"(7.128456,-73.183637)"
2014,Mayo,Panamá,591,216,211,,427,"(7.927209,-72.507910)"
2014,Mayo,Panamá,591,1,54,,55,"(8.066966,-76.735404)"
2014,Mayo,Panamá,591,72,162,,234,"(8.635765,-77.346578)"
2014,Mayo,Paraguay,600,2,2,,4,"(10.445761,-75.516429)"
2014,Mayo,Paraguay,600,1,2,,3,"(10.886611,-74.776708)"
2014,Mayo,Paraguay,600,14,12,,26,"(3.541112,-76.384584)"
2014,Mayo,Paraguay,600,64,136,,200,"(4.697144,-74.140516)"
2014,Mayo,Paraguay,600,2,2,,4,"(4.815061,-75.736532)"
2014,Mayo,Paraguay,600,9,27,,36,"(6.171601,-75.427454)"
2014,Mayo,Paraguay,600,1,1,,2,"(7.128456,-73.183637)"
2014,Mayo,Perú,604,72,121,,193,"(-4.197703,-69.941278)"
2014,Mayo,Perú,604,23,15,,38,"(0.814836,-77.662532)"
2014,Mayo,Perú,604,6,6,,12,"(10.445761,-75.516429)"
2014,Mayo,Perú,604,29,42,,71,"(10.886611,-74.776708)"
2014,Mayo,Perú,604,5,1,,6,"(12.586067,-81.702563)"
2014,Mayo,Perú,604,287,291,,578,"(3.541112,-76.384584)"
2014,Mayo,Perú,604,3110,4150,,7260,"(4.697144,-74.140516)"
2014,Mayo,Perú,604,8,12,,20,"(4.815061,-75.736532)"
2014,Mayo,Perú,604,398,496,,894,"(6.171601,-75.427454)"
2014,Mayo,Perú,604,15,8,,23,"(7.128456,-73.183637)"
2014,Mayo,Perú,604,4,3,,7,"(7.927209,-72.507910)"
2014,Mayo,Polonia,616,21,25,,46,"(4.697144,-74.140516)"
2014,Mayo,Polonia,616,1,0,,1,"(6.171601,-75.427454)"
2014,Mayo,Portugal,620,2,3,,5,"(3.541112,-76.384584)"
2014,Mayo,Portugal,620,43,48,,91,"(4.697144,-74.140516)"
2014,Mayo,Portugal,620,3,5,,8,"(6.171601,-75.427454)"
2014,Mayo,Puerto Rico/Territorio de Estados Unidos,630,7,4,,11,"(10.445761,-75.516429)"
2014,Mayo,Puerto Rico/Territorio de Estados Unidos,630,8,7,,15,"(10.886611,-74.776708)"
2014,Mayo,Puerto Rico/Territorio de Estados Unidos,630,0,1,,1,"(12.586067,-81.702563)"
2014,Mayo,Puerto Rico/Territorio de Estados Unidos,630,20,19,,39,"(3.541112,-76.384584)"
2014,Mayo,Puerto Rico/Territorio de Estados Unidos,630,430,342,,772,"(4.697144,-74.140516)"
2014,Mayo,Puerto Rico/Territorio de Estados Unidos,630,6,2,,8,"(4.815061,-75.736532)"
2014,Mayo,Puerto Rico/Territorio de Estados Unidos,630,72,42,,114,"(6.171601,-75.427454)"
2014,Mayo,Puerto Rico/Territorio de Estados Unidos,630,7,1,,8,"(7.128456,-73.183637)"
2014,Mayo,Qatar,634,1,0,,1,"(10.445761,-75.516429)"
2014,Mayo,Qatar,634,2,2,,4,"(4.697144,-74.140516)"
2014,Mayo,Reino Unido de Gran Bretaña e Irlanda del Norte,826,3,1,,4,"(10.445761,-75.516429)"
2014,Mayo,Reino Unido de Gran Bretaña e Irlanda del Norte,826,0,1,,1,"(10.886611,-74.776708)"
2014,Mayo,Reino Unido de Gran Bretaña e Irlanda del Norte,826,33,14,,47,"(3.541112,-76.384584)"
2014,Mayo,Reino Unido de Gran Bretaña e Irlanda del Norte,826,649,453,,1102,"(4.697144,-74.140516)"
2014,Mayo,Reino Unido de Gran Bretaña e Irlanda del Norte,826,22,30,,52,"(6.171601,-75.427454)"
2014,Mayo,Federación de Rusia,643,38,39,,77,"(4.697144,-74.140516)"
2014,Mayo,Federación de Rusia,643,0,1,,1,"(6.171601,-75.427454)"
2014,Mayo,República Dominicana,214,15,23,,38,"(10.445761,-75.516429)"
2014,Mayo,República Dominicana,214,52,79,,131,"(10.886611,-74.776708)"
2014,Mayo,República Dominicana,214,0,1,,1,"(12.586067,-81.702563)"
2014,Mayo,República Dominicana,214,47,44,,91,"(3.541112,-76.384584)"
2014,Mayo,República Dominicana,214,1749,1593,,3342,"(4.697144,-74.140516)"
2014,Mayo,República Dominicana,214,14,12,,26,"(4.815061,-75.736532)"
2014,Mayo,República Dominicana,214,103,118,,221,"(6.171601,-75.427454)"
2014,Mayo,República Dominicana,214,19,12,,31,"(7.128456,-73.183637)"
2014,Mayo,República Dominicana,214,7,9,,16,"(7.927209,-72.507910)"
2014,Mayo,Reunión,638,1,0,,1,"(4.697144,-74.140516)"
2014,Mayo,República Democrática Popular de Corea,408,1,0,,1,"(4.697144,-74.140516)"
2014,Mayo,Rumania,642,6,11,,17,"(4.697144,-74.140516)"
2014,Mayo,Rwanda,646,2,0,,2,"(4.697144,-74.140516)"
2014,Mayo,Sahara Occidental/Desierto Sahara,732,1,0,,1,"(3.541112,-76.384584)"
2014,Mayo,San Marino,674,1,0,,1,"(7.927209,-72.507910)"
2014,Mayo,Senegal,686,1,3,,4,"(4.697144,-74.140516)"
2014,Mayo,Serbia,688,0,1,,1,"(4.697144,-74.140516)"
2014,Mayo,Singapur,702,2,1,,3,"(10.886611,-74.776708)"
2014,Mayo,Singapur,702,26,34,,60,"(4.697144,-74.140516)"
2014,Mayo,Singapur,702,1,0,,1,"(4.815061,-75.736532)"
2014,Mayo,Singapur,702,2,3,,5,"(6.171601,-75.427454)"
2014,Mayo,Sri Lanka,144,1,1,,2,"(4.697144,-74.140516)"
2014,Mayo,Sudáfrica,710,1,0,,1,"(3.541112,-76.384584)"
2014,Mayo,Sudáfrica,710,20,27,,47,"(4.697144,-74.140516)"
2014,Mayo,Sudán,736,0,1,,1,"(4.697144,-74.140516)"
2014,Mayo,Sudán,736,0,1,,1,"(6.171601,-75.427454)"
2014,Mayo,Suecia,752,1,1,,2,"(10.445761,-75.516429)"
2014,Mayo,Suecia,752,2,3,,5,"(3.541112,-76.384584)"
2014,Mayo,Suecia,752,68,65,,133,"(4.697144,-74.140516)"
2014,Mayo,Suecia,752,6,4,,10,"(6.171601,-75.427454)"
2014,Mayo,Suecia,752,1,0,,1,"(7.128456,-73.183637)"
2014,Mayo,Suiza,756,1,0,,1,"(10.445761,-75.516429)"
2014,Mayo,Suiza,756,13,9,,22,"(3.541112,-76.384584)"
2014,Mayo,Suiza,756,204,147,,351,"(4.697144,-74.140516)"
2014,Mayo,Suiza,756,10,5,,15,"(6.171601,-75.427454)"
2014,Mayo,Surinam,740,2,10,,12,"(4.697144,-74.140516)"
2014,Mayo,Surinam,740,1,1,,2,"(6.171601,-75.427454)"
2014,Mayo,Taiwán,158,3,6,,9,"(4.697144,-74.140516)"
2014,Mayo,Taiwán,158,0,2,,2,"(6.171601,-75.427454)"
2014,Mayo,Tailandia,764,27,20,,47,"(4.697144,-74.140516)"
2014,Mayo,Tailandia,764,0,1,,1,"(6.171601,-75.427454)"
2014,Mayo,Tanzania,834,2,0,,2,"(4.697144,-74.140516)"
2014,Mayo,Trinidad y Tobago,780,1,4,,5,"(10.445761,-75.516429)"
2014,Mayo,Trinidad y Tobago,780,2,0,,2,"(10.886611,-74.776708)"
2014,Mayo,Trinidad y Tobago,780,6,4,,10,"(3.541112,-76.384584)"
2014,Mayo,Trinidad y Tobago,780,19,42,,61,"(4.697144,-74.140516)"
2014,Mayo,Trinidad y Tobago,780,1,3,,4,"(4.815061,-75.736532)"
2014,Mayo,Trinidad y Tobago,780,5,7,,12,"(6.171601,-75.427454)"
2014,Mayo,Trinidad y Tobago,780,1,1,,2,"(7.128456,-73.183637)"
2014,Mayo,Trinidad y Tobago,780,0,1,,1,"(7.927209,-72.507910)"
2014,Mayo,Túnez,788,1,2,,3,"(4.697144,-74.140516)"
2014,Mayo,Turquía,792,0,1,,1,"(3.541112,-76.384584)"
2014,Mayo,Turquía,792,111,97,,208,"(4.697144,-74.140516)"
2014,Mayo,Turquía,792,1,0,,1,"(6.171601,-75.427454)"
2014,Mayo,Ucrania,804,1,2,,3,"(4.697144,-74.140516)"
2014,Mayo,Uganda,800,1,0,,1,"(4.697144,-74.140516)"
2014,Mayo,Uruguay,858,0,1,,1,"(0.814836,-77.662532)"
2014,Mayo,Uruguay,858,1,2,,3,"(10.445761,-75.516429)"
2014,Mayo,Uruguay,858,1,0,,1,"(10.886611,-74.776708)"
2014,Mayo,Uruguay,858,5,10,,15,"(3.541112,-76.384584)"
2014,Mayo,Uruguay,858,47,55,,102,"(4.697144,-74.140516)"
2014,Mayo,Uruguay,858,0,1,,1,"(4.815061,-75.736532)"
2014,Mayo,Uruguay,858,14,54,,68,"(6.171601,-75.427454)"
2014,Mayo,Uruguay,858,1,0,,1,"(7.128456,-73.183637)"
2014,Mayo,Venezuela,862,9,13,,22,"(10.445761,-75.516429)"
2014,Mayo,Venezuela,862,10,21,,31,"(10.886611,-74.776708)"
2014,Mayo,Venezuela,862,1,2,,3,"(10.971302,-74.765397)"
2014,Mayo,Venezuela,862,9089,7397,,16486,"(11.360009,-72.129330)"
2014,Mayo,Venezuela,862,0,1,,1,"(12.586067,-81.702563)"
2014,Mayo,Venezuela,862,14,20,,34,"(3.541112,-76.384584)"
2014,Mayo,Venezuela,862,1035,1525,,2560,"(4.697144,-74.140516)"
2014,Mayo,Venezuela,862,6,4,,10,"(4.815061,-75.736532)"
2014,Mayo,Venezuela,862,253,312,,565,"(6.171601,-75.427454)"
2014,Mayo,Venezuela,862,152,157,,309,"(6.185799,-67.483929)"
2014,Mayo,Venezuela,862,1389,1295,,2684,"(7.088729,-70.740253)"
2014,Mayo,Venezuela,862,3,5,,8,"(7.128456,-73.183637)"
2014,Mayo,Venezuela,862,4838,4924,,9762,"(7.818934,-72.453226)"
2014,Mayo,Venezuela,862,0,13,,13,"(7.927209,-72.507910)"
2014,Mayo,Vietnam,704,1,0,,1,"(3.541112,-76.384584)"
2014,Mayo,Vietnam,704,3,6,,9,"(4.697144,-74.140516)"
2014,Mayo,Desconocido,99999,1,0,,1,"(10.408582,-75.538003)"
2014,Mayo,Desconocido,99999,7,64,,71,"(12.5744111,-81.703935)"
2014,Mayo,Desconocido,99999,708,710,,1418,"(4.697144,-74.140516)"
2014,Mayo,Desconocido,99999,1,0,,1,"(8.635765,-77.346578)"
2014,Junio,Desconocido,99999,5,57,,62,"(12.5744111,-81.703935)"
2014,Junio,Desconocido,99999,0,1,,1,"(13.3387613,-81.372937)"
2014,Junio,Desconocido,99999,780,779,,1559,"(4.697144,-74.140516)"
2014,Junio,Desconocido,99999,1,6,,7,"(8.635765,-77.346578)"
2014,Junio,Afganistán,4,3,12,,15,"(4.697144,-74.140516)"
2014,Junio,Alemania,276,1,4,,5,"(10.445761,-75.516429)"
2014,Junio,Alemania,276,13,12,,25,"(10.886611,-74.776708)"
2014,Junio,Alemania,276,15,11,,26,"(3.541112,-76.384584)"
2014,Junio,Alemania,276,1695,1500,,3195,"(4.697144,-74.140516)"
2014,Junio,Alemania,276,12,12,,24,"(6.171601,-75.427454)"
2014,Junio,Angola,24,2,8,,10,"(4.697144,-74.140516)"
2014,Junio,Antigua y Barbuda,28,1,1,,2,"(4.697144,-74.140516)"
2014,Junio,Países Bajos,528,5,5,,10,"(10.445761,-75.516429)"
2014,Junio,Países Bajos,528,6,0,,6,"(10.886611,-74.776708)"
2014,Junio,Países Bajos,528,32,12,,44,"(3.541112,-76.384584)"
2014,Junio,Países Bajos,528,187,133,,320,"(4.697144,-74.140516)"
2014,Junio,Países Bajos,528,1,0,,1,"(4.815061,-75.736532)"
2014,Junio,Países Bajos,528,64,32,,96,"(6.171601,-75.427454)"
2014,Junio,Países Bajos,528,2,3,,5,"(7.128456,-73.183637)"
2014,Junio,Arabia Saudita,682,2,13,,15,"(4.697144,-74.140516)"
2014,Junio,Arabia Saudita,682,1,3,,4,"(6.171601,-75.427454)"
2014,Junio,Argelia,12,1,10,,11,"(4.697144,-74.140516)"
2014,Junio,Argentina,32,25,33,,58,"(0.814836,-77.662532)"
2014,Junio,Argentina,32,14,13,,27,"(10.445761,-75.516429)"
2014,Junio,Argentina,32,22,15,,37,"(10.886611,-74.776708)"
2014,Junio,Argentina,32,6,9,,15,"(12.586067,-81.702563)"
2014,Junio,Argentina,32,128,138,,266,"(3.541112,-76.384584)"
2014,Junio,Argentina,32,2789,2891,,5680,"(4.697144,-74.140516)"
2014,Junio,Argentina,32,9,15,,24,"(4.815061,-75.736532)"
2014,Junio,Argentina,32,233,209,,442,"(6.171601,-75.427454)"
2014,Junio,Argentina,32,3,8,,11,"(7.128456,-73.183637)"
2014,Junio,Argentina,32,0,1,,1,"(7.927209,-72.507910)"
2014,Junio,República de Armenia,51,1,0,,1,"(4.697144,-74.140516)"
2014,Junio,Aruba,533,1,0,,1,"(10.445761,-75.516429)"
2014,Junio,Aruba,533,8,8,,16,"(10.886611,-74.776708)"
2014,Junio,Aruba,533,8,8,,16,"(3.541112,-76.384584)"
2014,Junio,Aruba,533,1900,1545,,3445,"(4.697144,-74.140516)"
2014,Junio,Aruba,533,8,6,,14,"(4.815061,-75.736532)"
2014,Junio,Aruba,533,135,104,,239,"(6.171601,-75.427454)"
2014,Junio,Aruba,533,8,12,,20,"(7.128456,-73.183637)"
2014,Junio,Australia,36,2,2,,4,"(10.445761,-75.516429)"
2014,Junio,Australia,36,1,1,,2,"(10.886611,-74.776708)"
2014,Junio,Australia,36,11,6,,17,"(3.541112,-76.384584)"
2014,Junio,Australia,36,162,120,,282,"(4.697144,-74.140516)"
2014,Junio,Australia,36,1,0,,1,"(4.815061,-75.736532)"
2014,Junio,Australia,36,41,21,,62,"(6.171601,-75.427454)"
2014,Junio,Australia,36,0,1,,1,"(7.128456,-73.183637)"
2014,Junio,Austria,40,1,0,,1,"(10.445761,-75.516429)"
2014,Junio,Austria,40,36,31,,67,"(4.697144,-74.140516)"
2014,Junio,Azerbaiyán,31,1,1,,2,"(4.697144,-74.140516)"
2014,Junio,Azerbaiyán,31,0,1,,1,"(6.171601,-75.427454)"
2014,Junio,Bahamas,44,2,4,,6,"(10.445761,-75.516429)"
2014,Junio,Bahamas,44,1,2,,3,"(10.886611,-74.776708)"
2014,Junio,Bahamas,44,0,1,,1,"(12.586067,-81.702563)"
2014,Junio,Bahamas,44,6,4,,10,"(3.541112,-76.384584)"
2014,Junio,Bahamas,44,13,14,,27,"(4.697144,-74.140516)"
2014,Junio,Bahamas,44,24,18,,42,"(6.171601,-75.427454)"
2014,Junio,Bahamas,44,0,1,,1,"(7.128456,-73.183637)"
2014,Junio,Bahamas,44,6,3,,9,"(7.927209,-72.507910)"
2014,Junio,Bangladesh,50,0,1,,1,"(4.697144,-74.140516)"
2014,Junio,Barbados,52,3,6,,9,"(4.697144,-74.140516)"
2014,Junio,Barbados,52,0,1,,1,"(6.171601,-75.427454)"
2014,Junio,República de Belarús,112,3,0,,3,"(11.360009,-72.129330)"
2014,Junio,República de Belarús,112,1,2,,3,"(4.697144,-74.140516)"
2014,Junio,Bélgica,56,1,1,,2,"(10.886611,-74.776708)"
2014,Junio,Bélgica,56,1,0,,1,"(12.586067,-81.702563)"
2014,Junio,Bélgica,56,2,3,,5,"(3.541112,-76.384584)"
2014,Junio,Bélgica,56,107,69,,176,"(4.697144,-74.140516)"
2014,Junio,Bélgica,56,8,5,,13,"(6.171601,-75.427454)"
2014,Junio,Belice,84,3,4,,7,"(4.697144,-74.140516)"
2014,Junio,Belice,84,2,0,,2,"(6.171601,-75.427454)"
2014,Junio,Bermudas/Territorio Británico de Ultramar,60,5,0,,5,"(4.697144,-74.140516)"
2014,Junio,Bermudas/Territorio Británico de Ultramar,60,1,1,,2,"(6.171601,-75.427454)"
2014,Junio,Bolivia,68,5,11,,16,"(0.814836,-77.662532)"
2014,Junio,Bolivia,68,2,3,,5,"(10.886611,-74.776708)"
2014,Junio,Bolivia,68,19,36,,55,"(3.541112,-76.384584)"
2014,Junio,Bolivia,68,269,430,,699,"(4.697144,-74.140516)"
2014,Junio,Bolivia,68,0,3,,3,"(4.815061,-75.736532)"
2014,Junio,Bolivia,68,37,59,,96,"(6.171601,-75.427454)"
2014,Junio,Bolivia,68,1,0,,1,"(7.128456,-73.183637)"
2014,Junio,Bosnia y Herzegovina,70,1,0,,1,"(3.541112,-76.384584)"
2014,Junio,Bosnia y Herzegovina,70,0,1,,1,"(4.697144,-74.140516)"
2014,Junio,Brasil,76,360,1094,,1454,"(-4.197703,-69.941278)"
2014,Junio,Brasil,76,35,151,,186,"(0.814836,-77.662532)"
2014,Junio,Brasil,76,54,173,,227,"(10.445761,-75.516429)"
2014,Junio,Brasil,76,42,167,,209,"(10.886611,-74.776708)"
2014,Junio,Brasil,76,2,3,,5,"(11.360009,-72.129330)"
2014,Junio,Brasil,76,42,110,,152,"(12.586067,-81.702563)"
2014,Junio,Brasil,76,252,809,,1061,"(3.541112,-76.384584)"
2014,Junio,Brasil,76,6368,16050,,22418,"(4.697144,-74.140516)"
2014,Junio,Brasil,76,21,68,,89,"(4.815061,-75.736532)"
2014,Junio,Brasil,76,382,1275,,1657,"(6.171601,-75.427454)"
2014,Junio,Brasil,76,0,2,,2,"(7.088729,-70.740253)"
2014,Junio,Brasil,76,9,33,,42,"(7.128456,-73.183637)"
2014,Junio,Brasil,76,0,1,,1,"(7.818934,-72.453226)"
2014,Junio,Brasil,76,8,15,,23,"(7.927209,-72.507910)"
2014,Junio,Brunei Darussalam,96,0,3,,3,"(4.697144,-74.140516)"
2014,Junio,Bulgaria,100,3,5,,8,"(4.697144,-74.140516)"
2014,Junio,Bulgaria,100,0,1,,1,"(6.171601,-75.427454)"
2014,Junio,Islas Caimán/Territorio Británico de Ultramar,136,1,2,,3,"(10.445761,-75.516429)"
2014,Junio,Islas Caimán/Territorio Británico de Ultramar,136,0,1,,1,"(10.886611,-74.776708)"
2014,Junio,Islas Caimán/Territorio Británico de Ultramar,136,6,0,,6,"(12.586067,-81.702563)"
2014,Junio,Islas Caimán/Territorio Británico de Ultramar,136,1,4,,5,"(4.697144,-74.140516)"
2014,Junio,Camboya,116,1,1,,2,"(4.697144,-74.140516)"
2014,Junio,Camerún,120,2,3,,5,"(4.697144,-74.140516)"
2014,Junio,Canadá,124,34,29,,63,"(10.445761,-75.516429)"
2014,Junio,Canadá,124,45,29,,74,"(10.886611,-74.776708)"
2014,Junio,Canadá,124,0,1,,1,"(12.586067,-81.702563)"
2014,Junio,Canadá,124,98,78,,176,"(3.541112,-76.384584)"
2014,Junio,Canadá,124,1,3,,4,"(4.452882,-75.766298)"
2014,Junio,Canadá,124,2006,1574,,3580,"(4.697144,-74.140516)"
2014,Junio,Canadá,124,16,19,,35,"(4.815061,-75.736532)"
2014,Junio,Canadá,124,250,235,,485,"(6.171601,-75.427454)"
2014,Junio,Canadá,124,15,6,,21,"(7.128456,-73.183637)"
2014,Junio,Canadá,124,1,0,,1,"(7.927209,-72.507910)"
2014,Junio,Chad,148,0,2,,2,"(4.697144,-74.140516)"
2014,Junio,España,724,1,1,,2,"(0.814836,-77.662532)"
2014,Junio,España,724,39,21,,60,"(10.445761,-75.516429)"
2014,Junio,España,724,6,6,,12,"(10.886611,-74.776708)"
2014,Junio,España,724,0,1,,1,"(12.586067,-81.702563)"
2014,Junio,España,724,1409,817,,2226,"(3.541112,-76.384584)"
2014,Junio,España,724,9580,7194,,16774,"(4.697144,-74.140516)"
2014,Junio,España,724,7,2,,9,"(4.815061,-75.736532)"
2014,Junio,España,724,907,687,,1594,"(6.171601,-75.427454)"
2014,Junio,República Democrática del Congo,180,0,3,,3,"(4.697144,-74.140516)"
2014,Junio,República de Corea,410,17,40,,57,"(4.697144,-74.140516)"
2014,Junio,República de Corea,410,0,1,,1,"(6.171601,-75.427454)"
2014,Junio,Costa de Marfil,384,5,1,,6,"(4.697144,-74.140516)"
2014,Junio,Costa de Marfil,384,1,0,,1,"(6.171601,-75.427454)"
2014,Junio,Costa Rica,188,0,7,,7,"(10.408582,-75.538003)"
2014,Junio,Costa Rica,188,6,17,,23,"(10.445761,-75.516429)"
2014,Junio,Costa Rica,188,17,24,,41,"(10.886611,-74.776708)"
2014,Junio,Costa Rica,188,6,3,,9,"(12.586067,-81.702563)"
2014,Junio,Costa Rica,188,40,41,,81,"(3.541112,-76.384584)"
2014,Junio,Costa Rica,188,765,813,,1578,"(4.697144,-74.140516)"
2014,Junio,Costa Rica,188,9,4,,13,"(4.815061,-75.736532)"
2014,Junio,Costa Rica,188,83,96,,179,"(6.171601,-75.427454)"
2014,Junio,Costa Rica,188,0,4,,4,"(7.128456,-73.183637)"
2014,Junio,Costa Rica,188,1,0,,1,"(7.927209,-72.507910)"
2014,Junio,Croacia,191,5,3,,8,"(4.697144,-74.140516)"
2014,Junio,Cuba,192,19,11,,30,"(10.445761,-75.516429)"
2014,Junio,Cuba,192,28,20,,48,"(10.886611,-74.776708)"
2014,Junio,Cuba,192,0,1,,1,"(12.586067,-81.702563)"
2014,Junio,Cuba,192,113,69,,182,"(3.541112,-76.384584)"
2014,Junio,Cuba,192,1346,1100,,2446,"(4.697144,-74.140516)"
2014,Junio,Cuba,192,37,36,,73,"(4.815061,-75.736532)"
2014,Junio,Cuba,192,195,158,,353,"(6.171601,-75.427454)"
2014,Junio,Cuba,192,13,13,,26,"(7.128456,-73.183637)"
2014,Junio,Cuba,192,7,5,,12,"(7.927209,-72.507910)"
2014,Junio,Curazao,99999,2,0,,2,"(10.445761,-75.516429)"
2014,Junio,Curazao,99999,29,17,,46,"(10.886611,-74.776708)"
2014,Junio,Curazao,99999,3,3,,6,"(3.541112,-76.384584)"
2014,Junio,Curazao,99999,456,430,,886,"(4.697144,-74.140516)"
2014,Junio,Curazao,99999,97,68,,165,"(6.171601,-75.427454)"
2014,Junio,República Checa,203,14,10,,24,"(4.697144,-74.140516)"
2014,Junio,República Checa,203,1,1,,2,"(6.171601,-75.427454)"
2014,Junio,Chile,152,58,79,,137,"(0.814836,-77.662532)"
2014,Junio,Chile,152,4,6,,10,"(10.445761,-75.516429)"
2014,Junio,Chile,152,18,7,,25,"(10.886611,-74.776708)"
2014,Junio,Chile,152,3,2,,5,"(12.586067,-81.702563)"
2014,Junio,Chile,152,361,272,,633,"(3.541112,-76.384584)"
2014,Junio,Chile,152,2693,2585,,5278,"(4.697144,-74.140516)"
2014,Junio,Chile,152,26,27,,53,"(4.815061,-75.736532)"
2014,Junio,Chile,152,164,101,,265,"(6.171601,-75.427454)"
2014,Junio,Chile,152,6,8,,14,"(7.128456,-73.183637)"
2014,Junio,Chile,152,0,3,,3,"(7.927209,-72.507910)"
2014,Junio,China,156,0,1,,1,"(0.814836,-77.662532)"
2014,Junio,China,156,0,1,,1,"(10.445761,-75.516429)"
2014,Junio,China,156,0,1,,1,"(10.886611,-74.776708)"
2014,Junio,China,156,1,4,,5,"(3.541112,-76.384584)"
2014,Junio,China,156,276,381,,657,"(4.697144,-74.140516)"
2014,Junio,China,156,1,1,,2,"(4.815061,-75.736532)"
2014,Junio,China,156,6,9,,15,"(6.171601,-75.427454)"
2014,Junio,China,156,4,2,,6,"(7.128456,-73.183637)"
2014,Junio,Chipre,196,1,2,,3,"(4.697144,-74.140516)"
2014,Junio,Dinamarca,208,0,1,,1,"(10.445761,-75.516429)"
2014,Junio,Dinamarca,208,1,0,,1,"(3.541112,-76.384584)"
2014,Junio,Dinamarca,208,43,41,,84,"(4.697144,-74.140516)"
2014,Junio,Dinamarca,208,6,7,,13,"(6.171601,-75.427454)"
2014,Junio,Ecuador,218,733,831,,1564,"(0.25129,-76.875963)"
2014,Junio,Ecuador,218,8728,8652,,17380,"(0.814836,-77.662532)"
2014,Junio,Ecuador,218,150,195,,345,"(1.813928,-78.763924)"
2014,Junio,Ecuador,218,0,2,,2,"(10.408582,-75.538003)"
2014,Junio,Ecuador,218,2,5,,7,"(10.445761,-75.516429)"
2014,Junio,Ecuador,218,13,27,,40,"(10.886611,-74.776708)"
2014,Junio,Ecuador,218,1,1,,2,"(12.586067,-81.702563)"
2014,Junio,Ecuador,218,878,818,,1696,"(3.541112,-76.384584)"
2014,Junio,Ecuador,218,2750,4241,,6991,"(4.697144,-74.140516)"
2014,Junio,Ecuador,218,0,2,,2,"(4.815061,-75.736532)"
2014,Junio,Ecuador,218,530,447,,977,"(6.171601,-75.427454)"
2014,Junio,Egipto,818,0,1,,1,"(10.886611,-74.776708)"
2014,Junio,Egipto,818,58,47,,105,"(4.697144,-74.140516)"
2014,Junio,Egipto,818,0,1,,1,"(6.171601,-75.427454)"
2014,Junio,El Salvador,222,1,3,,4,"(10.445761,-75.516429)"
2014,Junio,El Salvador,222,2,1,,3,"(10.886611,-74.776708)"
2014,Junio,El Salvador,222,6,14,,20,"(12.586067,-81.702563)"
2014,Junio,El Salvador,222,180,164,,344,"(3.541112,-76.384584)"
2014,Junio,El Salvador,222,1040,1042,,2082,"(4.697144,-74.140516)"
2014,Junio,El Salvador,222,95,110,,205,"(6.171601,-75.427454)"
2014,Junio,Emiratos Árabes,784,1,2,,3,"(3.541112,-76.384584)"
2014,Junio,Emiratos Árabes,784,111,281,,392,"(4.697144,-74.140516)"
2014,Junio,Emiratos Árabes,784,1,0,,1,"(6.171601,-75.427454)"
2014,Junio,Eritrea,232,0,1,,1,"(4.697144,-74.140516)"
2014,Junio,Eslovaquia,703,1,1,,2,"(4.697144,-74.140516)"
2014,Junio,Eslovenia,705,1,2,,3,"(4.697144,-74.140516)"
2014,Junio,Eslovenia,705,0,1,,1,"(6.171601,-75.427454)"
2014,Junio,Estados Unidos de América,840,2,1,,3,"(0.814836,-77.662532)"
2014,Junio,Estados Unidos de América,840,3157,2451,,5608,"(10.445761,-75.516429)"
2014,Junio,Estados Unidos de América,840,2569,1977,,4546,"(10.886611,-74.776708)"
2014,Junio,Estados Unidos de América,840,112,72,,184,"(12.586067,-81.702563)"
2014,Junio,Estados Unidos de América,840,6614,4730,,11344,"(3.541112,-76.384584)"
2014,Junio,Estados Unidos de América,840,512,371,,883,"(4.452882,-75.766298)"
2014,Junio,Estados Unidos de América,840,42619,35136,,77755,"(4.697144,-74.140516)"
2014,Junio,Estados Unidos de América,840,818,547,,1365,"(4.815061,-75.736532)"
2014,Junio,Estados Unidos de América,840,12811,9793,,22604,"(6.171601,-75.427454)"
2014,Junio,Estados Unidos de América,840,308,230,,538,"(7.128456,-73.183637)"
2014,Junio,Estados Unidos de América,840,321,265,,586,"(7.927209,-72.507910)"
2014,Junio,Estonia,233,3,3,,6,"(4.697144,-74.140516)"
2014,Junio,Etiopia,231,0,8,,8,"(4.697144,-74.140516)"
2014,Junio,Islas Fiji,242,0,1,,1,"(4.697144,-74.140516)"
2014,Junio,Filipinas,608,2,6,,8,"(4.697144,-74.140516)"
2014,Junio,Finlandia,246,1,0,,1,"(10.445761,-75.516429)"
2014,Junio,Finlandia,246,11,6,,17,"(4.697144,-74.140516)"
2014,Junio,Francia,250,7,1,,8,"(10.445761,-75.516429)"
2014,Junio,Francia,250,6,5,,11,"(10.886611,-74.776708)"
2014,Junio,Francia,250,47,24,,71,"(3.541112,-76.384584)"
2014,Junio,Francia,250,2211,1603,,3814,"(4.697144,-74.140516)"
2014,Junio,Francia,250,44,32,,76,"(6.171601,-75.427454)"
2014,Junio,Francia,250,1,0,,1,"(7.128456,-73.183637)"
2014,Junio,Gabón,266,0,7,,7,"(4.697144,-74.140516)"
2014,Junio,Ghana,288,1,2,,3,"(4.697144,-74.140516)"
2014,Junio,Grecia,300,9,1,,10,"(3.541112,-76.384584)"
2014,Junio,Grecia,300,54,47,,101,"(4.697144,-74.140516)"
2014,Junio,Guatemala,320,3,2,,5,"(10.445761,-75.516429)"
2014,Junio,Guatemala,320,3,4,,7,"(10.886611,-74.776708)"
2014,Junio,Guatemala,320,33,44,,77,"(3.541112,-76.384584)"
2014,Junio,Guatemala,320,480,563,,1043,"(4.697144,-74.140516)"
2014,Junio,Guatemala,320,4,10,,14,"(4.815061,-75.736532)"
2014,Junio,Guatemala,320,57,107,,164,"(6.171601,-75.427454)"
2014,Junio,Guatemala,320,1,0,,1,"(7.128456,-73.183637)"
2014,Junio,Guyana,328,0,1,,1,"(10.886611,-74.776708)"
2014,Junio,Guyana,328,0,1,,1,"(4.697144,-74.140516)"
2014,Junio,Guinea,324,1,0,,1,"(4.697144,-74.140516)"
2014,Junio,Guinea Ecuatorial,226,0,2,,2,"(3.541112,-76.384584)"
2014,Junio,Guinea Ecuatorial,226,0,4,,4,"(4.697144,-74.140516)"
2014,Junio,Guayana Francesa/Departamento de Ultramar Francés,254,0,1,,1,"(7.128456,-73.183637)"
2014,Junio,Haití,332,2,2,,4,"(10.886611,-74.776708)"
2014,Junio,Haití,332,1,1,,2,"(3.541112,-76.384584)"
2014,Junio,Haití,332,4,12,,16,"(4.697144,-74.140516)"
2014,Junio,Haití,332,0,1,,1,"(4.815061,-75.736532)"
2014,Junio,Haití,332,2,4,,6,"(6.171601,-75.427454)"
2014,Junio,Haití,332,0,1,,1,"(7.128456,-73.183637)"
2014,Junio,Honduras,340,0,6,,6,"(10.445761,-75.516429)"
2014,Junio,Honduras,340,4,9,,13,"(10.886611,-74.776708)"
2014,Junio,Honduras,340,1,1,,2,"(12.586067,-81.702563)"
2014,Junio,Honduras,340,6,20,,26,"(3.541112,-76.384584)"
2014,Junio,Honduras,340,83,140,,223,"(4.697144,-74.140516)"
2014,Junio,Honduras,340,1,2,,3,"(4.815061,-75.736532)"
2014,Junio,Honduras,340,23,44,,67,"(6.171601,-75.427454)"
2014,Junio,Hong Kong,344,0,1,,1,"(10.445761,-75.516429)"
2014,Junio,Hong Kong,344,1,0,,1,"(3.541112,-76.384584)"
2014,Junio,Hong Kong,344,30,63,,93,"(4.697144,-74.140516)"
2014,Junio,Hong Kong,344,3,1,,4,"(6.171601,-75.427454)"
2014,Junio,Hungría,348,1,0,,1,"(3.541112,-76.384584)"
2014,Junio,Hungría,348,7,8,,15,"(4.697144,-74.140516)"
2014,Junio,India,356,39,37,,76,"(4.697144,-74.140516)"
2014,Junio,India,356,0,1,,1,"(6.171601,-75.427454)"
2014,Junio,Indonesia,360,1,1,,2,"(3.541112,-76.384584)"
2014,Junio,Indonesia,360,18,15,,33,"(4.697144,-74.140516)"
2014,Junio,Indonesia,360,1,1,,2,"(6.171601,-75.427454)"
2014,Junio,Iraq,368,3,11,,14,"(4.697144,-74.140516)"
2014,Junio,Irán,364,3,5,,8,"(4.697144,-74.140516)"
2014,Junio,República de Irlanda,372,1,0,,1,"(3.541112,-76.384584)"
2014,Junio,República de Irlanda,372,19,9,,28,"(4.697144,-74.140516)"
2014,Junio,Islandia,352,2,0,,2,"(4.697144,-74.140516)"
2014,Junio,Israel,376,2,1,,3,"(10.445761,-75.516429)"
2014,Junio,Israel,376,0,1,,1,"(10.886611,-74.776708)"
2014,Junio,Israel,376,15,4,,19,"(3.541112,-76.384584)"
2014,Junio,Israel,376,207,170,,377,"(4.697144,-74.140516)"
2014,Junio,Israel,376,5,0,,5,"(6.171601,-75.427454)"
2014,Junio,Italia,380,1,0,,1,"(0.814836,-77.662532)"
2014,Junio,Italia,380,8,3,,11,"(10.445761,-75.516429)"
2014,Junio,Italia,380,1,1,,2,"(10.886611,-74.776708)"
2014,Junio,Italia,380,35,17,,52,"(3.541112,-76.384584)"
2014,Junio,Italia,380,816,530,,1346,"(4.697144,-74.140516)"
2014,Junio,Italia,380,30,21,,51,"(6.171601,-75.427454)"
2014,Junio,Jamaica,388,3,5,,8,"(10.445761,-75.516429)"
2014,Junio,Jamaica,388,2,3,,5,"(10.886611,-74.776708)"
2014,Junio,Jamaica,388,15,25,,40,"(3.541112,-76.384584)"
2014,Junio,Jamaica,388,39,41,,80,"(4.697144,-74.140516)"
2014,Junio,Jamaica,388,7,4,,11,"(4.815061,-75.736532)"
2014,Junio,Jamaica,388,11,12,,23,"(6.171601,-75.427454)"
2014,Junio,Jamaica,388,19,10,,29,"(7.128456,-73.183637)"
2014,Junio,Japón,392,1,0,,1,"(10.445761,-75.516429)"
2014,Junio,Japón,392,4,2,,6,"(3.541112,-76.384584)"
2014,Junio,Japón,392,56,56,,112,"(4.697144,-74.140516)"
2014,Junio,Japón,392,5,2,,7,"(6.171601,-75.427454)"
2014,Junio,Jordania,400,1,10,,11,"(4.697144,-74.140516)"
2014,Junio,Kenia,404,0,1,,1,"(10.886611,-74.776708)"
2014,Junio,Kenia,404,1,1,,2,"(3.541112,-76.384584)"
2014,Junio,Kenia,404,4,2,,6,"(4.697144,-74.140516)"
2014,Junio,Kuwait,414,0,6,,6,"(4.697144,-74.140516)"
2014,Junio,Letonia,428,0,1,,1,"(6.171601,-75.427454)"
2014,Junio,Lituania,440,2,1,,3,"(4.697144,-74.140516)"
2014,Junio,Líbano,422,2,1,,3,"(10.886611,-74.776708)"
2014,Junio,Líbano,422,35,40,,75,"(4.697144,-74.140516)"
2014,Junio,Luxemburgo,442,1,0,,1,"(3.541112,-76.384584)"
2014,Junio,Luxemburgo,442,4,2,,6,"(4.697144,-74.140516)"
2014,Junio,Madagascar,450,0,1,,1,"(4.697144,-74.140516)"
2014,Junio,Malasia,458,2,0,,2,"(3.541112,-76.384584)"
2014,Junio,Malasia,458,9,4,,13,"(4.697144,-74.140516)"
2014,Junio,Malasia,458,0,1,,1,"(7.128456,-73.183637)"
2014,Junio,Malawi,454,0,1,,1,"(4.697144,-74.140516)"
2014,Junio,Malta,470,5,6,,11,"(4.697144,-74.140516)"
2014,Junio,Marruecos,504,8,5,,13,"(4.697144,-74.140516)"
2014,Junio,Mauricio,480,1,0,,1,"(4.697144,-74.140516)"
2014,Junio,Martinica/Departamento de Ultramar Francés,474,0,1,,1,"(6.171601,-75.427454)"
2014,Junio,México,484,1,1,,2,"(0.25129,-76.875963)"
2014,Junio,México,484,3,3,,6,"(0.814836,-77.662532)"
2014,Junio,México,484,82,55,,137,"(10.445761,-75.516429)"
2014,Junio,México,484,142,112,,254,"(10.886611,-74.776708)"
2014,Junio,México,484,7,4,,11,"(12.586067,-81.702563)"
2014,Junio,México,484,537,481,,1018,"(3.541112,-76.384584)"
2014,Junio,México,484,11359,10133,,21492,"(4.697144,-74.140516)"
2014,Junio,México,484,79,64,,143,"(4.815061,-75.736532)"
2014,Junio,México,484,2038,1431,,3469,"(6.171601,-75.427454)"
2014,Junio,México,484,102,80,,182,"(7.128456,-73.183637)"
2014,Junio,México,484,0,1,,1,"(7.818934,-72.453226)"
2014,Junio,México,484,164,128,,292,"(7.927209,-72.507910)"
2014,Junio,Mónaco,492,1,1,,2,"(4.697144,-74.140516)"
2014,Junio,Mozambique,508,0,1,,1,"(4.697144,-74.140516)"
2014,Junio,Mozambique,508,2,1,,3,"(6.171601,-75.427454)"
2014,Junio,Nicaragua,558,6,21,,27,"(10.445761,-75.516429)"
2014,Junio,Nicaragua,558,4,2,,6,"(10.886611,-74.776708)"
2014,Junio,Nicaragua,558,4,13,,17,"(3.541112,-76.384584)"
2014,Junio,Nicaragua,558,32,42,,74,"(4.697144,-74.140516)"
2014,Junio,Nicaragua,558,3,0,,3,"(4.815061,-75.736532)"
2014,Junio,Nicaragua,558,2,25,,27,"(6.171601,-75.427454)"
2014,Junio,Nicaragua,558,0,1,,1,"(7.128456,-73.183637)"
2014,Junio,Nigeria,566,0,7,,7,"(4.697144,-74.140516)"
2014,Junio,Noruega,578,1,1,,2,"(10.886611,-74.776708)"
2014,Junio,Noruega,578,1,3,,4,"(3.541112,-76.384584)"
2014,Junio,Noruega,578,42,40,,82,"(4.697144,-74.140516)"
2014,Junio,Noruega,578,4,3,,7,"(6.171601,-75.427454)"
2014,Junio,Nueva Zelanda,554,0,1,,1,"(3.541112,-76.384584)"
2014,Junio,Nueva Zelanda,554,28,20,,48,"(4.697144,-74.140516)"
2014,Junio,Nueva Zelanda,554,6,2,,8,"(6.171601,-75.427454)"
2014,Junio,Omán,512,0,3,,3,"(4.697144,-74.140516)"
2014,Junio,Papúa Nueva Guinea,598,0,3,,3,"(4.697144,-74.140516)"
2014,Junio,Panamá,591,2,0,,2,"(0.814836,-77.662532)"
2014,Junio,Panamá,591,0,1,,1,"(1.813928,-78.763924)"
2014,Junio,Panamá,591,11,44,,55,"(10.408582,-75.538003)"
2014,Junio,Panamá,591,489,520,,1009,"(10.445761,-75.516429)"
2014,Junio,Panamá,591,1033,1052,,2085,"(10.886611,-74.776708)"
2014,Junio,Panamá,591,0,2,,2,"(10.971302,-74.765397)"
2014,Junio,Panamá,591,0,1,,1,"(11.117806,-74.232622)"
2014,Junio,Panamá,591,0,1,,1,"(11.247723,-74.213989)"
2014,Junio,Panamá,591,217,225,,442,"(12.586067,-81.702563)"
2014,Junio,Panamá,591,2546,2332,,4878,"(3.541112,-76.384584)"
2014,Junio,Panamá,591,74,63,,137,"(4.452882,-75.766298)"
2014,Junio,Panamá,591,7707,7855,,15562,"(4.697144,-74.140516)"
2014,Junio,Panamá,591,1547,1142,,2689,"(4.815061,-75.736532)"
2014,Junio,Panamá,591,2887,2798,,5685,"(6.171601,-75.427454)"
2014,Junio,Panamá,591,5,17,,22,"(7.102626,-77.762647)"
2014,Junio,Panamá,591,589,562,,1151,"(7.128456,-73.183637)"
2014,Junio,Panamá,591,1,0,,1,"(7.818934,-72.453226)"
2014,Junio,Panamá,591,203,182,,385,"(7.927209,-72.507910)"
2014,Junio,Panamá,591,1,79,,80,"(8.066966,-76.735404)"
2014,Junio,Panamá,591,81,164,,245,"(8.635765,-77.346578)"
2014,Junio,Paraguay,600,3,2,,5,"(10.445761,-75.516429)"
2014,Junio,Paraguay,600,1,4,,5,"(10.886611,-74.776708)"
2014,Junio,Paraguay,600,2,4,,6,"(12.586067,-81.702563)"
2014,Junio,Paraguay,600,22,46,,68,"(3.541112,-76.384584)"
2014,Junio,Paraguay,600,112,242,,354,"(4.697144,-74.140516)"
2014,Junio,Paraguay,600,1,2,,3,"(4.815061,-75.736532)"
2014,Junio,Paraguay,600,16,47,,63,"(6.171601,-75.427454)"
2014,Junio,Paraguay,600,0,6,,6,"(7.128456,-73.183637)"
2014,Junio,Perú,604,150,240,,390,"(-4.197703,-69.941278)"
2014,Junio,Perú,604,82,125,,207,"(0.814836,-77.662532)"
2014,Junio,Perú,604,7,15,,22,"(10.445761,-75.516429)"
2014,Junio,Perú,604,26,27,,53,"(10.886611,-74.776708)"
2014,Junio,Perú,604,4,2,,6,"(12.586067,-81.702563)"
2014,Junio,Perú,604,369,417,,786,"(3.541112,-76.384584)"
2014,Junio,Perú,604,4154,4917,,9071,"(4.697144,-74.140516)"
2014,Junio,Perú,604,5,10,,15,"(4.815061,-75.736532)"
2014,Junio,Perú,604,519,536,,1055,"(6.171601,-75.427454)"
2014,Junio,Perú,604,5,3,,8,"(7.128456,-73.183637)"
2014,Junio,Perú,604,2,1,,3,"(7.927209,-72.507910)"
2014,Junio,Palestina,99999,2,0,,2,"(4.697144,-74.140516)"
2014,Junio,Polonia,616,32,32,,64,"(4.697144,-74.140516)"
2014,Junio,Portugal,620,6,3,,9,"(3.541112,-76.384584)"
2014,Junio,Portugal,620,34,26,,60,"(4.697144,-74.140516)"
2014,Junio,Portugal,620,3,1,,4,"(6.171601,-75.427454)"
2014,Junio,Puerto Rico/Territorio de Estados Unidos,630,2,5,,7,"(10.445761,-75.516429)"
2014,Junio,Puerto Rico/Territorio de Estados Unidos,630,14,6,,20,"(10.886611,-74.776708)"
2014,Junio,Puerto Rico/Territorio de Estados Unidos,630,15,14,,29,"(3.541112,-76.384584)"
2014,Junio,Puerto Rico/Territorio de Estados Unidos,630,1,0,,1,"(4.452882,-75.766298)"
2014,Junio,Puerto Rico/Territorio de Estados Unidos,630,454,392,,846,"(4.697144,-74.140516)"
2014,Junio,Puerto Rico/Territorio de Estados Unidos,630,10,4,,14,"(4.815061,-75.736532)"
2014,Junio,Puerto Rico/Territorio de Estados Unidos,630,38,24,,62,"(6.171601,-75.427454)"
2014,Junio,Puerto Rico/Territorio de Estados Unidos,630,7,2,,9,"(7.128456,-73.183637)"
2014,Junio,Qatar,634,5,6,,11,"(4.697144,-74.140516)"
2014,Junio,Qatar,634,1,0,,1,"(6.171601,-75.427454)"
2014,Junio,Reino Unido de Gran Bretaña e Irlanda del Norte,826,5,2,,7,"(10.445761,-75.516429)"
2014,Junio,Reino Unido de Gran Bretaña e Irlanda del Norte,826,1,0,,1,"(10.886611,-74.776708)"
2014,Junio,Reino Unido de Gran Bretaña e Irlanda del Norte,826,23,27,,50,"(3.541112,-76.384584)"
2014,Junio,Reino Unido de Gran Bretaña e Irlanda del Norte,826,980,643,,1623,"(4.697144,-74.140516)"
2014,Junio,Reino Unido de Gran Bretaña e Irlanda del Norte,826,39,31,,70,"(6.171601,-75.427454)"
2014,Junio,República CentroÁfricana,140,2,2,,4,"(4.697144,-74.140516)"
2014,Junio,Federación de Rusia,643,1,1,,2,"(10.886611,-74.776708)"
2014,Junio,Federación de Rusia,643,77,84,,161,"(4.697144,-74.140516)"
2014,Junio,Federación de Rusia,643,0,1,,1,"(6.171601,-75.427454)"
2014,Junio,Federación de Rusia,643,2,0,,2,"(7.818934,-72.453226)"
2014,Junio,República Dominicana,214,6,11,,17,"(10.445761,-75.516429)"
2014,Junio,República Dominicana,214,20,37,,57,"(10.886611,-74.776708)"
2014,Junio,República Dominicana,214,3,1,,4,"(12.586067,-81.702563)"
2014,Junio,República Dominicana,214,115,129,,244,"(3.541112,-76.384584)"
2014,Junio,República Dominicana,214,2473,2398,,4871,"(4.697144,-74.140516)"
2014,Junio,República Dominicana,214,23,17,,40,"(4.815061,-75.736532)"
2014,Junio,República Dominicana,214,287,205,,492,"(6.171601,-75.427454)"
2014,Junio,República Dominicana,214,3,4,,7,"(7.128456,-73.183637)"
2014,Junio,República Dominicana,214,6,6,,12,"(7.927209,-72.507910)"
2014,Junio,Reunión,638,0,1,,1,"(6.171601,-75.427454)"
2014,Junio,República Democrática Popular de Corea,408,1,2,,3,"(4.697144,-74.140516)"
2014,Junio,Rumania,642,10,10,,20,"(4.697144,-74.140516)"
2014,Junio,Samoa Estadounidense/Territorio no incorporado de Estados Unidos,16,1,0,,1,"(4.697144,-74.140516)"
2014,Junio,San Marino,674,1,0,,1,"(6.171601,-75.427454)"
2014,Junio,Santo Tomé y Príncipe,678,1,0,,1,"(4.697144,-74.140516)"
2014,Junio,Senegal,686,0,1,,1,"(4.697144,-74.140516)"
2014,Junio,Singapur,702,1,0,,1,"(10.886611,-74.776708)"
2014,Junio,Singapur,702,19,15,,34,"(4.697144,-74.140516)"
2014,Junio,Singapur,702,1,0,,1,"(6.171601,-75.427454)"
2014,Junio,Sudáfrica,710,32,40,,72,"(4.697144,-74.140516)"
2014,Junio,Suecia,752,2,2,,4,"(10.445761,-75.516429)"
2014,Junio,Suecia,752,0,1,,1,"(10.886611,-74.776708)"
2014,Junio,Suecia,752,8,2,,10,"(3.541112,-76.384584)"
2014,Junio,Suecia,752,97,58,,155,"(4.697144,-74.140516)"
2014,Junio,Suecia,752,3,1,,4,"(6.171601,-75.427454)"
2014,Junio,Suiza,756,1,2,,3,"(10.445761,-75.516429)"
2014,Junio,Suiza,756,2,1,,3,"(10.886611,-74.776708)"
2014,Junio,Suiza,756,12,3,,15,"(3.541112,-76.384584)"
2014,Junio,Suiza,756,271,210,,481,"(4.697144,-74.140516)"
2014,Junio,Suiza,756,21,8,,29,"(6.171601,-75.427454)"
2014,Junio,Surinam,740,2,5,,7,"(10.886611,-74.776708)"
2014,Junio,Surinam,740,4,7,,11,"(4.697144,-74.140516)"
2014,Junio,Surinam,740,1,0,,1,"(6.171601,-75.427454)"
2014,Junio,Taiwán,158,2,15,,17,"(4.697144,-74.140516)"
2014,Junio,Tailandia,764,1,0,,1,"(10.886611,-74.776708)"
2014,Junio,Tailandia,764,1,0,,1,"(3.541112,-76.384584)"
2014,Junio,Tailandia,764,25,29,,54,"(4.697144,-74.140516)"
2014,Junio,Tanzania,834,1,1,,2,"(4.697144,-74.140516)"
2014,Junio,Trinidad y Tobago,780,4,4,,8,"(10.445761,-75.516429)"
2014,Junio,Trinidad y Tobago,780,1,2,,3,"(10.886611,-74.776708)"
2014,Junio,Trinidad y Tobago,780,7,8,,15,"(3.541112,-76.384584)"
2014,Junio,Trinidad y Tobago,780,20,35,,55,"(4.697144,-74.140516)"
2014,Junio,Trinidad y Tobago,780,1,1,,2,"(4.815061,-75.736532)"
2014,Junio,Trinidad y Tobago,780,9,8,,17,"(6.171601,-75.427454)"
2014,Junio,Trinidad y Tobago,780,3,2,,5,"(7.128456,-73.183637)"
2014,Junio,Túnez,788,2,2,,4,"(4.697144,-74.140516)"
2014,Junio,Turquía,792,0,1,,1,"(10.886611,-74.776708)"
2014,Junio,Turquía,792,2,0,,2,"(3.541112,-76.384584)"
2014,Junio,Turquía,792,137,94,,231,"(4.697144,-74.140516)"
2014,Junio,Turquía,792,0,1,,1,"(4.815061,-75.736532)"
2014,Junio,Turquía,792,2,1,,3,"(6.171601,-75.427454)"
2014,Junio,Ucrania,804,3,6,,9,"(4.697144,-74.140516)"
2014,Junio,Uganda,800,2,0,,2,"(4.697144,-74.140516)"
2014,Junio,Uruguay,858,1,3,,4,"(10.445761,-75.516429)"
2014,Junio,Uruguay,858,2,0,,2,"(10.886611,-74.776708)"
2014,Junio,Uruguay,858,7,11,,18,"(3.541112,-76.384584)"
2014,Junio,Uruguay,858,52,79,,131,"(4.697144,-74.140516)"
2014,Junio,Uruguay,858,13,15,,28,"(6.171601,-75.427454)"
2014,Junio,Venezuela,862,6,6,,12,"(10.445761,-75.516429)"
2014,Junio,Venezuela,862,4,11,,15,"(10.886611,-74.776708)"
2014,Junio,Venezuela,862,12686,9969,,22655,"(11.360009,-72.129330)"
2014,Junio,Venezuela,862,0,1,,1,"(12.586067,-81.702563)"
2014,Junio,Venezuela,862,11,12,,23,"(3.541112,-76.384584)"
2014,Junio,Venezuela,862,1186,1697,,2883,"(4.697144,-74.140516)"
2014,Junio,Venezuela,862,2,3,,5,"(4.815061,-75.736532)"
2014,Junio,Venezuela,862,75,90,,165,"(6.171601,-75.427454)"
2014,Junio,Venezuela,862,206,213,,419,"(6.185799,-67.483929)"
2014,Junio,Venezuela,862,2746,2360,,5106,"(7.088729,-70.740253)"
2014,Junio,Venezuela,862,4,8,,12,"(7.128456,-73.183637)"
2014,Junio,Venezuela,862,9965,8628,,18593,"(7.818934,-72.453226)"
2014,Junio,Venezuela,862,125,92,,217,"(7.927209,-72.507910)"
2014,Junio,Vietnam,704,1,0,,1,"(3.541112,-76.384584)"
2014,Junio,Vietnam,704,6,4,,10,"(4.697144,-74.140516)"
2014,Junio,Islas Vírgenes Estadounidenses/Territorio de Estados Unidos,850,0,1,,1,"(10.445761,-75.516429)"
2014,Junio,Islas Vírgenes Estadounidenses/Territorio de Estados Unidos,850,0,1,,1,"(4.697144,-74.140516)"
2014,Junio,República Árabe de Yemen,887,1,0,,1,"(4.697144,-74.140516)"
2014,Junio,Islas Turcas y Caicos/Territorio Británico de Ultramar,796,0,1,,1,"(4.697144,-74.140516)"
2014,Junio,Desconocido,99999,87,78,,165,"(4.697144,-74.140516)"
2014,Junio,Desconocido,99999,10,19,,29,"(8.635765,-77.346578)"
2014,Julio,Afganistán,4,0,7,,7,"(4.697144,-74.140516)"
2014,Julio,Alemania,276,1,1,,2,"(0.814836,-77.662532)"
2014,Julio,Alemania,276,1,3,,4,"(10.445761,-75.516429)"
2014,Julio,Alemania,276,15,1,,16,"(10.886611,-74.776708)"
2014,Julio,Alemania,276,14,7,,21,"(3.541112,-76.384584)"
2014,Julio,Alemania,276,1491,1327,,2818,"(4.697144,-74.140516)"
2014,Julio,Alemania,276,22,17,,39,"(6.171601,-75.427454)"
2014,Julio,Andorra,20,2,0,,2,"(4.697144,-74.140516)"
2014,Julio,Angola,24,1,16,,17,"(4.697144,-74.140516)"
2014,Julio,Antigua y Barbuda,28,3,2,,5,"(4.697144,-74.140516)"
2014,Julio,Países Bajos,528,49,31,,80,"(10.408582,-75.538003)"
2014,Julio,Países Bajos,528,4,4,,8,"(10.445761,-75.516429)"
2014,Julio,Países Bajos,528,2,1,,3,"(10.886611,-74.776708)"
2014,Julio,Países Bajos,528,26,11,,37,"(3.541112,-76.384584)"
2014,Julio,Países Bajos,528,180,153,,333,"(4.697144,-74.140516)"
2014,Julio,Países Bajos,528,2,0,,2,"(4.815061,-75.736532)"
2014,Julio,Países Bajos,528,40,32,,72,"(6.171601,-75.427454)"
2014,Julio,Países Bajos,528,3,3,,6,"(7.128456,-73.183637)"
2014,Julio,Países Bajos,528,0,1,,1,"(7.927209,-72.507910)"
2014,Julio,Arabia Saudita,682,3,0,,3,"(10.445761,-75.516429)"
2014,Julio,Arabia Saudita,682,0,1,,1,"(10.886611,-74.776708)"
2014,Julio,Arabia Saudita,682,7,39,,46,"(4.697144,-74.140516)"
2014,Julio,Arabia Saudita,682,0,1,,1,"(6.171601,-75.427454)"
2014,Julio,Argelia,12,0,1,,1,"(10.886611,-74.776708)"
2014,Julio,Argelia,12,3,1,,4,"(4.697144,-74.140516)"
2014,Julio,Argentina,32,22,45,,67,"(0.814836,-77.662532)"
2014,Julio,Argentina,32,16,14,,30,"(10.445761,-75.516429)"
2014,Julio,Argentina,32,29,25,,54,"(10.886611,-74.776708)"
2014,Julio,Argentina,32,1,0,,1,"(12.586067,-81.702563)"
2014,Julio,Argentina,32,177,169,,346,"(3.541112,-76.384584)"
2014,Julio,Argentina,32,2157,2375,,4532,"(4.697144,-74.140516)"
2014,Julio,Argentina,32,11,9,,20,"(4.815061,-75.736532)"
2014,Julio,Argentina,32,165,172,,337,"(6.171601,-75.427454)"
2014,Julio,Argentina,32,6,33,,39,"(7.128456,-73.183637)"
2014,Julio,Argentina,32,3,4,,7,"(7.927209,-72.507910)"
2014,Julio,República de Armenia,51,0,1,,1,"(4.697144,-74.140516)"
2014,Julio,Aruba,533,1326,984,,2310,"(10.408582,-75.538003)"
2014,Julio,Aruba,533,1,0,,1,"(10.445761,-75.516429)"
2014,Julio,Aruba,533,6,5,,11,"(10.886611,-74.776708)"
2014,Julio,Aruba,533,40,22,,62,"(3.541112,-76.384584)"
2014,Julio,Aruba,533,1668,1295,,2963,"(4.697144,-74.140516)"
2014,Julio,Aruba,533,7,3,,10,"(4.815061,-75.736532)"
2014,Julio,Aruba,533,59,38,,97,"(6.171601,-75.427454)"
2014,Julio,Aruba,533,7,11,,18,"(7.128456,-73.183637)"
2014,Julio,Australia,36,1,2,,3,"(10.445761,-75.516429)"
2014,Julio,Australia,36,3,0,,3,"(10.886611,-74.776708)"
2014,Julio,Australia,36,13,6,,19,"(3.541112,-76.384584)"
2014,Julio,Australia,36,180,165,,345,"(4.697144,-74.140516)"
2014,Julio,Australia,36,0,2,,2,"(4.815061,-75.736532)"
2014,Julio,Australia,36,37,31,,68,"(6.171601,-75.427454)"
2014,Julio,Australia,36,1,2,,3,"(7.128456,-73.183637)"
2014,Julio,Austria,40,1,0,,1,"(3.541112,-76.384584)"
2014,Julio,Austria,40,48,40,,88,"(4.697144,-74.140516)"
2014,Julio,Austria,40,1,0,,1,"(6.171601,-75.427454)"
2014,Julio,Azerbaiyán,31,4,5,,9,"(4.697144,-74.140516)"
2014,Julio,Bahamas,44,0,1,,1,"(10.445761,-75.516429)"
2014,Julio,Bahamas,44,3,4,,7,"(10.886611,-74.776708)"
2014,Julio,Bahamas,44,12,4,,16,"(3.541112,-76.384584)"
2014,Julio,Bahamas,44,30,33,,63,"(4.697144,-74.140516)"
2014,Julio,Bahamas,44,3,2,,5,"(4.815061,-75.736532)"
2014,Julio,Bahamas,44,17,14,,31,"(6.171601,-75.427454)"
2014,Julio,Bahamas,44,1,1,,2,"(7.927209,-72.507910)"
2014,Julio,Bahréin,48,1,1,,2,"(4.697144,-74.140516)"
2014,Julio,Bahréin,48,0,1,,1,"(6.171601,-75.427454)"
2014,Julio,Bangladesh,50,0,1,,1,"(4.697144,-74.140516)"
2014,Julio,Barbados,52,0,1,,1,"(4.697144,-74.140516)"
2014,Julio,República de Belarús,112,3,2,,5,"(11.360009,-72.129330)"
2014,Julio,República de Belarús,112,0,1,,1,"(4.697144,-74.140516)"
2014,Julio,Bélgica,56,1,1,,2,"(10.886611,-74.776708)"
2014,Julio,Bélgica,56,2,4,,6,"(3.541112,-76.384584)"
2014,Julio,Bélgica,56,114,98,,212,"(4.697144,-74.140516)"
2014,Julio,Bélgica,56,19,14,,33,"(6.171601,-75.427454)"
2014,Julio,Belice,84,0,1,,1,"(10.445761,-75.516429)"
2014,Julio,Belice,84,2,4,,6,"(4.697144,-74.140516)"
2014,Julio,Bermudas/Territorio Británico de Ultramar,60,1,0,,1,"(10.445761,-75.516429)"
2014,Julio,Bermudas/Territorio Británico de Ultramar,60,2,2,,4,"(4.697144,-74.140516)"
2014,Julio,Bermudas/Territorio Británico de Ultramar,60,3,0,,3,"(6.171601,-75.427454)"
2014,Julio,Bolivia,68,4,10,,14,"(0.814836,-77.662532)"
2014,Julio,Bolivia,68,0,2,,2,"(10.886611,-74.776708)"
2014,Julio,Bolivia,68,27,29,,56,"(3.541112,-76.384584)"
2014,Julio,Bolivia,68,249,427,,676,"(4.697144,-74.140516)"
2014,Julio,Bolivia,68,27,26,,53,"(6.171601,-75.427454)"
2014,Julio,Brasil,76,99,182,,281,"(-4.197703,-69.941278)"
2014,Julio,Brasil,76,1,1,,2,"(-4.223468,-69.945098)"
2014,Julio,Brasil,76,4,4,,8,"(0.814836,-77.662532)"
2014,Julio,Brasil,76,3,14,,17,"(10.445761,-75.516429)"
2014,Julio,Brasil,76,9,34,,43,"(10.886611,-74.776708)"
2014,Julio,Brasil,76,2,3,,5,"(12.586067,-81.702563)"
2014,Julio,Brasil,76,37,75,,112,"(3.541112,-76.384584)"
2014,Julio,Brasil,76,2728,3959,,6687,"(4.697144,-74.140516)"
2014,Julio,Brasil,76,4,9,,13,"(4.815061,-75.736532)"
2014,Julio,Brasil,76,86,158,,244,"(6.171601,-75.427454)"
2014,Julio,Brasil,76,1,9,,10,"(7.128456,-73.183637)"
2014,Julio,Brasil,76,0,2,,2,"(7.927209,-72.507910)"
2014,Julio,Brunei Darussalam,96,1,0,,1,"(4.697144,-74.140516)"
2014,Julio,Bulgaria,100,2,1,,3,"(4.697144,-74.140516)"
2014,Julio,Cabo Verde,132,2,0,,2,"(4.697144,-74.140516)"
2014,Julio,Islas Caimán/Territorio Británico de Ultramar,136,1,0,,1,"(10.886611,-74.776708)"
2014,Julio,Islas Caimán/Territorio Británico de Ultramar,136,6,2,,8,"(12.586067,-81.702563)"
2014,Julio,Islas Caimán/Territorio Británico de Ultramar,136,1,0,,1,"(3.541112,-76.384584)"
2014,Julio,Islas Caimán/Territorio Británico de Ultramar,136,1,3,,4,"(4.697144,-74.140516)"
2014,Julio,Islas Caimán/Territorio Británico de Ultramar,136,1,0,,1,"(6.171601,-75.427454)"
2014,Julio,Camerún,120,2,4,,6,"(4.697144,-74.140516)"
2014,Julio,Canadá,124,44,32,,76,"(10.445761,-75.516429)"
2014,Julio,Canadá,124,51,41,,92,"(10.886611,-74.776708)"
2014,Julio,Canadá,124,1,1,,2,"(12.586067,-81.702563)"
2014,Julio,Canadá,124,112,105,,217,"(3.541112,-76.384584)"
2014,Julio,Canadá,124,3,1,,4,"(4.452882,-75.766298)"
2014,Julio,Canadá,124,1873,1537,,3410,"(4.697144,-74.140516)"
2014,Julio,Canadá,124,21,20,,41,"(4.815061,-75.736532)"
2014,Julio,Canadá,124,233,201,,434,"(6.171601,-75.427454)"
2014,Julio,Canadá,124,9,4,,13,"(7.128456,-73.183637)"
2014,Julio,Canadá,124,3,4,,7,"(7.927209,-72.507910)"
2014,Julio,Chad,148,0,1,,1,"(4.697144,-74.140516)"
2014,Julio,España,724,12,13,,25,"(10.445761,-75.516429)"
2014,Julio,España,724,2,4,,6,"(10.886611,-74.776708)"
2014,Julio,España,724,1,4,,5,"(12.586067,-81.702563)"
2014,Julio,España,724,1426,809,,2235,"(3.541112,-76.384584)"
2014,Julio,España,724,7421,5541,,12962,"(4.697144,-74.140516)"
2014,Julio,España,724,1,1,,2,"(4.815061,-75.736532)"
2014,Julio,España,724,827,571,,1398,"(6.171601,-75.427454)"
2014,Julio,España,724,0,1,,1,"(7.128456,-73.183637)"
2014,Julio,República Democrática del Congo,180,1,5,,6,"(4.697144,-74.140516)"
2014,Julio,República de Corea,410,0,3,,3,"(3.541112,-76.384584)"
2014,Julio,República de Corea,410,18,37,,55,"(4.697144,-74.140516)"
2014,Julio,República de Corea,410,2,0,,2,"(6.171601,-75.427454)"
2014,Julio,Costa de Marfil,384,1,0,,1,"(3.541112,-76.384584)"
2014,Julio,Costa de Marfil,384,2,5,,7,"(4.697144,-74.140516)"
2014,Julio,Costa de Marfil,384,1,0,,1,"(6.171601,-75.427454)"
2014,Julio,Costa Rica,188,10,20,,30,"(10.445761,-75.516429)"
2014,Julio,Costa Rica,188,20,26,,46,"(10.886611,-74.776708)"
2014,Julio,Costa Rica,188,3,3,,6,"(12.586067,-81.702563)"
2014,Julio,Costa Rica,188,1,8,,9,"(13.3387613,-81.372937)"
2014,Julio,Costa Rica,188,31,38,,69,"(3.541112,-76.384584)"
2014,Julio,Costa Rica,188,716,835,,1551,"(4.697144,-74.140516)"
2014,Julio,Costa Rica,188,10,7,,17,"(4.815061,-75.736532)"
2014,Julio,Costa Rica,188,99,106,,205,"(6.171601,-75.427454)"
2014,Julio,Costa Rica,188,5,8,,13,"(7.128456,-73.183637)"
2014,Julio,Costa Rica,188,3,5,,8,"(7.927209,-72.507910)"
2014,Julio,Croacia,191,1,0,,1,"(4.697144,-74.140516)"
2014,Julio,Cuba,192,21,14,,35,"(10.445761,-75.516429)"
2014,Julio,Cuba,192,27,20,,47,"(10.886611,-74.776708)"
2014,Julio,Cuba,192,5,5,,10,"(12.586067,-81.702563)"
2014,Julio,Cuba,192,97,74,,171,"(3.541112,-76.384584)"
2014,Julio,Cuba,192,1085,843,,1928,"(4.697144,-74.140516)"
2014,Julio,Cuba,192,6,5,,11,"(4.815061,-75.736532)"
2014,Julio,Cuba,192,117,90,,207,"(6.171601,-75.427454)"
2014,Julio,Cuba,192,26,22,,48,"(7.128456,-73.183637)"
2014,Julio,Cuba,192,4,4,,8,"(7.927209,-72.507910)"
2014,Julio,Curazao,99999,74,38,,112,"(10.886611,-74.776708)"
2014,Julio,Curazao,99999,0,1,,1,"(11.247723,-74.213989)"
2014,Julio,Curazao,99999,6,1,,7,"(3.541112,-76.384584)"
2014,Julio,Curazao,99999,449,400,,849,"(4.697144,-74.140516)"
2014,Julio,Curazao,99999,84,50,,134,"(6.171601,-75.427454)"
2014,Julio,República Checa,203,1,1,,2,"(10.445761,-75.516429)"
2014,Julio,República Checa,203,8,4,,12,"(4.697144,-74.140516)"
2014,Julio,Chile,152,88,106,,194,"(0.814836,-77.662532)"
2014,Julio,Chile,152,5,6,,11,"(10.445761,-75.516429)"
2014,Julio,Chile,152,13,10,,23,"(10.886611,-74.776708)"
2014,Julio,Chile,152,3,3,,6,"(12.586067,-81.702563)"
2014,Julio,Chile,152,325,244,,569,"(3.541112,-76.384584)"
2014,Julio,Chile,152,2777,2522,,5299,"(4.697144,-74.140516)"
2014,Julio,Chile,152,42,37,,79,"(4.815061,-75.736532)"
2014,Julio,Chile,152,79,79,,158,"(6.171601,-75.427454)"
2014,Julio,Chile,152,3,4,,7,"(7.128456,-73.183637)"
2014,Julio,Chile,152,4,7,,11,"(7.927209,-72.507910)"
2014,Julio,China,156,1,1,,2,"(10.445761,-75.516429)"
2014,Julio,China,156,4,12,,16,"(3.541112,-76.384584)"
2014,Julio,China,156,174,446,,620,"(4.697144,-74.140516)"
2014,Julio,China,156,1,0,,1,"(4.815061,-75.736532)"
2014,Julio,China,156,11,28,,39,"(6.171601,-75.427454)"
2014,Julio,China,156,1,2,,3,"(7.128456,-73.183637)"
2014,Julio,Chipre,196,0,1,,1,"(4.697144,-74.140516)"
2014,Julio,Dinamarca,208,37,26,,63,"(4.697144,-74.140516)"
2014,Julio,Dinamarca,208,2,1,,3,"(6.171601,-75.427454)"
2014,Julio,Dominica,212,2,0,,2,"(3.541112,-76.384584)"
2014,Julio,Ecuador,218,757,771,,1528,"(0.25129,-76.875963)"
2014,Julio,Ecuador,218,11525,10824,,22349,"(0.814836,-77.662532)"
2014,Julio,Ecuador,218,263,199,,462,"(1.813928,-78.763924)"
2014,Julio,Ecuador,218,4,4,,8,"(10.445761,-75.516429)"
2014,Julio,Ecuador,218,6,13,,19,"(10.886611,-74.776708)"
2014,Julio,Ecuador,218,0,1,,1,"(12.586067,-81.702563)"
2014,Julio,Ecuador,218,787,737,,1524,"(3.541112,-76.384584)"
2014,Julio,Ecuador,218,2429,4105,,6534,"(4.697144,-74.140516)"
2014,Julio,Ecuador,218,2,3,,5,"(4.815061,-75.736532)"
2014,Julio,Ecuador,218,385,325,,710,"(6.171601,-75.427454)"
2014,Julio,Egipto,818,30,30,,60,"(4.697144,-74.140516)"
2014,Julio,Egipto,818,2,0,,2,"(6.171601,-75.427454)"
2014,Julio,El Salvador,222,0,1,,1,"(10.445761,-75.516429)"
2014,Julio,El Salvador,222,1,4,,5,"(10.886611,-74.776708)"
2014,Julio,El Salvador,222,185,124,,309,"(3.541112,-76.384584)"
2014,Julio,El Salvador,222,899,1037,,1936,"(4.697144,-74.140516)"
2014,Julio,El Salvador,222,2,0,,2,"(4.815061,-75.736532)"
2014,Julio,El Salvador,222,81,89,,170,"(6.171601,-75.427454)"
2014,Julio,El Salvador,222,3,0,,3,"(7.927209,-72.507910)"
2014,Julio,Emiratos Árabes,784,0,1,,1,"(10.886611,-74.776708)"
2014,Julio,Emiratos Árabes,784,0,1,,1,"(3.541112,-76.384584)"
2014,Julio,Emiratos Árabes,784,72,196,,268,"(4.697144,-74.140516)"
2014,Julio,Emiratos Árabes,784,1,2,,3,"(6.171601,-75.427454)"
2014,Julio,Eritrea,232,1,1,,2,"(4.697144,-74.140516)"
2014,Julio,Eslovaquia,703,0,2,,2,"(4.697144,-74.140516)"
2014,Julio,Eslovenia,705,0,1,,1,"(4.697144,-74.140516)"
2014,Julio,Estados Unidos de América,840,4,1,,5,"(0.814836,-77.662532)"
2014,Julio,Estados Unidos de América,840,3051,2521,,5572,"(10.445761,-75.516429)"
2014,Julio,Estados Unidos de América,840,2638,2081,,4719,"(10.886611,-74.776708)"
2014,Julio,Estados Unidos de América,840,55,55,,110,"(12.586067,-81.702563)"
2014,Julio,Estados Unidos de América,840,7411,5227,,12638,"(3.541112,-76.384584)"
2014,Julio,Estados Unidos de América,840,468,318,,786,"(4.452882,-75.766298)"
2014,Julio,Estados Unidos de América,840,38631,33547,,72178,"(4.697144,-74.140516)"
2014,Julio,Estados Unidos de América,840,985,694,,1679,"(4.815061,-75.736532)"
2014,Julio,Estados Unidos de América,840,9322,7257,,16579,"(6.171601,-75.427454)"
2014,Julio,Estados Unidos de América,840,259,169,,428,"(7.128456,-73.183637)"
2014,Julio,Estados Unidos de América,840,160,133,,293,"(7.927209,-72.507910)"
2014,Julio,Estonia,233,1,0,,1,"(4.697144,-74.140516)"
2014,Julio,Etiopia,231,1,6,,7,"(4.697144,-74.140516)"
2014,Julio,Islas Fiji,242,1,0,,1,"(4.697144,-74.140516)"
2014,Julio,Filipinas,608,2,0,,2,"(3.541112,-76.384584)"
2014,Julio,Filipinas,608,4,6,,10,"(4.697144,-74.140516)"
2014,Julio,Finlandia,246,0,1,,1,"(10.886611,-74.776708)"
2014,Julio,Finlandia,246,13,7,,20,"(4.697144,-74.140516)"
2014,Julio,Finlandia,246,1,1,,2,"(6.171601,-75.427454)"
2014,Julio,Francia,250,2,0,,2,"(10.445761,-75.516429)"
2014,Julio,Francia,250,6,5,,11,"(10.886611,-74.776708)"
2014,Julio,Francia,250,27,21,,48,"(3.541112,-76.384584)"
2014,Julio,Francia,250,1695,1357,,3052,"(4.697144,-74.140516)"
2014,Julio,Francia,250,1,0,,1,"(4.815061,-75.736532)"
2014,Julio,Francia,250,52,34,,86,"(6.171601,-75.427454)"
2014,Julio,Gabón,266,1,3,,4,"(4.697144,-74.140516)"
2014,Julio,Ghana,288,0,1,,1,"(4.697144,-74.140516)"
2014,Julio,Ghana,288,0,2,,2,"(6.171601,-75.427454)"
2014,Julio,Grecia,300,26,19,,45,"(4.697144,-74.140516)"
2014,Julio,Grecia,300,1,0,,1,"(6.171601,-75.427454)"
2014,Julio,Guatemala,320,4,5,,9,"(10.445761,-75.516429)"
2014,Julio,Guatemala,320,23,19,,42,"(10.886611,-74.776708)"
2014,Julio,Guatemala,320,3,2,,5,"(12.586067,-81.702563)"
2014,Julio,Guatemala,320,39,61,,100,"(3.541112,-76.384584)"
2014,Julio,Guatemala,320,369,510,,879,"(4.697144,-74.140516)"
2014,Julio,Guatemala,320,4,7,,11,"(4.815061,-75.736532)"
2014,Julio,Guatemala,320,56,76,,132,"(6.171601,-75.427454)"
2014,Julio,Guatemala,320,4,7,,11,"(7.128456,-73.183637)"
2014,Julio,Guatemala,320,34,52,,86,"(7.927209,-72.507910)"
2014,Julio,Guyana,328,3,2,,5,"(4.697144,-74.140516)"
2014,Julio,Guinea,324,0,1,,1,"(4.697144,-74.140516)"
2014,Julio,Guinea Ecuatorial,226,6,8,,14,"(4.697144,-74.140516)"
2014,Julio,Guadalupe/Territorio Francés,312,1,3,,4,"(4.697144,-74.140516)"
2014,Julio,Guadalupe/Territorio Francés,312,0,1,,1,"(6.171601,-75.427454)"
2014,Julio,Guayana Francesa/Departamento de Ultramar Francés,254,0,1,,1,"(10.886611,-74.776708)"
2014,Julio,Haití,332,0,6,,6,"(10.886611,-74.776708)"
2014,Julio,Haití,332,0,1,,1,"(3.541112,-76.384584)"
2014,Julio,Haití,332,0,32,,32,"(4.697144,-74.140516)"
2014,Julio,Haití,332,1,2,,3,"(4.815061,-75.736532)"
2014,Julio,Haití,332,1,4,,5,"(6.171601,-75.427454)"
2014,Julio,Honduras,340,2,3,,5,"(10.445761,-75.516429)"
2014,Julio,Honduras,340,4,11,,15,"(10.886611,-74.776708)"
2014,Julio,Honduras,340,1,7,,8,"(12.586067,-81.702563)"
2014,Julio,Honduras,340,10,27,,37,"(3.541112,-76.384584)"
2014,Julio,Honduras,340,85,158,,243,"(4.697144,-74.140516)"
2014,Julio,Honduras,340,3,1,,4,"(4.815061,-75.736532)"
2014,Julio,Honduras,340,29,34,,63,"(6.171601,-75.427454)"
2014,Julio,Honduras,340,1,4,,5,"(7.128456,-73.183637)"
2014,Julio,Honduras,340,0,2,,2,"(7.927209,-72.507910)"
2014,Julio,Hong Kong,344,0,1,,1,"(10.445761,-75.516429)"
2014,Julio,Hong Kong,344,24,54,,78,"(4.697144,-74.140516)"
2014,Julio,Hong Kong,344,1,1,,2,"(6.171601,-75.427454)"
2014,Julio,Hungría,348,1,1,,2,"(4.697144,-74.140516)"
2014,Julio,Hungría,348,0,1,,1,"(6.171601,-75.427454)"
2014,Julio,India,356,0,1,,1,"(10.445761,-75.516429)"
2014,Julio,India,356,1,0,,1,"(10.886611,-74.776708)"
2014,Julio,India,356,26,18,,44,"(4.697144,-74.140516)"
2014,Julio,India,356,1,1,,2,"(6.171601,-75.427454)"
2014,Julio,Indonesia,360,5,10,,15,"(4.697144,-74.140516)"
2014,Julio,Indonesia,360,1,0,,1,"(6.171601,-75.427454)"
2014,Julio,Iraq,368,1,7,,8,"(4.697144,-74.140516)"
2014,Julio,Iraq,368,1,0,,1,"(6.171601,-75.427454)"
2014,Julio,Irán,364,2,3,,5,"(4.697144,-74.140516)"
2014,Julio,República de Irlanda,372,29,11,,40,"(4.697144,-74.140516)"
2014,Julio,Islandia,352,1,0,,1,"(10.886611,-74.776708)"
2014,Julio,Israel,376,1,0,,1,"(10.445761,-75.516429)"
2014,Julio,Israel,376,5,3,,8,"(3.541112,-76.384584)"
2014,Julio,Israel,376,105,90,,195,"(4.697144,-74.140516)"
2014,Julio,Israel,376,5,3,,8,"(6.171601,-75.427454)"
2014,Julio,Italia,380,4,0,,4,"(10.445761,-75.516429)"
2014,Julio,Italia,380,4,2,,6,"(10.886611,-74.776708)"
2014,Julio,Italia,380,0,1,,1,"(12.586067,-81.702563)"
2014,Julio,Italia,380,43,27,,70,"(3.541112,-76.384584)"
2014,Julio,Italia,380,719,497,,1216,"(4.697144,-74.140516)"
2014,Julio,Italia,380,51,29,,80,"(6.171601,-75.427454)"
2014,Julio,Jamaica,388,2,10,,12,"(10.445761,-75.516429)"
2014,Julio,Jamaica,388,4,7,,11,"(10.886611,-74.776708)"
2014,Julio,Jamaica,388,16,7,,23,"(12.586067,-81.702563)"
2014,Julio,Jamaica,388,31,20,,51,"(3.541112,-76.384584)"
2014,Julio,Jamaica,388,58,66,,124,"(4.697144,-74.140516)"
2014,Julio,Jamaica,388,3,4,,7,"(4.815061,-75.736532)"
2014,Julio,Jamaica,388,10,14,,24,"(6.171601,-75.427454)"
2014,Julio,Jamaica,388,4,5,,9,"(7.128456,-73.183637)"
2014,Julio,Jamaica,388,1,1,,2,"(7.927209,-72.507910)"
2014,Julio,Japón,392,1,1,,2,"(3.541112,-76.384584)"
2014,Julio,Japón,392,60,59,,119,"(4.697144,-74.140516)"
2014,Julio,Japón,392,3,2,,5,"(6.171601,-75.427454)"
2014,Julio,Japón,392,1,0,,1,"(7.927209,-72.507910)"
2014,Julio,Jordania,400,0,2,,2,"(3.541112,-76.384584)"
2014,Julio,Jordania,400,5,10,,15,"(4.697144,-74.140516)"
2014,Julio,Kazajistán,398,1,3,,4,"(4.697144,-74.140516)"
2014,Julio,Kenia,404,1,4,,5,"(4.697144,-74.140516)"
2014,Julio,Kuwait,414,2,2,,4,"(4.697144,-74.140516)"
2014,Julio,Letonia,428,24,6,,30,"(4.697144,-74.140516)"
2014,Julio,Lituania,440,0,4,,4,"(4.697144,-74.140516)"
2014,Julio,Líbano,422,0,3,,3,"(10.408582,-75.538003)"
2014,Julio,Líbano,422,3,1,,4,"(10.886611,-74.776708)"
2014,Julio,Líbano,422,0,1,,1,"(3.541112,-76.384584)"
2014,Julio,Líbano,422,31,48,,79,"(4.697144,-74.140516)"
2014,Julio,Líbano,422,0,1,,1,"(7.128456,-73.183637)"
2014,Julio,Liberia,430,1,0,,1,"(6.171601,-75.427454)"
2014,Julio,Luxemburgo,442,1,2,,3,"(4.697144,-74.140516)"
2014,Julio,Malasia,458,0,1,,1,"(3.541112,-76.384584)"
2014,Julio,Malasia,458,9,11,,20,"(4.697144,-74.140516)"
2014,Julio,Malasia,458,1,1,,2,"(6.171601,-75.427454)"
2014,Julio,Malí,466,1,0,,1,"(4.697144,-74.140516)"
2014,Julio,Malta,470,8,3,,11,"(4.697144,-74.140516)"
2014,Julio,Marruecos,504,3,1,,4,"(4.697144,-74.140516)"
2014,Julio,Mauritania,478,0,2,,2,"(4.697144,-74.140516)"
2014,Julio,México,484,45,27,,72,"(0.814836,-77.662532)"
2014,Julio,México,484,53,27,,80,"(10.445761,-75.516429)"
2014,Julio,México,484,136,99,,235,"(10.886611,-74.776708)"
2014,Julio,México,484,7,7,,14,"(12.586067,-81.702563)"
2014,Julio,México,484,576,500,,1076,"(3.541112,-76.384584)"
2014,Julio,México,484,9322,8773,,18095,"(4.697144,-74.140516)"
2014,Julio,México,484,67,56,,123,"(4.815061,-75.736532)"
2014,Julio,México,484,971,800,,1771,"(6.171601,-75.427454)"
2014,Julio,México,484,67,48,,115,"(7.128456,-73.183637)"
2014,Julio,México,484,92,77,,169,"(7.927209,-72.507910)"
2014,Julio,Mónaco,492,1,1,,2,"(4.697144,-74.140516)"
2014,Julio,Mónaco,492,1,1,,2,"(6.171601,-75.427454)"
2014,Julio,Montenegro,499,2,0,,2,"(4.697144,-74.140516)"
2014,Julio,Micronesia,583,0,1,,1,"(4.697144,-74.140516)"
2014,Julio,Mozambique,508,0,3,,3,"(4.697144,-74.140516)"
2014,Julio,Myanmar,104,1,1,,2,"(4.697144,-74.140516)"
2014,Julio,Nepal,524,1,1,,2,"(6.171601,-75.427454)"
2014,Julio,Nicaragua,558,4,10,,14,"(10.445761,-75.516429)"
2014,Julio,Nicaragua,558,3,8,,11,"(10.886611,-74.776708)"
2014,Julio,Nicaragua,558,2,1,,3,"(12.586067,-81.702563)"
2014,Julio,Nicaragua,558,10,10,,20,"(3.541112,-76.384584)"
2014,Julio,Nicaragua,558,26,48,,74,"(4.697144,-74.140516)"
2014,Julio,Nicaragua,558,3,5,,8,"(4.815061,-75.736532)"
2014,Julio,Nicaragua,558,12,24,,36,"(6.171601,-75.427454)"
2014,Julio,Nicaragua,558,1,1,,2,"(7.927209,-72.507910)"
2014,Julio,Nigeria,566,0,1,,1,"(10.445761,-75.516429)"
2014,Julio,Nigeria,566,0,9,,9,"(4.697144,-74.140516)"
2014,Julio,Níger,562,0,1,,1,"(10.886611,-74.776708)"
2014,Julio,Noruega,578,6,1,,7,"(3.541112,-76.384584)"
2014,Julio,Noruega,578,22,21,,43,"(4.697144,-74.140516)"
2014,Julio,Noruega,578,3,2,,5,"(6.171601,-75.427454)"
2014,Julio,Noruega,578,0,1,,1,"(7.927209,-72.507910)"
2014,Julio,Nueva Zelanda,554,23,22,,45,"(4.697144,-74.140516)"
2014,Julio,Nueva Zelanda,554,9,2,,11,"(6.171601,-75.427454)"
2014,Julio,Omán,512,4,13,,17,"(4.697144,-74.140516)"
2014,Julio,Omán,512,0,1,,1,"(6.171601,-75.427454)"
2014,Julio,Papúa Nueva Guinea,598,0,1,,1,"(4.697144,-74.140516)"
2014,Julio,Pakistán,586,0,3,,3,"(4.697144,-74.140516)"
2014,Julio,Panamá,591,22,86,,108,"(10.408582,-75.538003)"
2014,Julio,Panamá,591,386,455,,841,"(10.445761,-75.516429)"
2014,Julio,Panamá,591,908,999,,1907,"(10.886611,-74.776708)"
2014,Julio,Panamá,591,1,3,,4,"(10.971302,-74.765397)"
2014,Julio,Panamá,591,0,1,,1,"(11.247723,-74.213989)"
2014,Julio,Panamá,591,166,189,,355,"(12.586067,-81.702563)"
2014,Julio,Panamá,591,0,2,,2,"(13.3387613,-81.372937)"
2014,Julio,Panamá,591,2777,2213,,4990,"(3.541112,-76.384584)"
2014,Julio,Panamá,591,7374,8131,,15505,"(4.697144,-74.140516)"
2014,Julio,Panamá,591,751,646,,1397,"(4.815061,-75.736532)"
2014,Julio,Panamá,591,2422,2566,,4988,"(6.171601,-75.427454)"
2014,Julio,Panamá,591,16,23,,39,"(7.102626,-77.762647)"
2014,Julio,Panamá,591,355,406,,761,"(7.128456,-73.183637)"
2014,Julio,Panamá,591,142,180,,322,"(7.927209,-72.507910)"
2014,Julio,Panamá,591,0,84,,84,"(8.066966,-76.735404)"
2014,Julio,Paraguay,600,0,3,,3,"(10.886611,-74.776708)"
2014,Julio,Paraguay,600,12,14,,26,"(3.541112,-76.384584)"
2014,Julio,Paraguay,600,41,155,,196,"(4.697144,-74.140516)"
2014,Julio,Paraguay,600,2,4,,6,"(4.815061,-75.736532)"
2014,Julio,Paraguay,600,12,22,,34,"(6.171601,-75.427454)"
2014,Julio,Perú,604,88,154,,242,"(-4.197703,-69.941278)"
2014,Julio,Perú,604,1,2,,3,"(-4.223468,-69.945098)"
2014,Julio,Perú,604,118,164,,282,"(0.814836,-77.662532)"
2014,Julio,Perú,604,5,3,,8,"(10.445761,-75.516429)"
2014,Julio,Perú,604,19,12,,31,"(10.886611,-74.776708)"
2014,Julio,Perú,604,3,1,,4,"(12.586067,-81.702563)"
2014,Julio,Perú,604,358,365,,723,"(3.541112,-76.384584)"
2014,Julio,Perú,604,3243,3990,,7233,"(4.697144,-74.140516)"
2014,Julio,Perú,604,9,8,,17,"(4.815061,-75.736532)"
2014,Julio,Perú,604,324,383,,707,"(6.171601,-75.427454)"
2014,Julio,Perú,604,6,4,,10,"(7.128456,-73.183637)"
2014,Julio,Perú,604,1,0,,1,"(7.927209,-72.507910)"
2014,Julio,Palestina,99999,0,2,,2,"(4.697144,-74.140516)"
2014,Julio,Polonia,616,18,21,,39,"(4.697144,-74.140516)"
2014,Julio,Polonia,616,1,0,,1,"(6.171601,-75.427454)"
2014,Julio,Portugal,620,3,1,,4,"(3.541112,-76.384584)"
2014,Julio,Portugal,620,200,184,,384,"(4.697144,-74.140516)"
2014,Julio,Portugal,620,1,3,,4,"(6.171601,-75.427454)"
2014,Julio,Polinesia Francesa/Colectividad de Ultramar Francesa,258,1,1,,2,"(4.697144,-74.140516)"
2014,Julio,Puerto Rico/Territorio de Estados Unidos,630,4,6,,10,"(10.445761,-75.516429)"
2014,Julio,Puerto Rico/Territorio de Estados Unidos,630,16,25,,41,"(10.886611,-74.776708)"
2014,Julio,Puerto Rico/Territorio de Estados Unidos,630,2,1,,3,"(12.586067,-81.702563)"
2014,Julio,Puerto Rico/Territorio de Estados Unidos,630,30,20,,50,"(3.541112,-76.384584)"
2014,Julio,Puerto Rico/Territorio de Estados Unidos,630,486,436,,922,"(4.697144,-74.140516)"
2014,Julio,Puerto Rico/Territorio de Estados Unidos,630,8,2,,10,"(4.815061,-75.736532)"
2014,Julio,Puerto Rico/Territorio de Estados Unidos,630,32,24,,56,"(6.171601,-75.427454)"
2014,Julio,Puerto Rico/Territorio de Estados Unidos,630,4,7,,11,"(7.128456,-73.183637)"
2014,Julio,Puerto Rico/Territorio de Estados Unidos,630,1,0,,1,"(7.927209,-72.507910)"
2014,Julio,Qatar,634,4,8,,12,"(4.697144,-74.140516)"
2014,Julio,Qatar,634,1,5,,6,"(6.171601,-75.427454)"
2014,Julio,Reino Unido de Gran Bretaña e Irlanda del Norte,826,1,0,,1,"(0.814836,-77.662532)"
2014,Julio,Reino Unido de Gran Bretaña e Irlanda del Norte,826,16,10,,26,"(3.541112,-76.384584)"
2014,Julio,Reino Unido de Gran Bretaña e Irlanda del Norte,826,1848,1523,,3371,"(4.697144,-74.140516)"
2014,Julio,Reino Unido de Gran Bretaña e Irlanda del Norte,826,11,16,,27,"(6.171601,-75.427454)"
2014,Julio,Federación de Rusia,643,1,0,,1,"(10.886611,-74.776708)"
2014,Julio,Federación de Rusia,643,2,0,,2,"(3.541112,-76.384584)"
2014,Julio,Federación de Rusia,643,54,44,,98,"(4.697144,-74.140516)"
2014,Julio,Federación de Rusia,643,0,1,,1,"(6.171601,-75.427454)"
2014,Julio,Federación de Rusia,643,0,1,,1,"(7.128456,-73.183637)"
2014,Julio,República Dominicana,214,7,17,,24,"(10.445761,-75.516429)"
2014,Julio,República Dominicana,214,35,33,,68,"(10.886611,-74.776708)"
2014,Julio,República Dominicana,214,69,51,,120,"(3.541112,-76.384584)"
2014,Julio,República Dominicana,214,1897,1943,,3840,"(4.697144,-74.140516)"
2014,Julio,República Dominicana,214,5,6,,11,"(4.815061,-75.736532)"
2014,Julio,República Dominicana,214,130,104,,234,"(6.171601,-75.427454)"
2014,Julio,República Dominicana,214,18,19,,37,"(7.128456,-73.183637)"
2014,Julio,República Dominicana,214,1,1,,2,"(7.927209,-72.507910)"
2014,Julio,República Democrática Popular de Corea,408,2,1,,3,"(4.697144,-74.140516)"
2014,Julio,Rumania,642,0,1,,1,"(3.541112,-76.384584)"
2014,Julio,Rumania,642,5,16,,21,"(4.697144,-74.140516)"
2014,Julio,Rumania,642,0,1,,1,"(6.171601,-75.427454)"
2014,Julio,Sahara Occidental/Desierto Sahara,732,0,1,,1,"(3.541112,-76.384584)"
2014,Julio,San Marino,674,1,0,,1,"(6.171601,-75.427454)"
2014,Julio,San  Vicente y las Granadinas,670,1,0,,1,"(6.171601,-75.427454)"
2014,Julio,Senegal,686,0,1,,1,"(4.697144,-74.140516)"
2014,Julio,Serbia,688,0,1,,1,"(4.697144,-74.140516)"
2014,Julio,Singapur,702,22,14,,36,"(4.697144,-74.140516)"
2014,Julio,Singapur,702,3,0,,3,"(6.171601,-75.427454)"
2014,Julio,Sudáfrica,710,20,25,,45,"(4.697144,-74.140516)"
2014,Julio,Sudán,736,0,2,,2,"(4.697144,-74.140516)"
2014,Julio,Suecia,752,1,1,,2,"(10.445761,-75.516429)"
2014,Julio,Suecia,752,4,5,,9,"(3.541112,-76.384584)"
2014,Julio,Suecia,752,84,85,,169,"(4.697144,-74.140516)"
2014,Julio,Suecia,752,14,3,,17,"(6.171601,-75.427454)"
2014,Julio,Suecia,752,3,2,,5,"(7.128456,-73.183637)"
2014,Julio,Suiza,756,17,8,,25,"(3.541112,-76.384584)"
2014,Julio,Suiza,756,320,218,,538,"(4.697144,-74.140516)"
2014,Julio,Suiza,756,25,24,,49,"(6.171601,-75.427454)"
2014,Julio,Surinam,740,0,1,,1,"(10.408582,-75.538003)"
2014,Julio,Surinam,740,3,10,,13,"(4.697144,-74.140516)"
2014,Julio,Taiwán,158,1,0,,1,"(3.541112,-76.384584)"
2014,Julio,Taiwán,158,0,4,,4,"(4.697144,-74.140516)"
2014,Julio,Taiwán,158,1,0,,1,"(6.171601,-75.427454)"
2014,Julio,Tailandia,764,20,24,,44,"(4.697144,-74.140516)"
2014,Julio,Tailandia,764,2,0,,2,"(6.171601,-75.427454)"
2014,Julio,Tanzania,834,0,1,,1,"(3.541112,-76.384584)"
2014,Julio,Tanzania,834,3,3,,6,"(4.697144,-74.140516)"
2014,Julio,Trinidad y Tobago,780,0,5,,5,"(10.445761,-75.516429)"
2014,Julio,Trinidad y Tobago,780,0,2,,2,"(10.886611,-74.776708)"
2014,Julio,Trinidad y Tobago,780,8,9,,17,"(3.541112,-76.384584)"
2014,Julio,Trinidad y Tobago,780,21,38,,59,"(4.697144,-74.140516)"
2014,Julio,Trinidad y Tobago,780,7,6,,13,"(4.815061,-75.736532)"
2014,Julio,Trinidad y Tobago,780,9,8,,17,"(6.171601,-75.427454)"
2014,Julio,Trinidad y Tobago,780,2,7,,9,"(7.128456,-73.183637)"
2014,Julio,Trinidad y Tobago,780,1,3,,4,"(7.927209,-72.507910)"
2014,Julio,Turquía,792,67,44,,111,"(4.697144,-74.140516)"
2014,Julio,Turquía,792,2,1,,3,"(6.171601,-75.427454)"
2014,Julio,Turkmenistán,795,0,1,,1,"(4.697144,-74.140516)"
2014,Julio,Ucrania,804,0,2,,2,"(4.697144,-74.140516)"
2014,Julio,Uganda,800,0,1,,1,"(4.697144,-74.140516)"
2014,Julio,Uruguay,858,1,1,,2,"(10.445761,-75.516429)"
2014,Julio,Uruguay,858,1,0,,1,"(10.886611,-74.776708)"
2014,Julio,Uruguay,858,19,13,,32,"(3.541112,-76.384584)"
2014,Julio,Uruguay,858,40,62,,102,"(4.697144,-74.140516)"
2014,Julio,Uruguay,858,10,15,,25,"(6.171601,-75.427454)"
2014,Julio,Uruguay,858,1,1,,2,"(7.927209,-72.507910)"
2014,Julio,Venezuela,862,0,1,,1,"(10.408582,-75.538003)"
2014,Julio,Venezuela,862,1,6,,7,"(10.445761,-75.516429)"
2014,Julio,Venezuela,862,11,15,,26,"(10.886611,-74.776708)"
2014,Julio,Venezuela,862,12186,10064,,22250,"(11.360009,-72.129330)"
2014,Julio,Venezuela,862,3,17,,20,"(3.541112,-76.384584)"
2014,Julio,Venezuela,862,1147,1465,,2612,"(4.697144,-74.140516)"
2014,Julio,Venezuela,862,67,69,,136,"(6.171601,-75.427454)"
2014,Julio,Venezuela,862,179,216,,395,"(6.185799,-67.483929)"
2014,Julio,Venezuela,862,2558,2018,,4576,"(7.088729,-70.740253)"
2014,Julio,Venezuela,862,1,2,,3,"(7.128456,-73.183637)"
2014,Julio,Venezuela,862,8047,7244,,15291,"(7.818934,-72.453226)"
2014,Julio,Venezuela,862,115,83,,198,"(7.927209,-72.507910)"
2014,Julio,Vietnam,704,2,3,,5,"(4.697144,-74.140516)"
2014,Julio,Zambia,894,0,1,,1,"(6.171601,-75.427454)"
2014,Julio,Desconocido,99999,1,15,,16,"(12.5744111,-81.703935)"
2014,Julio,Desconocido,99999,1,8,,9,"(13.3387613,-81.372937)"
2014,Julio,Desconocido,99999,920,955,,1875,"(4.697144,-74.140516)"
2014,Julio,Desconocido,99999,0,1,,1,"(6.185799,-67.483929)"
2014,Julio,Desconocido,99999,2,12,,14,"(8.635765,-77.346578)"
2014,Agosto,Afganistán,4,2,10,,12,"(4.697144,-74.140516)"
2014,Agosto,Afganistán,4,1,0,,1,"(6.171601,-75.427454)"
2014,Agosto,Alemania,276,2,2,,4,"(10.886611,-74.776708)"
2014,Agosto,Alemania,276,1,0,,1,"(12.586067,-81.702563)"
2014,Agosto,Alemania,276,13,10,,23,"(3.541112,-76.384584)"
2014,Agosto,Alemania,276,1222,1038,,2260,"(4.697144,-74.140516)"
2014,Agosto,Alemania,276,18,11,,29,"(6.171601,-75.427454)"
2014,Agosto,Angola,24,4,14,,18,"(4.697144,-74.140516)"
2014,Agosto,Antigua y Barbuda,28,1,1,,2,"(4.697144,-74.140516)"
2014,Agosto,Países Bajos,528,127,92,,219,"(10.408582,-75.538003)"
2014,Agosto,Países Bajos,528,1,0,,1,"(10.445761,-75.516429)"
2014,Agosto,Países Bajos,528,9,4,,13,"(10.886611,-74.776708)"
2014,Agosto,Países Bajos,528,30,25,,55,"(3.541112,-76.384584)"
2014,Agosto,Países Bajos,528,257,141,,398,"(4.697144,-74.140516)"
2014,Agosto,Países Bajos,528,1,0,,1,"(4.815061,-75.736532)"
2014,Agosto,Países Bajos,528,55,31,,86,"(6.171601,-75.427454)"
2014,Agosto,Países Bajos,528,2,0,,2,"(7.128456,-73.183637)"
2014,Agosto,Arabia Saudita,682,34,49,,83,"(4.697144,-74.140516)"
2014,Agosto,Arabia Saudita,682,2,3,,5,"(6.171601,-75.427454)"
2014,Agosto,Argelia,12,0,1,,1,"(3.541112,-76.384584)"
2014,Agosto,Argelia,12,1,10,,11,"(4.697144,-74.140516)"
2014,Agosto,Argelia,12,1,0,,1,"(6.171601,-75.427454)"
2014,Agosto,Argentina,32,16,30,,46,"(0.814836,-77.662532)"
2014,Agosto,Argentina,32,12,14,,26,"(10.445761,-75.516429)"
2014,Agosto,Argentina,32,22,39,,61,"(10.886611,-74.776708)"
2014,Agosto,Argentina,32,2,3,,5,"(12.586067,-81.702563)"
2014,Agosto,Argentina,32,155,159,,314,"(3.541112,-76.384584)"
2014,Agosto,Argentina,32,2576,2403,,4979,"(4.697144,-74.140516)"
2014,Agosto,Argentina,32,11,9,,20,"(4.815061,-75.736532)"
2014,Agosto,Argentina,32,188,239,,427,"(6.171601,-75.427454)"
2014,Agosto,Argentina,32,13,10,,23,"(7.128456,-73.183637)"
2014,Agosto,Aruba,533,1843,1251,,3094,"(10.408582,-75.538003)"
2014,Agosto,Aruba,533,4,8,,12,"(10.445761,-75.516429)"
2014,Agosto,Aruba,533,16,17,,33,"(10.886611,-74.776708)"
2014,Agosto,Aruba,533,0,1,,1,"(10.971302,-74.765397)"
2014,Agosto,Aruba,533,2,3,,5,"(11.117806,-74.232622)"
2014,Agosto,Aruba,533,27,19,,46,"(3.541112,-76.384584)"
2014,Agosto,Aruba,533,1887,1418,,3305,"(4.697144,-74.140516)"
2014,Agosto,Aruba,533,9,1,,10,"(4.815061,-75.736532)"
2014,Agosto,Aruba,533,44,33,,77,"(6.171601,-75.427454)"
2014,Agosto,Aruba,533,8,11,,19,"(7.128456,-73.183637)"
2014,Agosto,Aruba,533,1,2,,3,"(7.927209,-72.507910)"
2014,Agosto,Australia,36,3,1,,4,"(10.886611,-74.776708)"
2014,Agosto,Australia,36,6,10,,16,"(3.541112,-76.384584)"
2014,Agosto,Australia,36,172,138,,310,"(4.697144,-74.140516)"
2014,Agosto,Australia,36,0,2,,2,"(4.815061,-75.736532)"
2014,Agosto,Australia,36,12,13,,25,"(6.171601,-75.427454)"
2014,Agosto,Australia,36,1,0,,1,"(7.927209,-72.507910)"
2014,Agosto,Austria,40,50,29,,79,"(4.697144,-74.140516)"
2014,Agosto,Austria,40,2,1,,3,"(6.171601,-75.427454)"
2014,Agosto,Azerbaiyán,31,7,9,,16,"(4.697144,-74.140516)"
2014,Agosto,Bahamas,44,1,0,,1,"(10.445761,-75.516429)"
2014,Agosto,Bahamas,44,19,8,,27,"(3.541112,-76.384584)"
2014,Agosto,Bahamas,44,20,14,,34,"(4.697144,-74.140516)"
2014,Agosto,Bahamas,44,4,3,,7,"(4.815061,-75.736532)"
2014,Agosto,Bahamas,44,20,20,,40,"(6.171601,-75.427454)"
2014,Agosto,Bahréin,48,5,6,,11,"(4.697144,-74.140516)"
2014,Agosto,Bahréin,48,1,0,,1,"(4.815061,-75.736532)"
2014,Agosto,Bangladesh,50,4,2,,6,"(4.697144,-74.140516)"
2014,Agosto,Barbados,52,2,1,,3,"(10.445761,-75.516429)"
2014,Agosto,Barbados,52,3,7,,10,"(3.541112,-76.384584)"
2014,Agosto,Barbados,52,2,7,,9,"(4.697144,-74.140516)"
2014,Agosto,Barbados,52,0,2,,2,"(6.171601,-75.427454)"
2014,Agosto,República de Belarús,112,1,3,,4,"(11.360009,-72.129330)"
2014,Agosto,Bélgica,56,7,2,,9,"(10.445761,-75.516429)"
2014,Agosto,Bélgica,56,1,0,,1,"(10.886611,-74.776708)"
2014,Agosto,Bélgica,56,6,6,,12,"(3.541112,-76.384584)"
2014,Agosto,Bélgica,56,189,106,,295,"(4.697144,-74.140516)"
2014,Agosto,Bélgica,56,18,8,,26,"(6.171601,-75.427454)"
2014,Agosto,Belice,84,6,4,,10,"(4.697144,-74.140516)"
2014,Agosto,Belice,84,2,1,,3,"(6.171601,-75.427454)"
2014,Agosto,Benín,204,1,0,,1,"(4.697144,-74.140516)"
2014,Agosto,Bermudas/Territorio Británico de Ultramar,60,1,0,,1,"(6.171601,-75.427454)"
2014,Agosto,Bolivia,68,0,7,,7,"(0.814836,-77.662532)"
2014,Agosto,Bolivia,68,2,0,,2,"(10.445761,-75.516429)"
2014,Agosto,Bolivia,68,2,1,,3,"(10.886611,-74.776708)"
2014,Agosto,Bolivia,68,12,19,,31,"(3.541112,-76.384584)"
2014,Agosto,Bolivia,68,227,397,,624,"(4.697144,-74.140516)"
2014,Agosto,Bolivia,68,2,1,,3,"(4.815061,-75.736532)"
2014,Agosto,Bolivia,68,23,39,,62,"(6.171601,-75.427454)"
2014,Agosto,Bolivia,68,1,0,,1,"(7.128456,-73.183637)"
2014,Agosto,Botsuana,72,1,0,,1,"(4.697144,-74.140516)"
2014,Agosto,Brasil,76,87,127,,214,"(-4.197703,-69.941278)"
2014,Agosto,Brasil,76,3,1,,4,"(-4.223468,-69.945098)"
2014,Agosto,Brasil,76,3,9,,12,"(10.445761,-75.516429)"
2014,Agosto,Brasil,76,2,9,,11,"(10.886611,-74.776708)"
2014,Agosto,Brasil,76,0,1,,1,"(12.586067,-81.702563)"
2014,Agosto,Brasil,76,47,66,,113,"(3.541112,-76.384584)"
2014,Agosto,Brasil,76,3066,3996,,7062,"(4.697144,-74.140516)"
2014,Agosto,Brasil,76,8,18,,26,"(4.815061,-75.736532)"
2014,Agosto,Brasil,76,55,95,,150,"(6.171601,-75.427454)"
2014,Agosto,Brasil,76,1,2,,3,"(7.128456,-73.183637)"
2014,Agosto,Brasil,76,0,1,,1,"(7.818934,-72.453226)"
2014,Agosto,Brasil,76,1,1,,2,"(7.927209,-72.507910)"
2014,Agosto,Brunei Darussalam,96,1,0,,1,"(4.697144,-74.140516)"
2014,Agosto,Bulgaria,100,3,1,,4,"(4.697144,-74.140516)"
2014,Agosto,Islas Caimán/Territorio Británico de Ultramar,136,1,1,,2,"(10.445761,-75.516429)"
2014,Agosto,Islas Caimán/Territorio Británico de Ultramar,136,3,3,,6,"(12.586067,-81.702563)"
2014,Agosto,Camerún,120,1,2,,3,"(4.697144,-74.140516)"
2014,Agosto,Camerún,120,2,0,,2,"(6.171601,-75.427454)"
2014,Agosto,Canadá,124,48,27,,75,"(10.445761,-75.516429)"
2014,Agosto,Canadá,124,42,32,,74,"(10.886611,-74.776708)"
2014,Agosto,Canadá,124,1,3,,4,"(12.586067,-81.702563)"
2014,Agosto,Canadá,124,176,118,,294,"(3.541112,-76.384584)"
2014,Agosto,Canadá,124,2,1,,3,"(4.452882,-75.766298)"
2014,Agosto,Canadá,124,2231,1766,,3997,"(4.697144,-74.140516)"
2014,Agosto,Canadá,124,22,15,,37,"(4.815061,-75.736532)"
2014,Agosto,Canadá,124,272,208,,480,"(6.171601,-75.427454)"
2014,Agosto,Canadá,124,16,10,,26,"(7.128456,-73.183637)"
2014,Agosto,Canadá,124,2,4,,6,"(7.927209,-72.507910)"
2014,Agosto,Chad,148,0,1,,1,"(4.697144,-74.140516)"
2014,Agosto,España,724,1,0,,1,"(0.814836,-77.662532)"
2014,Agosto,España,724,8,8,,16,"(10.445761,-75.516429)"
2014,Agosto,España,724,4,0,,4,"(10.886611,-74.776708)"
2014,Agosto,España,724,2,1,,3,"(12.586067,-81.702563)"
2014,Agosto,España,724,1116,591,,1707,"(3.541112,-76.384584)"
2014,Agosto,España,724,7182,5035,,12217,"(4.697144,-74.140516)"
2014,Agosto,España,724,812,493,,1305,"(6.171601,-75.427454)"
2014,Agosto,España,724,1,1,,2,"(7.128456,-73.183637)"
2014,Agosto,Colombia,170,113,105,,218,"(4.697144,-74.140516)"
2014,Agosto,República Democrática del Congo,180,2,3,,5,"(4.697144,-74.140516)"
2014,Agosto,República de Corea,410,1,0,,1,"(10.886611,-74.776708)"
2014,Agosto,República de Corea,410,0,1,,1,"(12.586067,-81.702563)"
2014,Agosto,República de Corea,410,32,58,,90,"(4.697144,-74.140516)"
2014,Agosto,República de Corea,410,0,4,,4,"(6.171601,-75.427454)"
2014,Agosto,Costa de Marfil,384,2,7,,9,"(4.697144,-74.140516)"
2014,Agosto,Costa Rica,188,0,7,,7,"(10.408582,-75.538003)"
2014,Agosto,Costa Rica,188,8,17,,25,"(10.445761,-75.516429)"
2014,Agosto,Costa Rica,188,15,22,,37,"(10.886611,-74.776708)"
2014,Agosto,Costa Rica,188,6,9,,15,"(12.586067,-81.702563)"
2014,Agosto,Costa Rica,188,2,16,,18,"(13.3387613,-81.372937)"
2014,Agosto,Costa Rica,188,48,56,,104,"(3.541112,-76.384584)"
2014,Agosto,Costa Rica,188,923,1073,,1996,"(4.697144,-74.140516)"
2014,Agosto,Costa Rica,188,12,11,,23,"(4.815061,-75.736532)"
2014,Agosto,Costa Rica,188,88,119,,207,"(6.171601,-75.427454)"
2014,Agosto,Costa Rica,188,5,3,,8,"(7.128456,-73.183637)"
2014,Agosto,Costa Rica,188,3,3,,6,"(7.927209,-72.507910)"
2014,Agosto,Croacia,191,7,10,,17,"(4.697144,-74.140516)"
2014,Agosto,Cuba,192,21,19,,40,"(10.445761,-75.516429)"
2014,Agosto,Cuba,192,40,27,,67,"(10.886611,-74.776708)"
2014,Agosto,Cuba,192,1,4,,5,"(12.586067,-81.702563)"
2014,Agosto,Cuba,192,60,55,,115,"(3.541112,-76.384584)"
2014,Agosto,Cuba,192,1223,973,,2196,"(4.697144,-74.140516)"
2014,Agosto,Cuba,192,24,21,,45,"(4.815061,-75.736532)"
2014,Agosto,Cuba,192,154,114,,268,"(6.171601,-75.427454)"
2014,Agosto,Cuba,192,22,15,,37,"(7.128456,-73.183637)"
2014,Agosto,Cuba,192,1,2,,3,"(7.927209,-72.507910)"
2014,Agosto,Curazao,99999,167,108,,275,"(10.886611,-74.776708)"
2014,Agosto,Curazao,99999,9,11,,20,"(11.117806,-74.232622)"
2014,Agosto,Curazao,99999,9,2,,11,"(3.541112,-76.384584)"
2014,Agosto,Curazao,99999,592,551,,1143,"(4.697144,-74.140516)"
2014,Agosto,Curazao,99999,141,79,,220,"(6.171601,-75.427454)"
2014,Agosto,Curazao,99999,3,1,,4,"(7.128456,-73.183637)"
2014,Agosto,Curazao,99999,1,0,,1,"(7.927209,-72.507910)"
2014,Agosto,República Checa,203,6,12,,18,"(4.697144,-74.140516)"
2014,Agosto,República Checa,203,3,0,,3,"(6.171601,-75.427454)"
2014,Agosto,Chile,152,90,59,,149,"(0.814836,-77.662532)"
2014,Agosto,Chile,152,9,5,,14,"(10.445761,-75.516429)"
2014,Agosto,Chile,152,13,14,,27,"(10.886611,-74.776708)"
2014,Agosto,Chile,152,4,3,,7,"(12.586067,-81.702563)"
2014,Agosto,Chile,152,270,210,,480,"(3.541112,-76.384584)"
2014,Agosto,Chile,152,3250,3122,,6372,"(4.697144,-74.140516)"
2014,Agosto,Chile,152,78,85,,163,"(4.815061,-75.736532)"
2014,Agosto,Chile,152,114,127,,241,"(6.171601,-75.427454)"
2014,Agosto,Chile,152,3,8,,11,"(7.128456,-73.183637)"
2014,Agosto,Chile,152,1,0,,1,"(7.927209,-72.507910)"
2014,Agosto,China,156,3,6,,9,"(10.886611,-74.776708)"
2014,Agosto,China,156,9,10,,19,"(3.541112,-76.384584)"
2014,Agosto,China,156,206,502,,708,"(4.697144,-74.140516)"
2014,Agosto,China,156,3,3,,6,"(4.815061,-75.736532)"
2014,Agosto,China,156,14,30,,44,"(6.171601,-75.427454)"
2014,Agosto,China,156,1,1,,2,"(7.128456,-73.183637)"
2014,Agosto,Chipre,196,1,0,,1,"(3.541112,-76.384584)"
2014,Agosto,Chipre,196,4,0,,4,"(4.697144,-74.140516)"
2014,Agosto,Dinamarca,208,1,0,,1,"(10.886611,-74.776708)"
2014,Agosto,Dinamarca,208,1,2,,3,"(3.541112,-76.384584)"
2014,Agosto,Dinamarca,208,72,43,,115,"(4.697144,-74.140516)"
2014,Agosto,Dinamarca,208,2,3,,5,"(6.171601,-75.427454)"
2014,Agosto,Dominica,212,1,0,,1,"(4.815061,-75.736532)"
2014,Agosto,Ecuador,218,549,577,,1126,"(0.25129,-76.875963)"
2014,Agosto,Ecuador,218,7716,7946,,15662,"(0.814836,-77.662532)"
2014,Agosto,Ecuador,218,171,187,,358,"(1.813928,-78.763924)"
2014,Agosto,Ecuador,218,3,6,,9,"(10.445761,-75.516429)"
2014,Agosto,Ecuador,218,4,22,,26,"(10.886611,-74.776708)"
2014,Agosto,Ecuador,218,3,2,,5,"(12.586067,-81.702563)"
2014,Agosto,Ecuador,218,842,711,,1553,"(3.541112,-76.384584)"
2014,Agosto,Ecuador,218,2108,3747,,5855,"(4.697144,-74.140516)"
2014,Agosto,Ecuador,218,4,1,,5,"(4.815061,-75.736532)"
2014,Agosto,Ecuador,218,464,376,,840,"(6.171601,-75.427454)"
2014,Agosto,Ecuador,218,2,2,,4,"(7.128456,-73.183637)"
2014,Agosto,Egipto,818,17,11,,28,"(4.697144,-74.140516)"
2014,Agosto,El Salvador,222,1,3,,4,"(10.445761,-75.516429)"
2014,Agosto,El Salvador,222,2,8,,10,"(10.886611,-74.776708)"
2014,Agosto,El Salvador,222,1,1,,2,"(12.586067,-81.702563)"
2014,Agosto,El Salvador,222,204,204,,408,"(3.541112,-76.384584)"
2014,Agosto,El Salvador,222,979,1015,,1994,"(4.697144,-74.140516)"
2014,Agosto,El Salvador,222,0,1,,1,"(4.815061,-75.736532)"
2014,Agosto,El Salvador,222,77,88,,165,"(6.171601,-75.427454)"
2014,Agosto,El Salvador,222,1,2,,3,"(7.128456,-73.183637)"
2014,Agosto,Emiratos Árabes,784,1,0,,1,"(10.445761,-75.516429)"
2014,Agosto,Emiratos Árabes,784,2,1,,3,"(3.541112,-76.384584)"
2014,Agosto,Emiratos Árabes,784,175,257,,432,"(4.697144,-74.140516)"
2014,Agosto,Emiratos Árabes,784,6,7,,13,"(6.171601,-75.427454)"
2014,Agosto,Eritrea,232,0,2,,2,"(4.697144,-74.140516)"
2014,Agosto,Eslovaquia,703,1,0,,1,"(3.541112,-76.384584)"
2014,Agosto,Eslovaquia,703,1,1,,2,"(4.697144,-74.140516)"
2014,Agosto,Eslovenia,705,0,1,,1,"(4.697144,-74.140516)"
2014,Agosto,Estados Unidos de América,840,1,1,,2,"(0.814836,-77.662532)"
2014,Agosto,Estados Unidos de América,840,1,3,,4,"(10.408582,-75.538003)"
2014,Agosto,Estados Unidos de América,840,3336,2471,,5807,"(10.445761,-75.516429)"
2014,Agosto,Estados Unidos de América,840,2345,1805,,4150,"(10.886611,-74.776708)"
2014,Agosto,Estados Unidos de América,840,85,63,,148,"(12.586067,-81.702563)"
2014,Agosto,Estados Unidos de América,840,6598,4591,,11189,"(3.541112,-76.384584)"
2014,Agosto,Estados Unidos de América,840,551,399,,950,"(4.452882,-75.766298)"
2014,Agosto,Estados Unidos de América,840,36545,30396,,66941,"(4.697144,-74.140516)"
2014,Agosto,Estados Unidos de América,840,1261,909,,2170,"(4.815061,-75.736532)"
2014,Agosto,Estados Unidos de América,840,10631,7979,,18610,"(6.171601,-75.427454)"
2014,Agosto,Estados Unidos de América,840,256,150,,406,"(7.128456,-73.183637)"
2014,Agosto,Estados Unidos de América,840,119,120,,239,"(7.927209,-72.507910)"
2014,Agosto,Etiopia,231,4,4,,8,"(4.697144,-74.140516)"
2014,Agosto,Filipinas,608,0,1,,1,"(10.886611,-74.776708)"
2014,Agosto,Filipinas,608,3,7,,10,"(4.697144,-74.140516)"
2014,Agosto,Finlandia,246,0,1,,1,"(10.886611,-74.776708)"
2014,Agosto,Finlandia,246,13,22,,35,"(4.697144,-74.140516)"
2014,Agosto,Francia,250,1,0,,1,"(0.814836,-77.662532)"
2014,Agosto,Francia,250,6,1,,7,"(10.445761,-75.516429)"
2014,Agosto,Francia,250,2,2,,4,"(10.886611,-74.776708)"
2014,Agosto,Francia,250,54,32,,86,"(3.541112,-76.384584)"
2014,Agosto,Francia,250,2118,1424,,3542,"(4.697144,-74.140516)"
2014,Agosto,Francia,250,5,1,,6,"(4.815061,-75.736532)"
2014,Agosto,Francia,250,43,24,,67,"(6.171601,-75.427454)"
2014,Agosto,Gabón,266,1,5,,6,"(4.697144,-74.140516)"
2014,Agosto,Georgia,268,2,1,,3,"(3.541112,-76.384584)"
2014,Agosto,Georgia,268,1,0,,1,"(6.171601,-75.427454)"
2014,Agosto,Ghana,288,2,1,,3,"(4.697144,-74.140516)"
2014,Agosto,Grecia,300,27,13,,40,"(4.697144,-74.140516)"
2014,Agosto,Guatemala,320,0,3,,3,"(10.445761,-75.516429)"
2014,Agosto,Guatemala,320,6,13,,19,"(10.886611,-74.776708)"
2014,Agosto,Guatemala,320,1,0,,1,"(12.586067,-81.702563)"
2014,Agosto,Guatemala,320,38,51,,89,"(3.541112,-76.384584)"
2014,Agosto,Guatemala,320,0,2,,2,"(3.893038,-77.067921)"
2014,Agosto,Guatemala,320,414,570,,984,"(4.697144,-74.140516)"
2014,Agosto,Guatemala,320,12,6,,18,"(4.815061,-75.736532)"
2014,Agosto,Guatemala,320,46,78,,124,"(6.171601,-75.427454)"
2014,Agosto,Guatemala,320,1,2,,3,"(7.128456,-73.183637)"
2014,Agosto,Guatemala,320,1,2,,3,"(7.927209,-72.507910)"
2014,Agosto,Guyana,328,3,6,,9,"(10.886611,-74.776708)"
2014,Agosto,Guyana,328,2,1,,3,"(3.541112,-76.384584)"
2014,Agosto,Guyana,328,2,1,,3,"(4.697144,-74.140516)"
2014,Agosto,Guyana,328,1,0,,1,"(7.128456,-73.183637)"
2014,Agosto,Guinea,324,1,5,,6,"(4.697144,-74.140516)"
2014,Agosto,Guinea Ecuatorial,226,1,4,,5,"(3.541112,-76.384584)"
2014,Agosto,Guinea Ecuatorial,226,4,14,,18,"(4.697144,-74.140516)"
2014,Agosto,Guadalupe/Territorio Francés,312,4,2,,6,"(4.697144,-74.140516)"
2014,Agosto,Guadalupe/Territorio Francés,312,0,1,,1,"(6.171601,-75.427454)"
2014,Agosto,Guayana Francesa/Departamento de Ultramar Francés,254,1,1,,2,"(4.697144,-74.140516)"
2014,Agosto,Guayana Francesa/Departamento de Ultramar Francés,254,0,7,,7,"(6.171601,-75.427454)"
2014,Agosto,Haití,332,0,3,,3,"(10.886611,-74.776708)"
2014,Agosto,Haití,332,1,9,,10,"(10.971302,-74.765397)"
2014,Agosto,Haití,332,1,1,,2,"(3.541112,-76.384584)"
2014,Agosto,Haití,332,0,1,,1,"(3.893038,-77.067921)"
2014,Agosto,Haití,332,7,14,,21,"(4.697144,-74.140516)"
2014,Agosto,Haití,332,0,1,,1,"(4.815061,-75.736532)"
2014,Agosto,Haití,332,1,3,,4,"(6.171601,-75.427454)"
2014,Agosto,Honduras,340,3,10,,13,"(10.445761,-75.516429)"
2014,Agosto,Honduras,340,4,8,,12,"(10.886611,-74.776708)"
2014,Agosto,Honduras,340,0,1,,1,"(12.586067,-81.702563)"
2014,Agosto,Honduras,340,8,24,,32,"(3.541112,-76.384584)"
2014,Agosto,Honduras,340,84,133,,217,"(4.697144,-74.140516)"
2014,Agosto,Honduras,340,5,2,,7,"(4.815061,-75.736532)"
2014,Agosto,Honduras,340,27,65,,92,"(6.171601,-75.427454)"
2014,Agosto,Honduras,340,0,3,,3,"(7.128456,-73.183637)"
2014,Agosto,Honduras,340,0,1,,1,"(7.927209,-72.507910)"
2014,Agosto,Hong Kong,344,0,2,,2,"(3.541112,-76.384584)"
2014,Agosto,Hong Kong,344,32,44,,76,"(4.697144,-74.140516)"
2014,Agosto,Hong Kong,344,0,2,,2,"(6.171601,-75.427454)"
2014,Agosto,Hong Kong,344,1,1,,2,"(7.927209,-72.507910)"
2014,Agosto,Hungría,348,7,6,,13,"(4.697144,-74.140516)"
2014,Agosto,India,356,2,2,,4,"(3.541112,-76.384584)"
2014,Agosto,India,356,38,29,,67,"(4.697144,-74.140516)"
2014,Agosto,India,356,1,0,,1,"(6.171601,-75.427454)"
2014,Agosto,Indonesia,360,13,11,,24,"(4.697144,-74.140516)"
2014,Agosto,Indonesia,360,1,1,,2,"(6.171601,-75.427454)"
2014,Agosto,Iraq,368,0,9,,9,"(4.697144,-74.140516)"
2014,Agosto,Iraq,368,0,1,,1,"(7.128456,-73.183637)"
2014,Agosto,Irán,364,3,7,,10,"(4.697144,-74.140516)"
2014,Agosto,República de Irlanda,372,13,7,,20,"(4.697144,-74.140516)"
2014,Agosto,República de Irlanda,372,0,2,,2,"(6.171601,-75.427454)"
2014,Agosto,Islandia,352,2,1,,3,"(4.697144,-74.140516)"
2014,Agosto,Israel,376,1,0,,1,"(10.445761,-75.516429)"
2014,Agosto,Israel,376,1,0,,1,"(3.541112,-76.384584)"
2014,Agosto,Israel,376,93,58,,151,"(4.697144,-74.140516)"
2014,Agosto,Israel,376,4,3,,7,"(6.171601,-75.427454)"
2014,Agosto,Islas Aland/Provincia de Finlandia,248,0,1,,1,"(4.697144,-74.140516)"
2014,Agosto,Italia,380,2,0,,2,"(0.814836,-77.662532)"
2014,Agosto,Italia,380,6,0,,6,"(10.445761,-75.516429)"
2014,Agosto,Italia,380,3,5,,8,"(10.886611,-74.776708)"
2014,Agosto,Italia,380,36,14,,50,"(3.541112,-76.384584)"
2014,Agosto,Italia,380,602,385,,987,"(4.697144,-74.140516)"
2014,Agosto,Italia,380,0,1,,1,"(4.815061,-75.736532)"
2014,Agosto,Italia,380,37,12,,49,"(6.171601,-75.427454)"
2014,Agosto,Italia,380,2,0,,2,"(7.128456,-73.183637)"
2014,Agosto,Jamaica,388,10,7,,17,"(10.445761,-75.516429)"
2014,Agosto,Jamaica,388,2,5,,7,"(10.886611,-74.776708)"
2014,Agosto,Jamaica,388,3,2,,5,"(12.586067,-81.702563)"
2014,Agosto,Jamaica,388,26,16,,42,"(3.541112,-76.384584)"
2014,Agosto,Jamaica,388,67,56,,123,"(4.697144,-74.140516)"
2014,Agosto,Jamaica,388,6,7,,13,"(4.815061,-75.736532)"
2014,Agosto,Jamaica,388,19,17,,36,"(6.171601,-75.427454)"
2014,Agosto,Jamaica,388,6,5,,11,"(7.128456,-73.183637)"
2014,Agosto,Jamaica,388,4,2,,6,"(7.927209,-72.507910)"
2014,Agosto,Japón,392,2,0,,2,"(3.541112,-76.384584)"
2014,Agosto,Japón,392,58,81,,139,"(4.697144,-74.140516)"
2014,Agosto,Japón,392,4,1,,5,"(6.171601,-75.427454)"
2014,Agosto,Jordania,400,6,4,,10,"(4.697144,-74.140516)"
2014,Agosto,Kazajistán,398,3,5,,8,"(4.697144,-74.140516)"
2014,Agosto,Kenia,404,1,5,,6,"(4.697144,-74.140516)"
2014,Agosto,Kenia,404,3,2,,5,"(6.171601,-75.427454)"
2014,Agosto,Kirguistán,417,1,2,,3,"(6.171601,-75.427454)"
2014,Agosto,Kuwait,414,1,4,,5,"(4.697144,-74.140516)"
2014,Agosto,Lituania,440,1,3,,4,"(4.697144,-74.140516)"
2014,Agosto,Líbano,422,26,33,,59,"(4.697144,-74.140516)"
2014,Agosto,Liechtenstein,438,0,1,,1,"(4.697144,-74.140516)"
2014,Agosto,Luxemburgo,442,8,0,,8,"(4.697144,-74.140516)"
2014,Agosto,Malasia,458,15,24,,39,"(4.697144,-74.140516)"
2014,Agosto,Malawi,454,2,2,,4,"(4.697144,-74.140516)"
2014,Agosto,Malí,466,3,0,,3,"(4.697144,-74.140516)"
2014,Agosto,Malta,470,10,7,,17,"(4.697144,-74.140516)"
2014,Agosto,Marruecos,504,9,8,,17,"(4.697144,-74.140516)"
2014,Agosto,Marruecos,504,0,1,,1,"(6.171601,-75.427454)"
2014,Agosto,Martinica/Departamento de Ultramar Francés,474,1,0,,1,"(3.541112,-76.384584)"
2014,Agosto,Martinica/Departamento de Ultramar Francés,474,1,0,,1,"(4.697144,-74.140516)"
2014,Agosto,México,484,0,1,,1,"(0.814836,-77.662532)"
2014,Agosto,México,484,53,52,,105,"(10.445761,-75.516429)"
2014,Agosto,México,484,136,93,,229,"(10.886611,-74.776708)"
2014,Agosto,México,484,22,34,,56,"(12.586067,-81.702563)"
2014,Agosto,México,484,808,645,,1453,"(3.541112,-76.384584)"
2014,Agosto,México,484,11672,10431,,22103,"(4.697144,-74.140516)"
2014,Agosto,México,484,116,111,,227,"(4.815061,-75.736532)"
2014,Agosto,México,484,1408,1054,,2462,"(6.171601,-75.427454)"
2014,Agosto,México,484,127,95,,222,"(7.128456,-73.183637)"
2014,Agosto,México,484,98,75,,173,"(7.927209,-72.507910)"
2014,Agosto,República de Moldavia,498,1,0,,1,"(10.445761,-75.516429)"
2014,Agosto,Mónaco,492,0,1,,1,"(4.697144,-74.140516)"
2014,Agosto,Mozambique,508,1,0,,1,"(4.697144,-74.140516)"
2014,Agosto,Nicaragua,558,3,6,,9,"(10.445761,-75.516429)"
2014,Agosto,Nicaragua,558,3,4,,7,"(10.886611,-74.776708)"
2014,Agosto,Nicaragua,558,3,0,,3,"(12.586067,-81.702563)"
2014,Agosto,Nicaragua,558,3,8,,11,"(3.541112,-76.384584)"
2014,Agosto,Nicaragua,558,36,42,,78,"(4.697144,-74.140516)"
2014,Agosto,Nicaragua,558,1,2,,3,"(4.815061,-75.736532)"
2014,Agosto,Nicaragua,558,10,35,,45,"(6.171601,-75.427454)"
2014,Agosto,Nicaragua,558,0,1,,1,"(7.128456,-73.183637)"
2014,Agosto,Nicaragua,558,2,1,,3,"(7.927209,-72.507910)"
2014,Agosto,Nigeria,566,0,15,,15,"(4.697144,-74.140516)"
2014,Agosto,Noruega,578,2,1,,3,"(10.445761,-75.516429)"
2014,Agosto,Noruega,578,0,2,,2,"(3.541112,-76.384584)"
2014,Agosto,Noruega,578,23,23,,46,"(4.697144,-74.140516)"
2014,Agosto,Noruega,578,6,5,,11,"(6.171601,-75.427454)"
2014,Agosto,Nueva Zelanda,554,26,26,,52,"(4.697144,-74.140516)"
2014,Agosto,Nueva Zelanda,554,3,1,,4,"(6.171601,-75.427454)"
2014,Agosto,Nueva Zelanda,554,1,1,,2,"(7.128456,-73.183637)"
2014,Agosto,Omán,512,1,0,,1,"(10.445761,-75.516429)"
2014,Agosto,Omán,512,2,0,,2,"(3.541112,-76.384584)"
2014,Agosto,Omán,512,8,9,,17,"(4.697144,-74.140516)"
2014,Agosto,Omán,512,3,3,,6,"(6.171601,-75.427454)"
2014,Agosto,Pakistán,586,1,2,,3,"(4.697144,-74.140516)"
2014,Agosto,Pakistán,586,0,1,,1,"(6.171601,-75.427454)"
2014,Agosto,Panamá,591,77,162,,239,"(10.408582,-75.538003)"
2014,Agosto,Panamá,591,401,378,,779,"(10.445761,-75.516429)"
2014,Agosto,Panamá,591,924,968,,1892,"(10.886611,-74.776708)"
2014,Agosto,Panamá,591,1,8,,9,"(11.247723,-74.213989)"
2014,Agosto,Panamá,591,200,216,,416,"(12.586067,-81.702563)"
2014,Agosto,Panamá,591,2554,2154,,4708,"(3.541112,-76.384584)"
2014,Agosto,Panamá,591,12161,11652,,23813,"(4.697144,-74.140516)"
2014,Agosto,Panamá,591,724,582,,1306,"(4.815061,-75.736532)"
2014,Agosto,Panamá,591,5032,4379,,9411,"(6.171601,-75.427454)"
2014,Agosto,Panamá,591,1,2,,3,"(6.228046,-77.404104)"
2014,Agosto,Panamá,591,11,24,,35,"(7.102626,-77.762647)"
2014,Agosto,Panamá,591,339,319,,658,"(7.128456,-73.183637)"
2014,Agosto,Panamá,591,227,194,,421,"(7.927209,-72.507910)"
2014,Agosto,Panamá,591,1,132,,133,"(8.066966,-76.735404)"
2014,Agosto,Panamá,591,53,110,,163,"(8.635765,-77.346578)"
2014,Agosto,Paraguay,600,0,2,,2,"(0.814836,-77.662532)"
2014,Agosto,Paraguay,600,1,2,,3,"(10.445761,-75.516429)"
2014,Agosto,Paraguay,600,7,10,,17,"(3.541112,-76.384584)"
2014,Agosto,Paraguay,600,42,133,,175,"(4.697144,-74.140516)"
2014,Agosto,Paraguay,600,2,1,,3,"(4.815061,-75.736532)"
2014,Agosto,Paraguay,600,9,25,,34,"(6.171601,-75.427454)"
2014,Agosto,Perú,604,59,101,,160,"(-4.197703,-69.941278)"
2014,Agosto,Perú,604,0,1,,1,"(-4.223468,-69.945098)"
2014,Agosto,Perú,604,72,250,,322,"(0.814836,-77.662532)"
2014,Agosto,Perú,604,0,6,,6,"(10.408582,-75.538003)"
2014,Agosto,Perú,604,1,6,,7,"(10.445761,-75.516429)"
2014,Agosto,Perú,604,27,30,,57,"(10.886611,-74.776708)"
2014,Agosto,Perú,604,3,6,,9,"(12.586067,-81.702563)"
2014,Agosto,Perú,604,313,438,,751,"(3.541112,-76.384584)"
2014,Agosto,Perú,604,3909,4731,,8640,"(4.697144,-74.140516)"
2014,Agosto,Perú,604,13,18,,31,"(4.815061,-75.736532)"
2014,Agosto,Perú,604,539,600,,1139,"(6.171601,-75.427454)"
2014,Agosto,Perú,604,5,7,,12,"(7.128456,-73.183637)"
2014,Agosto,Perú,604,0,2,,2,"(7.927209,-72.507910)"
2014,Agosto,Palestina,99999,0,1,,1,"(4.697144,-74.140516)"
2014,Agosto,Polonia,616,16,10,,26,"(4.697144,-74.140516)"
2014,Agosto,Portugal,620,0,1,,1,"(10.886611,-74.776708)"
2014,Agosto,Portugal,620,214,150,,364,"(4.697144,-74.140516)"
2014,Agosto,Portugal,620,1,1,,2,"(4.815061,-75.736532)"
2014,Agosto,Portugal,620,3,1,,4,"(6.171601,-75.427454)"
2014,Agosto,Polinesia Francesa/Colectividad de Ultramar Francesa,258,1,0,,1,"(4.697144,-74.140516)"
2014,Agosto,Puerto Rico/Territorio de Estados Unidos,630,7,7,,14,"(10.445761,-75.516429)"
2014,Agosto,Puerto Rico/Territorio de Estados Unidos,630,15,13,,28,"(10.886611,-74.776708)"
2014,Agosto,Puerto Rico/Territorio de Estados Unidos,630,0,1,,1,"(12.586067,-81.702563)"
2014,Agosto,Puerto Rico/Territorio de Estados Unidos,630,38,34,,72,"(3.541112,-76.384584)"
2014,Agosto,Puerto Rico/Territorio de Estados Unidos,630,517,482,,999,"(4.697144,-74.140516)"
2014,Agosto,Puerto Rico/Territorio de Estados Unidos,630,7,6,,13,"(4.815061,-75.736532)"
2014,Agosto,Puerto Rico/Territorio de Estados Unidos,630,46,35,,81,"(6.171601,-75.427454)"
2014,Agosto,Puerto Rico/Territorio de Estados Unidos,630,7,6,,13,"(7.128456,-73.183637)"
2014,Agosto,Puerto Rico/Territorio de Estados Unidos,630,1,3,,4,"(7.927209,-72.507910)"
2014,Agosto,Qatar,634,2,0,,2,"(10.445761,-75.516429)"
2014,Agosto,Qatar,634,18,9,,27,"(4.697144,-74.140516)"
2014,Agosto,Qatar,634,2,3,,5,"(6.171601,-75.427454)"
2014,Agosto,Reino Unido de Gran Bretaña e Irlanda del Norte,826,0,2,,2,"(10.445761,-75.516429)"
2014,Agosto,Reino Unido de Gran Bretaña e Irlanda del Norte,826,3,1,,4,"(10.886611,-74.776708)"
2014,Agosto,Reino Unido de Gran Bretaña e Irlanda del Norte,826,0,1,,1,"(12.586067,-81.702563)"
2014,Agosto,Reino Unido de Gran Bretaña e Irlanda del Norte,826,36,21,,57,"(3.541112,-76.384584)"
2014,Agosto,Reino Unido de Gran Bretaña e Irlanda del Norte,826,1755,1170,,2925,"(4.697144,-74.140516)"
2014,Agosto,Reino Unido de Gran Bretaña e Irlanda del Norte,826,31,11,,42,"(6.171601,-75.427454)"
2014,Agosto,República CentroÁfricana,140,1,1,,2,"(4.697144,-74.140516)"
2014,Agosto,Federación de Rusia,643,63,79,,142,"(4.697144,-74.140516)"
2014,Agosto,Federación de Rusia,643,1,0,,1,"(6.171601,-75.427454)"
2014,Agosto,República Dominicana,214,11,40,,51,"(10.445761,-75.516429)"
2014,Agosto,República Dominicana,214,31,23,,54,"(10.886611,-74.776708)"
2014,Agosto,República Dominicana,214,1,7,,8,"(12.586067,-81.702563)"
2014,Agosto,República Dominicana,214,72,68,,140,"(3.541112,-76.384584)"
2014,Agosto,República Dominicana,214,2479,2271,,4750,"(4.697144,-74.140516)"
2014,Agosto,República Dominicana,214,24,21,,45,"(4.815061,-75.736532)"
2014,Agosto,República Dominicana,214,121,92,,213,"(6.171601,-75.427454)"
2014,Agosto,República Dominicana,214,13,10,,23,"(7.128456,-73.183637)"
2014,Agosto,República Dominicana,214,8,1,,9,"(7.927209,-72.507910)"
2014,Agosto,Reunión,638,0,1,,1,"(4.697144,-74.140516)"
2014,Agosto,República Democrática Popular de Corea,408,0,2,,2,"(4.697144,-74.140516)"
2014,Agosto,Rumania,642,6,3,,9,"(4.697144,-74.140516)"
2014,Agosto,Rwanda,646,1,0,,1,"(4.697144,-74.140516)"
2014,Agosto,Samoa Occidental,882,0,1,,1,"(6.171601,-75.427454)"
2014,Agosto,San  Vicente y las Granadinas,670,1,0,,1,"(4.697144,-74.140516)"
2014,Agosto,Santa Lucia,662,0,1,,1,"(4.697144,-74.140516)"
2014,Agosto,Santa Sede/Ciudad del Vaticano,336,0,1,,1,"(4.697144,-74.140516)"
2014,Agosto,Santo Tomé y Príncipe,678,0,1,,1,"(10.445761,-75.516429)"
2014,Agosto,Senegal,686,1,2,,3,"(4.697144,-74.140516)"
2014,Agosto,Serbia,688,2,2,,4,"(4.697144,-74.140516)"
2014,Agosto,Singapur,702,11,14,,25,"(4.697144,-74.140516)"
2014,Agosto,Singapur,702,1,0,,1,"(6.171601,-75.427454)"
2014,Agosto,Sri Lanka,144,1,0,,1,"(6.171601,-75.427454)"
2014,Agosto,Sudáfrica,710,19,17,,36,"(4.697144,-74.140516)"
2014,Agosto,Sudán,736,0,2,,2,"(4.697144,-74.140516)"
2014,Agosto,Suecia,752,2,0,,2,"(10.445761,-75.516429)"
2014,Agosto,Suecia,752,1,0,,1,"(10.886611,-74.776708)"
2014,Agosto,Suecia,752,4,3,,7,"(3.541112,-76.384584)"
2014,Agosto,Suecia,752,88,66,,154,"(4.697144,-74.140516)"
2014,Agosto,Suecia,752,16,6,,22,"(6.171601,-75.427454)"
2014,Agosto,Suiza,756,1,0,,1,"(0.814836,-77.662532)"
2014,Agosto,Suiza,756,3,6,,9,"(10.886611,-74.776708)"
2014,Agosto,Suiza,756,30,16,,46,"(3.541112,-76.384584)"
2014,Agosto,Suiza,756,389,276,,665,"(4.697144,-74.140516)"
2014,Agosto,Suiza,756,21,10,,31,"(6.171601,-75.427454)"
2014,Agosto,Surinam,740,6,8,,14,"(4.697144,-74.140516)"
2014,Agosto,Surinam,740,0,5,,5,"(6.171601,-75.427454)"
2014,Agosto,Taiwán,158,1,0,,1,"(10.886611,-74.776708)"
2014,Agosto,Taiwán,158,10,6,,16,"(4.697144,-74.140516)"
2014,Agosto,Taiwán,158,0,2,,2,"(6.171601,-75.427454)"
2014,Agosto,Tailandia,764,0,1,,1,"(3.541112,-76.384584)"
2014,Agosto,Tailandia,764,13,17,,30,"(4.697144,-74.140516)"
2014,Agosto,Tailandia,764,1,1,,2,"(6.171601,-75.427454)"
2014,Agosto,Tanzania,834,3,2,,5,"(4.697144,-74.140516)"
2014,Agosto,Trinidad y Tobago,780,2,6,,8,"(10.445761,-75.516429)"
2014,Agosto,Trinidad y Tobago,780,1,0,,1,"(10.886611,-74.776708)"
2014,Agosto,Trinidad y Tobago,780,10,10,,20,"(3.541112,-76.384584)"
2014,Agosto,Trinidad y Tobago,780,30,39,,69,"(4.697144,-74.140516)"
2014,Agosto,Trinidad y Tobago,780,4,1,,5,"(4.815061,-75.736532)"
2014,Agosto,Trinidad y Tobago,780,8,26,,34,"(6.171601,-75.427454)"
2014,Agosto,Trinidad y Tobago,780,2,4,,6,"(7.128456,-73.183637)"
2014,Agosto,Trinidad y Tobago,780,2,0,,2,"(7.927209,-72.507910)"
2014,Agosto,Túnez,788,1,2,,3,"(4.697144,-74.140516)"
2014,Agosto,Turquía,792,1,3,,4,"(3.541112,-76.384584)"
2014,Agosto,Turquía,792,103,83,,186,"(4.697144,-74.140516)"
2014,Agosto,Turquía,792,3,2,,5,"(6.171601,-75.427454)"
2014,Agosto,Ucrania,804,2,2,,4,"(4.697144,-74.140516)"
2014,Agosto,Uruguay,858,0,2,,2,"(0.814836,-77.662532)"
2014,Agosto,Uruguay,858,2,1,,3,"(10.445761,-75.516429)"
2014,Agosto,Uruguay,858,1,1,,2,"(10.886611,-74.776708)"
2014,Agosto,Uruguay,858,9,8,,17,"(3.541112,-76.384584)"
2014,Agosto,Uruguay,858,53,78,,131,"(4.697144,-74.140516)"
2014,Agosto,Uruguay,858,16,11,,27,"(6.171601,-75.427454)"
2014,Agosto,Uruguay,858,1,0,,1,"(7.128456,-73.183637)"
2014,Agosto,Venezuela,862,0,1,,1,"(10.408582,-75.538003)"
2014,Agosto,Venezuela,862,4,4,,8,"(10.445761,-75.516429)"
2014,Agosto,Venezuela,862,2,19,,21,"(10.886611,-74.776708)"
2014,Agosto,Venezuela,862,0,1,,1,"(11.117806,-74.232622)"
2014,Agosto,Venezuela,862,8795,7076,,15871,"(11.360009,-72.129330)"
2014,Agosto,Venezuela,862,0,1,,1,"(12.586067,-81.702563)"
2014,Agosto,Venezuela,862,8,9,,17,"(3.541112,-76.384584)"
2014,Agosto,Venezuela,862,1027,1235,,2262,"(4.697144,-74.140516)"
2014,Agosto,Venezuela,862,1,3,,4,"(4.815061,-75.736532)"
2014,Agosto,Venezuela,862,33,60,,93,"(6.171601,-75.427454)"
2014,Agosto,Venezuela,862,162,193,,355,"(6.185799,-67.483929)"
2014,Agosto,Venezuela,862,2590,2072,,4662,"(7.088729,-70.740253)"
2014,Agosto,Venezuela,862,13,13,,26,"(7.128456,-73.183637)"
2014,Agosto,Venezuela,862,6447,6342,,12789,"(7.818934,-72.453226)"
2014,Agosto,Venezuela,862,79,75,,154,"(7.927209,-72.507910)"
2014,Agosto,Vietnam,704,7,7,,14,"(4.697144,-74.140516)"
2014,Agosto,Islas Vírgenes Británicas/Territorio Británico de Ultramar,92,1,1,,2,"(3.541112,-76.384584)"
2014,Agosto,Islas Vírgenes Estadounidenses/Territorio de Estados Unidos,850,0,1,,1,"(3.541112,-76.384584)"
2014,Agosto,Desconocido,99999,2,24,,26,"(12.5744111,-81.703935)"
2014,Agosto,Desconocido,99999,0,4,,4,"(12.586067,-81.702563)"
2014,Agosto,Desconocido,99999,1,1,,2,"(3.541112,-76.384584)"
2014,Agosto,Desconocido,99999,815,892,,1707,"(4.697144,-74.140516)"
2014,Agosto,Desconocido,99999,1,1,,2,"(6.185799,-67.483929)"
2014,Septiembre,Afganistán,4,0,10,,10,"(4.697144,-74.140516)"
2014,Septiembre,Afganistán,4,1,0,,1,"(6.171601,-75.427454)"
2014,Septiembre,Albania,8,2,1,,3,"(4.697144,-74.140516)"
2014,Septiembre,Alemania,276,1,0,,1,"(0.814836,-77.662532)"
2014,Septiembre,Alemania,276,5,2,,7,"(10.445761,-75.516429)"
2014,Septiembre,Alemania,276,4,3,,7,"(10.886611,-74.776708)"
2014,Septiembre,Alemania,276,19,13,,32,"(3.541112,-76.384584)"
2014,Septiembre,Alemania,276,1688,1582,,3270,"(4.697144,-74.140516)"
2014,Septiembre,Alemania,276,1,0,,1,"(4.815061,-75.736532)"
2014,Septiembre,Alemania,276,20,19,,39,"(6.171601,-75.427454)"
2014,Septiembre,Andorra,20,1,0,,1,"(4.697144,-74.140516)"
2014,Septiembre,Angola,24,4,8,,12,"(4.697144,-74.140516)"
2014,Septiembre,Antigua y Barbuda,28,1,0,,1,"(4.697144,-74.140516)"
2014,Septiembre,Países Bajos,528,39,32,,71,"(10.408582,-75.538003)"
2014,Septiembre,Países Bajos,528,3,0,,3,"(10.445761,-75.516429)"
2014,Septiembre,Países Bajos,528,1,1,,2,"(10.886611,-74.776708)"
2014,Septiembre,Países Bajos,528,24,4,,28,"(3.541112,-76.384584)"
2014,Septiembre,Países Bajos,528,128,124,,252,"(4.697144,-74.140516)"
2014,Septiembre,Países Bajos,528,3,1,,4,"(4.815061,-75.736532)"
2014,Septiembre,Países Bajos,528,33,12,,45,"(6.171601,-75.427454)"
2014,Septiembre,Países Bajos,528,0,1,,1,"(7.927209,-72.507910)"
2014,Septiembre,Arabia Saudita,682,3,0,,3,"(10.445761,-75.516429)"
2014,Septiembre,Arabia Saudita,682,0,1,,1,"(10.886611,-74.776708)"
2014,Septiembre,Arabia Saudita,682,10,31,,41,"(4.697144,-74.140516)"
2014,Septiembre,Arabia Saudita,682,2,3,,5,"(6.171601,-75.427454)"
2014,Septiembre,Argelia,12,2,2,,4,"(4.697144,-74.140516)"
2014,Septiembre,Argelia,12,0,1,,1,"(6.171601,-75.427454)"
2014,Septiembre,Argentina,32,22,31,,53,"(0.814836,-77.662532)"
2014,Septiembre,Argentina,32,5,5,,10,"(10.445761,-75.516429)"
2014,Septiembre,Argentina,32,23,29,,52,"(10.886611,-74.776708)"
2014,Septiembre,Argentina,32,3,2,,5,"(12.586067,-81.702563)"
2014,Septiembre,Argentina,32,174,142,,316,"(3.541112,-76.384584)"
2014,Septiembre,Argentina,32,2261,2274,,4535,"(4.697144,-74.140516)"
2014,Septiembre,Argentina,32,12,14,,26,"(4.815061,-75.736532)"
2014,Septiembre,Argentina,32,267,273,,540,"(6.171601,-75.427454)"
2014,Septiembre,Argentina,32,16,11,,27,"(7.128456,-73.183637)"
2014,Septiembre,Argentina,32,1,0,,1,"(7.927209,-72.507910)"
2014,Septiembre,Aruba,533,1405,877,,2282,"(10.408582,-75.538003)"
2014,Septiembre,Aruba,533,1,0,,1,"(10.445761,-75.516429)"
2014,Septiembre,Aruba,533,14,8,,22,"(10.886611,-74.776708)"
2014,Septiembre,Aruba,533,0,3,,3,"(11.247723,-74.213989)"
2014,Septiembre,Aruba,533,1,0,,1,"(12.586067,-81.702563)"
2014,Septiembre,Aruba,533,10,10,,20,"(3.541112,-76.384584)"
2014,Septiembre,Aruba,533,1255,957,,2212,"(4.697144,-74.140516)"
2014,Septiembre,Aruba,533,9,7,,16,"(4.815061,-75.736532)"
2014,Septiembre,Aruba,533,46,29,,75,"(6.171601,-75.427454)"
2014,Septiembre,Aruba,533,16,29,,45,"(7.128456,-73.183637)"
2014,Septiembre,Aruba,533,2,6,,8,"(7.927209,-72.507910)"
2014,Septiembre,Australia,36,2,1,,3,"(10.445761,-75.516429)"
2014,Septiembre,Australia,36,8,7,,15,"(3.541112,-76.384584)"
2014,Septiembre,Australia,36,126,117,,243,"(4.697144,-74.140516)"
2014,Septiembre,Australia,36,2,1,,3,"(4.815061,-75.736532)"
2014,Septiembre,Australia,36,15,15,,30,"(6.171601,-75.427454)"
2014,Septiembre,Australia,36,2,3,,5,"(7.128456,-73.183637)"
2014,Septiembre,Australia,36,3,1,,4,"(7.927209,-72.507910)"
2014,Septiembre,Austria,40,1,0,,1,"(10.445761,-75.516429)"
2014,Septiembre,Austria,40,1,0,,1,"(3.541112,-76.384584)"
2014,Septiembre,Austria,40,52,59,,111,"(4.697144,-74.140516)"
2014,Septiembre,Austria,40,1,2,,3,"(6.171601,-75.427454)"
2014,Septiembre,Azerbaiyán,31,3,7,,10,"(4.697144,-74.140516)"
2014,Septiembre,Bahamas,44,1,1,,2,"(10.445761,-75.516429)"
2014,Septiembre,Bahamas,44,4,3,,7,"(10.886611,-74.776708)"
2014,Septiembre,Bahamas,44,6,2,,8,"(3.541112,-76.384584)"
2014,Septiembre,Bahamas,44,7,14,,21,"(4.697144,-74.140516)"
2014,Septiembre,Bahamas,44,1,1,,2,"(4.815061,-75.736532)"
2014,Septiembre,Bahamas,44,22,14,,36,"(6.171601,-75.427454)"
2014,Septiembre,Bahamas,44,1,1,,2,"(7.128456,-73.183637)"
2014,Septiembre,Bahamas,44,0,6,,6,"(7.927209,-72.507910)"
2014,Septiembre,Bahréin,48,1,0,,1,"(11.360009,-72.129330)"
2014,Septiembre,Bahréin,48,0,1,,1,"(4.697144,-74.140516)"
2014,Septiembre,Barbados,52,1,3,,4,"(4.697144,-74.140516)"
2014,Septiembre,Barbados,52,1,0,,1,"(6.171601,-75.427454)"
2014,Septiembre,Barbados,52,1,0,,1,"(7.128456,-73.183637)"
2014,Septiembre,República de Belarús,112,3,1,,4,"(11.360009,-72.129330)"
2014,Septiembre,República de Belarús,112,0,2,,2,"(4.697144,-74.140516)"
2014,Septiembre,Bélgica,56,3,2,,5,"(3.541112,-76.384584)"
2014,Septiembre,Bélgica,56,72,75,,147,"(4.697144,-74.140516)"
2014,Septiembre,Bélgica,56,9,10,,19,"(6.171601,-75.427454)"
2014,Septiembre,Belice,84,0,7,,7,"(4.697144,-74.140516)"
2014,Septiembre,Belice,84,0,1,,1,"(6.171601,-75.427454)"
2014,Septiembre,Bermudas/Territorio Británico de Ultramar,60,1,0,,1,"(3.541112,-76.384584)"
2014,Septiembre,Bermudas/Territorio Británico de Ultramar,60,0,2,,2,"(4.697144,-74.140516)"
2014,Septiembre,Bolivia,68,7,9,,16,"(0.814836,-77.662532)"
2014,Septiembre,Bolivia,68,1,2,,3,"(10.886611,-74.776708)"
2014,Septiembre,Bolivia,68,28,36,,64,"(3.541112,-76.384584)"
2014,Septiembre,Bolivia,68,238,376,,614,"(4.697144,-74.140516)"
2014,Septiembre,Bolivia,68,3,4,,7,"(4.815061,-75.736532)"
2014,Septiembre,Bolivia,68,23,47,,70,"(6.171601,-75.427454)"
2014,Septiembre,Brasil,76,70,167,,237,"(-4.197703,-69.941278)"
2014,Septiembre,Brasil,76,2,3,,5,"(0.814836,-77.662532)"
2014,Septiembre,Brasil,76,5,7,,12,"(10.445761,-75.516429)"
2014,Septiembre,Brasil,76,3,11,,14,"(10.886611,-74.776708)"
2014,Septiembre,Brasil,76,1,0,,1,"(12.586067,-81.702563)"
2014,Septiembre,Brasil,76,53,76,,129,"(3.541112,-76.384584)"
2014,Septiembre,Brasil,76,2377,3120,,5497,"(4.697144,-74.140516)"
2014,Septiembre,Brasil,76,4,6,,10,"(4.815061,-75.736532)"
2014,Septiembre,Brasil,76,84,134,,218,"(6.171601,-75.427454)"
2014,Septiembre,Brasil,76,0,5,,5,"(7.128456,-73.183637)"
2014,Septiembre,Brasil,76,0,1,,1,"(7.927209,-72.507910)"
2014,Septiembre,Brunei Darussalam,96,1,0,,1,"(4.697144,-74.140516)"
2014,Septiembre,Bulgaria,100,1,5,,6,"(4.697144,-74.140516)"
2014,Septiembre,Burundi,108,1,0,,1,"(4.697144,-74.140516)"
2014,Septiembre,Cabo Verde,132,1,0,,1,"(4.697144,-74.140516)"
2014,Septiembre,Islas Caimán/Territorio Británico de Ultramar,136,1,0,,1,"(10.445761,-75.516429)"
2014,Septiembre,Islas Caimán/Territorio Británico de Ultramar,136,1,0,,1,"(10.886611,-74.776708)"
2014,Septiembre,Islas Caimán/Territorio Británico de Ultramar,136,5,2,,7,"(12.586067,-81.702563)"
2014,Septiembre,Islas Caimán/Territorio Británico de Ultramar,136,0,1,,1,"(3.541112,-76.384584)"
2014,Septiembre,Islas Caimán/Territorio Británico de Ultramar,136,1,0,,1,"(4.697144,-74.140516)"
2014,Septiembre,Islas Caimán/Territorio Británico de Ultramar,136,2,0,,2,"(6.171601,-75.427454)"
2014,Septiembre,Camboya,116,1,2,,3,"(4.697144,-74.140516)"
2014,Septiembre,Camboya,116,1,0,,1,"(6.171601,-75.427454)"
2014,Septiembre,Camerún,120,1,4,,5,"(4.697144,-74.140516)"
2014,Septiembre,Canadá,124,14,11,,25,"(10.445761,-75.516429)"
2014,Septiembre,Canadá,124,16,8,,24,"(10.886611,-74.776708)"
2014,Septiembre,Canadá,124,0,1,,1,"(12.586067,-81.702563)"
2014,Septiembre,Canadá,124,115,87,,202,"(3.541112,-76.384584)"
2014,Septiembre,Canadá,124,2,0,,2,"(4.452882,-75.766298)"
2014,Septiembre,Canadá,124,1439,1204,,2643,"(4.697144,-74.140516)"
2014,Septiembre,Canadá,124,17,13,,30,"(4.815061,-75.736532)"
2014,Septiembre,Canadá,124,201,180,,381,"(6.171601,-75.427454)"
2014,Septiembre,Canadá,124,17,20,,37,"(7.128456,-73.183637)"
2014,Septiembre,Canadá,124,1,0,,1,"(7.927209,-72.507910)"
2014,Septiembre,España,724,0,1,,1,"(0.814836,-77.662532)"
2014,Septiembre,España,724,6,5,,11,"(10.445761,-75.516429)"
2014,Septiembre,España,724,4,6,,10,"(10.886611,-74.776708)"
2014,Septiembre,España,724,0,1,,1,"(12.586067,-81.702563)"
2014,Septiembre,España,724,1357,879,,2236,"(3.541112,-76.384584)"
2014,Septiembre,España,724,9309,7006,,16315,"(4.697144,-74.140516)"
2014,Septiembre,España,724,1,1,,2,"(4.815061,-75.736532)"
2014,Septiembre,España,724,788,572,,1360,"(6.171601,-75.427454)"
2014,Septiembre,España,724,1,1,,2,"(7.128456,-73.183637)"
2014,Septiembre,Colombia,170,319,399,,718,"(4.697144,-74.140516)"
2014,Septiembre,República Democrática del Congo,180,1,2,,3,"(4.697144,-74.140516)"
2014,Septiembre,República de Corea,410,1,2,,3,"(3.541112,-76.384584)"
2014,Septiembre,República de Corea,410,28,34,,62,"(4.697144,-74.140516)"
2014,Septiembre,República de Corea,410,4,3,,7,"(6.171601,-75.427454)"
2014,Septiembre,Costa de Marfil,384,2,6,,8,"(4.697144,-74.140516)"
2014,Septiembre,Costa de Marfil,384,2,0,,2,"(6.171601,-75.427454)"
2014,Septiembre,Costa Rica,188,8,13,,21,"(10.445761,-75.516429)"
2014,Septiembre,Costa Rica,188,8,23,,31,"(10.886611,-74.776708)"
2014,Septiembre,Costa Rica,188,3,3,,6,"(12.586067,-81.702563)"
2014,Septiembre,Costa Rica,188,0,7,,7,"(13.3387613,-81.372937)"
2014,Septiembre,Costa Rica,188,39,61,,100,"(3.541112,-76.384584)"
2014,Septiembre,Costa Rica,188,759,909,,1668,"(4.697144,-74.140516)"
2014,Septiembre,Costa Rica,188,13,18,,31,"(4.815061,-75.736532)"
2014,Septiembre,Costa Rica,188,80,115,,195,"(6.171601,-75.427454)"
2014,Septiembre,Costa Rica,188,2,2,,4,"(7.128456,-73.183637)"
2014,Septiembre,Costa Rica,188,3,1,,4,"(7.927209,-72.507910)"
2014,Septiembre,Croacia,191,7,0,,7,"(4.697144,-74.140516)"
2014,Septiembre,Cuba,192,10,17,,27,"(10.445761,-75.516429)"
2014,Septiembre,Cuba,192,57,57,,114,"(10.886611,-74.776708)"
2014,Septiembre,Cuba,192,148,146,,294,"(3.541112,-76.384584)"
2014,Septiembre,Cuba,192,1221,1038,,2259,"(4.697144,-74.140516)"
2014,Septiembre,Cuba,192,25,33,,58,"(4.815061,-75.736532)"
2014,Septiembre,Cuba,192,117,89,,206,"(6.171601,-75.427454)"
2014,Septiembre,Cuba,192,29,40,,69,"(7.128456,-73.183637)"
2014,Septiembre,Cuba,192,7,8,,15,"(7.927209,-72.507910)"
2014,Septiembre,Curazao,99999,1,1,,2,"(10.445761,-75.516429)"
2014,Septiembre,Curazao,99999,77,42,,119,"(10.886611,-74.776708)"
2014,Septiembre,Curazao,99999,6,4,,10,"(3.541112,-76.384584)"
2014,Septiembre,Curazao,99999,479,454,,933,"(4.697144,-74.140516)"
2014,Septiembre,Curazao,99999,89,56,,145,"(6.171601,-75.427454)"
2014,Septiembre,República Checa,203,12,14,,26,"(4.697144,-74.140516)"
2014,Septiembre,República Checa,203,0,1,,1,"(6.171601,-75.427454)"
2014,Septiembre,Chile,152,77,62,,139,"(0.814836,-77.662532)"
2014,Septiembre,Chile,152,22,14,,36,"(10.445761,-75.516429)"
2014,Septiembre,Chile,152,18,11,,29,"(10.886611,-74.776708)"
2014,Septiembre,Chile,152,3,2,,5,"(12.586067,-81.702563)"
2014,Septiembre,Chile,152,382,322,,704,"(3.541112,-76.384584)"
2014,Septiembre,Chile,152,2855,2511,,5366,"(4.697144,-74.140516)"
2014,Septiembre,Chile,152,69,91,,160,"(4.815061,-75.736532)"
2014,Septiembre,Chile,152,120,112,,232,"(6.171601,-75.427454)"
2014,Septiembre,Chile,152,14,6,,20,"(7.128456,-73.183637)"
2014,Septiembre,Chile,152,0,1,,1,"(7.927209,-72.507910)"
2014,Septiembre,China,156,2,1,,3,"(10.445761,-75.516429)"
2014,Septiembre,China,156,3,4,,7,"(10.886611,-74.776708)"
2014,Septiembre,China,156,2,12,,14,"(3.541112,-76.384584)"
2014,Septiembre,China,156,198,431,,629,"(4.697144,-74.140516)"
2014,Septiembre,China,156,3,4,,7,"(4.815061,-75.736532)"
2014,Septiembre,China,156,19,35,,54,"(6.171601,-75.427454)"
2014,Septiembre,China,156,0,4,,4,"(7.128456,-73.183637)"
2014,Septiembre,Chipre,196,0,1,,1,"(4.697144,-74.140516)"
2014,Septiembre,Dinamarca,208,0,1,,1,"(10.445761,-75.516429)"
2014,Septiembre,Dinamarca,208,0,2,,2,"(3.541112,-76.384584)"
2014,Septiembre,Dinamarca,208,19,22,,41,"(4.697144,-74.140516)"
2014,Septiembre,Dominica,212,1,0,,1,"(4.697144,-74.140516)"
2014,Septiembre,Ecuador,218,547,703,,1250,"(0.25129,-76.875963)"
2014,Septiembre,Ecuador,218,5054,5778,,10832,"(0.814836,-77.662532)"
2014,Septiembre,Ecuador,218,146,178,,324,"(1.813928,-78.763924)"
2014,Septiembre,Ecuador,218,0,9,,9,"(10.408582,-75.538003)"
2014,Septiembre,Ecuador,218,1,3,,4,"(10.445761,-75.516429)"
2014,Septiembre,Ecuador,218,3,23,,26,"(10.886611,-74.776708)"
2014,Septiembre,Ecuador,218,0,1,,1,"(12.586067,-81.702563)"
2014,Septiembre,Ecuador,218,729,723,,1452,"(3.541112,-76.384584)"
2014,Septiembre,Ecuador,218,2312,4140,,6452,"(4.697144,-74.140516)"
2014,Septiembre,Ecuador,218,3,5,,8,"(4.815061,-75.736532)"
2014,Septiembre,Ecuador,218,444,399,,843,"(6.171601,-75.427454)"
2014,Septiembre,Ecuador,218,0,1,,1,"(7.128456,-73.183637)"
2014,Septiembre,Egipto,818,47,31,,78,"(4.697144,-74.140516)"
2014,Septiembre,El Salvador,222,2,2,,4,"(10.445761,-75.516429)"
2014,Septiembre,El Salvador,222,0,3,,3,"(10.886611,-74.776708)"
2014,Septiembre,El Salvador,222,1,1,,2,"(12.586067,-81.702563)"
2014,Septiembre,El Salvador,222,100,103,,203,"(3.541112,-76.384584)"
2014,Septiembre,El Salvador,222,1013,1131,,2144,"(4.697144,-74.140516)"
2014,Septiembre,El Salvador,222,0,1,,1,"(4.815061,-75.736532)"
2014,Septiembre,El Salvador,222,49,109,,158,"(6.171601,-75.427454)"
2014,Septiembre,Emiratos Árabes,784,5,3,,8,"(3.541112,-76.384584)"
2014,Septiembre,Emiratos Árabes,784,115,166,,281,"(4.697144,-74.140516)"
2014,Septiembre,Emiratos Árabes,784,1,6,,7,"(6.171601,-75.427454)"
2014,Septiembre,Eslovaquia,703,0,1,,1,"(10.886611,-74.776708)"
2014,Septiembre,Eslovaquia,703,1,0,,1,"(4.697144,-74.140516)"
2014,Septiembre,Eslovenia,705,2,1,,3,"(4.697144,-74.140516)"
2014,Septiembre,Estados Unidos de América,840,0,1,,1,"(10.408582,-75.538003)"
2014,Septiembre,Estados Unidos de América,840,2396,2074,,4470,"(10.445761,-75.516429)"
2014,Septiembre,Estados Unidos de América,840,1791,1520,,3311,"(10.886611,-74.776708)"
2014,Septiembre,Estados Unidos de América,840,42,72,,114,"(12.586067,-81.702563)"
2014,Septiembre,Estados Unidos de América,840,4833,3606,,8439,"(3.541112,-76.384584)"
2014,Septiembre,Estados Unidos de América,840,618,447,,1065,"(4.452882,-75.766298)"
2014,Septiembre,Estados Unidos de América,840,31360,28585,,59945,"(4.697144,-74.140516)"
2014,Septiembre,Estados Unidos de América,840,985,774,,1759,"(4.815061,-75.736532)"
2014,Septiembre,Estados Unidos de América,840,8466,6764,,15230,"(6.171601,-75.427454)"
2014,Septiembre,Estados Unidos de América,840,171,127,,298,"(7.128456,-73.183637)"
2014,Septiembre,Estados Unidos de América,840,104,97,,201,"(7.927209,-72.507910)"
2014,Septiembre,Estonia,233,1,6,,7,"(4.697144,-74.140516)"
2014,Septiembre,Etiopia,231,0,7,,7,"(4.697144,-74.140516)"
2014,Septiembre,Filipinas,608,0,1,,1,"(3.541112,-76.384584)"
2014,Septiembre,Filipinas,608,3,2,,5,"(4.697144,-74.140516)"
2014,Septiembre,Finlandia,246,20,7,,27,"(4.697144,-74.140516)"
2014,Septiembre,Finlandia,246,1,0,,1,"(6.171601,-75.427454)"
2014,Septiembre,Francia,250,4,2,,6,"(10.445761,-75.516429)"
2014,Septiembre,Francia,250,6,3,,9,"(10.886611,-74.776708)"
2014,Septiembre,Francia,250,39,35,,74,"(3.541112,-76.384584)"
2014,Septiembre,Francia,250,1622,1261,,2883,"(4.697144,-74.140516)"
2014,Septiembre,Francia,250,1,0,,1,"(4.815061,-75.736532)"
2014,Septiembre,Francia,250,61,46,,107,"(6.171601,-75.427454)"
2014,Septiembre,Francia,250,1,0,,1,"(7.128456,-73.183637)"
2014,Septiembre,Francia,250,1,1,,2,"(7.927209,-72.507910)"
2014,Septiembre,Gabón,266,0,7,,7,"(4.697144,-74.140516)"
2014,Septiembre,Georgia,268,1,1,,2,"(4.697144,-74.140516)"
2014,Septiembre,Ghana,288,0,1,,1,"(4.697144,-74.140516)"
2014,Septiembre,Grecia,300,27,18,,45,"(4.697144,-74.140516)"
2014,Septiembre,Grecia,300,1,1,,2,"(6.171601,-75.427454)"
2014,Septiembre,Guatemala,320,2,4,,6,"(10.445761,-75.516429)"
2014,Septiembre,Guatemala,320,4,14,,18,"(10.886611,-74.776708)"
2014,Septiembre,Guatemala,320,1,2,,3,"(12.586067,-81.702563)"
2014,Septiembre,Guatemala,320,45,60,,105,"(3.541112,-76.384584)"
2014,Septiembre,Guatemala,320,426,547,,973,"(4.697144,-74.140516)"
2014,Septiembre,Guatemala,320,6,6,,12,"(4.815061,-75.736532)"
2014,Septiembre,Guatemala,320,47,66,,113,"(6.171601,-75.427454)"
2014,Septiembre,Guatemala,320,1,2,,3,"(7.128456,-73.183637)"
2014,Septiembre,Guatemala,320,1,1,,2,"(7.927209,-72.507910)"
2014,Septiembre,Guyana,328,3,2,,5,"(4.697144,-74.140516)"
2014,Septiembre,Guyana,328,1,1,,2,"(6.171601,-75.427454)"
2014,Septiembre,Guinea,324,1,0,,1,"(0.814836,-77.662532)"
2014,Septiembre,Guinea,324,0,2,,2,"(4.697144,-74.140516)"
2014,Septiembre,Guinea Ecuatorial,226,0,1,,1,"(3.541112,-76.384584)"
2014,Septiembre,Guinea Ecuatorial,226,3,13,,16,"(4.697144,-74.140516)"
2014,Septiembre,Guadalupe/Territorio Francés,312,0,1,,1,"(10.445761,-75.516429)"
2014,Septiembre,Guadalupe/Territorio Francés,312,1,1,,2,"(4.697144,-74.140516)"
2014,Septiembre,Haití,332,0,7,,7,"(10.886611,-74.776708)"
2014,Septiembre,Haití,332,6,14,,20,"(4.697144,-74.140516)"
2014,Septiembre,Haití,332,1,0,,1,"(4.815061,-75.736532)"
2014,Septiembre,Haití,332,3,4,,7,"(6.171601,-75.427454)"
2014,Septiembre,Honduras,340,0,4,,4,"(10.445761,-75.516429)"
2014,Septiembre,Honduras,340,2,5,,7,"(10.886611,-74.776708)"
2014,Septiembre,Honduras,340,0,1,,1,"(12.586067,-81.702563)"
2014,Septiembre,Honduras,340,14,32,,46,"(3.541112,-76.384584)"
2014,Septiembre,Honduras,340,45,131,,176,"(4.697144,-74.140516)"
2014,Septiembre,Honduras,340,0,2,,2,"(4.815061,-75.736532)"
2014,Septiembre,Honduras,340,28,37,,65,"(6.171601,-75.427454)"
2014,Septiembre,Honduras,340,1,3,,4,"(7.128456,-73.183637)"
2014,Septiembre,Honduras,340,1,1,,2,"(7.927209,-72.507910)"
2014,Septiembre,Hong Kong,344,1,0,,1,"(10.445761,-75.516429)"
2014,Septiembre,Hong Kong,344,0,1,,1,"(10.886611,-74.776708)"
2014,Septiembre,Hong Kong,344,0,1,,1,"(3.541112,-76.384584)"
2014,Septiembre,Hong Kong,344,34,62,,96,"(4.697144,-74.140516)"
2014,Septiembre,Hong Kong,344,1,3,,4,"(6.171601,-75.427454)"
2014,Septiembre,Hong Kong,344,1,0,,1,"(7.927209,-72.507910)"
2014,Septiembre,Hungría,348,4,3,,7,"(4.697144,-74.140516)"
2014,Septiembre,India,356,1,0,,1,"(10.445761,-75.516429)"
2014,Septiembre,India,356,1,3,,4,"(3.541112,-76.384584)"
2014,Septiembre,India,356,46,28,,74,"(4.697144,-74.140516)"
2014,Septiembre,India,356,2,0,,2,"(4.815061,-75.736532)"
2014,Septiembre,India,356,5,4,,9,"(6.171601,-75.427454)"
2014,Septiembre,Indonesia,360,9,5,,14,"(4.697144,-74.140516)"
2014,Septiembre,Iraq,368,1,8,,9,"(4.697144,-74.140516)"
2014,Septiembre,Irán,364,4,1,,5,"(4.697144,-74.140516)"
2014,Septiembre,República de Irlanda,372,13,16,,29,"(4.697144,-74.140516)"
2014,Septiembre,República de Irlanda,372,0,4,,4,"(6.171601,-75.427454)"
2014,Septiembre,Islandia,352,1,4,,5,"(4.697144,-74.140516)"
2014,Septiembre,Israel,376,3,1,,4,"(3.541112,-76.384584)"
2014,Septiembre,Israel,376,136,86,,222,"(4.697144,-74.140516)"
2014,Septiembre,Israel,376,2,1,,3,"(6.171601,-75.427454)"
2014,Septiembre,Italia,380,6,3,,9,"(10.445761,-75.516429)"
2014,Septiembre,Italia,380,4,1,,5,"(10.886611,-74.776708)"
2014,Septiembre,Italia,380,55,43,,98,"(3.541112,-76.384584)"
2014,Septiembre,Italia,380,883,610,,1493,"(4.697144,-74.140516)"
2014,Septiembre,Italia,380,1,0,,1,"(4.815061,-75.736532)"
2014,Septiembre,Italia,380,55,28,,83,"(6.171601,-75.427454)"
2014,Septiembre,Jamaica,388,2,4,,6,"(10.445761,-75.516429)"
2014,Septiembre,Jamaica,388,5,3,,8,"(10.886611,-74.776708)"
2014,Septiembre,Jamaica,388,1,2,,3,"(12.586067,-81.702563)"
2014,Septiembre,Jamaica,388,11,11,,22,"(3.541112,-76.384584)"
2014,Septiembre,Jamaica,388,33,31,,64,"(4.697144,-74.140516)"
2014,Septiembre,Jamaica,388,7,9,,16,"(4.815061,-75.736532)"
2014,Septiembre,Jamaica,388,20,12,,32,"(6.171601,-75.427454)"
2014,Septiembre,Jamaica,388,1,3,,4,"(7.128456,-73.183637)"
2014,Septiembre,Jamaica,388,4,4,,8,"(7.927209,-72.507910)"
2014,Septiembre,Japón,392,0,2,,2,"(10.886611,-74.776708)"
2014,Septiembre,Japón,392,2,2,,4,"(3.541112,-76.384584)"
2014,Septiembre,Japón,392,67,55,,122,"(4.697144,-74.140516)"
2014,Septiembre,Japón,392,3,4,,7,"(6.171601,-75.427454)"
2014,Septiembre,Jordania,400,2,3,,5,"(4.697144,-74.140516)"
2014,Septiembre,Kazajistán,398,0,5,,5,"(4.697144,-74.140516)"
2014,Septiembre,Kenia,404,3,3,,6,"(3.541112,-76.384584)"
2014,Septiembre,Kenia,404,2,5,,7,"(4.697144,-74.140516)"
2014,Septiembre,Kuwait,414,1,1,,2,"(4.697144,-74.140516)"
2014,Septiembre,Letonia,428,0,1,,1,"(4.697144,-74.140516)"
2014,Septiembre,Líbano,422,41,46,,87,"(4.697144,-74.140516)"
2014,Septiembre,Liberia,430,1,0,,1,"(4.697144,-74.140516)"
2014,Septiembre,Luxemburgo,442,2,11,,13,"(4.697144,-74.140516)"
2014,Septiembre,Luxemburgo,442,0,1,,1,"(6.171601,-75.427454)"
2014,Septiembre,Malasia,458,8,9,,17,"(4.697144,-74.140516)"
2014,Septiembre,Malasia,458,0,1,,1,"(4.815061,-75.736532)"
2014,Septiembre,Malasia,458,3,7,,10,"(6.171601,-75.427454)"
2014,Septiembre,Malawi,454,0,1,,1,"(4.697144,-74.140516)"
2014,Septiembre,Malí,466,1,0,,1,"(4.697144,-74.140516)"
2014,Septiembre,Malta,470,10,0,,10,"(4.697144,-74.140516)"
2014,Septiembre,Malta,470,2,0,,2,"(6.171601,-75.427454)"
2014,Septiembre,Marruecos,504,1,1,,2,"(3.541112,-76.384584)"
2014,Septiembre,Marruecos,504,11,13,,24,"(4.697144,-74.140516)"
2014,Septiembre,Mauricio,480,0,1,,1,"(4.697144,-74.140516)"
2014,Septiembre,Mauritania,478,0,2,,2,"(4.697144,-74.140516)"
2014,Septiembre,México,484,0,2,,2,"(0.814836,-77.662532)"
2014,Septiembre,México,484,34,36,,70,"(10.445761,-75.516429)"
2014,Septiembre,México,484,105,98,,203,"(10.886611,-74.776708)"
2014,Septiembre,México,484,19,2,,21,"(12.586067,-81.702563)"
2014,Septiembre,México,484,522,539,,1061,"(3.541112,-76.384584)"
2014,Septiembre,México,484,10858,9876,,20734,"(4.697144,-74.140516)"
2014,Septiembre,México,484,115,101,,216,"(4.815061,-75.736532)"
2014,Septiembre,México,484,1112,846,,1958,"(6.171601,-75.427454)"
2014,Septiembre,México,484,163,127,,290,"(7.128456,-73.183637)"
2014,Septiembre,México,484,121,103,,224,"(7.927209,-72.507910)"
2014,Septiembre,Mónaco,492,1,2,,3,"(4.697144,-74.140516)"
2014,Septiembre,Mongolia,496,0,1,,1,"(4.697144,-74.140516)"
2014,Septiembre,Mozambique,508,1,1,,2,"(4.697144,-74.140516)"
2014,Septiembre,Nicaragua,558,0,4,,4,"(10.445761,-75.516429)"
2014,Septiembre,Nicaragua,558,1,4,,5,"(10.886611,-74.776708)"
2014,Septiembre,Nicaragua,558,0,2,,2,"(12.586067,-81.702563)"
2014,Septiembre,Nicaragua,558,7,9,,16,"(3.541112,-76.384584)"
2014,Septiembre,Nicaragua,558,28,49,,77,"(4.697144,-74.140516)"
2014,Septiembre,Nicaragua,558,1,1,,2,"(4.815061,-75.736532)"
2014,Septiembre,Nicaragua,558,9,27,,36,"(6.171601,-75.427454)"
2014,Septiembre,Nicaragua,558,0,1,,1,"(7.927209,-72.507910)"
2014,Septiembre,Nigeria,566,0,8,,8,"(4.697144,-74.140516)"
2014,Septiembre,Noruega,578,1,0,,1,"(10.886611,-74.776708)"
2014,Septiembre,Noruega,578,10,14,,24,"(4.697144,-74.140516)"
2014,Septiembre,Noruega,578,1,0,,1,"(6.171601,-75.427454)"
2014,Septiembre,Nueva Zelanda,554,0,1,,1,"(3.541112,-76.384584)"
2014,Septiembre,Nueva Zelanda,554,28,22,,50,"(4.697144,-74.140516)"
2014,Septiembre,Nueva Zelanda,554,3,0,,3,"(6.171601,-75.427454)"
2014,Septiembre,Omán,512,5,6,,11,"(4.697144,-74.140516)"
2014,Septiembre,Papúa Nueva Guinea,598,0,1,,1,"(6.171601,-75.427454)"
2014,Septiembre,Pakistán,586,0,1,,1,"(4.697144,-74.140516)"
2014,Septiembre,Panamá,591,1,0,,1,"(0.814836,-77.662532)"
2014,Septiembre,Panamá,591,68,115,,183,"(10.408582,-75.538003)"
2014,Septiembre,Panamá,591,312,342,,654,"(10.445761,-75.516429)"
2014,Septiembre,Panamá,591,745,892,,1637,"(10.886611,-74.776708)"
2014,Septiembre,Panamá,591,164,199,,363,"(12.586067,-81.702563)"
2014,Septiembre,Panamá,591,2008,1813,,3821,"(3.541112,-76.384584)"
2014,Septiembre,Panamá,591,9530,9811,,19341,"(4.697144,-74.140516)"
2014,Septiembre,Panamá,591,525,446,,971,"(4.815061,-75.736532)"
2014,Septiembre,Panamá,591,4283,4111,,8394,"(6.171601,-75.427454)"
2014,Septiembre,Panamá,591,5,13,,18,"(7.102626,-77.762647)"
2014,Septiembre,Panamá,591,334,325,,659,"(7.128456,-73.183637)"
2014,Septiembre,Panamá,591,158,183,,341,"(7.927209,-72.507910)"
2014,Septiembre,Panamá,591,1,117,,118,"(8.066966,-76.735404)"
2014,Septiembre,Panamá,591,36,93,,129,"(8.635765,-77.346578)"
2014,Septiembre,Paraguay,600,0,3,,3,"(0.814836,-77.662532)"
2014,Septiembre,Paraguay,600,0,1,,1,"(10.445761,-75.516429)"
2014,Septiembre,Paraguay,600,0,1,,1,"(10.886611,-74.776708)"
2014,Septiembre,Paraguay,600,1,1,,2,"(12.586067,-81.702563)"
2014,Septiembre,Paraguay,600,7,11,,18,"(3.541112,-76.384584)"
2014,Septiembre,Paraguay,600,47,127,,174,"(4.697144,-74.140516)"
2014,Septiembre,Paraguay,600,1,1,,2,"(4.815061,-75.736532)"
2014,Septiembre,Paraguay,600,8,43,,51,"(6.171601,-75.427454)"
2014,Septiembre,Perú,604,44,104,,148,"(-4.197703,-69.941278)"
2014,Septiembre,Perú,604,66,107,,173,"(0.814836,-77.662532)"
2014,Septiembre,Perú,604,12,12,,24,"(10.445761,-75.516429)"
2014,Septiembre,Perú,604,21,15,,36,"(10.886611,-74.776708)"
2014,Septiembre,Perú,604,2,1,,3,"(12.586067,-81.702563)"
2014,Septiembre,Perú,604,348,422,,770,"(3.541112,-76.384584)"
2014,Septiembre,Perú,604,3629,4551,,8180,"(4.697144,-74.140516)"
2014,Septiembre,Perú,604,11,7,,18,"(4.815061,-75.736532)"
2014,Septiembre,Perú,604,447,513,,960,"(6.171601,-75.427454)"
2014,Septiembre,Perú,604,5,6,,11,"(7.128456,-73.183637)"
2014,Septiembre,Perú,604,1,0,,1,"(7.927209,-72.507910)"
2014,Septiembre,Polonia,616,0,1,,1,"(10.445761,-75.516429)"
2014,Septiembre,Polonia,616,17,33,,50,"(4.697144,-74.140516)"
2014,Septiembre,Portugal,620,3,2,,5,"(3.541112,-76.384584)"
2014,Septiembre,Portugal,620,355,301,,656,"(4.697144,-74.140516)"
2014,Septiembre,Portugal,620,0,1,,1,"(4.815061,-75.736532)"
2014,Septiembre,Portugal,620,7,1,,8,"(6.171601,-75.427454)"
2014,Septiembre,Polinesia Francesa/Colectividad de Ultramar Francesa,258,0,2,,2,"(4.697144,-74.140516)"
2014,Septiembre,Puerto Rico/Territorio de Estados Unidos,630,2,2,,4,"(10.445761,-75.516429)"
2014,Septiembre,Puerto Rico/Territorio de Estados Unidos,630,10,9,,19,"(10.886611,-74.776708)"
2014,Septiembre,Puerto Rico/Territorio de Estados Unidos,630,1,1,,2,"(12.586067,-81.702563)"
2014,Septiembre,Puerto Rico/Territorio de Estados Unidos,630,16,19,,35,"(3.541112,-76.384584)"
2014,Septiembre,Puerto Rico/Territorio de Estados Unidos,630,375,393,,768,"(4.697144,-74.140516)"
2014,Septiembre,Puerto Rico/Territorio de Estados Unidos,630,5,4,,9,"(4.815061,-75.736532)"
2014,Septiembre,Puerto Rico/Territorio de Estados Unidos,630,35,37,,72,"(6.171601,-75.427454)"
2014,Septiembre,Puerto Rico/Territorio de Estados Unidos,630,2,2,,4,"(7.128456,-73.183637)"
2014,Septiembre,Qatar,634,7,1,,8,"(4.697144,-74.140516)"
2014,Septiembre,Qatar,634,1,0,,1,"(6.171601,-75.427454)"
2014,Septiembre,Reino Unido de Gran Bretaña e Irlanda del Norte,826,2,0,,2,"(10.886611,-74.776708)"
2014,Septiembre,Reino Unido de Gran Bretaña e Irlanda del Norte,826,33,29,,62,"(3.541112,-76.384584)"
2014,Septiembre,Reino Unido de Gran Bretaña e Irlanda del Norte,826,1982,1504,,3486,"(4.697144,-74.140516)"
2014,Septiembre,Reino Unido de Gran Bretaña e Irlanda del Norte,826,31,27,,58,"(6.171601,-75.427454)"
2014,Septiembre,Reino Unido de Gran Bretaña e Irlanda del Norte,826,1,0,,1,"(7.128456,-73.183637)"
2014,Septiembre,Federación de Rusia,643,0,1,,1,"(3.541112,-76.384584)"
2014,Septiembre,Federación de Rusia,643,62,106,,168,"(4.697144,-74.140516)"
2014,Septiembre,Federación de Rusia,643,0,3,,3,"(6.171601,-75.427454)"
2014,Septiembre,República Dominicana,214,0,6,,6,"(10.408582,-75.538003)"
2014,Septiembre,República Dominicana,214,7,21,,28,"(10.445761,-75.516429)"
2014,Septiembre,República Dominicana,214,23,28,,51,"(10.886611,-74.776708)"
2014,Septiembre,República Dominicana,214,46,48,,94,"(3.541112,-76.384584)"
2014,Septiembre,República Dominicana,214,2155,1869,,4024,"(4.697144,-74.140516)"
2014,Septiembre,República Dominicana,214,12,10,,22,"(4.815061,-75.736532)"
2014,Septiembre,República Dominicana,214,131,120,,251,"(6.171601,-75.427454)"
2014,Septiembre,República Dominicana,214,9,11,,20,"(7.128456,-73.183637)"
2014,Septiembre,República Dominicana,214,1,1,,2,"(7.927209,-72.507910)"
2014,Septiembre,Reunión,638,1,1,,2,"(4.697144,-74.140516)"
2014,Septiembre,Rumania,642,5,10,,15,"(4.697144,-74.140516)"
2014,Septiembre,Santa Sede/Ciudad del Vaticano,336,1,1,,2,"(4.697144,-74.140516)"
2014,Septiembre,Serbia,688,0,1,,1,"(4.697144,-74.140516)"
2014,Septiembre,Singapur,702,0,1,,1,"(3.541112,-76.384584)"
2014,Septiembre,Singapur,702,14,4,,18,"(4.697144,-74.140516)"
2014,Septiembre,Somalia,706,0,1,,1,"(10.886611,-74.776708)"
2014,Septiembre,Sri Lanka,144,1,1,,2,"(4.697144,-74.140516)"
2014,Septiembre,Sudáfrica,710,0,1,,1,"(10.886611,-74.776708)"
2014,Septiembre,Sudáfrica,710,1,1,,2,"(3.541112,-76.384584)"
2014,Septiembre,Sudáfrica,710,20,17,,37,"(4.697144,-74.140516)"
2014,Septiembre,Sudáfrica,710,0,1,,1,"(6.171601,-75.427454)"
2014,Septiembre,Sudán,736,0,2,,2,"(4.697144,-74.140516)"
2014,Septiembre,Sudán,736,0,1,,1,"(6.171601,-75.427454)"
2014,Septiembre,Suecia,752,3,1,,4,"(3.541112,-76.384584)"
2014,Septiembre,Suecia,752,42,43,,85,"(4.697144,-74.140516)"
2014,Septiembre,Suecia,752,5,1,,6,"(6.171601,-75.427454)"
2014,Septiembre,Suiza,756,1,0,,1,"(10.886611,-74.776708)"
2014,Septiembre,Suiza,756,17,8,,25,"(3.541112,-76.384584)"
2014,Septiembre,Suiza,756,190,149,,339,"(4.697144,-74.140516)"
2014,Septiembre,Suiza,756,6,3,,9,"(6.171601,-75.427454)"
2014,Septiembre,Surinam,740,0,1,,1,"(10.886611,-74.776708)"
2014,Septiembre,Surinam,740,6,6,,12,"(4.697144,-74.140516)"
2014,Septiembre,Surinam,740,3,2,,5,"(6.171601,-75.427454)"
2014,Septiembre,Suazilandia,748,1,0,,1,"(4.697144,-74.140516)"
2014,Septiembre,Taiwán,158,5,6,,11,"(4.697144,-74.140516)"
2014,Septiembre,Tailandia,764,23,19,,42,"(4.697144,-74.140516)"
2014,Septiembre,Tailandia,764,1,0,,1,"(6.171601,-75.427454)"
2014,Septiembre,Tanzania,834,0,1,,1,"(4.697144,-74.140516)"
2014,Septiembre,Trinidad y Tobago,780,3,7,,10,"(10.445761,-75.516429)"
2014,Septiembre,Trinidad y Tobago,780,0,2,,2,"(10.886611,-74.776708)"
2014,Septiembre,Trinidad y Tobago,780,13,21,,34,"(3.541112,-76.384584)"
2014,Septiembre,Trinidad y Tobago,780,29,37,,66,"(4.697144,-74.140516)"
2014,Septiembre,Trinidad y Tobago,780,8,3,,11,"(4.815061,-75.736532)"
2014,Septiembre,Trinidad y Tobago,780,9,6,,15,"(6.171601,-75.427454)"
2014,Septiembre,Trinidad y Tobago,780,8,2,,10,"(7.128456,-73.183637)"
2014,Septiembre,Túnez,788,2,3,,5,"(4.697144,-74.140516)"
2014,Septiembre,Turquía,792,3,1,,4,"(3.541112,-76.384584)"
2014,Septiembre,Turquía,792,142,101,,243,"(4.697144,-74.140516)"
2014,Septiembre,Turquía,792,0,1,,1,"(4.815061,-75.736532)"
2014,Septiembre,Turquía,792,4,8,,12,"(6.171601,-75.427454)"
2014,Septiembre,Ucrania,804,1,1,,2,"(4.697144,-74.140516)"
2014,Septiembre,Uganda,800,1,0,,1,"(3.541112,-76.384584)"
2014,Septiembre,Uganda,800,2,0,,2,"(4.697144,-74.140516)"
2014,Septiembre,Uruguay,858,0,1,,1,"(0.814836,-77.662532)"
2014,Septiembre,Uruguay,858,0,1,,1,"(10.886611,-74.776708)"
2014,Septiembre,Uruguay,858,6,8,,14,"(3.541112,-76.384584)"
2014,Septiembre,Uruguay,858,45,101,,146,"(4.697144,-74.140516)"
2014,Septiembre,Uruguay,858,14,11,,25,"(6.171601,-75.427454)"
2014,Septiembre,Uruguay,858,1,0,,1,"(7.128456,-73.183637)"
2014,Septiembre,Uzbekistán,860,1,0,,1,"(4.697144,-74.140516)"
2014,Septiembre,Venezuela,862,0,2,,2,"(10.408582,-75.538003)"
2014,Septiembre,Venezuela,862,3,27,,30,"(10.445761,-75.516429)"
2014,Septiembre,Venezuela,862,2,20,,22,"(10.886611,-74.776708)"
2014,Septiembre,Venezuela,862,0,2,,2,"(11.247723,-74.213989)"
2014,Septiembre,Venezuela,862,8996,7169,,16165,"(11.360009,-72.129330)"
2014,Septiembre,Venezuela,862,1,1,,2,"(12.586067,-81.702563)"
2014,Septiembre,Venezuela,862,7,18,,25,"(3.541112,-76.384584)"
2014,Septiembre,Venezuela,862,1017,1243,,2260,"(4.697144,-74.140516)"
2014,Septiembre,Venezuela,862,2,5,,7,"(4.815061,-75.736532)"
2014,Septiembre,Venezuela,862,22,53,,75,"(6.171601,-75.427454)"
2014,Septiembre,Venezuela,862,168,198,,366,"(6.185799,-67.483929)"
2014,Septiembre,Venezuela,862,2152,1733,,3885,"(7.088729,-70.740253)"
2014,Septiembre,Venezuela,862,2,3,,5,"(7.128456,-73.183637)"
2014,Septiembre,Venezuela,862,5948,5386,,11334,"(7.818934,-72.453226)"
2014,Septiembre,Venezuela,862,4,9,,13,"(7.927209,-72.507910)"
2014,Septiembre,Vietnam,704,2,5,,7,"(4.697144,-74.140516)"
2014,Septiembre,Islas Vírgenes Británicas/Territorio Británico de Ultramar,92,1,0,,1,"(4.697144,-74.140516)"
2014,Septiembre,Islas Vírgenes Estadounidenses/Territorio de Estados Unidos,850,1,0,,1,"(4.697144,-74.140516)"
2014,Septiembre,República Árabe de Yemen,887,0,1,,1,"(4.697144,-74.140516)"
2014,Septiembre,Desconocido,99999,2,44,,46,"(12.5744111,-81.703935)"
2014,Septiembre,Desconocido,99999,504,613,,1117,"(4.697144,-74.140516)"
2014,Septiembre,Desconocido,99999,0,1,,1,"(6.185799,-67.483929)"
2014,Septiembre,Desconocido,99999,0,1,,1,"(8.635765,-77.346578)"
2014,Octubre,Afganistán,4,1,14,,15,"(4.697144,-74.140516)"
2014,Octubre,Albania,8,1,0,,1,"(4.697144,-74.140516)"
2014,Octubre,Alemania,276,1,2,,3,"(10.886611,-74.776708)"
2014,Octubre,Alemania,276,17,12,,29,"(3.541112,-76.384584)"
2014,Octubre,Alemania,276,1142,1137,,2279,"(4.697144,-74.140516)"
2014,Octubre,Alemania,276,9,17,,26,"(6.171601,-75.427454)"
2014,Octubre,Andorra,20,0,1,,1,"(10.408582,-75.538003)"
2014,Octubre,Andorra,20,0,1,,1,"(4.697144,-74.140516)"
2014,Octubre,Angola,24,1,8,,9,"(4.697144,-74.140516)"
2014,Octubre,Antigua y Barbuda,28,0,2,,2,"(10.886611,-74.776708)"
2014,Octubre,Antigua y Barbuda,28,0,2,,2,"(4.815061,-75.736532)"
2014,Octubre,Países Bajos,528,29,14,,43,"(10.408582,-75.538003)"
2014,Octubre,Países Bajos,528,1,0,,1,"(10.445761,-75.516429)"
2014,Octubre,Países Bajos,528,3,0,,3,"(10.886611,-74.776708)"
2014,Octubre,Países Bajos,528,24,13,,37,"(3.541112,-76.384584)"
2014,Octubre,Países Bajos,528,157,131,,288,"(4.697144,-74.140516)"
2014,Octubre,Países Bajos,528,4,2,,6,"(4.815061,-75.736532)"
2014,Octubre,Países Bajos,528,52,33,,85,"(6.171601,-75.427454)"
2014,Octubre,Países Bajos,528,3,1,,4,"(7.927209,-72.507910)"
2014,Octubre,Arabia Saudita,682,12,25,,37,"(4.697144,-74.140516)"
2014,Octubre,Arabia Saudita,682,0,3,,3,"(6.171601,-75.427454)"
2014,Octubre,Argelia,12,0,1,,1,"(3.541112,-76.384584)"
2014,Octubre,Argelia,12,6,6,,12,"(4.697144,-74.140516)"
2014,Octubre,Argelia,12,1,0,,1,"(6.171601,-75.427454)"
2014,Octubre,Argentina,32,11,27,,38,"(0.814836,-77.662532)"
2014,Octubre,Argentina,32,19,24,,43,"(10.445761,-75.516429)"
2014,Octubre,Argentina,32,55,49,,104,"(10.886611,-74.776708)"
2014,Octubre,Argentina,32,3,3,,6,"(12.586067,-81.702563)"
2014,Octubre,Argentina,32,184,153,,337,"(3.541112,-76.384584)"
2014,Octubre,Argentina,32,3226,3265,,6491,"(4.697144,-74.140516)"
2014,Octubre,Argentina,32,23,33,,56,"(4.815061,-75.736532)"
2014,Octubre,Argentina,32,316,267,,583,"(6.171601,-75.427454)"
2014,Octubre,Argentina,32,19,26,,45,"(7.128456,-73.183637)"
2014,Octubre,Argentina,32,5,5,,10,"(7.927209,-72.507910)"
2014,Octubre,República de Armenia,51,1,1,,2,"(4.697144,-74.140516)"
2014,Octubre,Aruba,533,2138,1746,,3884,"(10.408582,-75.538003)"
2014,Octubre,Aruba,533,7,13,,20,"(10.445761,-75.516429)"
2014,Octubre,Aruba,533,23,19,,42,"(10.886611,-74.776708)"
2014,Octubre,Aruba,533,0,1,,1,"(10.971302,-74.765397)"
2014,Octubre,Aruba,533,1,5,,6,"(11.247723,-74.213989)"
2014,Octubre,Aruba,533,1,0,,1,"(12.586067,-81.702563)"
2014,Octubre,Aruba,533,32,23,,55,"(3.541112,-76.384584)"
2014,Octubre,Aruba,533,1398,1037,,2435,"(4.697144,-74.140516)"
2014,Octubre,Aruba,533,8,9,,17,"(4.815061,-75.736532)"
2014,Octubre,Aruba,533,57,56,,113,"(6.171601,-75.427454)"
2014,Octubre,Aruba,533,11,18,,29,"(7.128456,-73.183637)"
2014,Octubre,Aruba,533,0,1,,1,"(7.927209,-72.507910)"
2014,Octubre,Australia,36,3,0,,3,"(10.445761,-75.516429)"
2014,Octubre,Australia,36,0,1,,1,"(10.886611,-74.776708)"
2014,Octubre,Australia,36,7,6,,13,"(3.541112,-76.384584)"
2014,Octubre,Australia,36,146,121,,267,"(4.697144,-74.140516)"
2014,Octubre,Australia,36,0,1,,1,"(4.815061,-75.736532)"
2014,Octubre,Australia,36,16,6,,22,"(6.171601,-75.427454)"
2014,Octubre,Australia,36,1,0,,1,"(7.128456,-73.183637)"
2014,Octubre,Austria,40,43,52,,95,"(4.697144,-74.140516)"
2014,Octubre,Austria,40,1,2,,3,"(6.171601,-75.427454)"
2014,Octubre,Azerbaiyán,31,2,1,,3,"(4.697144,-74.140516)"
2014,Octubre,Azerbaiyán,31,2,0,,2,"(6.171601,-75.427454)"
2014,Octubre,Bahamas,44,12,13,,25,"(10.886611,-74.776708)"
2014,Octubre,Bahamas,44,10,5,,15,"(3.541112,-76.384584)"
2014,Octubre,Bahamas,44,30,23,,53,"(4.697144,-74.140516)"
2014,Octubre,Bahamas,44,3,4,,7,"(4.815061,-75.736532)"
2014,Octubre,Bahamas,44,6,14,,20,"(6.171601,-75.427454)"
2014,Octubre,Bahamas,44,2,0,,2,"(7.128456,-73.183637)"
2014,Octubre,Bahamas,44,1,1,,2,"(7.927209,-72.507910)"
2014,Octubre,Bahréin,48,1,0,,1,"(3.541112,-76.384584)"
2014,Octubre,Bahréin,48,5,2,,7,"(4.697144,-74.140516)"
2014,Octubre,Bahréin,48,1,0,,1,"(6.171601,-75.427454)"
2014,Octubre,Bahréin,48,1,0,,1,"(7.818934,-72.453226)"
2014,Octubre,Bangladesh,50,0,1,,1,"(4.697144,-74.140516)"
2014,Octubre,Barbados,52,1,0,,1,"(10.886611,-74.776708)"
2014,Octubre,Barbados,52,0,2,,2,"(3.541112,-76.384584)"
2014,Octubre,Barbados,52,0,2,,2,"(4.697144,-74.140516)"
2014,Octubre,Bélgica,56,2,2,,4,"(3.541112,-76.384584)"
2014,Octubre,Bélgica,56,56,61,,117,"(4.697144,-74.140516)"
2014,Octubre,Bélgica,56,6,2,,8,"(6.171601,-75.427454)"
2014,Octubre,Belice,84,0,1,,1,"(10.445761,-75.516429)"
2014,Octubre,Belice,84,2,7,,9,"(4.697144,-74.140516)"
2014,Octubre,Benín,204,0,1,,1,"(4.697144,-74.140516)"
2014,Octubre,Bermudas/Territorio Británico de Ultramar,60,1,0,,1,"(4.697144,-74.140516)"
2014,Octubre,Bermudas/Territorio Británico de Ultramar,60,1,0,,1,"(6.171601,-75.427454)"
2014,Octubre,Bolivia,68,4,2,,6,"(0.814836,-77.662532)"
2014,Octubre,Bolivia,68,1,0,,1,"(10.445761,-75.516429)"
2014,Octubre,Bolivia,68,0,2,,2,"(10.886611,-74.776708)"
2014,Octubre,Bolivia,68,15,30,,45,"(3.541112,-76.384584)"
2014,Octubre,Bolivia,68,231,421,,652,"(4.697144,-74.140516)"
2014,Octubre,Bolivia,68,2,4,,6,"(4.815061,-75.736532)"
2014,Octubre,Bolivia,68,17,36,,53,"(6.171601,-75.427454)"
2014,Octubre,Bolivia,68,0,1,,1,"(7.128456,-73.183637)"
2014,Octubre,Bolivia,68,0,1,,1,"(7.927209,-72.507910)"
2014,Octubre,Brasil,76,73,167,,240,"(-4.197703,-69.941278)"
2014,Octubre,Brasil,76,1,0,,1,"(-4.223468,-69.945098)"
2014,Octubre,Brasil,76,0,3,,3,"(0.814836,-77.662532)"
2014,Octubre,Brasil,76,1,4,,5,"(10.445761,-75.516429)"
2014,Octubre,Brasil,76,5,7,,12,"(10.886611,-74.776708)"
2014,Octubre,Brasil,76,41,83,,124,"(3.541112,-76.384584)"
2014,Octubre,Brasil,76,2650,3364,,6014,"(4.697144,-74.140516)"
2014,Octubre,Brasil,76,8,16,,24,"(4.815061,-75.736532)"
2014,Octubre,Brasil,76,72,121,,193,"(6.171601,-75.427454)"
2014,Octubre,Brasil,76,2,1,,3,"(7.128456,-73.183637)"
2014,Octubre,Brunei Darussalam,96,1,1,,2,"(4.697144,-74.140516)"
2014,Octubre,Bulgaria,100,0,1,,1,"(4.697144,-74.140516)"
2014,Octubre,Cabo Verde,132,0,1,,1,"(4.697144,-74.140516)"
2014,Octubre,Islas Caimán/Territorio Británico de Ultramar,136,1,0,,1,"(10.445761,-75.516429)"
2014,Octubre,Islas Caimán/Territorio Británico de Ultramar,136,1,0,,1,"(10.886611,-74.776708)"
2014,Octubre,Islas Caimán/Territorio Británico de Ultramar,136,4,2,,6,"(12.586067,-81.702563)"
2014,Octubre,Islas Caimán/Territorio Británico de Ultramar,136,3,3,,6,"(4.697144,-74.140516)"
2014,Octubre,Islas Caimán/Territorio Británico de Ultramar,136,1,0,,1,"(6.171601,-75.427454)"
2014,Octubre,Camerún,120,0,1,,1,"(4.697144,-74.140516)"
2014,Octubre,Canadá,124,9,9,,18,"(10.445761,-75.516429)"
2014,Octubre,Canadá,124,15,11,,26,"(10.886611,-74.776708)"
2014,Octubre,Canadá,124,5,1,,6,"(12.586067,-81.702563)"
2014,Octubre,Canadá,124,67,58,,125,"(3.541112,-76.384584)"
2014,Octubre,Canadá,124,3,1,,4,"(4.452882,-75.766298)"
2014,Octubre,Canadá,124,988,946,,1934,"(4.697144,-74.140516)"
2014,Octubre,Canadá,124,10,5,,15,"(4.815061,-75.736532)"
2014,Octubre,Canadá,124,151,121,,272,"(6.171601,-75.427454)"
2014,Octubre,Canadá,124,7,7,,14,"(7.128456,-73.183637)"
2014,Octubre,Canadá,124,4,2,,6,"(7.927209,-72.507910)"
2014,Octubre,Chad,148,1,2,,3,"(4.697144,-74.140516)"
2014,Octubre,España,724,1,2,,3,"(0.814836,-77.662532)"
2014,Octubre,España,724,19,35,,54,"(10.445761,-75.516429)"
2014,Octubre,España,724,4,0,,4,"(10.886611,-74.776708)"
2014,Octubre,España,724,926,555,,1481,"(3.541112,-76.384584)"
2014,Octubre,España,724,6784,5416,,12200,"(4.697144,-74.140516)"
2014,Octubre,España,724,0,2,,2,"(4.815061,-75.736532)"
2014,Octubre,España,724,671,537,,1208,"(6.171601,-75.427454)"
2014,Octubre,Colombia,170,568,694,,1262,"(4.697144,-74.140516)"
2014,Octubre,República Del Congo,178,0,2,,2,"(4.697144,-74.140516)"
2014,Octubre,República Democrática del Congo,180,1,3,,4,"(4.697144,-74.140516)"
2014,Octubre,República de Corea,410,26,41,,67,"(4.697144,-74.140516)"
2014,Octubre,República de Corea,410,5,18,,23,"(6.171601,-75.427454)"
2014,Octubre,Costa de Marfil,384,3,2,,5,"(4.697144,-74.140516)"
2014,Octubre,Costa Rica,188,0,7,,7,"(10.408582,-75.538003)"
2014,Octubre,Costa Rica,188,8,10,,18,"(10.445761,-75.516429)"
2014,Octubre,Costa Rica,188,17,16,,33,"(10.886611,-74.776708)"
2014,Octubre,Costa Rica,188,1,14,,15,"(12.5744111,-81.703935)"
2014,Octubre,Costa Rica,188,3,8,,11,"(12.586067,-81.702563)"
2014,Octubre,Costa Rica,188,43,34,,77,"(3.541112,-76.384584)"
2014,Octubre,Costa Rica,188,881,975,,1856,"(4.697144,-74.140516)"
2014,Octubre,Costa Rica,188,13,12,,25,"(4.815061,-75.736532)"
2014,Octubre,Costa Rica,188,122,134,,256,"(6.171601,-75.427454)"
2014,Octubre,Costa Rica,188,1,1,,2,"(7.128456,-73.183637)"
2014,Octubre,Costa Rica,188,4,5,,9,"(7.927209,-72.507910)"
2014,Octubre,Croacia,191,0,1,,1,"(4.697144,-74.140516)"
2014,Octubre,Cuba,192,13,13,,26,"(10.445761,-75.516429)"
2014,Octubre,Cuba,192,23,23,,46,"(10.886611,-74.776708)"
2014,Octubre,Cuba,192,5,5,,10,"(12.586067,-81.702563)"
2014,Octubre,Cuba,192,166,126,,292,"(3.541112,-76.384584)"
2014,Octubre,Cuba,192,1332,1060,,2392,"(4.697144,-74.140516)"
2014,Octubre,Cuba,192,30,26,,56,"(4.815061,-75.736532)"
2014,Octubre,Cuba,192,146,132,,278,"(6.171601,-75.427454)"
2014,Octubre,Cuba,192,14,12,,26,"(7.128456,-73.183637)"
2014,Octubre,Cuba,192,3,15,,18,"(7.927209,-72.507910)"
2014,Octubre,Curazao,99999,98,53,,151,"(10.886611,-74.776708)"
2014,Octubre,Curazao,99999,15,11,,26,"(3.541112,-76.384584)"
2014,Octubre,Curazao,99999,585,533,,1118,"(4.697144,-74.140516)"
2014,Octubre,Curazao,99999,100,56,,156,"(6.171601,-75.427454)"
2014,Octubre,Curazao,99999,3,2,,5,"(7.128456,-73.183637)"
2014,Octubre,Curazao,99999,0,1,,1,"(7.927209,-72.507910)"
2014,Octubre,República Checa,203,13,14,,27,"(4.697144,-74.140516)"
2014,Octubre,Chile,152,88,81,,169,"(0.814836,-77.662532)"
2014,Octubre,Chile,152,13,7,,20,"(10.445761,-75.516429)"
2014,Octubre,Chile,152,21,22,,43,"(10.886611,-74.776708)"
2014,Octubre,Chile,152,2,0,,2,"(12.586067,-81.702563)"
2014,Octubre,Chile,152,279,237,,516,"(3.541112,-76.384584)"
2014,Octubre,Chile,152,3129,3098,,6227,"(4.697144,-74.140516)"
2014,Octubre,Chile,152,42,85,,127,"(4.815061,-75.736532)"
2014,Octubre,Chile,152,128,135,,263,"(6.171601,-75.427454)"
2014,Octubre,Chile,152,14,15,,29,"(7.128456,-73.183637)"
2014,Octubre,Chile,152,3,0,,3,"(7.927209,-72.507910)"
2014,Octubre,China,156,0,9,,9,"(10.445761,-75.516429)"
2014,Octubre,China,156,1,14,,15,"(10.886611,-74.776708)"
2014,Octubre,China,156,8,17,,25,"(3.541112,-76.384584)"
2014,Octubre,China,156,253,611,,864,"(4.697144,-74.140516)"
2014,Octubre,China,156,1,5,,6,"(4.815061,-75.736532)"
2014,Octubre,China,156,31,60,,91,"(6.171601,-75.427454)"
2014,Octubre,China,156,0,4,,4,"(7.128456,-73.183637)"
2014,Octubre,Chipre,196,0,1,,1,"(4.697144,-74.140516)"
2014,Octubre,Dinamarca,208,12,11,,23,"(4.697144,-74.140516)"
2014,Octubre,Dinamarca,208,0,1,,1,"(6.171601,-75.427454)"
2014,Octubre,Ecuador,218,705,725,,1430,"(0.25129,-76.875963)"
2014,Octubre,Ecuador,218,6982,7281,,14263,"(0.814836,-77.662532)"
2014,Octubre,Ecuador,218,208,205,,413,"(1.813928,-78.763924)"
2014,Octubre,Ecuador,218,6,11,,17,"(10.445761,-75.516429)"
2014,Octubre,Ecuador,218,5,18,,23,"(10.886611,-74.776708)"
2014,Octubre,Ecuador,218,4,1,,5,"(12.586067,-81.702563)"
2014,Octubre,Ecuador,218,726,689,,1415,"(3.541112,-76.384584)"
2014,Octubre,Ecuador,218,2413,4120,,6533,"(4.697144,-74.140516)"
2014,Octubre,Ecuador,218,3,4,,7,"(4.815061,-75.736532)"
2014,Octubre,Ecuador,218,395,396,,791,"(6.171601,-75.427454)"
2014,Octubre,Ecuador,218,1,1,,2,"(7.128456,-73.183637)"
2014,Octubre,Egipto,818,45,32,,77,"(4.697144,-74.140516)"
2014,Octubre,Egipto,818,3,2,,5,"(6.171601,-75.427454)"
2014,Octubre,El Salvador,222,3,9,,12,"(10.445761,-75.516429)"
2014,Octubre,El Salvador,222,1,3,,4,"(10.886611,-74.776708)"
2014,Octubre,El Salvador,222,90,89,,179,"(3.541112,-76.384584)"
2014,Octubre,El Salvador,222,943,1009,,1952,"(4.697144,-74.140516)"
2014,Octubre,El Salvador,222,1,4,,5,"(4.815061,-75.736532)"
2014,Octubre,El Salvador,222,78,111,,189,"(6.171601,-75.427454)"
2014,Octubre,El Salvador,222,1,1,,2,"(7.128456,-73.183637)"
2014,Octubre,Emiratos Árabes,784,2,1,,3,"(3.541112,-76.384584)"
2014,Octubre,Emiratos Árabes,784,140,376,,516,"(4.697144,-74.140516)"
2014,Octubre,Emiratos Árabes,784,4,3,,7,"(6.171601,-75.427454)"
2014,Octubre,Eslovaquia,703,1,3,,4,"(4.697144,-74.140516)"
2014,Octubre,Eslovenia,705,3,2,,5,"(4.697144,-74.140516)"
2014,Octubre,Estados Unidos de América,840,0,1,,1,"(0.814836,-77.662532)"
2014,Octubre,Estados Unidos de América,840,1,0,,1,"(10.408582,-75.538003)"
2014,Octubre,Estados Unidos de América,840,2797,2239,,5036,"(10.445761,-75.516429)"
2014,Octubre,Estados Unidos de América,840,2059,1723,,3782,"(10.886611,-74.776708)"
2014,Octubre,Estados Unidos de América,840,65,62,,127,"(12.586067,-81.702563)"
2014,Octubre,Estados Unidos de América,840,4698,3437,,8135,"(3.541112,-76.384584)"
2014,Octubre,Estados Unidos de América,840,569,421,,990,"(4.452882,-75.766298)"
2014,Octubre,Estados Unidos de América,840,32752,30168,,62920,"(4.697144,-74.140516)"
2014,Octubre,Estados Unidos de América,840,996,709,,1705,"(4.815061,-75.736532)"
2014,Octubre,Estados Unidos de América,840,9269,7423,,16692,"(6.171601,-75.427454)"
2014,Octubre,Estados Unidos de América,840,203,169,,372,"(7.128456,-73.183637)"
2014,Octubre,Estados Unidos de América,840,149,128,,277,"(7.927209,-72.507910)"
2014,Octubre,Etiopia,231,1,12,,13,"(4.697144,-74.140516)"
2014,Octubre,Filipinas,608,4,3,,7,"(4.697144,-74.140516)"
2014,Octubre,Finlandia,246,7,8,,15,"(4.697144,-74.140516)"
2014,Octubre,Francia,250,1,0,,1,"(10.886611,-74.776708)"
2014,Octubre,Francia,250,20,18,,38,"(3.541112,-76.384584)"
2014,Octubre,Francia,250,1162,1059,,2221,"(4.697144,-74.140516)"
2014,Octubre,Francia,250,25,18,,43,"(6.171601,-75.427454)"
2014,Octubre,Gabón,266,0,8,,8,"(4.697144,-74.140516)"
2014,Octubre,Ghana,288,2,0,,2,"(4.697144,-74.140516)"
2014,Octubre,Grecia,300,17,14,,31,"(4.697144,-74.140516)"
2014,Octubre,Guatemala,320,0,1,,1,"(10.445761,-75.516429)"
2014,Octubre,Guatemala,320,2,2,,4,"(10.886611,-74.776708)"
2014,Octubre,Guatemala,320,49,74,,123,"(3.541112,-76.384584)"
2014,Octubre,Guatemala,320,448,514,,962,"(4.697144,-74.140516)"
2014,Octubre,Guatemala,320,5,14,,19,"(4.815061,-75.736532)"
2014,Octubre,Guatemala,320,58,126,,184,"(6.171601,-75.427454)"
2014,Octubre,Guatemala,320,4,1,,5,"(7.128456,-73.183637)"
2014,Octubre,Guatemala,320,4,2,,6,"(7.927209,-72.507910)"
2014,Octubre,Guyana,328,1,3,,4,"(4.697144,-74.140516)"
2014,Octubre,Guyana,328,1,0,,1,"(4.815061,-75.736532)"
2014,Octubre,Guyana,328,0,1,,1,"(6.171601,-75.427454)"
2014,Octubre,Guinea,324,1,2,,3,"(0.814836,-77.662532)"
2014,Octubre,Guinea Ecuatorial,226,2,2,,4,"(3.541112,-76.384584)"
2014,Octubre,Guinea Ecuatorial,226,2,6,,8,"(4.697144,-74.140516)"
2014,Octubre,Guadalupe/Territorio Francés,312,3,0,,3,"(4.697144,-74.140516)"
2014,Octubre,Guam/Territorio no incorporado de Estados Unidos,316,1,0,,1,"(0.814836,-77.662532)"
2014,Octubre,Guayana Francesa/Departamento de Ultramar Francés,254,1,0,,1,"(3.541112,-76.384584)"
2014,Octubre,Guayana Francesa/Departamento de Ultramar Francés,254,0,1,,1,"(4.697144,-74.140516)"
2014,Octubre,Guayana Francesa/Departamento de Ultramar Francés,254,1,0,,1,"(6.171601,-75.427454)"
2014,Octubre,Haití,332,0,3,,3,"(10.445761,-75.516429)"
2014,Octubre,Haití,332,0,2,,2,"(10.886611,-74.776708)"
2014,Octubre,Haití,332,1,2,,3,"(3.541112,-76.384584)"
2014,Octubre,Haití,332,3,4,,7,"(4.697144,-74.140516)"
2014,Octubre,Haití,332,0,3,,3,"(4.815061,-75.736532)"
2014,Octubre,Haití,332,1,4,,5,"(6.171601,-75.427454)"
2014,Octubre,Honduras,340,1,7,,8,"(10.445761,-75.516429)"
2014,Octubre,Honduras,340,1,6,,7,"(10.886611,-74.776708)"
2014,Octubre,Honduras,340,0,1,,1,"(12.586067,-81.702563)"
2014,Octubre,Honduras,340,9,23,,32,"(3.541112,-76.384584)"
2014,Octubre,Honduras,340,61,158,,219,"(4.697144,-74.140516)"
2014,Octubre,Honduras,340,3,3,,6,"(4.815061,-75.736532)"
2014,Octubre,Honduras,340,14,48,,62,"(6.171601,-75.427454)"
2014,Octubre,Honduras,340,0,1,,1,"(7.128456,-73.183637)"
2014,Octubre,Hong Kong,344,1,5,,6,"(10.445761,-75.516429)"
2014,Octubre,Hong Kong,344,0,2,,2,"(10.886611,-74.776708)"
2014,Octubre,Hong Kong,344,0,1,,1,"(3.541112,-76.384584)"
2014,Octubre,Hong Kong,344,43,113,,156,"(4.697144,-74.140516)"
2014,Octubre,Hong Kong,344,6,9,,15,"(6.171601,-75.427454)"
2014,Octubre,Hong Kong,344,1,0,,1,"(7.927209,-72.507910)"
2014,Octubre,Hungría,348,1,0,,1,"(3.541112,-76.384584)"
2014,Octubre,Hungría,348,3,6,,9,"(4.697144,-74.140516)"
2014,Octubre,India,356,1,1,,2,"(10.886611,-74.776708)"
2014,Octubre,India,356,2,1,,3,"(3.541112,-76.384584)"
2014,Octubre,India,356,70,70,,140,"(4.697144,-74.140516)"
2014,Octubre,India,356,10,4,,14,"(6.171601,-75.427454)"
2014,Octubre,Indonesia,360,10,9,,19,"(4.697144,-74.140516)"
2014,Octubre,Indonesia,360,2,2,,4,"(6.171601,-75.427454)"
2014,Octubre,Iraq,368,1,13,,14,"(4.697144,-74.140516)"
2014,Octubre,Irán,364,4,2,,6,"(4.697144,-74.140516)"
2014,Octubre,República de Irlanda,372,10,12,,22,"(4.697144,-74.140516)"
2014,Octubre,Islandia,352,1,0,,1,"(3.541112,-76.384584)"
2014,Octubre,Israel,376,2,1,,3,"(3.541112,-76.384584)"
2014,Octubre,Israel,376,206,168,,374,"(4.697144,-74.140516)"
2014,Octubre,Israel,376,1,0,,1,"(6.171601,-75.427454)"
2014,Octubre,Italia,380,5,0,,5,"(10.445761,-75.516429)"
2014,Octubre,Italia,380,0,1,,1,"(10.886611,-74.776708)"
2014,Octubre,Italia,380,29,13,,42,"(3.541112,-76.384584)"
2014,Octubre,Italia,380,522,409,,931,"(4.697144,-74.140516)"
2014,Octubre,Italia,380,1,1,,2,"(4.815061,-75.736532)"
2014,Octubre,Italia,380,22,18,,40,"(6.171601,-75.427454)"
2014,Octubre,Jamaica,388,1,0,,1,"(10.408582,-75.538003)"
2014,Octubre,Jamaica,388,0,2,,2,"(10.445761,-75.516429)"
2014,Octubre,Jamaica,388,0,2,,2,"(10.886611,-74.776708)"
2014,Octubre,Jamaica,388,2,0,,2,"(12.586067,-81.702563)"
2014,Octubre,Jamaica,388,16,21,,37,"(3.541112,-76.384584)"
2014,Octubre,Jamaica,388,46,51,,97,"(4.697144,-74.140516)"
2014,Octubre,Jamaica,388,5,4,,9,"(4.815061,-75.736532)"
2014,Octubre,Jamaica,388,44,30,,74,"(6.171601,-75.427454)"
2014,Octubre,Jamaica,388,5,6,,11,"(7.128456,-73.183637)"
2014,Octubre,Jamaica,388,4,1,,5,"(7.927209,-72.507910)"
2014,Octubre,Islas Salomón,90,1,0,,1,"(4.697144,-74.140516)"
2014,Octubre,Japón,392,4,4,,8,"(3.541112,-76.384584)"
2014,Octubre,Japón,392,77,92,,169,"(4.697144,-74.140516)"
2014,Octubre,Japón,392,1,6,,7,"(6.171601,-75.427454)"
2014,Octubre,Jordania,400,10,1,,11,"(4.697144,-74.140516)"
2014,Octubre,Kazajistán,398,0,3,,3,"(4.697144,-74.140516)"
2014,Octubre,Kenia,404,2,5,,7,"(4.697144,-74.140516)"
2014,Octubre,Kuwait,414,3,6,,9,"(4.697144,-74.140516)"
2014,Octubre,Lituania,440,3,2,,5,"(4.697144,-74.140516)"
2014,Octubre,Líbano,422,7,16,,23,"(4.697144,-74.140516)"
2014,Octubre,Liberia,430,3,1,,4,"(6.171601,-75.427454)"
2014,Octubre,Luxemburgo,442,1,6,,7,"(4.697144,-74.140516)"
2014,Octubre,Malasia,458,1,0,,1,"(10.445761,-75.516429)"
2014,Octubre,Malasia,458,6,8,,14,"(4.697144,-74.140516)"
2014,Octubre,Malasia,458,4,1,,5,"(6.171601,-75.427454)"
2014,Octubre,Maldivas,462,0,1,,1,"(4.697144,-74.140516)"
2014,Octubre,Malta,470,2,5,,7,"(4.697144,-74.140516)"
2014,Octubre,Marruecos,504,13,8,,21,"(4.697144,-74.140516)"
2014,Octubre,Marruecos,504,0,1,,1,"(6.171601,-75.427454)"
2014,Octubre,Mauritania,478,0,1,,1,"(4.697144,-74.140516)"
2014,Octubre,México,484,2,7,,9,"(0.814836,-77.662532)"
2014,Octubre,México,484,70,69,,139,"(10.445761,-75.516429)"
2014,Octubre,México,484,145,134,,279,"(10.886611,-74.776708)"
2014,Octubre,México,484,8,10,,18,"(12.586067,-81.702563)"
2014,Octubre,México,484,623,575,,1198,"(3.541112,-76.384584)"
2014,Octubre,México,484,12663,11010,,23673,"(4.697144,-74.140516)"
2014,Octubre,México,484,154,140,,294,"(4.815061,-75.736532)"
2014,Octubre,México,484,1486,1117,,2603,"(6.171601,-75.427454)"
2014,Octubre,México,484,178,146,,324,"(7.128456,-73.183637)"
2014,Octubre,México,484,198,150,,348,"(7.927209,-72.507910)"
2014,Octubre,Mónaco,492,0,1,,1,"(4.697144,-74.140516)"
2014,Octubre,Montenegro,499,0,1,,1,"(4.697144,-74.140516)"
2014,Octubre,Mozambique,508,1,1,,2,"(4.697144,-74.140516)"
2014,Octubre,Namibia,516,1,0,,1,"(4.697144,-74.140516)"
2014,Octubre,Nepal,524,2,0,,2,"(4.697144,-74.140516)"
2014,Octubre,Nicaragua,558,0,1,,1,"(0.814836,-77.662532)"
2014,Octubre,Nicaragua,558,3,3,,6,"(10.445761,-75.516429)"
2014,Octubre,Nicaragua,558,4,6,,10,"(10.886611,-74.776708)"
2014,Octubre,Nicaragua,558,8,16,,24,"(3.541112,-76.384584)"
2014,Octubre,Nicaragua,558,27,52,,79,"(4.697144,-74.140516)"
2014,Octubre,Nicaragua,558,1,4,,5,"(4.815061,-75.736532)"
2014,Octubre,Nicaragua,558,7,25,,32,"(6.171601,-75.427454)"
2014,Octubre,Nicaragua,558,3,2,,5,"(7.128456,-73.183637)"
2014,Octubre,Nicaragua,558,0,1,,1,"(7.927209,-72.507910)"
2014,Octubre,Nigeria,566,0,6,,6,"(4.697144,-74.140516)"
2014,Octubre,Noruega,578,1,0,,1,"(10.886611,-74.776708)"
2014,Octubre,Noruega,578,3,2,,5,"(3.541112,-76.384584)"
2014,Octubre,Noruega,578,13,18,,31,"(4.697144,-74.140516)"
2014,Octubre,Noruega,578,1,0,,1,"(6.171601,-75.427454)"
2014,Octubre,Nueva Caledonia/Territorio francés,540,1,0,,1,"(7.128456,-73.183637)"
2014,Octubre,Nueva Zelanda,554,2,0,,2,"(3.541112,-76.384584)"
2014,Octubre,Nueva Zelanda,554,22,19,,41,"(4.697144,-74.140516)"
2014,Octubre,Nueva Zelanda,554,3,0,,3,"(6.171601,-75.427454)"
2014,Octubre,Omán,512,0,4,,4,"(4.697144,-74.140516)"
2014,Octubre,Pakistán,586,1,0,,1,"(3.541112,-76.384584)"
2014,Octubre,Pakistán,586,0,1,,1,"(4.697144,-74.140516)"
2014,Octubre,Panamá,591,1,1,,2,"(0.814836,-77.662532)"
2014,Octubre,Panamá,591,113,178,,291,"(10.408582,-75.538003)"
2014,Octubre,Panamá,591,344,369,,713,"(10.445761,-75.516429)"
2014,Octubre,Panamá,591,875,907,,1782,"(10.886611,-74.776708)"
2014,Octubre,Panamá,591,0,2,,2,"(10.971302,-74.765397)"
2014,Octubre,Panamá,591,3,30,,33,"(12.5744111,-81.703935)"
2014,Octubre,Panamá,591,213,202,,415,"(12.586067,-81.702563)"
2014,Octubre,Panamá,591,2016,1882,,3898,"(3.541112,-76.384584)"
2014,Octubre,Panamá,591,10906,10669,,21575,"(4.697144,-74.140516)"
2014,Octubre,Panamá,591,538,412,,950,"(4.815061,-75.736532)"
2014,Octubre,Panamá,591,4454,3938,,8392,"(6.171601,-75.427454)"
2014,Octubre,Panamá,591,2,9,,11,"(6.228046,-77.404104)"
2014,Octubre,Panamá,591,1,5,,6,"(7.102626,-77.762647)"
2014,Octubre,Panamá,591,439,386,,825,"(7.128456,-73.183637)"
2014,Octubre,Panamá,591,101,102,,203,"(7.927209,-72.507910)"
2014,Octubre,Panamá,591,1,101,,102,"(8.066966,-76.735404)"
2014,Octubre,Panamá,591,45,110,,155,"(8.635765,-77.346578)"
2014,Octubre,Paraguay,600,0,1,,1,"(10.445761,-75.516429)"
2014,Octubre,Paraguay,600,7,19,,26,"(3.541112,-76.384584)"
2014,Octubre,Paraguay,600,57,121,,178,"(4.697144,-74.140516)"
2014,Octubre,Paraguay,600,1,1,,2,"(4.815061,-75.736532)"
2014,Octubre,Paraguay,600,11,16,,27,"(6.171601,-75.427454)"
2014,Octubre,Perú,604,77,93,,170,"(-4.197703,-69.941278)"
2014,Octubre,Perú,604,6,3,,9,"(-4.223468,-69.945098)"
2014,Octubre,Perú,604,103,135,,238,"(0.814836,-77.662532)"
2014,Octubre,Perú,604,0,11,,11,"(10.408582,-75.538003)"
2014,Octubre,Perú,604,5,5,,10,"(10.445761,-75.516429)"
2014,Octubre,Perú,604,18,21,,39,"(10.886611,-74.776708)"
2014,Octubre,Perú,604,0,1,,1,"(12.586067,-81.702563)"
2014,Octubre,Perú,604,329,435,,764,"(3.541112,-76.384584)"
2014,Octubre,Perú,604,4192,4900,,9092,"(4.697144,-74.140516)"
2014,Octubre,Perú,604,11,12,,23,"(4.815061,-75.736532)"
2014,Octubre,Perú,604,398,480,,878,"(6.171601,-75.427454)"
2014,Octubre,Perú,604,7,8,,15,"(7.128456,-73.183637)"
2014,Octubre,Perú,604,0,3,,3,"(7.927209,-72.507910)"
2014,Octubre,Palestina,99999,2,1,,3,"(4.697144,-74.140516)"
2014,Octubre,Polonia,616,1,0,,1,"(3.541112,-76.384584)"
2014,Octubre,Polonia,616,13,17,,30,"(4.697144,-74.140516)"
2014,Octubre,Portugal,620,0,3,,3,"(3.541112,-76.384584)"
2014,Octubre,Portugal,620,175,148,,323,"(4.697144,-74.140516)"
2014,Octubre,Portugal,620,1,0,,1,"(6.171601,-75.427454)"
2014,Octubre,Puerto Rico/Territorio de Estados Unidos,630,8,6,,14,"(10.445761,-75.516429)"
2014,Octubre,Puerto Rico/Territorio de Estados Unidos,630,9,5,,14,"(10.886611,-74.776708)"
2014,Octubre,Puerto Rico/Territorio de Estados Unidos,630,0,1,,1,"(12.586067,-81.702563)"
2014,Octubre,Puerto Rico/Territorio de Estados Unidos,630,49,47,,96,"(3.541112,-76.384584)"
2014,Octubre,Puerto Rico/Territorio de Estados Unidos,630,534,527,,1061,"(4.697144,-74.140516)"
2014,Octubre,Puerto Rico/Territorio de Estados Unidos,630,17,7,,24,"(4.815061,-75.736532)"
2014,Octubre,Puerto Rico/Territorio de Estados Unidos,630,47,36,,83,"(6.171601,-75.427454)"
2014,Octubre,Puerto Rico/Territorio de Estados Unidos,630,6,4,,10,"(7.128456,-73.183637)"
2014,Octubre,Puerto Rico/Territorio de Estados Unidos,630,0,3,,3,"(7.927209,-72.507910)"
2014,Octubre,Qatar,634,2,6,,8,"(4.697144,-74.140516)"
2014,Octubre,Reino Unido de Gran Bretaña e Irlanda del Norte,826,1,0,,1,"(10.445761,-75.516429)"
2014,Octubre,Reino Unido de Gran Bretaña e Irlanda del Norte,826,0,1,,1,"(10.886611,-74.776708)"
2014,Octubre,Reino Unido de Gran Bretaña e Irlanda del Norte,826,8,4,,12,"(3.541112,-76.384584)"
2014,Octubre,Reino Unido de Gran Bretaña e Irlanda del Norte,826,1441,1257,,2698,"(4.697144,-74.140516)"
2014,Octubre,Reino Unido de Gran Bretaña e Irlanda del Norte,826,8,9,,17,"(6.171601,-75.427454)"
2014,Octubre,República CentroÁfricana,140,2,1,,3,"(4.697144,-74.140516)"
2014,Octubre,Federación de Rusia,643,0,1,,1,"(3.541112,-76.384584)"
2014,Octubre,Federación de Rusia,643,34,47,,81,"(4.697144,-74.140516)"
2014,Octubre,Federación de Rusia,643,1,0,,1,"(4.815061,-75.736532)"
2014,Octubre,Federación de Rusia,643,0,3,,3,"(6.171601,-75.427454)"
2014,Octubre,República Dominicana,214,11,39,,50,"(10.445761,-75.516429)"
2014,Octubre,República Dominicana,214,34,28,,62,"(10.886611,-74.776708)"
2014,Octubre,República Dominicana,214,0,1,,1,"(11.247723,-74.213989)"
2014,Octubre,República Dominicana,214,53,58,,111,"(3.541112,-76.384584)"
2014,Octubre,República Dominicana,214,2534,2374,,4908,"(4.697144,-74.140516)"
2014,Octubre,República Dominicana,214,18,10,,28,"(4.815061,-75.736532)"
2014,Octubre,República Dominicana,214,221,222,,443,"(6.171601,-75.427454)"
2014,Octubre,República Dominicana,214,3,8,,11,"(7.128456,-73.183637)"
2014,Octubre,República Dominicana,214,12,13,,25,"(7.927209,-72.507910)"
2014,Octubre,República Democrática Popular de Corea,408,0,1,,1,"(3.541112,-76.384584)"
2014,Octubre,República Democrática Popular de Corea,408,0,1,,1,"(4.697144,-74.140516)"
2014,Octubre,Rumania,642,3,3,,6,"(4.697144,-74.140516)"
2014,Octubre,Rwanda,646,1,1,,2,"(4.697144,-74.140516)"
2014,Octubre,Samoa Occidental,882,0,1,,1,"(4.697144,-74.140516)"
2014,Octubre,San  Vicente y las Granadinas,670,1,1,,2,"(6.171601,-75.427454)"
2014,Octubre,Santa Lucia,662,1,0,,1,"(6.171601,-75.427454)"
2014,Octubre,Santo Tomé y Príncipe,678,1,0,,1,"(4.697144,-74.140516)"
2014,Octubre,Senegal,686,0,1,,1,"(4.697144,-74.140516)"
2014,Octubre,Serbia,688,1,2,,3,"(4.697144,-74.140516)"
2014,Octubre,Seychelles,690,1,0,,1,"(4.697144,-74.140516)"
2014,Octubre,Singapur,702,10,15,,25,"(4.697144,-74.140516)"
2014,Octubre,Singapur,702,1,1,,2,"(6.171601,-75.427454)"
2014,Octubre,Sri Lanka,144,2,1,,3,"(4.697144,-74.140516)"
2014,Octubre,Sri Lanka,144,1,0,,1,"(6.171601,-75.427454)"
2014,Octubre,Sudáfrica,710,0,1,,1,"(10.886611,-74.776708)"
2014,Octubre,Sudáfrica,710,1,4,,5,"(3.541112,-76.384584)"
2014,Octubre,Sudáfrica,710,10,15,,25,"(4.697144,-74.140516)"
2014,Octubre,Sudán,736,3,1,,4,"(4.697144,-74.140516)"
2014,Octubre,Suecia,752,1,1,,2,"(3.541112,-76.384584)"
2014,Octubre,Suecia,752,47,30,,77,"(4.697144,-74.140516)"
2014,Octubre,Suecia,752,1,3,,4,"(6.171601,-75.427454)"
2014,Octubre,Suiza,756,0,1,,1,"(10.445761,-75.516429)"
2014,Octubre,Suiza,756,12,5,,17,"(3.541112,-76.384584)"
2014,Octubre,Suiza,756,211,133,,344,"(4.697144,-74.140516)"
2014,Octubre,Suiza,756,9,7,,16,"(6.171601,-75.427454)"
2014,Octubre,Surinam,740,1,1,,2,"(10.886611,-74.776708)"
2014,Octubre,Surinam,740,4,16,,20,"(4.697144,-74.140516)"
2014,Octubre,Surinam,740,3,2,,5,"(6.171601,-75.427454)"
2014,Octubre,Taiwán,158,2,6,,8,"(4.697144,-74.140516)"
2014,Octubre,Taiwán,158,0,1,,1,"(4.815061,-75.736532)"
2014,Octubre,Taiwán,158,0,2,,2,"(6.171601,-75.427454)"
2014,Octubre,Tailandia,764,0,1,,1,"(10.445761,-75.516429)"
2014,Octubre,Tailandia,764,8,9,,17,"(3.541112,-76.384584)"
2014,Octubre,Tailandia,764,27,30,,57,"(4.697144,-74.140516)"
2014,Octubre,Tailandia,764,1,2,,3,"(6.171601,-75.427454)"
2014,Octubre,Tanzania,834,0,1,,1,"(4.697144,-74.140516)"
2014,Octubre,Tanzania,834,0,1,,1,"(4.815061,-75.736532)"
2014,Octubre,Togo,768,0,1,,1,"(4.697144,-74.140516)"
2014,Octubre,Trinidad y Tobago,780,0,1,,1,"(10.408582,-75.538003)"
2014,Octubre,Trinidad y Tobago,780,0,2,,2,"(10.445761,-75.516429)"
2014,Octubre,Trinidad y Tobago,780,0,3,,3,"(10.886611,-74.776708)"
2014,Octubre,Trinidad y Tobago,780,7,18,,25,"(3.541112,-76.384584)"
2014,Octubre,Trinidad y Tobago,780,26,37,,63,"(4.697144,-74.140516)"
2014,Octubre,Trinidad y Tobago,780,4,2,,6,"(4.815061,-75.736532)"
2014,Octubre,Trinidad y Tobago,780,5,1,,6,"(6.171601,-75.427454)"
2014,Octubre,Trinidad y Tobago,780,5,3,,8,"(7.128456,-73.183637)"
2014,Octubre,Trinidad y Tobago,780,0,2,,2,"(7.927209,-72.507910)"
2014,Octubre,Trinidad y Tobago,780,0,1,,1,"(9.402978,-75.681599)"
2014,Octubre,Túnez,788,1,0,,1,"(4.697144,-74.140516)"
2014,Octubre,Turquía,792,2,0,,2,"(3.541112,-76.384584)"
2014,Octubre,Turquía,792,114,88,,202,"(4.697144,-74.140516)"
2014,Octubre,Turquía,792,2,0,,2,"(4.815061,-75.736532)"
2014,Octubre,Turquía,792,4,8,,12,"(6.171601,-75.427454)"
2014,Octubre,Turkmenistán,795,0,1,,1,"(0.814836,-77.662532)"
2014,Octubre,Turkmenistán,795,1,0,,1,"(4.697144,-74.140516)"
2014,Octubre,Ucrania,804,0,7,,7,"(4.697144,-74.140516)"
2014,Octubre,Uganda,800,0,1,,1,"(10.445761,-75.516429)"
2014,Octubre,Uruguay,858,0,2,,2,"(0.814836,-77.662532)"
2014,Octubre,Uruguay,858,6,1,,7,"(10.445761,-75.516429)"
2014,Octubre,Uruguay,858,2,3,,5,"(10.886611,-74.776708)"
2014,Octubre,Uruguay,858,9,13,,22,"(3.541112,-76.384584)"
2014,Octubre,Uruguay,858,73,83,,156,"(4.697144,-74.140516)"
2014,Octubre,Uruguay,858,0,2,,2,"(4.815061,-75.736532)"
2014,Octubre,Uruguay,858,19,27,,46,"(6.171601,-75.427454)"
2014,Octubre,Venezuela,862,1,5,,6,"(10.445761,-75.516429)"
2014,Octubre,Venezuela,862,6,21,,27,"(10.886611,-74.776708)"
2014,Octubre,Venezuela,862,10163,8839,,19002,"(11.360009,-72.129330)"
2014,Octubre,Venezuela,862,1,1,,2,"(12.586067,-81.702563)"
2014,Octubre,Venezuela,862,12,40,,52,"(3.541112,-76.384584)"
2014,Octubre,Venezuela,862,1119,1472,,2591,"(4.697144,-74.140516)"
2014,Octubre,Venezuela,862,5,6,,11,"(4.815061,-75.736532)"
2014,Octubre,Venezuela,862,36,80,,116,"(6.171601,-75.427454)"
2014,Octubre,Venezuela,862,186,206,,392,"(6.185799,-67.483929)"
2014,Octubre,Venezuela,862,2880,2282,,5162,"(7.088729,-70.740253)"
2014,Octubre,Venezuela,862,1,2,,3,"(7.128456,-73.183637)"
2014,Octubre,Venezuela,862,8785,7680,,16465,"(7.818934,-72.453226)"
2014,Octubre,Venezuela,862,3,2,,5,"(7.927209,-72.507910)"
2014,Octubre,Vietnam,704,4,4,,8,"(4.697144,-74.140516)"
2014,Octubre,Islas Vírgenes Británicas/Territorio Británico de Ultramar,92,1,2,,3,"(3.541112,-76.384584)"
2014,Octubre,Islas Vírgenes Británicas/Territorio Británico de Ultramar,92,3,3,,6,"(4.697144,-74.140516)"
2014,Octubre,Islas Vírgenes Estadounidenses/Territorio de Estados Unidos,850,1,0,,1,"(4.697144,-74.140516)"
2014,Octubre,República Árabe de Yemen,887,0,1,,1,"(4.697144,-74.140516)"
2014,Octubre,Zambia,894,0,1,,1,"(4.697144,-74.140516)"
2014,Octubre,Anguila/Territorio Británico de Ultramar,660,1,0,,1,"(6.171601,-75.427454)"
2014,Octubre,Desconocido,99999,294,354,,648,"(4.697144,-74.140516)"
2014,Noviembre,Afganistán,4,3,2,,5,"(4.697144,-74.140516)"
2014,Noviembre,Albania,8,0,1,,1,"(3.541112,-76.384584)"
2014,Noviembre,Alemania,276,3,1,,4,"(10.445761,-75.516429)"
2014,Noviembre,Alemania,276,0,3,,3,"(10.886611,-74.776708)"
2014,Noviembre,Alemania,276,11,9,,20,"(3.541112,-76.384584)"
2014,Noviembre,Alemania,276,750,842,,1592,"(4.697144,-74.140516)"
2014,Noviembre,Alemania,276,0,1,,1,"(4.815061,-75.736532)"
2014,Noviembre,Alemania,276,9,15,,24,"(6.171601,-75.427454)"
2014,Noviembre,Angola,24,1,11,,12,"(4.697144,-74.140516)"
2014,Noviembre,Antigua y Barbuda,28,0,1,,1,"(10.886611,-74.776708)"
2014,Noviembre,Antigua y Barbuda,28,0,2,,2,"(4.697144,-74.140516)"
2014,Noviembre,Antigua y Barbuda,28,0,1,,1,"(4.815061,-75.736532)"
2014,Noviembre,Antigua y Barbuda,28,0,1,,1,"(6.171601,-75.427454)"
2014,Noviembre,Países Bajos,528,49,24,,73,"(10.408582,-75.538003)"
2014,Noviembre,Países Bajos,528,0,9,,9,"(10.445761,-75.516429)"
2014,Noviembre,Países Bajos,528,3,1,,4,"(10.886611,-74.776708)"
2014,Noviembre,Países Bajos,528,1,0,,1,"(11.247723,-74.213989)"
2014,Noviembre,Países Bajos,528,1,0,,1,"(12.586067,-81.702563)"
2014,Noviembre,Países Bajos,528,40,10,,50,"(3.541112,-76.384584)"
2014,Noviembre,Países Bajos,528,134,109,,243,"(4.697144,-74.140516)"
2014,Noviembre,Países Bajos,528,0,2,,2,"(4.815061,-75.736532)"
2014,Noviembre,Países Bajos,528,49,20,,69,"(6.171601,-75.427454)"
2014,Noviembre,Países Bajos,528,1,0,,1,"(7.128456,-73.183637)"
2014,Noviembre,Países Bajos,528,0,1,,1,"(7.927209,-72.507910)"
2014,Noviembre,Arabia Saudita,682,8,28,,36,"(4.697144,-74.140516)"
2014,Noviembre,Arabia Saudita,682,0,1,,1,"(6.171601,-75.427454)"
2014,Noviembre,Argelia,12,2,7,,9,"(4.697144,-74.140516)"
2014,Noviembre,Argentina,32,22,41,,63,"(0.814836,-77.662532)"
2014,Noviembre,Argentina,32,37,30,,67,"(10.445761,-75.516429)"
2014,Noviembre,Argentina,32,29,23,,52,"(10.886611,-74.776708)"
2014,Noviembre,Argentina,32,3,4,,7,"(12.586067,-81.702563)"
2014,Noviembre,Argentina,32,171,163,,334,"(3.541112,-76.384584)"
2014,Noviembre,Argentina,32,3079,3216,,6295,"(4.697144,-74.140516)"
2014,Noviembre,Argentina,32,17,33,,50,"(4.815061,-75.736532)"
2014,Noviembre,Argentina,32,248,240,,488,"(6.171601,-75.427454)"
2014,Noviembre,Argentina,32,18,18,,36,"(7.128456,-73.183637)"
2014,Noviembre,Argentina,32,2,2,,4,"(7.927209,-72.507910)"
2014,Noviembre,Aruba,533,2688,1846,,4534,"(10.408582,-75.538003)"
2014,Noviembre,Aruba,533,4,3,,7,"(10.445761,-75.516429)"
2014,Noviembre,Aruba,533,21,19,,40,"(10.886611,-74.776708)"
2014,Noviembre,Aruba,533,28,17,,45,"(3.541112,-76.384584)"
2014,Noviembre,Aruba,533,1217,907,,2124,"(4.697144,-74.140516)"
2014,Noviembre,Aruba,533,14,8,,22,"(4.815061,-75.736532)"
2014,Noviembre,Aruba,533,77,38,,115,"(6.171601,-75.427454)"
2014,Noviembre,Aruba,533,11,20,,31,"(7.128456,-73.183637)"
2014,Noviembre,Aruba,533,3,1,,4,"(7.927209,-72.507910)"
2014,Noviembre,Australia,36,1,2,,3,"(10.445761,-75.516429)"
2014,Noviembre,Australia,36,1,2,,3,"(10.886611,-74.776708)"
2014,Noviembre,Australia,36,12,7,,19,"(3.541112,-76.384584)"
2014,Noviembre,Australia,36,178,125,,303,"(4.697144,-74.140516)"
2014,Noviembre,Australia,36,2,2,,4,"(4.815061,-75.736532)"
2014,Noviembre,Australia,36,35,20,,55,"(6.171601,-75.427454)"
2014,Noviembre,Australia,36,2,1,,3,"(7.128456,-73.183637)"
2014,Noviembre,Austria,40,1,1,,2,"(10.886611,-74.776708)"
2014,Noviembre,Austria,40,29,27,,56,"(4.697144,-74.140516)"
2014,Noviembre,Austria,40,1,0,,1,"(6.171601,-75.427454)"
2014,Noviembre,Azerbaiyán,31,1,2,,3,"(4.697144,-74.140516)"
2014,Noviembre,Bahamas,44,2,1,,3,"(10.445761,-75.516429)"
2014,Noviembre,Bahamas,44,1,2,,3,"(10.886611,-74.776708)"
2014,Noviembre,Bahamas,44,0,1,,1,"(12.586067,-81.702563)"
2014,Noviembre,Bahamas,44,9,5,,14,"(3.541112,-76.384584)"
2014,Noviembre,Bahamas,44,34,40,,74,"(4.697144,-74.140516)"
2014,Noviembre,Bahamas,44,1,2,,3,"(4.815061,-75.736532)"
2014,Noviembre,Bahamas,44,26,23,,49,"(6.171601,-75.427454)"
2014,Noviembre,Bahamas,44,1,0,,1,"(7.128456,-73.183637)"
2014,Noviembre,Bahréin,48,1,1,,2,"(4.697144,-74.140516)"
2014,Noviembre,Bangladesh,50,1,1,,2,"(4.697144,-74.140516)"
2014,Noviembre,Barbados,52,2,3,,5,"(4.697144,-74.140516)"
2014,Noviembre,República de Belarús,112,6,4,,10,"(11.360009,-72.129330)"
2014,Noviembre,República de Belarús,112,0,1,,1,"(4.697144,-74.140516)"
2014,Noviembre,República de Belarús,112,0,1,,1,"(7.818934,-72.453226)"
2014,Noviembre,Bélgica,56,6,3,,9,"(3.541112,-76.384584)"
2014,Noviembre,Bélgica,56,51,48,,99,"(4.697144,-74.140516)"
2014,Noviembre,Bélgica,56,12,5,,17,"(6.171601,-75.427454)"
2014,Noviembre,Belice,84,2,7,,9,"(4.697144,-74.140516)"
2014,Noviembre,Benín,204,0,2,,2,"(4.697144,-74.140516)"
2014,Noviembre,Bermudas/Territorio Británico de Ultramar,60,1,1,,2,"(4.697144,-74.140516)"
2014,Noviembre,Bolivia,68,2,10,,12,"(0.814836,-77.662532)"
2014,Noviembre,Bolivia,68,1,0,,1,"(10.445761,-75.516429)"
2014,Noviembre,Bolivia,68,4,4,,8,"(10.886611,-74.776708)"
2014,Noviembre,Bolivia,68,24,35,,59,"(3.541112,-76.384584)"
2014,Noviembre,Bolivia,68,230,432,,662,"(4.697144,-74.140516)"
2014,Noviembre,Bolivia,68,2,2,,4,"(4.815061,-75.736532)"
2014,Noviembre,Bolivia,68,23,37,,60,"(6.171601,-75.427454)"
2014,Noviembre,Bolivia,68,0,2,,2,"(7.128456,-73.183637)"
2014,Noviembre,Brasil,76,94,175,,269,"(-4.197703,-69.941278)"
2014,Noviembre,Brasil,76,0,5,,5,"(0.814836,-77.662532)"
2014,Noviembre,Brasil,76,7,10,,17,"(10.445761,-75.516429)"
2014,Noviembre,Brasil,76,11,37,,48,"(10.886611,-74.776708)"
2014,Noviembre,Brasil,76,0,5,,5,"(12.586067,-81.702563)"
2014,Noviembre,Brasil,76,71,131,,202,"(3.541112,-76.384584)"
2014,Noviembre,Brasil,76,2619,3560,,6179,"(4.697144,-74.140516)"
2014,Noviembre,Brasil,76,15,30,,45,"(4.815061,-75.736532)"
2014,Noviembre,Brasil,76,106,164,,270,"(6.171601,-75.427454)"
2014,Noviembre,Brasil,76,3,6,,9,"(7.128456,-73.183637)"
2014,Noviembre,Bulgaria,100,2,0,,2,"(4.697144,-74.140516)"
2014,Noviembre,Islas Caimán/Territorio Británico de Ultramar,136,1,0,,1,"(10.886611,-74.776708)"
2014,Noviembre,Islas Caimán/Territorio Británico de Ultramar,136,2,0,,2,"(12.586067,-81.702563)"
2014,Noviembre,Islas Caimán/Territorio Británico de Ultramar,136,1,0,,1,"(3.541112,-76.384584)"
2014,Noviembre,Islas Caimán/Territorio Británico de Ultramar,136,1,1,,2,"(4.697144,-74.140516)"
2014,Noviembre,Islas Caimán/Territorio Británico de Ultramar,136,0,1,,1,"(6.171601,-75.427454)"
2014,Noviembre,Camboya,116,0,1,,1,"(4.697144,-74.140516)"
2014,Noviembre,Camerún,120,1,2,,3,"(4.697144,-74.140516)"
2014,Noviembre,Canadá,124,16,8,,24,"(10.445761,-75.516429)"
2014,Noviembre,Canadá,124,16,11,,27,"(10.886611,-74.776708)"
2014,Noviembre,Canadá,124,58,38,,96,"(3.541112,-76.384584)"
2014,Noviembre,Canadá,124,4,3,,7,"(4.452882,-75.766298)"
2014,Noviembre,Canadá,124,790,667,,1457,"(4.697144,-74.140516)"
2014,Noviembre,Canadá,124,7,2,,9,"(4.815061,-75.736532)"
2014,Noviembre,Canadá,124,100,86,,186,"(6.171601,-75.427454)"
2014,Noviembre,Canadá,124,4,1,,5,"(7.128456,-73.183637)"
2014,Noviembre,Canadá,124,2,0,,2,"(7.927209,-72.507910)"
2014,Noviembre,Chad,148,0,2,,2,"(4.697144,-74.140516)"
2014,Noviembre,España,724,2,0,,2,"(0.814836,-77.662532)"
2014,Noviembre,España,724,1,0,,1,"(10.445761,-75.516429)"
2014,Noviembre,España,724,0,1,,1,"(10.886611,-74.776708)"
2014,Noviembre,España,724,766,485,,1251,"(3.541112,-76.384584)"
2014,Noviembre,España,724,5086,4182,,9268,"(4.697144,-74.140516)"
2014,Noviembre,España,724,0,5,,5,"(4.815061,-75.736532)"
2014,Noviembre,España,724,465,322,,787,"(6.171601,-75.427454)"
2014,Noviembre,Colombia,170,541,652,,1193,"(4.697144,-74.140516)"
2014,Noviembre,República Del Congo,178,0,7,,7,"(4.697144,-74.140516)"
2014,Noviembre,República Democrática del Congo,180,1,0,,1,"(3.541112,-76.384584)"
2014,Noviembre,República Democrática del Congo,180,0,2,,2,"(4.697144,-74.140516)"
2014,Noviembre,República de Corea,410,31,47,,78,"(4.697144,-74.140516)"
2014,Noviembre,República de Corea,410,1,2,,3,"(6.171601,-75.427454)"
2014,Noviembre,Costa de Marfil,384,1,3,,4,"(4.697144,-74.140516)"
2014,Noviembre,Costa de Marfil,384,1,0,,1,"(6.171601,-75.427454)"
2014,Noviembre,Costa Rica,188,2,3,,5,"(10.408582,-75.538003)"
2014,Noviembre,Costa Rica,188,11,11,,22,"(10.445761,-75.516429)"
2014,Noviembre,Costa Rica,188,19,20,,39,"(10.886611,-74.776708)"
2014,Noviembre,Costa Rica,188,5,53,,58,"(12.5744111,-81.703935)"
2014,Noviembre,Costa Rica,188,1,3,,4,"(12.586067,-81.702563)"
2014,Noviembre,Costa Rica,188,44,59,,103,"(3.541112,-76.384584)"
2014,Noviembre,Costa Rica,188,790,1015,,1805,"(4.697144,-74.140516)"
2014,Noviembre,Costa Rica,188,17,18,,35,"(4.815061,-75.736532)"
2014,Noviembre,Costa Rica,188,112,140,,252,"(6.171601,-75.427454)"
2014,Noviembre,Costa Rica,188,6,6,,12,"(7.128456,-73.183637)"
2014,Noviembre,Costa Rica,188,2,2,,4,"(7.927209,-72.507910)"
2014,Noviembre,Costa Rica,188,0,1,,1,"(8.066966,-76.735404)"
2014,Noviembre,Croacia,191,3,2,,5,"(4.697144,-74.140516)"
2014,Noviembre,Cuba,192,25,28,,53,"(10.445761,-75.516429)"
2014,Noviembre,Cuba,192,14,20,,34,"(10.886611,-74.776708)"
2014,Noviembre,Cuba,192,0,3,,3,"(12.586067,-81.702563)"
2014,Noviembre,Cuba,192,124,117,,241,"(3.541112,-76.384584)"
2014,Noviembre,Cuba,192,1034,952,,1986,"(4.697144,-74.140516)"
2014,Noviembre,Cuba,192,17,26,,43,"(4.815061,-75.736532)"
2014,Noviembre,Cuba,192,178,150,,328,"(6.171601,-75.427454)"
2014,Noviembre,Cuba,192,23,23,,46,"(7.128456,-73.183637)"
2014,Noviembre,Cuba,192,2,3,,5,"(7.927209,-72.507910)"
2014,Noviembre,Curazao,99999,87,54,,141,"(10.886611,-74.776708)"
2014,Noviembre,Curazao,99999,0,1,,1,"(11.247723,-74.213989)"
2014,Noviembre,Curazao,99999,12,1,,13,"(3.541112,-76.384584)"
2014,Noviembre,Curazao,99999,526,447,,973,"(4.697144,-74.140516)"
2014,Noviembre,Curazao,99999,63,36,,99,"(6.171601,-75.427454)"
2014,Noviembre,Curazao,99999,1,4,,5,"(7.128456,-73.183637)"
2014,Noviembre,República Checa,203,2,6,,8,"(4.697144,-74.140516)"
2014,Noviembre,Chile,152,74,67,,141,"(0.814836,-77.662532)"
2014,Noviembre,Chile,152,2,0,,2,"(1.813928,-78.763924)"
2014,Noviembre,Chile,152,22,13,,35,"(10.445761,-75.516429)"
2014,Noviembre,Chile,152,22,22,,44,"(10.886611,-74.776708)"
2014,Noviembre,Chile,152,4,3,,7,"(12.586067,-81.702563)"
2014,Noviembre,Chile,152,290,232,,522,"(3.541112,-76.384584)"
2014,Noviembre,Chile,152,3166,3156,,6322,"(4.697144,-74.140516)"
2014,Noviembre,Chile,152,24,34,,58,"(4.815061,-75.736532)"
2014,Noviembre,Chile,152,151,151,,302,"(6.171601,-75.427454)"
2014,Noviembre,Chile,152,10,10,,20,"(7.128456,-73.183637)"
2014,Noviembre,Chile,152,0,1,,1,"(7.927209,-72.507910)"
2014,Noviembre,China,156,0,1,,1,"(10.445761,-75.516429)"
2014,Noviembre,China,156,3,6,,9,"(10.886611,-74.776708)"
2014,Noviembre,China,156,1,10,,11,"(3.541112,-76.384584)"
2014,Noviembre,China,156,97,328,,425,"(4.697144,-74.140516)"
2014,Noviembre,China,156,0,1,,1,"(4.815061,-75.736532)"
2014,Noviembre,China,156,17,35,,52,"(6.171601,-75.427454)"
2014,Noviembre,China,156,2,2,,4,"(7.128456,-73.183637)"
2014,Noviembre,Dinamarca,208,13,13,,26,"(4.697144,-74.140516)"
2014,Noviembre,Dinamarca,208,1,1,,2,"(6.171601,-75.427454)"
2014,Noviembre,Ecuador,218,685,727,,1412,"(0.25129,-76.875963)"
2014,Noviembre,Ecuador,218,5746,6221,,11967,"(0.814836,-77.662532)"
2014,Noviembre,Ecuador,218,141,170,,311,"(1.813928,-78.763924)"
2014,Noviembre,Ecuador,218,0,3,,3,"(10.445761,-75.516429)"
2014,Noviembre,Ecuador,218,5,18,,23,"(10.886611,-74.776708)"
2014,Noviembre,Ecuador,218,1,1,,2,"(12.586067,-81.702563)"
2014,Noviembre,Ecuador,218,568,631,,1199,"(3.541112,-76.384584)"
2014,Noviembre,Ecuador,218,2455,4409,,6864,"(4.697144,-74.140516)"
2014,Noviembre,Ecuador,218,3,9,,12,"(4.815061,-75.736532)"
2014,Noviembre,Ecuador,218,373,378,,751,"(6.171601,-75.427454)"
2014,Noviembre,Ecuador,218,6,3,,9,"(7.128456,-73.183637)"
2014,Noviembre,Ecuador,218,2,1,,3,"(7.927209,-72.507910)"
2014,Noviembre,Egipto,818,21,15,,36,"(4.697144,-74.140516)"
2014,Noviembre,El Salvador,222,0,3,,3,"(10.445761,-75.516429)"
2014,Noviembre,El Salvador,222,1,5,,6,"(10.886611,-74.776708)"
2014,Noviembre,El Salvador,222,59,71,,130,"(3.541112,-76.384584)"
2014,Noviembre,El Salvador,222,750,976,,1726,"(4.697144,-74.140516)"
2014,Noviembre,El Salvador,222,0,2,,2,"(4.815061,-75.736532)"
2014,Noviembre,El Salvador,222,50,66,,116,"(6.171601,-75.427454)"
2014,Noviembre,Emiratos Árabes,784,1,1,,2,"(3.541112,-76.384584)"
2014,Noviembre,Emiratos Árabes,784,84,257,,341,"(4.697144,-74.140516)"
2014,Noviembre,Emiratos Árabes,784,5,7,,12,"(6.171601,-75.427454)"
2014,Noviembre,Eritrea,232,1,0,,1,"(4.697144,-74.140516)"
2014,Noviembre,Eslovenia,705,1,1,,2,"(4.697144,-74.140516)"
2014,Noviembre,Estados Unidos de América,840,3,3,,6,"(0.814836,-77.662532)"
2014,Noviembre,Estados Unidos de América,840,0,3,,3,"(10.408582,-75.538003)"
2014,Noviembre,Estados Unidos de América,840,3583,2832,,6415,"(10.445761,-75.516429)"
2014,Noviembre,Estados Unidos de América,840,2074,1605,,3679,"(10.886611,-74.776708)"
2014,Noviembre,Estados Unidos de América,840,0,3,,3,"(11.117806,-74.232622)"
2014,Noviembre,Estados Unidos de América,840,59,42,,101,"(12.586067,-81.702563)"
2014,Noviembre,Estados Unidos de América,840,5120,3729,,8849,"(3.541112,-76.384584)"
2014,Noviembre,Estados Unidos de América,840,451,313,,764,"(4.452882,-75.766298)"
2014,Noviembre,Estados Unidos de América,840,33792,29347,,63139,"(4.697144,-74.140516)"
2014,Noviembre,Estados Unidos de América,840,827,645,,1472,"(4.815061,-75.736532)"
2014,Noviembre,Estados Unidos de América,840,9120,7188,,16308,"(6.171601,-75.427454)"
2014,Noviembre,Estados Unidos de América,840,286,210,,496,"(7.128456,-73.183637)"
2014,Noviembre,Estados Unidos de América,840,152,104,,256,"(7.927209,-72.507910)"
2014,Noviembre,Estonia,233,1,2,,3,"(4.697144,-74.140516)"
2014,Noviembre,Etiopia,231,1,10,,11,"(4.697144,-74.140516)"
2014,Noviembre,Filipinas,608,1,3,,4,"(4.697144,-74.140516)"
2014,Noviembre,Finlandia,246,7,1,,8,"(4.697144,-74.140516)"
2014,Noviembre,Francia,250,1,0,,1,"(10.445761,-75.516429)"
2014,Noviembre,Francia,250,2,1,,3,"(10.886611,-74.776708)"
2014,Noviembre,Francia,250,15,8,,23,"(3.541112,-76.384584)"
2014,Noviembre,Francia,250,721,653,,1374,"(4.697144,-74.140516)"
2014,Noviembre,Francia,250,24,19,,43,"(6.171601,-75.427454)"
2014,Noviembre,Gabón,266,0,5,,5,"(4.697144,-74.140516)"
2014,Noviembre,Gambia,270,0,1,,1,"(4.697144,-74.140516)"
2014,Noviembre,Ghana,288,1,1,,2,"(4.697144,-74.140516)"
2014,Noviembre,Granada,308,1,0,,1,"(6.171601,-75.427454)"
2014,Noviembre,Grecia,300,4,5,,9,"(4.697144,-74.140516)"
2014,Noviembre,Guatemala,320,2,7,,9,"(10.445761,-75.516429)"
2014,Noviembre,Guatemala,320,2,7,,9,"(10.886611,-74.776708)"
2014,Noviembre,Guatemala,320,0,7,,7,"(12.586067,-81.702563)"
2014,Noviembre,Guatemala,320,51,60,,111,"(3.541112,-76.384584)"
2014,Noviembre,Guatemala,320,476,627,,1103,"(4.697144,-74.140516)"
2014,Noviembre,Guatemala,320,3,4,,7,"(4.815061,-75.736532)"
2014,Noviembre,Guatemala,320,59,99,,158,"(6.171601,-75.427454)"
2014,Noviembre,Guatemala,320,2,3,,5,"(7.128456,-73.183637)"
2014,Noviembre,Guatemala,320,1,0,,1,"(7.927209,-72.507910)"
2014,Noviembre,Guyana,328,4,4,,8,"(10.886611,-74.776708)"
2014,Noviembre,Guyana,328,0,14,,14,"(10.971302,-74.765397)"
2014,Noviembre,Guyana,328,1,2,,3,"(4.697144,-74.140516)"
2014,Noviembre,Guinea,324,1,0,,1,"(4.697144,-74.140516)"
2014,Noviembre,Guinea Ecuatorial,226,1,2,,3,"(3.541112,-76.384584)"
2014,Noviembre,Guinea Ecuatorial,226,2,6,,8,"(4.697144,-74.140516)"
2014,Noviembre,Guinea Ecuatorial,226,1,1,,2,"(6.171601,-75.427454)"
2014,Noviembre,Guam/Territorio no incorporado de Estados Unidos,316,1,0,,1,"(0.25129,-76.875963)"
2014,Noviembre,Guayana Francesa/Departamento de Ultramar Francés,254,0,1,,1,"(10.886611,-74.776708)"
2014,Noviembre,Guayana Francesa/Departamento de Ultramar Francés,254,1,0,,1,"(4.697144,-74.140516)"
2014,Noviembre,Haití,332,2,2,,4,"(10.886611,-74.776708)"
2014,Noviembre,Haití,332,3,16,,19,"(3.541112,-76.384584)"
2014,Noviembre,Haití,332,1,11,,12,"(4.697144,-74.140516)"
2014,Noviembre,Haití,332,3,18,,21,"(6.171601,-75.427454)"
2014,Noviembre,Honduras,340,3,7,,10,"(10.445761,-75.516429)"
2014,Noviembre,Honduras,340,3,12,,15,"(10.886611,-74.776708)"
2014,Noviembre,Honduras,340,0,1,,1,"(12.586067,-81.702563)"
2014,Noviembre,Honduras,340,19,22,,41,"(3.541112,-76.384584)"
2014,Noviembre,Honduras,340,54,132,,186,"(4.697144,-74.140516)"
2014,Noviembre,Honduras,340,2,6,,8,"(4.815061,-75.736532)"
2014,Noviembre,Honduras,340,46,46,,92,"(6.171601,-75.427454)"
2014,Noviembre,Honduras,340,2,0,,2,"(7.128456,-73.183637)"
2014,Noviembre,Honduras,340,0,1,,1,"(7.927209,-72.507910)"
2014,Noviembre,Hong Kong,344,0,1,,1,"(10.886611,-74.776708)"
2014,Noviembre,Hong Kong,344,0,2,,2,"(3.541112,-76.384584)"
2014,Noviembre,Hong Kong,344,21,23,,44,"(4.697144,-74.140516)"
2014,Noviembre,Hong Kong,344,1,1,,2,"(6.171601,-75.427454)"
2014,Noviembre,Hungría,348,2,4,,6,"(4.697144,-74.140516)"
2014,Noviembre,India,356,0,1,,1,"(10.886611,-74.776708)"
2014,Noviembre,India,356,1,3,,4,"(3.541112,-76.384584)"
2014,Noviembre,India,356,50,39,,89,"(4.697144,-74.140516)"
2014,Noviembre,India,356,2,0,,2,"(6.171601,-75.427454)"
2014,Noviembre,Indonesia,360,1,0,,1,"(3.541112,-76.384584)"
2014,Noviembre,Indonesia,360,5,9,,14,"(4.697144,-74.140516)"
2014,Noviembre,Iraq,368,2,9,,11,"(4.697144,-74.140516)"
2014,Noviembre,Iraq,368,0,1,,1,"(6.171601,-75.427454)"
2014,Noviembre,Irán,364,3,3,,6,"(4.697144,-74.140516)"
2014,Noviembre,República de Irlanda,372,2,0,,2,"(3.541112,-76.384584)"
2014,Noviembre,República de Irlanda,372,18,9,,27,"(4.697144,-74.140516)"
2014,Noviembre,República de Irlanda,372,1,0,,1,"(6.171601,-75.427454)"
2014,Noviembre,Islandia,352,1,0,,1,"(3.541112,-76.384584)"
2014,Noviembre,Islandia,352,0,1,,1,"(4.697144,-74.140516)"
2014,Noviembre,Israel,376,4,0,,4,"(3.541112,-76.384584)"
2014,Noviembre,Israel,376,151,121,,272,"(4.697144,-74.140516)"
2014,Noviembre,Israel,376,2,2,,4,"(6.171601,-75.427454)"
2014,Noviembre,Italia,380,1,0,,1,"(10.445761,-75.516429)"
2014,Noviembre,Italia,380,1,0,,1,"(10.886611,-74.776708)"
2014,Noviembre,Italia,380,39,13,,52,"(3.541112,-76.384584)"
2014,Noviembre,Italia,380,406,255,,661,"(4.697144,-74.140516)"
2014,Noviembre,Italia,380,29,27,,56,"(6.171601,-75.427454)"
2014,Noviembre,Jamaica,388,4,8,,12,"(10.445761,-75.516429)"
2014,Noviembre,Jamaica,388,2,2,,4,"(10.886611,-74.776708)"
2014,Noviembre,Jamaica,388,2,5,,7,"(12.586067,-81.702563)"
2014,Noviembre,Jamaica,388,10,8,,18,"(3.541112,-76.384584)"
2014,Noviembre,Jamaica,388,32,29,,61,"(4.697144,-74.140516)"
2014,Noviembre,Jamaica,388,1,3,,4,"(4.815061,-75.736532)"
2014,Noviembre,Jamaica,388,28,22,,50,"(6.171601,-75.427454)"
2014,Noviembre,Jamaica,388,5,0,,5,"(7.128456,-73.183637)"
2014,Noviembre,Japón,392,0,1,,1,"(10.445761,-75.516429)"
2014,Noviembre,Japón,392,2,0,,2,"(10.886611,-74.776708)"
2014,Noviembre,Japón,392,45,71,,116,"(4.697144,-74.140516)"
2014,Noviembre,Japón,392,4,5,,9,"(6.171601,-75.427454)"
2014,Noviembre,Jordania,400,7,9,,16,"(4.697144,-74.140516)"
2014,Noviembre,Kazajistán,398,0,3,,3,"(4.697144,-74.140516)"
2014,Noviembre,Kenia,404,1,1,,2,"(3.541112,-76.384584)"
2014,Noviembre,Kenia,404,2,3,,5,"(4.697144,-74.140516)"
2014,Noviembre,Kuwait,414,0,2,,2,"(6.171601,-75.427454)"
2014,Noviembre,Lituania,440,1,0,,1,"(4.697144,-74.140516)"
2014,Noviembre,Líbano,422,3,9,,12,"(4.697144,-74.140516)"
2014,Noviembre,Luxemburgo,442,1,0,,1,"(3.541112,-76.384584)"
2014,Noviembre,Luxemburgo,442,4,2,,6,"(4.697144,-74.140516)"
2014,Noviembre,Macao,446,0,1,,1,"(4.697144,-74.140516)"
2014,Noviembre,Malasia,458,7,5,,12,"(4.697144,-74.140516)"
2014,Noviembre,Malí,466,1,1,,2,"(4.697144,-74.140516)"
2014,Noviembre,Malta,470,3,2,,5,"(4.697144,-74.140516)"
2014,Noviembre,Marruecos,504,3,10,,13,"(4.697144,-74.140516)"
2014,Noviembre,Marruecos,504,3,1,,4,"(6.171601,-75.427454)"
2014,Noviembre,Mauricio,480,0,1,,1,"(4.697144,-74.140516)"
2014,Noviembre,México,484,5,3,,8,"(0.814836,-77.662532)"
2014,Noviembre,México,484,57,71,,128,"(10.445761,-75.516429)"
2014,Noviembre,México,484,120,117,,237,"(10.886611,-74.776708)"
2014,Noviembre,México,484,1,0,,1,"(10.971302,-74.765397)"
2014,Noviembre,México,484,0,4,,4,"(12.586067,-81.702563)"
2014,Noviembre,México,484,532,535,,1067,"(3.541112,-76.384584)"
2014,Noviembre,México,484,10845,10336,,21181,"(4.697144,-74.140516)"
2014,Noviembre,México,484,146,148,,294,"(4.815061,-75.736532)"
2014,Noviembre,México,484,1576,1288,,2864,"(6.171601,-75.427454)"
2014,Noviembre,México,484,149,127,,276,"(7.128456,-73.183637)"
2014,Noviembre,México,484,64,61,,125,"(7.927209,-72.507910)"
2014,Noviembre,Mónaco,492,1,1,,2,"(4.697144,-74.140516)"
2014,Noviembre,Myanmar,104,0,1,,1,"(4.697144,-74.140516)"
2014,Noviembre,Nauru,520,1,0,,1,"(6.171601,-75.427454)"
2014,Noviembre,Nicaragua,558,3,5,,8,"(10.445761,-75.516429)"
2014,Noviembre,Nicaragua,558,2,4,,6,"(10.886611,-74.776708)"
2014,Noviembre,Nicaragua,558,14,24,,38,"(3.541112,-76.384584)"
2014,Noviembre,Nicaragua,558,25,45,,70,"(4.697144,-74.140516)"
2014,Noviembre,Nicaragua,558,0,2,,2,"(4.815061,-75.736532)"
2014,Noviembre,Nicaragua,558,14,43,,57,"(6.171601,-75.427454)"
2014,Noviembre,Nicaragua,558,1,2,,3,"(7.128456,-73.183637)"
2014,Noviembre,Nicaragua,558,1,1,,2,"(7.927209,-72.507910)"
2014,Noviembre,Nigeria,566,0,12,,12,"(4.697144,-74.140516)"
2014,Noviembre,Níger,562,0,1,,1,"(4.697144,-74.140516)"
2014,Noviembre,Noruega,578,2,0,,2,"(10.886611,-74.776708)"
2014,Noviembre,Noruega,578,14,11,,25,"(4.697144,-74.140516)"
2014,Noviembre,Noruega,578,0,1,,1,"(6.171601,-75.427454)"
2014,Noviembre,Nueva Caledonia/Territorio francés,540,1,1,,2,"(4.697144,-74.140516)"
2014,Noviembre,Nueva Caledonia/Territorio francés,540,1,0,,1,"(6.171601,-75.427454)"
2014,Noviembre,Nueva Zelanda,554,1,1,,2,"(3.541112,-76.384584)"
2014,Noviembre,Nueva Zelanda,554,18,21,,39,"(4.697144,-74.140516)"
2014,Noviembre,Nueva Zelanda,554,2,2,,4,"(6.171601,-75.427454)"
2014,Noviembre,Omán,512,2,5,,7,"(4.697144,-74.140516)"
2014,Noviembre,Papúa Nueva Guinea,598,0,1,,1,"(6.171601,-75.427454)"
2014,Noviembre,Pakistán,586,0,2,,2,"(4.697144,-74.140516)"
2014,Noviembre,Panamá,591,390,378,,768,"(10.408582,-75.538003)"
2014,Noviembre,Panamá,591,433,411,,844,"(10.445761,-75.516429)"
2014,Noviembre,Panamá,591,787,823,,1610,"(10.886611,-74.776708)"
2014,Noviembre,Panamá,591,0,1,,1,"(10.971302,-74.765397)"
2014,Noviembre,Panamá,591,1,1,,2,"(11.247723,-74.213989)"
2014,Noviembre,Panamá,591,2,13,,15,"(12.5744111,-81.703935)"
2014,Noviembre,Panamá,591,224,218,,442,"(12.586067,-81.702563)"
2014,Noviembre,Panamá,591,2096,1831,,3927,"(3.541112,-76.384584)"
2014,Noviembre,Panamá,591,9881,9762,,19643,"(4.697144,-74.140516)"
2014,Noviembre,Panamá,591,420,387,,807,"(4.815061,-75.736532)"
2014,Noviembre,Panamá,591,3978,3602,,7580,"(6.171601,-75.427454)"
2014,Noviembre,Panamá,591,1,8,,9,"(6.228046,-77.404104)"
2014,Noviembre,Panamá,591,17,28,,45,"(7.102626,-77.762647)"
2014,Noviembre,Panamá,591,433,347,,780,"(7.128456,-73.183637)"
2014,Noviembre,Panamá,591,140,156,,296,"(7.927209,-72.507910)"
2014,Noviembre,Panamá,591,0,159,,159,"(8.066966,-76.735404)"
2014,Noviembre,Panamá,591,44,97,,141,"(8.635765,-77.346578)"
2014,Noviembre,Paraguay,600,1,0,,1,"(0.814836,-77.662532)"
2014,Noviembre,Paraguay,600,3,3,,6,"(10.445761,-75.516429)"
2014,Noviembre,Paraguay,600,24,24,,48,"(3.541112,-76.384584)"
2014,Noviembre,Paraguay,600,47,137,,184,"(4.697144,-74.140516)"
2014,Noviembre,Paraguay,600,0,1,,1,"(4.815061,-75.736532)"
2014,Noviembre,Paraguay,600,8,14,,22,"(6.171601,-75.427454)"
2014,Noviembre,Paraguay,600,0,1,,1,"(7.128456,-73.183637)"
2014,Noviembre,Perú,604,113,169,,282,"(-4.197703,-69.941278)"
2014,Noviembre,Perú,604,2,1,,3,"(-4.223468,-69.945098)"
2014,Noviembre,Perú,604,112,200,,312,"(0.814836,-77.662532)"
2014,Noviembre,Perú,604,2,8,,10,"(10.445761,-75.516429)"
2014,Noviembre,Perú,604,34,34,,68,"(10.886611,-74.776708)"
2014,Noviembre,Perú,604,0,6,,6,"(11.117806,-74.232622)"
2014,Noviembre,Perú,604,0,1,,1,"(12.586067,-81.702563)"
2014,Noviembre,Perú,604,365,411,,776,"(3.541112,-76.384584)"
2014,Noviembre,Perú,604,3958,4916,,8874,"(4.697144,-74.140516)"
2014,Noviembre,Perú,604,9,8,,17,"(4.815061,-75.736532)"
2014,Noviembre,Perú,604,462,548,,1010,"(6.171601,-75.427454)"
2014,Noviembre,Perú,604,2,2,,4,"(7.128456,-73.183637)"
2014,Noviembre,Perú,604,4,1,,5,"(7.927209,-72.507910)"
2014,Noviembre,Polonia,616,1,0,,1,"(3.541112,-76.384584)"
2014,Noviembre,Polonia,616,7,12,,19,"(4.697144,-74.140516)"
2014,Noviembre,Portugal,620,1,1,,2,"(10.886611,-74.776708)"
2014,Noviembre,Portugal,620,6,1,,7,"(3.541112,-76.384584)"
2014,Noviembre,Portugal,620,147,113,,260,"(4.697144,-74.140516)"
2014,Noviembre,Portugal,620,0,1,,1,"(4.815061,-75.736532)"
2014,Noviembre,Portugal,620,2,1,,3,"(6.171601,-75.427454)"
2014,Noviembre,Puerto Rico/Territorio de Estados Unidos,630,5,5,,10,"(10.445761,-75.516429)"
2014,Noviembre,Puerto Rico/Territorio de Estados Unidos,630,15,14,,29,"(10.886611,-74.776708)"
2014,Noviembre,Puerto Rico/Territorio de Estados Unidos,630,2,0,,2,"(12.586067,-81.702563)"
2014,Noviembre,Puerto Rico/Territorio de Estados Unidos,630,36,31,,67,"(3.541112,-76.384584)"
2014,Noviembre,Puerto Rico/Territorio de Estados Unidos,630,436,422,,858,"(4.697144,-74.140516)"
2014,Noviembre,Puerto Rico/Territorio de Estados Unidos,630,5,5,,10,"(4.815061,-75.736532)"
2014,Noviembre,Puerto Rico/Territorio de Estados Unidos,630,46,50,,96,"(6.171601,-75.427454)"
2014,Noviembre,Puerto Rico/Territorio de Estados Unidos,630,2,4,,6,"(7.128456,-73.183637)"
2014,Noviembre,Puerto Rico/Territorio de Estados Unidos,630,1,2,,3,"(7.927209,-72.507910)"
2014,Noviembre,Qatar,634,0,1,,1,"(10.886611,-74.776708)"
2014,Noviembre,Qatar,634,3,2,,5,"(4.697144,-74.140516)"
2014,Noviembre,Reino Unido de Gran Bretaña e Irlanda del Norte,826,2,2,,4,"(0.814836,-77.662532)"
2014,Noviembre,Reino Unido de Gran Bretaña e Irlanda del Norte,826,1,3,,4,"(10.445761,-75.516429)"
2014,Noviembre,Reino Unido de Gran Bretaña e Irlanda del Norte,826,0,1,,1,"(10.886611,-74.776708)"
2014,Noviembre,Reino Unido de Gran Bretaña e Irlanda del Norte,826,7,10,,17,"(3.541112,-76.384584)"
2014,Noviembre,Reino Unido de Gran Bretaña e Irlanda del Norte,826,927,752,,1679,"(4.697144,-74.140516)"
2014,Noviembre,Reino Unido de Gran Bretaña e Irlanda del Norte,826,3,8,,11,"(6.171601,-75.427454)"
2014,Noviembre,República CentroÁfricana,140,1,1,,2,"(4.697144,-74.140516)"
2014,Noviembre,Federación de Rusia,643,0,2,,2,"(10.445761,-75.516429)"
2014,Noviembre,Federación de Rusia,643,1,1,,2,"(10.886611,-74.776708)"
2014,Noviembre,Federación de Rusia,643,19,35,,54,"(4.697144,-74.140516)"
2014,Noviembre,Federación de Rusia,643,0,1,,1,"(7.128456,-73.183637)"
2014,Noviembre,República Dominicana,214,0,1,,1,"(10.408582,-75.538003)"
2014,Noviembre,República Dominicana,214,22,29,,51,"(10.445761,-75.516429)"
2014,Noviembre,República Dominicana,214,31,25,,56,"(10.886611,-74.776708)"
2014,Noviembre,República Dominicana,214,5,6,,11,"(12.586067,-81.702563)"
2014,Noviembre,República Dominicana,214,96,95,,191,"(3.541112,-76.384584)"
2014,Noviembre,República Dominicana,214,2343,2170,,4513,"(4.697144,-74.140516)"
2014,Noviembre,República Dominicana,214,13,12,,25,"(4.815061,-75.736532)"
2014,Noviembre,República Dominicana,214,165,132,,297,"(6.171601,-75.427454)"
2014,Noviembre,República Dominicana,214,18,13,,31,"(7.128456,-73.183637)"
2014,Noviembre,República Dominicana,214,3,2,,5,"(7.927209,-72.507910)"
2014,Noviembre,Reunión,638,1,1,,2,"(4.697144,-74.140516)"
2014,Noviembre,República Democrática Popular de Corea,408,1,0,,1,"(10.886611,-74.776708)"
2014,Noviembre,Rumania,642,1,3,,4,"(4.697144,-74.140516)"
2014,Noviembre,Rwanda,646,0,1,,1,"(4.697144,-74.140516)"
2014,Noviembre,Santa Lucia,662,0,1,,1,"(4.697144,-74.140516)"
2014,Noviembre,Senegal,686,1,2,,3,"(4.697144,-74.140516)"
2014,Noviembre,Singapur,702,6,13,,19,"(4.697144,-74.140516)"
2014,Noviembre,Sri Lanka,144,1,1,,2,"(4.697144,-74.140516)"
2014,Noviembre,Sudáfrica,710,29,34,,63,"(4.697144,-74.140516)"
2014,Noviembre,Suecia,752,0,2,,2,"(3.541112,-76.384584)"
2014,Noviembre,Suecia,752,47,48,,95,"(4.697144,-74.140516)"
2014,Noviembre,Suecia,752,1,0,,1,"(6.171601,-75.427454)"
2014,Noviembre,Suiza,756,1,0,,1,"(0.814836,-77.662532)"
2014,Noviembre,Suiza,756,0,1,,1,"(10.445761,-75.516429)"
2014,Noviembre,Suiza,756,18,5,,23,"(3.541112,-76.384584)"
2014,Noviembre,Suiza,756,192,107,,299,"(4.697144,-74.140516)"
2014,Noviembre,Suiza,756,1,2,,3,"(4.815061,-75.736532)"
2014,Noviembre,Suiza,756,11,8,,19,"(6.171601,-75.427454)"
2014,Noviembre,Surinam,740,0,1,,1,"(10.886611,-74.776708)"
2014,Noviembre,Surinam,740,6,8,,14,"(4.697144,-74.140516)"
2014,Noviembre,Surinam,740,2,4,,6,"(6.171601,-75.427454)"
2014,Noviembre,Taiwán,158,1,2,,3,"(3.541112,-76.384584)"
2014,Noviembre,Taiwán,158,7,4,,11,"(4.697144,-74.140516)"
2014,Noviembre,Taiwán,158,0,2,,2,"(6.171601,-75.427454)"
2014,Noviembre,Tailandia,764,17,16,,33,"(4.697144,-74.140516)"
2014,Noviembre,Tailandia,764,2,0,,2,"(6.171601,-75.427454)"
2014,Noviembre,Tanzania,834,1,1,,2,"(4.697144,-74.140516)"
2014,Noviembre,Trinidad y Tobago,780,2,4,,6,"(10.445761,-75.516429)"
2014,Noviembre,Trinidad y Tobago,780,2,5,,7,"(10.886611,-74.776708)"
2014,Noviembre,Trinidad y Tobago,780,4,7,,11,"(3.541112,-76.384584)"
2014,Noviembre,Trinidad y Tobago,780,16,39,,55,"(4.697144,-74.140516)"
2014,Noviembre,Trinidad y Tobago,780,1,1,,2,"(4.815061,-75.736532)"
2014,Noviembre,Trinidad y Tobago,780,13,32,,45,"(6.171601,-75.427454)"
2014,Noviembre,Trinidad y Tobago,780,6,5,,11,"(7.128456,-73.183637)"
2014,Noviembre,Trinidad y Tobago,780,0,1,,1,"(7.927209,-72.507910)"
2014,Noviembre,Túnez,788,0,1,,1,"(4.697144,-74.140516)"
2014,Noviembre,Turquía,792,1,1,,2,"(3.541112,-76.384584)"
2014,Noviembre,Turquía,792,51,58,,109,"(4.697144,-74.140516)"
2014,Noviembre,Turquía,792,0,3,,3,"(6.171601,-75.427454)"
2014,Noviembre,Ucrania,804,0,1,,1,"(4.697144,-74.140516)"
2014,Noviembre,Uruguay,858,1,0,,1,"(0.814836,-77.662532)"
2014,Noviembre,Uruguay,858,0,3,,3,"(10.445761,-75.516429)"
2014,Noviembre,Uruguay,858,5,3,,8,"(10.886611,-74.776708)"
2014,Noviembre,Uruguay,858,19,20,,39,"(3.541112,-76.384584)"
2014,Noviembre,Uruguay,858,106,129,,235,"(4.697144,-74.140516)"
2014,Noviembre,Uruguay,858,0,4,,4,"(4.815061,-75.736532)"
2014,Noviembre,Uruguay,858,26,33,,59,"(6.171601,-75.427454)"
2014,Noviembre,Uruguay,858,0,1,,1,"(7.128456,-73.183637)"
2014,Noviembre,Venezuela,862,5,17,,22,"(10.445761,-75.516429)"
2014,Noviembre,Venezuela,862,4,13,,17,"(10.886611,-74.776708)"
2014,Noviembre,Venezuela,862,0,11,,11,"(10.971302,-74.765397)"
2014,Noviembre,Venezuela,862,9533,8134,,17667,"(11.360009,-72.129330)"
2014,Noviembre,Venezuela,862,2,0,,2,"(12.586067,-81.702563)"
2014,Noviembre,Venezuela,862,15,33,,48,"(3.541112,-76.384584)"
2014,Noviembre,Venezuela,862,993,1419,,2412,"(4.697144,-74.140516)"
2014,Noviembre,Venezuela,862,0,3,,3,"(4.815061,-75.736532)"
2014,Noviembre,Venezuela,862,36,71,,107,"(6.171601,-75.427454)"
2014,Noviembre,Venezuela,862,239,257,,496,"(6.185799,-67.483929)"
2014,Noviembre,Venezuela,862,2652,2009,,4661,"(7.088729,-70.740253)"
2014,Noviembre,Venezuela,862,1,2,,3,"(7.128456,-73.183637)"
2014,Noviembre,Venezuela,862,7456,6484,,13940,"(7.818934,-72.453226)"
2014,Noviembre,Venezuela,862,0,2,,2,"(7.927209,-72.507910)"
2014,Noviembre,Vietnam,704,1,5,,6,"(4.697144,-74.140516)"
2014,Noviembre,Vietnam,704,2,0,,2,"(6.171601,-75.427454)"
2014,Noviembre,Zambia,894,0,1,,1,"(6.171601,-75.427454)"
2014,Noviembre,Islas Turcas y Caicos/Territorio Británico de Ultramar,796,1,0,,1,"(3.541112,-76.384584)"
2014,Noviembre,Desconocido,99999,289,388,,677,"(4.697144,-74.140516)"
2014,Diciembre,Afganistán,4,0,3,,3,"(4.697144,-74.140516)"
2014,Diciembre,Albania,8,0,1,,1,"(4.697144,-74.140516)"
2014,Diciembre,Alemania,276,1,0,,1,"(0.814836,-77.662532)"
2014,Diciembre,Alemania,276,1,0,,1,"(10.445761,-75.516429)"
2014,Diciembre,Alemania,276,1,3,,4,"(10.886611,-74.776708)"
2014,Diciembre,Alemania,276,13,15,,28,"(3.541112,-76.384584)"
2014,Diciembre,Alemania,276,1019,748,,1767,"(4.697144,-74.140516)"
2014,Diciembre,Alemania,276,21,11,,32,"(6.171601,-75.427454)"
2014,Diciembre,Andorra,20,1,0,,1,"(10.408582,-75.538003)"
2014,Diciembre,Angola,24,0,7,,7,"(4.697144,-74.140516)"
2014,Diciembre,Antigua y Barbuda,28,2,2,,4,"(4.697144,-74.140516)"
2014,Diciembre,Países Bajos,528,88,70,,158,"(10.408582,-75.538003)"
2014,Diciembre,Países Bajos,528,1,0,,1,"(10.445761,-75.516429)"
2014,Diciembre,Países Bajos,528,2,0,,2,"(10.886611,-74.776708)"
2014,Diciembre,Países Bajos,528,23,8,,31,"(3.541112,-76.384584)"
2014,Diciembre,Países Bajos,528,185,93,,278,"(4.697144,-74.140516)"
2014,Diciembre,Países Bajos,528,2,0,,2,"(4.815061,-75.736532)"
2014,Diciembre,Países Bajos,528,45,21,,66,"(6.171601,-75.427454)"
2014,Diciembre,Países Bajos,528,0,1,,1,"(7.927209,-72.507910)"
2014,Diciembre,Arabia Saudita,682,16,24,,40,"(4.697144,-74.140516)"
2014,Diciembre,Argelia,12,3,5,,8,"(4.697144,-74.140516)"
2014,Diciembre,Argentina,32,31,47,,78,"(0.814836,-77.662532)"
2014,Diciembre,Argentina,32,12,14,,26,"(10.445761,-75.516429)"
2014,Diciembre,Argentina,32,28,27,,55,"(10.886611,-74.776708)"
2014,Diciembre,Argentina,32,9,8,,17,"(12.586067,-81.702563)"
2014,Diciembre,Argentina,32,248,209,,457,"(3.541112,-76.384584)"
2014,Diciembre,Argentina,32,4346,3840,,8186,"(4.697144,-74.140516)"
2014,Diciembre,Argentina,32,17,11,,28,"(4.815061,-75.736532)"
2014,Diciembre,Argentina,32,347,420,,767,"(6.171601,-75.427454)"
2014,Diciembre,Argentina,32,16,11,,27,"(7.128456,-73.183637)"
2014,Diciembre,República de Armenia,51,1,0,,1,"(4.697144,-74.140516)"
2014,Diciembre,Aruba,533,2066,1474,,3540,"(10.408582,-75.538003)"
2014,Diciembre,Aruba,533,5,2,,7,"(10.445761,-75.516429)"
2014,Diciembre,Aruba,533,38,30,,68,"(10.886611,-74.776708)"
2014,Diciembre,Aruba,533,0,3,,3,"(10.971302,-74.765397)"
2014,Diciembre,Aruba,533,56,42,,98,"(3.541112,-76.384584)"
2014,Diciembre,Aruba,533,1438,1098,,2536,"(4.697144,-74.140516)"
2014,Diciembre,Aruba,533,12,12,,24,"(4.815061,-75.736532)"
2014,Diciembre,Aruba,533,93,64,,157,"(6.171601,-75.427454)"
2014,Diciembre,Aruba,533,21,25,,46,"(7.128456,-73.183637)"
2014,Diciembre,Aruba,533,0,1,,1,"(7.927209,-72.507910)"
2014,Diciembre,Australia,36,4,3,,7,"(10.886611,-74.776708)"
2014,Diciembre,Australia,36,17,9,,26,"(3.541112,-76.384584)"
2014,Diciembre,Australia,36,281,180,,461,"(4.697144,-74.140516)"
2014,Diciembre,Australia,36,1,1,,2,"(4.815061,-75.736532)"
2014,Diciembre,Australia,36,41,25,,66,"(6.171601,-75.427454)"
2014,Diciembre,Austria,40,21,37,,58,"(4.697144,-74.140516)"
2014,Diciembre,Austria,40,0,2,,2,"(6.171601,-75.427454)"
2014,Diciembre,Azerbaiyán,31,8,4,,12,"(4.697144,-74.140516)"
2014,Diciembre,Bahamas,44,1,2,,3,"(10.445761,-75.516429)"
2014,Diciembre,Bahamas,44,7,5,,12,"(10.886611,-74.776708)"
2014,Diciembre,Bahamas,44,11,10,,21,"(3.541112,-76.384584)"
2014,Diciembre,Bahamas,44,13,9,,22,"(4.697144,-74.140516)"
2014,Diciembre,Bahamas,44,3,5,,8,"(4.815061,-75.736532)"
2014,Diciembre,Bahamas,44,17,19,,36,"(6.171601,-75.427454)"
2014,Diciembre,Bahamas,44,0,1,,1,"(7.128456,-73.183637)"
2014,Diciembre,Bahréin,48,1,0,,1,"(11.360009,-72.129330)"
2014,Diciembre,Bahréin,48,2,1,,3,"(4.697144,-74.140516)"
2014,Diciembre,Bahréin,48,1,0,,1,"(6.171601,-75.427454)"
2014,Diciembre,Barbados,52,0,9,,9,"(4.697144,-74.140516)"
2014,Diciembre,Barbados,52,0,1,,1,"(6.171601,-75.427454)"
2014,Diciembre,República de Belarús,112,16,7,,23,"(11.360009,-72.129330)"
2014,Diciembre,República de Belarús,112,0,1,,1,"(7.818934,-72.453226)"
2014,Diciembre,Bélgica,56,7,5,,12,"(3.541112,-76.384584)"
2014,Diciembre,Bélgica,56,94,63,,157,"(4.697144,-74.140516)"
2014,Diciembre,Bélgica,56,11,2,,13,"(6.171601,-75.427454)"
2014,Diciembre,Belice,84,0,1,,1,"(3.541112,-76.384584)"
2014,Diciembre,Belice,84,5,11,,16,"(4.697144,-74.140516)"
2014,Diciembre,Belice,84,2,1,,3,"(6.171601,-75.427454)"
2014,Diciembre,Benín,204,0,1,,1,"(6.171601,-75.427454)"
2014,Diciembre,Bermudas/Territorio Británico de Ultramar,60,2,1,,3,"(6.171601,-75.427454)"
2014,Diciembre,Bolivia,68,6,11,,17,"(0.814836,-77.662532)"
2014,Diciembre,Bolivia,68,0,1,,1,"(10.445761,-75.516429)"
2014,Diciembre,Bolivia,68,1,1,,2,"(10.886611,-74.776708)"
2014,Diciembre,Bolivia,68,35,27,,62,"(3.541112,-76.384584)"
2014,Diciembre,Bolivia,68,282,360,,642,"(4.697144,-74.140516)"
2014,Diciembre,Bolivia,68,5,5,,10,"(4.815061,-75.736532)"
2014,Diciembre,Bolivia,68,21,22,,43,"(6.171601,-75.427454)"
2014,Diciembre,Botsuana,72,0,1,,1,"(4.697144,-74.140516)"
2014,Diciembre,Brasil,76,156,200,,356,"(-4.197703,-69.941278)"
2014,Diciembre,Brasil,76,2,7,,9,"(-4.223468,-69.945098)"
2014,Diciembre,Brasil,76,2,2,,4,"(0.814836,-77.662532)"
2014,Diciembre,Brasil,76,6,18,,24,"(10.445761,-75.516429)"
2014,Diciembre,Brasil,76,12,12,,24,"(10.886611,-74.776708)"
2014,Diciembre,Brasil,76,4,3,,7,"(12.586067,-81.702563)"
2014,Diciembre,Brasil,76,90,71,,161,"(3.541112,-76.384584)"
2014,Diciembre,Brasil,76,3322,3254,,6576,"(4.697144,-74.140516)"
2014,Diciembre,Brasil,76,36,38,,74,"(4.815061,-75.736532)"
2014,Diciembre,Brasil,76,130,133,,263,"(6.171601,-75.427454)"
2014,Diciembre,Brasil,76,5,4,,9,"(7.128456,-73.183637)"
2014,Diciembre,Brasil,76,2,1,,3,"(7.927209,-72.507910)"
2014,Diciembre,Brunei Darussalam,96,0,1,,1,"(4.697144,-74.140516)"
2014,Diciembre,Bulgaria,100,4,3,,7,"(4.697144,-74.140516)"
2014,Diciembre,Cabo Verde,132,1,1,,2,"(4.697144,-74.140516)"
2014,Diciembre,Islas Caimán/Territorio Británico de Ultramar,136,36,24,,60,"(12.586067,-81.702563)"
2014,Diciembre,Islas Caimán/Territorio Británico de Ultramar,136,0,3,,3,"(6.171601,-75.427454)"
2014,Diciembre,Antártida,10,10,70,,80,"(10.408582,-75.538003)"
2014,Diciembre,Camerún,120,1,1,,2,"(4.697144,-74.140516)"
2014,Diciembre,Canadá,124,17,20,,37,"(10.445761,-75.516429)"
2014,Diciembre,Canadá,124,26,15,,41,"(10.886611,-74.776708)"
2014,Diciembre,Canadá,124,3,4,,7,"(12.586067,-81.702563)"
2014,Diciembre,Canadá,124,83,66,,149,"(3.541112,-76.384584)"
2014,Diciembre,Canadá,124,1,0,,1,"(4.452882,-75.766298)"
2014,Diciembre,Canadá,124,1228,941,,2169,"(4.697144,-74.140516)"
2014,Diciembre,Canadá,124,13,11,,24,"(4.815061,-75.736532)"
2014,Diciembre,Canadá,124,150,97,,247,"(6.171601,-75.427454)"
2014,Diciembre,Canadá,124,7,12,,19,"(7.128456,-73.183637)"
2014,Diciembre,Canadá,124,2,3,,5,"(7.927209,-72.507910)"
2014,Diciembre,Chad,148,0,1,,1,"(4.697144,-74.140516)"
2014,Diciembre,España,724,1,0,,1,"(10.445761,-75.516429)"
2014,Diciembre,España,724,1140,776,,1916,"(3.541112,-76.384584)"
2014,Diciembre,España,724,7517,5774,,13291,"(4.697144,-74.140516)"
2014,Diciembre,España,724,7,2,,9,"(4.815061,-75.736532)"
2014,Diciembre,España,724,749,526,,1275,"(6.171601,-75.427454)"
2014,Diciembre,España,724,2,1,,3,"(7.128456,-73.183637)"
2014,Diciembre,Colombia,170,617,635,,1252,"(4.697144,-74.140516)"
2014,Diciembre,República Del Congo,178,1,0,,1,"(3.541112,-76.384584)"
2014,Diciembre,República Del Congo,178,1,4,,5,"(4.697144,-74.140516)"
2014,Diciembre,República Del Congo,178,1,0,,1,"(6.171601,-75.427454)"
2014,Diciembre,República Democrática del Congo,180,0,2,,2,"(4.697144,-74.140516)"
2014,Diciembre,República de Corea,410,1,0,,1,"(3.541112,-76.384584)"
2014,Diciembre,República de Corea,410,12,20,,32,"(4.697144,-74.140516)"
2014,Diciembre,Costa de Marfil,384,1,0,,1,"(3.541112,-76.384584)"
2014,Diciembre,Costa de Marfil,384,3,1,,4,"(4.697144,-74.140516)"
2014,Diciembre,Costa de Marfil,384,1,1,,2,"(6.171601,-75.427454)"
2014,Diciembre,Costa Rica,188,8,12,,20,"(10.445761,-75.516429)"
2014,Diciembre,Costa Rica,188,23,22,,45,"(10.886611,-74.776708)"
2014,Diciembre,Costa Rica,188,0,13,,13,"(12.5744111,-81.703935)"
2014,Diciembre,Costa Rica,188,15,6,,21,"(12.586067,-81.702563)"
2014,Diciembre,Costa Rica,188,59,28,,87,"(3.541112,-76.384584)"
2014,Diciembre,Costa Rica,188,983,943,,1926,"(4.697144,-74.140516)"
2014,Diciembre,Costa Rica,188,5,3,,8,"(4.815061,-75.736532)"
2014,Diciembre,Costa Rica,188,126,121,,247,"(6.171601,-75.427454)"
2014,Diciembre,Costa Rica,188,12,8,,20,"(7.128456,-73.183637)"
2014,Diciembre,Costa Rica,188,5,4,,9,"(7.927209,-72.507910)"
2014,Diciembre,Croacia,191,4,0,,4,"(4.697144,-74.140516)"
2014,Diciembre,Cuba,192,42,33,,75,"(10.445761,-75.516429)"
2014,Diciembre,Cuba,192,49,28,,77,"(10.886611,-74.776708)"
2014,Diciembre,Cuba,192,7,9,,16,"(12.586067,-81.702563)"
2014,Diciembre,Cuba,192,106,93,,199,"(3.541112,-76.384584)"
2014,Diciembre,Cuba,192,1700,1394,,3094,"(4.697144,-74.140516)"
2014,Diciembre,Cuba,192,27,17,,44,"(4.815061,-75.736532)"
2014,Diciembre,Cuba,192,187,135,,322,"(6.171601,-75.427454)"
2014,Diciembre,Cuba,192,20,28,,48,"(7.128456,-73.183637)"
2014,Diciembre,Cuba,192,10,8,,18,"(7.927209,-72.507910)"
2014,Diciembre,Curazao,99999,117,57,,174,"(10.886611,-74.776708)"
2014,Diciembre,Curazao,99999,0,1,,1,"(11.247723,-74.213989)"
2014,Diciembre,Curazao,99999,6,1,,7,"(3.541112,-76.384584)"
2014,Diciembre,Curazao,99999,719,618,,1337,"(4.697144,-74.140516)"
2014,Diciembre,Curazao,99999,131,83,,214,"(6.171601,-75.427454)"
2014,Diciembre,Curazao,99999,0,1,,1,"(7.128456,-73.183637)"
2014,Diciembre,República Checa,203,4,7,,11,"(4.697144,-74.140516)"
2014,Diciembre,Chile,152,70,55,,125,"(0.814836,-77.662532)"
2014,Diciembre,Chile,152,2,1,,3,"(1.813928,-78.763924)"
2014,Diciembre,Chile,152,14,14,,28,"(10.445761,-75.516429)"
2014,Diciembre,Chile,152,21,13,,34,"(10.886611,-74.776708)"
2014,Diciembre,Chile,152,2,0,,2,"(12.586067,-81.702563)"
2014,Diciembre,Chile,152,468,343,,811,"(3.541112,-76.384584)"
2014,Diciembre,Chile,152,4993,3895,,8888,"(4.697144,-74.140516)"
2014,Diciembre,Chile,152,50,33,,83,"(4.815061,-75.736532)"
2014,Diciembre,Chile,152,228,183,,411,"(6.171601,-75.427454)"
2014,Diciembre,Chile,152,11,8,,19,"(7.128456,-73.183637)"
2014,Diciembre,Chile,152,3,2,,5,"(7.927209,-72.507910)"
2014,Diciembre,China,156,1,0,,1,"(10.886611,-74.776708)"
2014,Diciembre,China,156,3,11,,14,"(3.541112,-76.384584)"
2014,Diciembre,China,156,83,136,,219,"(4.697144,-74.140516)"
2014,Diciembre,China,156,11,19,,30,"(6.171601,-75.427454)"
2014,Diciembre,Chipre,196,0,1,,1,"(4.697144,-74.140516)"
2014,Diciembre,Dinamarca,208,1,0,,1,"(3.541112,-76.384584)"
2014,Diciembre,Dinamarca,208,28,20,,48,"(4.697144,-74.140516)"
2014,Diciembre,Dinamarca,208,0,1,,1,"(6.171601,-75.427454)"
2014,Diciembre,Dominica,212,0,1,,1,"(4.697144,-74.140516)"
2014,Diciembre,Ecuador,218,987,1053,,2040,"(0.25129,-76.875963)"
2014,Diciembre,Ecuador,218,14,14,,28,"(0.812436,-77.847006)"
2014,Diciembre,Ecuador,218,11983,11624,,23607,"(0.814836,-77.662532)"
2014,Diciembre,Ecuador,218,258,198,,456,"(1.813928,-78.763924)"
2014,Diciembre,Ecuador,218,0,5,,5,"(10.408582,-75.538003)"
2014,Diciembre,Ecuador,218,4,4,,8,"(10.445761,-75.516429)"
2014,Diciembre,Ecuador,218,11,11,,22,"(10.886611,-74.776708)"
2014,Diciembre,Ecuador,218,1,1,,2,"(12.586067,-81.702563)"
2014,Diciembre,Ecuador,218,958,837,,1795,"(3.541112,-76.384584)"
2014,Diciembre,Ecuador,218,4216,4946,,9162,"(4.697144,-74.140516)"
2014,Diciembre,Ecuador,218,1,2,,3,"(4.815061,-75.736532)"
2014,Diciembre,Ecuador,218,588,471,,1059,"(6.171601,-75.427454)"
2014,Diciembre,Ecuador,218,3,4,,7,"(7.128456,-73.183637)"
2014,Diciembre,Ecuador,218,3,1,,4,"(7.927209,-72.507910)"
2014,Diciembre,Egipto,818,45,148,,193,"(4.697144,-74.140516)"
2014,Diciembre,El Salvador,222,0,2,,2,"(10.445761,-75.516429)"
2014,Diciembre,El Salvador,222,2,2,,4,"(10.886611,-74.776708)"
2014,Diciembre,El Salvador,222,153,137,,290,"(3.541112,-76.384584)"
2014,Diciembre,El Salvador,222,1125,1102,,2227,"(4.697144,-74.140516)"
2014,Diciembre,El Salvador,222,1,1,,2,"(4.815061,-75.736532)"
2014,Diciembre,El Salvador,222,65,75,,140,"(6.171601,-75.427454)"
2014,Diciembre,Emiratos Árabes,784,2,2,,4,"(10.886611,-74.776708)"
2014,Diciembre,Emiratos Árabes,784,6,7,,13,"(3.541112,-76.384584)"
2014,Diciembre,Emiratos Árabes,784,195,245,,440,"(4.697144,-74.140516)"
2014,Diciembre,Emiratos Árabes,784,8,6,,14,"(6.171601,-75.427454)"
2014,Diciembre,Eritrea,232,1,0,,1,"(4.697144,-74.140516)"
2014,Diciembre,Eslovaquia,703,1,5,,6,"(4.697144,-74.140516)"
2014,Diciembre,Eslovaquia,703,0,1,,1,"(7.128456,-73.183637)"
2014,Diciembre,Eslovenia,705,1,1,,2,"(4.697144,-74.140516)"
2014,Diciembre,Estados Unidos de América,840,1,0,,1,"(0.814836,-77.662532)"
2014,Diciembre,Estados Unidos de América,840,1,3,,4,"(10.408582,-75.538003)"
2014,Diciembre,Estados Unidos de América,840,4719,3913,,8632,"(10.445761,-75.516429)"
2014,Diciembre,Estados Unidos de América,840,2819,2337,,5156,"(10.886611,-74.776708)"
2014,Diciembre,Estados Unidos de América,840,77,73,,150,"(12.586067,-81.702563)"
2014,Diciembre,Estados Unidos de América,840,6336,4892,,11228,"(3.541112,-76.384584)"
2014,Diciembre,Estados Unidos de América,840,622,455,,1077,"(4.452882,-75.766298)"
2014,Diciembre,Estados Unidos de América,840,44338,36734,,81072,"(4.697144,-74.140516)"
2014,Diciembre,Estados Unidos de América,840,1177,828,,2005,"(4.815061,-75.736532)"
2014,Diciembre,Estados Unidos de América,840,11854,9460,,21314,"(6.171601,-75.427454)"
2014,Diciembre,Estados Unidos de América,840,483,400,,883,"(7.128456,-73.183637)"
2014,Diciembre,Estados Unidos de América,840,205,181,,386,"(7.927209,-72.507910)"
2014,Diciembre,Etiopia,231,0,6,,6,"(4.697144,-74.140516)"
2014,Diciembre,Filipinas,608,0,1,,1,"(3.541112,-76.384584)"
2014,Diciembre,Filipinas,608,3,2,,5,"(4.697144,-74.140516)"
2014,Diciembre,Finlandia,246,0,1,,1,"(3.541112,-76.384584)"
2014,Diciembre,Finlandia,246,13,9,,22,"(4.697144,-74.140516)"
2014,Diciembre,Francia,250,47,25,,72,"(3.541112,-76.384584)"
2014,Diciembre,Francia,250,1361,1024,,2385,"(4.697144,-74.140516)"
2014,Diciembre,Francia,250,31,19,,50,"(6.171601,-75.427454)"
2014,Diciembre,Gabón,266,0,4,,4,"(4.697144,-74.140516)"
2014,Diciembre,Georgia,268,1,0,,1,"(4.697144,-74.140516)"
2014,Diciembre,Georgia,268,1,0,,1,"(7.128456,-73.183637)"
2014,Diciembre,Ghana,288,4,1,,5,"(4.697144,-74.140516)"
2014,Diciembre,Ghana,288,1,0,,1,"(6.171601,-75.427454)"
2014,Diciembre,Grecia,300,1,1,,2,"(3.541112,-76.384584)"
2014,Diciembre,Grecia,300,6,4,,10,"(4.697144,-74.140516)"
2014,Diciembre,Guatemala,320,1,2,,3,"(10.445761,-75.516429)"
2014,Diciembre,Guatemala,320,2,3,,5,"(10.886611,-74.776708)"
2014,Diciembre,Guatemala,320,1,1,,2,"(12.586067,-81.702563)"
2014,Diciembre,Guatemala,320,49,41,,90,"(3.541112,-76.384584)"
2014,Diciembre,Guatemala,320,563,583,,1146,"(4.697144,-74.140516)"
2014,Diciembre,Guatemala,320,5,3,,8,"(4.815061,-75.736532)"
2014,Diciembre,Guatemala,320,57,66,,123,"(6.171601,-75.427454)"
2014,Diciembre,Guatemala,320,6,3,,9,"(7.128456,-73.183637)"
2014,Diciembre,Guatemala,320,2,4,,6,"(7.927209,-72.507910)"
2014,Diciembre,Guyana,328,1,1,,2,"(10.886611,-74.776708)"
2014,Diciembre,Guyana,328,1,0,,1,"(4.697144,-74.140516)"
2014,Diciembre,Guinea,324,0,1,,1,"(0.814836,-77.662532)"
2014,Diciembre,Guinea Ecuatorial,226,0,4,,4,"(4.697144,-74.140516)"
2014,Diciembre,Guadalupe/Territorio Francés,312,0,1,,1,"(4.697144,-74.140516)"
2014,Diciembre,Guayana Francesa/Departamento de Ultramar Francés,254,0,1,,1,"(10.886611,-74.776708)"
2014,Diciembre,Haití,332,4,3,,7,"(10.886611,-74.776708)"
2014,Diciembre,Haití,332,1,4,,5,"(4.697144,-74.140516)"
2014,Diciembre,Haití,332,2,0,,2,"(4.815061,-75.736532)"
2014,Diciembre,Haití,332,1,3,,4,"(6.171601,-75.427454)"
2014,Diciembre,Haití,332,1,0,,1,"(7.128456,-73.183637)"
2014,Diciembre,Honduras,340,0,11,,11,"(10.445761,-75.516429)"
2014,Diciembre,Honduras,340,5,9,,14,"(10.886611,-74.776708)"
2014,Diciembre,Honduras,340,3,0,,3,"(12.586067,-81.702563)"
2014,Diciembre,Honduras,340,20,23,,43,"(3.541112,-76.384584)"
2014,Diciembre,Honduras,340,75,116,,191,"(4.697144,-74.140516)"
2014,Diciembre,Honduras,340,4,0,,4,"(4.815061,-75.736532)"
2014,Diciembre,Honduras,340,39,58,,97,"(6.171601,-75.427454)"
2014,Diciembre,Honduras,340,1,3,,4,"(7.128456,-73.183637)"
2014,Diciembre,Honduras,340,0,1,,1,"(7.927209,-72.507910)"
2014,Diciembre,Hong Kong,344,2,0,,2,"(3.541112,-76.384584)"
2014,Diciembre,Hong Kong,344,25,45,,70,"(4.697144,-74.140516)"
2014,Diciembre,Hong Kong,344,0,1,,1,"(4.815061,-75.736532)"
2014,Diciembre,Hong Kong,344,0,3,,3,"(6.171601,-75.427454)"
2014,Diciembre,Hungría,348,1,4,,5,"(4.697144,-74.140516)"
2014,Diciembre,India,356,1,0,,1,"(10.886611,-74.776708)"
2014,Diciembre,India,356,1,1,,2,"(3.541112,-76.384584)"
2014,Diciembre,India,356,51,42,,93,"(4.697144,-74.140516)"
2014,Diciembre,India,356,2,0,,2,"(4.815061,-75.736532)"
2014,Diciembre,India,356,2,4,,6,"(6.171601,-75.427454)"
2014,Diciembre,India,356,0,1,,1,"(7.128456,-73.183637)"
2014,Diciembre,Indonesia,360,19,14,,33,"(4.697144,-74.140516)"
2014,Diciembre,Indonesia,360,0,1,,1,"(6.171601,-75.427454)"
2014,Diciembre,Iraq,368,0,10,,10,"(4.697144,-74.140516)"
2014,Diciembre,Irán,364,8,14,,22,"(4.697144,-74.140516)"
2014,Diciembre,República de Irlanda,372,15,10,,25,"(4.697144,-74.140516)"
2014,Diciembre,Islandia,352,1,1,,2,"(4.697144,-74.140516)"
2014,Diciembre,Israel,376,0,1,,1,"(10.886611,-74.776708)"
2014,Diciembre,Israel,376,1,2,,3,"(3.541112,-76.384584)"
2014,Diciembre,Israel,376,188,164,,352,"(4.697144,-74.140516)"
2014,Diciembre,Israel,376,4,2,,6,"(6.171601,-75.427454)"
2014,Diciembre,Italia,380,5,1,,6,"(10.445761,-75.516429)"
2014,Diciembre,Italia,380,1,1,,2,"(10.886611,-74.776708)"
2014,Diciembre,Italia,380,49,24,,73,"(3.541112,-76.384584)"
2014,Diciembre,Italia,380,523,314,,837,"(4.697144,-74.140516)"
2014,Diciembre,Italia,380,0,2,,2,"(4.815061,-75.736532)"
2014,Diciembre,Italia,380,33,21,,54,"(6.171601,-75.427454)"
2014,Diciembre,Jamaica,388,4,0,,4,"(10.445761,-75.516429)"
2014,Diciembre,Jamaica,388,3,3,,6,"(10.886611,-74.776708)"
2014,Diciembre,Jamaica,388,1,0,,1,"(12.586067,-81.702563)"
2014,Diciembre,Jamaica,388,23,12,,35,"(3.541112,-76.384584)"
2014,Diciembre,Jamaica,388,35,35,,70,"(4.697144,-74.140516)"
2014,Diciembre,Jamaica,388,4,2,,6,"(4.815061,-75.736532)"
2014,Diciembre,Jamaica,388,26,18,,44,"(6.171601,-75.427454)"
2014,Diciembre,Jamaica,388,2,5,,7,"(7.128456,-73.183637)"
2014,Diciembre,Japón,392,2,2,,4,"(3.541112,-76.384584)"
2014,Diciembre,Japón,392,47,41,,88,"(4.697144,-74.140516)"
2014,Diciembre,Japón,392,0,2,,2,"(6.171601,-75.427454)"
2014,Diciembre,Jordania,400,4,7,,11,"(4.697144,-74.140516)"
2014,Diciembre,Kazajistán,398,0,2,,2,"(4.697144,-74.140516)"
2014,Diciembre,Kenia,404,2,5,,7,"(4.697144,-74.140516)"
2014,Diciembre,Líbano,422,18,12,,30,"(4.697144,-74.140516)"
2014,Diciembre,Luxemburgo,442,4,3,,7,"(4.697144,-74.140516)"
2014,Diciembre,Malasia,458,7,7,,14,"(4.697144,-74.140516)"
2014,Diciembre,Malasia,458,1,1,,2,"(6.171601,-75.427454)"
2014,Diciembre,Malí,466,0,1,,1,"(4.697144,-74.140516)"
2014,Diciembre,Malta,470,6,6,,12,"(4.697144,-74.140516)"
2014,Diciembre,Marruecos,504,1,3,,4,"(3.541112,-76.384584)"
2014,Diciembre,Marruecos,504,10,12,,22,"(4.697144,-74.140516)"
2014,Diciembre,México,484,5,3,,8,"(0.814836,-77.662532)"
2014,Diciembre,México,484,74,87,,161,"(10.445761,-75.516429)"
2014,Diciembre,México,484,167,117,,284,"(10.886611,-74.776708)"
2014,Diciembre,México,484,2,1,,3,"(12.586067,-81.702563)"
2014,Diciembre,México,484,574,434,,1008,"(3.541112,-76.384584)"
2014,Diciembre,México,484,0,1,,1,"(4.452882,-75.766298)"
2014,Diciembre,México,484,14306,11792,,26098,"(4.697144,-74.140516)"
2014,Diciembre,México,484,210,132,,342,"(4.815061,-75.736532)"
2014,Diciembre,México,484,1981,1415,,3396,"(6.171601,-75.427454)"
2014,Diciembre,México,484,198,139,,337,"(7.128456,-73.183637)"
2014,Diciembre,México,484,151,74,,225,"(7.927209,-72.507910)"
2014,Diciembre,Mónaco,492,0,1,,1,"(4.697144,-74.140516)"
2014,Diciembre,Mozambique,508,0,2,,2,"(4.697144,-74.140516)"
2014,Diciembre,Nepal,524,0,1,,1,"(4.697144,-74.140516)"
2014,Diciembre,Nicaragua,558,0,1,,1,"(10.445761,-75.516429)"
2014,Diciembre,Nicaragua,558,1,6,,7,"(10.886611,-74.776708)"
2014,Diciembre,Nicaragua,558,1,3,,4,"(12.5744111,-81.703935)"
2014,Diciembre,Nicaragua,558,6,3,,9,"(12.586067,-81.702563)"
2014,Diciembre,Nicaragua,558,10,23,,33,"(3.541112,-76.384584)"
2014,Diciembre,Nicaragua,558,32,37,,69,"(4.697144,-74.140516)"
2014,Diciembre,Nicaragua,558,1,1,,2,"(4.815061,-75.736532)"
2014,Diciembre,Nicaragua,558,8,30,,38,"(6.171601,-75.427454)"
2014,Diciembre,Nigeria,566,1,6,,7,"(4.697144,-74.140516)"
2014,Diciembre,Noruega,578,3,0,,3,"(10.445761,-75.516429)"
2014,Diciembre,Noruega,578,27,14,,41,"(4.697144,-74.140516)"
2014,Diciembre,Nueva Zelanda,554,2,1,,3,"(3.541112,-76.384584)"
2014,Diciembre,Nueva Zelanda,554,29,23,,52,"(4.697144,-74.140516)"
2014,Diciembre,Nueva Zelanda,554,0,5,,5,"(6.171601,-75.427454)"
2014,Diciembre,Omán,512,7,7,,14,"(4.697144,-74.140516)"
2014,Diciembre,Papúa Nueva Guinea,598,1,0,,1,"(4.697144,-74.140516)"
2014,Diciembre,Pakistán,586,1,1,,2,"(3.541112,-76.384584)"
2014,Diciembre,Pakistán,586,1,2,,3,"(4.697144,-74.140516)"
2014,Diciembre,Panamá,591,1,0,,1,"(0.814836,-77.662532)"
2014,Diciembre,Panamá,591,796,760,,1556,"(10.408582,-75.538003)"
2014,Diciembre,Panamá,591,336,281,,617,"(10.445761,-75.516429)"
2014,Diciembre,Panamá,591,1003,911,,1914,"(10.886611,-74.776708)"
2014,Diciembre,Panamá,591,0,2,,2,"(11.247723,-74.213989)"
2014,Diciembre,Panamá,591,0,2,,2,"(12.5744111,-81.703935)"
2014,Diciembre,Panamá,591,282,221,,503,"(12.586067,-81.702563)"
2014,Diciembre,Panamá,591,2,14,,16,"(13.3387613,-81.372937)"
2014,Diciembre,Panamá,591,2145,1766,,3911,"(3.541112,-76.384584)"
2014,Diciembre,Panamá,591,11531,10460,,21991,"(4.697144,-74.140516)"
2014,Diciembre,Panamá,591,573,403,,976,"(4.815061,-75.736532)"
2014,Diciembre,Panamá,591,5085,3944,,9029,"(6.171601,-75.427454)"
2014,Diciembre,Panamá,591,1,5,,6,"(6.228046,-77.404104)"
2014,Diciembre,Panamá,591,4,12,,16,"(7.102626,-77.762647)"
2014,Diciembre,Panamá,591,424,357,,781,"(7.128456,-73.183637)"
2014,Diciembre,Panamá,591,216,232,,448,"(7.927209,-72.507910)"
2014,Diciembre,Panamá,591,0,61,,61,"(8.066966,-76.735404)"
2014,Diciembre,Panamá,591,34,65,,99,"(8.635765,-77.346578)"
2014,Diciembre,Paraguay,600,0,1,,1,"(10.445761,-75.516429)"
2014,Diciembre,Paraguay,600,0,2,,2,"(10.886611,-74.776708)"
2014,Diciembre,Paraguay,600,10,21,,31,"(3.541112,-76.384584)"
2014,Diciembre,Paraguay,600,75,136,,211,"(4.697144,-74.140516)"
2014,Diciembre,Paraguay,600,1,2,,3,"(4.815061,-75.736532)"
2014,Diciembre,Paraguay,600,3,6,,9,"(6.171601,-75.427454)"
2014,Diciembre,Paraguay,600,0,1,,1,"(7.128456,-73.183637)"
2014,Diciembre,Perú,604,188,197,,385,"(-4.197703,-69.941278)"
2014,Diciembre,Perú,604,5,9,,14,"(-4.223468,-69.945098)"
2014,Diciembre,Perú,604,134,166,,300,"(0.814836,-77.662532)"
2014,Diciembre,Perú,604,0,7,,7,"(10.408582,-75.538003)"
2014,Diciembre,Perú,604,6,8,,14,"(10.445761,-75.516429)"
2014,Diciembre,Perú,604,25,15,,40,"(10.886611,-74.776708)"
2014,Diciembre,Perú,604,4,4,,8,"(12.586067,-81.702563)"
2014,Diciembre,Perú,604,441,416,,857,"(3.541112,-76.384584)"
2014,Diciembre,Perú,604,5899,5606,,11505,"(4.697144,-74.140516)"
2014,Diciembre,Perú,604,14,7,,21,"(4.815061,-75.736532)"
2014,Diciembre,Perú,604,517,475,,992,"(6.171601,-75.427454)"
2014,Diciembre,Perú,604,17,15,,32,"(7.128456,-73.183637)"
2014,Diciembre,Polonia,616,2,0,,2,"(3.541112,-76.384584)"
2014,Diciembre,Polonia,616,13,15,,28,"(4.697144,-74.140516)"
2014,Diciembre,Polonia,616,2,1,,3,"(6.171601,-75.427454)"
2014,Diciembre,Portugal,620,1,2,,3,"(3.541112,-76.384584)"
2014,Diciembre,Portugal,620,181,134,,315,"(4.697144,-74.140516)"
2014,Diciembre,Portugal,620,1,0,,1,"(6.171601,-75.427454)"
2014,Diciembre,Polinesia Francesa/Colectividad de Ultramar Francesa,258,0,1,,1,"(4.697144,-74.140516)"
2014,Diciembre,Puerto Rico/Territorio de Estados Unidos,630,0,1,,1,"(0.814836,-77.662532)"
2014,Diciembre,Puerto Rico/Territorio de Estados Unidos,630,4,4,,8,"(10.445761,-75.516429)"
2014,Diciembre,Puerto Rico/Territorio de Estados Unidos,630,18,18,,36,"(10.886611,-74.776708)"
2014,Diciembre,Puerto Rico/Territorio de Estados Unidos,630,1,0,,1,"(12.586067,-81.702563)"
2014,Diciembre,Puerto Rico/Territorio de Estados Unidos,630,52,44,,96,"(3.541112,-76.384584)"
2014,Diciembre,Puerto Rico/Territorio de Estados Unidos,630,750,691,,1441,"(4.697144,-74.140516)"
2014,Diciembre,Puerto Rico/Territorio de Estados Unidos,630,12,8,,20,"(4.815061,-75.736532)"
2014,Diciembre,Puerto Rico/Territorio de Estados Unidos,630,83,71,,154,"(6.171601,-75.427454)"
2014,Diciembre,Puerto Rico/Territorio de Estados Unidos,630,21,19,,40,"(7.128456,-73.183637)"
2014,Diciembre,Puerto Rico/Territorio de Estados Unidos,630,1,2,,3,"(7.927209,-72.507910)"
2014,Diciembre,Qatar,634,7,8,,15,"(4.697144,-74.140516)"
2014,Diciembre,Reino Unido de Gran Bretaña e Irlanda del Norte,826,1,0,,1,"(10.886611,-74.776708)"
2014,Diciembre,Reino Unido de Gran Bretaña e Irlanda del Norte,826,6,7,,13,"(3.541112,-76.384584)"
2014,Diciembre,Reino Unido de Gran Bretaña e Irlanda del Norte,826,1439,1037,,2476,"(4.697144,-74.140516)"
2014,Diciembre,Reino Unido de Gran Bretaña e Irlanda del Norte,826,1,0,,1,"(4.815061,-75.736532)"
2014,Diciembre,Reino Unido de Gran Bretaña e Irlanda del Norte,826,5,7,,12,"(6.171601,-75.427454)"
2014,Diciembre,República CentroÁfricana,140,0,3,,3,"(4.697144,-74.140516)"
2014,Diciembre,Federación de Rusia,643,20,38,,58,"(4.697144,-74.140516)"
2014,Diciembre,Federación de Rusia,643,0,1,,1,"(6.171601,-75.427454)"
2014,Diciembre,República Dominicana,214,24,38,,62,"(10.445761,-75.516429)"
2014,Diciembre,República Dominicana,214,48,62,,110,"(10.886611,-74.776708)"
2014,Diciembre,República Dominicana,214,1,1,,2,"(12.586067,-81.702563)"
2014,Diciembre,República Dominicana,214,61,72,,133,"(3.541112,-76.384584)"
2014,Diciembre,República Dominicana,214,2951,2607,,5558,"(4.697144,-74.140516)"
2014,Diciembre,República Dominicana,214,24,16,,40,"(4.815061,-75.736532)"
2014,Diciembre,República Dominicana,214,313,209,,522,"(6.171601,-75.427454)"
2014,Diciembre,República Dominicana,214,28,24,,52,"(7.128456,-73.183637)"
2014,Diciembre,República Dominicana,214,16,11,,27,"(7.927209,-72.507910)"
2014,Diciembre,Rumania,642,2,3,,5,"(4.697144,-74.140516)"
2014,Diciembre,San Marino,674,0,1,,1,"(4.697144,-74.140516)"
2014,Diciembre,Santa Lucia,662,1,1,,2,"(4.697144,-74.140516)"
2014,Diciembre,Senegal,686,2,0,,2,"(4.697144,-74.140516)"
2014,Diciembre,Serbia,688,1,0,,1,"(4.697144,-74.140516)"
2014,Diciembre,Singapur,702,0,1,,1,"(3.541112,-76.384584)"
2014,Diciembre,Singapur,702,24,30,,54,"(4.697144,-74.140516)"
2014,Diciembre,Sudáfrica,710,0,1,,1,"(3.541112,-76.384584)"
2014,Diciembre,Sudáfrica,710,21,25,,46,"(4.697144,-74.140516)"
2014,Diciembre,Sudán,736,0,1,,1,"(4.697144,-74.140516)"
2014,Diciembre,Suecia,752,0,1,,1,"(10.445761,-75.516429)"
2014,Diciembre,Suecia,752,2,1,,3,"(10.886611,-74.776708)"
2014,Diciembre,Suecia,752,1,1,,2,"(3.541112,-76.384584)"
2014,Diciembre,Suecia,752,69,42,,111,"(4.697144,-74.140516)"
2014,Diciembre,Suecia,752,0,1,,1,"(4.815061,-75.736532)"
2014,Diciembre,Suecia,752,5,3,,8,"(6.171601,-75.427454)"
2014,Diciembre,Suiza,756,1,0,,1,"(10.445761,-75.516429)"
2014,Diciembre,Suiza,756,2,0,,2,"(10.886611,-74.776708)"
2014,Diciembre,Suiza,756,13,10,,23,"(3.541112,-76.384584)"
2014,Diciembre,Suiza,756,217,190,,407,"(4.697144,-74.140516)"
2014,Diciembre,Suiza,756,15,12,,27,"(6.171601,-75.427454)"
2014,Diciembre,Surinam,740,4,25,,29,"(4.697144,-74.140516)"
2014,Diciembre,Surinam,740,2,0,,2,"(6.171601,-75.427454)"
2014,Diciembre,Taiwán,158,1,3,,4,"(4.697144,-74.140516)"
2014,Diciembre,Taiwán,158,0,2,,2,"(6.171601,-75.427454)"
2014,Diciembre,República de Tayikistán,762,0,1,,1,"(4.697144,-74.140516)"
2014,Diciembre,Tailandia,764,37,41,,78,"(4.697144,-74.140516)"
2014,Diciembre,Tailandia,764,1,1,,2,"(6.171601,-75.427454)"
2014,Diciembre,Tanzania,834,0,1,,1,"(4.697144,-74.140516)"
2014,Diciembre,Trinidad y Tobago,780,1,3,,4,"(10.445761,-75.516429)"
2014,Diciembre,Trinidad y Tobago,780,2,3,,5,"(10.886611,-74.776708)"
2014,Diciembre,Trinidad y Tobago,780,0,2,,2,"(11.247723,-74.213989)"
2014,Diciembre,Trinidad y Tobago,780,6,1,,7,"(12.586067,-81.702563)"
2014,Diciembre,Trinidad y Tobago,780,8,3,,11,"(3.541112,-76.384584)"
2014,Diciembre,Trinidad y Tobago,780,26,22,,48,"(4.697144,-74.140516)"
2014,Diciembre,Trinidad y Tobago,780,5,4,,9,"(4.815061,-75.736532)"
2014,Diciembre,Trinidad y Tobago,780,10,10,,20,"(6.171601,-75.427454)"
2014,Diciembre,Trinidad y Tobago,780,3,2,,5,"(7.128456,-73.183637)"
2014,Diciembre,Túnez,788,0,1,,1,"(4.697144,-74.140516)"
2014,Diciembre,Túnez,788,1,0,,1,"(7.818934,-72.453226)"
2014,Diciembre,Turquía,792,6,1,,7,"(3.541112,-76.384584)"
2014,Diciembre,Turquía,792,68,58,,126,"(4.697144,-74.140516)"
2014,Diciembre,Turquía,792,9,6,,15,"(6.171601,-75.427454)"
2014,Diciembre,Ucrania,804,1,1,,2,"(4.697144,-74.140516)"
2014,Diciembre,Uganda,800,0,1,,1,"(6.171601,-75.427454)"
2014,Diciembre,Uruguay,858,2,2,,4,"(0.814836,-77.662532)"
2014,Diciembre,Uruguay,858,8,3,,11,"(10.445761,-75.516429)"
2014,Diciembre,Uruguay,858,2,1,,3,"(10.886611,-74.776708)"
2014,Diciembre,Uruguay,858,26,21,,47,"(3.541112,-76.384584)"
2014,Diciembre,Uruguay,858,99,75,,174,"(4.697144,-74.140516)"
2014,Diciembre,Uruguay,858,3,2,,5,"(4.815061,-75.736532)"
2014,Diciembre,Uruguay,858,36,33,,69,"(6.171601,-75.427454)"
2014,Diciembre,Uruguay,858,2,2,,4,"(7.128456,-73.183637)"
2014,Diciembre,Venezuela,862,4,6,,10,"(10.445761,-75.516429)"
2014,Diciembre,Venezuela,862,5,22,,27,"(10.886611,-74.776708)"
2014,Diciembre,Venezuela,862,0,9,,9,"(10.971302,-74.765397)"
2014,Diciembre,Venezuela,862,0,2,,2,"(11.117806,-74.232622)"
2014,Diciembre,Venezuela,862,0,2,,2,"(11.247723,-74.213989)"
2014,Diciembre,Venezuela,862,11217,9284,,20501,"(11.360009,-72.129330)"
2014,Diciembre,Venezuela,862,1,0,,1,"(12.586067,-81.702563)"
2014,Diciembre,Venezuela,862,13,19,,32,"(3.541112,-76.384584)"
2014,Diciembre,Venezuela,862,50,42,,92,"(3.866713,-67.927521)"
2014,Diciembre,Venezuela,862,1573,1640,,3213,"(4.697144,-74.140516)"
2014,Diciembre,Venezuela,862,6,4,,10,"(4.815061,-75.736532)"
2014,Diciembre,Venezuela,862,35,40,,75,"(6.171601,-75.427454)"
2014,Diciembre,Venezuela,862,397,346,,743,"(6.185799,-67.483929)"
2014,Diciembre,Venezuela,862,3221,2575,,5796,"(7.088729,-70.740253)"
2014,Diciembre,Venezuela,862,6,8,,14,"(7.128456,-73.183637)"
2014,Diciembre,Venezuela,862,10773,9319,,20092,"(7.818934,-72.453226)"
2014,Diciembre,Venezuela,862,2,2,,4,"(7.927209,-72.507910)"
2014,Diciembre,Vietnam,704,2,1,,3,"(4.697144,-74.140516)"
2014,Diciembre,Vietnam,704,2,0,,2,"(4.815061,-75.736532)"
2014,Diciembre,Islas Vírgenes Británicas/Territorio Británico de Ultramar,92,1,4,,5,"(4.697144,-74.140516)"
2014,Diciembre,República Árabe de Yemen,887,0,1,,1,"(6.171601,-75.427454)"
2014,Diciembre,República Árabe de Yemen,887,1,0,,1,"(7.818934,-72.453226)"
2014,Diciembre,Islas Turcas y Caicos/Territorio Británico de Ultramar,796,4,7,,11,"(10.445761,-75.516429)"
2014,Diciembre,Islas Turcas y Caicos/Territorio Británico de Ultramar,796,6,5,,11,"(4.697144,-74.140516)"
2014,Diciembre,Desconocido,99999,210,255,,465,"(4.697144,-74.140516)"
2015,Enero,Afganistán,4,2,10,,12,"(4.697144,-74.140516)"
2015,Enero,Afganistán,4,1,0,,1,"(6.171601,-75.427454)"
2015,Enero,Albania,8,0,1,,1,"(4.697144,-74.140516)"
2015,Enero,Albania,8,2,0,,2,"(6.171601,-75.427454)"
2015,Enero,Alemania,276,2,0,,2,"(0.814836,-77.662532)"
2015,Enero,Alemania,276,4,2,,6,"(10.445761,-75.516429)"
2015,Enero,Alemania,276,4,7,,11,"(10.886611,-74.776708)"
2015,Enero,Alemania,276,1,0,,1,"(12.586067,-81.702563)"
2015,Enero,Alemania,276,32,17,,49,"(3.541112,-76.384584)"
2015,Enero,Alemania,276,1321,1039,,2360,"(4.697144,-74.140516)"
2015,Enero,Alemania,276,3,0,,3,"(4.815061,-75.736532)"
2015,Enero,Alemania,276,31,26,,57,"(6.171601,-75.427454)"
2015,Enero,Andorra,20,0,2,,2,"(3.541112,-76.384584)"
2015,Enero,Andorra,20,3,5,,8,"(4.697144,-74.140516)"
2015,Enero,Angola,24,0,1,,1,"(3.541112,-76.384584)"
2015,Enero,Angola,24,11,24,,35,"(4.697144,-74.140516)"
2015,Enero,Angola,24,1,1,,2,"(6.171601,-75.427454)"
2015,Enero,Antigua y Barbuda,28,0,5,,5,"(10.445761,-75.516429)"
2015,Enero,Antigua y Barbuda,28,2,2,,4,"(4.697144,-74.140516)"
2015,Enero,Países Bajos,528,180,149,,329,"(10.408582,-75.538003)"
2015,Enero,Países Bajos,528,3,0,,3,"(10.445761,-75.516429)"
2015,Enero,Países Bajos,528,2,2,,4,"(10.886611,-74.776708)"
2015,Enero,Países Bajos,528,38,28,,66,"(3.541112,-76.384584)"
2015,Enero,Países Bajos,528,280,170,,450,"(4.697144,-74.140516)"
2015,Enero,Países Bajos,528,3,2,,5,"(4.815061,-75.736532)"
2015,Enero,Países Bajos,528,77,57,,134,"(6.171601,-75.427454)"
2015,Enero,Países Bajos,528,2,0,,2,"(7.128456,-73.183637)"
2015,Enero,Arabia Saudita,682,1,1,,2,"(3.541112,-76.384584)"
2015,Enero,Arabia Saudita,682,30,62,,92,"(4.697144,-74.140516)"
2015,Enero,Arabia Saudita,682,0,5,,5,"(6.171601,-75.427454)"
2015,Enero,Argelia,12,0,1,,1,"(0.814836,-77.662532)"
2015,Enero,Argelia,12,1,0,,1,"(3.541112,-76.384584)"
2015,Enero,Argelia,12,3,9,,12,"(4.697144,-74.140516)"
2015,Enero,Argentina,32,21,34,,55,"(0.814836,-77.662532)"
2015,Enero,Argentina,32,17,15,,32,"(10.445761,-75.516429)"
2015,Enero,Argentina,32,39,26,,65,"(10.886611,-74.776708)"
2015,Enero,Argentina,32,19,16,,35,"(12.586067,-81.702563)"
2015,Enero,Argentina,32,286,259,,545,"(3.541112,-76.384584)"
2015,Enero,Argentina,32,3724,3509,,7233,"(4.697144,-74.140516)"
2015,Enero,Argentina,32,3,6,,9,"(4.815061,-75.736532)"
2015,Enero,Argentina,32,259,247,,506,"(6.171601,-75.427454)"
2015,Enero,Argentina,32,3,5,,8,"(7.128456,-73.183637)"
2015,Enero,Argentina,32,7,14,,21,"(7.927209,-72.507910)"
2015,Enero,Aruba,533,1771,1401,,3172,"(10.408582,-75.538003)"
2015,Enero,Aruba,533,5,9,,14,"(10.445761,-75.516429)"
2015,Enero,Aruba,533,32,19,,51,"(10.886611,-74.776708)"
2015,Enero,Aruba,533,23,9,,32,"(3.541112,-76.384584)"
2015,Enero,Aruba,533,1332,1055,,2387,"(4.697144,-74.140516)"
2015,Enero,Aruba,533,96,68,,164,"(6.171601,-75.427454)"
2015,Enero,Aruba,533,20,27,,47,"(7.128456,-73.183637)"
2015,Enero,Aruba,533,3,4,,7,"(7.927209,-72.507910)"
2015,Enero,Australia,36,1,4,,5,"(10.445761,-75.516429)"
2015,Enero,Australia,36,7,6,,13,"(10.886611,-74.776708)"
2015,Enero,Australia,36,1,0,,1,"(12.586067,-81.702563)"
2015,Enero,Australia,36,45,22,,67,"(3.541112,-76.384584)"
2015,Enero,Australia,36,492,377,,869,"(4.697144,-74.140516)"
2015,Enero,Australia,36,2,1,,3,"(4.815061,-75.736532)"
2015,Enero,Australia,36,98,61,,159,"(6.171601,-75.427454)"
2015,Enero,Australia,36,1,2,,3,"(7.128456,-73.183637)"
2015,Enero,Australia,36,1,3,,4,"(7.927209,-72.507910)"
2015,Enero,Austria,40,3,1,,4,"(3.541112,-76.384584)"
2015,Enero,Austria,40,43,29,,72,"(4.697144,-74.140516)"
2015,Enero,Austria,40,3,1,,4,"(6.171601,-75.427454)"
2015,Enero,Azerbaiyán,31,0,1,,1,"(3.541112,-76.384584)"
2015,Enero,Azerbaiyán,31,4,5,,9,"(4.697144,-74.140516)"
2015,Enero,Bahamas,44,3,3,,6,"(10.445761,-75.516429)"
2015,Enero,Bahamas,44,0,1,,1,"(10.886611,-74.776708)"
2015,Enero,Bahamas,44,0,1,,1,"(12.586067,-81.702563)"
2015,Enero,Bahamas,44,18,14,,32,"(3.541112,-76.384584)"
2015,Enero,Bahamas,44,12,19,,31,"(4.697144,-74.140516)"
2015,Enero,Bahamas,44,2,5,,7,"(4.815061,-75.736532)"
2015,Enero,Bahamas,44,7,46,,53,"(6.171601,-75.427454)"
2015,Enero,Bahamas,44,6,8,,14,"(7.927209,-72.507910)"
2015,Enero,Bahréin,48,1,0,,1,"(10.886611,-74.776708)"
2015,Enero,Bahréin,48,1,1,,2,"(11.360009,-72.129330)"
2015,Enero,Bahréin,48,4,2,,6,"(4.697144,-74.140516)"
2015,Enero,Bahréin,48,1,1,,2,"(6.171601,-75.427454)"
2015,Enero,Bangladesh,50,2,0,,2,"(4.697144,-74.140516)"
2015,Enero,Barbados,52,0,2,,2,"(3.541112,-76.384584)"
2015,Enero,Barbados,52,1,1,,2,"(4.697144,-74.140516)"
2015,Enero,República de Belarús,112,9,6,,15,"(11.360009,-72.129330)"
2015,Enero,República de Belarús,112,0,1,,1,"(7.818934,-72.453226)"
2015,Enero,Bélgica,56,1,1,,2,"(10.445761,-75.516429)"
2015,Enero,Bélgica,56,4,6,,10,"(3.541112,-76.384584)"
2015,Enero,Bélgica,56,165,108,,273,"(4.697144,-74.140516)"
2015,Enero,Bélgica,56,19,11,,30,"(6.171601,-75.427454)"
2015,Enero,Belice,84,2,2,,4,"(3.541112,-76.384584)"
2015,Enero,Belice,84,12,18,,30,"(4.697144,-74.140516)"
2015,Enero,Bermudas/Territorio Británico de Ultramar,60,1,0,,1,"(4.815061,-75.736532)"
2015,Enero,Bermudas/Territorio Británico de Ultramar,60,1,1,,2,"(6.171601,-75.427454)"
2015,Enero,Bolivia,68,17,13,,30,"(0.814836,-77.662532)"
2015,Enero,Bolivia,68,3,6,,9,"(10.886611,-74.776708)"
2015,Enero,Bolivia,68,20,41,,61,"(3.541112,-76.384584)"
2015,Enero,Bolivia,68,321,601,,922,"(4.697144,-74.140516)"
2015,Enero,Bolivia,68,1,3,,4,"(4.815061,-75.736532)"
2015,Enero,Bolivia,68,22,34,,56,"(6.171601,-75.427454)"
2015,Enero,Bolivia,68,2,3,,5,"(7.128456,-73.183637)"
2015,Enero,Brasil,76,112,216,,328,"(-4.197703,-69.941278)"
2015,Enero,Brasil,76,6,7,,13,"(-4.223468,-69.945098)"
2015,Enero,Brasil,76,2,8,,10,"(0.814836,-77.662532)"
2015,Enero,Brasil,76,11,24,,35,"(10.445761,-75.516429)"
2015,Enero,Brasil,76,30,32,,62,"(10.886611,-74.776708)"
2015,Enero,Brasil,76,9,14,,23,"(12.586067,-81.702563)"
2015,Enero,Brasil,76,126,162,,288,"(3.541112,-76.384584)"
2015,Enero,Brasil,76,2784,3439,,6223,"(4.697144,-74.140516)"
2015,Enero,Brasil,76,20,39,,59,"(4.815061,-75.736532)"
2015,Enero,Brasil,76,143,194,,337,"(6.171601,-75.427454)"
2015,Enero,Brasil,76,22,23,,45,"(7.128456,-73.183637)"
2015,Enero,Brasil,76,3,6,,9,"(7.927209,-72.507910)"
2015,Enero,Bulgaria,100,0,3,,3,"(4.697144,-74.140516)"
2015,Enero,Burkina Faso,854,0,1,,1,"(4.697144,-74.140516)"
2015,Enero,Cabo Verde,132,1,1,,2,"(4.697144,-74.140516)"
2015,Enero,Islas Caimán/Territorio Británico de Ultramar,136,0,1,,1,"(10.445761,-75.516429)"
2015,Enero,Islas Caimán/Territorio Británico de Ultramar,136,22,18,,40,"(12.586067,-81.702563)"
2015,Enero,Islas Caimán/Territorio Británico de Ultramar,136,0,2,,2,"(3.541112,-76.384584)"
2015,Enero,Islas Caimán/Territorio Británico de Ultramar,136,3,2,,5,"(4.697144,-74.140516)"
2015,Enero,Islas Caimán/Territorio Británico de Ultramar,136,2,0,,2,"(4.815061,-75.736532)"
2015,Enero,Camboya,116,0,1,,1,"(6.171601,-75.427454)"
2015,Enero,Camerún,120,2,3,,5,"(4.697144,-74.140516)"
2015,Enero,Canadá,124,0,1,,1,"(0.814836,-77.662532)"
2015,Enero,Canadá,124,201,180,,381,"(10.445761,-75.516429)"
2015,Enero,Canadá,124,68,76,,144,"(10.886611,-74.776708)"
2015,Enero,Canadá,124,18,16,,34,"(12.586067,-81.702563)"
2015,Enero,Canadá,124,284,283,,567,"(3.541112,-76.384584)"
2015,Enero,Canadá,124,12,12,,24,"(4.452882,-75.766298)"
2015,Enero,Canadá,124,2974,2674,,5648,"(4.697144,-74.140516)"
2015,Enero,Canadá,124,43,54,,97,"(4.815061,-75.736532)"
2015,Enero,Canadá,124,592,503,,1095,"(6.171601,-75.427454)"
2015,Enero,Canadá,124,38,34,,72,"(7.128456,-73.183637)"
2015,Enero,Canadá,124,20,25,,45,"(7.927209,-72.507910)"
2015,Enero,Chad,148,0,5,,5,"(4.697144,-74.140516)"
2015,Enero,España,724,0,1,,1,"(0.814836,-77.662532)"
2015,Enero,España,724,11,10,,21,"(10.445761,-75.516429)"
2015,Enero,España,724,7,0,,7,"(10.886611,-74.776708)"
2015,Enero,España,724,1525,929,,2454,"(3.541112,-76.384584)"
2015,Enero,España,724,9838,6846,,16684,"(4.697144,-74.140516)"
2015,Enero,España,724,15,9,,24,"(4.815061,-75.736532)"
2015,Enero,España,724,905,602,,1507,"(6.171601,-75.427454)"
2015,Enero,España,724,3,2,,5,"(7.128456,-73.183637)"
2015,Enero,España,724,1,1,,2,"(7.927209,-72.507910)"
2015,Enero,Colombia,170,550,637,,1187,"(4.697144,-74.140516)"
2015,Enero,República Del Congo,178,0,7,,7,"(4.697144,-74.140516)"
2015,Enero,República Democrática del Congo,180,0,1,,1,"(4.697144,-74.140516)"
2015,Enero,República de Corea,410,1,0,,1,"(3.541112,-76.384584)"
2015,Enero,República de Corea,410,6,13,,19,"(4.697144,-74.140516)"
2015,Enero,República de Corea,410,3,3,,6,"(6.171601,-75.427454)"
2015,Enero,Costa de Marfil,384,1,3,,4,"(3.541112,-76.384584)"
2015,Enero,Costa de Marfil,384,4,11,,15,"(4.697144,-74.140516)"
2015,Enero,Costa Rica,188,21,29,,50,"(10.445761,-75.516429)"
2015,Enero,Costa Rica,188,34,43,,77,"(10.886611,-74.776708)"
2015,Enero,Costa Rica,188,2,15,,17,"(12.5744111,-81.703935)"
2015,Enero,Costa Rica,188,9,14,,23,"(12.586067,-81.702563)"
2015,Enero,Costa Rica,188,0,12,,12,"(13.3387613,-81.372937)"
2015,Enero,Costa Rica,188,94,96,,190,"(3.541112,-76.384584)"
2015,Enero,Costa Rica,188,1254,1273,,2527,"(4.697144,-74.140516)"
2015,Enero,Costa Rica,188,42,30,,72,"(4.815061,-75.736532)"
2015,Enero,Costa Rica,188,287,237,,524,"(6.171601,-75.427454)"
2015,Enero,Costa Rica,188,16,13,,29,"(7.128456,-73.183637)"
2015,Enero,Costa Rica,188,6,3,,9,"(7.927209,-72.507910)"
2015,Enero,Croacia,191,0,1,,1,"(4.697144,-74.140516)"
2015,Enero,Cuba,192,3,2,,5,"(0.814836,-77.662532)"
2015,Enero,Cuba,192,14,15,,29,"(10.445761,-75.516429)"
2015,Enero,Cuba,192,28,31,,59,"(10.886611,-74.776708)"
2015,Enero,Cuba,192,12,13,,25,"(12.586067,-81.702563)"
2015,Enero,Cuba,192,70,69,,139,"(3.541112,-76.384584)"
2015,Enero,Cuba,192,1506,1273,,2779,"(4.697144,-74.140516)"
2015,Enero,Cuba,192,12,11,,23,"(4.815061,-75.736532)"
2015,Enero,Cuba,192,180,159,,339,"(6.171601,-75.427454)"
2015,Enero,Cuba,192,11,16,,27,"(7.128456,-73.183637)"
2015,Enero,Cuba,192,17,14,,31,"(7.927209,-72.507910)"
2015,Enero,Curazao,99999,153,82,,235,"(10.886611,-74.776708)"
2015,Enero,Curazao,99999,10,4,,14,"(3.541112,-76.384584)"
2015,Enero,Curazao,99999,720,642,,1362,"(4.697144,-74.140516)"
2015,Enero,Curazao,99999,170,98,,268,"(6.171601,-75.427454)"
2015,Enero,Curazao,99999,2,1,,3,"(7.128456,-73.183637)"
2015,Enero,Curazao,99999,1,1,,2,"(7.927209,-72.507910)"
2015,Enero,República Checa,203,3,8,,11,"(4.697144,-74.140516)"
2015,Enero,República Checa,203,1,2,,3,"(6.171601,-75.427454)"
2015,Enero,Chile,152,224,214,,438,"(0.814836,-77.662532)"
2015,Enero,Chile,152,0,1,,1,"(1.813928,-78.763924)"
2015,Enero,Chile,152,17,16,,33,"(10.445761,-75.516429)"
2015,Enero,Chile,152,24,19,,43,"(10.886611,-74.776708)"
2015,Enero,Chile,152,11,9,,20,"(12.586067,-81.702563)"
2015,Enero,Chile,152,527,378,,905,"(3.541112,-76.384584)"
2015,Enero,Chile,152,5252,4179,,9431,"(4.697144,-74.140516)"
2015,Enero,Chile,152,49,42,,91,"(4.815061,-75.736532)"
2015,Enero,Chile,152,198,148,,346,"(6.171601,-75.427454)"
2015,Enero,Chile,152,7,5,,12,"(7.128456,-73.183637)"
2015,Enero,Chile,152,0,4,,4,"(7.927209,-72.507910)"
2015,Enero,China,156,0,4,,4,"(10.886611,-74.776708)"
2015,Enero,China,156,4,8,,12,"(3.541112,-76.384584)"
2015,Enero,China,156,121,350,,471,"(4.697144,-74.140516)"
2015,Enero,China,156,6,22,,28,"(6.171601,-75.427454)"
2015,Enero,China,156,2,1,,3,"(7.128456,-73.183637)"
2015,Enero,China,156,2,3,,5,"(7.927209,-72.507910)"
2015,Enero,Chipre,196,0,2,,2,"(4.697144,-74.140516)"
2015,Enero,Dinamarca,208,1,1,,2,"(10.445761,-75.516429)"
2015,Enero,Dinamarca,208,1,0,,1,"(10.886611,-74.776708)"
2015,Enero,Dinamarca,208,2,0,,2,"(3.541112,-76.384584)"
2015,Enero,Dinamarca,208,35,27,,62,"(4.697144,-74.140516)"
2015,Enero,Dinamarca,208,1,0,,1,"(4.815061,-75.736532)"
2015,Enero,Dinamarca,208,5,3,,8,"(6.171601,-75.427454)"
2015,Enero,Dinamarca,208,1,0,,1,"(7.128456,-73.183637)"
2015,Enero,Ecuador,218,1490,1622,,3112,"(0.25129,-76.875963)"
2015,Enero,Ecuador,218,33,33,,66,"(0.812436,-77.847006)"
2015,Enero,Ecuador,218,20969,20539,,41508,"(0.814836,-77.662532)"
2015,Enero,Ecuador,218,296,306,,602,"(1.813928,-78.763924)"
2015,Enero,Ecuador,218,0,5,,5,"(10.408582,-75.538003)"
2015,Enero,Ecuador,218,1,6,,7,"(10.445761,-75.516429)"
2015,Enero,Ecuador,218,18,18,,36,"(10.886611,-74.776708)"
2015,Enero,Ecuador,218,3,4,,7,"(12.586067,-81.702563)"
2015,Enero,Ecuador,218,850,763,,1613,"(3.541112,-76.384584)"
2015,Enero,Ecuador,218,3748,4968,,8716,"(4.697144,-74.140516)"
2015,Enero,Ecuador,218,2,6,,8,"(4.815061,-75.736532)"
2015,Enero,Ecuador,218,394,352,,746,"(6.171601,-75.427454)"
2015,Enero,Ecuador,218,2,3,,5,"(7.128456,-73.183637)"
2015,Enero,Ecuador,218,0,1,,1,"(7.927209,-72.507910)"
2015,Enero,Egipto,818,0,1,,1,"(3.541112,-76.384584)"
2015,Enero,Egipto,818,13,16,,29,"(4.697144,-74.140516)"
2015,Enero,Egipto,818,1,0,,1,"(6.171601,-75.427454)"
2015,Enero,El Salvador,222,2,3,,5,"(10.445761,-75.516429)"
2015,Enero,El Salvador,222,4,1,,5,"(10.886611,-74.776708)"
2015,Enero,El Salvador,222,1,0,,1,"(12.586067,-81.702563)"
2015,Enero,El Salvador,222,130,120,,250,"(3.541112,-76.384584)"
2015,Enero,El Salvador,222,1006,1102,,2108,"(4.697144,-74.140516)"
2015,Enero,El Salvador,222,0,1,,1,"(4.815061,-75.736532)"
2015,Enero,El Salvador,222,51,85,,136,"(6.171601,-75.427454)"
2015,Enero,El Salvador,222,1,0,,1,"(7.128456,-73.183637)"
2015,Enero,El Salvador,222,3,3,,6,"(7.927209,-72.507910)"
2015,Enero,Emiratos Árabes,784,0,1,,1,"(10.445761,-75.516429)"
2015,Enero,Emiratos Árabes,784,3,0,,3,"(3.541112,-76.384584)"
2015,Enero,Emiratos Árabes,784,124,549,,673,"(4.697144,-74.140516)"
2015,Enero,Emiratos Árabes,784,6,3,,9,"(6.171601,-75.427454)"
2015,Enero,Eritrea,232,1,0,,1,"(4.697144,-74.140516)"
2015,Enero,Eslovaquia,703,1,0,,1,"(3.541112,-76.384584)"
2015,Enero,Eslovaquia,703,1,1,,2,"(4.697144,-74.140516)"
2015,Enero,Eslovenia,705,1,1,,2,"(4.697144,-74.140516)"
2015,Enero,Estados Unidos de América,840,2,0,,2,"(0.814836,-77.662532)"
2015,Enero,Estados Unidos de América,840,1,3,,4,"(10.408582,-75.538003)"
2015,Enero,Estados Unidos de América,840,4114,3410,,7524,"(10.445761,-75.516429)"
2015,Enero,Estados Unidos de América,840,2103,1744,,3847,"(10.886611,-74.776708)"
2015,Enero,Estados Unidos de América,840,2,6,,8,"(11.117806,-74.232622)"
2015,Enero,Estados Unidos de América,840,141,98,,239,"(12.586067,-81.702563)"
2015,Enero,Estados Unidos de América,840,5772,4597,,10369,"(3.541112,-76.384584)"
2015,Enero,Estados Unidos de América,840,639,561,,1200,"(4.452882,-75.766298)"
2015,Enero,Estados Unidos de América,840,35884,32209,,68093,"(4.697144,-74.140516)"
2015,Enero,Estados Unidos de América,840,1230,960,,2190,"(4.815061,-75.736532)"
2015,Enero,Estados Unidos de América,840,10635,9007,,19642,"(6.171601,-75.427454)"
2015,Enero,Estados Unidos de América,840,294,255,,549,"(7.128456,-73.183637)"
2015,Enero,Estados Unidos de América,840,147,132,,279,"(7.927209,-72.507910)"
2015,Enero,Estonia,233,3,3,,6,"(4.697144,-74.140516)"
2015,Enero,Etiopia,231,2,7,,9,"(4.697144,-74.140516)"
2015,Enero,Etiopia,231,0,1,,1,"(6.171601,-75.427454)"
2015,Enero,Filipinas,608,2,0,,2,"(10.886611,-74.776708)"
2015,Enero,Filipinas,608,5,1,,6,"(3.541112,-76.384584)"
2015,Enero,Filipinas,608,5,11,,16,"(4.697144,-74.140516)"
2015,Enero,Filipinas,608,1,0,,1,"(6.171601,-75.427454)"
2015,Enero,Finlandia,246,2,0,,2,"(3.541112,-76.384584)"
2015,Enero,Finlandia,246,15,13,,28,"(4.697144,-74.140516)"
2015,Enero,Francia,250,4,3,,7,"(10.445761,-75.516429)"
2015,Enero,Francia,250,2,1,,3,"(10.886611,-74.776708)"
2015,Enero,Francia,250,42,36,,78,"(3.541112,-76.384584)"
2015,Enero,Francia,250,1475,1212,,2687,"(4.697144,-74.140516)"
2015,Enero,Francia,250,7,8,,15,"(4.815061,-75.736532)"
2015,Enero,Francia,250,38,39,,77,"(6.171601,-75.427454)"
2015,Enero,Gabón,266,1,4,,5,"(4.697144,-74.140516)"
2015,Enero,Ghana,288,2,3,,5,"(4.697144,-74.140516)"
2015,Enero,Ghana,288,0,1,,1,"(6.171601,-75.427454)"
2015,Enero,Grecia,300,1,0,,1,"(3.541112,-76.384584)"
2015,Enero,Grecia,300,12,2,,14,"(4.697144,-74.140516)"
2015,Enero,Grecia,300,1,0,,1,"(6.171601,-75.427454)"
2015,Enero,Guatemala,320,4,3,,7,"(10.445761,-75.516429)"
2015,Enero,Guatemala,320,8,12,,20,"(10.886611,-74.776708)"
2015,Enero,Guatemala,320,2,5,,7,"(12.586067,-81.702563)"
2015,Enero,Guatemala,320,57,77,,134,"(3.541112,-76.384584)"
2015,Enero,Guatemala,320,619,763,,1382,"(4.697144,-74.140516)"
2015,Enero,Guatemala,320,10,21,,31,"(4.815061,-75.736532)"
2015,Enero,Guatemala,320,97,99,,196,"(6.171601,-75.427454)"
2015,Enero,Guatemala,320,9,5,,14,"(7.128456,-73.183637)"
2015,Enero,Guatemala,320,2,10,,12,"(7.927209,-72.507910)"
2015,Enero,Guyana,328,0,1,,1,"(10.886611,-74.776708)"
2015,Enero,Guyana,328,1,2,,3,"(3.541112,-76.384584)"
2015,Enero,Guyana,328,4,3,,7,"(4.697144,-74.140516)"
2015,Enero,Guyana,328,1,0,,1,"(6.171601,-75.427454)"
2015,Enero,Guyana,328,0,1,,1,"(7.927209,-72.507910)"
2015,Enero,Guinea,324,0,1,,1,"(0.25129,-76.875963)"
2015,Enero,Guinea,324,1,0,,1,"(0.814836,-77.662532)"
2015,Enero,Guinea,324,2,2,,4,"(4.697144,-74.140516)"
2015,Enero,Guinea Ecuatorial,226,7,29,,36,"(4.697144,-74.140516)"
2015,Enero,Guadalupe/Territorio Francés,312,1,1,,2,"(4.697144,-74.140516)"
2015,Enero,Guadalupe/Territorio Francés,312,0,1,,1,"(6.171601,-75.427454)"
2015,Enero,Guam/Territorio no incorporado de Estados Unidos,316,1,0,,1,"(4.697144,-74.140516)"
2015,Enero,Guayana Francesa/Departamento de Ultramar Francés,254,1,0,,1,"(10.886611,-74.776708)"
2015,Enero,Guayana Francesa/Departamento de Ultramar Francés,254,1,0,,1,"(3.541112,-76.384584)"
2015,Enero,Guayana Francesa/Departamento de Ultramar Francés,254,1,2,,3,"(4.697144,-74.140516)"
2015,Enero,Guayana Francesa/Departamento de Ultramar Francés,254,2,1,,3,"(4.815061,-75.736532)"
2015,Enero,Guayana Francesa/Departamento de Ultramar Francés,254,1,0,,1,"(6.171601,-75.427454)"
2015,Enero,Haití,332,1,10,,11,"(10.445761,-75.516429)"
2015,Enero,Haití,332,0,3,,3,"(10.886611,-74.776708)"
2015,Enero,Haití,332,1,1,,2,"(3.541112,-76.384584)"
2015,Enero,Haití,332,4,11,,15,"(4.697144,-74.140516)"
2015,Enero,Haití,332,0,4,,4,"(4.815061,-75.736532)"
2015,Enero,Haití,332,3,4,,7,"(6.171601,-75.427454)"
2015,Enero,Haití,332,1,4,,5,"(7.128456,-73.183637)"
2015,Enero,Honduras,340,0,2,,2,"(10.408582,-75.538003)"
2015,Enero,Honduras,340,4,6,,10,"(10.445761,-75.516429)"
2015,Enero,Honduras,340,11,14,,25,"(10.886611,-74.776708)"
2015,Enero,Honduras,340,13,17,,30,"(3.541112,-76.384584)"
2015,Enero,Honduras,340,95,144,,239,"(4.697144,-74.140516)"
2015,Enero,Honduras,340,1,1,,2,"(4.815061,-75.736532)"
2015,Enero,Honduras,340,39,78,,117,"(6.171601,-75.427454)"
2015,Enero,Honduras,340,2,5,,7,"(7.128456,-73.183637)"
2015,Enero,Honduras,340,0,1,,1,"(7.927209,-72.507910)"
2015,Enero,Hong Kong,344,0,1,,1,"(10.886611,-74.776708)"
2015,Enero,Hong Kong,344,2,3,,5,"(3.541112,-76.384584)"
2015,Enero,Hong Kong,344,39,66,,105,"(4.697144,-74.140516)"
2015,Enero,Hong Kong,344,3,3,,6,"(6.171601,-75.427454)"
2015,Enero,Hungría,348,0,1,,1,"(10.886611,-74.776708)"
2015,Enero,Hungría,348,6,13,,19,"(4.697144,-74.140516)"
2015,Enero,Hungría,348,0,1,,1,"(6.171601,-75.427454)"
2015,Enero,India,356,3,4,,7,"(3.541112,-76.384584)"
2015,Enero,India,356,36,27,,63,"(4.697144,-74.140516)"
2015,Enero,India,356,1,4,,5,"(6.171601,-75.427454)"
2015,Enero,Indonesia,360,6,13,,19,"(4.697144,-74.140516)"
2015,Enero,Iraq,368,2,7,,9,"(4.697144,-74.140516)"
2015,Enero,Irán,364,1,2,,3,"(4.697144,-74.140516)"
2015,Enero,República de Irlanda,372,27,31,,58,"(4.697144,-74.140516)"
2015,Enero,República de Irlanda,372,0,3,,3,"(6.171601,-75.427454)"
2015,Enero,Islandia,352,2,1,,3,"(4.697144,-74.140516)"
2015,Enero,Isla de Man,833,0,1,,1,"(12.586067,-81.702563)"
2015,Enero,Israel,376,1,1,,2,"(10.886611,-74.776708)"
2015,Enero,Israel,376,3,1,,4,"(3.541112,-76.384584)"
2015,Enero,Israel,376,139,104,,243,"(4.697144,-74.140516)"
2015,Enero,Israel,376,7,1,,8,"(6.171601,-75.427454)"
2015,Enero,Islas Aland/Provincia de Finlandia,248,1,0,,1,"(4.697144,-74.140516)"
2015,Enero,Italia,380,14,6,,20,"(10.445761,-75.516429)"
2015,Enero,Italia,380,6,1,,7,"(10.886611,-74.776708)"
2015,Enero,Italia,380,1,1,,2,"(12.586067,-81.702563)"
2015,Enero,Italia,380,79,34,,113,"(3.541112,-76.384584)"
2015,Enero,Italia,380,866,505,,1371,"(4.697144,-74.140516)"
2015,Enero,Italia,380,6,6,,12,"(4.815061,-75.736532)"
2015,Enero,Italia,380,47,15,,62,"(6.171601,-75.427454)"
2015,Enero,Italia,380,2,0,,2,"(7.128456,-73.183637)"
2015,Enero,Jamaica,388,1,0,,1,"(10.445761,-75.516429)"
2015,Enero,Jamaica,388,1,3,,4,"(10.886611,-74.776708)"
2015,Enero,Jamaica,388,7,3,,10,"(3.541112,-76.384584)"
2015,Enero,Jamaica,388,34,39,,73,"(4.697144,-74.140516)"
2015,Enero,Jamaica,388,0,1,,1,"(4.815061,-75.736532)"
2015,Enero,Jamaica,388,11,9,,20,"(6.171601,-75.427454)"
2015,Enero,Jamaica,388,7,10,,17,"(7.128456,-73.183637)"
2015,Enero,Jamaica,388,5,5,,10,"(7.927209,-72.507910)"
2015,Enero,Japón,392,1,1,,2,"(10.445761,-75.516429)"
2015,Enero,Japón,392,8,3,,11,"(3.541112,-76.384584)"
2015,Enero,Japón,392,51,72,,123,"(4.697144,-74.140516)"
2015,Enero,Japón,392,4,4,,8,"(6.171601,-75.427454)"
2015,Enero,Jordania,400,0,1,,1,"(4.697144,-74.140516)"
2015,Enero,Kazajistán,398,3,4,,7,"(4.697144,-74.140516)"
2015,Enero,Kenia,404,1,5,,6,"(4.697144,-74.140516)"
2015,Enero,Kuwait,414,5,11,,16,"(4.697144,-74.140516)"
2015,Enero,República Democrática Popular  Lao,418,1,1,,2,"(4.697144,-74.140516)"
2015,Enero,Líbano,422,25,34,,59,"(4.697144,-74.140516)"
2015,Enero,Luxemburgo,442,6,7,,13,"(4.697144,-74.140516)"
2015,Enero,Luxemburgo,442,1,1,,2,"(6.171601,-75.427454)"
2015,Enero,Macao,446,1,0,,1,"(4.697144,-74.140516)"
2015,Enero,Malasia,458,13,20,,33,"(4.697144,-74.140516)"
2015,Enero,Malasia,458,5,6,,11,"(6.171601,-75.427454)"
2015,Enero,Malí,466,1,2,,3,"(4.697144,-74.140516)"
2015,Enero,Malta,470,0,1,,1,"(3.541112,-76.384584)"
2015,Enero,Malta,470,15,10,,25,"(4.697144,-74.140516)"
2015,Enero,Marruecos,504,5,2,,7,"(4.697144,-74.140516)"
2015,Enero,Mauricio,480,0,1,,1,"(4.697144,-74.140516)"
2015,Enero,Mauritania,478,0,2,,2,"(4.697144,-74.140516)"
2015,Enero,Martinica/Departamento de Ultramar Francés,474,1,1,,2,"(4.697144,-74.140516)"
2015,Enero,Martinica/Departamento de Ultramar Francés,474,1,1,,2,"(6.171601,-75.427454)"
2015,Enero,México,484,7,3,,10,"(0.814836,-77.662532)"
2015,Enero,México,484,0,7,,7,"(10.408582,-75.538003)"
2015,Enero,México,484,81,73,,154,"(10.445761,-75.516429)"
2015,Enero,México,484,158,102,,260,"(10.886611,-74.776708)"
2015,Enero,México,484,15,11,,26,"(12.586067,-81.702563)"
2015,Enero,México,484,460,416,,876,"(3.541112,-76.384584)"
2015,Enero,México,484,14841,13268,,28109,"(4.697144,-74.140516)"
2015,Enero,México,484,131,124,,255,"(4.815061,-75.736532)"
2015,Enero,México,484,1381,1160,,2541,"(6.171601,-75.427454)"
2015,Enero,México,484,214,184,,398,"(7.128456,-73.183637)"
2015,Enero,México,484,158,139,,297,"(7.927209,-72.507910)"
2015,Enero,Mónaco,492,1,0,,1,"(4.697144,-74.140516)"
2015,Enero,Mozambique,508,2,7,,9,"(4.697144,-74.140516)"
2015,Enero,Myanmar,104,3,1,,4,"(4.697144,-74.140516)"
2015,Enero,Namibia,516,1,1,,2,"(4.697144,-74.140516)"
2015,Enero,Nicaragua,558,0,1,,1,"(10.408582,-75.538003)"
2015,Enero,Nicaragua,558,0,15,,15,"(10.445761,-75.516429)"
2015,Enero,Nicaragua,558,7,7,,14,"(10.886611,-74.776708)"
2015,Enero,Nicaragua,558,1,2,,3,"(12.586067,-81.702563)"
2015,Enero,Nicaragua,558,13,41,,54,"(3.541112,-76.384584)"
2015,Enero,Nicaragua,558,49,76,,125,"(4.697144,-74.140516)"
2015,Enero,Nicaragua,558,0,6,,6,"(4.815061,-75.736532)"
2015,Enero,Nicaragua,558,9,39,,48,"(6.171601,-75.427454)"
2015,Enero,Nicaragua,558,2,2,,4,"(7.128456,-73.183637)"
2015,Enero,Nicaragua,558,1,0,,1,"(7.927209,-72.507910)"
2015,Enero,Nigeria,566,1,0,,1,"(3.541112,-76.384584)"
2015,Enero,Nigeria,566,2,16,,18,"(4.697144,-74.140516)"
2015,Enero,Noruega,578,1,0,,1,"(10.886611,-74.776708)"
2015,Enero,Noruega,578,2,4,,6,"(3.541112,-76.384584)"
2015,Enero,Noruega,578,47,35,,82,"(4.697144,-74.140516)"
2015,Enero,Noruega,578,1,1,,2,"(4.815061,-75.736532)"
2015,Enero,Noruega,578,3,4,,7,"(6.171601,-75.427454)"
2015,Enero,Nueva Caledonia/Territorio francés,540,1,0,,1,"(4.697144,-74.140516)"
2015,Enero,Nueva Zelanda,554,4,1,,5,"(3.541112,-76.384584)"
2015,Enero,Nueva Zelanda,554,46,52,,98,"(4.697144,-74.140516)"
2015,Enero,Nueva Zelanda,554,12,7,,19,"(6.171601,-75.427454)"
2015,Enero,Nueva Zelanda,554,1,0,,1,"(7.128456,-73.183637)"
2015,Enero,Omán,512,5,12,,17,"(4.697144,-74.140516)"
2015,Enero,Omán,512,0,1,,1,"(7.128456,-73.183637)"
2015,Enero,Papúa Nueva Guinea,598,1,1,,2,"(4.697144,-74.140516)"
2015,Enero,Papúa Nueva Guinea,598,0,1,,1,"(6.171601,-75.427454)"
2015,Enero,Pakistán,586,1,4,,5,"(4.697144,-74.140516)"
2015,Enero,Panamá,591,1,1,,2,"(0.814836,-77.662532)"
2015,Enero,Panamá,591,1784,1429,,3213,"(10.408582,-75.538003)"
2015,Enero,Panamá,591,506,487,,993,"(10.445761,-75.516429)"
2015,Enero,Panamá,591,997,990,,1987,"(10.886611,-74.776708)"
2015,Enero,Panamá,591,0,2,,2,"(10.971302,-74.765397)"
2015,Enero,Panamá,591,0,2,,2,"(11.247723,-74.213989)"
2015,Enero,Panamá,591,227,266,,493,"(12.586067,-81.702563)"
2015,Enero,Panamá,591,2324,1949,,4273,"(3.541112,-76.384584)"
2015,Enero,Panamá,591,0,7,,7,"(3.893038,-77.067921)"
2015,Enero,Panamá,591,11173,11261,,22434,"(4.697144,-74.140516)"
2015,Enero,Panamá,591,709,525,,1234,"(4.815061,-75.736532)"
2015,Enero,Panamá,591,4570,4460,,9030,"(6.171601,-75.427454)"
2015,Enero,Panamá,591,2,10,,12,"(6.228046,-77.404104)"
2015,Enero,Panamá,591,18,23,,41,"(7.102626,-77.762647)"
2015,Enero,Panamá,591,357,316,,673,"(7.128456,-73.183637)"
2015,Enero,Panamá,591,266,254,,520,"(7.927209,-72.507910)"
2015,Enero,Panamá,591,0,43,,43,"(8.066966,-76.735404)"
2015,Enero,Panamá,591,63,133,,196,"(8.635765,-77.346578)"
2015,Enero,Paraguay,600,0,6,,6,"(0.814836,-77.662532)"
2015,Enero,Paraguay,600,2,1,,3,"(10.445761,-75.516429)"
2015,Enero,Paraguay,600,15,22,,37,"(3.541112,-76.384584)"
2015,Enero,Paraguay,600,57,131,,188,"(4.697144,-74.140516)"
2015,Enero,Paraguay,600,11,14,,25,"(6.171601,-75.427454)"
2015,Enero,Paraguay,600,0,1,,1,"(7.128456,-73.183637)"
2015,Enero,Perú,604,114,135,,249,"(-4.197703,-69.941278)"
2015,Enero,Perú,604,2,8,,10,"(-4.223468,-69.945098)"
2015,Enero,Perú,604,114,150,,264,"(0.814836,-77.662532)"
2015,Enero,Perú,604,5,7,,12,"(10.445761,-75.516429)"
2015,Enero,Perú,604,13,12,,25,"(10.886611,-74.776708)"
2015,Enero,Perú,604,2,1,,3,"(12.586067,-81.702563)"
2015,Enero,Perú,604,389,439,,828,"(3.541112,-76.384584)"
2015,Enero,Perú,604,4937,5620,,10557,"(4.697144,-74.140516)"
2015,Enero,Perú,604,10,11,,21,"(4.815061,-75.736532)"
2015,Enero,Perú,604,396,393,,789,"(6.171601,-75.427454)"
2015,Enero,Perú,604,2,3,,5,"(7.128456,-73.183637)"
2015,Enero,Perú,604,1,18,,19,"(7.927209,-72.507910)"
2015,Enero,Polonia,616,0,1,,1,"(3.541112,-76.384584)"
2015,Enero,Polonia,616,14,17,,31,"(4.697144,-74.140516)"
2015,Enero,Portugal,620,1,0,,1,"(10.445761,-75.516429)"
2015,Enero,Portugal,620,1,1,,2,"(10.886611,-74.776708)"
2015,Enero,Portugal,620,1,1,,2,"(3.541112,-76.384584)"
2015,Enero,Portugal,620,243,185,,428,"(4.697144,-74.140516)"
2015,Enero,Portugal,620,3,0,,3,"(6.171601,-75.427454)"
2015,Enero,Puerto Rico/Territorio de Estados Unidos,630,22,17,,39,"(10.445761,-75.516429)"
2015,Enero,Puerto Rico/Territorio de Estados Unidos,630,11,6,,17,"(10.886611,-74.776708)"
2015,Enero,Puerto Rico/Territorio de Estados Unidos,630,3,1,,4,"(12.586067,-81.702563)"
2015,Enero,Puerto Rico/Territorio de Estados Unidos,630,46,44,,90,"(3.541112,-76.384584)"
2015,Enero,Puerto Rico/Territorio de Estados Unidos,630,612,591,,1203,"(4.697144,-74.140516)"
2015,Enero,Puerto Rico/Territorio de Estados Unidos,630,16,9,,25,"(4.815061,-75.736532)"
2015,Enero,Puerto Rico/Territorio de Estados Unidos,630,75,60,,135,"(6.171601,-75.427454)"
2015,Enero,Puerto Rico/Territorio de Estados Unidos,630,15,18,,33,"(7.128456,-73.183637)"
2015,Enero,Puerto Rico/Territorio de Estados Unidos,630,1,3,,4,"(7.927209,-72.507910)"
2015,Enero,Qatar,634,8,9,,17,"(4.697144,-74.140516)"
2015,Enero,Qatar,634,6,7,,13,"(6.171601,-75.427454)"
2015,Enero,Reino Unido de Gran Bretaña e Irlanda del Norte,826,2,2,,4,"(10.445761,-75.516429)"
2015,Enero,Reino Unido de Gran Bretaña e Irlanda del Norte,826,1,0,,1,"(10.886611,-74.776708)"
2015,Enero,Reino Unido de Gran Bretaña e Irlanda del Norte,826,71,57,,128,"(3.541112,-76.384584)"
2015,Enero,Reino Unido de Gran Bretaña e Irlanda del Norte,826,2178,1708,,3886,"(4.697144,-74.140516)"
2015,Enero,Reino Unido de Gran Bretaña e Irlanda del Norte,826,1,1,,2,"(4.815061,-75.736532)"
2015,Enero,Reino Unido de Gran Bretaña e Irlanda del Norte,826,51,47,,98,"(6.171601,-75.427454)"
2015,Enero,Reino Unido de Gran Bretaña e Irlanda del Norte,826,1,0,,1,"(7.927209,-72.507910)"
2015,Enero,República CentroÁfricana,140,1,1,,2,"(4.697144,-74.140516)"
2015,Enero,Federación de Rusia,643,0,1,,1,"(3.541112,-76.384584)"
2015,Enero,Federación de Rusia,643,18,29,,47,"(4.697144,-74.140516)"
2015,Enero,Federación de Rusia,643,0,1,,1,"(6.171601,-75.427454)"
2015,Enero,República Dominicana,214,21,39,,60,"(10.445761,-75.516429)"
2015,Enero,República Dominicana,214,26,30,,56,"(10.886611,-74.776708)"
2015,Enero,República Dominicana,214,9,18,,27,"(11.117806,-74.232622)"
2015,Enero,República Dominicana,214,1,2,,3,"(12.586067,-81.702563)"
2015,Enero,República Dominicana,214,73,78,,151,"(3.541112,-76.384584)"
2015,Enero,República Dominicana,214,2330,2180,,4510,"(4.697144,-74.140516)"
2015,Enero,República Dominicana,214,10,14,,24,"(4.815061,-75.736532)"
2015,Enero,República Dominicana,214,319,284,,603,"(6.171601,-75.427454)"
2015,Enero,República Dominicana,214,52,46,,98,"(7.128456,-73.183637)"
2015,Enero,República Dominicana,214,5,1,,6,"(7.927209,-72.507910)"
2015,Enero,Reunión,638,0,2,,2,"(4.697144,-74.140516)"
2015,Enero,Rumania,642,5,9,,14,"(4.697144,-74.140516)"
2015,Enero,San Marino,674,1,0,,1,"(4.697144,-74.140516)"
2015,Enero,Santa Sede/Ciudad del Vaticano,336,0,1,,1,"(4.697144,-74.140516)"
2015,Enero,Santo Tomé y Príncipe,678,2,0,,2,"(4.697144,-74.140516)"
2015,Enero,Santo Tomé y Príncipe,678,0,1,,1,"(7.927209,-72.507910)"
2015,Enero,Senegal,686,0,1,,1,"(4.697144,-74.140516)"
2015,Enero,Singapur,702,1,0,,1,"(10.886611,-74.776708)"
2015,Enero,Singapur,702,1,0,,1,"(12.586067,-81.702563)"
2015,Enero,Singapur,702,0,1,,1,"(3.541112,-76.384584)"
2015,Enero,Singapur,702,19,30,,49,"(4.697144,-74.140516)"
2015,Enero,Singapur,702,2,0,,2,"(4.815061,-75.736532)"
2015,Enero,Singapur,702,1,2,,3,"(6.171601,-75.427454)"
2015,Enero,Sri Lanka,144,0,1,,1,"(4.697144,-74.140516)"
2015,Enero,Sudáfrica,710,2,2,,4,"(3.541112,-76.384584)"
2015,Enero,Sudáfrica,710,29,45,,74,"(4.697144,-74.140516)"
2015,Enero,Sudáfrica,710,1,1,,2,"(6.171601,-75.427454)"
2015,Enero,Sudán,736,0,1,,1,"(4.697144,-74.140516)"
2015,Enero,Suecia,752,1,2,,3,"(10.445761,-75.516429)"
2015,Enero,Suecia,752,2,1,,3,"(10.886611,-74.776708)"
2015,Enero,Suecia,752,32,26,,58,"(3.541112,-76.384584)"
2015,Enero,Suecia,752,193,161,,354,"(4.697144,-74.140516)"
2015,Enero,Suecia,752,2,2,,4,"(4.815061,-75.736532)"
2015,Enero,Suecia,752,19,10,,29,"(6.171601,-75.427454)"
2015,Enero,Suecia,752,0,1,,1,"(7.128456,-73.183637)"
2015,Enero,Suiza,756,1,0,,1,"(10.445761,-75.516429)"
2015,Enero,Suiza,756,44,20,,64,"(3.541112,-76.384584)"
2015,Enero,Suiza,756,521,283,,804,"(4.697144,-74.140516)"
2015,Enero,Suiza,756,1,0,,1,"(4.815061,-75.736532)"
2015,Enero,Suiza,756,14,16,,30,"(6.171601,-75.427454)"
2015,Enero,Suiza,756,1,2,,3,"(7.128456,-73.183637)"
2015,Enero,Surinam,740,0,1,,1,"(10.445761,-75.516429)"
2015,Enero,Surinam,740,3,8,,11,"(4.697144,-74.140516)"
2015,Enero,Surinam,740,2,1,,3,"(6.171601,-75.427454)"
2015,Enero,Taiwán,158,1,11,,12,"(4.697144,-74.140516)"
2015,Enero,Tailandia,764,14,22,,36,"(4.697144,-74.140516)"
2015,Enero,Tailandia,764,2,0,,2,"(6.171601,-75.427454)"
2015,Enero,Tanzania,834,0,1,,1,"(4.697144,-74.140516)"
2015,Enero,Trinidad y Tobago,780,1,4,,5,"(10.445761,-75.516429)"
2015,Enero,Trinidad y Tobago,780,4,3,,7,"(10.886611,-74.776708)"
2015,Enero,Trinidad y Tobago,780,0,1,,1,"(11.247723,-74.213989)"
2015,Enero,Trinidad y Tobago,780,14,87,,101,"(3.541112,-76.384584)"
2015,Enero,Trinidad y Tobago,780,27,51,,78,"(4.697144,-74.140516)"
2015,Enero,Trinidad y Tobago,780,3,5,,8,"(4.815061,-75.736532)"
2015,Enero,Trinidad y Tobago,780,7,16,,23,"(6.171601,-75.427454)"
2015,Enero,Trinidad y Tobago,780,5,7,,12,"(7.128456,-73.183637)"
2015,Enero,Trinidad y Tobago,780,3,1,,4,"(7.927209,-72.507910)"
2015,Enero,Túnez,788,2,1,,3,"(4.697144,-74.140516)"
2015,Enero,Turquía,792,30,36,,66,"(4.697144,-74.140516)"
2015,Enero,Turquía,792,4,1,,5,"(6.171601,-75.427454)"
2015,Enero,Turkmenistán,795,0,1,,1,"(4.697144,-74.140516)"
2015,Enero,Ucrania,804,2,2,,4,"(4.697144,-74.140516)"
2015,Enero,Uganda,800,0,1,,1,"(10.445761,-75.516429)"
2015,Enero,Uganda,800,0,4,,4,"(4.697144,-74.140516)"
2015,Enero,Uruguay,858,0,3,,3,"(0.814836,-77.662532)"
2015,Enero,Uruguay,858,4,2,,6,"(10.445761,-75.516429)"
2015,Enero,Uruguay,858,2,3,,5,"(10.886611,-74.776708)"
2015,Enero,Uruguay,858,0,1,,1,"(12.586067,-81.702563)"
2015,Enero,Uruguay,858,18,18,,36,"(3.541112,-76.384584)"
2015,Enero,Uruguay,858,75,104,,179,"(4.697144,-74.140516)"
2015,Enero,Uruguay,858,3,2,,5,"(4.815061,-75.736532)"
2015,Enero,Uruguay,858,24,32,,56,"(6.171601,-75.427454)"
2015,Enero,Uruguay,858,1,1,,2,"(7.128456,-73.183637)"
2015,Enero,Uruguay,858,0,1,,1,"(7.927209,-72.507910)"
2015,Enero,Venezuela,862,6,7,,13,"(10.445761,-75.516429)"
2015,Enero,Venezuela,862,15,18,,33,"(10.886611,-74.776708)"
2015,Enero,Venezuela,862,14266,11174,,25440,"(11.360009,-72.129330)"
2015,Enero,Venezuela,862,2,3,,5,"(12.586067,-81.702563)"
2015,Enero,Venezuela,862,26,30,,56,"(3.541112,-76.384584)"
2015,Enero,Venezuela,862,46,34,,80,"(3.866713,-67.927521)"
2015,Enero,Venezuela,862,2249,2090,,4339,"(4.697144,-74.140516)"
2015,Enero,Venezuela,862,9,4,,13,"(4.815061,-75.736532)"
2015,Enero,Venezuela,862,54,64,,118,"(6.171601,-75.427454)"
2015,Enero,Venezuela,862,295,304,,599,"(6.185799,-67.483929)"
2015,Enero,Venezuela,862,2850,2480,,5330,"(7.088729,-70.740253)"
2015,Enero,Venezuela,862,6,6,,12,"(7.128456,-73.183637)"
2015,Enero,Venezuela,862,13284,11847,,25131,"(7.818934,-72.453226)"
2015,Enero,Venezuela,862,1,0,,1,"(7.927209,-72.507910)"
2015,Enero,Vietnam,704,1,0,,1,"(10.445761,-75.516429)"
2015,Enero,Vietnam,704,4,5,,9,"(4.697144,-74.140516)"
2015,Enero,Islas Vírgenes Británicas/Territorio Británico de Ultramar,92,1,1,,2,"(3.541112,-76.384584)"
2015,Enero,Islas Vírgenes Británicas/Territorio Británico de Ultramar,92,2,2,,4,"(4.697144,-74.140516)"
2015,Enero,Zambia,894,0,3,,3,"(4.697144,-74.140516)"
2015,Enero,Desconocido,99999,198,307,,505,"(4.697144,-74.140516)"
2015,Febrero,Afganistán,4,0,1,,1,"(10.886611,-74.776708)"
2015,Febrero,Afganistán,4,0,1,,1,"(4.697144,-74.140516)"
2015,Febrero,Alemania,276,3,2,,5,"(10.886611,-74.776708)"
2015,Febrero,Alemania,276,16,7,,23,"(3.541112,-76.384584)"
2015,Febrero,Alemania,276,766,673,,1439,"(4.697144,-74.140516)"
2015,Febrero,Alemania,276,25,20,,45,"(6.171601,-75.427454)"
2015,Febrero,Angola,24,2,8,,10,"(4.697144,-74.140516)"
2015,Febrero,Países Bajos,528,19,9,,28,"(10.886611,-74.776708)"
2015,Febrero,Países Bajos,528,24,13,,37,"(3.541112,-76.384584)"
2015,Febrero,Países Bajos,528,185,114,,299,"(4.697144,-74.140516)"
2015,Febrero,Países Bajos,528,2,0,,2,"(4.815061,-75.736532)"
2015,Febrero,Países Bajos,528,53,19,,72,"(6.171601,-75.427454)"
2015,Febrero,Arabia Saudita,682,2,1,,3,"(10.886611,-74.776708)"
2015,Febrero,Arabia Saudita,682,3,15,,18,"(4.697144,-74.140516)"
2015,Febrero,Arabia Saudita,682,3,2,,5,"(6.171601,-75.427454)"
2015,Febrero,Argelia,12,5,4,,9,"(4.697144,-74.140516)"
2015,Febrero,Argentina,32,11,22,,33,"(0.814836,-77.662532)"
2015,Febrero,Argentina,32,6,11,,17,"(10.445761,-75.516429)"
2015,Febrero,Argentina,32,22,14,,36,"(10.886611,-74.776708)"
2015,Febrero,Argentina,32,14,10,,24,"(12.586067,-81.702563)"
2015,Febrero,Argentina,32,208,172,,380,"(3.541112,-76.384584)"
2015,Febrero,Argentina,32,2707,2483,,5190,"(4.697144,-74.140516)"
2015,Febrero,Argentina,32,2,5,,7,"(4.815061,-75.736532)"
2015,Febrero,Argentina,32,241,190,,431,"(6.171601,-75.427454)"
2015,Febrero,Argentina,32,3,6,,9,"(7.128456,-73.183637)"
2015,Febrero,Argentina,32,2,2,,4,"(7.927209,-72.507910)"
2015,Febrero,Aruba,533,1178,814,,1992,"(10.408582,-75.538003)"
2015,Febrero,Aruba,533,0,1,,1,"(10.445761,-75.516429)"
2015,Febrero,Aruba,533,23,11,,34,"(10.886611,-74.776708)"
2015,Febrero,Aruba,533,0,1,,1,"(11.360009,-72.129330)"
2015,Febrero,Aruba,533,0,3,,3,"(12.586067,-81.702563)"
2015,Febrero,Aruba,533,16,27,,43,"(3.541112,-76.384584)"
2015,Febrero,Aruba,533,858,624,,1482,"(4.697144,-74.140516)"
2015,Febrero,Aruba,533,11,6,,17,"(4.815061,-75.736532)"
2015,Febrero,Aruba,533,19,10,,29,"(6.171601,-75.427454)"
2015,Febrero,Aruba,533,10,23,,33,"(7.128456,-73.183637)"
2015,Febrero,Aruba,533,2,2,,4,"(7.927209,-72.507910)"
2015,Febrero,Australia,36,1,3,,4,"(10.445761,-75.516429)"
2015,Febrero,Australia,36,3,4,,7,"(10.886611,-74.776708)"
2015,Febrero,Australia,36,21,16,,37,"(3.541112,-76.384584)"
2015,Febrero,Australia,36,255,215,,470,"(4.697144,-74.140516)"
2015,Febrero,Australia,36,6,3,,9,"(4.815061,-75.736532)"
2015,Febrero,Australia,36,55,37,,92,"(6.171601,-75.427454)"
2015,Febrero,Australia,36,3,2,,5,"(7.128456,-73.183637)"
2015,Febrero,Australia,36,0,1,,1,"(7.927209,-72.507910)"
2015,Febrero,Austria,40,0,1,,1,"(10.886611,-74.776708)"
2015,Febrero,Austria,40,29,24,,53,"(4.697144,-74.140516)"
2015,Febrero,Austria,40,1,1,,2,"(6.171601,-75.427454)"
2015,Febrero,Azerbaiyán,31,3,4,,7,"(4.697144,-74.140516)"
2015,Febrero,Azerbaiyán,31,1,0,,1,"(6.171601,-75.427454)"
2015,Febrero,Bahamas,44,5,6,,11,"(10.886611,-74.776708)"
2015,Febrero,Bahamas,44,0,1,,1,"(12.586067,-81.702563)"
2015,Febrero,Bahamas,44,14,15,,29,"(3.541112,-76.384584)"
2015,Febrero,Bahamas,44,5,9,,14,"(4.697144,-74.140516)"
2015,Febrero,Bahamas,44,2,0,,2,"(4.815061,-75.736532)"
2015,Febrero,Bahamas,44,8,21,,29,"(6.171601,-75.427454)"
2015,Febrero,Bahamas,44,3,2,,5,"(7.128456,-73.183637)"
2015,Febrero,Bahamas,44,3,1,,4,"(7.927209,-72.507910)"
2015,Febrero,Bahréin,48,3,2,,5,"(4.697144,-74.140516)"
2015,Febrero,Bahréin,48,1,1,,2,"(6.171601,-75.427454)"
2015,Febrero,Bangladesh,50,1,1,,2,"(4.697144,-74.140516)"
2015,Febrero,Barbados,52,1,1,,2,"(4.697144,-74.140516)"
2015,Febrero,Barbados,52,0,1,,1,"(6.171601,-75.427454)"
2015,Febrero,República de Belarús,112,2,0,,2,"(11.360009,-72.129330)"
2015,Febrero,Bélgica,56,11,0,,11,"(3.541112,-76.384584)"
2015,Febrero,Bélgica,56,71,40,,111,"(4.697144,-74.140516)"
2015,Febrero,Bélgica,56,2,6,,8,"(6.171601,-75.427454)"
2015,Febrero,Belice,84,0,1,,1,"(12.586067,-81.702563)"
2015,Febrero,Belice,84,1,1,,2,"(3.541112,-76.384584)"
2015,Febrero,Belice,84,4,6,,10,"(4.697144,-74.140516)"
2015,Febrero,Benín,204,0,1,,1,"(4.697144,-74.140516)"
2015,Febrero,Bermudas/Territorio Británico de Ultramar,60,3,0,,3,"(4.697144,-74.140516)"
2015,Febrero,Bolivia,68,7,8,,15,"(0.814836,-77.662532)"
2015,Febrero,Bolivia,68,1,0,,1,"(10.445761,-75.516429)"
2015,Febrero,Bolivia,68,1,4,,5,"(10.886611,-74.776708)"
2015,Febrero,Bolivia,68,22,47,,69,"(3.541112,-76.384584)"
2015,Febrero,Bolivia,68,257,425,,682,"(4.697144,-74.140516)"
2015,Febrero,Bolivia,68,1,4,,5,"(4.815061,-75.736532)"
2015,Febrero,Bolivia,68,17,40,,57,"(6.171601,-75.427454)"
2015,Febrero,Bolivia,68,0,1,,1,"(7.128456,-73.183637)"
2015,Febrero,Brasil,76,104,201,,305,"(-4.197703,-69.941278)"
2015,Febrero,Brasil,76,10,16,,26,"(-4.223468,-69.945098)"
2015,Febrero,Brasil,76,2,0,,2,"(0.814836,-77.662532)"
2015,Febrero,Brasil,76,7,14,,21,"(10.445761,-75.516429)"
2015,Febrero,Brasil,76,16,20,,36,"(10.886611,-74.776708)"
2015,Febrero,Brasil,76,1,2,,3,"(12.586067,-81.702563)"
2015,Febrero,Brasil,76,108,187,,295,"(3.541112,-76.384584)"
2015,Febrero,Brasil,76,3,0,,3,"(3.866713,-67.927521)"
2015,Febrero,Brasil,76,2505,3095,,5600,"(4.697144,-74.140516)"
2015,Febrero,Brasil,76,15,28,,43,"(4.815061,-75.736532)"
2015,Febrero,Brasil,76,86,131,,217,"(6.171601,-75.427454)"
2015,Febrero,Brasil,76,15,21,,36,"(7.128456,-73.183637)"
2015,Febrero,Brasil,76,5,9,,14,"(7.927209,-72.507910)"
2015,Febrero,Bulgaria,100,2,0,,2,"(4.697144,-74.140516)"
2015,Febrero,Cabo Verde,132,0,1,,1,"(10.408582,-75.538003)"
2015,Febrero,Cabo Verde,132,2,0,,2,"(4.697144,-74.140516)"
2015,Febrero,Islas Caimán/Territorio Británico de Ultramar,136,1,1,,2,"(12.586067,-81.702563)"
2015,Febrero,Islas Caimán/Territorio Británico de Ultramar,136,1,0,,1,"(3.541112,-76.384584)"
2015,Febrero,Islas Caimán/Territorio Británico de Ultramar,136,1,1,,2,"(4.697144,-74.140516)"
2015,Febrero,Islas Caimán/Territorio Británico de Ultramar,136,1,1,,2,"(6.171601,-75.427454)"
2015,Febrero,Camerún,120,1,1,,2,"(4.697144,-74.140516)"
2015,Febrero,Canadá,124,71,40,,111,"(10.445761,-75.516429)"
2015,Febrero,Canadá,124,35,23,,58,"(10.886611,-74.776708)"
2015,Febrero,Canadá,124,5,4,,9,"(12.586067,-81.702563)"
2015,Febrero,Canadá,124,98,93,,191,"(3.541112,-76.384584)"
2015,Febrero,Canadá,124,7,5,,12,"(4.452882,-75.766298)"
2015,Febrero,Canadá,124,1133,1047,,2180,"(4.697144,-74.140516)"
2015,Febrero,Canadá,124,22,15,,37,"(4.815061,-75.736532)"
2015,Febrero,Canadá,124,188,168,,356,"(6.171601,-75.427454)"
2015,Febrero,Canadá,124,14,14,,28,"(7.128456,-73.183637)"
2015,Febrero,Canadá,124,5,4,,9,"(7.927209,-72.507910)"
2015,Febrero,España,724,5,0,,5,"(10.445761,-75.516429)"
2015,Febrero,España,724,1400,797,,2197,"(3.541112,-76.384584)"
2015,Febrero,España,724,6949,5344,,12293,"(4.697144,-74.140516)"
2015,Febrero,España,724,10,7,,17,"(4.815061,-75.736532)"
2015,Febrero,España,724,683,444,,1127,"(6.171601,-75.427454)"
2015,Febrero,España,724,3,2,,5,"(7.128456,-73.183637)"
2015,Febrero,Colombia,170,1,0,,1,"(0.25129,-76.875963)"
2015,Febrero,Colombia,170,466,612,,1078,"(4.697144,-74.140516)"
2015,Febrero,República Del Congo,178,0,3,,3,"(4.697144,-74.140516)"
2015,Febrero,República de Corea,410,22,22,,44,"(4.697144,-74.140516)"
2015,Febrero,República de Corea,410,2,6,,8,"(6.171601,-75.427454)"
2015,Febrero,Costa de Marfil,384,3,4,,7,"(4.697144,-74.140516)"
2015,Febrero,Costa de Marfil,384,0,1,,1,"(6.171601,-75.427454)"
2015,Febrero,Costa Rica,188,1,1,,2,"(10.408582,-75.538003)"
2015,Febrero,Costa Rica,188,13,16,,29,"(10.445761,-75.516429)"
2015,Febrero,Costa Rica,188,26,18,,44,"(10.886611,-74.776708)"
2015,Febrero,Costa Rica,188,0,1,,1,"(10.971302,-74.765397)"
2015,Febrero,Costa Rica,188,2,14,,16,"(12.5744111,-81.703935)"
2015,Febrero,Costa Rica,188,2,2,,4,"(12.586067,-81.702563)"
2015,Febrero,Costa Rica,188,57,51,,108,"(3.541112,-76.384584)"
2015,Febrero,Costa Rica,188,759,903,,1662,"(4.697144,-74.140516)"
2015,Febrero,Costa Rica,188,13,13,,26,"(4.815061,-75.736532)"
2015,Febrero,Costa Rica,188,96,121,,217,"(6.171601,-75.427454)"
2015,Febrero,Costa Rica,188,7,11,,18,"(7.128456,-73.183637)"
2015,Febrero,Costa Rica,188,5,3,,8,"(7.927209,-72.507910)"
2015,Febrero,Croacia,191,2,4,,6,"(4.697144,-74.140516)"
2015,Febrero,Cuba,192,6,15,,21,"(10.445761,-75.516429)"
2015,Febrero,Cuba,192,19,35,,54,"(10.886611,-74.776708)"
2015,Febrero,Cuba,192,0,1,,1,"(12.586067,-81.702563)"
2015,Febrero,Cuba,192,50,50,,100,"(3.541112,-76.384584)"
2015,Febrero,Cuba,192,632,579,,1211,"(4.697144,-74.140516)"
2015,Febrero,Cuba,192,5,6,,11,"(4.815061,-75.736532)"
2015,Febrero,Cuba,192,65,48,,113,"(6.171601,-75.427454)"
2015,Febrero,Cuba,192,11,13,,24,"(7.128456,-73.183637)"
2015,Febrero,Cuba,192,5,2,,7,"(7.927209,-72.507910)"
2015,Febrero,Curazao,99999,1,9,,10,"(10.445761,-75.516429)"
2015,Febrero,Curazao,99999,67,36,,103,"(10.886611,-74.776708)"
2015,Febrero,Curazao,99999,6,1,,7,"(3.541112,-76.384584)"
2015,Febrero,Curazao,99999,312,291,,603,"(4.697144,-74.140516)"
2015,Febrero,Curazao,99999,63,26,,89,"(6.171601,-75.427454)"
2015,Febrero,República Checa,203,15,10,,25,"(4.697144,-74.140516)"
2015,Febrero,Chile,152,175,136,,311,"(0.814836,-77.662532)"
2015,Febrero,Chile,152,4,8,,12,"(10.445761,-75.516429)"
2015,Febrero,Chile,152,14,12,,26,"(10.886611,-74.776708)"
2015,Febrero,Chile,152,1,1,,2,"(12.586067,-81.702563)"
2015,Febrero,Chile,152,417,250,,667,"(3.541112,-76.384584)"
2015,Febrero,Chile,152,2572,2101,,4673,"(4.697144,-74.140516)"
2015,Febrero,Chile,152,32,20,,52,"(4.815061,-75.736532)"
2015,Febrero,Chile,152,104,101,,205,"(6.171601,-75.427454)"
2015,Febrero,Chile,152,10,3,,13,"(7.128456,-73.183637)"
2015,Febrero,Chile,152,4,1,,5,"(7.927209,-72.507910)"
2015,Febrero,China,156,1,0,,1,"(10.445761,-75.516429)"
2015,Febrero,China,156,2,3,,5,"(3.541112,-76.384584)"
2015,Febrero,China,156,94,149,,243,"(4.697144,-74.140516)"
2015,Febrero,China,156,1,1,,2,"(4.815061,-75.736532)"
2015,Febrero,China,156,7,10,,17,"(6.171601,-75.427454)"
2015,Febrero,China,156,1,0,,1,"(7.128456,-73.183637)"
2015,Febrero,Chipre,196,0,1,,1,"(4.697144,-74.140516)"
2015,Febrero,Dinamarca,208,0,1,,1,"(3.541112,-76.384584)"
2015,Febrero,Dinamarca,208,16,10,,26,"(4.697144,-74.140516)"
2015,Febrero,Dinamarca,208,2,1,,3,"(6.171601,-75.427454)"
2015,Febrero,Dominica,212,0,1,,1,"(3.541112,-76.384584)"
2015,Febrero,Ecuador,218,433,631,,1064,"(0.25129,-76.875963)"
2015,Febrero,Ecuador,218,1,5,,6,"(0.812436,-77.847006)"
2015,Febrero,Ecuador,218,5592,6454,,12046,"(0.814836,-77.662532)"
2015,Febrero,Ecuador,218,158,155,,313,"(1.813928,-78.763924)"
2015,Febrero,Ecuador,218,0,2,,2,"(10.408582,-75.538003)"
2015,Febrero,Ecuador,218,2,1,,3,"(10.445761,-75.516429)"
2015,Febrero,Ecuador,218,0,7,,7,"(10.886611,-74.776708)"
2015,Febrero,Ecuador,218,412,454,,866,"(3.541112,-76.384584)"
2015,Febrero,Ecuador,218,2186,3961,,6147,"(4.697144,-74.140516)"
2015,Febrero,Ecuador,218,4,7,,11,"(4.815061,-75.736532)"
2015,Febrero,Ecuador,218,285,332,,617,"(6.171601,-75.427454)"
2015,Febrero,Ecuador,218,3,3,,6,"(7.128456,-73.183637)"
2015,Febrero,Ecuador,218,0,2,,2,"(7.927209,-72.507910)"
2015,Febrero,Egipto,818,9,11,,20,"(4.697144,-74.140516)"
2015,Febrero,El Salvador,222,0,1,,1,"(12.586067,-81.702563)"
2015,Febrero,El Salvador,222,63,72,,135,"(3.541112,-76.384584)"
2015,Febrero,El Salvador,222,636,741,,1377,"(4.697144,-74.140516)"
2015,Febrero,El Salvador,222,79,110,,189,"(6.171601,-75.427454)"
2015,Febrero,El Salvador,222,3,2,,5,"(7.128456,-73.183637)"
2015,Febrero,El Salvador,222,0,1,,1,"(7.927209,-72.507910)"
2015,Febrero,Emiratos Árabes,784,3,1,,4,"(3.541112,-76.384584)"
2015,Febrero,Emiratos Árabes,784,59,166,,225,"(4.697144,-74.140516)"
2015,Febrero,Emiratos Árabes,784,1,0,,1,"(4.815061,-75.736532)"
2015,Febrero,Emiratos Árabes,784,1,3,,4,"(6.171601,-75.427454)"
2015,Febrero,Eslovaquia,703,1,0,,1,"(3.541112,-76.384584)"
2015,Febrero,Eslovenia,705,2,3,,5,"(4.697144,-74.140516)"
2015,Febrero,Estados Unidos de América,840,0,1,,1,"(0.814836,-77.662532)"
2015,Febrero,Estados Unidos de América,840,1,0,,1,"(10.408582,-75.538003)"
2015,Febrero,Estados Unidos de América,840,2559,2144,,4703,"(10.445761,-75.516429)"
2015,Febrero,Estados Unidos de América,840,1377,1225,,2602,"(10.886611,-74.776708)"
2015,Febrero,Estados Unidos de América,840,0,2,,2,"(10.971302,-74.765397)"
2015,Febrero,Estados Unidos de América,840,45,28,,73,"(12.586067,-81.702563)"
2015,Febrero,Estados Unidos de América,840,3611,2754,,6365,"(3.541112,-76.384584)"
2015,Febrero,Estados Unidos de América,840,538,420,,958,"(4.452882,-75.766298)"
2015,Febrero,Estados Unidos de América,840,21253,20385,,41638,"(4.697144,-74.140516)"
2015,Febrero,Estados Unidos de América,840,662,540,,1202,"(4.815061,-75.736532)"
2015,Febrero,Estados Unidos de América,840,6350,5277,,11627,"(6.171601,-75.427454)"
2015,Febrero,Estados Unidos de América,840,101,88,,189,"(7.128456,-73.183637)"
2015,Febrero,Estados Unidos de América,840,39,32,,71,"(7.927209,-72.507910)"
2015,Febrero,Etiopia,231,1,5,,6,"(4.697144,-74.140516)"
2015,Febrero,Filipinas,608,1,4,,5,"(4.697144,-74.140516)"
2015,Febrero,Filipinas,608,0,2,,2,"(6.171601,-75.427454)"
2015,Febrero,Finlandia,246,7,6,,13,"(4.697144,-74.140516)"
2015,Febrero,Francia,250,1,0,,1,"(10.445761,-75.516429)"
2015,Febrero,Francia,250,28,31,,59,"(3.541112,-76.384584)"
2015,Febrero,Francia,250,705,614,,1319,"(4.697144,-74.140516)"
2015,Febrero,Francia,250,1,0,,1,"(4.815061,-75.736532)"
2015,Febrero,Francia,250,41,32,,73,"(6.171601,-75.427454)"
2015,Febrero,Gabón,266,1,2,,3,"(4.697144,-74.140516)"
2015,Febrero,Ghana,288,2,1,,3,"(4.697144,-74.140516)"
2015,Febrero,Grecia,300,5,3,,8,"(4.697144,-74.140516)"
2015,Febrero,Guatemala,320,3,8,,11,"(10.445761,-75.516429)"
2015,Febrero,Guatemala,320,2,3,,5,"(10.886611,-74.776708)"
2015,Febrero,Guatemala,320,1,0,,1,"(12.586067,-81.702563)"
2015,Febrero,Guatemala,320,35,61,,96,"(3.541112,-76.384584)"
2015,Febrero,Guatemala,320,440,719,,1159,"(4.697144,-74.140516)"
2015,Febrero,Guatemala,320,10,8,,18,"(4.815061,-75.736532)"
2015,Febrero,Guatemala,320,53,101,,154,"(6.171601,-75.427454)"
2015,Febrero,Guatemala,320,1,5,,6,"(7.128456,-73.183637)"
2015,Febrero,Guatemala,320,1,1,,2,"(7.927209,-72.507910)"
2015,Febrero,Guyana,328,0,8,,8,"(10.886611,-74.776708)"
2015,Febrero,Guyana,328,1,0,,1,"(3.541112,-76.384584)"
2015,Febrero,Guyana,328,1,2,,3,"(4.697144,-74.140516)"
2015,Febrero,Guinea,324,0,1,,1,"(4.697144,-74.140516)"
2015,Febrero,Guinea,324,1,0,,1,"(6.171601,-75.427454)"
2015,Febrero,Guinea Ecuatorial,226,0,1,,1,"(3.541112,-76.384584)"
2015,Febrero,Guinea Ecuatorial,226,3,4,,7,"(4.697144,-74.140516)"
2015,Febrero,Guadalupe/Territorio Francés,312,0,1,,1,"(4.697144,-74.140516)"
2015,Febrero,Guadalupe/Territorio Francés,312,1,2,,3,"(6.171601,-75.427454)"
2015,Febrero,Guayana Francesa/Departamento de Ultramar Francés,254,0,1,,1,"(4.697144,-74.140516)"
2015,Febrero,Haití,332,0,1,,1,"(10.445761,-75.516429)"
2015,Febrero,Haití,332,0,1,,1,"(10.886611,-74.776708)"
2015,Febrero,Haití,332,0,5,,5,"(4.697144,-74.140516)"
2015,Febrero,Haití,332,6,0,,6,"(6.171601,-75.427454)"
2015,Febrero,Haití,332,0,1,,1,"(7.128456,-73.183637)"
2015,Febrero,Haití,332,0,1,,1,"(7.927209,-72.507910)"
2015,Febrero,Honduras,340,0,4,,4,"(10.408582,-75.538003)"
2015,Febrero,Honduras,340,0,7,,7,"(10.445761,-75.516429)"
2015,Febrero,Honduras,340,3,5,,8,"(10.886611,-74.776708)"
2015,Febrero,Honduras,340,1,0,,1,"(12.5744111,-81.703935)"
2015,Febrero,Honduras,340,1,0,,1,"(12.586067,-81.702563)"
2015,Febrero,Honduras,340,7,19,,26,"(3.541112,-76.384584)"
2015,Febrero,Honduras,340,33,134,,167,"(4.697144,-74.140516)"
2015,Febrero,Honduras,340,2,3,,5,"(4.815061,-75.736532)"
2015,Febrero,Honduras,340,28,57,,85,"(6.171601,-75.427454)"
2015,Febrero,Honduras,340,1,1,,2,"(7.927209,-72.507910)"
2015,Febrero,Hong Kong,344,1,1,,2,"(3.541112,-76.384584)"
2015,Febrero,Hong Kong,344,19,39,,58,"(4.697144,-74.140516)"
2015,Febrero,Hong Kong,344,1,1,,2,"(6.171601,-75.427454)"
2015,Febrero,Hungría,348,6,5,,11,"(4.697144,-74.140516)"
2015,Febrero,India,356,0,1,,1,"(10.445761,-75.516429)"
2015,Febrero,India,356,7,2,,9,"(3.541112,-76.384584)"
2015,Febrero,India,356,34,23,,57,"(4.697144,-74.140516)"
2015,Febrero,India,356,6,8,,14,"(6.171601,-75.427454)"
2015,Febrero,Indonesia,360,1,0,,1,"(3.541112,-76.384584)"
2015,Febrero,Indonesia,360,5,5,,10,"(4.697144,-74.140516)"
2015,Febrero,Indonesia,360,2,2,,4,"(6.171601,-75.427454)"
2015,Febrero,Iraq,368,0,6,,6,"(4.697144,-74.140516)"
2015,Febrero,Irán,364,2,2,,4,"(4.697144,-74.140516)"
2015,Febrero,República de Irlanda,372,0,2,,2,"(3.541112,-76.384584)"
2015,Febrero,República de Irlanda,372,20,21,,41,"(4.697144,-74.140516)"
2015,Febrero,Islandia,352,1,1,,2,"(4.697144,-74.140516)"
2015,Febrero,Israel,376,1,1,,2,"(10.445761,-75.516429)"
2015,Febrero,Israel,376,1,0,,1,"(10.886611,-74.776708)"
2015,Febrero,Israel,376,5,1,,6,"(3.541112,-76.384584)"
2015,Febrero,Israel,376,74,72,,146,"(4.697144,-74.140516)"
2015,Febrero,Italia,380,3,2,,5,"(10.445761,-75.516429)"
2015,Febrero,Italia,380,105,41,,146,"(3.541112,-76.384584)"
2015,Febrero,Italia,380,594,351,,945,"(4.697144,-74.140516)"
2015,Febrero,Italia,380,4,3,,7,"(4.815061,-75.736532)"
2015,Febrero,Italia,380,67,37,,104,"(6.171601,-75.427454)"
2015,Febrero,Jamaica,388,3,8,,11,"(10.445761,-75.516429)"
2015,Febrero,Jamaica,388,2,1,,3,"(12.586067,-81.702563)"
2015,Febrero,Jamaica,388,3,1,,4,"(3.541112,-76.384584)"
2015,Febrero,Jamaica,388,17,15,,32,"(4.697144,-74.140516)"
2015,Febrero,Jamaica,388,1,3,,4,"(4.815061,-75.736532)"
2015,Febrero,Jamaica,388,4,8,,12,"(6.171601,-75.427454)"
2015,Febrero,Jamaica,388,0,1,,1,"(7.128456,-73.183637)"
2015,Febrero,Japón,392,3,2,,5,"(3.541112,-76.384584)"
2015,Febrero,Japón,392,49,49,,98,"(4.697144,-74.140516)"
2015,Febrero,Japón,392,1,1,,2,"(4.815061,-75.736532)"
2015,Febrero,Japón,392,0,1,,1,"(6.171601,-75.427454)"
2015,Febrero,Jordania,400,1,0,,1,"(3.541112,-76.384584)"
2015,Febrero,Jordania,400,3,1,,4,"(4.697144,-74.140516)"
2015,Febrero,Kazajistán,398,0,3,,3,"(4.697144,-74.140516)"
2015,Febrero,Kenia,404,2,3,,5,"(4.697144,-74.140516)"
2015,Febrero,Kenia,404,1,2,,3,"(6.171601,-75.427454)"
2015,Febrero,Kuwait,414,2,1,,3,"(4.697144,-74.140516)"
2015,Febrero,República Democrática Popular  Lao,418,1,1,,2,"(4.697144,-74.140516)"
2015,Febrero,Letonia,428,0,1,,1,"(4.697144,-74.140516)"
2015,Febrero,Lituania,440,1,1,,2,"(4.697144,-74.140516)"
2015,Febrero,Líbano,422,0,3,,3,"(10.408582,-75.538003)"
2015,Febrero,Líbano,422,8,25,,33,"(4.697144,-74.140516)"
2015,Febrero,Luxemburgo,442,2,1,,3,"(4.697144,-74.140516)"
2015,Febrero,Luxemburgo,442,0,2,,2,"(6.171601,-75.427454)"
2015,Febrero,Macao,446,1,0,,1,"(4.697144,-74.140516)"
2015,Febrero,Malasia,458,9,14,,23,"(4.697144,-74.140516)"
2015,Febrero,Malawi,454,1,1,,2,"(4.697144,-74.140516)"
2015,Febrero,Maldivas,462,0,1,,1,"(4.697144,-74.140516)"
2015,Febrero,Malí,466,1,1,,2,"(4.697144,-74.140516)"
2015,Febrero,Malta,470,10,10,,20,"(4.697144,-74.140516)"
2015,Febrero,Marruecos,504,6,2,,8,"(4.697144,-74.140516)"
2015,Febrero,Mauricio,480,1,0,,1,"(4.697144,-74.140516)"
2015,Febrero,Martinica/Departamento de Ultramar Francés,474,1,0,,1,"(4.697144,-74.140516)"
2015,Febrero,México,484,1,1,,2,"(0.814836,-77.662532)"
2015,Febrero,México,484,31,40,,71,"(10.445761,-75.516429)"
2015,Febrero,México,484,103,98,,201,"(10.886611,-74.776708)"
2015,Febrero,México,484,2,3,,5,"(12.586067,-81.702563)"
2015,Febrero,México,484,340,336,,676,"(3.541112,-76.384584)"
2015,Febrero,México,484,8315,8155,,16470,"(4.697144,-74.140516)"
2015,Febrero,México,484,104,63,,167,"(4.815061,-75.736532)"
2015,Febrero,México,484,678,593,,1271,"(6.171601,-75.427454)"
2015,Febrero,México,484,86,70,,156,"(7.128456,-73.183637)"
2015,Febrero,México,484,30,28,,58,"(7.927209,-72.507910)"
2015,Febrero,Mónaco,492,1,2,,3,"(4.697144,-74.140516)"
2015,Febrero,Mongolia,496,0,1,,1,"(4.697144,-74.140516)"
2015,Febrero,Myanmar,104,0,1,,1,"(4.697144,-74.140516)"
2015,Febrero,Nepal,524,1,3,,4,"(4.697144,-74.140516)"
2015,Febrero,Nicaragua,558,1,3,,4,"(10.445761,-75.516429)"
2015,Febrero,Nicaragua,558,3,2,,5,"(10.886611,-74.776708)"
2015,Febrero,Nicaragua,558,0,2,,2,"(12.5744111,-81.703935)"
2015,Febrero,Nicaragua,558,2,4,,6,"(12.586067,-81.702563)"
2015,Febrero,Nicaragua,558,5,25,,30,"(3.541112,-76.384584)"
2015,Febrero,Nicaragua,558,33,66,,99,"(4.697144,-74.140516)"
2015,Febrero,Nicaragua,558,0,2,,2,"(4.815061,-75.736532)"
2015,Febrero,Nicaragua,558,10,35,,45,"(6.171601,-75.427454)"
2015,Febrero,Nicaragua,558,1,0,,1,"(7.128456,-73.183637)"
2015,Febrero,Nicaragua,558,1,1,,2,"(7.927209,-72.507910)"
2015,Febrero,Nigeria,566,1,0,,1,"(3.541112,-76.384584)"
2015,Febrero,Nigeria,566,0,6,,6,"(4.697144,-74.140516)"
2015,Febrero,Noruega,578,2,2,,4,"(10.445761,-75.516429)"
2015,Febrero,Noruega,578,20,12,,32,"(4.697144,-74.140516)"
2015,Febrero,Noruega,578,2,1,,3,"(6.171601,-75.427454)"
2015,Febrero,Nueva Caledonia/Territorio francés,540,0,1,,1,"(4.697144,-74.140516)"
2015,Febrero,Nueva Zelanda,554,1,0,,1,"(10.445761,-75.516429)"
2015,Febrero,Nueva Zelanda,554,1,1,,2,"(3.541112,-76.384584)"
2015,Febrero,Nueva Zelanda,554,30,26,,56,"(4.697144,-74.140516)"
2015,Febrero,Nueva Zelanda,554,5,2,,7,"(6.171601,-75.427454)"
2015,Febrero,Omán,512,4,3,,7,"(4.697144,-74.140516)"
2015,Febrero,Papúa Nueva Guinea,598,1,1,,2,"(4.697144,-74.140516)"
2015,Febrero,Papúa Nueva Guinea,598,0,1,,1,"(6.171601,-75.427454)"
2015,Febrero,Pakistán,586,0,4,,4,"(4.697144,-74.140516)"
2015,Febrero,Panamá,591,1292,937,,2229,"(10.408582,-75.538003)"
2015,Febrero,Panamá,591,294,343,,637,"(10.445761,-75.516429)"
2015,Febrero,Panamá,591,657,702,,1359,"(10.886611,-74.776708)"
2015,Febrero,Panamá,591,150,157,,307,"(12.586067,-81.702563)"
2015,Febrero,Panamá,591,2156,1758,,3914,"(3.541112,-76.384584)"
2015,Febrero,Panamá,591,6921,7668,,14589,"(4.697144,-74.140516)"
2015,Febrero,Panamá,591,615,509,,1124,"(4.815061,-75.736532)"
2015,Febrero,Panamá,591,3268,3210,,6478,"(6.171601,-75.427454)"
2015,Febrero,Panamá,591,1,7,,8,"(6.228046,-77.404104)"
2015,Febrero,Panamá,591,14,7,,21,"(7.102626,-77.762647)"
2015,Febrero,Panamá,591,276,271,,547,"(7.128456,-73.183637)"
2015,Febrero,Panamá,591,156,186,,342,"(7.927209,-72.507910)"
2015,Febrero,Panamá,591,0,84,,84,"(8.066966,-76.735404)"
2015,Febrero,Panamá,591,45,106,,151,"(8.635765,-77.346578)"
2015,Febrero,Paraguay,600,0,5,,5,"(0.814836,-77.662532)"
2015,Febrero,Paraguay,600,1,1,,2,"(10.445761,-75.516429)"
2015,Febrero,Paraguay,600,2,2,,4,"(10.886611,-74.776708)"
2015,Febrero,Paraguay,600,19,44,,63,"(3.541112,-76.384584)"
2015,Febrero,Paraguay,600,44,118,,162,"(4.697144,-74.140516)"
2015,Febrero,Paraguay,600,2,0,,2,"(4.815061,-75.736532)"
2015,Febrero,Paraguay,600,12,43,,55,"(6.171601,-75.427454)"
2015,Febrero,Paraguay,600,0,1,,1,"(7.927209,-72.507910)"
2015,Febrero,Perú,604,75,82,,157,"(-4.197703,-69.941278)"
2015,Febrero,Perú,604,2,3,,5,"(-4.223468,-69.945098)"
2015,Febrero,Perú,604,60,103,,163,"(0.814836,-77.662532)"
2015,Febrero,Perú,604,4,6,,10,"(10.445761,-75.516429)"
2015,Febrero,Perú,604,22,15,,37,"(10.886611,-74.776708)"
2015,Febrero,Perú,604,1,2,,3,"(12.586067,-81.702563)"
2015,Febrero,Perú,604,297,310,,607,"(3.541112,-76.384584)"
2015,Febrero,Perú,604,3074,3869,,6943,"(4.697144,-74.140516)"
2015,Febrero,Perú,604,15,9,,24,"(4.815061,-75.736532)"
2015,Febrero,Perú,604,319,349,,668,"(6.171601,-75.427454)"
2015,Febrero,Perú,604,7,8,,15,"(7.128456,-73.183637)"
2015,Febrero,Perú,604,2,1,,3,"(7.927209,-72.507910)"
2015,Febrero,Polonia,616,4,15,,19,"(4.697144,-74.140516)"
2015,Febrero,Portugal,620,0,1,,1,"(12.586067,-81.702563)"
2015,Febrero,Portugal,620,4,1,,5,"(3.541112,-76.384584)"
2015,Febrero,Portugal,620,110,105,,215,"(4.697144,-74.140516)"
2015,Febrero,Portugal,620,2,1,,3,"(6.171601,-75.427454)"
2015,Febrero,Puerto Rico/Territorio de Estados Unidos,630,6,6,,12,"(10.445761,-75.516429)"
2015,Febrero,Puerto Rico/Territorio de Estados Unidos,630,10,14,,24,"(10.886611,-74.776708)"
2015,Febrero,Puerto Rico/Territorio de Estados Unidos,630,47,26,,73,"(3.541112,-76.384584)"
2015,Febrero,Puerto Rico/Territorio de Estados Unidos,630,349,334,,683,"(4.697144,-74.140516)"
2015,Febrero,Puerto Rico/Territorio de Estados Unidos,630,6,3,,9,"(4.815061,-75.736532)"
2015,Febrero,Puerto Rico/Territorio de Estados Unidos,630,32,36,,68,"(6.171601,-75.427454)"
2015,Febrero,Puerto Rico/Territorio de Estados Unidos,630,6,7,,13,"(7.128456,-73.183637)"
2015,Febrero,Puerto Rico/Territorio de Estados Unidos,630,0,1,,1,"(7.927209,-72.507910)"
2015,Febrero,Qatar,634,3,4,,7,"(4.697144,-74.140516)"
2015,Febrero,Reino Unido de Gran Bretaña e Irlanda del Norte,826,1,2,,3,"(10.445761,-75.516429)"
2015,Febrero,Reino Unido de Gran Bretaña e Irlanda del Norte,826,1,1,,2,"(10.886611,-74.776708)"
2015,Febrero,Reino Unido de Gran Bretaña e Irlanda del Norte,826,10,5,,15,"(3.541112,-76.384584)"
2015,Febrero,Reino Unido de Gran Bretaña e Irlanda del Norte,826,1022,781,,1803,"(4.697144,-74.140516)"
2015,Febrero,Reino Unido de Gran Bretaña e Irlanda del Norte,826,9,17,,26,"(6.171601,-75.427454)"
2015,Febrero,República CentroÁfricana,140,3,0,,3,"(4.697144,-74.140516)"
2015,Febrero,Federación de Rusia,643,11,26,,37,"(4.697144,-74.140516)"
2015,Febrero,Federación de Rusia,643,0,1,,1,"(6.171601,-75.427454)"
2015,Febrero,República Dominicana,214,7,24,,31,"(10.445761,-75.516429)"
2015,Febrero,República Dominicana,214,21,27,,48,"(10.886611,-74.776708)"
2015,Febrero,República Dominicana,214,2,2,,4,"(11.117806,-74.232622)"
2015,Febrero,República Dominicana,214,1,3,,4,"(12.586067,-81.702563)"
2015,Febrero,República Dominicana,214,55,58,,113,"(3.541112,-76.384584)"
2015,Febrero,República Dominicana,214,960,1075,,2035,"(4.697144,-74.140516)"
2015,Febrero,República Dominicana,214,6,11,,17,"(4.815061,-75.736532)"
2015,Febrero,República Dominicana,214,109,109,,218,"(6.171601,-75.427454)"
2015,Febrero,República Dominicana,214,10,13,,23,"(7.128456,-73.183637)"
2015,Febrero,República Dominicana,214,7,1,,8,"(7.927209,-72.507910)"
2015,Febrero,República Democrática Popular de Corea,408,1,2,,3,"(4.697144,-74.140516)"
2015,Febrero,Rumania,642,2,4,,6,"(4.697144,-74.140516)"
2015,Febrero,San Cristóbal y Nevis,659,0,1,,1,"(4.697144,-74.140516)"
2015,Febrero,Senegal,686,0,1,,1,"(4.697144,-74.140516)"
2015,Febrero,Singapur,702,14,6,,20,"(4.697144,-74.140516)"
2015,Febrero,Sudáfrica,710,1,0,,1,"(3.541112,-76.384584)"
2015,Febrero,Sudáfrica,710,8,13,,21,"(4.697144,-74.140516)"
2015,Febrero,Sudáfrica,710,2,0,,2,"(6.171601,-75.427454)"
2015,Febrero,Suecia,752,0,1,,1,"(10.445761,-75.516429)"
2015,Febrero,Suecia,752,1,0,,1,"(10.886611,-74.776708)"
2015,Febrero,Suecia,752,6,5,,11,"(3.541112,-76.384584)"
2015,Febrero,Suecia,752,54,60,,114,"(4.697144,-74.140516)"
2015,Febrero,Suecia,752,8,3,,11,"(6.171601,-75.427454)"
2015,Febrero,Suiza,756,1,0,,1,"(10.886611,-74.776708)"
2015,Febrero,Suiza,756,25,9,,34,"(3.541112,-76.384584)"
2015,Febrero,Suiza,756,204,107,,311,"(4.697144,-74.140516)"
2015,Febrero,Suiza,756,20,5,,25,"(6.171601,-75.427454)"
2015,Febrero,Surinam,740,5,17,,22,"(4.697144,-74.140516)"
2015,Febrero,Surinam,740,2,0,,2,"(6.171601,-75.427454)"
2015,Febrero,Taiwán,158,0,1,,1,"(3.541112,-76.384584)"
2015,Febrero,Taiwán,158,1,5,,6,"(4.697144,-74.140516)"
2015,Febrero,Taiwán,158,0,1,,1,"(6.171601,-75.427454)"
2015,Febrero,Tailandia,764,21,12,,33,"(4.697144,-74.140516)"
2015,Febrero,Tanzania,834,1,0,,1,"(4.697144,-74.140516)"
2015,Febrero,Trinidad y Tobago,780,1,6,,7,"(10.886611,-74.776708)"
2015,Febrero,Trinidad y Tobago,780,0,1,,1,"(11.247723,-74.213989)"
2015,Febrero,Trinidad y Tobago,780,10,10,,20,"(3.541112,-76.384584)"
2015,Febrero,Trinidad y Tobago,780,13,27,,40,"(4.697144,-74.140516)"
2015,Febrero,Trinidad y Tobago,780,2,1,,3,"(4.815061,-75.736532)"
2015,Febrero,Trinidad y Tobago,780,4,7,,11,"(6.171601,-75.427454)"
2015,Febrero,Trinidad y Tobago,780,3,1,,4,"(7.128456,-73.183637)"
2015,Febrero,Trinidad y Tobago,780,0,2,,2,"(7.927209,-72.507910)"
2015,Febrero,Turquía,792,2,1,,3,"(3.541112,-76.384584)"
2015,Febrero,Turquía,792,44,40,,84,"(4.697144,-74.140516)"
2015,Febrero,Turquía,792,3,4,,7,"(6.171601,-75.427454)"
2015,Febrero,Uganda,800,1,0,,1,"(3.541112,-76.384584)"
2015,Febrero,Uruguay,858,1,0,,1,"(10.445761,-75.516429)"
2015,Febrero,Uruguay,858,2,2,,4,"(10.886611,-74.776708)"
2015,Febrero,Uruguay,858,0,1,,1,"(12.586067,-81.702563)"
2015,Febrero,Uruguay,858,7,9,,16,"(3.541112,-76.384584)"
2015,Febrero,Uruguay,858,74,86,,160,"(4.697144,-74.140516)"
2015,Febrero,Uruguay,858,1,3,,4,"(4.815061,-75.736532)"
2015,Febrero,Uruguay,858,16,15,,31,"(6.171601,-75.427454)"
2015,Febrero,Venezuela,862,1,9,,10,"(10.408582,-75.538003)"
2015,Febrero,Venezuela,862,8,5,,13,"(10.445761,-75.516429)"
2015,Febrero,Venezuela,862,15,32,,47,"(10.886611,-74.776708)"
2015,Febrero,Venezuela,862,7682,6424,,14106,"(11.360009,-72.129330)"
2015,Febrero,Venezuela,862,11,21,,32,"(3.541112,-76.384584)"
2015,Febrero,Venezuela,862,12,25,,37,"(3.866713,-67.927521)"
2015,Febrero,Venezuela,862,1018,1262,,2280,"(4.697144,-74.140516)"
2015,Febrero,Venezuela,862,1,10,,11,"(4.815061,-75.736532)"
2015,Febrero,Venezuela,862,30,49,,79,"(6.171601,-75.427454)"
2015,Febrero,Venezuela,862,140,183,,323,"(6.185799,-67.483929)"
2015,Febrero,Venezuela,862,1768,1642,,3410,"(7.088729,-70.740253)"
2015,Febrero,Venezuela,862,1,1,,2,"(7.128456,-73.183637)"
2015,Febrero,Venezuela,862,5930,5675,,11605,"(7.818934,-72.453226)"
2015,Febrero,Venezuela,862,1,0,,1,"(7.927209,-72.507910)"
2015,Febrero,Vietnam,704,1,3,,4,"(4.697144,-74.140516)"
2015,Febrero,Islas Vírgenes Británicas/Territorio Británico de Ultramar,92,0,1,,1,"(4.697144,-74.140516)"
2015,Febrero,Islas Vírgenes Británicas/Territorio Británico de Ultramar,92,0,1,,1,"(6.171601,-75.427454)"
2015,Febrero,República Árabe de Yemen,887,0,1,,1,"(4.697144,-74.140516)"
2015,Febrero,Anguila/Territorio Británico de Ultramar,660,1,0,,1,"(6.171601,-75.427454)"
2015,Febrero,Desconocido,99999,6,13,,19,"(0.812436,-77.847006)"
2015,Febrero,Desconocido,99999,204,389,,593,"(4.697144,-74.140516)"
2015,Marzo,Afganistán,4,1,2,,3,"(4.697144,-74.140516)"
2015,Marzo,Alemania,276,0,2,,2,"(0.814836,-77.662532)"
2015,Marzo,Alemania,276,1,0,,1,"(10.886611,-74.776708)"
2015,Marzo,Alemania,276,17,11,,28,"(3.541112,-76.384584)"
2015,Marzo,Alemania,276,1089,1016,,2105,"(4.697144,-74.140516)"
2015,Marzo,Alemania,276,19,23,,42,"(6.171601,-75.427454)"
2015,Marzo,Andorra,20,1,0,,1,"(3.541112,-76.384584)"
2015,Marzo,Andorra,20,1,0,,1,"(4.697144,-74.140516)"
2015,Marzo,Angola,24,0,1,,1,"(3.541112,-76.384584)"
2015,Marzo,Angola,24,2,11,,13,"(4.697144,-74.140516)"
2015,Marzo,Antigua y Barbuda,28,0,1,,1,"(10.886611,-74.776708)"
2015,Marzo,Antigua y Barbuda,28,2,2,,4,"(4.697144,-74.140516)"
2015,Marzo,Antigua y Barbuda,28,0,1,,1,"(6.171601,-75.427454)"
2015,Marzo,Países Bajos,528,1,0,,1,"(10.445761,-75.516429)"
2015,Marzo,Países Bajos,528,53,34,,87,"(10.886611,-74.776708)"
2015,Marzo,Países Bajos,528,1,2,,3,"(11.117806,-74.232622)"
2015,Marzo,Países Bajos,528,68,33,,101,"(3.541112,-76.384584)"
2015,Marzo,Países Bajos,528,615,449,,1064,"(4.697144,-74.140516)"
2015,Marzo,Países Bajos,528,6,0,,6,"(4.815061,-75.736532)"
2015,Marzo,Países Bajos,528,142,83,,225,"(6.171601,-75.427454)"
2015,Marzo,Países Bajos,528,1,0,,1,"(7.927209,-72.507910)"
2015,Marzo,Arabia Saudita,682,3,22,,25,"(4.697144,-74.140516)"
2015,Marzo,Arabia Saudita,682,0,1,,1,"(4.815061,-75.736532)"
2015,Marzo,Arabia Saudita,682,0,1,,1,"(6.171601,-75.427454)"
2015,Marzo,Argelia,12,2,11,,13,"(4.697144,-74.140516)"
2015,Marzo,Argentina,32,47,65,,112,"(0.814836,-77.662532)"
2015,Marzo,Argentina,32,5,5,,10,"(10.445761,-75.516429)"
2015,Marzo,Argentina,32,19,16,,35,"(10.886611,-74.776708)"
2015,Marzo,Argentina,32,11,4,,15,"(12.586067,-81.702563)"
2015,Marzo,Argentina,32,213,174,,387,"(3.541112,-76.384584)"
2015,Marzo,Argentina,32,3488,3184,,6672,"(4.697144,-74.140516)"
2015,Marzo,Argentina,32,7,4,,11,"(4.815061,-75.736532)"
2015,Marzo,Argentina,32,278,201,,479,"(6.171601,-75.427454)"
2015,Marzo,Argentina,32,9,4,,13,"(7.128456,-73.183637)"
2015,Marzo,Aruba,533,1347,1013,,2360,"(10.408582,-75.538003)"
2015,Marzo,Aruba,533,2,2,,4,"(10.445761,-75.516429)"
2015,Marzo,Aruba,533,55,35,,90,"(10.886611,-74.776708)"
2015,Marzo,Aruba,533,0,3,,3,"(10.971302,-74.765397)"
2015,Marzo,Aruba,533,4,4,,8,"(11.117806,-74.232622)"
2015,Marzo,Aruba,533,0,1,,1,"(11.247723,-74.213989)"
2015,Marzo,Aruba,533,39,24,,63,"(3.541112,-76.384584)"
2015,Marzo,Aruba,533,1360,1034,,2394,"(4.697144,-74.140516)"
2015,Marzo,Aruba,533,12,5,,17,"(4.815061,-75.736532)"
2015,Marzo,Aruba,533,49,35,,84,"(6.171601,-75.427454)"
2015,Marzo,Aruba,533,17,24,,41,"(7.128456,-73.183637)"
2015,Marzo,Aruba,533,1,1,,2,"(7.927209,-72.507910)"
2015,Marzo,Australia,36,2,1,,3,"(10.445761,-75.516429)"
2015,Marzo,Australia,36,3,3,,6,"(10.886611,-74.776708)"
2015,Marzo,Australia,36,15,12,,27,"(3.541112,-76.384584)"
2015,Marzo,Australia,36,203,147,,350,"(4.697144,-74.140516)"
2015,Marzo,Australia,36,2,1,,3,"(4.815061,-75.736532)"
2015,Marzo,Australia,36,28,22,,50,"(6.171601,-75.427454)"
2015,Marzo,Australia,36,2,0,,2,"(7.128456,-73.183637)"
2015,Marzo,Austria,40,0,1,,1,"(10.445761,-75.516429)"
2015,Marzo,Austria,40,1,0,,1,"(10.886611,-74.776708)"
2015,Marzo,Austria,40,2,2,,4,"(3.541112,-76.384584)"
2015,Marzo,Austria,40,27,34,,61,"(4.697144,-74.140516)"
2015,Marzo,Austria,40,0,1,,1,"(6.171601,-75.427454)"
2015,Marzo,Azerbaiyán,31,0,1,,1,"(4.697144,-74.140516)"
2015,Marzo,Bahamas,44,1,0,,1,"(10.445761,-75.516429)"
2015,Marzo,Bahamas,44,6,7,,13,"(10.886611,-74.776708)"
2015,Marzo,Bahamas,44,19,11,,30,"(3.541112,-76.384584)"
2015,Marzo,Bahamas,44,19,20,,39,"(4.697144,-74.140516)"
2015,Marzo,Bahamas,44,3,2,,5,"(4.815061,-75.736532)"
2015,Marzo,Bahamas,44,19,24,,43,"(6.171601,-75.427454)"
2015,Marzo,Bahréin,48,1,0,,1,"(3.541112,-76.384584)"
2015,Marzo,Bahréin,48,0,2,,2,"(4.697144,-74.140516)"
2015,Marzo,Bangladesh,50,0,3,,3,"(4.697144,-74.140516)"
2015,Marzo,Barbados,52,0,4,,4,"(10.886611,-74.776708)"
2015,Marzo,Barbados,52,2,2,,4,"(3.541112,-76.384584)"
2015,Marzo,Barbados,52,0,2,,2,"(4.697144,-74.140516)"
2015,Marzo,República de Belarús,112,0,1,,1,"(11.360009,-72.129330)"
2015,Marzo,Bélgica,56,9,5,,14,"(3.541112,-76.384584)"
2015,Marzo,Bélgica,56,74,56,,130,"(4.697144,-74.140516)"
2015,Marzo,Bélgica,56,13,6,,19,"(6.171601,-75.427454)"
2015,Marzo,Belice,84,4,3,,7,"(3.541112,-76.384584)"
2015,Marzo,Belice,84,7,5,,12,"(4.697144,-74.140516)"
2015,Marzo,Belice,84,3,4,,7,"(6.171601,-75.427454)"
2015,Marzo,Benín,204,0,1,,1,"(4.697144,-74.140516)"
2015,Marzo,Bermudas/Territorio Británico de Ultramar,60,1,0,,1,"(4.697144,-74.140516)"
2015,Marzo,Bermudas/Territorio Británico de Ultramar,60,0,1,,1,"(6.171601,-75.427454)"
2015,Marzo,Bolivia,68,8,19,,27,"(0.814836,-77.662532)"
2015,Marzo,Bolivia,68,0,1,,1,"(10.408582,-75.538003)"
2015,Marzo,Bolivia,68,1,1,,2,"(10.445761,-75.516429)"
2015,Marzo,Bolivia,68,1,4,,5,"(10.886611,-74.776708)"
2015,Marzo,Bolivia,68,30,32,,62,"(3.541112,-76.384584)"
2015,Marzo,Bolivia,68,288,430,,718,"(4.697144,-74.140516)"
2015,Marzo,Bolivia,68,2,2,,4,"(4.815061,-75.736532)"
2015,Marzo,Bolivia,68,18,48,,66,"(6.171601,-75.427454)"
2015,Marzo,Bolivia,68,0,1,,1,"(7.927209,-72.507910)"
2015,Marzo,Brasil,76,125,198,,323,"(-4.197703,-69.941278)"
2015,Marzo,Brasil,76,8,25,,33,"(-4.223468,-69.945098)"
2015,Marzo,Brasil,76,0,6,,6,"(0.814836,-77.662532)"
2015,Marzo,Brasil,76,8,16,,24,"(10.445761,-75.516429)"
2015,Marzo,Brasil,76,12,10,,22,"(10.886611,-74.776708)"
2015,Marzo,Brasil,76,1,3,,4,"(12.586067,-81.702563)"
2015,Marzo,Brasil,76,99,123,,222,"(3.541112,-76.384584)"
2015,Marzo,Brasil,76,3310,3770,,7080,"(4.697144,-74.140516)"
2015,Marzo,Brasil,76,28,29,,57,"(4.815061,-75.736532)"
2015,Marzo,Brasil,76,81,158,,239,"(6.171601,-75.427454)"
2015,Marzo,Brasil,76,9,6,,15,"(7.128456,-73.183637)"
2015,Marzo,Brasil,76,3,5,,8,"(7.927209,-72.507910)"
2015,Marzo,Bulgaria,100,3,0,,3,"(4.697144,-74.140516)"
2015,Marzo,Bután,64,0,2,,2,"(3.541112,-76.384584)"
2015,Marzo,Islas Caimán/Territorio Británico de Ultramar,136,1,0,,1,"(10.445761,-75.516429)"
2015,Marzo,Islas Caimán/Territorio Británico de Ultramar,136,2,7,,9,"(12.586067,-81.702563)"
2015,Marzo,Islas Caimán/Territorio Británico de Ultramar,136,2,0,,2,"(3.541112,-76.384584)"
2015,Marzo,Islas Caimán/Territorio Británico de Ultramar,136,3,3,,6,"(4.697144,-74.140516)"
2015,Marzo,Camboya,116,1,1,,2,"(4.697144,-74.140516)"
2015,Marzo,Camerún,120,0,1,,1,"(4.697144,-74.140516)"
2015,Marzo,Canadá,124,1,0,,1,"(0.814836,-77.662532)"
2015,Marzo,Canadá,124,59,49,,108,"(10.445761,-75.516429)"
2015,Marzo,Canadá,124,25,11,,36,"(10.886611,-74.776708)"
2015,Marzo,Canadá,124,13,12,,25,"(12.586067,-81.702563)"
2015,Marzo,Canadá,124,137,99,,236,"(3.541112,-76.384584)"
2015,Marzo,Canadá,124,0,3,,3,"(4.452882,-75.766298)"
2015,Marzo,Canadá,124,1309,1029,,2338,"(4.697144,-74.140516)"
2015,Marzo,Canadá,124,10,7,,17,"(4.815061,-75.736532)"
2015,Marzo,Canadá,124,215,143,,358,"(6.171601,-75.427454)"
2015,Marzo,Canadá,124,10,9,,19,"(7.128456,-73.183637)"
2015,Marzo,Canadá,124,5,2,,7,"(7.927209,-72.507910)"
2015,Marzo,Chad,148,0,3,,3,"(4.697144,-74.140516)"
2015,Marzo,España,724,1,1,,2,"(0.814836,-77.662532)"
2015,Marzo,España,724,8,2,,10,"(10.445761,-75.516429)"
2015,Marzo,España,724,2,0,,2,"(10.886611,-74.776708)"
2015,Marzo,España,724,1,0,,1,"(11.360009,-72.129330)"
2015,Marzo,España,724,1300,753,,2053,"(3.541112,-76.384584)"
2015,Marzo,España,724,7534,6115,,13649,"(4.697144,-74.140516)"
2015,Marzo,España,724,21,19,,40,"(4.815061,-75.736532)"
2015,Marzo,España,724,741,559,,1300,"(6.171601,-75.427454)"
2015,Marzo,España,724,2,3,,5,"(7.128456,-73.183637)"
2015,Marzo,España,724,0,1,,1,"(7.927209,-72.507910)"
2015,Marzo,Colombia,170,498,700,,1198,"(4.697144,-74.140516)"
2015,Marzo,Colombia,170,1,0,,1,"(6.185799,-67.483929)"
2015,Marzo,República Del Congo,178,0,3,,3,"(4.697144,-74.140516)"
2015,Marzo,República de Corea,410,0,2,,2,"(10.886611,-74.776708)"
2015,Marzo,República de Corea,410,0,1,,1,"(3.541112,-76.384584)"
2015,Marzo,República de Corea,410,24,43,,67,"(4.697144,-74.140516)"
2015,Marzo,Costa de Marfil,384,2,6,,8,"(4.697144,-74.140516)"
2015,Marzo,Costa Rica,188,9,18,,27,"(10.445761,-75.516429)"
2015,Marzo,Costa Rica,188,23,31,,54,"(10.886611,-74.776708)"
2015,Marzo,Costa Rica,188,1,19,,20,"(12.5744111,-81.703935)"
2015,Marzo,Costa Rica,188,4,1,,5,"(12.586067,-81.702563)"
2015,Marzo,Costa Rica,188,0,7,,7,"(13.3387613,-81.372937)"
2015,Marzo,Costa Rica,188,55,52,,107,"(3.541112,-76.384584)"
2015,Marzo,Costa Rica,188,964,1106,,2070,"(4.697144,-74.140516)"
2015,Marzo,Costa Rica,188,13,7,,20,"(4.815061,-75.736532)"
2015,Marzo,Costa Rica,188,130,131,,261,"(6.171601,-75.427454)"
2015,Marzo,Costa Rica,188,4,5,,9,"(7.128456,-73.183637)"
2015,Marzo,Costa Rica,188,1,1,,2,"(7.927209,-72.507910)"
2015,Marzo,Croacia,191,5,2,,7,"(4.697144,-74.140516)"
2015,Marzo,Cuba,192,20,13,,33,"(10.445761,-75.516429)"
2015,Marzo,Cuba,192,12,10,,22,"(10.886611,-74.776708)"
2015,Marzo,Cuba,192,6,4,,10,"(12.586067,-81.702563)"
2015,Marzo,Cuba,192,97,82,,179,"(3.541112,-76.384584)"
2015,Marzo,Cuba,192,1063,961,,2024,"(4.697144,-74.140516)"
2015,Marzo,Cuba,192,21,13,,34,"(4.815061,-75.736532)"
2015,Marzo,Cuba,192,215,141,,356,"(6.171601,-75.427454)"
2015,Marzo,Cuba,192,58,44,,102,"(7.128456,-73.183637)"
2015,Marzo,Cuba,192,33,17,,50,"(7.927209,-72.507910)"
2015,Marzo,República Checa,203,4,12,,16,"(4.697144,-74.140516)"
2015,Marzo,Chile,152,255,185,,440,"(0.814836,-77.662532)"
2015,Marzo,Chile,152,24,13,,37,"(10.445761,-75.516429)"
2015,Marzo,Chile,152,12,15,,27,"(10.886611,-74.776708)"
2015,Marzo,Chile,152,12,2,,14,"(12.586067,-81.702563)"
2015,Marzo,Chile,152,506,389,,895,"(3.541112,-76.384584)"
2015,Marzo,Chile,152,3590,3241,,6831,"(4.697144,-74.140516)"
2015,Marzo,Chile,152,54,55,,109,"(4.815061,-75.736532)"
2015,Marzo,Chile,152,158,145,,303,"(6.171601,-75.427454)"
2015,Marzo,Chile,152,7,10,,17,"(7.128456,-73.183637)"
2015,Marzo,Chile,152,3,3,,6,"(7.927209,-72.507910)"
2015,Marzo,China,156,1,7,,8,"(10.445761,-75.516429)"
2015,Marzo,China,156,6,9,,15,"(10.886611,-74.776708)"
2015,Marzo,China,156,7,45,,52,"(3.541112,-76.384584)"
2015,Marzo,China,156,293,808,,1101,"(4.697144,-74.140516)"
2015,Marzo,China,156,3,4,,7,"(4.815061,-75.736532)"
2015,Marzo,China,156,26,87,,113,"(6.171601,-75.427454)"
2015,Marzo,China,156,0,3,,3,"(7.128456,-73.183637)"
2015,Marzo,China,156,0,3,,3,"(7.927209,-72.507910)"
2015,Marzo,Chipre,196,1,1,,2,"(4.697144,-74.140516)"
2015,Marzo,Dinamarca,208,3,0,,3,"(3.541112,-76.384584)"
2015,Marzo,Dinamarca,208,17,21,,38,"(4.697144,-74.140516)"
2015,Marzo,Dinamarca,208,1,1,,2,"(6.171601,-75.427454)"
2015,Marzo,Ecuador,218,693,836,,1529,"(0.25129,-76.875963)"
2015,Marzo,Ecuador,218,1,1,,2,"(0.812436,-77.847006)"
2015,Marzo,Ecuador,218,7589,9381,,16970,"(0.814836,-77.662532)"
2015,Marzo,Ecuador,218,190,185,,375,"(1.813928,-78.763924)"
2015,Marzo,Ecuador,218,0,1,,1,"(10.408582,-75.538003)"
2015,Marzo,Ecuador,218,2,2,,4,"(10.445761,-75.516429)"
2015,Marzo,Ecuador,218,5,9,,14,"(10.886611,-74.776708)"
2015,Marzo,Ecuador,218,1,0,,1,"(12.586067,-81.702563)"
2015,Marzo,Ecuador,218,589,526,,1115,"(3.541112,-76.384584)"
2015,Marzo,Ecuador,218,2998,4733,,7731,"(4.697144,-74.140516)"
2015,Marzo,Ecuador,218,1,8,,9,"(4.815061,-75.736532)"
2015,Marzo,Ecuador,218,257,296,,553,"(6.171601,-75.427454)"
2015,Marzo,Ecuador,218,8,8,,16,"(7.128456,-73.183637)"
2015,Marzo,Ecuador,218,6,6,,12,"(7.927209,-72.507910)"
2015,Marzo,Egipto,818,19,128,,147,"(4.697144,-74.140516)"
2015,Marzo,El Salvador,222,3,6,,9,"(10.886611,-74.776708)"
2015,Marzo,El Salvador,222,4,3,,7,"(12.586067,-81.702563)"
2015,Marzo,El Salvador,222,93,102,,195,"(3.541112,-76.384584)"
2015,Marzo,El Salvador,222,725,975,,1700,"(4.697144,-74.140516)"
2015,Marzo,El Salvador,222,1,0,,1,"(4.815061,-75.736532)"
2015,Marzo,El Salvador,222,91,94,,185,"(6.171601,-75.427454)"
2015,Marzo,El Salvador,222,0,1,,1,"(7.128456,-73.183637)"
2015,Marzo,Emiratos Árabes,784,1,0,,1,"(10.445761,-75.516429)"
2015,Marzo,Emiratos Árabes,784,2,1,,3,"(3.541112,-76.384584)"
2015,Marzo,Emiratos Árabes,784,138,372,,510,"(4.697144,-74.140516)"
2015,Marzo,Emiratos Árabes,784,6,1,,7,"(6.171601,-75.427454)"
2015,Marzo,Eritrea,232,1,0,,1,"(4.697144,-74.140516)"
2015,Marzo,Eslovaquia,703,4,3,,7,"(4.697144,-74.140516)"
2015,Marzo,Eslovenia,705,1,0,,1,"(4.697144,-74.140516)"
2015,Marzo,Estados Unidos de América,840,3,2,,5,"(0.814836,-77.662532)"
2015,Marzo,Estados Unidos de América,840,3312,2772,,6084,"(10.445761,-75.516429)"
2015,Marzo,Estados Unidos de América,840,1838,1588,,3426,"(10.886611,-74.776708)"
2015,Marzo,Estados Unidos de América,840,2,9,,11,"(11.117806,-74.232622)"
2015,Marzo,Estados Unidos de América,840,49,41,,90,"(12.586067,-81.702563)"
2015,Marzo,Estados Unidos de América,840,5174,3868,,9042,"(3.541112,-76.384584)"
2015,Marzo,Estados Unidos de América,840,695,546,,1241,"(4.452882,-75.766298)"
2015,Marzo,Estados Unidos de América,840,31223,29073,,60296,"(4.697144,-74.140516)"
2015,Marzo,Estados Unidos de América,840,885,727,,1612,"(4.815061,-75.736532)"
2015,Marzo,Estados Unidos de América,840,9119,7557,,16676,"(6.171601,-75.427454)"
2015,Marzo,Estados Unidos de América,840,218,130,,348,"(7.128456,-73.183637)"
2015,Marzo,Estados Unidos de América,840,129,106,,235,"(7.927209,-72.507910)"
2015,Marzo,Estonia,233,1,0,,1,"(4.697144,-74.140516)"
2015,Marzo,Etiopia,231,4,2,,6,"(4.697144,-74.140516)"
2015,Marzo,Etiopia,231,0,1,,1,"(4.815061,-75.736532)"
2015,Marzo,Filipinas,608,1,0,,1,"(3.541112,-76.384584)"
2015,Marzo,Filipinas,608,4,6,,10,"(4.697144,-74.140516)"
2015,Marzo,Filipinas,608,0,1,,1,"(6.171601,-75.427454)"
2015,Marzo,Finlandia,246,1,0,,1,"(3.541112,-76.384584)"
2015,Marzo,Finlandia,246,9,7,,16,"(4.697144,-74.140516)"
2015,Marzo,Finlandia,246,1,1,,2,"(6.171601,-75.427454)"
2015,Marzo,Francia,250,1,0,,1,"(10.445761,-75.516429)"
2015,Marzo,Francia,250,39,15,,54,"(3.541112,-76.384584)"
2015,Marzo,Francia,250,1109,886,,1995,"(4.697144,-74.140516)"
2015,Marzo,Francia,250,1,0,,1,"(4.815061,-75.736532)"
2015,Marzo,Francia,250,27,28,,55,"(6.171601,-75.427454)"
2015,Marzo,Francia,250,0,1,,1,"(7.128456,-73.183637)"
2015,Marzo,Francia,250,2,0,,2,"(7.927209,-72.507910)"
2015,Marzo,Gabón,266,0,4,,4,"(4.697144,-74.140516)"
2015,Marzo,Georgia,268,1,0,,1,"(6.171601,-75.427454)"
2015,Marzo,Ghana,288,0,1,,1,"(4.697144,-74.140516)"
2015,Marzo,Gibraltar/Territorio Británico de Ultramar,292,3,2,,5,"(0.814836,-77.662532)"
2015,Marzo,Granada,308,1,0,,1,"(3.541112,-76.384584)"
2015,Marzo,Grecia,300,0,1,,1,"(3.541112,-76.384584)"
2015,Marzo,Grecia,300,20,12,,32,"(4.697144,-74.140516)"
2015,Marzo,Guatemala,320,5,5,,10,"(10.445761,-75.516429)"
2015,Marzo,Guatemala,320,6,11,,17,"(10.886611,-74.776708)"
2015,Marzo,Guatemala,320,0,1,,1,"(12.586067,-81.702563)"
2015,Marzo,Guatemala,320,65,70,,135,"(3.541112,-76.384584)"
2015,Marzo,Guatemala,320,547,651,,1198,"(4.697144,-74.140516)"
2015,Marzo,Guatemala,320,11,6,,17,"(4.815061,-75.736532)"
2015,Marzo,Guatemala,320,93,113,,206,"(6.171601,-75.427454)"
2015,Marzo,Guatemala,320,3,2,,5,"(7.128456,-73.183637)"
2015,Marzo,Guatemala,320,3,4,,7,"(7.927209,-72.507910)"
2015,Marzo,Guyana,328,1,1,,2,"(10.886611,-74.776708)"
2015,Marzo,Guyana,328,2,0,,2,"(3.541112,-76.384584)"
2015,Marzo,Guyana,328,0,2,,2,"(4.697144,-74.140516)"
2015,Marzo,Guinea,324,0,1,,1,"(4.697144,-74.140516)"
2015,Marzo,Guinea Ecuatorial,226,0,1,,1,"(3.541112,-76.384584)"
2015,Marzo,Guinea Ecuatorial,226,3,7,,10,"(4.697144,-74.140516)"
2015,Marzo,Guadalupe/Territorio Francés,312,0,1,,1,"(4.697144,-74.140516)"
2015,Marzo,Haití,332,2,12,,14,"(10.445761,-75.516429)"
2015,Marzo,Haití,332,0,2,,2,"(10.886611,-74.776708)"
2015,Marzo,Haití,332,0,2,,2,"(3.541112,-76.384584)"
2015,Marzo,Haití,332,5,3,,8,"(4.697144,-74.140516)"
2015,Marzo,Haití,332,1,0,,1,"(4.815061,-75.736532)"
2015,Marzo,Haití,332,2,12,,14,"(6.171601,-75.427454)"
2015,Marzo,Honduras,340,1,0,,1,"(0.814836,-77.662532)"
2015,Marzo,Honduras,340,0,14,,14,"(10.408582,-75.538003)"
2015,Marzo,Honduras,340,2,11,,13,"(10.445761,-75.516429)"
2015,Marzo,Honduras,340,0,6,,6,"(10.886611,-74.776708)"
2015,Marzo,Honduras,340,0,3,,3,"(12.5744111,-81.703935)"
2015,Marzo,Honduras,340,5,6,,11,"(12.586067,-81.702563)"
2015,Marzo,Honduras,340,9,23,,32,"(3.541112,-76.384584)"
2015,Marzo,Honduras,340,64,189,,253,"(4.697144,-74.140516)"
2015,Marzo,Honduras,340,2,3,,5,"(4.815061,-75.736532)"
2015,Marzo,Honduras,340,37,60,,97,"(6.171601,-75.427454)"
2015,Marzo,Honduras,340,1,0,,1,"(7.128456,-73.183637)"
2015,Marzo,Hong Kong,344,0,1,,1,"(10.445761,-75.516429)"
2015,Marzo,Hong Kong,344,1,4,,5,"(3.541112,-76.384584)"
2015,Marzo,Hong Kong,344,66,109,,175,"(4.697144,-74.140516)"
2015,Marzo,Hong Kong,344,4,2,,6,"(6.171601,-75.427454)"
2015,Marzo,Hungría,348,4,4,,8,"(4.697144,-74.140516)"
2015,Marzo,India,356,1,2,,3,"(3.541112,-76.384584)"
2015,Marzo,India,356,77,80,,157,"(4.697144,-74.140516)"
2015,Marzo,India,356,0,1,,1,"(4.815061,-75.736532)"
2015,Marzo,India,356,2,0,,2,"(6.171601,-75.427454)"
2015,Marzo,India,356,3,0,,3,"(7.128456,-73.183637)"
2015,Marzo,Indonesia,360,4,4,,8,"(4.697144,-74.140516)"
2015,Marzo,Indonesia,360,1,1,,2,"(6.171601,-75.427454)"
2015,Marzo,Iraq,368,0,12,,12,"(4.697144,-74.140516)"
2015,Marzo,Irán,364,6,3,,9,"(4.697144,-74.140516)"
2015,Marzo,República de Irlanda,372,1,1,,2,"(3.541112,-76.384584)"
2015,Marzo,República de Irlanda,372,9,8,,17,"(4.697144,-74.140516)"
2015,Marzo,Islandia,352,0,2,,2,"(4.697144,-74.140516)"
2015,Marzo,Isla de Man,833,1,0,,1,"(4.697144,-74.140516)"
2015,Marzo,Israel,376,0,1,,1,"(10.886611,-74.776708)"
2015,Marzo,Israel,376,3,2,,5,"(3.541112,-76.384584)"
2015,Marzo,Israel,376,245,151,,396,"(4.697144,-74.140516)"
2015,Marzo,Israel,376,6,1,,7,"(6.171601,-75.427454)"
2015,Marzo,Islas Aland/Provincia de Finlandia,248,0,1,,1,"(4.697144,-74.140516)"
2015,Marzo,Italia,380,1,1,,2,"(10.445761,-75.516429)"
2015,Marzo,Italia,380,109,25,,134,"(3.541112,-76.384584)"
2015,Marzo,Italia,380,802,429,,1231,"(4.697144,-74.140516)"
2015,Marzo,Italia,380,2,0,,2,"(4.815061,-75.736532)"
2015,Marzo,Italia,380,35,27,,62,"(6.171601,-75.427454)"
2015,Marzo,Jamaica,388,1,0,,1,"(10.445761,-75.516429)"
2015,Marzo,Jamaica,388,2,5,,7,"(10.886611,-74.776708)"
2015,Marzo,Jamaica,388,3,1,,4,"(12.586067,-81.702563)"
2015,Marzo,Jamaica,388,11,8,,19,"(3.541112,-76.384584)"
2015,Marzo,Jamaica,388,23,35,,58,"(4.697144,-74.140516)"
2015,Marzo,Jamaica,388,3,2,,5,"(4.815061,-75.736532)"
2015,Marzo,Jamaica,388,13,12,,25,"(6.171601,-75.427454)"
2015,Marzo,Jamaica,388,1,1,,2,"(7.128456,-73.183637)"
2015,Marzo,Jamaica,388,1,2,,3,"(7.927209,-72.507910)"
2015,Marzo,Japón,392,0,1,,1,"(10.886611,-74.776708)"
2015,Marzo,Japón,392,5,7,,12,"(3.541112,-76.384584)"
2015,Marzo,Japón,392,62,88,,150,"(4.697144,-74.140516)"
2015,Marzo,Japón,392,1,0,,1,"(4.815061,-75.736532)"
2015,Marzo,Japón,392,6,4,,10,"(6.171601,-75.427454)"
2015,Marzo,Jordania,400,0,1,,1,"(3.541112,-76.384584)"
2015,Marzo,Jordania,400,1,4,,5,"(4.697144,-74.140516)"
2015,Marzo,Kazajistán,398,1,4,,5,"(4.697144,-74.140516)"
2015,Marzo,Kenia,404,0,2,,2,"(4.697144,-74.140516)"
2015,Marzo,Kuwait,414,0,1,,1,"(3.541112,-76.384584)"
2015,Marzo,Kuwait,414,1,2,,3,"(4.697144,-74.140516)"
2015,Marzo,República Democrática Popular  Lao,418,1,0,,1,"(3.541112,-76.384584)"
2015,Marzo,República Democrática Popular  Lao,418,0,1,,1,"(4.697144,-74.140516)"
2015,Marzo,Líbano,422,14,19,,33,"(4.697144,-74.140516)"
2015,Marzo,Luxemburgo,442,3,3,,6,"(4.697144,-74.140516)"
2015,Marzo,Luxemburgo,442,1,0,,1,"(6.171601,-75.427454)"
2015,Marzo,Macao,446,1,1,,2,"(4.697144,-74.140516)"
2015,Marzo,Macedonia,807,1,0,,1,"(4.697144,-74.140516)"
2015,Marzo,Malasia,458,1,12,,13,"(4.697144,-74.140516)"
2015,Marzo,Malí,466,1,0,,1,"(4.697144,-74.140516)"
2015,Marzo,Malta,470,11,9,,20,"(4.697144,-74.140516)"
2015,Marzo,Marruecos,504,8,3,,11,"(4.697144,-74.140516)"
2015,Marzo,Marruecos,504,1,1,,2,"(6.171601,-75.427454)"
2015,Marzo,Mauricio,480,0,1,,1,"(4.697144,-74.140516)"
2015,Marzo,Mauritania,478,0,1,,1,"(4.697144,-74.140516)"
2015,Marzo,México,484,1,0,,1,"(0.814836,-77.662532)"
2015,Marzo,México,484,73,98,,171,"(10.445761,-75.516429)"
2015,Marzo,México,484,99,79,,178,"(10.886611,-74.776708)"
2015,Marzo,México,484,2,1,,3,"(12.586067,-81.702563)"
2015,Marzo,México,484,541,445,,986,"(3.541112,-76.384584)"
2015,Marzo,México,484,10801,9879,,20680,"(4.697144,-74.140516)"
2015,Marzo,México,484,125,93,,218,"(4.815061,-75.736532)"
2015,Marzo,México,484,1390,1248,,2638,"(6.171601,-75.427454)"
2015,Marzo,México,484,88,77,,165,"(7.128456,-73.183637)"
2015,Marzo,México,484,37,37,,74,"(7.927209,-72.507910)"
2015,Marzo,Mónaco,492,1,0,,1,"(4.697144,-74.140516)"
2015,Marzo,Mozambique,508,1,2,,3,"(4.697144,-74.140516)"
2015,Marzo,Namibia,516,0,1,,1,"(6.171601,-75.427454)"
2015,Marzo,Nepal,524,0,1,,1,"(4.697144,-74.140516)"
2015,Marzo,Nicaragua,558,3,4,,7,"(10.445761,-75.516429)"
2015,Marzo,Nicaragua,558,0,4,,4,"(10.886611,-74.776708)"
2015,Marzo,Nicaragua,558,11,13,,24,"(12.5744111,-81.703935)"
2015,Marzo,Nicaragua,558,1,3,,4,"(12.586067,-81.702563)"
2015,Marzo,Nicaragua,558,7,30,,37,"(3.541112,-76.384584)"
2015,Marzo,Nicaragua,558,36,56,,92,"(4.697144,-74.140516)"
2015,Marzo,Nicaragua,558,5,1,,6,"(4.815061,-75.736532)"
2015,Marzo,Nicaragua,558,13,33,,46,"(6.171601,-75.427454)"
2015,Marzo,Nicaragua,558,0,2,,2,"(7.128456,-73.183637)"
2015,Marzo,Nigeria,566,0,16,,16,"(4.697144,-74.140516)"
2015,Marzo,Noruega,578,1,0,,1,"(10.886611,-74.776708)"
2015,Marzo,Noruega,578,15,16,,31,"(4.697144,-74.140516)"
2015,Marzo,Noruega,578,1,0,,1,"(6.171601,-75.427454)"
2015,Marzo,Nueva Caledonia/Territorio francés,540,0,2,,2,"(4.697144,-74.140516)"
2015,Marzo,Nueva Zelanda,554,1,1,,2,"(3.541112,-76.384584)"
2015,Marzo,Nueva Zelanda,554,31,17,,48,"(4.697144,-74.140516)"
2015,Marzo,Nueva Zelanda,554,1,1,,2,"(4.815061,-75.736532)"
2015,Marzo,Nueva Zelanda,554,7,2,,9,"(6.171601,-75.427454)"
2015,Marzo,Omán,512,1,5,,6,"(4.697144,-74.140516)"
2015,Marzo,Papúa Nueva Guinea,598,0,1,,1,"(6.171601,-75.427454)"
2015,Marzo,Pakistán,586,1,1,,2,"(4.697144,-74.140516)"
2015,Marzo,Panamá,591,1089,904,,1993,"(10.408582,-75.538003)"
2015,Marzo,Panamá,591,313,331,,644,"(10.445761,-75.516429)"
2015,Marzo,Panamá,591,607,700,,1307,"(10.886611,-74.776708)"
2015,Marzo,Panamá,591,2,15,,17,"(12.5744111,-81.703935)"
2015,Marzo,Panamá,591,154,165,,319,"(12.586067,-81.702563)"
2015,Marzo,Panamá,591,1900,1774,,3674,"(3.541112,-76.384584)"
2015,Marzo,Panamá,591,8439,9150,,17589,"(4.697144,-74.140516)"
2015,Marzo,Panamá,591,609,486,,1095,"(4.815061,-75.736532)"
2015,Marzo,Panamá,591,3413,3342,,6755,"(6.171601,-75.427454)"
2015,Marzo,Panamá,591,1,5,,6,"(6.228046,-77.404104)"
2015,Marzo,Panamá,591,2,12,,14,"(7.102626,-77.762647)"
2015,Marzo,Panamá,591,307,289,,596,"(7.128456,-73.183637)"
2015,Marzo,Panamá,591,204,191,,395,"(7.927209,-72.507910)"
2015,Marzo,Panamá,591,0,76,,76,"(8.066966,-76.735404)"
2015,Marzo,Panamá,591,47,95,,142,"(8.635765,-77.346578)"
2015,Marzo,Paraguay,600,0,2,,2,"(10.445761,-75.516429)"
2015,Marzo,Paraguay,600,1,0,,1,"(10.886611,-74.776708)"
2015,Marzo,Paraguay,600,0,1,,1,"(12.586067,-81.702563)"
2015,Marzo,Paraguay,600,19,54,,73,"(3.541112,-76.384584)"
2015,Marzo,Paraguay,600,84,162,,246,"(4.697144,-74.140516)"
2015,Marzo,Paraguay,600,0,1,,1,"(4.815061,-75.736532)"
2015,Marzo,Paraguay,600,4,12,,16,"(6.171601,-75.427454)"
2015,Marzo,Perú,604,99,110,,209,"(-4.197703,-69.941278)"
2015,Marzo,Perú,604,9,13,,22,"(-4.223468,-69.945098)"
2015,Marzo,Perú,604,97,134,,231,"(0.814836,-77.662532)"
2015,Marzo,Perú,604,0,12,,12,"(10.408582,-75.538003)"
2015,Marzo,Perú,604,1,3,,4,"(10.445761,-75.516429)"
2015,Marzo,Perú,604,21,24,,45,"(10.886611,-74.776708)"
2015,Marzo,Perú,604,1,0,,1,"(12.586067,-81.702563)"
2015,Marzo,Perú,604,365,402,,767,"(3.541112,-76.384584)"
2015,Marzo,Perú,604,4058,4777,,8835,"(4.697144,-74.140516)"
2015,Marzo,Perú,604,2,3,,5,"(4.815061,-75.736532)"
2015,Marzo,Perú,604,413,440,,853,"(6.171601,-75.427454)"
2015,Marzo,Perú,604,1,4,,5,"(7.128456,-73.183637)"
2015,Marzo,Perú,604,2,2,,4,"(7.927209,-72.507910)"
2015,Marzo,Palestina,99999,0,1,,1,"(4.697144,-74.140516)"
2015,Marzo,Polonia,616,12,17,,29,"(4.697144,-74.140516)"
2015,Marzo,Portugal,620,0,1,,1,"(3.541112,-76.384584)"
2015,Marzo,Portugal,620,208,139,,347,"(4.697144,-74.140516)"
2015,Marzo,Portugal,620,0,2,,2,"(6.171601,-75.427454)"
2015,Marzo,Puerto Rico/Territorio de Estados Unidos,630,9,12,,21,"(10.445761,-75.516429)"
2015,Marzo,Puerto Rico/Territorio de Estados Unidos,630,4,10,,14,"(10.886611,-74.776708)"
2015,Marzo,Puerto Rico/Territorio de Estados Unidos,630,1,1,,2,"(12.586067,-81.702563)"
2015,Marzo,Puerto Rico/Territorio de Estados Unidos,630,50,38,,88,"(3.541112,-76.384584)"
2015,Marzo,Puerto Rico/Territorio de Estados Unidos,630,581,577,,1158,"(4.697144,-74.140516)"
2015,Marzo,Puerto Rico/Territorio de Estados Unidos,630,16,10,,26,"(4.815061,-75.736532)"
2015,Marzo,Puerto Rico/Territorio de Estados Unidos,630,46,53,,99,"(6.171601,-75.427454)"
2015,Marzo,Puerto Rico/Territorio de Estados Unidos,630,19,8,,27,"(7.128456,-73.183637)"
2015,Marzo,Puerto Rico/Territorio de Estados Unidos,630,1,2,,3,"(7.927209,-72.507910)"
2015,Marzo,Qatar,634,0,6,,6,"(4.697144,-74.140516)"
2015,Marzo,Reino Unido de Gran Bretaña e Irlanda del Norte,826,1,0,,1,"(10.886611,-74.776708)"
2015,Marzo,Reino Unido de Gran Bretaña e Irlanda del Norte,826,14,9,,23,"(3.541112,-76.384584)"
2015,Marzo,Reino Unido de Gran Bretaña e Irlanda del Norte,826,1326,1052,,2378,"(4.697144,-74.140516)"
2015,Marzo,Reino Unido de Gran Bretaña e Irlanda del Norte,826,20,12,,32,"(6.171601,-75.427454)"
2015,Marzo,Federación de Rusia,643,29,45,,74,"(4.697144,-74.140516)"
2015,Marzo,Federación de Rusia,643,0,1,,1,"(6.171601,-75.427454)"
2015,Marzo,República Dominicana,214,7,26,,33,"(10.445761,-75.516429)"
2015,Marzo,República Dominicana,214,13,28,,41,"(10.886611,-74.776708)"
2015,Marzo,República Dominicana,214,4,2,,6,"(11.117806,-74.232622)"
2015,Marzo,República Dominicana,214,143,137,,280,"(3.541112,-76.384584)"
2015,Marzo,República Dominicana,214,1511,1499,,3010,"(4.697144,-74.140516)"
2015,Marzo,República Dominicana,214,20,19,,39,"(4.815061,-75.736532)"
2015,Marzo,República Dominicana,214,171,160,,331,"(6.171601,-75.427454)"
2015,Marzo,República Dominicana,214,22,26,,48,"(7.128456,-73.183637)"
2015,Marzo,República Dominicana,214,6,8,,14,"(7.927209,-72.507910)"
2015,Marzo,Reunión,638,0,1,,1,"(4.697144,-74.140516)"
2015,Marzo,Rumania,642,0,4,,4,"(4.697144,-74.140516)"
2015,Marzo,Rumania,642,0,2,,2,"(6.171601,-75.427454)"
2015,Marzo,San Marino,674,0,1,,1,"(4.697144,-74.140516)"
2015,Marzo,San Marino,674,0,1,,1,"(7.927209,-72.507910)"
2015,Marzo,San  Vicente y las Granadinas,670,0,1,,1,"(6.171601,-75.427454)"
2015,Marzo,Senegal,686,0,1,,1,"(4.697144,-74.140516)"
2015,Marzo,Seychelles,690,0,1,,1,"(4.697144,-74.140516)"
2015,Marzo,Singapur,702,1,3,,4,"(3.541112,-76.384584)"
2015,Marzo,Singapur,702,23,24,,47,"(4.697144,-74.140516)"
2015,Marzo,Sri Lanka,144,0,2,,2,"(4.697144,-74.140516)"
2015,Marzo,Sudáfrica,710,11,15,,26,"(4.697144,-74.140516)"
2015,Marzo,Sudáfrica,710,1,2,,3,"(6.171601,-75.427454)"
2015,Marzo,Suecia,752,6,4,,10,"(3.541112,-76.384584)"
2015,Marzo,Suecia,752,68,49,,117,"(4.697144,-74.140516)"
2015,Marzo,Suecia,752,3,0,,3,"(6.171601,-75.427454)"
2015,Marzo,Suiza,756,31,13,,44,"(3.541112,-76.384584)"
2015,Marzo,Suiza,756,204,142,,346,"(4.697144,-74.140516)"
2015,Marzo,Suiza,756,18,7,,25,"(6.171601,-75.427454)"
2015,Marzo,Surinam,740,3,23,,26,"(4.697144,-74.140516)"
2015,Marzo,Surinam,740,1,3,,4,"(6.171601,-75.427454)"
2015,Marzo,Taiwán,158,2,8,,10,"(4.697144,-74.140516)"
2015,Marzo,Taiwán,158,0,3,,3,"(6.171601,-75.427454)"
2015,Marzo,Tailandia,764,0,1,,1,"(10.445761,-75.516429)"
2015,Marzo,Tailandia,764,26,37,,63,"(4.697144,-74.140516)"
2015,Marzo,Tailandia,764,3,2,,5,"(6.171601,-75.427454)"
2015,Marzo,Tanzania,834,1,1,,2,"(4.697144,-74.140516)"
2015,Marzo,Trinidad y Tobago,780,5,4,,9,"(10.445761,-75.516429)"
2015,Marzo,Trinidad y Tobago,780,1,3,,4,"(10.886611,-74.776708)"
2015,Marzo,Trinidad y Tobago,780,6,8,,14,"(3.541112,-76.384584)"
2015,Marzo,Trinidad y Tobago,780,17,33,,50,"(4.697144,-74.140516)"
2015,Marzo,Trinidad y Tobago,780,0,13,,13,"(4.815061,-75.736532)"
2015,Marzo,Trinidad y Tobago,780,7,8,,15,"(6.171601,-75.427454)"
2015,Marzo,Trinidad y Tobago,780,1,1,,2,"(7.128456,-73.183637)"
2015,Marzo,Trinidad y Tobago,780,2,0,,2,"(7.927209,-72.507910)"
2015,Marzo,Túnez,788,0,1,,1,"(4.697144,-74.140516)"
2015,Marzo,Turquía,792,0,1,,1,"(3.541112,-76.384584)"
2015,Marzo,Turquía,792,179,131,,310,"(4.697144,-74.140516)"
2015,Marzo,Turquía,792,1,5,,6,"(6.171601,-75.427454)"
2015,Marzo,Turkmenistán,795,1,0,,1,"(4.697144,-74.140516)"
2015,Marzo,Ucrania,804,1,4,,5,"(4.697144,-74.140516)"
2015,Marzo,Uganda,800,1,0,,1,"(4.697144,-74.140516)"
2015,Marzo,Uganda,800,0,1,,1,"(4.815061,-75.736532)"
2015,Marzo,Uruguay,858,0,2,,2,"(0.814836,-77.662532)"
2015,Marzo,Uruguay,858,1,0,,1,"(10.445761,-75.516429)"
2015,Marzo,Uruguay,858,1,0,,1,"(10.886611,-74.776708)"
2015,Marzo,Uruguay,858,0,1,,1,"(12.586067,-81.702563)"
2015,Marzo,Uruguay,858,22,18,,40,"(3.541112,-76.384584)"
2015,Marzo,Uruguay,858,95,78,,173,"(4.697144,-74.140516)"
2015,Marzo,Uruguay,858,4,2,,6,"(4.815061,-75.736532)"
2015,Marzo,Uruguay,858,14,15,,29,"(6.171601,-75.427454)"
2015,Marzo,Venezuela,862,9,8,,17,"(10.445761,-75.516429)"
2015,Marzo,Venezuela,862,49,44,,93,"(10.886611,-74.776708)"
2015,Marzo,Venezuela,862,0,1,,1,"(11.247723,-74.213989)"
2015,Marzo,Venezuela,862,10225,8641,,18866,"(11.360009,-72.129330)"
2015,Marzo,Venezuela,862,11,28,,39,"(3.541112,-76.384584)"
2015,Marzo,Venezuela,862,20,33,,53,"(3.866713,-67.927521)"
2015,Marzo,Venezuela,862,1080,1431,,2511,"(4.697144,-74.140516)"
2015,Marzo,Venezuela,862,4,4,,8,"(4.815061,-75.736532)"
2015,Marzo,Venezuela,862,16,38,,54,"(6.171601,-75.427454)"
2015,Marzo,Venezuela,862,192,187,,379,"(6.185799,-67.483929)"
2015,Marzo,Venezuela,862,2433,1967,,4400,"(7.088729,-70.740253)"
2015,Marzo,Venezuela,862,4,2,,6,"(7.128456,-73.183637)"
2015,Marzo,Venezuela,862,8284,7421,,15705,"(7.818934,-72.453226)"
2015,Marzo,Venezuela,862,0,3,,3,"(7.927209,-72.507910)"
2015,Marzo,Vietnam,704,3,6,,9,"(4.697144,-74.140516)"
2015,Marzo,Vietnam,704,1,0,,1,"(6.171601,-75.427454)"
2015,Marzo,Islas Vírgenes Británicas/Territorio Británico de Ultramar,92,1,0,,1,"(3.541112,-76.384584)"
2015,Marzo,Islas Vírgenes Británicas/Territorio Británico de Ultramar,92,2,0,,2,"(4.697144,-74.140516)"
2015,Marzo,República Árabe de Yemen,887,1,0,,1,"(4.697144,-74.140516)"
2015,Marzo,Islas Turcas y Caicos/Territorio Británico de Ultramar,796,0,1,,1,"(3.541112,-76.384584)"
2015,Marzo,Desconocido,99999,18,17,,35,"(0.812436,-77.847006)"
2015,Marzo,Desconocido,99999,273,464,,737,"(4.697144,-74.140516)"
2015,Marzo,Desconocido,99999,46,40,,86,"(6.185799,-67.483929)"
2015,Abril,Afganistán,4,1,4,,5,"(4.697144,-74.140516)"
2015,Abril,Afganistán,4,0,1,,1,"(6.171601,-75.427454)"
2015,Abril,Albania,8,0,2,,2,"(4.697144,-74.140516)"
2015,Abril,Alemania,276,1,0,,1,"(10.445761,-75.516429)"
2015,Abril,Alemania,276,0,2,,2,"(10.886611,-74.776708)"
2015,Abril,Alemania,276,44,26,,70,"(3.541112,-76.384584)"
2015,Abril,Alemania,276,1148,1145,,2293,"(4.697144,-74.140516)"
2015,Abril,Alemania,276,15,20,,35,"(6.171601,-75.427454)"
2015,Abril,Andorra,20,1,1,,2,"(4.697144,-74.140516)"
2015,Abril,Angola,24,1,14,,15,"(4.697144,-74.140516)"
2015,Abril,Antigua y Barbuda,28,1,2,,3,"(4.697144,-74.140516)"
2015,Abril,Países Bajos,528,3,9,,12,"(10.445761,-75.516429)"
2015,Abril,Países Bajos,528,58,40,,98,"(10.886611,-74.776708)"
2015,Abril,Países Bajos,528,0,1,,1,"(12.586067,-81.702563)"
2015,Abril,Países Bajos,528,130,65,,195,"(3.541112,-76.384584)"
2015,Abril,Países Bajos,528,562,487,,1049,"(4.697144,-74.140516)"
2015,Abril,Países Bajos,528,127,66,,193,"(6.171601,-75.427454)"
2015,Abril,Países Bajos,528,2,3,,5,"(7.128456,-73.183637)"
2015,Abril,Arabia Saudita,682,7,34,,41,"(4.697144,-74.140516)"
2015,Abril,Arabia Saudita,682,0,1,,1,"(4.815061,-75.736532)"
2015,Abril,Arabia Saudita,682,1,3,,4,"(6.171601,-75.427454)"
2015,Abril,Argelia,12,0,1,,1,"(3.541112,-76.384584)"
2015,Abril,Argelia,12,2,7,,9,"(4.697144,-74.140516)"
2015,Abril,Argelia,12,1,0,,1,"(6.171601,-75.427454)"
2015,Abril,Argentina,32,20,29,,49,"(0.814836,-77.662532)"
2015,Abril,Argentina,32,9,5,,14,"(10.445761,-75.516429)"
2015,Abril,Argentina,32,14,15,,29,"(10.886611,-74.776708)"
2015,Abril,Argentina,32,5,4,,9,"(12.586067,-81.702563)"
2015,Abril,Argentina,32,154,134,,288,"(3.541112,-76.384584)"
2015,Abril,Argentina,32,2149,2152,,4301,"(4.697144,-74.140516)"
2015,Abril,Argentina,32,6,11,,17,"(4.815061,-75.736532)"
2015,Abril,Argentina,32,187,201,,388,"(6.171601,-75.427454)"
2015,Abril,Argentina,32,3,4,,7,"(7.128456,-73.183637)"
2015,Abril,Argentina,32,2,4,,6,"(7.927209,-72.507910)"
2015,Abril,República de Armenia,51,1,2,,3,"(4.697144,-74.140516)"
2015,Abril,Aruba,533,920,607,,1527,"(10.408582,-75.538003)"
2015,Abril,Aruba,533,0,1,,1,"(10.445761,-75.516429)"
2015,Abril,Aruba,533,24,24,,48,"(10.886611,-74.776708)"
2015,Abril,Aruba,533,0,6,,6,"(10.971302,-74.765397)"
2015,Abril,Aruba,533,29,26,,55,"(3.541112,-76.384584)"
2015,Abril,Aruba,533,1287,1032,,2319,"(4.697144,-74.140516)"
2015,Abril,Aruba,533,4,2,,6,"(4.815061,-75.736532)"
2015,Abril,Aruba,533,53,36,,89,"(6.171601,-75.427454)"
2015,Abril,Aruba,533,19,28,,47,"(7.128456,-73.183637)"
2015,Abril,Aruba,533,6,2,,8,"(7.927209,-72.507910)"
2015,Abril,Australia,36,1,2,,3,"(10.445761,-75.516429)"
2015,Abril,Australia,36,0,2,,2,"(10.886611,-74.776708)"
2015,Abril,Australia,36,14,8,,22,"(3.541112,-76.384584)"
2015,Abril,Australia,36,184,119,,303,"(4.697144,-74.140516)"
2015,Abril,Australia,36,3,1,,4,"(4.815061,-75.736532)"
2015,Abril,Australia,36,25,11,,36,"(6.171601,-75.427454)"
2015,Abril,Australia,36,1,0,,1,"(7.128456,-73.183637)"
2015,Abril,Australia,36,0,1,,1,"(7.927209,-72.507910)"
2015,Abril,Austria,40,0,1,,1,"(10.886611,-74.776708)"
2015,Abril,Austria,40,0,1,,1,"(12.586067,-81.702563)"
2015,Abril,Austria,40,0,2,,2,"(3.541112,-76.384584)"
2015,Abril,Austria,40,39,31,,70,"(4.697144,-74.140516)"
2015,Abril,Austria,40,3,2,,5,"(6.171601,-75.427454)"
2015,Abril,Azerbaiyán,31,0,2,,2,"(4.697144,-74.140516)"
2015,Abril,Bahamas,44,2,0,,2,"(10.445761,-75.516429)"
2015,Abril,Bahamas,44,1,3,,4,"(10.886611,-74.776708)"
2015,Abril,Bahamas,44,10,6,,16,"(3.541112,-76.384584)"
2015,Abril,Bahamas,44,20,15,,35,"(4.697144,-74.140516)"
2015,Abril,Bahamas,44,2,1,,3,"(4.815061,-75.736532)"
2015,Abril,Bahamas,44,11,6,,17,"(6.171601,-75.427454)"
2015,Abril,Bahamas,44,1,0,,1,"(7.128456,-73.183637)"
2015,Abril,Bahréin,48,1,4,,5,"(4.697144,-74.140516)"
2015,Abril,Bahréin,48,1,0,,1,"(6.171601,-75.427454)"
2015,Abril,Bangladesh,50,0,1,,1,"(4.697144,-74.140516)"
2015,Abril,Barbados,52,1,8,,9,"(4.697144,-74.140516)"
2015,Abril,Barbados,52,0,1,,1,"(4.815061,-75.736532)"
2015,Abril,Barbados,52,0,1,,1,"(6.171601,-75.427454)"
2015,Abril,Barbados,52,0,1,,1,"(7.927209,-72.507910)"
2015,Abril,República de Belarús,112,0,1,,1,"(11.360009,-72.129330)"
2015,Abril,República de Belarús,112,2,2,,4,"(4.697144,-74.140516)"
2015,Abril,Bélgica,56,7,6,,13,"(3.541112,-76.384584)"
2015,Abril,Bélgica,56,76,57,,133,"(4.697144,-74.140516)"
2015,Abril,Bélgica,56,9,2,,11,"(6.171601,-75.427454)"
2015,Abril,Belice,84,1,0,,1,"(3.541112,-76.384584)"
2015,Abril,Belice,84,4,5,,9,"(4.697144,-74.140516)"
2015,Abril,Belice,84,4,5,,9,"(6.171601,-75.427454)"
2015,Abril,Benín,204,0,1,,1,"(3.541112,-76.384584)"
2015,Abril,Benín,204,0,1,,1,"(4.697144,-74.140516)"
2015,Abril,Bermudas/Territorio Británico de Ultramar,60,3,0,,3,"(4.697144,-74.140516)"
2015,Abril,Bermudas/Territorio Británico de Ultramar,60,1,1,,2,"(6.171601,-75.427454)"
2015,Abril,Bolivia,68,2,3,,5,"(0.814836,-77.662532)"
2015,Abril,Bolivia,68,1,4,,5,"(10.886611,-74.776708)"
2015,Abril,Bolivia,68,36,56,,92,"(3.541112,-76.384584)"
2015,Abril,Bolivia,68,257,500,,757,"(4.697144,-74.140516)"
2015,Abril,Bolivia,68,3,10,,13,"(4.815061,-75.736532)"
2015,Abril,Bolivia,68,34,56,,90,"(6.171601,-75.427454)"
2015,Abril,Bolivia,68,1,0,,1,"(7.128456,-73.183637)"
2015,Abril,Bolivia,68,0,1,,1,"(7.927209,-72.507910)"
2015,Abril,Bosnia y Herzegovina,70,2,0,,2,"(4.697144,-74.140516)"
2015,Abril,Brasil,76,102,216,,318,"(-4.197703,-69.941278)"
2015,Abril,Brasil,76,8,10,,18,"(-4.223468,-69.945098)"
2015,Abril,Brasil,76,1,1,,2,"(0.814836,-77.662532)"
2015,Abril,Brasil,76,4,11,,15,"(10.445761,-75.516429)"
2015,Abril,Brasil,76,5,9,,14,"(10.886611,-74.776708)"
2015,Abril,Brasil,76,3,3,,6,"(12.586067,-81.702563)"
2015,Abril,Brasil,76,59,118,,177,"(3.541112,-76.384584)"
2015,Abril,Brasil,76,2477,3603,,6080,"(4.697144,-74.140516)"
2015,Abril,Brasil,76,14,37,,51,"(4.815061,-75.736532)"
2015,Abril,Brasil,76,76,134,,210,"(6.171601,-75.427454)"
2015,Abril,Brasil,76,4,4,,8,"(7.128456,-73.183637)"
2015,Abril,Brasil,76,0,2,,2,"(7.927209,-72.507910)"
2015,Abril,Bulgaria,100,0,1,,1,"(6.171601,-75.427454)"
2015,Abril,Burundi,108,0,1,,1,"(4.697144,-74.140516)"
2015,Abril,Bután,64,1,0,,1,"(4.697144,-74.140516)"
2015,Abril,Cabo Verde,132,1,0,,1,"(4.697144,-74.140516)"
2015,Abril,Islas Caimán/Territorio Británico de Ultramar,136,2,0,,2,"(10.445761,-75.516429)"
2015,Abril,Islas Caimán/Territorio Británico de Ultramar,136,1,0,,1,"(10.886611,-74.776708)"
2015,Abril,Islas Caimán/Territorio Británico de Ultramar,136,1,1,,2,"(12.586067,-81.702563)"
2015,Abril,Islas Caimán/Territorio Británico de Ultramar,136,1,0,,1,"(3.541112,-76.384584)"
2015,Abril,Islas Caimán/Territorio Británico de Ultramar,136,1,2,,3,"(4.697144,-74.140516)"
2015,Abril,Islas Caimán/Territorio Británico de Ultramar,136,0,1,,1,"(6.171601,-75.427454)"
2015,Abril,Camboya,116,0,2,,2,"(4.697144,-74.140516)"
2015,Abril,Canadá,124,0,1,,1,"(0.814836,-77.662532)"
2015,Abril,Canadá,124,25,20,,45,"(10.445761,-75.516429)"
2015,Abril,Canadá,124,13,14,,27,"(10.886611,-74.776708)"
2015,Abril,Canadá,124,2,0,,2,"(12.586067,-81.702563)"
2015,Abril,Canadá,124,144,91,,235,"(3.541112,-76.384584)"
2015,Abril,Canadá,124,2,2,,4,"(4.452882,-75.766298)"
2015,Abril,Canadá,124,1170,1032,,2202,"(4.697144,-74.140516)"
2015,Abril,Canadá,124,21,14,,35,"(4.815061,-75.736532)"
2015,Abril,Canadá,124,230,179,,409,"(6.171601,-75.427454)"
2015,Abril,Canadá,124,6,6,,12,"(7.128456,-73.183637)"
2015,Abril,Canadá,124,3,5,,8,"(7.927209,-72.507910)"
2015,Abril,España,724,3,2,,5,"(10.445761,-75.516429)"
2015,Abril,España,724,3,0,,3,"(10.886611,-74.776708)"
2015,Abril,España,724,1231,772,,2003,"(3.541112,-76.384584)"
2015,Abril,España,724,6690,5275,,11965,"(4.697144,-74.140516)"
2015,Abril,España,724,8,5,,13,"(4.815061,-75.736532)"
2015,Abril,España,724,760,619,,1379,"(6.171601,-75.427454)"
2015,Abril,España,724,1,2,,3,"(7.128456,-73.183637)"
2015,Abril,Colombia,170,415,695,,1110,"(4.697144,-74.140516)"
2015,Abril,República Del Congo,178,0,3,,3,"(4.697144,-74.140516)"
2015,Abril,República Democrática del Congo,180,0,1,,1,"(4.697144,-74.140516)"
2015,Abril,República de Corea,410,1,1,,2,"(10.886611,-74.776708)"
2015,Abril,República de Corea,410,0,1,,1,"(3.541112,-76.384584)"
2015,Abril,República de Corea,410,39,38,,77,"(4.697144,-74.140516)"
2015,Abril,República de Corea,410,1,1,,2,"(6.171601,-75.427454)"
2015,Abril,Costa de Marfil,384,1,6,,7,"(4.697144,-74.140516)"
2015,Abril,Costa Rica,188,0,2,,2,"(10.408582,-75.538003)"
2015,Abril,Costa Rica,188,11,13,,24,"(10.445761,-75.516429)"
2015,Abril,Costa Rica,188,10,15,,25,"(10.886611,-74.776708)"
2015,Abril,Costa Rica,188,3,20,,23,"(12.5744111,-81.703935)"
2015,Abril,Costa Rica,188,2,2,,4,"(12.586067,-81.702563)"
2015,Abril,Costa Rica,188,0,8,,8,"(13.3387613,-81.372937)"
2015,Abril,Costa Rica,188,44,64,,108,"(3.541112,-76.384584)"
2015,Abril,Costa Rica,188,728,935,,1663,"(4.697144,-74.140516)"
2015,Abril,Costa Rica,188,17,11,,28,"(4.815061,-75.736532)"
2015,Abril,Costa Rica,188,115,120,,235,"(6.171601,-75.427454)"
2015,Abril,Costa Rica,188,5,7,,12,"(7.128456,-73.183637)"
2015,Abril,Costa Rica,188,1,1,,2,"(7.927209,-72.507910)"
2015,Abril,Croacia,191,2,2,,4,"(4.697144,-74.140516)"
2015,Abril,Cuba,192,13,7,,20,"(10.445761,-75.516429)"
2015,Abril,Cuba,192,32,18,,50,"(10.886611,-74.776708)"
2015,Abril,Cuba,192,1,2,,3,"(12.586067,-81.702563)"
2015,Abril,Cuba,192,53,68,,121,"(3.541112,-76.384584)"
2015,Abril,Cuba,192,792,793,,1585,"(4.697144,-74.140516)"
2015,Abril,Cuba,192,6,8,,14,"(4.815061,-75.736532)"
2015,Abril,Cuba,192,109,103,,212,"(6.171601,-75.427454)"
2015,Abril,Cuba,192,9,9,,18,"(7.128456,-73.183637)"
2015,Abril,Cuba,192,15,18,,33,"(7.927209,-72.507910)"
2015,Abril,República Checa,203,1,1,,2,"(3.541112,-76.384584)"
2015,Abril,República Checa,203,3,7,,10,"(4.697144,-74.140516)"
2015,Abril,República Checa,203,1,1,,2,"(6.171601,-75.427454)"
2015,Abril,Chile,152,176,135,,311,"(0.814836,-77.662532)"
2015,Abril,Chile,152,10,5,,15,"(10.445761,-75.516429)"
2015,Abril,Chile,152,6,2,,8,"(10.886611,-74.776708)"
2015,Abril,Chile,152,1,1,,2,"(12.586067,-81.702563)"
2015,Abril,Chile,152,255,237,,492,"(3.541112,-76.384584)"
2015,Abril,Chile,152,2805,2754,,5559,"(4.697144,-74.140516)"
2015,Abril,Chile,152,45,34,,79,"(4.815061,-75.736532)"
2015,Abril,Chile,152,82,88,,170,"(6.171601,-75.427454)"
2015,Abril,Chile,152,10,8,,18,"(7.128456,-73.183637)"
2015,Abril,Chile,152,4,3,,7,"(7.927209,-72.507910)"
2015,Abril,China,156,0,1,,1,"(10.445761,-75.516429)"
2015,Abril,China,156,4,5,,9,"(10.886611,-74.776708)"
2015,Abril,China,156,35,114,,149,"(3.541112,-76.384584)"
2015,Abril,China,156,327,847,,1174,"(4.697144,-74.140516)"
2015,Abril,China,156,0,4,,4,"(4.815061,-75.736532)"
2015,Abril,China,156,31,67,,98,"(6.171601,-75.427454)"
2015,Abril,China,156,0,2,,2,"(7.128456,-73.183637)"
2015,Abril,China,156,1,1,,2,"(7.927209,-72.507910)"
2015,Abril,Chipre,196,1,0,,1,"(3.541112,-76.384584)"
2015,Abril,Chipre,196,1,0,,1,"(4.697144,-74.140516)"
2015,Abril,Dinamarca,208,1,0,,1,"(10.445761,-75.516429)"
2015,Abril,Dinamarca,208,3,2,,5,"(3.541112,-76.384584)"
2015,Abril,Dinamarca,208,32,27,,59,"(4.697144,-74.140516)"
2015,Abril,Dinamarca,208,2,1,,3,"(6.171601,-75.427454)"
2015,Abril,Ecuador,218,547,743,,1290,"(0.25129,-76.875963)"
2015,Abril,Ecuador,218,10,25,,35,"(0.812436,-77.847006)"
2015,Abril,Ecuador,218,6422,7031,,13453,"(0.814836,-77.662532)"
2015,Abril,Ecuador,218,156,167,,323,"(1.813928,-78.763924)"
2015,Abril,Ecuador,218,0,1,,1,"(10.408582,-75.538003)"
2015,Abril,Ecuador,218,0,1,,1,"(10.445761,-75.516429)"
2015,Abril,Ecuador,218,1,13,,14,"(10.886611,-74.776708)"
2015,Abril,Ecuador,218,0,2,,2,"(12.586067,-81.702563)"
2015,Abril,Ecuador,218,296,312,,608,"(3.541112,-76.384584)"
2015,Abril,Ecuador,218,0,2,,2,"(3.893038,-77.067921)"
2015,Abril,Ecuador,218,2555,4086,,6641,"(4.697144,-74.140516)"
2015,Abril,Ecuador,218,4,14,,18,"(4.815061,-75.736532)"
2015,Abril,Ecuador,218,46,78,,124,"(6.171601,-75.427454)"
2015,Abril,Ecuador,218,4,7,,11,"(7.128456,-73.183637)"
2015,Abril,Ecuador,218,2,2,,4,"(7.927209,-72.507910)"
2015,Abril,Egipto,818,23,10,,33,"(4.697144,-74.140516)"
2015,Abril,El Salvador,222,0,2,,2,"(10.445761,-75.516429)"
2015,Abril,El Salvador,222,2,0,,2,"(10.886611,-74.776708)"
2015,Abril,El Salvador,222,85,94,,179,"(3.541112,-76.384584)"
2015,Abril,El Salvador,222,669,852,,1521,"(4.697144,-74.140516)"
2015,Abril,El Salvador,222,1,0,,1,"(4.815061,-75.736532)"
2015,Abril,El Salvador,222,63,112,,175,"(6.171601,-75.427454)"
2015,Abril,El Salvador,222,0,3,,3,"(7.128456,-73.183637)"
2015,Abril,El Salvador,222,1,1,,2,"(7.927209,-72.507910)"
2015,Abril,Emiratos Árabes,784,1,3,,4,"(3.541112,-76.384584)"
2015,Abril,Emiratos Árabes,784,67,140,,207,"(4.697144,-74.140516)"
2015,Abril,Emiratos Árabes,784,5,3,,8,"(6.171601,-75.427454)"
2015,Abril,Eslovenia,705,1,3,,4,"(4.697144,-74.140516)"
2015,Abril,Estados Unidos de América,840,0,1,,1,"(10.408582,-75.538003)"
2015,Abril,Estados Unidos de América,840,3237,2598,,5835,"(10.445761,-75.516429)"
2015,Abril,Estados Unidos de América,840,1471,1192,,2663,"(10.886611,-74.776708)"
2015,Abril,Estados Unidos de América,840,3,6,,9,"(11.117806,-74.232622)"
2015,Abril,Estados Unidos de América,840,24,15,,39,"(12.586067,-81.702563)"
2015,Abril,Estados Unidos de América,840,4697,3372,,8069,"(3.541112,-76.384584)"
2015,Abril,Estados Unidos de América,840,600,423,,1023,"(4.452882,-75.766298)"
2015,Abril,Estados Unidos de América,840,27037,24531,,51568,"(4.697144,-74.140516)"
2015,Abril,Estados Unidos de América,840,807,620,,1427,"(4.815061,-75.736532)"
2015,Abril,Estados Unidos de América,840,7819,6221,,14040,"(6.171601,-75.427454)"
2015,Abril,Estados Unidos de América,840,159,109,,268,"(7.128456,-73.183637)"
2015,Abril,Estados Unidos de América,840,78,56,,134,"(7.927209,-72.507910)"
2015,Abril,Etiopia,231,2,8,,10,"(4.697144,-74.140516)"
2015,Abril,Etiopia,231,0,1,,1,"(4.815061,-75.736532)"
2015,Abril,Filipinas,608,0,1,,1,"(3.541112,-76.384584)"
2015,Abril,Filipinas,608,4,3,,7,"(4.697144,-74.140516)"
2015,Abril,Finlandia,246,8,7,,15,"(4.697144,-74.140516)"
2015,Abril,Finlandia,246,0,1,,1,"(6.171601,-75.427454)"
2015,Abril,Francia,250,1,0,,1,"(10.445761,-75.516429)"
2015,Abril,Francia,250,33,15,,48,"(3.541112,-76.384584)"
2015,Abril,Francia,250,896,828,,1724,"(4.697144,-74.140516)"
2015,Abril,Francia,250,2,0,,2,"(4.815061,-75.736532)"
2015,Abril,Francia,250,32,19,,51,"(6.171601,-75.427454)"
2015,Abril,Gabón,266,0,3,,3,"(4.697144,-74.140516)"
2015,Abril,Georgia,268,1,1,,2,"(4.697144,-74.140516)"
2015,Abril,Ghana,288,4,8,,12,"(4.697144,-74.140516)"
2015,Abril,Gibraltar/Territorio Británico de Ultramar,292,0,1,,1,"(0.814836,-77.662532)"
2015,Abril,Grecia,300,0,2,,2,"(3.541112,-76.384584)"
2015,Abril,Grecia,300,19,7,,26,"(4.697144,-74.140516)"
2015,Abril,Guatemala,320,3,3,,6,"(10.445761,-75.516429)"
2015,Abril,Guatemala,320,2,8,,10,"(10.886611,-74.776708)"
2015,Abril,Guatemala,320,0,7,,7,"(11.117806,-74.232622)"
2015,Abril,Guatemala,320,1,0,,1,"(12.586067,-81.702563)"
2015,Abril,Guatemala,320,59,88,,147,"(3.541112,-76.384584)"
2015,Abril,Guatemala,320,427,621,,1048,"(4.697144,-74.140516)"
2015,Abril,Guatemala,320,6,8,,14,"(4.815061,-75.736532)"
2015,Abril,Guatemala,320,85,136,,221,"(6.171601,-75.427454)"
2015,Abril,Guatemala,320,7,7,,14,"(7.128456,-73.183637)"
2015,Abril,Guatemala,320,1,1,,2,"(7.927209,-72.507910)"
2015,Abril,Guyana,328,0,1,,1,"(3.541112,-76.384584)"
2015,Abril,Guinea,324,1,0,,1,"(0.814836,-77.662532)"
2015,Abril,Guinea Ecuatorial,226,1,0,,1,"(3.541112,-76.384584)"
2015,Abril,Guinea Ecuatorial,226,4,8,,12,"(4.697144,-74.140516)"
2015,Abril,Guadalupe/Territorio Francés,312,1,2,,3,"(4.697144,-74.140516)"
2015,Abril,Haití,332,0,2,,2,"(10.445761,-75.516429)"
2015,Abril,Haití,332,0,4,,4,"(10.886611,-74.776708)"
2015,Abril,Haití,332,1,1,,2,"(3.541112,-76.384584)"
2015,Abril,Haití,332,4,20,,24,"(4.697144,-74.140516)"
2015,Abril,Haití,332,0,6,,6,"(6.171601,-75.427454)"
2015,Abril,Haití,332,0,1,,1,"(7.927209,-72.507910)"
2015,Abril,Honduras,340,0,12,,12,"(10.445761,-75.516429)"
2015,Abril,Honduras,340,4,8,,12,"(10.886611,-74.776708)"
2015,Abril,Honduras,340,0,1,,1,"(12.586067,-81.702563)"
2015,Abril,Honduras,340,8,18,,26,"(3.541112,-76.384584)"
2015,Abril,Honduras,340,65,149,,214,"(4.697144,-74.140516)"
2015,Abril,Honduras,340,2,2,,4,"(4.815061,-75.736532)"
2015,Abril,Honduras,340,41,47,,88,"(6.171601,-75.427454)"
2015,Abril,Honduras,340,0,1,,1,"(7.128456,-73.183637)"
2015,Abril,Hong Kong,344,1,4,,5,"(3.541112,-76.384584)"
2015,Abril,Hong Kong,344,48,103,,151,"(4.697144,-74.140516)"
2015,Abril,Hong Kong,344,1,2,,3,"(6.171601,-75.427454)"
2015,Abril,Hong Kong,344,0,2,,2,"(7.128456,-73.183637)"
2015,Abril,Hungría,348,1,1,,2,"(4.697144,-74.140516)"
2015,Abril,India,356,4,1,,5,"(3.541112,-76.384584)"
2015,Abril,India,356,33,85,,118,"(4.697144,-74.140516)"
2015,Abril,India,356,17,10,,27,"(6.171601,-75.427454)"
2015,Abril,Indonesia,360,0,1,,1,"(10.445761,-75.516429)"
2015,Abril,Indonesia,360,0,1,,1,"(3.541112,-76.384584)"
2015,Abril,Indonesia,360,1,5,,6,"(4.697144,-74.140516)"
2015,Abril,Iraq,368,1,6,,7,"(4.697144,-74.140516)"
2015,Abril,Irán,364,2,1,,3,"(4.697144,-74.140516)"
2015,Abril,República de Irlanda,372,8,12,,20,"(4.697144,-74.140516)"
2015,Abril,Israel,376,0,2,,2,"(10.408582,-75.538003)"
2015,Abril,Israel,376,5,4,,9,"(3.541112,-76.384584)"
2015,Abril,Israel,376,111,112,,223,"(4.697144,-74.140516)"
2015,Abril,Israel,376,3,2,,5,"(6.171601,-75.427454)"
2015,Abril,Italia,380,2,0,,2,"(10.445761,-75.516429)"
2015,Abril,Italia,380,96,39,,135,"(3.541112,-76.384584)"
2015,Abril,Italia,380,569,365,,934,"(4.697144,-74.140516)"
2015,Abril,Italia,380,41,25,,66,"(6.171601,-75.427454)"
2015,Abril,Italia,380,0,1,,1,"(7.128456,-73.183637)"
2015,Abril,Italia,380,2,0,,2,"(7.927209,-72.507910)"
2015,Abril,Islas Feroe/Región Autónoma de Dinamarca,234,1,0,,1,"(4.697144,-74.140516)"
2015,Abril,Jamaica,388,1,0,,1,"(10.408582,-75.538003)"
2015,Abril,Jamaica,388,0,6,,6,"(10.445761,-75.516429)"
2015,Abril,Jamaica,388,4,4,,8,"(10.886611,-74.776708)"
2015,Abril,Jamaica,388,1,0,,1,"(12.586067,-81.702563)"
2015,Abril,Jamaica,388,8,5,,13,"(3.541112,-76.384584)"
2015,Abril,Jamaica,388,13,8,,21,"(4.697144,-74.140516)"
2015,Abril,Jamaica,388,0,2,,2,"(4.815061,-75.736532)"
2015,Abril,Jamaica,388,24,27,,51,"(6.171601,-75.427454)"
2015,Abril,Jamaica,388,1,1,,2,"(7.128456,-73.183637)"
2015,Abril,Jamaica,388,0,2,,2,"(7.927209,-72.507910)"
2015,Abril,Japón,392,8,3,,11,"(3.541112,-76.384584)"
2015,Abril,Japón,392,40,39,,79,"(4.697144,-74.140516)"
2015,Abril,Japón,392,2,2,,4,"(6.171601,-75.427454)"
2015,Abril,Jordania,400,2,9,,11,"(4.697144,-74.140516)"
2015,Abril,Kazajistán,398,2,1,,3,"(4.697144,-74.140516)"
2015,Abril,Kenia,404,2,4,,6,"(4.697144,-74.140516)"
2015,Abril,Kuwait,414,0,2,,2,"(4.697144,-74.140516)"
2015,Abril,Líbano,422,0,1,,1,"(10.886611,-74.776708)"
2015,Abril,Líbano,422,9,21,,30,"(4.697144,-74.140516)"
2015,Abril,Liberia,430,1,0,,1,"(3.541112,-76.384584)"
2015,Abril,Liberia,430,2,0,,2,"(4.697144,-74.140516)"
2015,Abril,Luxemburgo,442,2,3,,5,"(4.697144,-74.140516)"
2015,Abril,Malasia,458,1,9,,10,"(4.697144,-74.140516)"
2015,Abril,Malta,470,6,7,,13,"(4.697144,-74.140516)"
2015,Abril,Marruecos,504,1,0,,1,"(3.541112,-76.384584)"
2015,Abril,Marruecos,504,24,12,,36,"(4.697144,-74.140516)"
2015,Abril,Marruecos,504,1,1,,2,"(6.171601,-75.427454)"
2015,Abril,Martinica/Departamento de Ultramar Francés,474,0,2,,2,"(4.697144,-74.140516)"
2015,Abril,México,484,36,32,,68,"(10.445761,-75.516429)"
2015,Abril,México,484,86,78,,164,"(10.886611,-74.776708)"
2015,Abril,México,484,1,0,,1,"(12.586067,-81.702563)"
2015,Abril,México,484,419,418,,837,"(3.541112,-76.384584)"
2015,Abril,México,484,9461,8924,,18385,"(4.697144,-74.140516)"
2015,Abril,México,484,98,129,,227,"(4.815061,-75.736532)"
2015,Abril,México,484,1305,1031,,2336,"(6.171601,-75.427454)"
2015,Abril,México,484,121,105,,226,"(7.128456,-73.183637)"
2015,Abril,México,484,37,28,,65,"(7.927209,-72.507910)"
2015,Abril,Mónaco,492,1,1,,2,"(4.697144,-74.140516)"
2015,Abril,Mónaco,492,0,1,,1,"(6.171601,-75.427454)"
2015,Abril,Montenegro,499,0,1,,1,"(4.697144,-74.140516)"
2015,Abril,Mozambique,508,1,0,,1,"(4.697144,-74.140516)"
2015,Abril,Nepal,524,2,1,,3,"(4.697144,-74.140516)"
2015,Abril,Nicaragua,558,1,7,,8,"(10.445761,-75.516429)"
2015,Abril,Nicaragua,558,1,4,,5,"(10.886611,-74.776708)"
2015,Abril,Nicaragua,558,1,0,,1,"(12.586067,-81.702563)"
2015,Abril,Nicaragua,558,9,32,,41,"(3.541112,-76.384584)"
2015,Abril,Nicaragua,558,29,61,,90,"(4.697144,-74.140516)"
2015,Abril,Nicaragua,558,0,6,,6,"(4.815061,-75.736532)"
2015,Abril,Nicaragua,558,12,36,,48,"(6.171601,-75.427454)"
2015,Abril,Nicaragua,558,0,2,,2,"(7.128456,-73.183637)"
2015,Abril,Nigeria,566,0,12,,12,"(4.697144,-74.140516)"
2015,Abril,Noruega,578,6,1,,7,"(3.541112,-76.384584)"
2015,Abril,Noruega,578,28,27,,55,"(4.697144,-74.140516)"
2015,Abril,Noruega,578,2,0,,2,"(6.171601,-75.427454)"
2015,Abril,Noruega,578,0,1,,1,"(7.128456,-73.183637)"
2015,Abril,Nueva Caledonia/Territorio francés,540,1,0,,1,"(4.697144,-74.140516)"
2015,Abril,Nueva Zelanda,554,1,0,,1,"(0.814836,-77.662532)"
2015,Abril,Nueva Zelanda,554,28,35,,63,"(4.697144,-74.140516)"
2015,Abril,Nueva Zelanda,554,3,3,,6,"(6.171601,-75.427454)"
2015,Abril,Nueva Zelanda,554,0,1,,1,"(7.128456,-73.183637)"
2015,Abril,Omán,512,0,8,,8,"(4.697144,-74.140516)"
2015,Abril,Omán,512,0,1,,1,"(6.171601,-75.427454)"
2015,Abril,Papúa Nueva Guinea,598,1,1,,2,"(4.697144,-74.140516)"
2015,Abril,Pakistán,586,0,1,,1,"(4.697144,-74.140516)"
2015,Abril,Pakistán,586,0,1,,1,"(6.171601,-75.427454)"
2015,Abril,Panamá,591,540,427,,967,"(10.408582,-75.538003)"
2015,Abril,Panamá,591,266,297,,563,"(10.445761,-75.516429)"
2015,Abril,Panamá,591,625,623,,1248,"(10.886611,-74.776708)"
2015,Abril,Panamá,591,0,1,,1,"(11.247723,-74.213989)"
2015,Abril,Panamá,591,2,9,,11,"(12.5744111,-81.703935)"
2015,Abril,Panamá,591,142,152,,294,"(12.586067,-81.702563)"
2015,Abril,Panamá,591,1702,1490,,3192,"(3.541112,-76.384584)"
2015,Abril,Panamá,591,1,18,,19,"(3.893038,-77.067921)"
2015,Abril,Panamá,591,6701,7380,,14081,"(4.697144,-74.140516)"
2015,Abril,Panamá,591,507,410,,917,"(4.815061,-75.736532)"
2015,Abril,Panamá,591,2712,2797,,5509,"(6.171601,-75.427454)"
2015,Abril,Panamá,591,0,2,,2,"(6.228046,-77.404104)"
2015,Abril,Panamá,591,7,6,,13,"(7.102626,-77.762647)"
2015,Abril,Panamá,591,206,186,,392,"(7.128456,-73.183637)"
2015,Abril,Panamá,591,162,189,,351,"(7.927209,-72.507910)"
2015,Abril,Panamá,591,0,63,,63,"(8.066966,-76.735404)"
2015,Abril,Panamá,591,40,103,,143,"(8.635765,-77.346578)"
2015,Abril,Paraguay,600,0,1,,1,"(0.814836,-77.662532)"
2015,Abril,Paraguay,600,0,2,,2,"(10.886611,-74.776708)"
2015,Abril,Paraguay,600,14,18,,32,"(3.541112,-76.384584)"
2015,Abril,Paraguay,600,65,139,,204,"(4.697144,-74.140516)"
2015,Abril,Paraguay,600,1,3,,4,"(4.815061,-75.736532)"
2015,Abril,Paraguay,600,7,27,,34,"(6.171601,-75.427454)"
2015,Abril,Perú,604,90,90,,180,"(-4.197703,-69.941278)"
2015,Abril,Perú,604,1,2,,3,"(-4.223468,-69.945098)"
2015,Abril,Perú,604,73,88,,161,"(0.814836,-77.662532)"
2015,Abril,Perú,604,2,1,,3,"(10.445761,-75.516429)"
2015,Abril,Perú,604,9,14,,23,"(10.886611,-74.776708)"
2015,Abril,Perú,604,3,1,,4,"(12.586067,-81.702563)"
2015,Abril,Perú,604,241,280,,521,"(3.541112,-76.384584)"
2015,Abril,Perú,604,3592,4370,,7962,"(4.697144,-74.140516)"
2015,Abril,Perú,604,9,8,,17,"(4.815061,-75.736532)"
2015,Abril,Perú,604,304,384,,688,"(6.171601,-75.427454)"
2015,Abril,Perú,604,7,2,,9,"(7.128456,-73.183637)"
2015,Abril,Perú,604,1,1,,2,"(7.927209,-72.507910)"
2015,Abril,Palestina,99999,1,0,,1,"(4.697144,-74.140516)"
2015,Abril,Polonia,616,1,1,,2,"(3.541112,-76.384584)"
2015,Abril,Polonia,616,6,7,,13,"(4.697144,-74.140516)"
2015,Abril,Polonia,616,0,1,,1,"(6.171601,-75.427454)"
2015,Abril,Portugal,620,1,1,,2,"(3.541112,-76.384584)"
2015,Abril,Portugal,620,104,68,,172,"(4.697144,-74.140516)"
2015,Abril,Portugal,620,1,2,,3,"(6.171601,-75.427454)"
2015,Abril,Puerto Rico/Territorio de Estados Unidos,630,2,3,,5,"(10.445761,-75.516429)"
2015,Abril,Puerto Rico/Territorio de Estados Unidos,630,5,8,,13,"(10.886611,-74.776708)"
2015,Abril,Puerto Rico/Territorio de Estados Unidos,630,1,1,,2,"(12.586067,-81.702563)"
2015,Abril,Puerto Rico/Territorio de Estados Unidos,630,58,50,,108,"(3.541112,-76.384584)"
2015,Abril,Puerto Rico/Territorio de Estados Unidos,630,537,492,,1029,"(4.697144,-74.140516)"
2015,Abril,Puerto Rico/Territorio de Estados Unidos,630,6,3,,9,"(4.815061,-75.736532)"
2015,Abril,Puerto Rico/Territorio de Estados Unidos,630,47,44,,91,"(6.171601,-75.427454)"
2015,Abril,Puerto Rico/Territorio de Estados Unidos,630,5,3,,8,"(7.128456,-73.183637)"
2015,Abril,Qatar,634,6,2,,8,"(4.697144,-74.140516)"
2015,Abril,Qatar,634,2,0,,2,"(6.171601,-75.427454)"
2015,Abril,Reino Unido de Gran Bretaña e Irlanda del Norte,826,0,1,,1,"(10.886611,-74.776708)"
2015,Abril,Reino Unido de Gran Bretaña e Irlanda del Norte,826,14,14,,28,"(3.541112,-76.384584)"
2015,Abril,Reino Unido de Gran Bretaña e Irlanda del Norte,826,1236,911,,2147,"(4.697144,-74.140516)"
2015,Abril,Reino Unido de Gran Bretaña e Irlanda del Norte,826,10,7,,17,"(6.171601,-75.427454)"
2015,Abril,República CentroÁfricana,140,0,3,,3,"(4.697144,-74.140516)"
2015,Abril,Federación de Rusia,643,27,42,,69,"(4.697144,-74.140516)"
2015,Abril,Federación de Rusia,643,1,1,,2,"(6.171601,-75.427454)"
2015,Abril,República Dominicana,214,11,26,,37,"(10.445761,-75.516429)"
2015,Abril,República Dominicana,214,52,57,,109,"(10.886611,-74.776708)"
2015,Abril,República Dominicana,214,5,10,,15,"(11.117806,-74.232622)"
2015,Abril,República Dominicana,214,1,2,,3,"(12.586067,-81.702563)"
2015,Abril,República Dominicana,214,111,122,,233,"(3.541112,-76.384584)"
2015,Abril,República Dominicana,214,1255,1326,,2581,"(4.697144,-74.140516)"
2015,Abril,República Dominicana,214,12,17,,29,"(4.815061,-75.736532)"
2015,Abril,República Dominicana,214,182,165,,347,"(6.171601,-75.427454)"
2015,Abril,República Dominicana,214,15,10,,25,"(7.128456,-73.183637)"
2015,Abril,República Dominicana,214,10,4,,14,"(7.927209,-72.507910)"
2015,Abril,Reunión,638,1,0,,1,"(4.697144,-74.140516)"
2015,Abril,República Democrática Popular de Corea,408,1,1,,2,"(4.697144,-74.140516)"
2015,Abril,Rumania,642,3,3,,6,"(4.697144,-74.140516)"
2015,Abril,Samoa Occidental,882,1,0,,1,"(4.697144,-74.140516)"
2015,Abril,San Marino,674,1,0,,1,"(4.697144,-74.140516)"
2015,Abril,Santa Lucia,662,1,0,,1,"(4.697144,-74.140516)"
2015,Abril,Senegal,686,1,2,,3,"(4.697144,-74.140516)"
2015,Abril,Singapur,702,12,17,,29,"(4.697144,-74.140516)"
2015,Abril,Sudáfrica,710,1,0,,1,"(12.586067,-81.702563)"
2015,Abril,Sudáfrica,710,0,2,,2,"(3.541112,-76.384584)"
2015,Abril,Sudáfrica,710,20,11,,31,"(4.697144,-74.140516)"
2015,Abril,Sudáfrica,710,0,1,,1,"(6.171601,-75.427454)"
2015,Abril,Sudáfrica,710,1,0,,1,"(7.128456,-73.183637)"
2015,Abril,Suecia,752,11,8,,19,"(3.541112,-76.384584)"
2015,Abril,Suecia,752,50,54,,104,"(4.697144,-74.140516)"
2015,Abril,Suecia,752,1,2,,3,"(6.171601,-75.427454)"
2015,Abril,Suiza,756,29,5,,34,"(3.541112,-76.384584)"
2015,Abril,Suiza,756,248,173,,421,"(4.697144,-74.140516)"
2015,Abril,Suiza,756,15,5,,20,"(6.171601,-75.427454)"
2015,Abril,Surinam,740,1,0,,1,"(10.445761,-75.516429)"
2015,Abril,Surinam,740,3,15,,18,"(4.697144,-74.140516)"
2015,Abril,Surinam,740,2,0,,2,"(6.171601,-75.427454)"
2015,Abril,Taiwán,158,1,1,,2,"(3.541112,-76.384584)"
2015,Abril,Taiwán,158,0,6,,6,"(4.697144,-74.140516)"
2015,Abril,Tailandia,764,0,1,,1,"(3.541112,-76.384584)"
2015,Abril,Tailandia,764,17,16,,33,"(4.697144,-74.140516)"
2015,Abril,Tanzania,834,0,2,,2,"(4.697144,-74.140516)"
2015,Abril,Trinidad y Tobago,780,4,6,,10,"(10.445761,-75.516429)"
2015,Abril,Trinidad y Tobago,780,0,8,,8,"(10.886611,-74.776708)"
2015,Abril,Trinidad y Tobago,780,5,7,,12,"(3.541112,-76.384584)"
2015,Abril,Trinidad y Tobago,780,21,30,,51,"(4.697144,-74.140516)"
2015,Abril,Trinidad y Tobago,780,4,0,,4,"(4.815061,-75.736532)"
2015,Abril,Trinidad y Tobago,780,4,8,,12,"(6.171601,-75.427454)"
2015,Abril,Trinidad y Tobago,780,6,0,,6,"(7.128456,-73.183637)"
2015,Abril,Túnez,788,1,1,,2,"(4.697144,-74.140516)"
2015,Abril,Turquía,792,1,1,,2,"(10.445761,-75.516429)"
2015,Abril,Turquía,792,41,46,,87,"(3.541112,-76.384584)"
2015,Abril,Turquía,792,76,108,,184,"(4.697144,-74.140516)"
2015,Abril,Turquía,792,3,2,,5,"(6.171601,-75.427454)"
2015,Abril,Turkmenistán,795,1,0,,1,"(3.541112,-76.384584)"
2015,Abril,Turkmenistán,795,2,0,,2,"(4.697144,-74.140516)"
2015,Abril,Turkmenistán,795,0,2,,2,"(6.171601,-75.427454)"
2015,Abril,Ucrania,804,1,8,,9,"(4.697144,-74.140516)"
2015,Abril,Uruguay,858,1,1,,2,"(0.814836,-77.662532)"
2015,Abril,Uruguay,858,1,0,,1,"(10.445761,-75.516429)"
2015,Abril,Uruguay,858,3,3,,6,"(10.886611,-74.776708)"
2015,Abril,Uruguay,858,8,14,,22,"(3.541112,-76.384584)"
2015,Abril,Uruguay,858,82,83,,165,"(4.697144,-74.140516)"
2015,Abril,Uruguay,858,1,1,,2,"(4.815061,-75.736532)"
2015,Abril,Uruguay,858,23,30,,53,"(6.171601,-75.427454)"
2015,Abril,Uruguay,858,0,1,,1,"(7.128456,-73.183637)"
2015,Abril,Venezuela,862,5,5,,10,"(10.445761,-75.516429)"
2015,Abril,Venezuela,862,6,29,,35,"(10.886611,-74.776708)"
2015,Abril,Venezuela,862,9931,8393,,18324,"(11.360009,-72.129330)"
2015,Abril,Venezuela,862,2,24,,26,"(3.541112,-76.384584)"
2015,Abril,Venezuela,862,26,49,,75,"(3.866713,-67.927521)"
2015,Abril,Venezuela,862,1036,1403,,2439,"(4.697144,-74.140516)"
2015,Abril,Venezuela,862,2,9,,11,"(4.815061,-75.736532)"
2015,Abril,Venezuela,862,30,26,,56,"(6.171601,-75.427454)"
2015,Abril,Venezuela,862,136,161,,297,"(6.185799,-67.483929)"
2015,Abril,Venezuela,862,1997,1760,,3757,"(7.088729,-70.740253)"
2015,Abril,Venezuela,862,5,9,,14,"(7.128456,-73.183637)"
2015,Abril,Venezuela,862,6163,5905,,12068,"(7.818934,-72.453226)"
2015,Abril,Venezuela,862,0,3,,3,"(7.927209,-72.507910)"
2015,Abril,Vietnam,704,0,1,,1,"(10.445761,-75.516429)"
2015,Abril,Vietnam,704,2,2,,4,"(4.697144,-74.140516)"
2015,Abril,Islas Vírgenes Estadounidenses/Territorio de Estados Unidos,850,1,0,,1,"(3.541112,-76.384584)"
2015,Abril,Zambia,894,1,0,,1,"(4.697144,-74.140516)"
2015,Abril,Islas Turcas y Caicos/Territorio Británico de Ultramar,796,2,3,,5,"(4.697144,-74.140516)"
2015,Abril,Desconocido,99999,1,2,,3,"(0.812436,-77.847006)"
2015,Abril,Desconocido,99999,251,494,,745,"(4.697144,-74.140516)"
2015,Abril,Desconocido,99999,25,22,,47,"(6.185799,-67.483929)"
2015,Mayo,Afganistán,4,0,1,,1,"(0.814836,-77.662532)"
2015,Mayo,Afganistán,4,0,1,,1,"(3.541112,-76.384584)"
2015,Mayo,Afganistán,4,1,6,,7,"(4.697144,-74.140516)"
2015,Mayo,Albania,8,0,1,,1,"(3.541112,-76.384584)"
2015,Mayo,Alemania,276,1,0,,1,"(10.445761,-75.516429)"
2015,Mayo,Alemania,276,37,20,,57,"(3.541112,-76.384584)"
2015,Mayo,Alemania,276,1379,1263,,2642,"(4.697144,-74.140516)"
2015,Mayo,Alemania,276,25,17,,42,"(6.171601,-75.427454)"
2015,Mayo,Andorra,20,0,1,,1,"(3.541112,-76.384584)"
2015,Mayo,Andorra,20,2,1,,3,"(4.697144,-74.140516)"
2015,Mayo,Angola,24,0,17,,17,"(4.697144,-74.140516)"
2015,Mayo,Antigua y Barbuda,28,3,1,,4,"(4.697144,-74.140516)"
2015,Mayo,Países Bajos,528,0,5,,5,"(10.445761,-75.516429)"
2015,Mayo,Países Bajos,528,81,35,,116,"(10.886611,-74.776708)"
2015,Mayo,Países Bajos,528,0,1,,1,"(12.586067,-81.702563)"
2015,Mayo,Países Bajos,528,204,113,,317,"(3.541112,-76.384584)"
2015,Mayo,Países Bajos,528,703,594,,1297,"(4.697144,-74.140516)"
2015,Mayo,Países Bajos,528,0,2,,2,"(4.815061,-75.736532)"
2015,Mayo,Países Bajos,528,118,61,,179,"(6.171601,-75.427454)"
2015,Mayo,Países Bajos,528,3,0,,3,"(7.128456,-73.183637)"
2015,Mayo,Países Bajos,528,0,1,,1,"(7.927209,-72.507910)"
2015,Mayo,Arabia Saudita,682,6,34,,40,"(4.697144,-74.140516)"
2015,Mayo,Arabia Saudita,682,0,1,,1,"(6.171601,-75.427454)"
2015,Mayo,Argelia,12,4,6,,10,"(4.697144,-74.140516)"
2015,Mayo,Argentina,32,13,23,,36,"(0.814836,-77.662532)"
2015,Mayo,Argentina,32,5,2,,7,"(10.445761,-75.516429)"
2015,Mayo,Argentina,32,15,12,,27,"(10.886611,-74.776708)"
2015,Mayo,Argentina,32,1,1,,2,"(12.586067,-81.702563)"
2015,Mayo,Argentina,32,143,128,,271,"(3.541112,-76.384584)"
2015,Mayo,Argentina,32,2014,2219,,4233,"(4.697144,-74.140516)"
2015,Mayo,Argentina,32,4,10,,14,"(4.815061,-75.736532)"
2015,Mayo,Argentina,32,112,136,,248,"(6.171601,-75.427454)"
2015,Mayo,Argentina,32,0,2,,2,"(7.128456,-73.183637)"
2015,Mayo,Argentina,32,0,1,,1,"(7.927209,-72.507910)"
2015,Mayo,República de Armenia,51,0,1,,1,"(4.697144,-74.140516)"
2015,Mayo,Aruba,533,1281,815,,2096,"(10.408582,-75.538003)"
2015,Mayo,Aruba,533,14,9,,23,"(10.886611,-74.776708)"
2015,Mayo,Aruba,533,29,10,,39,"(3.541112,-76.384584)"
2015,Mayo,Aruba,533,1413,1092,,2505,"(4.697144,-74.140516)"
2015,Mayo,Aruba,533,8,4,,12,"(4.815061,-75.736532)"
2015,Mayo,Aruba,533,42,32,,74,"(6.171601,-75.427454)"
2015,Mayo,Aruba,533,13,28,,41,"(7.128456,-73.183637)"
2015,Mayo,Aruba,533,0,1,,1,"(7.927209,-72.507910)"
2015,Mayo,Australia,36,4,0,,4,"(10.886611,-74.776708)"
2015,Mayo,Australia,36,5,7,,12,"(3.541112,-76.384584)"
2015,Mayo,Australia,36,160,143,,303,"(4.697144,-74.140516)"
2015,Mayo,Australia,36,1,0,,1,"(4.815061,-75.736532)"
2015,Mayo,Australia,36,28,11,,39,"(6.171601,-75.427454)"
2015,Mayo,Australia,36,0,1,,1,"(7.128456,-73.183637)"
2015,Mayo,Austria,40,0,2,,2,"(10.445761,-75.516429)"
2015,Mayo,Austria,40,0,2,,2,"(3.541112,-76.384584)"
2015,Mayo,Austria,40,30,41,,71,"(4.697144,-74.140516)"
2015,Mayo,Austria,40,0,1,,1,"(6.171601,-75.427454)"
2015,Mayo,Azerbaiyán,31,1,0,,1,"(3.541112,-76.384584)"
2015,Mayo,Azerbaiyán,31,2,1,,3,"(4.697144,-74.140516)"
2015,Mayo,Bahamas,44,0,2,,2,"(10.445761,-75.516429)"
2015,Mayo,Bahamas,44,2,0,,2,"(10.886611,-74.776708)"
2015,Mayo,Bahamas,44,12,3,,15,"(3.541112,-76.384584)"
2015,Mayo,Bahamas,44,14,22,,36,"(4.697144,-74.140516)"
2015,Mayo,Bahamas,44,14,13,,27,"(6.171601,-75.427454)"
2015,Mayo,Bahamas,44,1,0,,1,"(7.128456,-73.183637)"
2015,Mayo,Bahamas,44,1,0,,1,"(7.927209,-72.507910)"
2015,Mayo,Bahréin,48,0,1,,1,"(3.541112,-76.384584)"
2015,Mayo,Bahréin,48,0,1,,1,"(4.697144,-74.140516)"
2015,Mayo,Bangladesh,50,0,1,,1,"(4.697144,-74.140516)"
2015,Mayo,Barbados,52,2,1,,3,"(3.541112,-76.384584)"
2015,Mayo,Barbados,52,0,7,,7,"(4.697144,-74.140516)"
2015,Mayo,República de Belarús,112,1,0,,1,"(11.360009,-72.129330)"
2015,Mayo,República de Belarús,112,0,1,,1,"(4.697144,-74.140516)"
2015,Mayo,Bélgica,56,10,7,,17,"(3.541112,-76.384584)"
2015,Mayo,Bélgica,56,73,54,,127,"(4.697144,-74.140516)"
2015,Mayo,Bélgica,56,7,7,,14,"(6.171601,-75.427454)"
2015,Mayo,Belice,84,0,3,,3,"(3.541112,-76.384584)"
2015,Mayo,Belice,84,4,4,,8,"(4.697144,-74.140516)"
2015,Mayo,Belice,84,2,2,,4,"(6.171601,-75.427454)"
2015,Mayo,Benín,204,0,1,,1,"(4.697144,-74.140516)"
2015,Mayo,Bermudas/Territorio Británico de Ultramar,60,1,0,,1,"(3.541112,-76.384584)"
2015,Mayo,Bermudas/Territorio Británico de Ultramar,60,0,1,,1,"(4.697144,-74.140516)"
2015,Mayo,Bermudas/Territorio Británico de Ultramar,60,0,1,,1,"(6.171601,-75.427454)"
2015,Mayo,Bolivia,68,2,7,,9,"(0.814836,-77.662532)"
2015,Mayo,Bolivia,68,2,1,,3,"(10.886611,-74.776708)"
2015,Mayo,Bolivia,68,17,46,,63,"(3.541112,-76.384584)"
2015,Mayo,Bolivia,68,255,459,,714,"(4.697144,-74.140516)"
2015,Mayo,Bolivia,68,4,1,,5,"(4.815061,-75.736532)"
2015,Mayo,Bolivia,68,25,33,,58,"(6.171601,-75.427454)"
2015,Mayo,Bolivia,68,1,0,,1,"(7.128456,-73.183637)"
2015,Mayo,Bolivia,68,0,1,,1,"(7.927209,-72.507910)"
2015,Mayo,Brasil,76,108,179,,287,"(-4.197703,-69.941278)"
2015,Mayo,Brasil,76,4,16,,20,"(-4.223468,-69.945098)"
2015,Mayo,Brasil,76,2,4,,6,"(0.814836,-77.662532)"
2015,Mayo,Brasil,76,5,6,,11,"(10.445761,-75.516429)"
2015,Mayo,Brasil,76,4,4,,8,"(10.886611,-74.776708)"
2015,Mayo,Brasil,76,1,1,,2,"(12.586067,-81.702563)"
2015,Mayo,Brasil,76,59,83,,142,"(3.541112,-76.384584)"
2015,Mayo,Brasil,76,1,0,,1,"(3.866713,-67.927521)"
2015,Mayo,Brasil,76,2528,3437,,5965,"(4.697144,-74.140516)"
2015,Mayo,Brasil,76,19,22,,41,"(4.815061,-75.736532)"
2015,Mayo,Brasil,76,75,116,,191,"(6.171601,-75.427454)"
2015,Mayo,Brasil,76,1,7,,8,"(7.128456,-73.183637)"
2015,Mayo,Brasil,76,1,2,,3,"(7.927209,-72.507910)"
2015,Mayo,Bulgaria,100,11,16,,27,"(4.697144,-74.140516)"
2015,Mayo,Burkina Faso,854,1,0,,1,"(3.541112,-76.384584)"
2015,Mayo,Islas Caimán/Territorio Británico de Ultramar,136,0,1,,1,"(10.445761,-75.516429)"
2015,Mayo,Islas Caimán/Territorio Británico de Ultramar,136,0,2,,2,"(6.171601,-75.427454)"
2015,Mayo,Camboya,116,7,3,,10,"(4.697144,-74.140516)"
2015,Mayo,Camboya,116,0,1,,1,"(6.171601,-75.427454)"
2015,Mayo,Camerún,120,0,1,,1,"(4.697144,-74.140516)"
2015,Mayo,Canadá,124,26,20,,46,"(10.445761,-75.516429)"
2015,Mayo,Canadá,124,29,16,,45,"(10.886611,-74.776708)"
2015,Mayo,Canadá,124,159,110,,269,"(3.541112,-76.384584)"
2015,Mayo,Canadá,124,3,3,,6,"(4.452882,-75.766298)"
2015,Mayo,Canadá,124,1473,1185,,2658,"(4.697144,-74.140516)"
2015,Mayo,Canadá,124,8,10,,18,"(4.815061,-75.736532)"
2015,Mayo,Canadá,124,277,229,,506,"(6.171601,-75.427454)"
2015,Mayo,Canadá,124,14,7,,21,"(7.128456,-73.183637)"
2015,Mayo,Canadá,124,6,4,,10,"(7.927209,-72.507910)"
2015,Mayo,Chad,148,0,2,,2,"(4.697144,-74.140516)"
2015,Mayo,España,724,9,6,,15,"(10.445761,-75.516429)"
2015,Mayo,España,724,3,4,,7,"(10.886611,-74.776708)"
2015,Mayo,España,724,1196,716,,1912,"(3.541112,-76.384584)"
2015,Mayo,España,724,8532,6372,,14904,"(4.697144,-74.140516)"
2015,Mayo,España,724,7,17,,24,"(4.815061,-75.736532)"
2015,Mayo,España,724,932,650,,1582,"(6.171601,-75.427454)"
2015,Mayo,España,724,9,6,,15,"(7.128456,-73.183637)"
2015,Mayo,España,724,1,2,,3,"(7.927209,-72.507910)"
2015,Mayo,Colombia,170,430,823,,1253,"(4.697144,-74.140516)"
2015,Mayo,República Del Congo,178,2,3,,5,"(4.697144,-74.140516)"
2015,Mayo,Islas Heard Y Mcdonald,334,0,1,,1,"(6.171601,-75.427454)"
2015,Mayo,República de Corea,410,0,1,,1,"(3.541112,-76.384584)"
2015,Mayo,República de Corea,410,20,45,,65,"(4.697144,-74.140516)"
2015,Mayo,República de Corea,410,0,1,,1,"(6.171601,-75.427454)"
2015,Mayo,Costa de Marfil,384,1,0,,1,"(3.541112,-76.384584)"
2015,Mayo,Costa de Marfil,384,4,3,,7,"(4.697144,-74.140516)"
2015,Mayo,Costa de Marfil,384,0,1,,1,"(6.171601,-75.427454)"
2015,Mayo,Costa Rica,188,5,6,,11,"(10.445761,-75.516429)"
2015,Mayo,Costa Rica,188,9,17,,26,"(10.886611,-74.776708)"
2015,Mayo,Costa Rica,188,5,44,,49,"(12.5744111,-81.703935)"
2015,Mayo,Costa Rica,188,2,0,,2,"(12.586067,-81.702563)"
2015,Mayo,Costa Rica,188,52,54,,106,"(3.541112,-76.384584)"
2015,Mayo,Costa Rica,188,697,888,,1585,"(4.697144,-74.140516)"
2015,Mayo,Costa Rica,188,11,11,,22,"(4.815061,-75.736532)"
2015,Mayo,Costa Rica,188,129,129,,258,"(6.171601,-75.427454)"
2015,Mayo,Costa Rica,188,3,3,,6,"(7.128456,-73.183637)"
2015,Mayo,Costa Rica,188,1,3,,4,"(7.927209,-72.507910)"
2015,Mayo,Croacia,191,1,2,,3,"(4.697144,-74.140516)"
2015,Mayo,Cuba,192,17,13,,30,"(10.445761,-75.516429)"
2015,Mayo,Cuba,192,11,9,,20,"(10.886611,-74.776708)"
2015,Mayo,Cuba,192,2,2,,4,"(12.586067,-81.702563)"
2015,Mayo,Cuba,192,78,74,,152,"(3.541112,-76.384584)"
2015,Mayo,Cuba,192,888,842,,1730,"(4.697144,-74.140516)"
2015,Mayo,Cuba,192,19,8,,27,"(4.815061,-75.736532)"
2015,Mayo,Cuba,192,154,134,,288,"(6.171601,-75.427454)"
2015,Mayo,Cuba,192,12,12,,24,"(7.128456,-73.183637)"
2015,Mayo,Cuba,192,1,1,,2,"(7.927209,-72.507910)"
2015,Mayo,República Checa,203,0,1,,1,"(3.541112,-76.384584)"
2015,Mayo,República Checa,203,11,16,,27,"(4.697144,-74.140516)"
2015,Mayo,República Checa,203,1,1,,2,"(6.171601,-75.427454)"
2015,Mayo,Chile,152,151,176,,327,"(0.814836,-77.662532)"
2015,Mayo,Chile,152,8,7,,15,"(10.445761,-75.516429)"
2015,Mayo,Chile,152,2,2,,4,"(10.886611,-74.776708)"
2015,Mayo,Chile,152,0,2,,2,"(12.586067,-81.702563)"
2015,Mayo,Chile,152,254,222,,476,"(3.541112,-76.384584)"
2015,Mayo,Chile,152,2683,2682,,5365,"(4.697144,-74.140516)"
2015,Mayo,Chile,152,26,20,,46,"(4.815061,-75.736532)"
2015,Mayo,Chile,152,71,73,,144,"(6.171601,-75.427454)"
2015,Mayo,Chile,152,2,3,,5,"(7.128456,-73.183637)"
2015,Mayo,Chile,152,2,1,,3,"(7.927209,-72.507910)"
2015,Mayo,China,156,0,1,,1,"(10.886611,-74.776708)"
2015,Mayo,China,156,13,62,,75,"(3.541112,-76.384584)"
2015,Mayo,China,156,271,511,,782,"(4.697144,-74.140516)"
2015,Mayo,China,156,7,33,,40,"(6.171601,-75.427454)"
2015,Mayo,China,156,3,3,,6,"(7.128456,-73.183637)"
2015,Mayo,Chipre,196,1,0,,1,"(4.697144,-74.140516)"
2015,Mayo,Dinamarca,208,2,1,,3,"(3.541112,-76.384584)"
2015,Mayo,Dinamarca,208,35,36,,71,"(4.697144,-74.140516)"
2015,Mayo,Ecuador,218,476,731,,1207,"(0.25129,-76.875963)"
2015,Mayo,Ecuador,218,21,21,,42,"(0.812436,-77.847006)"
2015,Mayo,Ecuador,218,5249,6732,,11981,"(0.814836,-77.662532)"
2015,Mayo,Ecuador,218,141,150,,291,"(1.813928,-78.763924)"
2015,Mayo,Ecuador,218,0,1,,1,"(10.408582,-75.538003)"
2015,Mayo,Ecuador,218,11,16,,27,"(10.445761,-75.516429)"
2015,Mayo,Ecuador,218,2,8,,10,"(10.886611,-74.776708)"
2015,Mayo,Ecuador,218,0,1,,1,"(12.586067,-81.702563)"
2015,Mayo,Ecuador,218,281,372,,653,"(3.541112,-76.384584)"
2015,Mayo,Ecuador,218,0,4,,4,"(3.893038,-77.067921)"
2015,Mayo,Ecuador,218,2477,4021,,6498,"(4.697144,-74.140516)"
2015,Mayo,Ecuador,218,4,3,,7,"(4.815061,-75.736532)"
2015,Mayo,Ecuador,218,48,68,,116,"(6.171601,-75.427454)"
2015,Mayo,Ecuador,218,8,4,,12,"(7.128456,-73.183637)"
2015,Mayo,Egipto,818,24,23,,47,"(4.697144,-74.140516)"
2015,Mayo,Egipto,818,1,1,,2,"(6.171601,-75.427454)"
2015,Mayo,El Salvador,222,4,1,,5,"(10.445761,-75.516429)"
2015,Mayo,El Salvador,222,1,2,,3,"(10.886611,-74.776708)"
2015,Mayo,El Salvador,222,57,52,,109,"(3.541112,-76.384584)"
2015,Mayo,El Salvador,222,589,844,,1433,"(4.697144,-74.140516)"
2015,Mayo,El Salvador,222,1,1,,2,"(4.815061,-75.736532)"
2015,Mayo,El Salvador,222,49,89,,138,"(6.171601,-75.427454)"
2015,Mayo,Emiratos Árabes,784,1,0,,1,"(10.445761,-75.516429)"
2015,Mayo,Emiratos Árabes,784,2,2,,4,"(3.541112,-76.384584)"
2015,Mayo,Emiratos Árabes,784,112,231,,343,"(4.697144,-74.140516)"
2015,Mayo,Emiratos Árabes,784,2,3,,5,"(6.171601,-75.427454)"
2015,Mayo,Eritrea,232,2,0,,2,"(4.697144,-74.140516)"
2015,Mayo,Eslovaquia,703,0,1,,1,"(3.541112,-76.384584)"
2015,Mayo,Eslovenia,705,0,1,,1,"(4.697144,-74.140516)"
2015,Mayo,Estados Unidos de América,840,0,4,,4,"(10.408582,-75.538003)"
2015,Mayo,Estados Unidos de América,840,0,2,,2,"(10.433609,-73.247863)"
2015,Mayo,Estados Unidos de América,840,3569,2779,,6348,"(10.445761,-75.516429)"
2015,Mayo,Estados Unidos de América,840,1751,1400,,3151,"(10.886611,-74.776708)"
2015,Mayo,Estados Unidos de América,840,1,8,,9,"(11.117806,-74.232622)"
2015,Mayo,Estados Unidos de América,840,23,24,,47,"(12.586067,-81.702563)"
2015,Mayo,Estados Unidos de América,840,5694,3811,,9505,"(3.541112,-76.384584)"
2015,Mayo,Estados Unidos de América,840,677,467,,1144,"(4.452882,-75.766298)"
2015,Mayo,Estados Unidos de América,840,31070,27399,,58469,"(4.697144,-74.140516)"
2015,Mayo,Estados Unidos de América,840,1073,749,,1822,"(4.815061,-75.736532)"
2015,Mayo,Estados Unidos de América,840,9388,7222,,16610,"(6.171601,-75.427454)"
2015,Mayo,Estados Unidos de América,840,217,151,,368,"(7.128456,-73.183637)"
2015,Mayo,Estados Unidos de América,840,88,69,,157,"(7.927209,-72.507910)"
2015,Mayo,Estonia,233,0,2,,2,"(4.697144,-74.140516)"
2015,Mayo,Etiopia,231,1,0,,1,"(3.541112,-76.384584)"
2015,Mayo,Etiopia,231,1,4,,5,"(4.697144,-74.140516)"
2015,Mayo,Filipinas,608,1,0,,1,"(3.541112,-76.384584)"
2015,Mayo,Filipinas,608,4,5,,9,"(4.697144,-74.140516)"
2015,Mayo,Finlandia,246,6,4,,10,"(4.697144,-74.140516)"
2015,Mayo,Francia,250,42,24,,66,"(3.541112,-76.384584)"
2015,Mayo,Francia,250,1387,1121,,2508,"(4.697144,-74.140516)"
2015,Mayo,Francia,250,21,14,,35,"(6.171601,-75.427454)"
2015,Mayo,Gabón,266,0,6,,6,"(4.697144,-74.140516)"
2015,Mayo,Gambia,270,0,1,,1,"(4.697144,-74.140516)"
2015,Mayo,Ghana,288,0,1,,1,"(3.541112,-76.384584)"
2015,Mayo,Ghana,288,0,1,,1,"(4.697144,-74.140516)"
2015,Mayo,Gibraltar/Territorio Británico de Ultramar,292,1,0,,1,"(0.814836,-77.662532)"
2015,Mayo,Grecia,300,0,1,,1,"(3.541112,-76.384584)"
2015,Mayo,Grecia,300,24,13,,37,"(4.697144,-74.140516)"
2015,Mayo,Guatemala,320,5,2,,7,"(10.445761,-75.516429)"
2015,Mayo,Guatemala,320,7,6,,13,"(10.886611,-74.776708)"
2015,Mayo,Guatemala,320,0,1,,1,"(12.586067,-81.702563)"
2015,Mayo,Guatemala,320,77,97,,174,"(3.541112,-76.384584)"
2015,Mayo,Guatemala,320,439,630,,1069,"(4.697144,-74.140516)"
2015,Mayo,Guatemala,320,2,7,,9,"(4.815061,-75.736532)"
2015,Mayo,Guatemala,320,86,106,,192,"(6.171601,-75.427454)"
2015,Mayo,Guatemala,320,2,2,,4,"(7.128456,-73.183637)"
2015,Mayo,Guatemala,320,3,5,,8,"(7.927209,-72.507910)"
2015,Mayo,Guyana,328,0,1,,1,"(10.886611,-74.776708)"
2015,Mayo,Guyana,328,3,0,,3,"(3.541112,-76.384584)"
2015,Mayo,Guyana,328,0,2,,2,"(4.697144,-74.140516)"
2015,Mayo,Guinea,324,1,2,,3,"(4.697144,-74.140516)"
2015,Mayo,Guinea Ecuatorial,226,5,12,,17,"(4.697144,-74.140516)"
2015,Mayo,Guinea Bissau,624,0,1,,1,"(4.697144,-74.140516)"
2015,Mayo,Guadalupe/Territorio Francés,312,3,1,,4,"(4.697144,-74.140516)"
2015,Mayo,Guayana Francesa/Departamento de Ultramar Francés,254,1,1,,2,"(4.697144,-74.140516)"
2015,Mayo,Haití,332,1,0,,1,"(10.445761,-75.516429)"
2015,Mayo,Haití,332,0,1,,1,"(10.886611,-74.776708)"
2015,Mayo,Haití,332,1,0,,1,"(3.541112,-76.384584)"
2015,Mayo,Haití,332,3,14,,17,"(4.697144,-74.140516)"
2015,Mayo,Haití,332,4,9,,13,"(6.171601,-75.427454)"
2015,Mayo,Honduras,340,0,8,,8,"(10.445761,-75.516429)"
2015,Mayo,Honduras,340,4,10,,14,"(10.886611,-74.776708)"
2015,Mayo,Honduras,340,2,22,,24,"(3.541112,-76.384584)"
2015,Mayo,Honduras,340,71,174,,245,"(4.697144,-74.140516)"
2015,Mayo,Honduras,340,2,5,,7,"(4.815061,-75.736532)"
2015,Mayo,Honduras,340,24,46,,70,"(6.171601,-75.427454)"
2015,Mayo,Honduras,340,2,3,,5,"(7.128456,-73.183637)"
2015,Mayo,Honduras,340,0,2,,2,"(7.927209,-72.507910)"
2015,Mayo,Hong Kong,344,0,1,,1,"(3.541112,-76.384584)"
2015,Mayo,Hong Kong,344,24,47,,71,"(4.697144,-74.140516)"
2015,Mayo,Hong Kong,344,2,4,,6,"(6.171601,-75.427454)"
2015,Mayo,Hungría,348,2,6,,8,"(4.697144,-74.140516)"
2015,Mayo,Hungría,348,0,1,,1,"(6.171601,-75.427454)"
2015,Mayo,India,356,15,28,,43,"(4.697144,-74.140516)"
2015,Mayo,India,356,3,0,,3,"(6.171601,-75.427454)"
2015,Mayo,Indonesia,360,11,12,,23,"(4.697144,-74.140516)"
2015,Mayo,Iraq,368,2,11,,13,"(4.697144,-74.140516)"
2015,Mayo,Irán,364,4,3,,7,"(4.697144,-74.140516)"
2015,Mayo,República de Irlanda,372,2,0,,2,"(3.541112,-76.384584)"
2015,Mayo,República de Irlanda,372,16,8,,24,"(4.697144,-74.140516)"
2015,Mayo,Islandia,352,3,0,,3,"(4.697144,-74.140516)"
2015,Mayo,Israel,376,11,7,,18,"(3.541112,-76.384584)"
2015,Mayo,Israel,376,139,97,,236,"(4.697144,-74.140516)"
2015,Mayo,Israel,376,3,2,,5,"(6.171601,-75.427454)"
2015,Mayo,Italia,380,3,1,,4,"(10.445761,-75.516429)"
2015,Mayo,Italia,380,2,0,,2,"(10.886611,-74.776708)"
2015,Mayo,Italia,380,103,43,,146,"(3.541112,-76.384584)"
2015,Mayo,Italia,380,527,420,,947,"(4.697144,-74.140516)"
2015,Mayo,Italia,380,1,0,,1,"(4.815061,-75.736532)"
2015,Mayo,Italia,380,39,16,,55,"(6.171601,-75.427454)"
2015,Mayo,Jamaica,388,2,1,,3,"(10.445761,-75.516429)"
2015,Mayo,Jamaica,388,1,4,,5,"(10.886611,-74.776708)"
2015,Mayo,Jamaica,388,2,2,,4,"(12.586067,-81.702563)"
2015,Mayo,Jamaica,388,3,6,,9,"(3.541112,-76.384584)"
2015,Mayo,Jamaica,388,24,29,,53,"(4.697144,-74.140516)"
2015,Mayo,Jamaica,388,1,0,,1,"(4.815061,-75.736532)"
2015,Mayo,Jamaica,388,11,7,,18,"(6.171601,-75.427454)"
2015,Mayo,Jamaica,388,8,8,,16,"(7.128456,-73.183637)"
2015,Mayo,Jamaica,388,0,1,,1,"(7.927209,-72.507910)"
2015,Mayo,Japón,392,3,2,,5,"(3.541112,-76.384584)"
2015,Mayo,Japón,392,54,58,,112,"(4.697144,-74.140516)"
2015,Mayo,Japón,392,0,2,,2,"(6.171601,-75.427454)"
2015,Mayo,Jordania,400,1,1,,2,"(4.697144,-74.140516)"
2015,Mayo,Kazajistán,398,0,1,,1,"(3.541112,-76.384584)"
2015,Mayo,Kazajistán,398,0,3,,3,"(4.697144,-74.140516)"
2015,Mayo,Kenia,404,5,6,,11,"(4.697144,-74.140516)"
2015,Mayo,Kuwait,414,4,3,,7,"(4.697144,-74.140516)"
2015,Mayo,República Democrática Popular  Lao,418,1,0,,1,"(4.697144,-74.140516)"
2015,Mayo,Letonia,428,0,2,,2,"(4.697144,-74.140516)"
2015,Mayo,Lituania,440,0,5,,5,"(4.697144,-74.140516)"
2015,Mayo,Líbano,422,37,40,,77,"(4.697144,-74.140516)"
2015,Mayo,Liberia,430,0,1,,1,"(6.171601,-75.427454)"
2015,Mayo,Luxemburgo,442,3,1,,4,"(4.697144,-74.140516)"
2015,Mayo,Macao,446,2,1,,3,"(4.697144,-74.140516)"
2015,Mayo,Madagascar,450,1,0,,1,"(6.171601,-75.427454)"
2015,Mayo,Malasia,458,9,18,,27,"(4.697144,-74.140516)"
2015,Mayo,Malasia,458,1,2,,3,"(6.171601,-75.427454)"
2015,Mayo,Malawi,454,0,1,,1,"(6.171601,-75.427454)"
2015,Mayo,Malta,470,8,7,,15,"(4.697144,-74.140516)"
2015,Mayo,Marruecos,504,40,46,,86,"(4.697144,-74.140516)"
2015,Mayo,Marruecos,504,2,1,,3,"(6.171601,-75.427454)"
2015,Mayo,Mauricio,480,0,1,,1,"(4.697144,-74.140516)"
2015,Mayo,México,484,0,1,,1,"(10.408582,-75.538003)"
2015,Mayo,México,484,27,27,,54,"(10.445761,-75.516429)"
2015,Mayo,México,484,64,69,,133,"(10.886611,-74.776708)"
2015,Mayo,México,484,0,2,,2,"(12.586067,-81.702563)"
2015,Mayo,México,484,593,448,,1041,"(3.541112,-76.384584)"
2015,Mayo,México,484,11424,10200,,21624,"(4.697144,-74.140516)"
2015,Mayo,México,484,149,132,,281,"(4.815061,-75.736532)"
2015,Mayo,México,484,1694,1284,,2978,"(6.171601,-75.427454)"
2015,Mayo,México,484,139,110,,249,"(7.128456,-73.183637)"
2015,Mayo,México,484,37,31,,68,"(7.927209,-72.507910)"
2015,Mayo,Mónaco,492,3,4,,7,"(4.697144,-74.140516)"
2015,Mayo,Nauru,520,0,1,,1,"(4.697144,-74.140516)"
2015,Mayo,Nepal,524,0,3,,3,"(4.697144,-74.140516)"
2015,Mayo,Nicaragua,558,0,4,,4,"(10.445761,-75.516429)"
2015,Mayo,Nicaragua,558,3,6,,9,"(10.886611,-74.776708)"
2015,Mayo,Nicaragua,558,0,2,,2,"(12.5744111,-81.703935)"
2015,Mayo,Nicaragua,558,0,5,,5,"(12.586067,-81.702563)"
2015,Mayo,Nicaragua,558,19,31,,50,"(3.541112,-76.384584)"
2015,Mayo,Nicaragua,558,36,64,,100,"(4.697144,-74.140516)"
2015,Mayo,Nicaragua,558,2,4,,6,"(4.815061,-75.736532)"
2015,Mayo,Nicaragua,558,12,39,,51,"(6.171601,-75.427454)"
2015,Mayo,Nicaragua,558,1,2,,3,"(7.128456,-73.183637)"
2015,Mayo,Nigeria,566,6,10,,16,"(4.697144,-74.140516)"
2015,Mayo,Níger,562,0,1,,1,"(4.697144,-74.140516)"
2015,Mayo,Noruega,578,3,0,,3,"(10.445761,-75.516429)"
2015,Mayo,Noruega,578,0,1,,1,"(10.886611,-74.776708)"
2015,Mayo,Noruega,578,2,2,,4,"(3.541112,-76.384584)"
2015,Mayo,Noruega,578,18,18,,36,"(4.697144,-74.140516)"
2015,Mayo,Noruega,578,3,1,,4,"(6.171601,-75.427454)"
2015,Mayo,Nueva Caledonia/Territorio francés,540,0,1,,1,"(4.697144,-74.140516)"
2015,Mayo,Nueva Zelanda,554,0,1,,1,"(3.541112,-76.384584)"
2015,Mayo,Nueva Zelanda,554,16,28,,44,"(4.697144,-74.140516)"
2015,Mayo,Nueva Zelanda,554,1,1,,2,"(6.171601,-75.427454)"
2015,Mayo,Omán,512,1,4,,5,"(4.697144,-74.140516)"
2015,Mayo,Panamá,591,373,340,,713,"(10.408582,-75.538003)"
2015,Mayo,Panamá,591,311,309,,620,"(10.445761,-75.516429)"
2015,Mayo,Panamá,591,552,620,,1172,"(10.886611,-74.776708)"
2015,Mayo,Panamá,591,0,2,,2,"(10.971302,-74.765397)"
2015,Mayo,Panamá,591,0,3,,3,"(11.247723,-74.213989)"
2015,Mayo,Panamá,591,2,4,,6,"(12.5744111,-81.703935)"
2015,Mayo,Panamá,591,147,157,,304,"(12.586067,-81.702563)"
2015,Mayo,Panamá,591,2003,1677,,3680,"(3.541112,-76.384584)"
2015,Mayo,Panamá,591,1,9,,10,"(3.893038,-77.067921)"
2015,Mayo,Panamá,591,7313,7866,,15179,"(4.697144,-74.140516)"
2015,Mayo,Panamá,591,540,408,,948,"(4.815061,-75.736532)"
2015,Mayo,Panamá,591,2973,2917,,5890,"(6.171601,-75.427454)"
2015,Mayo,Panamá,591,0,13,,13,"(6.228046,-77.404104)"
2015,Mayo,Panamá,591,5,14,,19,"(7.102626,-77.762647)"
2015,Mayo,Panamá,591,241,228,,469,"(7.128456,-73.183637)"
2015,Mayo,Panamá,591,177,163,,340,"(7.927209,-72.507910)"
2015,Mayo,Panamá,591,0,52,,52,"(8.066966,-76.735404)"
2015,Mayo,Panamá,591,54,108,,162,"(8.635765,-77.346578)"
2015,Mayo,Paraguay,600,1,1,,2,"(10.445761,-75.516429)"
2015,Mayo,Paraguay,600,8,11,,19,"(3.541112,-76.384584)"
2015,Mayo,Paraguay,600,54,121,,175,"(4.697144,-74.140516)"
2015,Mayo,Paraguay,600,5,8,,13,"(6.171601,-75.427454)"
2015,Mayo,Paraguay,600,1,1,,2,"(7.927209,-72.507910)"
2015,Mayo,Perú,604,86,117,,203,"(-4.197703,-69.941278)"
2015,Mayo,Perú,604,1,3,,4,"(-4.223468,-69.945098)"
2015,Mayo,Perú,604,36,73,,109,"(0.814836,-77.662532)"
2015,Mayo,Perú,604,2,7,,9,"(10.445761,-75.516429)"
2015,Mayo,Perú,604,9,12,,21,"(10.886611,-74.776708)"
2015,Mayo,Perú,604,2,1,,3,"(12.586067,-81.702563)"
2015,Mayo,Perú,604,225,309,,534,"(3.541112,-76.384584)"
2015,Mayo,Perú,604,3954,4727,,8681,"(4.697144,-74.140516)"
2015,Mayo,Perú,604,8,7,,15,"(4.815061,-75.736532)"
2015,Mayo,Perú,604,362,450,,812,"(6.171601,-75.427454)"
2015,Mayo,Perú,604,1,1,,2,"(7.128456,-73.183637)"
2015,Mayo,Perú,604,0,1,,1,"(7.927209,-72.507910)"
2015,Mayo,Palestina,99999,1,0,,1,"(4.697144,-74.140516)"
2015,Mayo,Polonia,616,0,2,,2,"(3.541112,-76.384584)"
2015,Mayo,Polonia,616,11,16,,27,"(4.697144,-74.140516)"
2015,Mayo,Portugal,620,1,0,,1,"(10.445761,-75.516429)"
2015,Mayo,Portugal,620,6,3,,9,"(3.541112,-76.384584)"
2015,Mayo,Portugal,620,159,124,,283,"(4.697144,-74.140516)"
2015,Mayo,Portugal,620,4,1,,5,"(6.171601,-75.427454)"
2015,Mayo,Puerto Rico/Territorio de Estados Unidos,630,6,3,,9,"(10.445761,-75.516429)"
2015,Mayo,Puerto Rico/Territorio de Estados Unidos,630,16,7,,23,"(10.886611,-74.776708)"
2015,Mayo,Puerto Rico/Territorio de Estados Unidos,630,52,35,,87,"(3.541112,-76.384584)"
2015,Mayo,Puerto Rico/Territorio de Estados Unidos,630,607,575,,1182,"(4.697144,-74.140516)"
2015,Mayo,Puerto Rico/Territorio de Estados Unidos,630,11,6,,17,"(4.815061,-75.736532)"
2015,Mayo,Puerto Rico/Territorio de Estados Unidos,630,68,56,,124,"(6.171601,-75.427454)"
2015,Mayo,Puerto Rico/Territorio de Estados Unidos,630,1,1,,2,"(7.128456,-73.183637)"
2015,Mayo,Qatar,634,1,1,,2,"(4.697144,-74.140516)"
2015,Mayo,Qatar,634,1,0,,1,"(6.171601,-75.427454)"
2015,Mayo,Reino Unido de Gran Bretaña e Irlanda del Norte,826,1,0,,1,"(10.445761,-75.516429)"
2015,Mayo,Reino Unido de Gran Bretaña e Irlanda del Norte,826,19,19,,38,"(3.541112,-76.384584)"
2015,Mayo,Reino Unido de Gran Bretaña e Irlanda del Norte,826,1395,1168,,2563,"(4.697144,-74.140516)"
2015,Mayo,Reino Unido de Gran Bretaña e Irlanda del Norte,826,6,1,,7,"(6.171601,-75.427454)"
2015,Mayo,República CentroÁfricana,140,3,1,,4,"(4.697144,-74.140516)"
2015,Mayo,Federación de Rusia,643,1,3,,4,"(3.541112,-76.384584)"
2015,Mayo,Federación de Rusia,643,43,62,,105,"(4.697144,-74.140516)"
2015,Mayo,República Dominicana,214,7,7,,14,"(10.445761,-75.516429)"
2015,Mayo,República Dominicana,214,21,34,,55,"(10.886611,-74.776708)"
2015,Mayo,República Dominicana,214,83,59,,142,"(3.541112,-76.384584)"
2015,Mayo,República Dominicana,214,1883,1794,,3677,"(4.697144,-74.140516)"
2015,Mayo,República Dominicana,214,13,7,,20,"(4.815061,-75.736532)"
2015,Mayo,República Dominicana,214,138,127,,265,"(6.171601,-75.427454)"
2015,Mayo,República Dominicana,214,19,14,,33,"(7.128456,-73.183637)"
2015,Mayo,República Dominicana,214,5,5,,10,"(7.927209,-72.507910)"
2015,Mayo,República Democrática Popular de Corea,408,2,2,,4,"(4.697144,-74.140516)"
2015,Mayo,Rumania,642,1,0,,1,"(3.541112,-76.384584)"
2015,Mayo,Rumania,642,4,3,,7,"(4.697144,-74.140516)"
2015,Mayo,Samoa Estadounidense/Territorio no incorporado de Estados Unidos,16,0,1,,1,"(6.171601,-75.427454)"
2015,Mayo,San Marino,674,2,0,,2,"(4.697144,-74.140516)"
2015,Mayo,Santa Lucia,662,4,3,,7,"(4.697144,-74.140516)"
2015,Mayo,Santa Lucia,662,0,1,,1,"(6.171601,-75.427454)"
2015,Mayo,Senegal,686,2,2,,4,"(4.697144,-74.140516)"
2015,Mayo,Singapur,702,1,0,,1,"(3.541112,-76.384584)"
2015,Mayo,Singapur,702,4,13,,17,"(4.697144,-74.140516)"
2015,Mayo,Sri Lanka,144,1,1,,2,"(4.697144,-74.140516)"
2015,Mayo,Sudáfrica,710,0,1,,1,"(3.541112,-76.384584)"
2015,Mayo,Sudáfrica,710,11,9,,20,"(4.697144,-74.140516)"
2015,Mayo,Sudán,736,1,0,,1,"(4.697144,-74.140516)"
2015,Mayo,Suecia,752,5,4,,9,"(3.541112,-76.384584)"
2015,Mayo,Suecia,752,79,64,,143,"(4.697144,-74.140516)"
2015,Mayo,Suecia,752,3,1,,4,"(6.171601,-75.427454)"
2015,Mayo,Suecia,752,0,1,,1,"(7.128456,-73.183637)"
2015,Mayo,Suiza,756,30,12,,42,"(3.541112,-76.384584)"
2015,Mayo,Suiza,756,236,199,,435,"(4.697144,-74.140516)"
2015,Mayo,Suiza,756,14,6,,20,"(6.171601,-75.427454)"
2015,Mayo,Surinam,740,0,2,,2,"(10.886611,-74.776708)"
2015,Mayo,Surinam,740,0,11,,11,"(4.697144,-74.140516)"
2015,Mayo,Surinam,740,1,2,,3,"(6.171601,-75.427454)"
2015,Mayo,Taiwán,158,1,0,,1,"(10.445761,-75.516429)"
2015,Mayo,Taiwán,158,1,2,,3,"(3.541112,-76.384584)"
2015,Mayo,Taiwán,158,6,8,,14,"(4.697144,-74.140516)"
2015,Mayo,Tailandia,764,23,23,,46,"(4.697144,-74.140516)"
2015,Mayo,Tailandia,764,2,0,,2,"(6.171601,-75.427454)"
2015,Mayo,Tanzania,834,0,3,,3,"(4.697144,-74.140516)"
2015,Mayo,Trinidad y Tobago,780,2,7,,9,"(10.445761,-75.516429)"
2015,Mayo,Trinidad y Tobago,780,1,4,,5,"(10.886611,-74.776708)"
2015,Mayo,Trinidad y Tobago,780,0,1,,1,"(12.586067,-81.702563)"
2015,Mayo,Trinidad y Tobago,780,7,4,,11,"(3.541112,-76.384584)"
2015,Mayo,Trinidad y Tobago,780,18,24,,42,"(4.697144,-74.140516)"
2015,Mayo,Trinidad y Tobago,780,3,4,,7,"(4.815061,-75.736532)"
2015,Mayo,Trinidad y Tobago,780,11,4,,15,"(6.171601,-75.427454)"
2015,Mayo,Trinidad y Tobago,780,1,2,,3,"(7.128456,-73.183637)"
2015,Mayo,Trinidad y Tobago,780,2,3,,5,"(7.927209,-72.507910)"
2015,Mayo,Turquía,792,20,23,,43,"(3.541112,-76.384584)"
2015,Mayo,Turquía,792,120,106,,226,"(4.697144,-74.140516)"
2015,Mayo,Turquía,792,10,14,,24,"(6.171601,-75.427454)"
2015,Mayo,Turkmenistán,795,1,1,,2,"(4.697144,-74.140516)"
2015,Mayo,Ucrania,804,0,4,,4,"(4.697144,-74.140516)"
2015,Mayo,Uganda,800,0,1,,1,"(3.541112,-76.384584)"
2015,Mayo,Uruguay,858,1,1,,2,"(10.445761,-75.516429)"
2015,Mayo,Uruguay,858,1,0,,1,"(10.886611,-74.776708)"
2015,Mayo,Uruguay,858,5,11,,16,"(3.541112,-76.384584)"
2015,Mayo,Uruguay,858,63,114,,177,"(4.697144,-74.140516)"
2015,Mayo,Uruguay,858,0,1,,1,"(4.815061,-75.736532)"
2015,Mayo,Uruguay,858,18,15,,33,"(6.171601,-75.427454)"
2015,Mayo,Venezuela,862,1,3,,4,"(10.433609,-73.247863)"
2015,Mayo,Venezuela,862,5,9,,14,"(10.445761,-75.516429)"
2015,Mayo,Venezuela,862,15,21,,36,"(10.886611,-74.776708)"
2015,Mayo,Venezuela,862,9798,8429,,18227,"(11.360009,-72.129330)"
2015,Mayo,Venezuela,862,13,22,,35,"(3.541112,-76.384584)"
2015,Mayo,Venezuela,862,21,33,,54,"(3.866713,-67.927521)"
2015,Mayo,Venezuela,862,925,1267,,2192,"(4.697144,-74.140516)"
2015,Mayo,Venezuela,862,2,4,,6,"(4.815061,-75.736532)"
2015,Mayo,Venezuela,862,37,50,,87,"(6.171601,-75.427454)"
2015,Mayo,Venezuela,862,220,256,,476,"(6.185799,-67.483929)"
2015,Mayo,Venezuela,862,2262,1885,,4147,"(7.088729,-70.740253)"
2015,Mayo,Venezuela,862,3,7,,10,"(7.128456,-73.183637)"
2015,Mayo,Venezuela,862,6217,5843,,12060,"(7.818934,-72.453226)"
2015,Mayo,Vietnam,704,10,10,,20,"(4.697144,-74.140516)"
2015,Mayo,República Árabe de Yemen,887,0,1,,1,"(4.697144,-74.140516)"
2015,Mayo,Islas Turcas y Caicos/Territorio Británico de Ultramar,796,1,0,,1,"(3.541112,-76.384584)"
2015,Mayo,Desconocido,99999,271,704,,975,"(4.697144,-74.140516)"
2015,Junio,Afganistán,4,0,1,,1,"(10.886611,-74.776708)"
2015,Junio,Afganistán,4,1,7,,8,"(4.697144,-74.140516)"
2015,Junio,Afganistán,4,0,2,,2,"(6.171601,-75.427454)"
2015,Junio,Alemania,276,0,1,,1,"(0.814836,-77.662532)"
2015,Junio,Alemania,276,4,2,,6,"(10.445761,-75.516429)"
2015,Junio,Alemania,276,52,51,,103,"(3.541112,-76.384584)"
2015,Junio,Alemania,276,1891,1652,,3543,"(4.697144,-74.140516)"
2015,Junio,Alemania,276,31,22,,53,"(6.171601,-75.427454)"
2015,Junio,Andorra,20,1,2,,3,"(4.697144,-74.140516)"
2015,Junio,Angola,24,0,5,,5,"(4.697144,-74.140516)"
2015,Junio,Antigua y Barbuda,28,2,1,,3,"(4.697144,-74.140516)"
2015,Junio,Países Bajos,528,15,134,,149,"(10.408582,-75.538003)"
2015,Junio,Países Bajos,528,5,1,,6,"(10.445761,-75.516429)"
2015,Junio,Países Bajos,528,97,52,,149,"(10.886611,-74.776708)"
2015,Junio,Países Bajos,528,1,1,,2,"(11.117806,-74.232622)"
2015,Junio,Países Bajos,528,1,0,,1,"(11.247723,-74.213989)"
2015,Junio,Países Bajos,528,166,135,,301,"(3.541112,-76.384584)"
2015,Junio,Países Bajos,528,891,767,,1658,"(4.697144,-74.140516)"
2015,Junio,Países Bajos,528,0,1,,1,"(4.815061,-75.736532)"
2015,Junio,Países Bajos,528,109,90,,199,"(6.171601,-75.427454)"
2015,Junio,Países Bajos,528,2,1,,3,"(7.128456,-73.183637)"
2015,Junio,Arabia Saudita,682,1,1,,2,"(10.445761,-75.516429)"
2015,Junio,Arabia Saudita,682,3,40,,43,"(4.697144,-74.140516)"
2015,Junio,Arabia Saudita,682,0,2,,2,"(6.171601,-75.427454)"
2015,Junio,Argelia,12,1,8,,9,"(4.697144,-74.140516)"
2015,Junio,Argentina,32,28,38,,66,"(0.814836,-77.662532)"
2015,Junio,Argentina,32,14,12,,26,"(10.445761,-75.516429)"
2015,Junio,Argentina,32,28,6,,34,"(10.886611,-74.776708)"
2015,Junio,Argentina,32,8,6,,14,"(12.586067,-81.702563)"
2015,Junio,Argentina,32,203,185,,388,"(3.541112,-76.384584)"
2015,Junio,Argentina,32,2438,2392,,4830,"(4.697144,-74.140516)"
2015,Junio,Argentina,32,7,8,,15,"(4.815061,-75.736532)"
2015,Junio,Argentina,32,178,183,,361,"(6.171601,-75.427454)"
2015,Junio,Argentina,32,6,5,,11,"(7.128456,-73.183637)"
2015,Junio,Argentina,32,6,8,,14,"(7.927209,-72.507910)"
2015,Junio,Aruba,533,3,0,,3,"(10.408582,-75.538003)"
2015,Junio,Aruba,533,5,6,,11,"(10.445761,-75.516429)"
2015,Junio,Aruba,533,34,20,,54,"(10.886611,-74.776708)"
2015,Junio,Aruba,533,0,3,,3,"(10.971302,-74.765397)"
2015,Junio,Aruba,533,19,15,,34,"(3.541112,-76.384584)"
2015,Junio,Aruba,533,1741,1349,,3090,"(4.697144,-74.140516)"
2015,Junio,Aruba,533,10,2,,12,"(4.815061,-75.736532)"
2015,Junio,Aruba,533,101,79,,180,"(6.171601,-75.427454)"
2015,Junio,Aruba,533,19,30,,49,"(7.128456,-73.183637)"
2015,Junio,Aruba,533,2,4,,6,"(7.927209,-72.507910)"
2015,Junio,Australia,36,0,3,,3,"(10.445761,-75.516429)"
2015,Junio,Australia,36,3,2,,5,"(10.886611,-74.776708)"
2015,Junio,Australia,36,14,7,,21,"(3.541112,-76.384584)"
2015,Junio,Australia,36,190,165,,355,"(4.697144,-74.140516)"
2015,Junio,Australia,36,2,0,,2,"(4.815061,-75.736532)"
2015,Junio,Australia,36,40,38,,78,"(6.171601,-75.427454)"
2015,Junio,Austria,40,3,1,,4,"(3.541112,-76.384584)"
2015,Junio,Austria,40,60,61,,121,"(4.697144,-74.140516)"
2015,Junio,Austria,40,4,1,,5,"(6.171601,-75.427454)"
2015,Junio,Bahamas,44,5,3,,8,"(10.445761,-75.516429)"
2015,Junio,Bahamas,44,3,2,,5,"(10.886611,-74.776708)"
2015,Junio,Bahamas,44,35,24,,59,"(3.541112,-76.384584)"
2015,Junio,Bahamas,44,24,23,,47,"(4.697144,-74.140516)"
2015,Junio,Bahamas,44,0,2,,2,"(4.815061,-75.736532)"
2015,Junio,Bahamas,44,14,20,,34,"(6.171601,-75.427454)"
2015,Junio,Bahamas,44,3,6,,9,"(7.128456,-73.183637)"
2015,Junio,Bahamas,44,2,3,,5,"(7.927209,-72.507910)"
2015,Junio,Bahréin,48,0,5,,5,"(4.697144,-74.140516)"
2015,Junio,Bangladesh,50,0,1,,1,"(4.697144,-74.140516)"
2015,Junio,Barbados,52,1,7,,8,"(3.541112,-76.384584)"
2015,Junio,Barbados,52,1,9,,10,"(4.697144,-74.140516)"
2015,Junio,Barbados,52,0,1,,1,"(6.171601,-75.427454)"
2015,Junio,República de Belarús,112,1,3,,4,"(11.360009,-72.129330)"
2015,Junio,República de Belarús,112,3,0,,3,"(4.697144,-74.140516)"
2015,Junio,Bélgica,56,1,0,,1,"(10.445761,-75.516429)"
2015,Junio,Bélgica,56,15,7,,22,"(3.541112,-76.384584)"
2015,Junio,Bélgica,56,126,143,,269,"(4.697144,-74.140516)"
2015,Junio,Bélgica,56,8,5,,13,"(6.171601,-75.427454)"
2015,Junio,Belice,84,3,4,,7,"(3.541112,-76.384584)"
2015,Junio,Belice,84,4,9,,13,"(4.697144,-74.140516)"
2015,Junio,Belice,84,1,2,,3,"(6.171601,-75.427454)"
2015,Junio,Belice,84,0,1,,1,"(7.927209,-72.507910)"
2015,Junio,Bermudas/Territorio Británico de Ultramar,60,2,0,,2,"(4.697144,-74.140516)"
2015,Junio,Bermudas/Territorio Británico de Ultramar,60,3,2,,5,"(6.171601,-75.427454)"
2015,Junio,Bolivia,68,0,11,,11,"(0.814836,-77.662532)"
2015,Junio,Bolivia,68,0,1,,1,"(10.445761,-75.516429)"
2015,Junio,Bolivia,68,1,2,,3,"(10.886611,-74.776708)"
2015,Junio,Bolivia,68,31,40,,71,"(3.541112,-76.384584)"
2015,Junio,Bolivia,68,289,414,,703,"(4.697144,-74.140516)"
2015,Junio,Bolivia,68,14,49,,63,"(6.171601,-75.427454)"
2015,Junio,Bolivia,68,1,0,,1,"(7.128456,-73.183637)"
2015,Junio,Botsuana,72,0,1,,1,"(4.697144,-74.140516)"
2015,Junio,Brasil,76,158,242,,400,"(-4.197703,-69.941278)"
2015,Junio,Brasil,76,3,0,,3,"(-4.223468,-69.945098)"
2015,Junio,Brasil,76,2,3,,5,"(0.814836,-77.662532)"
2015,Junio,Brasil,76,0,7,,7,"(10.408582,-75.538003)"
2015,Junio,Brasil,76,4,12,,16,"(10.445761,-75.516429)"
2015,Junio,Brasil,76,3,7,,10,"(10.886611,-74.776708)"
2015,Junio,Brasil,76,3,1,,4,"(12.586067,-81.702563)"
2015,Junio,Brasil,76,65,103,,168,"(3.541112,-76.384584)"
2015,Junio,Brasil,76,3028,3505,,6533,"(4.697144,-74.140516)"
2015,Junio,Brasil,76,13,18,,31,"(4.815061,-75.736532)"
2015,Junio,Brasil,76,88,121,,209,"(6.171601,-75.427454)"
2015,Junio,Brasil,76,7,7,,14,"(7.128456,-73.183637)"
2015,Junio,Brasil,76,3,1,,4,"(7.927209,-72.507910)"
2015,Junio,Bulgaria,100,2,1,,3,"(4.697144,-74.140516)"
2015,Junio,Islas Caimán/Territorio Británico de Ultramar,136,2,0,,2,"(10.886611,-74.776708)"
2015,Junio,Islas Caimán/Territorio Británico de Ultramar,136,2,0,,2,"(12.586067,-81.702563)"
2015,Junio,Islas Caimán/Territorio Británico de Ultramar,136,2,0,,2,"(3.541112,-76.384584)"
2015,Junio,Islas Caimán/Territorio Británico de Ultramar,136,0,1,,1,"(4.697144,-74.140516)"
2015,Junio,Islas Caimán/Territorio Británico de Ultramar,136,0,1,,1,"(6.171601,-75.427454)"
2015,Junio,Camboya,116,0,1,,1,"(6.171601,-75.427454)"
2015,Junio,Camerún,120,0,1,,1,"(4.697144,-74.140516)"
2015,Junio,Canadá,124,37,21,,58,"(10.445761,-75.516429)"
2015,Junio,Canadá,124,65,46,,111,"(10.886611,-74.776708)"
2015,Junio,Canadá,124,0,2,,2,"(12.586067,-81.702563)"
2015,Junio,Canadá,124,151,119,,270,"(3.541112,-76.384584)"
2015,Junio,Canadá,124,4,3,,7,"(4.452882,-75.766298)"
2015,Junio,Canadá,124,2340,1742,,4082,"(4.697144,-74.140516)"
2015,Junio,Canadá,124,19,18,,37,"(4.815061,-75.736532)"
2015,Junio,Canadá,124,352,240,,592,"(6.171601,-75.427454)"
2015,Junio,Canadá,124,19,15,,34,"(7.128456,-73.183637)"
2015,Junio,Canadá,124,17,9,,26,"(7.927209,-72.507910)"
2015,Junio,Chad,148,1,1,,2,"(4.697144,-74.140516)"
2015,Junio,España,724,4,79,,83,"(10.408582,-75.538003)"
2015,Junio,España,724,27,22,,49,"(10.445761,-75.516429)"
2015,Junio,España,724,29,14,,43,"(10.886611,-74.776708)"
2015,Junio,España,724,1626,966,,2592,"(3.541112,-76.384584)"
2015,Junio,España,724,11265,8335,,19600,"(4.697144,-74.140516)"
2015,Junio,España,724,56,54,,110,"(4.815061,-75.736532)"
2015,Junio,España,724,1040,745,,1785,"(6.171601,-75.427454)"
2015,Junio,España,724,24,23,,47,"(7.128456,-73.183637)"
2015,Junio,España,724,9,5,,14,"(7.927209,-72.507910)"
2015,Junio,Colombia,170,315,909,,1224,"(4.697144,-74.140516)"
2015,Junio,República de Corea,410,2,0,,2,"(3.541112,-76.384584)"
2015,Junio,República de Corea,410,43,37,,80,"(4.697144,-74.140516)"
2015,Junio,República de Corea,410,0,2,,2,"(6.171601,-75.427454)"
2015,Junio,Costa de Marfil,384,6,12,,18,"(4.697144,-74.140516)"
2015,Junio,Costa Rica,188,17,14,,31,"(10.445761,-75.516429)"
2015,Junio,Costa Rica,188,18,16,,34,"(10.886611,-74.776708)"
2015,Junio,Costa Rica,188,1,1,,2,"(12.586067,-81.702563)"
2015,Junio,Costa Rica,188,24,29,,53,"(3.541112,-76.384584)"
2015,Junio,Costa Rica,188,810,934,,1744,"(4.697144,-74.140516)"
2015,Junio,Costa Rica,188,8,10,,18,"(4.815061,-75.736532)"
2015,Junio,Costa Rica,188,116,106,,222,"(6.171601,-75.427454)"
2015,Junio,Costa Rica,188,6,2,,8,"(7.128456,-73.183637)"
2015,Junio,Costa Rica,188,1,3,,4,"(7.927209,-72.507910)"
2015,Junio,Croacia,191,4,14,,18,"(4.697144,-74.140516)"
2015,Junio,Cuba,192,47,32,,79,"(10.445761,-75.516429)"
2015,Junio,Cuba,192,30,16,,46,"(10.886611,-74.776708)"
2015,Junio,Cuba,192,1,2,,3,"(12.586067,-81.702563)"
2015,Junio,Cuba,192,81,59,,140,"(3.541112,-76.384584)"
2015,Junio,Cuba,192,1299,1184,,2483,"(4.697144,-74.140516)"
2015,Junio,Cuba,192,35,33,,68,"(4.815061,-75.736532)"
2015,Junio,Cuba,192,337,162,,499,"(6.171601,-75.427454)"
2015,Junio,Cuba,192,23,17,,40,"(7.128456,-73.183637)"
2015,Junio,Cuba,192,27,19,,46,"(7.927209,-72.507910)"
2015,Junio,Curazao,99999,0,2,,2,"(4.697144,-74.140516)"
2015,Junio,República Checa,203,28,30,,58,"(4.697144,-74.140516)"
2015,Junio,Chile,152,2,29,,31,"(0.25129,-76.875963)"
2015,Junio,Chile,152,265,450,,715,"(0.814836,-77.662532)"
2015,Junio,Chile,152,44,86,,130,"(10.445761,-75.516429)"
2015,Junio,Chile,152,33,57,,90,"(10.886611,-74.776708)"
2015,Junio,Chile,152,11,21,,32,"(12.586067,-81.702563)"
2015,Junio,Chile,152,336,442,,778,"(3.541112,-76.384584)"
2015,Junio,Chile,152,5172,7980,,13152,"(4.697144,-74.140516)"
2015,Junio,Chile,152,47,77,,124,"(4.815061,-75.736532)"
2015,Junio,Chile,152,254,431,,685,"(6.171601,-75.427454)"
2015,Junio,Chile,152,39,78,,117,"(7.128456,-73.183637)"
2015,Junio,Chile,152,24,55,,79,"(7.927209,-72.507910)"
2015,Junio,China,156,0,3,,3,"(10.886611,-74.776708)"
2015,Junio,China,156,7,19,,26,"(3.541112,-76.384584)"
2015,Junio,China,156,241,409,,650,"(4.697144,-74.140516)"
2015,Junio,China,156,2,0,,2,"(4.815061,-75.736532)"
2015,Junio,China,156,11,19,,30,"(6.171601,-75.427454)"
2015,Junio,China,156,0,1,,1,"(7.128456,-73.183637)"
2015,Junio,Chipre,196,0,1,,1,"(4.697144,-74.140516)"
2015,Junio,Dinamarca,208,4,4,,8,"(3.541112,-76.384584)"
2015,Junio,Dinamarca,208,55,42,,97,"(4.697144,-74.140516)"
2015,Junio,Dinamarca,208,2,2,,4,"(6.171601,-75.427454)"
2015,Junio,Ecuador,218,722,894,,1616,"(0.25129,-76.875963)"
2015,Junio,Ecuador,218,28,30,,58,"(0.812436,-77.847006)"
2015,Junio,Ecuador,218,8699,9067,,17766,"(0.814836,-77.662532)"
2015,Junio,Ecuador,218,185,149,,334,"(1.813928,-78.763924)"
2015,Junio,Ecuador,218,0,1,,1,"(10.408582,-75.538003)"
2015,Junio,Ecuador,218,2,4,,6,"(10.445761,-75.516429)"
2015,Junio,Ecuador,218,2,3,,5,"(10.886611,-74.776708)"
2015,Junio,Ecuador,218,0,1,,1,"(12.586067,-81.702563)"
2015,Junio,Ecuador,218,417,460,,877,"(3.541112,-76.384584)"
2015,Junio,Ecuador,218,2896,4383,,7279,"(4.697144,-74.140516)"
2015,Junio,Ecuador,218,2,4,,6,"(4.815061,-75.736532)"
2015,Junio,Ecuador,218,19,29,,48,"(6.171601,-75.427454)"
2015,Junio,Ecuador,218,0,1,,1,"(7.128456,-73.183637)"
2015,Junio,Egipto,818,47,35,,82,"(4.697144,-74.140516)"
2015,Junio,Egipto,818,0,1,,1,"(6.171601,-75.427454)"
2015,Junio,El Salvador,222,3,0,,3,"(10.445761,-75.516429)"
2015,Junio,El Salvador,222,4,4,,8,"(10.886611,-74.776708)"
2015,Junio,El Salvador,222,86,90,,176,"(3.541112,-76.384584)"
2015,Junio,El Salvador,222,803,1011,,1814,"(4.697144,-74.140516)"
2015,Junio,El Salvador,222,0,1,,1,"(4.815061,-75.736532)"
2015,Junio,El Salvador,222,78,102,,180,"(6.171601,-75.427454)"
2015,Junio,El Salvador,222,0,1,,1,"(7.128456,-73.183637)"
2015,Junio,Emiratos Árabes,784,2,4,,6,"(3.541112,-76.384584)"
2015,Junio,Emiratos Árabes,784,88,139,,227,"(4.697144,-74.140516)"
2015,Junio,Emiratos Árabes,784,4,4,,8,"(6.171601,-75.427454)"
2015,Junio,Eritrea,232,1,0,,1,"(4.697144,-74.140516)"
2015,Junio,Eslovaquia,703,0,1,,1,"(3.541112,-76.384584)"
2015,Junio,Eslovaquia,703,0,8,,8,"(4.697144,-74.140516)"
2015,Junio,Eslovaquia,703,0,1,,1,"(6.171601,-75.427454)"
2015,Junio,Eslovaquia,703,1,0,,1,"(7.927209,-72.507910)"
2015,Junio,Eslovenia,705,2,0,,2,"(3.541112,-76.384584)"
2015,Junio,Eslovenia,705,0,4,,4,"(4.697144,-74.140516)"
2015,Junio,Estados Unidos de América,840,2,1,,3,"(0.814836,-77.662532)"
2015,Junio,Estados Unidos de América,840,0,3,,3,"(10.408582,-75.538003)"
2015,Junio,Estados Unidos de América,840,4750,3632,,8382,"(10.445761,-75.516429)"
2015,Junio,Estados Unidos de América,840,3223,2593,,5816,"(10.886611,-74.776708)"
2015,Junio,Estados Unidos de América,840,1,0,,1,"(11.117806,-74.232622)"
2015,Junio,Estados Unidos de América,840,31,34,,65,"(12.586067,-81.702563)"
2015,Junio,Estados Unidos de América,840,6645,4760,,11405,"(3.541112,-76.384584)"
2015,Junio,Estados Unidos de América,840,617,495,,1112,"(4.452882,-75.766298)"
2015,Junio,Estados Unidos de América,840,43957,36173,,80130,"(4.697144,-74.140516)"
2015,Junio,Estados Unidos de América,840,1303,844,,2147,"(4.815061,-75.736532)"
2015,Junio,Estados Unidos de América,840,12861,9819,,22680,"(6.171601,-75.427454)"
2015,Junio,Estados Unidos de América,840,558,415,,973,"(7.128456,-73.183637)"
2015,Junio,Estados Unidos de América,840,299,239,,538,"(7.927209,-72.507910)"
2015,Junio,Estonia,233,1,0,,1,"(3.541112,-76.384584)"
2015,Junio,Estonia,233,1,0,,1,"(4.697144,-74.140516)"
2015,Junio,Etiopia,231,1,1,,2,"(4.697144,-74.140516)"
2015,Junio,Filipinas,608,1,3,,4,"(3.541112,-76.384584)"
2015,Junio,Filipinas,608,7,7,,14,"(4.697144,-74.140516)"
2015,Junio,Filipinas,608,0,1,,1,"(6.171601,-75.427454)"
2015,Junio,Finlandia,246,1,0,,1,"(3.541112,-76.384584)"
2015,Junio,Finlandia,246,12,9,,21,"(4.697144,-74.140516)"
2015,Junio,Finlandia,246,1,0,,1,"(6.171601,-75.427454)"
2015,Junio,Francia,250,1,0,,1,"(10.445761,-75.516429)"
2015,Junio,Francia,250,9,4,,13,"(10.886611,-74.776708)"
2015,Junio,Francia,250,82,48,,130,"(3.541112,-76.384584)"
2015,Junio,Francia,250,2144,1606,,3750,"(4.697144,-74.140516)"
2015,Junio,Francia,250,47,38,,85,"(6.171601,-75.427454)"
2015,Junio,Georgia,268,1,0,,1,"(4.697144,-74.140516)"
2015,Junio,Ghana,288,0,1,,1,"(4.697144,-74.140516)"
2015,Junio,Grecia,300,3,3,,6,"(3.541112,-76.384584)"
2015,Junio,Grecia,300,54,28,,82,"(4.697144,-74.140516)"
2015,Junio,Guatemala,320,9,8,,17,"(10.445761,-75.516429)"
2015,Junio,Guatemala,320,22,21,,43,"(10.886611,-74.776708)"
2015,Junio,Guatemala,320,67,84,,151,"(3.541112,-76.384584)"
2015,Junio,Guatemala,320,606,715,,1321,"(4.697144,-74.140516)"
2015,Junio,Guatemala,320,6,12,,18,"(4.815061,-75.736532)"
2015,Junio,Guatemala,320,81,81,,162,"(6.171601,-75.427454)"
2015,Junio,Guatemala,320,2,4,,6,"(7.128456,-73.183637)"
2015,Junio,Guatemala,320,0,2,,2,"(7.927209,-72.507910)"
2015,Junio,Guyana,328,1,3,,4,"(10.886611,-74.776708)"
2015,Junio,Guyana,328,0,1,,1,"(4.697144,-74.140516)"
2015,Junio,Guyana,328,1,0,,1,"(6.171601,-75.427454)"
2015,Junio,Guinea,324,0,1,,1,"(4.697144,-74.140516)"
2015,Junio,Guinea,324,0,1,,1,"(4.815061,-75.736532)"
2015,Junio,Guinea Ecuatorial,226,0,1,,1,"(3.541112,-76.384584)"
2015,Junio,Guinea Ecuatorial,226,3,4,,7,"(4.697144,-74.140516)"
2015,Junio,Guinea Ecuatorial,226,1,0,,1,"(6.171601,-75.427454)"
2015,Junio,Guadalupe/Territorio Francés,312,3,3,,6,"(4.697144,-74.140516)"
2015,Junio,Guayana Francesa/Departamento de Ultramar Francés,254,1,0,,1,"(3.541112,-76.384584)"
2015,Junio,Guayana Francesa/Departamento de Ultramar Francés,254,1,1,,2,"(4.697144,-74.140516)"
2015,Junio,Haití,332,1,6,,7,"(10.886611,-74.776708)"
2015,Junio,Haití,332,0,1,,1,"(3.541112,-76.384584)"
2015,Junio,Haití,332,1,13,,14,"(4.697144,-74.140516)"
2015,Junio,Haití,332,0,1,,1,"(4.815061,-75.736532)"
2015,Junio,Haití,332,1,3,,4,"(6.171601,-75.427454)"
2015,Junio,Honduras,340,1,0,,1,"(10.408582,-75.538003)"
2015,Junio,Honduras,340,8,14,,22,"(10.445761,-75.516429)"
2015,Junio,Honduras,340,1,9,,10,"(10.886611,-74.776708)"
2015,Junio,Honduras,340,10,28,,38,"(3.541112,-76.384584)"
2015,Junio,Honduras,340,72,157,,229,"(4.697144,-74.140516)"
2015,Junio,Honduras,340,1,2,,3,"(4.815061,-75.736532)"
2015,Junio,Honduras,340,43,66,,109,"(6.171601,-75.427454)"
2015,Junio,Honduras,340,0,3,,3,"(7.128456,-73.183637)"
2015,Junio,Honduras,340,2,1,,3,"(7.927209,-72.507910)"
2015,Junio,Hong Kong,344,0,3,,3,"(3.541112,-76.384584)"
2015,Junio,Hong Kong,344,30,41,,71,"(4.697144,-74.140516)"
2015,Junio,Hong Kong,344,0,1,,1,"(4.815061,-75.736532)"
2015,Junio,Hong Kong,344,2,1,,3,"(6.171601,-75.427454)"
2015,Junio,Hungría,348,4,2,,6,"(4.697144,-74.140516)"
2015,Junio,Hungría,348,0,1,,1,"(6.171601,-75.427454)"
2015,Junio,India,356,0,1,,1,"(10.886611,-74.776708)"
2015,Junio,India,356,60,33,,93,"(4.697144,-74.140516)"
2015,Junio,India,356,1,4,,5,"(6.171601,-75.427454)"
2015,Junio,Indonesia,360,0,1,,1,"(3.541112,-76.384584)"
2015,Junio,Indonesia,360,9,7,,16,"(4.697144,-74.140516)"
2015,Junio,Iraq,368,3,6,,9,"(4.697144,-74.140516)"
2015,Junio,Irán,364,6,2,,8,"(4.697144,-74.140516)"
2015,Junio,República de Irlanda,372,24,11,,35,"(4.697144,-74.140516)"
2015,Junio,República de Irlanda,372,1,0,,1,"(6.171601,-75.427454)"
2015,Junio,Islandia,352,4,1,,5,"(4.697144,-74.140516)"
2015,Junio,Israel,376,8,3,,11,"(3.541112,-76.384584)"
2015,Junio,Israel,376,201,130,,331,"(4.697144,-74.140516)"
2015,Junio,Israel,376,3,3,,6,"(6.171601,-75.427454)"
2015,Junio,Italia,380,4,2,,6,"(10.445761,-75.516429)"
2015,Junio,Italia,380,6,2,,8,"(10.886611,-74.776708)"
2015,Junio,Italia,380,129,67,,196,"(3.541112,-76.384584)"
2015,Junio,Italia,380,878,702,,1580,"(4.697144,-74.140516)"
2015,Junio,Italia,380,1,3,,4,"(4.815061,-75.736532)"
2015,Junio,Italia,380,47,20,,67,"(6.171601,-75.427454)"
2015,Junio,Jamaica,388,3,9,,12,"(10.445761,-75.516429)"
2015,Junio,Jamaica,388,1,2,,3,"(10.886611,-74.776708)"
2015,Junio,Jamaica,388,1,6,,7,"(12.586067,-81.702563)"
2015,Junio,Jamaica,388,4,4,,8,"(3.541112,-76.384584)"
2015,Junio,Jamaica,388,43,39,,82,"(4.697144,-74.140516)"
2015,Junio,Jamaica,388,3,3,,6,"(4.815061,-75.736532)"
2015,Junio,Jamaica,388,8,9,,17,"(6.171601,-75.427454)"
2015,Junio,Jamaica,388,0,1,,1,"(7.927209,-72.507910)"
2015,Junio,Japón,392,1,1,,2,"(3.541112,-76.384584)"
2015,Junio,Japón,392,107,96,,203,"(4.697144,-74.140516)"
2015,Junio,Japón,392,2,4,,6,"(6.171601,-75.427454)"
2015,Junio,Japón,392,0,1,,1,"(7.128456,-73.183637)"
2015,Junio,Jordania,400,2,10,,12,"(4.697144,-74.140516)"
2015,Junio,Kazajistán,398,0,2,,2,"(4.697144,-74.140516)"
2015,Junio,Kenia,404,5,3,,8,"(4.697144,-74.140516)"
2015,Junio,Kuwait,414,1,3,,4,"(4.697144,-74.140516)"
2015,Junio,República Democrática Popular  Lao,418,1,0,,1,"(4.697144,-74.140516)"
2015,Junio,Letonia,428,0,1,,1,"(4.697144,-74.140516)"
2015,Junio,Lituania,440,1,3,,4,"(4.697144,-74.140516)"
2015,Junio,Líbano,422,0,1,,1,"(3.541112,-76.384584)"
2015,Junio,Líbano,422,81,83,,164,"(4.697144,-74.140516)"
2015,Junio,Liberia,430,1,0,,1,"(3.541112,-76.384584)"
2015,Junio,Liberia,430,1,0,,1,"(4.697144,-74.140516)"
2015,Junio,Liberia,430,1,1,,2,"(6.171601,-75.427454)"
2015,Junio,Libia,434,0,1,,1,"(4.697144,-74.140516)"
2015,Junio,Luxemburgo,442,0,1,,1,"(3.541112,-76.384584)"
2015,Junio,Luxemburgo,442,3,2,,5,"(4.697144,-74.140516)"
2015,Junio,Macao,446,0,1,,1,"(3.541112,-76.384584)"
2015,Junio,Malasia,458,4,4,,8,"(4.697144,-74.140516)"
2015,Junio,Malasia,458,1,1,,2,"(6.171601,-75.427454)"
2015,Junio,Malawi,454,1,0,,1,"(4.697144,-74.140516)"
2015,Junio,Malta,470,4,0,,4,"(3.541112,-76.384584)"
2015,Junio,Malta,470,16,6,,22,"(4.697144,-74.140516)"
2015,Junio,Marruecos,504,0,1,,1,"(3.541112,-76.384584)"
2015,Junio,Marruecos,504,11,1,,12,"(4.697144,-74.140516)"
2015,Junio,Marruecos,504,1,1,,2,"(6.171601,-75.427454)"
2015,Junio,Mauritania,478,0,1,,1,"(4.697144,-74.140516)"
2015,Junio,México,484,12,4,,16,"(0.814836,-77.662532)"
2015,Junio,México,484,0,1,,1,"(10.408582,-75.538003)"
2015,Junio,México,484,72,74,,146,"(10.445761,-75.516429)"
2015,Junio,México,484,172,118,,290,"(10.886611,-74.776708)"
2015,Junio,México,484,6,7,,13,"(12.586067,-81.702563)"
2015,Junio,México,484,781,661,,1442,"(3.541112,-76.384584)"
2015,Junio,México,484,16749,14251,,31000,"(4.697144,-74.140516)"
2015,Junio,México,484,269,198,,467,"(4.815061,-75.736532)"
2015,Junio,México,484,3138,2374,,5512,"(6.171601,-75.427454)"
2015,Junio,México,484,179,158,,337,"(7.128456,-73.183637)"
2015,Junio,México,484,117,95,,212,"(7.927209,-72.507910)"
2015,Junio,Mónaco,492,0,1,,1,"(4.697144,-74.140516)"
2015,Junio,Mozambique,508,0,1,,1,"(4.697144,-74.140516)"
2015,Junio,Myanmar,104,0,1,,1,"(4.697144,-74.140516)"
2015,Junio,Nicaragua,558,0,3,,3,"(10.408582,-75.538003)"
2015,Junio,Nicaragua,558,3,10,,13,"(10.445761,-75.516429)"
2015,Junio,Nicaragua,558,2,4,,6,"(10.886611,-74.776708)"
2015,Junio,Nicaragua,558,3,3,,6,"(12.586067,-81.702563)"
2015,Junio,Nicaragua,558,17,40,,57,"(3.541112,-76.384584)"
2015,Junio,Nicaragua,558,51,64,,115,"(4.697144,-74.140516)"
2015,Junio,Nicaragua,558,2,9,,11,"(4.815061,-75.736532)"
2015,Junio,Nicaragua,558,17,43,,60,"(6.171601,-75.427454)"
2015,Junio,Nicaragua,558,1,1,,2,"(7.128456,-73.183637)"
2015,Junio,Nigeria,566,1,9,,10,"(4.697144,-74.140516)"
2015,Junio,Noruega,578,2,0,,2,"(10.886611,-74.776708)"
2015,Junio,Noruega,578,2,2,,4,"(3.541112,-76.384584)"
2015,Junio,Noruega,578,29,25,,54,"(4.697144,-74.140516)"
2015,Junio,Noruega,578,1,3,,4,"(6.171601,-75.427454)"
2015,Junio,Nueva Zelanda,554,1,0,,1,"(3.541112,-76.384584)"
2015,Junio,Nueva Zelanda,554,30,27,,57,"(4.697144,-74.140516)"
2015,Junio,Nueva Zelanda,554,2,4,,6,"(6.171601,-75.427454)"
2015,Junio,Omán,512,0,6,,6,"(4.697144,-74.140516)"
2015,Junio,Papúa Nueva Guinea,598,0,2,,2,"(4.697144,-74.140516)"
2015,Junio,Papúa Nueva Guinea,598,0,1,,1,"(6.171601,-75.427454)"
2015,Junio,Pakistán,586,0,2,,2,"(4.697144,-74.140516)"
2015,Junio,Panamá,591,13,65,,78,"(10.408582,-75.538003)"
2015,Junio,Panamá,591,435,381,,816,"(10.445761,-75.516429)"
2015,Junio,Panamá,591,919,909,,1828,"(10.886611,-74.776708)"
2015,Junio,Panamá,591,0,1,,1,"(11.247723,-74.213989)"
2015,Junio,Panamá,591,1,8,,9,"(12.5744111,-81.703935)"
2015,Junio,Panamá,591,168,177,,345,"(12.586067,-81.702563)"
2015,Junio,Panamá,591,0,1,,1,"(13.3387613,-81.372937)"
2015,Junio,Panamá,591,1713,1542,,3255,"(3.541112,-76.384584)"
2015,Junio,Panamá,591,10231,10042,,20273,"(4.697144,-74.140516)"
2015,Junio,Panamá,591,1094,731,,1825,"(4.815061,-75.736532)"
2015,Junio,Panamá,591,4581,4087,,8668,"(6.171601,-75.427454)"
2015,Junio,Panamá,591,1,3,,4,"(6.228046,-77.404104)"
2015,Junio,Panamá,591,5,9,,14,"(7.102626,-77.762647)"
2015,Junio,Panamá,591,305,307,,612,"(7.128456,-73.183637)"
2015,Junio,Panamá,591,271,244,,515,"(7.927209,-72.507910)"
2015,Junio,Panamá,591,0,67,,67,"(8.066966,-76.735404)"
2015,Junio,Panamá,591,49,92,,141,"(8.635765,-77.346578)"
2015,Junio,Paraguay,600,0,1,,1,"(0.814836,-77.662532)"
2015,Junio,Paraguay,600,2,1,,3,"(10.445761,-75.516429)"
2015,Junio,Paraguay,600,0,1,,1,"(10.886611,-74.776708)"
2015,Junio,Paraguay,600,21,27,,48,"(3.541112,-76.384584)"
2015,Junio,Paraguay,600,88,146,,234,"(4.697144,-74.140516)"
2015,Junio,Paraguay,600,17,11,,28,"(6.171601,-75.427454)"
2015,Junio,Perú,604,183,195,,378,"(-4.197703,-69.941278)"
2015,Junio,Perú,604,0,2,,2,"(0.25129,-76.875963)"
2015,Junio,Perú,604,127,166,,293,"(0.814836,-77.662532)"
2015,Junio,Perú,604,20,22,,42,"(10.445761,-75.516429)"
2015,Junio,Perú,604,43,24,,67,"(10.886611,-74.776708)"
2015,Junio,Perú,604,1,0,,1,"(12.586067,-81.702563)"
2015,Junio,Perú,604,305,324,,629,"(3.541112,-76.384584)"
2015,Junio,Perú,604,6275,6363,,12638,"(4.697144,-74.140516)"
2015,Junio,Perú,604,5,3,,8,"(4.815061,-75.736532)"
2015,Junio,Perú,604,368,458,,826,"(6.171601,-75.427454)"
2015,Junio,Perú,604,5,5,,10,"(7.128456,-73.183637)"
2015,Junio,Perú,604,2,3,,5,"(7.927209,-72.507910)"
2015,Junio,Palestina,99999,0,1,,1,"(4.697144,-74.140516)"
2015,Junio,Polonia,616,1,0,,1,"(3.541112,-76.384584)"
2015,Junio,Polonia,616,24,47,,71,"(4.697144,-74.140516)"
2015,Junio,Portugal,620,1,1,,2,"(3.541112,-76.384584)"
2015,Junio,Portugal,620,423,340,,763,"(4.697144,-74.140516)"
2015,Junio,Portugal,620,7,4,,11,"(6.171601,-75.427454)"
2015,Junio,Puerto Rico/Territorio de Estados Unidos,630,7,9,,16,"(10.445761,-75.516429)"
2015,Junio,Puerto Rico/Territorio de Estados Unidos,630,11,12,,23,"(10.886611,-74.776708)"
2015,Junio,Puerto Rico/Territorio de Estados Unidos,630,1,0,,1,"(12.586067,-81.702563)"
2015,Junio,Puerto Rico/Territorio de Estados Unidos,630,31,17,,48,"(3.541112,-76.384584)"
2015,Junio,Puerto Rico/Territorio de Estados Unidos,630,653,602,,1255,"(4.697144,-74.140516)"
2015,Junio,Puerto Rico/Territorio de Estados Unidos,630,7,8,,15,"(4.815061,-75.736532)"
2015,Junio,Puerto Rico/Territorio de Estados Unidos,630,48,43,,91,"(6.171601,-75.427454)"
2015,Junio,Puerto Rico/Territorio de Estados Unidos,630,8,3,,11,"(7.128456,-73.183637)"
2015,Junio,Puerto Rico/Territorio de Estados Unidos,630,8,5,,13,"(7.927209,-72.507910)"
2015,Junio,Qatar,634,2,2,,4,"(4.697144,-74.140516)"
2015,Junio,Qatar,634,1,1,,2,"(6.171601,-75.427454)"
2015,Junio,Reino Unido de Gran Bretaña e Irlanda del Norte,826,0,1,,1,"(10.886611,-74.776708)"
2015,Junio,Reino Unido de Gran Bretaña e Irlanda del Norte,826,53,39,,92,"(3.541112,-76.384584)"
2015,Junio,Reino Unido de Gran Bretaña e Irlanda del Norte,826,2230,1587,,3817,"(4.697144,-74.140516)"
2015,Junio,Reino Unido de Gran Bretaña e Irlanda del Norte,826,26,15,,41,"(6.171601,-75.427454)"
2015,Junio,Reino Unido de Gran Bretaña e Irlanda del Norte,826,3,1,,4,"(7.128456,-73.183637)"
2015,Junio,República CentroÁfricana,140,3,3,,6,"(4.697144,-74.140516)"
2015,Junio,Federación de Rusia,643,4,2,,6,"(3.541112,-76.384584)"
2015,Junio,Federación de Rusia,643,73,96,,169,"(4.697144,-74.140516)"
2015,Junio,Federación de Rusia,643,0,6,,6,"(6.171601,-75.427454)"
2015,Junio,República Dominicana,214,24,37,,61,"(10.445761,-75.516429)"
2015,Junio,República Dominicana,214,72,55,,127,"(10.886611,-74.776708)"
2015,Junio,República Dominicana,214,2,4,,6,"(12.586067,-81.702563)"
2015,Junio,República Dominicana,214,236,231,,467,"(3.541112,-76.384584)"
2015,Junio,República Dominicana,214,3146,2865,,6011,"(4.697144,-74.140516)"
2015,Junio,República Dominicana,214,31,26,,57,"(4.815061,-75.736532)"
2015,Junio,República Dominicana,214,358,331,,689,"(6.171601,-75.427454)"
2015,Junio,República Dominicana,214,59,50,,109,"(7.128456,-73.183637)"
2015,Junio,República Dominicana,214,31,28,,59,"(7.927209,-72.507910)"
2015,Junio,Reunión,638,1,0,,1,"(4.697144,-74.140516)"
2015,Junio,Reunión,638,0,1,,1,"(6.171601,-75.427454)"
2015,Junio,República Democrática Popular de Corea,408,1,0,,1,"(4.697144,-74.140516)"
2015,Junio,Rumania,642,0,1,,1,"(3.541112,-76.384584)"
2015,Junio,Rumania,642,5,2,,7,"(4.697144,-74.140516)"
2015,Junio,San  Vicente y las Granadinas,670,1,0,,1,"(4.697144,-74.140516)"
2015,Junio,Senegal,686,0,1,,1,"(4.697144,-74.140516)"
2015,Junio,Serbia,688,0,1,,1,"(4.697144,-74.140516)"
2015,Junio,Seychelles,690,1,0,,1,"(4.697144,-74.140516)"
2015,Junio,Singapur,702,1,0,,1,"(3.541112,-76.384584)"
2015,Junio,Singapur,702,21,19,,40,"(4.697144,-74.140516)"
2015,Junio,Singapur,702,1,0,,1,"(6.171601,-75.427454)"
2015,Junio,Sri Lanka,144,1,1,,2,"(3.541112,-76.384584)"
2015,Junio,Sudáfrica,710,0,1,,1,"(3.541112,-76.384584)"
2015,Junio,Sudáfrica,710,8,7,,15,"(4.697144,-74.140516)"
2015,Junio,Sudáfrica,710,0,1,,1,"(6.171601,-75.427454)"
2015,Junio,Suecia,752,2,0,,2,"(10.445761,-75.516429)"
2015,Junio,Suecia,752,12,7,,19,"(3.541112,-76.384584)"
2015,Junio,Suecia,752,76,55,,131,"(4.697144,-74.140516)"
2015,Junio,Suecia,752,2,0,,2,"(6.171601,-75.427454)"
2015,Junio,Suecia,752,1,1,,2,"(7.128456,-73.183637)"
2015,Junio,Suiza,756,0,1,,1,"(10.445761,-75.516429)"
2015,Junio,Suiza,756,5,0,,5,"(10.886611,-74.776708)"
2015,Junio,Suiza,756,57,26,,83,"(3.541112,-76.384584)"
2015,Junio,Suiza,756,302,212,,514,"(4.697144,-74.140516)"
2015,Junio,Suiza,756,1,0,,1,"(4.815061,-75.736532)"
2015,Junio,Suiza,756,10,10,,20,"(6.171601,-75.427454)"
2015,Junio,Surinam,740,6,12,,18,"(4.697144,-74.140516)"
2015,Junio,Surinam,740,3,1,,4,"(6.171601,-75.427454)"
2015,Junio,Taiwán,158,1,2,,3,"(3.541112,-76.384584)"
2015,Junio,Taiwán,158,2,0,,2,"(4.697144,-74.140516)"
2015,Junio,Tailandia,764,0,1,,1,"(3.541112,-76.384584)"
2015,Junio,Tailandia,764,28,33,,61,"(4.697144,-74.140516)"
2015,Junio,Togo,768,2,2,,4,"(4.697144,-74.140516)"
2015,Junio,Trinidad y Tobago,780,2,5,,7,"(10.445761,-75.516429)"
2015,Junio,Trinidad y Tobago,780,2,0,,2,"(10.886611,-74.776708)"
2015,Junio,Trinidad y Tobago,780,8,5,,13,"(3.541112,-76.384584)"
2015,Junio,Trinidad y Tobago,780,16,19,,35,"(4.697144,-74.140516)"
2015,Junio,Trinidad y Tobago,780,4,4,,8,"(4.815061,-75.736532)"
2015,Junio,Trinidad y Tobago,780,11,13,,24,"(6.171601,-75.427454)"
2015,Junio,Trinidad y Tobago,780,4,7,,11,"(7.128456,-73.183637)"
2015,Junio,Turquía,792,5,7,,12,"(3.541112,-76.384584)"
2015,Junio,Turquía,792,123,96,,219,"(4.697144,-74.140516)"
2015,Junio,Turquía,792,7,5,,12,"(6.171601,-75.427454)"
2015,Junio,Turquía,792,0,1,,1,"(7.927209,-72.507910)"
2015,Junio,Ucrania,804,1,1,,2,"(4.697144,-74.140516)"
2015,Junio,Uganda,800,1,0,,1,"(3.541112,-76.384584)"
2015,Junio,Uganda,800,2,3,,5,"(4.697144,-74.140516)"
2015,Junio,Uruguay,858,0,1,,1,"(10.445761,-75.516429)"
2015,Junio,Uruguay,858,2,0,,2,"(10.886611,-74.776708)"
2015,Junio,Uruguay,858,6,10,,16,"(3.541112,-76.384584)"
2015,Junio,Uruguay,858,53,73,,126,"(4.697144,-74.140516)"
2015,Junio,Uruguay,858,1,2,,3,"(4.815061,-75.736532)"
2015,Junio,Uruguay,858,15,4,,19,"(6.171601,-75.427454)"
2015,Junio,Venezuela,862,5,10,,15,"(10.445761,-75.516429)"
2015,Junio,Venezuela,862,6,22,,28,"(10.886611,-74.776708)"
2015,Junio,Venezuela,862,12986,10387,,23373,"(11.360009,-72.129330)"
2015,Junio,Venezuela,862,1,0,,1,"(12.586067,-81.702563)"
2015,Junio,Venezuela,862,5,20,,25,"(3.541112,-76.384584)"
2015,Junio,Venezuela,862,34,37,,71,"(3.866713,-67.927521)"
2015,Junio,Venezuela,862,1161,1548,,2709,"(4.697144,-74.140516)"
2015,Junio,Venezuela,862,3,14,,17,"(4.815061,-75.736532)"
2015,Junio,Venezuela,862,15,29,,44,"(6.171601,-75.427454)"
2015,Junio,Venezuela,862,308,304,,612,"(6.185799,-67.483929)"
2015,Junio,Venezuela,862,3072,2493,,5565,"(7.088729,-70.740253)"
2015,Junio,Venezuela,862,1,10,,11,"(7.128456,-73.183637)"
2015,Junio,Venezuela,862,13476,10969,,24445,"(7.818934,-72.453226)"
2015,Junio,Venezuela,862,0,1,,1,"(7.927209,-72.507910)"
2015,Junio,Vietnam,704,1,1,,2,"(4.697144,-74.140516)"
2015,Junio,Vietnam,704,0,1,,1,"(6.171601,-75.427454)"
2015,Junio,Desconocido,99999,0,2,,2,"(0.812436,-77.847006)"
2015,Junio,Desconocido,99999,261,736,,997,"(4.697144,-74.140516)"
2015,Junio,Desconocido,99999,3,1,,4,"(7.088729,-70.740253)"
2015,Julio,Afganistán,4,2,2,,4,"(4.697144,-74.140516)"
2015,Julio,Albania,8,2,1,,3,"(3.541112,-76.384584)"
2015,Julio,Alemania,276,3,0,,3,"(0.814836,-77.662532)"
2015,Julio,Alemania,276,0,1,,1,"(10.886611,-74.776708)"
2015,Julio,Alemania,276,69,36,,105,"(3.541112,-76.384584)"
2015,Julio,Alemania,276,1305,1013,,2318,"(4.697144,-74.140516)"
2015,Julio,Alemania,276,33,11,,44,"(6.171601,-75.427454)"
2015,Julio,Angola,24,0,14,,14,"(4.697144,-74.140516)"
2015,Julio,Países Bajos,528,1,0,,1,"(10.445761,-75.516429)"
2015,Julio,Países Bajos,528,101,61,,162,"(10.886611,-74.776708)"
2015,Julio,Países Bajos,528,187,118,,305,"(3.541112,-76.384584)"
2015,Julio,Países Bajos,528,828,733,,1561,"(4.697144,-74.140516)"
2015,Julio,Países Bajos,528,5,2,,7,"(4.815061,-75.736532)"
2015,Julio,Países Bajos,528,209,115,,324,"(6.171601,-75.427454)"
2015,Julio,Países Bajos,528,2,0,,2,"(7.128456,-73.183637)"
2015,Julio,Arabia Saudita,682,1,1,,2,"(10.445761,-75.516429)"
2015,Julio,Arabia Saudita,682,0,1,,1,"(3.541112,-76.384584)"
2015,Julio,Arabia Saudita,682,6,36,,42,"(4.697144,-74.140516)"
2015,Julio,Arabia Saudita,682,0,2,,2,"(6.171601,-75.427454)"
2015,Julio,Argelia,12,3,5,,8,"(4.697144,-74.140516)"
2015,Julio,Argentina,32,13,25,,38,"(0.814836,-77.662532)"
2015,Julio,Argentina,32,8,7,,15,"(10.445761,-75.516429)"
2015,Julio,Argentina,32,14,10,,24,"(10.886611,-74.776708)"
2015,Julio,Argentina,32,6,2,,8,"(12.586067,-81.702563)"
2015,Julio,Argentina,32,187,189,,376,"(3.541112,-76.384584)"
2015,Julio,Argentina,32,2091,2150,,4241,"(4.697144,-74.140516)"
2015,Julio,Argentina,32,5,0,,5,"(4.815061,-75.736532)"
2015,Julio,Argentina,32,146,153,,299,"(6.171601,-75.427454)"
2015,Julio,Argentina,32,7,26,,33,"(7.128456,-73.183637)"
2015,Julio,Argentina,32,1,2,,3,"(7.927209,-72.507910)"
2015,Julio,República de Armenia,51,0,1,,1,"(4.697144,-74.140516)"
2015,Julio,Aruba,533,0,3,,3,"(10.408582,-75.538003)"
2015,Julio,Aruba,533,3,5,,8,"(10.445761,-75.516429)"
2015,Julio,Aruba,533,42,26,,68,"(10.886611,-74.776708)"
2015,Julio,Aruba,533,0,2,,2,"(10.971302,-74.765397)"
2015,Julio,Aruba,533,0,4,,4,"(11.247723,-74.213989)"
2015,Julio,Aruba,533,35,23,,58,"(3.541112,-76.384584)"
2015,Julio,Aruba,533,1542,1133,,2675,"(4.697144,-74.140516)"
2015,Julio,Aruba,533,9,8,,17,"(4.815061,-75.736532)"
2015,Julio,Aruba,533,104,70,,174,"(6.171601,-75.427454)"
2015,Julio,Aruba,533,23,39,,62,"(7.128456,-73.183637)"
2015,Julio,Aruba,533,4,6,,10,"(7.927209,-72.507910)"
2015,Julio,Australia,36,3,1,,4,"(10.445761,-75.516429)"
2015,Julio,Australia,36,9,3,,12,"(10.886611,-74.776708)"
2015,Julio,Australia,36,15,14,,29,"(3.541112,-76.384584)"
2015,Julio,Australia,36,213,157,,370,"(4.697144,-74.140516)"
2015,Julio,Australia,36,2,1,,3,"(4.815061,-75.736532)"
2015,Julio,Australia,36,35,28,,63,"(6.171601,-75.427454)"
2015,Julio,Australia,36,1,1,,2,"(7.128456,-73.183637)"
2015,Julio,Austria,40,2,0,,2,"(10.886611,-74.776708)"
2015,Julio,Austria,40,9,4,,13,"(3.541112,-76.384584)"
2015,Julio,Austria,40,42,44,,86,"(4.697144,-74.140516)"
2015,Julio,Austria,40,6,2,,8,"(6.171601,-75.427454)"
2015,Julio,Azerbaiyán,31,1,5,,6,"(4.697144,-74.140516)"
2015,Julio,Bahamas,44,3,1,,4,"(10.445761,-75.516429)"
2015,Julio,Bahamas,44,4,2,,6,"(10.886611,-74.776708)"
2015,Julio,Bahamas,44,0,2,,2,"(12.586067,-81.702563)"
2015,Julio,Bahamas,44,15,11,,26,"(3.541112,-76.384584)"
2015,Julio,Bahamas,44,11,11,,22,"(4.697144,-74.140516)"
2015,Julio,Bahamas,44,4,1,,5,"(4.815061,-75.736532)"
2015,Julio,Bahamas,44,13,9,,22,"(6.171601,-75.427454)"
2015,Julio,Bahréin,48,1,0,,1,"(10.445761,-75.516429)"
2015,Julio,Bahréin,48,4,7,,11,"(4.697144,-74.140516)"
2015,Julio,Bahréin,48,1,0,,1,"(6.171601,-75.427454)"
2015,Julio,Bangladesh,50,0,1,,1,"(4.697144,-74.140516)"
2015,Julio,Barbados,52,1,0,,1,"(4.697144,-74.140516)"
2015,Julio,Barbados,52,0,5,,5,"(7.927209,-72.507910)"
2015,Julio,República de Belarús,112,1,0,,1,"(11.360009,-72.129330)"
2015,Julio,República de Belarús,112,0,3,,3,"(4.697144,-74.140516)"
2015,Julio,República de Belarús,112,0,2,,2,"(7.818934,-72.453226)"
2015,Julio,Bélgica,56,4,0,,4,"(10.886611,-74.776708)"
2015,Julio,Bélgica,56,59,49,,108,"(3.541112,-76.384584)"
2015,Julio,Bélgica,56,104,86,,190,"(4.697144,-74.140516)"
2015,Julio,Bélgica,56,23,34,,57,"(6.171601,-75.427454)"
2015,Julio,Bélgica,56,1,1,,2,"(7.128456,-73.183637)"
2015,Julio,Belice,84,3,2,,5,"(3.541112,-76.384584)"
2015,Julio,Belice,84,7,4,,11,"(4.697144,-74.140516)"
2015,Julio,Benín,204,2,0,,2,"(4.697144,-74.140516)"
2015,Julio,Bermudas/Territorio Británico de Ultramar,60,1,1,,2,"(4.697144,-74.140516)"
2015,Julio,Bermudas/Territorio Británico de Ultramar,60,1,0,,1,"(6.171601,-75.427454)"
2015,Julio,Bolivia,68,5,12,,17,"(0.814836,-77.662532)"
2015,Julio,Bolivia,68,0,1,,1,"(10.445761,-75.516429)"
2015,Julio,Bolivia,68,1,2,,3,"(10.886611,-74.776708)"
2015,Julio,Bolivia,68,39,66,,105,"(3.541112,-76.384584)"
2015,Julio,Bolivia,68,251,418,,669,"(4.697144,-74.140516)"
2015,Julio,Bolivia,68,0,1,,1,"(4.815061,-75.736532)"
2015,Julio,Bolivia,68,20,48,,68,"(6.171601,-75.427454)"
2015,Julio,Bolivia,68,1,2,,3,"(7.128456,-73.183637)"
2015,Julio,Bosnia y Herzegovina,70,0,2,,2,"(4.697144,-74.140516)"
2015,Julio,Brasil,76,98,186,,284,"(-4.197703,-69.941278)"
2015,Julio,Brasil,76,0,2,,2,"(-4.223468,-69.945098)"
2015,Julio,Brasil,76,1,4,,5,"(0.814836,-77.662532)"
2015,Julio,Brasil,76,1,4,,5,"(10.445761,-75.516429)"
2015,Julio,Brasil,76,9,13,,22,"(10.886611,-74.776708)"
2015,Julio,Brasil,76,0,2,,2,"(12.586067,-81.702563)"
2015,Julio,Brasil,76,63,72,,135,"(3.541112,-76.384584)"
2015,Julio,Brasil,76,2581,2903,,5484,"(4.697144,-74.140516)"
2015,Julio,Brasil,76,3,13,,16,"(4.815061,-75.736532)"
2015,Julio,Brasil,76,76,117,,193,"(6.171601,-75.427454)"
2015,Julio,Brasil,76,2,2,,4,"(7.128456,-73.183637)"
2015,Julio,Brasil,76,0,1,,1,"(7.927209,-72.507910)"
2015,Julio,Brunei Darussalam,96,0,1,,1,"(4.697144,-74.140516)"
2015,Julio,Bulgaria,100,3,3,,6,"(4.697144,-74.140516)"
2015,Julio,Burundi,108,1,0,,1,"(4.697144,-74.140516)"
2015,Julio,Cabo Verde,132,1,0,,1,"(4.697144,-74.140516)"
2015,Julio,Islas Caimán/Territorio Británico de Ultramar,136,6,0,,6,"(12.586067,-81.702563)"
2015,Julio,Islas Caimán/Territorio Británico de Ultramar,136,3,1,,4,"(3.541112,-76.384584)"
2015,Julio,Islas Caimán/Territorio Británico de Ultramar,136,3,2,,5,"(4.697144,-74.140516)"
2015,Julio,Camboya,116,3,4,,7,"(4.697144,-74.140516)"
2015,Julio,Camerún,120,4,5,,9,"(4.697144,-74.140516)"
2015,Julio,Canadá,124,44,29,,73,"(10.445761,-75.516429)"
2015,Julio,Canadá,124,49,34,,83,"(10.886611,-74.776708)"
2015,Julio,Canadá,124,2,2,,4,"(12.586067,-81.702563)"
2015,Julio,Canadá,124,159,149,,308,"(3.541112,-76.384584)"
2015,Julio,Canadá,124,3,2,,5,"(4.452882,-75.766298)"
2015,Julio,Canadá,124,1950,1631,,3581,"(4.697144,-74.140516)"
2015,Julio,Canadá,124,12,17,,29,"(4.815061,-75.736532)"
2015,Julio,Canadá,124,311,308,,619,"(6.171601,-75.427454)"
2015,Julio,Canadá,124,16,17,,33,"(7.128456,-73.183637)"
2015,Julio,Canadá,124,9,5,,14,"(7.927209,-72.507910)"
2015,Julio,Chad,148,0,2,,2,"(4.697144,-74.140516)"
2015,Julio,España,724,13,22,,35,"(10.445761,-75.516429)"
2015,Julio,España,724,18,18,,36,"(10.886611,-74.776708)"
2015,Julio,España,724,2395,1621,,4016,"(3.541112,-76.384584)"
2015,Julio,España,724,7119,5546,,12665,"(4.697144,-74.140516)"
2015,Julio,España,724,50,39,,89,"(4.815061,-75.736532)"
2015,Julio,España,724,1223,850,,2073,"(6.171601,-75.427454)"
2015,Julio,España,724,17,15,,32,"(7.128456,-73.183637)"
2015,Julio,España,724,5,4,,9,"(7.927209,-72.507910)"
2015,Julio,Colombia,170,382,1019,,1401,"(4.697144,-74.140516)"
2015,Julio,República Del Congo,178,0,1,,1,"(4.697144,-74.140516)"
2015,Julio,República Democrática del Congo,180,0,1,,1,"(4.697144,-74.140516)"
2015,Julio,República de Corea,410,0,2,,2,"(3.541112,-76.384584)"
2015,Julio,República de Corea,410,20,16,,36,"(4.697144,-74.140516)"
2015,Julio,República de Corea,410,0,1,,1,"(6.171601,-75.427454)"
2015,Julio,Islas Malvinas,238,1,0,,1,"(3.541112,-76.384584)"
2015,Julio,Costa de Marfil,384,3,4,,7,"(4.697144,-74.140516)"
2015,Julio,Costa de Marfil,384,0,1,,1,"(6.171601,-75.427454)"
2015,Julio,Costa Rica,188,11,10,,21,"(10.445761,-75.516429)"
2015,Julio,Costa Rica,188,18,7,,25,"(10.886611,-74.776708)"
2015,Julio,Costa Rica,188,4,40,,44,"(12.5744111,-81.703935)"
2015,Julio,Costa Rica,188,13,14,,27,"(12.586067,-81.702563)"
2015,Julio,Costa Rica,188,48,58,,106,"(3.541112,-76.384584)"
2015,Julio,Costa Rica,188,896,1024,,1920,"(4.697144,-74.140516)"
2015,Julio,Costa Rica,188,8,8,,16,"(4.815061,-75.736532)"
2015,Julio,Costa Rica,188,119,119,,238,"(6.171601,-75.427454)"
2015,Julio,Costa Rica,188,14,9,,23,"(7.128456,-73.183637)"
2015,Julio,Costa Rica,188,0,2,,2,"(7.927209,-72.507910)"
2015,Julio,Croacia,191,8,5,,13,"(4.697144,-74.140516)"
2015,Julio,Cuba,192,8,14,,22,"(10.445761,-75.516429)"
2015,Julio,Cuba,192,24,42,,66,"(10.886611,-74.776708)"
2015,Julio,Cuba,192,6,5,,11,"(12.586067,-81.702563)"
2015,Julio,Cuba,192,114,95,,209,"(3.541112,-76.384584)"
2015,Julio,Cuba,192,894,857,,1751,"(4.697144,-74.140516)"
2015,Julio,Cuba,192,6,10,,16,"(4.815061,-75.736532)"
2015,Julio,Cuba,192,98,119,,217,"(6.171601,-75.427454)"
2015,Julio,Cuba,192,14,10,,24,"(7.128456,-73.183637)"
2015,Julio,Cuba,192,0,1,,1,"(7.927209,-72.507910)"
2015,Julio,República Checa,203,12,9,,21,"(4.697144,-74.140516)"
2015,Julio,Chile,152,179,177,,356,"(0.814836,-77.662532)"
2015,Julio,Chile,152,13,6,,19,"(10.445761,-75.516429)"
2015,Julio,Chile,152,6,3,,9,"(10.886611,-74.776708)"
2015,Julio,Chile,152,2,0,,2,"(12.586067,-81.702563)"
2015,Julio,Chile,152,213,156,,369,"(3.541112,-76.384584)"
2015,Julio,Chile,152,2496,2439,,4935,"(4.697144,-74.140516)"
2015,Julio,Chile,152,23,21,,44,"(4.815061,-75.736532)"
2015,Julio,Chile,152,103,90,,193,"(6.171601,-75.427454)"
2015,Julio,Chile,152,11,10,,21,"(7.128456,-73.183637)"
2015,Julio,Chile,152,1,0,,1,"(7.927209,-72.507910)"
2015,Julio,China,156,1,2,,3,"(10.886611,-74.776708)"
2015,Julio,China,156,8,23,,31,"(3.541112,-76.384584)"
2015,Julio,China,156,181,370,,551,"(4.697144,-74.140516)"
2015,Julio,China,156,14,40,,54,"(6.171601,-75.427454)"
2015,Julio,China,156,1,0,,1,"(7.128456,-73.183637)"
2015,Julio,China,156,0,1,,1,"(7.927209,-72.507910)"
2015,Julio,Dinamarca,208,2,1,,3,"(10.886611,-74.776708)"
2015,Julio,Dinamarca,208,9,2,,11,"(3.541112,-76.384584)"
2015,Julio,Dinamarca,208,73,39,,112,"(4.697144,-74.140516)"
2015,Julio,Dinamarca,208,1,1,,2,"(6.171601,-75.427454)"
2015,Julio,Dominica,212,2,4,,6,"(4.697144,-74.140516)"
2015,Julio,Dominica,212,1,3,,4,"(6.171601,-75.427454)"
2015,Julio,Ecuador,218,584,812,,1396,"(0.25129,-76.875963)"
2015,Julio,Ecuador,218,22,22,,44,"(0.812436,-77.847006)"
2015,Julio,Ecuador,218,11812,10851,,22663,"(0.814836,-77.662532)"
2015,Julio,Ecuador,218,242,189,,431,"(1.813928,-78.763924)"
2015,Julio,Ecuador,218,9,4,,13,"(10.445761,-75.516429)"
2015,Julio,Ecuador,218,3,7,,10,"(10.886611,-74.776708)"
2015,Julio,Ecuador,218,0,1,,1,"(12.586067,-81.702563)"
2015,Julio,Ecuador,218,402,438,,840,"(3.541112,-76.384584)"
2015,Julio,Ecuador,218,2818,4119,,6937,"(4.697144,-74.140516)"
2015,Julio,Ecuador,218,2,6,,8,"(4.815061,-75.736532)"
2015,Julio,Ecuador,218,38,49,,87,"(6.171601,-75.427454)"
2015,Julio,Ecuador,218,0,2,,2,"(7.128456,-73.183637)"
2015,Julio,Ecuador,218,1,0,,1,"(7.927209,-72.507910)"
2015,Julio,Egipto,818,0,1,,1,"(3.541112,-76.384584)"
2015,Julio,Egipto,818,34,20,,54,"(4.697144,-74.140516)"
2015,Julio,Egipto,818,0,1,,1,"(6.171601,-75.427454)"
2015,Julio,Egipto,818,1,1,,2,"(7.128456,-73.183637)"
2015,Julio,El Salvador,222,1,1,,2,"(10.445761,-75.516429)"
2015,Julio,El Salvador,222,1,4,,5,"(10.886611,-74.776708)"
2015,Julio,El Salvador,222,1,1,,2,"(12.586067,-81.702563)"
2015,Julio,El Salvador,222,85,93,,178,"(3.541112,-76.384584)"
2015,Julio,El Salvador,222,717,911,,1628,"(4.697144,-74.140516)"
2015,Julio,El Salvador,222,1,0,,1,"(4.815061,-75.736532)"
2015,Julio,El Salvador,222,66,104,,170,"(6.171601,-75.427454)"
2015,Julio,El Salvador,222,0,1,,1,"(7.128456,-73.183637)"
2015,Julio,El Salvador,222,1,0,,1,"(7.927209,-72.507910)"
2015,Julio,Emiratos Árabes,784,3,3,,6,"(3.541112,-76.384584)"
2015,Julio,Emiratos Árabes,784,118,327,,445,"(4.697144,-74.140516)"
2015,Julio,Emiratos Árabes,784,1,0,,1,"(4.815061,-75.736532)"
2015,Julio,Emiratos Árabes,784,5,3,,8,"(6.171601,-75.427454)"
2015,Julio,Eritrea,232,1,1,,2,"(4.697144,-74.140516)"
2015,Julio,Eslovaquia,703,1,0,,1,"(4.697144,-74.140516)"
2015,Julio,Eslovenia,705,3,0,,3,"(4.697144,-74.140516)"
2015,Julio,Estados Unidos de América,840,4540,3543,,8083,"(10.445761,-75.516429)"
2015,Julio,Estados Unidos de América,840,3406,2668,,6074,"(10.886611,-74.776708)"
2015,Julio,Estados Unidos de América,840,29,23,,52,"(12.586067,-81.702563)"
2015,Julio,Estados Unidos de América,840,7194,5073,,12267,"(3.541112,-76.384584)"
2015,Julio,Estados Unidos de América,840,605,432,,1037,"(4.452882,-75.766298)"
2015,Julio,Estados Unidos de América,840,39743,33977,,73720,"(4.697144,-74.140516)"
2015,Julio,Estados Unidos de América,840,1175,736,,1911,"(4.815061,-75.736532)"
2015,Julio,Estados Unidos de América,840,9813,7483,,17296,"(6.171601,-75.427454)"
2015,Julio,Estados Unidos de América,840,351,257,,608,"(7.128456,-73.183637)"
2015,Julio,Estados Unidos de América,840,110,72,,182,"(7.927209,-72.507910)"
2015,Julio,Estonia,233,0,3,,3,"(4.697144,-74.140516)"
2015,Julio,Etiopia,231,2,9,,11,"(4.697144,-74.140516)"
2015,Julio,Etiopia,231,0,1,,1,"(6.171601,-75.427454)"
2015,Julio,Filipinas,608,0,1,,1,"(10.445761,-75.516429)"
2015,Julio,Filipinas,608,2,0,,2,"(10.886611,-74.776708)"
2015,Julio,Filipinas,608,6,2,,8,"(4.697144,-74.140516)"
2015,Julio,Filipinas,608,1,3,,4,"(6.171601,-75.427454)"
2015,Julio,Finlandia,246,0,1,,1,"(3.541112,-76.384584)"
2015,Julio,Finlandia,246,10,11,,21,"(4.697144,-74.140516)"
2015,Julio,Finlandia,246,1,1,,2,"(6.171601,-75.427454)"
2015,Julio,Francia,250,1,1,,2,"(10.445761,-75.516429)"
2015,Julio,Francia,250,1,2,,3,"(10.886611,-74.776708)"
2015,Julio,Francia,250,120,67,,187,"(3.541112,-76.384584)"
2015,Julio,Francia,250,1478,1235,,2713,"(4.697144,-74.140516)"
2015,Julio,Francia,250,52,41,,93,"(6.171601,-75.427454)"
2015,Julio,Francia,250,2,1,,3,"(7.128456,-73.183637)"
2015,Julio,Georgia,268,2,0,,2,"(4.697144,-74.140516)"
2015,Julio,Ghana,288,0,3,,3,"(4.697144,-74.140516)"
2015,Julio,Gibraltar/Territorio Británico de Ultramar,292,1,0,,1,"(0.814836,-77.662532)"
2015,Julio,Granada,308,0,1,,1,"(3.541112,-76.384584)"
2015,Julio,Granada,308,1,0,,1,"(4.697144,-74.140516)"
2015,Julio,Grecia,300,4,1,,5,"(3.541112,-76.384584)"
2015,Julio,Grecia,300,31,22,,53,"(4.697144,-74.140516)"
2015,Julio,Grecia,300,0,1,,1,"(6.171601,-75.427454)"
2015,Julio,Guatemala,320,3,0,,3,"(10.445761,-75.516429)"
2015,Julio,Guatemala,320,8,10,,18,"(10.886611,-74.776708)"
2015,Julio,Guatemala,320,8,4,,12,"(12.586067,-81.702563)"
2015,Julio,Guatemala,320,59,87,,146,"(3.541112,-76.384584)"
2015,Julio,Guatemala,320,527,645,,1172,"(4.697144,-74.140516)"
2015,Julio,Guatemala,320,10,11,,21,"(4.815061,-75.736532)"
2015,Julio,Guatemala,320,101,137,,238,"(6.171601,-75.427454)"
2015,Julio,Guatemala,320,7,5,,12,"(7.128456,-73.183637)"
2015,Julio,Guyana,328,0,2,,2,"(10.886611,-74.776708)"
2015,Julio,Guyana,328,2,2,,4,"(3.541112,-76.384584)"
2015,Julio,Guyana,328,0,3,,3,"(4.697144,-74.140516)"
2015,Julio,Guyana,328,1,0,,1,"(6.171601,-75.427454)"
2015,Julio,Guyana,328,0,1,,1,"(7.927209,-72.507910)"
2015,Julio,Guinea,324,0,1,,1,"(7.128456,-73.183637)"
2015,Julio,Guinea Ecuatorial,226,0,1,,1,"(3.541112,-76.384584)"
2015,Julio,Guinea Ecuatorial,226,3,6,,9,"(4.697144,-74.140516)"
2015,Julio,Guinea Ecuatorial,226,0,1,,1,"(6.171601,-75.427454)"
2015,Julio,Guadalupe/Territorio Francés,312,1,0,,1,"(4.697144,-74.140516)"
2015,Julio,Guayana Francesa/Departamento de Ultramar Francés,254,0,1,,1,"(10.886611,-74.776708)"
2015,Julio,Guayana Francesa/Departamento de Ultramar Francés,254,1,2,,3,"(3.541112,-76.384584)"
2015,Julio,Guayana Francesa/Departamento de Ultramar Francés,254,1,0,,1,"(4.697144,-74.140516)"
2015,Julio,Guayana Francesa/Departamento de Ultramar Francés,254,0,2,,2,"(6.171601,-75.427454)"
2015,Julio,Haití,332,1,0,,1,"(10.445761,-75.516429)"
2015,Julio,Haití,332,1,3,,4,"(10.886611,-74.776708)"
2015,Julio,Haití,332,0,1,,1,"(3.541112,-76.384584)"
2015,Julio,Haití,332,1,7,,8,"(4.697144,-74.140516)"
2015,Julio,Haití,332,1,7,,8,"(6.171601,-75.427454)"
2015,Julio,Haití,332,2,1,,3,"(7.128456,-73.183637)"
2015,Julio,Honduras,340,1,2,,3,"(10.445761,-75.516429)"
2015,Julio,Honduras,340,2,4,,6,"(10.886611,-74.776708)"
2015,Julio,Honduras,340,0,14,,14,"(12.5744111,-81.703935)"
2015,Julio,Honduras,340,0,3,,3,"(12.586067,-81.702563)"
2015,Julio,Honduras,340,23,34,,57,"(3.541112,-76.384584)"
2015,Julio,Honduras,340,78,159,,237,"(4.697144,-74.140516)"
2015,Julio,Honduras,340,35,62,,97,"(6.171601,-75.427454)"
2015,Julio,Honduras,340,1,3,,4,"(7.128456,-73.183637)"
2015,Julio,Hong Kong,344,0,1,,1,"(12.586067,-81.702563)"
2015,Julio,Hong Kong,344,3,3,,6,"(3.541112,-76.384584)"
2015,Julio,Hong Kong,344,15,30,,45,"(4.697144,-74.140516)"
2015,Julio,Hong Kong,344,1,2,,3,"(6.171601,-75.427454)"
2015,Julio,Hungría,348,2,3,,5,"(3.541112,-76.384584)"
2015,Julio,Hungría,348,4,4,,8,"(4.697144,-74.140516)"
2015,Julio,India,356,1,0,,1,"(10.445761,-75.516429)"
2015,Julio,India,356,2,2,,4,"(3.541112,-76.384584)"
2015,Julio,India,356,37,36,,73,"(4.697144,-74.140516)"
2015,Julio,India,356,3,2,,5,"(6.171601,-75.427454)"
2015,Julio,Indonesia,360,1,0,,1,"(3.541112,-76.384584)"
2015,Julio,Indonesia,360,13,18,,31,"(4.697144,-74.140516)"
2015,Julio,Indonesia,360,0,2,,2,"(6.171601,-75.427454)"
2015,Julio,Iraq,368,1,17,,18,"(4.697144,-74.140516)"
2015,Julio,Irán,364,1,4,,5,"(4.697144,-74.140516)"
2015,Julio,República de Irlanda,372,6,9,,15,"(4.697144,-74.140516)"
2015,Julio,República de Irlanda,372,1,0,,1,"(6.171601,-75.427454)"
2015,Julio,Islandia,352,2,1,,3,"(4.697144,-74.140516)"
2015,Julio,Isla de Man,833,1,0,,1,"(4.697144,-74.140516)"
2015,Julio,Israel,376,10,6,,16,"(3.541112,-76.384584)"
2015,Julio,Israel,376,101,91,,192,"(4.697144,-74.140516)"
2015,Julio,Israel,376,8,3,,11,"(6.171601,-75.427454)"
2015,Julio,Italia,380,1,2,,3,"(10.445761,-75.516429)"
2015,Julio,Italia,380,6,4,,10,"(10.886611,-74.776708)"
2015,Julio,Italia,380,184,77,,261,"(3.541112,-76.384584)"
2015,Julio,Italia,380,600,412,,1012,"(4.697144,-74.140516)"
2015,Julio,Italia,380,1,3,,4,"(4.815061,-75.736532)"
2015,Julio,Italia,380,68,43,,111,"(6.171601,-75.427454)"
2015,Julio,Jamaica,388,6,4,,10,"(10.445761,-75.516429)"
2015,Julio,Jamaica,388,0,6,,6,"(10.886611,-74.776708)"
2015,Julio,Jamaica,388,3,1,,4,"(12.586067,-81.702563)"
2015,Julio,Jamaica,388,13,4,,17,"(3.541112,-76.384584)"
2015,Julio,Jamaica,388,12,20,,32,"(4.697144,-74.140516)"
2015,Julio,Jamaica,388,2,2,,4,"(4.815061,-75.736532)"
2015,Julio,Jamaica,388,0,4,,4,"(6.171601,-75.427454)"
2015,Julio,Jamaica,388,3,2,,5,"(7.128456,-73.183637)"
2015,Julio,Japón,392,4,3,,7,"(3.541112,-76.384584)"
2015,Julio,Japón,392,63,87,,150,"(4.697144,-74.140516)"
2015,Julio,Japón,392,1,1,,2,"(6.171601,-75.427454)"
2015,Julio,Jordania,400,11,13,,24,"(4.697144,-74.140516)"
2015,Julio,Kazajistán,398,0,5,,5,"(4.697144,-74.140516)"
2015,Julio,Kazajistán,398,0,1,,1,"(6.171601,-75.427454)"
2015,Julio,Kenia,404,1,3,,4,"(4.697144,-74.140516)"
2015,Julio,Kuwait,414,4,1,,5,"(4.697144,-74.140516)"
2015,Julio,Kuwait,414,1,0,,1,"(6.171601,-75.427454)"
2015,Julio,República Democrática Popular  Lao,418,0,3,,3,"(4.697144,-74.140516)"
2015,Julio,Lituania,440,0,1,,1,"(4.697144,-74.140516)"
2015,Julio,Líbano,422,0,2,,2,"(10.408582,-75.538003)"
2015,Julio,Líbano,422,1,1,,2,"(10.886611,-74.776708)"
2015,Julio,Líbano,422,1,2,,3,"(12.586067,-81.702563)"
2015,Julio,Líbano,422,1,2,,3,"(3.541112,-76.384584)"
2015,Julio,Líbano,422,63,76,,139,"(4.697144,-74.140516)"
2015,Julio,Liberia,430,0,2,,2,"(4.697144,-74.140516)"
2015,Julio,Luxemburgo,442,3,3,,6,"(4.697144,-74.140516)"
2015,Julio,Malasia,458,11,13,,24,"(4.697144,-74.140516)"
2015,Julio,Malasia,458,4,2,,6,"(6.171601,-75.427454)"
2015,Julio,Malawi,454,0,1,,1,"(4.697144,-74.140516)"
2015,Julio,Malí,466,0,1,,1,"(4.697144,-74.140516)"
2015,Julio,Malta,470,0,1,,1,"(3.541112,-76.384584)"
2015,Julio,Malta,470,15,9,,24,"(4.697144,-74.140516)"
2015,Julio,Malta,470,1,0,,1,"(6.171601,-75.427454)"
2015,Julio,Marruecos,504,1,0,,1,"(3.541112,-76.384584)"
2015,Julio,Marruecos,504,11,3,,14,"(4.697144,-74.140516)"
2015,Julio,Mauritania,478,0,1,,1,"(4.697144,-74.140516)"
2015,Julio,Martinica/Departamento de Ultramar Francés,474,1,2,,3,"(4.697144,-74.140516)"
2015,Julio,México,484,0,2,,2,"(0.814836,-77.662532)"
2015,Julio,México,484,62,52,,114,"(10.445761,-75.516429)"
2015,Julio,México,484,160,126,,286,"(10.886611,-74.776708)"
2015,Julio,México,484,6,11,,17,"(12.586067,-81.702563)"
2015,Julio,México,484,827,644,,1471,"(3.541112,-76.384584)"
2015,Julio,México,484,13282,11755,,25037,"(4.697144,-74.140516)"
2015,Julio,México,484,164,128,,292,"(4.815061,-75.736532)"
2015,Julio,México,484,1888,1543,,3431,"(6.171601,-75.427454)"
2015,Julio,México,484,184,115,,299,"(7.128456,-73.183637)"
2015,Julio,México,484,37,31,,68,"(7.927209,-72.507910)"
2015,Julio,Mónaco,492,3,1,,4,"(4.697144,-74.140516)"
2015,Julio,Mozambique,508,5,3,,8,"(4.697144,-74.140516)"
2015,Julio,Myanmar,104,1,0,,1,"(4.815061,-75.736532)"
2015,Julio,Nauru,520,0,1,,1,"(4.697144,-74.140516)"
2015,Julio,Nicaragua,558,1,4,,5,"(10.886611,-74.776708)"
2015,Julio,Nicaragua,558,2,1,,3,"(12.5744111,-81.703935)"
2015,Julio,Nicaragua,558,15,29,,44,"(3.541112,-76.384584)"
2015,Julio,Nicaragua,558,34,74,,108,"(4.697144,-74.140516)"
2015,Julio,Nicaragua,558,1,4,,5,"(4.815061,-75.736532)"
2015,Julio,Nicaragua,558,13,31,,44,"(6.171601,-75.427454)"
2015,Julio,Nicaragua,558,1,2,,3,"(7.128456,-73.183637)"
2015,Julio,Nicaragua,558,2,1,,3,"(7.927209,-72.507910)"
2015,Julio,Nigeria,566,0,9,,9,"(4.697144,-74.140516)"
2015,Julio,Noruega,578,2,0,,2,"(10.886611,-74.776708)"
2015,Julio,Noruega,578,6,3,,9,"(3.541112,-76.384584)"
2015,Julio,Noruega,578,40,27,,67,"(4.697144,-74.140516)"
2015,Julio,Noruega,578,6,4,,10,"(6.171601,-75.427454)"
2015,Julio,Noruega,578,1,0,,1,"(7.128456,-73.183637)"
2015,Julio,Nueva Caledonia/Territorio francés,540,0,1,,1,"(6.171601,-75.427454)"
2015,Julio,Nueva Zelanda,554,0,1,,1,"(10.886611,-74.776708)"
2015,Julio,Nueva Zelanda,554,0,1,,1,"(3.541112,-76.384584)"
2015,Julio,Nueva Zelanda,554,24,18,,42,"(4.697144,-74.140516)"
2015,Julio,Nueva Zelanda,554,0,1,,1,"(4.815061,-75.736532)"
2015,Julio,Nueva Zelanda,554,6,6,,12,"(6.171601,-75.427454)"
2015,Julio,Omán,512,9,10,,19,"(4.697144,-74.140516)"
2015,Julio,Panamá,591,12,53,,65,"(10.408582,-75.538003)"
2015,Julio,Panamá,591,331,304,,635,"(10.445761,-75.516429)"
2015,Julio,Panamá,591,916,924,,1840,"(10.886611,-74.776708)"
2015,Julio,Panamá,591,0,2,,2,"(11.247723,-74.213989)"
2015,Julio,Panamá,591,3,7,,10,"(12.5744111,-81.703935)"
2015,Julio,Panamá,591,187,180,,367,"(12.586067,-81.702563)"
2015,Julio,Panamá,591,0,1,,1,"(13.3387613,-81.372937)"
2015,Julio,Panamá,591,2012,1671,,3683,"(3.541112,-76.384584)"
2015,Julio,Panamá,591,9144,9464,,18608,"(4.697144,-74.140516)"
2015,Julio,Panamá,591,508,383,,891,"(4.815061,-75.736532)"
2015,Julio,Panamá,591,3341,3210,,6551,"(6.171601,-75.427454)"
2015,Julio,Panamá,591,0,5,,5,"(6.228046,-77.404104)"
2015,Julio,Panamá,591,2,21,,23,"(7.102626,-77.762647)"
2015,Julio,Panamá,591,260,226,,486,"(7.128456,-73.183637)"
2015,Julio,Panamá,591,179,162,,341,"(7.927209,-72.507910)"
2015,Julio,Panamá,591,0,59,,59,"(8.066966,-76.735404)"
2015,Julio,Panamá,591,54,112,,166,"(8.635765,-77.346578)"
2015,Julio,Paraguay,600,0,3,,3,"(0.814836,-77.662532)"
2015,Julio,Paraguay,600,0,2,,2,"(10.886611,-74.776708)"
2015,Julio,Paraguay,600,2,0,,2,"(12.586067,-81.702563)"
2015,Julio,Paraguay,600,12,20,,32,"(3.541112,-76.384584)"
2015,Julio,Paraguay,600,54,135,,189,"(4.697144,-74.140516)"
2015,Julio,Paraguay,600,2,2,,4,"(4.815061,-75.736532)"
2015,Julio,Paraguay,600,8,12,,20,"(6.171601,-75.427454)"
2015,Julio,Paraguay,600,0,1,,1,"(7.927209,-72.507910)"
2015,Julio,Perú,604,150,140,,290,"(-4.197703,-69.941278)"
2015,Julio,Perú,604,1,2,,3,"(0.25129,-76.875963)"
2015,Julio,Perú,604,91,136,,227,"(0.814836,-77.662532)"
2015,Julio,Perú,604,7,4,,11,"(10.445761,-75.516429)"
2015,Julio,Perú,604,5,13,,18,"(10.886611,-74.776708)"
2015,Julio,Perú,604,1,0,,1,"(12.586067,-81.702563)"
2015,Julio,Perú,604,262,331,,593,"(3.541112,-76.384584)"
2015,Julio,Perú,604,4565,5097,,9662,"(4.697144,-74.140516)"
2015,Julio,Perú,604,1,1,,2,"(4.815061,-75.736532)"
2015,Julio,Perú,604,268,388,,656,"(6.171601,-75.427454)"
2015,Julio,Perú,604,0,2,,2,"(7.128456,-73.183637)"
2015,Julio,Perú,604,1,1,,2,"(7.927209,-72.507910)"
2015,Julio,Polonia,616,1,0,,1,"(10.886611,-74.776708)"
2015,Julio,Polonia,616,12,14,,26,"(4.697144,-74.140516)"
2015,Julio,Polonia,616,1,0,,1,"(6.171601,-75.427454)"
2015,Julio,Portugal,620,8,4,,12,"(3.541112,-76.384584)"
2015,Julio,Portugal,620,195,151,,346,"(4.697144,-74.140516)"
2015,Julio,Portugal,620,1,0,,1,"(4.815061,-75.736532)"
2015,Julio,Portugal,620,4,5,,9,"(6.171601,-75.427454)"
2015,Julio,Puerto Rico/Territorio de Estados Unidos,630,14,31,,45,"(10.445761,-75.516429)"
2015,Julio,Puerto Rico/Territorio de Estados Unidos,630,15,8,,23,"(10.886611,-74.776708)"
2015,Julio,Puerto Rico/Territorio de Estados Unidos,630,0,1,,1,"(12.586067,-81.702563)"
2015,Julio,Puerto Rico/Territorio de Estados Unidos,630,53,24,,77,"(3.541112,-76.384584)"
2015,Julio,Puerto Rico/Territorio de Estados Unidos,630,527,413,,940,"(4.697144,-74.140516)"
2015,Julio,Puerto Rico/Territorio de Estados Unidos,630,13,10,,23,"(4.815061,-75.736532)"
2015,Julio,Puerto Rico/Territorio de Estados Unidos,630,64,30,,94,"(6.171601,-75.427454)"
2015,Julio,Puerto Rico/Territorio de Estados Unidos,630,5,1,,6,"(7.128456,-73.183637)"
2015,Julio,Qatar,634,3,3,,6,"(4.697144,-74.140516)"
2015,Julio,Reino Unido de Gran Bretaña e Irlanda del Norte,826,0,2,,2,"(10.886611,-74.776708)"
2015,Julio,Reino Unido de Gran Bretaña e Irlanda del Norte,826,36,27,,63,"(3.541112,-76.384584)"
2015,Julio,Reino Unido de Gran Bretaña e Irlanda del Norte,826,1983,1650,,3633,"(4.697144,-74.140516)"
2015,Julio,Reino Unido de Gran Bretaña e Irlanda del Norte,826,12,16,,28,"(6.171601,-75.427454)"
2015,Julio,Reino Unido de Gran Bretaña e Irlanda del Norte,826,1,0,,1,"(7.128456,-73.183637)"
2015,Julio,República CentroÁfricana,140,1,2,,3,"(4.697144,-74.140516)"
2015,Julio,República CentroÁfricana,140,0,1,,1,"(6.171601,-75.427454)"
2015,Julio,Federación de Rusia,643,3,8,,11,"(3.541112,-76.384584)"
2015,Julio,Federación de Rusia,643,52,57,,109,"(4.697144,-74.140516)"
2015,Julio,Federación de Rusia,643,6,3,,9,"(6.171601,-75.427454)"
2015,Julio,República Dominicana,214,16,24,,40,"(10.445761,-75.516429)"
2015,Julio,República Dominicana,214,50,63,,113,"(10.886611,-74.776708)"
2015,Julio,República Dominicana,214,17,14,,31,"(11.117806,-74.232622)"
2015,Julio,República Dominicana,214,4,4,,8,"(12.586067,-81.702563)"
2015,Julio,República Dominicana,214,141,132,,273,"(3.541112,-76.384584)"
2015,Julio,República Dominicana,214,2113,2061,,4174,"(4.697144,-74.140516)"
2015,Julio,República Dominicana,214,31,40,,71,"(4.815061,-75.736532)"
2015,Julio,República Dominicana,214,240,209,,449,"(6.171601,-75.427454)"
2015,Julio,República Dominicana,214,30,19,,49,"(7.128456,-73.183637)"
2015,Julio,República Dominicana,214,21,14,,35,"(7.927209,-72.507910)"
2015,Julio,República Democrática Popular de Corea,408,0,2,,2,"(4.697144,-74.140516)"
2015,Julio,Rumania,642,0,1,,1,"(10.886611,-74.776708)"
2015,Julio,Rumania,642,4,3,,7,"(4.697144,-74.140516)"
2015,Julio,Rwanda,646,0,1,,1,"(4.697144,-74.140516)"
2015,Julio,San  Vicente y las Granadinas,670,1,0,,1,"(12.586067,-81.702563)"
2015,Julio,Santa Lucia,662,0,1,,1,"(4.697144,-74.140516)"
2015,Julio,Santo Tomé y Príncipe,678,2,0,,2,"(4.815061,-75.736532)"
2015,Julio,Senegal,686,1,1,,2,"(4.697144,-74.140516)"
2015,Julio,Serbia,688,1,1,,2,"(4.697144,-74.140516)"
2015,Julio,Seychelles,690,1,0,,1,"(4.697144,-74.140516)"
2015,Julio,Sierra Leona,694,0,1,,1,"(3.541112,-76.384584)"
2015,Julio,Singapur,702,1,0,,1,"(3.541112,-76.384584)"
2015,Julio,Singapur,702,15,21,,36,"(4.697144,-74.140516)"
2015,Julio,Singapur,702,1,1,,2,"(6.171601,-75.427454)"
2015,Julio,República Árabe Siria,760,0,1,,1,"(7.128456,-73.183637)"
2015,Julio,Sri Lanka,144,1,0,,1,"(4.697144,-74.140516)"
2015,Julio,Sudáfrica,710,15,16,,31,"(4.697144,-74.140516)"
2015,Julio,Sudáfrica,710,0,1,,1,"(6.171601,-75.427454)"
2015,Julio,Suecia,752,2,1,,3,"(10.886611,-74.776708)"
2015,Julio,Suecia,752,27,21,,48,"(3.541112,-76.384584)"
2015,Julio,Suecia,752,104,97,,201,"(4.697144,-74.140516)"
2015,Julio,Suecia,752,9,8,,17,"(6.171601,-75.427454)"
2015,Julio,Suiza,756,1,0,,1,"(10.886611,-74.776708)"
2015,Julio,Suiza,756,76,34,,110,"(3.541112,-76.384584)"
2015,Julio,Suiza,756,278,175,,453,"(4.697144,-74.140516)"
2015,Julio,Suiza,756,0,1,,1,"(4.815061,-75.736532)"
2015,Julio,Suiza,756,22,13,,35,"(6.171601,-75.427454)"
2015,Julio,Surinam,740,3,9,,12,"(4.697144,-74.140516)"
2015,Julio,Surinam,740,3,4,,7,"(6.171601,-75.427454)"
2015,Julio,Taiwán,158,0,1,,1,"(3.541112,-76.384584)"
2015,Julio,Taiwán,158,1,1,,2,"(4.697144,-74.140516)"
2015,Julio,Tailandia,764,0,2,,2,"(3.541112,-76.384584)"
2015,Julio,Tailandia,764,11,26,,37,"(4.697144,-74.140516)"
2015,Julio,Tailandia,764,1,1,,2,"(4.815061,-75.736532)"
2015,Julio,Tailandia,764,0,1,,1,"(6.171601,-75.427454)"
2015,Julio,Trinidad y Tobago,780,5,2,,7,"(10.445761,-75.516429)"
2015,Julio,Trinidad y Tobago,780,3,2,,5,"(10.886611,-74.776708)"
2015,Julio,Trinidad y Tobago,780,10,6,,16,"(3.541112,-76.384584)"
2015,Julio,Trinidad y Tobago,780,18,32,,50,"(4.697144,-74.140516)"
2015,Julio,Trinidad y Tobago,780,3,2,,5,"(4.815061,-75.736532)"
2015,Julio,Trinidad y Tobago,780,13,13,,26,"(6.171601,-75.427454)"
2015,Julio,Trinidad y Tobago,780,5,3,,8,"(7.128456,-73.183637)"
2015,Julio,Trinidad y Tobago,780,2,2,,4,"(7.927209,-72.507910)"
2015,Julio,Túnez,788,1,0,,1,"(4.697144,-74.140516)"
2015,Julio,Turquía,792,5,6,,11,"(3.541112,-76.384584)"
2015,Julio,Turquía,792,130,95,,225,"(4.697144,-74.140516)"
2015,Julio,Turquía,792,0,2,,2,"(6.171601,-75.427454)"
2015,Julio,Ucrania,804,0,2,,2,"(4.697144,-74.140516)"
2015,Julio,Uruguay,858,0,1,,1,"(0.814836,-77.662532)"
2015,Julio,Uruguay,858,1,0,,1,"(10.445761,-75.516429)"
2015,Julio,Uruguay,858,14,6,,20,"(3.541112,-76.384584)"
2015,Julio,Uruguay,858,62,66,,128,"(4.697144,-74.140516)"
2015,Julio,Uruguay,858,8,7,,15,"(6.171601,-75.427454)"
2015,Julio,Venezuela,862,39,29,,68,"(10.445761,-75.516429)"
2015,Julio,Venezuela,862,7,22,,29,"(10.886611,-74.776708)"
2015,Julio,Venezuela,862,1,2,,3,"(11.117806,-74.232622)"
2015,Julio,Venezuela,862,12658,10794,,23452,"(11.360009,-72.129330)"
2015,Julio,Venezuela,862,8,30,,38,"(3.541112,-76.384584)"
2015,Julio,Venezuela,862,29,37,,66,"(3.866713,-67.927521)"
2015,Julio,Venezuela,862,1064,1376,,2440,"(4.697144,-74.140516)"
2015,Julio,Venezuela,862,1,1,,2,"(4.815061,-75.736532)"
2015,Julio,Venezuela,862,89,129,,218,"(6.171601,-75.427454)"
2015,Julio,Venezuela,862,271,255,,526,"(6.185799,-67.483929)"
2015,Julio,Venezuela,862,1797,1516,,3313,"(7.088729,-70.740253)"
2015,Julio,Venezuela,862,5,6,,11,"(7.128456,-73.183637)"
2015,Julio,Venezuela,862,9932,8818,,18750,"(7.818934,-72.453226)"
2015,Julio,Vietnam,704,1,1,,2,"(3.541112,-76.384584)"
2015,Julio,Vietnam,704,5,7,,12,"(4.697144,-74.140516)"
2015,Julio,Islas Vírgenes Británicas/Territorio Británico de Ultramar,92,1,1,,2,"(3.541112,-76.384584)"
2015,Julio,Islas Vírgenes Británicas/Territorio Británico de Ultramar,92,1,0,,1,"(4.697144,-74.140516)"
2015,Julio,Islas Vírgenes Estadounidenses/Territorio de Estados Unidos,850,2,2,,4,"(4.697144,-74.140516)"
2015,Julio,Desconocido,99999,7,7,,14,"(0.812436,-77.847006)"
2015,Julio,Desconocido,99999,1,2,,3,"(12.5744111,-81.703935)"
2015,Julio,Desconocido,99999,318,866,,1184,"(4.697144,-74.140516)"
2015,Agosto,Afganistán,4,0,2,,2,"(4.697144,-74.140516)"
2015,Agosto,Albania,8,0,1,,1,"(4.697144,-74.140516)"
2015,Agosto,Alemania,276,5,6,,11,"(10.886611,-74.776708)"
2015,Agosto,Alemania,276,85,46,,131,"(3.541112,-76.384584)"
2015,Agosto,Alemania,276,1068,897,,1965,"(4.697144,-74.140516)"
2015,Agosto,Alemania,276,2,0,,2,"(4.815061,-75.736532)"
2015,Agosto,Alemania,276,43,24,,67,"(6.171601,-75.427454)"
2015,Agosto,Andorra,20,0,1,,1,"(4.697144,-74.140516)"
2015,Agosto,Andorra,20,0,4,,4,"(6.171601,-75.427454)"
2015,Agosto,Angola,24,5,11,,16,"(4.697144,-74.140516)"
2015,Agosto,Antigua y Barbuda,28,3,3,,6,"(4.697144,-74.140516)"
2015,Agosto,Antigua y Barbuda,28,0,1,,1,"(6.171601,-75.427454)"
2015,Agosto,Países Bajos,528,9,4,,13,"(10.445761,-75.516429)"
2015,Agosto,Países Bajos,528,157,77,,234,"(10.886611,-74.776708)"
2015,Agosto,Países Bajos,528,220,127,,347,"(3.541112,-76.384584)"
2015,Agosto,Países Bajos,528,931,820,,1751,"(4.697144,-74.140516)"
2015,Agosto,Países Bajos,528,11,6,,17,"(4.815061,-75.736532)"
2015,Agosto,Países Bajos,528,262,144,,406,"(6.171601,-75.427454)"
2015,Agosto,Países Bajos,528,2,2,,4,"(7.128456,-73.183637)"
2015,Agosto,Países Bajos,528,0,2,,2,"(7.927209,-72.507910)"
2015,Agosto,Arabia Saudita,682,1,0,,1,"(3.541112,-76.384584)"
2015,Agosto,Arabia Saudita,682,25,48,,73,"(4.697144,-74.140516)"
2015,Agosto,Arabia Saudita,682,0,1,,1,"(4.815061,-75.736532)"
2015,Agosto,Arabia Saudita,682,3,2,,5,"(6.171601,-75.427454)"
2015,Agosto,Arabia Saudita,682,0,3,,3,"(7.128456,-73.183637)"
2015,Agosto,Argelia,12,3,8,,11,"(4.697144,-74.140516)"
2015,Agosto,Argentina,32,9,19,,28,"(0.814836,-77.662532)"
2015,Agosto,Argentina,32,8,9,,17,"(10.445761,-75.516429)"
2015,Agosto,Argentina,32,11,11,,22,"(10.886611,-74.776708)"
2015,Agosto,Argentina,32,4,1,,5,"(12.586067,-81.702563)"
2015,Agosto,Argentina,32,143,118,,261,"(3.541112,-76.384584)"
2015,Agosto,Argentina,32,2398,2280,,4678,"(4.697144,-74.140516)"
2015,Agosto,Argentina,32,15,17,,32,"(4.815061,-75.736532)"
2015,Agosto,Argentina,32,152,177,,329,"(6.171601,-75.427454)"
2015,Agosto,Argentina,32,5,5,,10,"(7.128456,-73.183637)"
2015,Agosto,Argentina,32,1,2,,3,"(7.927209,-72.507910)"
2015,Agosto,República de Armenia,51,0,1,,1,"(4.697144,-74.140516)"
2015,Agosto,Aruba,533,1,0,,1,"(10.445761,-75.516429)"
2015,Agosto,Aruba,533,28,16,,44,"(10.886611,-74.776708)"
2015,Agosto,Aruba,533,0,4,,4,"(11.247723,-74.213989)"
2015,Agosto,Aruba,533,24,21,,45,"(3.541112,-76.384584)"
2015,Agosto,Aruba,533,1767,1364,,3131,"(4.697144,-74.140516)"
2015,Agosto,Aruba,533,13,5,,18,"(4.815061,-75.736532)"
2015,Agosto,Aruba,533,141,89,,230,"(6.171601,-75.427454)"
2015,Agosto,Aruba,533,17,26,,43,"(7.128456,-73.183637)"
2015,Agosto,Aruba,533,5,4,,9,"(7.927209,-72.507910)"
2015,Agosto,Australia,36,1,1,,2,"(10.445761,-75.516429)"
2015,Agosto,Australia,36,3,1,,4,"(10.886611,-74.776708)"
2015,Agosto,Australia,36,14,5,,19,"(3.541112,-76.384584)"
2015,Agosto,Australia,36,190,147,,337,"(4.697144,-74.140516)"
2015,Agosto,Australia,36,30,26,,56,"(6.171601,-75.427454)"
2015,Agosto,Australia,36,0,1,,1,"(7.128456,-73.183637)"
2015,Agosto,Australia,36,1,0,,1,"(7.927209,-72.507910)"
2015,Agosto,Austria,40,1,0,,1,"(3.541112,-76.384584)"
2015,Agosto,Austria,40,57,46,,103,"(4.697144,-74.140516)"
2015,Agosto,Austria,40,7,0,,7,"(6.171601,-75.427454)"
2015,Agosto,Azerbaiyán,31,4,5,,9,"(4.697144,-74.140516)"
2015,Agosto,Azerbaiyán,31,0,1,,1,"(4.815061,-75.736532)"
2015,Agosto,Bahamas,44,1,0,,1,"(10.445761,-75.516429)"
2015,Agosto,Bahamas,44,11,5,,16,"(10.886611,-74.776708)"
2015,Agosto,Bahamas,44,0,1,,1,"(12.586067,-81.702563)"
2015,Agosto,Bahamas,44,14,8,,22,"(3.541112,-76.384584)"
2015,Agosto,Bahamas,44,12,17,,29,"(4.697144,-74.140516)"
2015,Agosto,Bahamas,44,1,2,,3,"(4.815061,-75.736532)"
2015,Agosto,Bahamas,44,3,9,,12,"(6.171601,-75.427454)"
2015,Agosto,Bahamas,44,2,0,,2,"(7.128456,-73.183637)"
2015,Agosto,Bahamas,44,2,0,,2,"(7.927209,-72.507910)"
2015,Agosto,Bahréin,48,2,6,,8,"(4.697144,-74.140516)"
2015,Agosto,Bahréin,48,1,0,,1,"(7.818934,-72.453226)"
2015,Agosto,Barbados,52,0,2,,2,"(4.697144,-74.140516)"
2015,Agosto,Bélgica,56,1,0,,1,"(10.445761,-75.516429)"
2015,Agosto,Bélgica,56,29,26,,55,"(3.541112,-76.384584)"
2015,Agosto,Bélgica,56,161,107,,268,"(4.697144,-74.140516)"
2015,Agosto,Bélgica,56,40,24,,64,"(6.171601,-75.427454)"
2015,Agosto,Belice,84,0,1,,1,"(10.886611,-74.776708)"
2015,Agosto,Belice,84,1,1,,2,"(3.541112,-76.384584)"
2015,Agosto,Belice,84,6,9,,15,"(4.697144,-74.140516)"
2015,Agosto,Belice,84,3,3,,6,"(6.171601,-75.427454)"
2015,Agosto,Benín,204,1,2,,3,"(4.697144,-74.140516)"
2015,Agosto,Bermudas/Territorio Británico de Ultramar,60,4,0,,4,"(4.697144,-74.140516)"
2015,Agosto,Bolivia,68,6,5,,11,"(0.814836,-77.662532)"
2015,Agosto,Bolivia,68,1,1,,2,"(10.445761,-75.516429)"
2015,Agosto,Bolivia,68,1,7,,8,"(10.886611,-74.776708)"
2015,Agosto,Bolivia,68,42,59,,101,"(3.541112,-76.384584)"
2015,Agosto,Bolivia,68,280,448,,728,"(4.697144,-74.140516)"
2015,Agosto,Bolivia,68,5,4,,9,"(4.815061,-75.736532)"
2015,Agosto,Bolivia,68,35,53,,88,"(6.171601,-75.427454)"
2015,Agosto,Bolivia,68,4,4,,8,"(7.128456,-73.183637)"
2015,Agosto,Bosnia y Herzegovina,70,0,1,,1,"(4.697144,-74.140516)"
2015,Agosto,Brasil,76,102,216,,318,"(-4.197703,-69.941278)"
2015,Agosto,Brasil,76,3,3,,6,"(-4.223468,-69.945098)"
2015,Agosto,Brasil,76,9,7,,16,"(10.445761,-75.516429)"
2015,Agosto,Brasil,76,3,4,,7,"(10.886611,-74.776708)"
2015,Agosto,Brasil,76,1,2,,3,"(12.586067,-81.702563)"
2015,Agosto,Brasil,76,52,86,,138,"(3.541112,-76.384584)"
2015,Agosto,Brasil,76,3012,3977,,6989,"(4.697144,-74.140516)"
2015,Agosto,Brasil,76,11,13,,24,"(4.815061,-75.736532)"
2015,Agosto,Brasil,76,86,125,,211,"(6.171601,-75.427454)"
2015,Agosto,Brasil,76,2,2,,4,"(7.128456,-73.183637)"
2015,Agosto,Brasil,76,2,4,,6,"(7.927209,-72.507910)"
2015,Agosto,Bulgaria,100,1,0,,1,"(4.697144,-74.140516)"
2015,Agosto,Cabo Verde,132,0,1,,1,"(4.697144,-74.140516)"
2015,Agosto,Cabo Verde,132,0,1,,1,"(4.815061,-75.736532)"
2015,Agosto,Islas Caimán/Territorio Británico de Ultramar,136,1,0,,1,"(10.445761,-75.516429)"
2015,Agosto,Islas Caimán/Territorio Británico de Ultramar,136,7,1,,8,"(12.586067,-81.702563)"
2015,Agosto,Islas Caimán/Territorio Británico de Ultramar,136,0,1,,1,"(3.541112,-76.384584)"
2015,Agosto,Islas Caimán/Territorio Británico de Ultramar,136,2,0,,2,"(4.697144,-74.140516)"
2015,Agosto,Islas Caimán/Territorio Británico de Ultramar,136,1,0,,1,"(4.815061,-75.736532)"
2015,Agosto,Islas Caimán/Territorio Británico de Ultramar,136,1,0,,1,"(6.171601,-75.427454)"
2015,Agosto,Camboya,116,1,0,,1,"(10.886611,-74.776708)"
2015,Agosto,Camboya,116,1,1,,2,"(4.697144,-74.140516)"
2015,Agosto,Camerún,120,1,1,,2,"(4.697144,-74.140516)"
2015,Agosto,Canadá,124,42,28,,70,"(10.445761,-75.516429)"
2015,Agosto,Canadá,124,53,58,,111,"(10.886611,-74.776708)"
2015,Agosto,Canadá,124,202,154,,356,"(3.541112,-76.384584)"
2015,Agosto,Canadá,124,6,3,,9,"(4.452882,-75.766298)"
2015,Agosto,Canadá,124,2104,1742,,3846,"(4.697144,-74.140516)"
2015,Agosto,Canadá,124,23,14,,37,"(4.815061,-75.736532)"
2015,Agosto,Canadá,124,346,228,,574,"(6.171601,-75.427454)"
2015,Agosto,Canadá,124,31,16,,47,"(7.128456,-73.183637)"
2015,Agosto,Canadá,124,6,4,,10,"(7.927209,-72.507910)"
2015,Agosto,Chad,148,0,1,,1,"(4.697144,-74.140516)"
2015,Agosto,España,724,12,4,,16,"(10.445761,-75.516429)"
2015,Agosto,España,724,13,6,,19,"(10.886611,-74.776708)"
2015,Agosto,España,724,2086,1331,,3417,"(3.541112,-76.384584)"
2015,Agosto,España,724,6986,4792,,11778,"(4.697144,-74.140516)"
2015,Agosto,España,724,23,23,,46,"(4.815061,-75.736532)"
2015,Agosto,España,724,1159,708,,1867,"(6.171601,-75.427454)"
2015,Agosto,España,724,9,13,,22,"(7.128456,-73.183637)"
2015,Agosto,España,724,2,0,,2,"(7.927209,-72.507910)"
2015,Agosto,Colombia,170,0,1,,1,"(11.360009,-72.129330)"
2015,Agosto,Colombia,170,84,274,,358,"(4.697144,-74.140516)"
2015,Agosto,República Del Congo,178,0,2,,2,"(4.697144,-74.140516)"
2015,Agosto,República Democrática del Congo,180,0,3,,3,"(4.697144,-74.140516)"
2015,Agosto,República de Corea,410,3,4,,7,"(3.541112,-76.384584)"
2015,Agosto,República de Corea,410,16,33,,49,"(4.697144,-74.140516)"
2015,Agosto,República de Corea,410,1,4,,5,"(6.171601,-75.427454)"
2015,Agosto,Costa de Marfil,384,5,4,,9,"(4.697144,-74.140516)"
2015,Agosto,Costa de Marfil,384,0,1,,1,"(6.171601,-75.427454)"
2015,Agosto,Costa Rica,188,7,5,,12,"(10.445761,-75.516429)"
2015,Agosto,Costa Rica,188,15,24,,39,"(10.886611,-74.776708)"
2015,Agosto,Costa Rica,188,3,21,,24,"(12.5744111,-81.703935)"
2015,Agosto,Costa Rica,188,10,15,,25,"(12.586067,-81.702563)"
2015,Agosto,Costa Rica,188,31,30,,61,"(3.541112,-76.384584)"
2015,Agosto,Costa Rica,188,891,1044,,1935,"(4.697144,-74.140516)"
2015,Agosto,Costa Rica,188,7,7,,14,"(4.815061,-75.736532)"
2015,Agosto,Costa Rica,188,96,79,,175,"(6.171601,-75.427454)"
2015,Agosto,Costa Rica,188,3,5,,8,"(7.128456,-73.183637)"
2015,Agosto,Costa Rica,188,2,1,,3,"(7.927209,-72.507910)"
2015,Agosto,Croacia,191,6,3,,9,"(4.697144,-74.140516)"
2015,Agosto,Cuba,192,12,16,,28,"(10.445761,-75.516429)"
2015,Agosto,Cuba,192,19,19,,38,"(10.886611,-74.776708)"
2015,Agosto,Cuba,192,6,1,,7,"(12.586067,-81.702563)"
2015,Agosto,Cuba,192,98,92,,190,"(3.541112,-76.384584)"
2015,Agosto,Cuba,192,938,828,,1766,"(4.697144,-74.140516)"
2015,Agosto,Cuba,192,9,11,,20,"(4.815061,-75.736532)"
2015,Agosto,Cuba,192,136,103,,239,"(6.171601,-75.427454)"
2015,Agosto,Cuba,192,11,7,,18,"(7.128456,-73.183637)"
2015,Agosto,Curazao,99999,7,38,,45,"(4.697144,-74.140516)"
2015,Agosto,República Checa,203,4,3,,7,"(4.697144,-74.140516)"
2015,Agosto,Chile,152,0,1,,1,"(0.25129,-76.875963)"
2015,Agosto,Chile,152,138,122,,260,"(0.814836,-77.662532)"
2015,Agosto,Chile,152,10,10,,20,"(10.445761,-75.516429)"
2015,Agosto,Chile,152,12,19,,31,"(10.886611,-74.776708)"
2015,Agosto,Chile,152,268,200,,468,"(3.541112,-76.384584)"
2015,Agosto,Chile,152,3231,3010,,6241,"(4.697144,-74.140516)"
2015,Agosto,Chile,152,57,49,,106,"(4.815061,-75.736532)"
2015,Agosto,Chile,152,131,105,,236,"(6.171601,-75.427454)"
2015,Agosto,Chile,152,9,12,,21,"(7.128456,-73.183637)"
2015,Agosto,Chile,152,4,3,,7,"(7.927209,-72.507910)"
2015,Agosto,China,156,2,5,,7,"(10.886611,-74.776708)"
2015,Agosto,China,156,20,23,,43,"(3.541112,-76.384584)"
2015,Agosto,China,156,171,369,,540,"(4.697144,-74.140516)"
2015,Agosto,China,156,1,2,,3,"(4.815061,-75.736532)"
2015,Agosto,China,156,25,46,,71,"(6.171601,-75.427454)"
2015,Agosto,China,156,0,1,,1,"(7.128456,-73.183637)"
2015,Agosto,Chipre,196,0,1,,1,"(4.697144,-74.140516)"
2015,Agosto,Dinamarca,208,1,0,,1,"(10.445761,-75.516429)"
2015,Agosto,Dinamarca,208,3,2,,5,"(3.541112,-76.384584)"
2015,Agosto,Dinamarca,208,44,33,,77,"(4.697144,-74.140516)"
2015,Agosto,Dinamarca,208,1,0,,1,"(6.171601,-75.427454)"
2015,Agosto,Dominica,212,1,3,,4,"(4.697144,-74.140516)"
2015,Agosto,Dominica,212,0,1,,1,"(7.927209,-72.507910)"
2015,Agosto,Ecuador,218,823,1119,,1942,"(0.25129,-76.875963)"
2015,Agosto,Ecuador,218,24,34,,58,"(0.812436,-77.847006)"
2015,Agosto,Ecuador,218,6515,7609,,14124,"(0.814836,-77.662532)"
2015,Agosto,Ecuador,218,166,173,,339,"(1.813928,-78.763924)"
2015,Agosto,Ecuador,218,6,6,,12,"(10.445761,-75.516429)"
2015,Agosto,Ecuador,218,9,13,,22,"(10.886611,-74.776708)"
2015,Agosto,Ecuador,218,1,1,,2,"(12.586067,-81.702563)"
2015,Agosto,Ecuador,218,385,463,,848,"(3.541112,-76.384584)"
2015,Agosto,Ecuador,218,2416,3867,,6283,"(4.697144,-74.140516)"
2015,Agosto,Ecuador,218,7,3,,10,"(4.815061,-75.736532)"
2015,Agosto,Ecuador,218,40,79,,119,"(6.171601,-75.427454)"
2015,Agosto,Ecuador,218,0,3,,3,"(7.128456,-73.183637)"
2015,Agosto,Ecuador,218,1,0,,1,"(7.927209,-72.507910)"
2015,Agosto,Egipto,818,2,0,,2,"(3.541112,-76.384584)"
2015,Agosto,Egipto,818,12,11,,23,"(4.697144,-74.140516)"
2015,Agosto,Egipto,818,1,0,,1,"(6.171601,-75.427454)"
2015,Agosto,El Salvador,222,1,2,,3,"(10.445761,-75.516429)"
2015,Agosto,El Salvador,222,4,3,,7,"(10.886611,-74.776708)"
2015,Agosto,El Salvador,222,1,1,,2,"(12.586067,-81.702563)"
2015,Agosto,El Salvador,222,65,88,,153,"(3.541112,-76.384584)"
2015,Agosto,El Salvador,222,721,893,,1614,"(4.697144,-74.140516)"
2015,Agosto,El Salvador,222,70,83,,153,"(6.171601,-75.427454)"
2015,Agosto,El Salvador,222,1,1,,2,"(7.128456,-73.183637)"
2015,Agosto,Emiratos Árabes,784,0,1,,1,"(10.445761,-75.516429)"
2015,Agosto,Emiratos Árabes,784,5,3,,8,"(3.541112,-76.384584)"
2015,Agosto,Emiratos Árabes,784,134,257,,391,"(4.697144,-74.140516)"
2015,Agosto,Emiratos Árabes,784,17,18,,35,"(6.171601,-75.427454)"
2015,Agosto,Eslovaquia,703,0,1,,1,"(4.697144,-74.140516)"
2015,Agosto,Eslovenia,705,2,2,,4,"(4.697144,-74.140516)"
2015,Agosto,Estados Unidos de América,840,0,1,,1,"(10.408582,-75.538003)"
2015,Agosto,Estados Unidos de América,840,3974,3061,,7035,"(10.445761,-75.516429)"
2015,Agosto,Estados Unidos de América,840,3180,2426,,5606,"(10.886611,-74.776708)"
2015,Agosto,Estados Unidos de América,840,0,2,,2,"(11.117806,-74.232622)"
2015,Agosto,Estados Unidos de América,840,33,22,,55,"(12.586067,-81.702563)"
2015,Agosto,Estados Unidos de América,840,6731,4392,,11123,"(3.541112,-76.384584)"
2015,Agosto,Estados Unidos de América,840,596,422,,1018,"(4.452882,-75.766298)"
2015,Agosto,Estados Unidos de América,840,37158,30682,,67840,"(4.697144,-74.140516)"
2015,Agosto,Estados Unidos de América,840,1077,681,,1758,"(4.815061,-75.736532)"
2015,Agosto,Estados Unidos de América,840,10462,7927,,18389,"(6.171601,-75.427454)"
2015,Agosto,Estados Unidos de América,840,291,192,,483,"(7.128456,-73.183637)"
2015,Agosto,Estados Unidos de América,840,110,101,,211,"(7.927209,-72.507910)"
2015,Agosto,Estonia,233,2,2,,4,"(4.697144,-74.140516)"
2015,Agosto,Estonia,233,0,1,,1,"(6.171601,-75.427454)"
2015,Agosto,Etiopia,231,1,3,,4,"(4.697144,-74.140516)"
2015,Agosto,Filipinas,608,0,1,,1,"(3.541112,-76.384584)"
2015,Agosto,Filipinas,608,4,2,,6,"(4.697144,-74.140516)"
2015,Agosto,Finlandia,246,2,0,,2,"(3.541112,-76.384584)"
2015,Agosto,Finlandia,246,10,12,,22,"(4.697144,-74.140516)"
2015,Agosto,Francia,250,6,3,,9,"(10.445761,-75.516429)"
2015,Agosto,Francia,250,5,2,,7,"(10.886611,-74.776708)"
2015,Agosto,Francia,250,243,143,,386,"(3.541112,-76.384584)"
2015,Agosto,Francia,250,2018,1320,,3338,"(4.697144,-74.140516)"
2015,Agosto,Francia,250,4,2,,6,"(4.815061,-75.736532)"
2015,Agosto,Francia,250,117,55,,172,"(6.171601,-75.427454)"
2015,Agosto,Francia,250,4,1,,5,"(7.128456,-73.183637)"
2015,Agosto,Gabón,266,1,3,,4,"(4.697144,-74.140516)"
2015,Agosto,Georgia,268,0,3,,3,"(4.697144,-74.140516)"
2015,Agosto,Ghana,288,6,4,,10,"(4.697144,-74.140516)"
2015,Agosto,Gibraltar/Territorio Británico de Ultramar,292,1,0,,1,"(0.814836,-77.662532)"
2015,Agosto,Gibraltar/Territorio Británico de Ultramar,292,1,1,,2,"(4.697144,-74.140516)"
2015,Agosto,Grecia,300,1,0,,1,"(3.541112,-76.384584)"
2015,Agosto,Grecia,300,21,9,,30,"(4.697144,-74.140516)"
2015,Agosto,Guatemala,320,2,4,,6,"(10.445761,-75.516429)"
2015,Agosto,Guatemala,320,2,3,,5,"(10.886611,-74.776708)"
2015,Agosto,Guatemala,320,4,3,,7,"(12.586067,-81.702563)"
2015,Agosto,Guatemala,320,68,89,,157,"(3.541112,-76.384584)"
2015,Agosto,Guatemala,320,459,602,,1061,"(4.697144,-74.140516)"
2015,Agosto,Guatemala,320,8,8,,16,"(4.815061,-75.736532)"
2015,Agosto,Guatemala,320,79,105,,184,"(6.171601,-75.427454)"
2015,Agosto,Guatemala,320,8,6,,14,"(7.128456,-73.183637)"
2015,Agosto,Guatemala,320,1,2,,3,"(7.927209,-72.507910)"
2015,Agosto,Guyana,328,0,1,,1,"(10.445761,-75.516429)"
2015,Agosto,Guyana,328,5,7,,12,"(10.886611,-74.776708)"
2015,Agosto,Guyana,328,2,2,,4,"(4.697144,-74.140516)"
2015,Agosto,Guyana,328,1,1,,2,"(6.171601,-75.427454)"
2015,Agosto,Guinea,324,1,1,,2,"(4.697144,-74.140516)"
2015,Agosto,Guinea Ecuatorial,226,5,7,,12,"(4.697144,-74.140516)"
2015,Agosto,Guinea Ecuatorial,226,0,1,,1,"(6.171601,-75.427454)"
2015,Agosto,Guadalupe/Territorio Francés,312,1,0,,1,"(3.541112,-76.384584)"
2015,Agosto,Guadalupe/Territorio Francés,312,0,1,,1,"(4.697144,-74.140516)"
2015,Agosto,Guayana Francesa/Departamento de Ultramar Francés,254,3,2,,5,"(4.697144,-74.140516)"
2015,Agosto,Guayana Francesa/Departamento de Ultramar Francés,254,1,0,,1,"(6.171601,-75.427454)"
2015,Agosto,Haití,332,0,2,,2,"(10.445761,-75.516429)"
2015,Agosto,Haití,332,2,2,,4,"(3.541112,-76.384584)"
2015,Agosto,Haití,332,1,6,,7,"(4.697144,-74.140516)"
2015,Agosto,Haití,332,4,2,,6,"(6.171601,-75.427454)"
2015,Agosto,Haití,332,0,2,,2,"(7.128456,-73.183637)"
2015,Agosto,Honduras,340,0,1,,1,"(10.445761,-75.516429)"
2015,Agosto,Honduras,340,4,7,,11,"(10.886611,-74.776708)"
2015,Agosto,Honduras,340,2,3,,5,"(12.586067,-81.702563)"
2015,Agosto,Honduras,340,13,32,,45,"(3.541112,-76.384584)"
2015,Agosto,Honduras,340,79,193,,272,"(4.697144,-74.140516)"
2015,Agosto,Honduras,340,1,5,,6,"(4.815061,-75.736532)"
2015,Agosto,Honduras,340,32,73,,105,"(6.171601,-75.427454)"
2015,Agosto,Honduras,340,3,0,,3,"(7.128456,-73.183637)"
2015,Agosto,Hong Kong,344,36,54,,90,"(4.697144,-74.140516)"
2015,Agosto,Hong Kong,344,5,4,,9,"(6.171601,-75.427454)"
2015,Agosto,Hong Kong,344,1,1,,2,"(7.128456,-73.183637)"
2015,Agosto,Hungría,348,9,10,,19,"(4.697144,-74.140516)"
2015,Agosto,India,356,0,1,,1,"(10.886611,-74.776708)"
2015,Agosto,India,356,0,1,,1,"(3.541112,-76.384584)"
2015,Agosto,India,356,36,37,,73,"(4.697144,-74.140516)"
2015,Agosto,India,356,3,2,,5,"(6.171601,-75.427454)"
2015,Agosto,Indonesia,360,0,1,,1,"(10.445761,-75.516429)"
2015,Agosto,Indonesia,360,1,0,,1,"(10.886611,-74.776708)"
2015,Agosto,Indonesia,360,11,6,,17,"(4.697144,-74.140516)"
2015,Agosto,Indonesia,360,1,3,,4,"(6.171601,-75.427454)"
2015,Agosto,Iraq,368,1,6,,7,"(4.697144,-74.140516)"
2015,Agosto,Iraq,368,0,1,,1,"(6.171601,-75.427454)"
2015,Agosto,Irán,364,2,5,,7,"(4.697144,-74.140516)"
2015,Agosto,República de Irlanda,372,3,0,,3,"(10.886611,-74.776708)"
2015,Agosto,República de Irlanda,372,1,0,,1,"(3.541112,-76.384584)"
2015,Agosto,República de Irlanda,372,22,9,,31,"(4.697144,-74.140516)"
2015,Agosto,República de Irlanda,372,3,0,,3,"(6.171601,-75.427454)"
2015,Agosto,Islandia,352,2,2,,4,"(4.697144,-74.140516)"
2015,Agosto,Islandia,352,1,0,,1,"(6.171601,-75.427454)"
2015,Agosto,Israel,376,1,0,,1,"(10.445761,-75.516429)"
2015,Agosto,Israel,376,3,2,,5,"(10.886611,-74.776708)"
2015,Agosto,Israel,376,12,7,,19,"(3.541112,-76.384584)"
2015,Agosto,Israel,376,121,96,,217,"(4.697144,-74.140516)"
2015,Agosto,Israel,376,2,1,,3,"(6.171601,-75.427454)"
2015,Agosto,Israel,376,1,0,,1,"(7.128456,-73.183637)"
2015,Agosto,Italia,380,4,0,,4,"(10.445761,-75.516429)"
2015,Agosto,Italia,380,3,2,,5,"(10.886611,-74.776708)"
2015,Agosto,Italia,380,126,45,,171,"(3.541112,-76.384584)"
2015,Agosto,Italia,380,567,373,,940,"(4.697144,-74.140516)"
2015,Agosto,Italia,380,1,0,,1,"(4.815061,-75.736532)"
2015,Agosto,Italia,380,84,53,,137,"(6.171601,-75.427454)"
2015,Agosto,Italia,380,1,0,,1,"(7.927209,-72.507910)"
2015,Agosto,Jamaica,388,1,6,,7,"(10.445761,-75.516429)"
2015,Agosto,Jamaica,388,4,8,,12,"(10.886611,-74.776708)"
2015,Agosto,Jamaica,388,5,9,,14,"(12.586067,-81.702563)"
2015,Agosto,Jamaica,388,13,9,,22,"(3.541112,-76.384584)"
2015,Agosto,Jamaica,388,30,30,,60,"(4.697144,-74.140516)"
2015,Agosto,Jamaica,388,1,1,,2,"(4.815061,-75.736532)"
2015,Agosto,Jamaica,388,17,22,,39,"(6.171601,-75.427454)"
2015,Agosto,Jamaica,388,4,3,,7,"(7.128456,-73.183637)"
2015,Agosto,Japón,392,6,1,,7,"(3.541112,-76.384584)"
2015,Agosto,Japón,392,58,50,,108,"(4.697144,-74.140516)"
2015,Agosto,Japón,392,9,10,,19,"(6.171601,-75.427454)"
2015,Agosto,Jordania,400,2,4,,6,"(4.697144,-74.140516)"
2015,Agosto,Kazajistán,398,0,1,,1,"(3.541112,-76.384584)"
2015,Agosto,Kazajistán,398,5,10,,15,"(4.697144,-74.140516)"
2015,Agosto,Kenia,404,6,8,,14,"(4.697144,-74.140516)"
2015,Agosto,Kuwait,414,2,2,,4,"(10.886611,-74.776708)"
2015,Agosto,Kuwait,414,2,3,,5,"(4.697144,-74.140516)"
2015,Agosto,Letonia,428,1,0,,1,"(4.697144,-74.140516)"
2015,Agosto,Lituania,440,0,1,,1,"(4.697144,-74.140516)"
2015,Agosto,Líbano,422,0,2,,2,"(10.408582,-75.538003)"
2015,Agosto,Líbano,422,20,43,,63,"(4.697144,-74.140516)"
2015,Agosto,Liberia,430,1,1,,2,"(4.697144,-74.140516)"
2015,Agosto,Luxemburgo,442,0,1,,1,"(3.541112,-76.384584)"
2015,Agosto,Luxemburgo,442,8,2,,10,"(4.697144,-74.140516)"
2015,Agosto,Luxemburgo,442,2,0,,2,"(6.171601,-75.427454)"
2015,Agosto,Madagascar,450,0,1,,1,"(4.697144,-74.140516)"
2015,Agosto,Malasia,458,11,16,,27,"(4.697144,-74.140516)"
2015,Agosto,Malasia,458,1,1,,2,"(6.171601,-75.427454)"
2015,Agosto,Maldivas,462,1,0,,1,"(3.541112,-76.384584)"
2015,Agosto,Malí,466,1,1,,2,"(4.697144,-74.140516)"
2015,Agosto,Malta,470,12,8,,20,"(4.697144,-74.140516)"
2015,Agosto,Marruecos,504,2,2,,4,"(4.697144,-74.140516)"
2015,Agosto,Mauritania,478,0,2,,2,"(4.697144,-74.140516)"
2015,Agosto,Martinica/Departamento de Ultramar Francés,474,1,0,,1,"(10.886611,-74.776708)"
2015,Agosto,Martinica/Departamento de Ultramar Francés,474,2,0,,2,"(4.697144,-74.140516)"
2015,Agosto,Martinica/Departamento de Ultramar Francés,474,1,1,,2,"(7.128456,-73.183637)"
2015,Agosto,México,484,1,3,,4,"(10.408582,-75.538003)"
2015,Agosto,México,484,68,68,,136,"(10.445761,-75.516429)"
2015,Agosto,México,484,232,185,,417,"(10.886611,-74.776708)"
2015,Agosto,México,484,2,2,,4,"(12.586067,-81.702563)"
2015,Agosto,México,484,1118,912,,2030,"(3.541112,-76.384584)"
2015,Agosto,México,484,13268,11945,,25213,"(4.697144,-74.140516)"
2015,Agosto,México,484,210,171,,381,"(4.815061,-75.736532)"
2015,Agosto,México,484,2650,2109,,4759,"(6.171601,-75.427454)"
2015,Agosto,México,484,246,177,,423,"(7.128456,-73.183637)"
2015,Agosto,México,484,94,62,,156,"(7.927209,-72.507910)"
2015,Agosto,Mónaco,492,0,2,,2,"(4.697144,-74.140516)"
2015,Agosto,Mongolia,496,1,0,,1,"(4.697144,-74.140516)"
2015,Agosto,Mozambique,508,1,1,,2,"(4.697144,-74.140516)"
2015,Agosto,Nicaragua,558,1,4,,5,"(10.445761,-75.516429)"
2015,Agosto,Nicaragua,558,1,2,,3,"(10.886611,-74.776708)"
2015,Agosto,Nicaragua,558,3,2,,5,"(12.586067,-81.702563)"
2015,Agosto,Nicaragua,558,12,36,,48,"(3.541112,-76.384584)"
2015,Agosto,Nicaragua,558,40,77,,117,"(4.697144,-74.140516)"
2015,Agosto,Nicaragua,558,1,4,,5,"(4.815061,-75.736532)"
2015,Agosto,Nicaragua,558,8,36,,44,"(6.171601,-75.427454)"
2015,Agosto,Nicaragua,558,2,1,,3,"(7.927209,-72.507910)"
2015,Agosto,Nigeria,566,1,7,,8,"(4.697144,-74.140516)"
2015,Agosto,Níger,562,0,1,,1,"(4.697144,-74.140516)"
2015,Agosto,Noruega,578,3,1,,4,"(10.445761,-75.516429)"
2015,Agosto,Noruega,578,1,0,,1,"(10.886611,-74.776708)"
2015,Agosto,Noruega,578,3,2,,5,"(3.541112,-76.384584)"
2015,Agosto,Noruega,578,41,23,,64,"(4.697144,-74.140516)"
2015,Agosto,Noruega,578,4,3,,7,"(6.171601,-75.427454)"
2015,Agosto,Noruega,578,2,2,,4,"(7.128456,-73.183637)"
2015,Agosto,Nueva Zelanda,554,27,15,,42,"(4.697144,-74.140516)"
2015,Agosto,Nueva Zelanda,554,1,4,,5,"(6.171601,-75.427454)"
2015,Agosto,Omán,512,8,12,,20,"(4.697144,-74.140516)"
2015,Agosto,Omán,512,2,4,,6,"(6.171601,-75.427454)"
2015,Agosto,Papúa Nueva Guinea,598,1,0,,1,"(4.697144,-74.140516)"
2015,Agosto,Papúa Nueva Guinea,598,0,1,,1,"(6.171601,-75.427454)"
2015,Agosto,Pakistán,586,0,1,,1,"(4.697144,-74.140516)"
2015,Agosto,Panamá,591,7,75,,82,"(10.408582,-75.538003)"
2015,Agosto,Panamá,591,335,276,,611,"(10.445761,-75.516429)"
2015,Agosto,Panamá,591,862,862,,1724,"(10.886611,-74.776708)"
2015,Agosto,Panamá,591,1,2,,3,"(10.971302,-74.765397)"
2015,Agosto,Panamá,591,0,4,,4,"(11.247723,-74.213989)"
2015,Agosto,Panamá,591,2,11,,13,"(12.5744111,-81.703935)"
2015,Agosto,Panamá,591,152,141,,293,"(12.586067,-81.702563)"
2015,Agosto,Panamá,591,0,1,,1,"(13.3387613,-81.372937)"
2015,Agosto,Panamá,591,1900,1697,,3597,"(3.541112,-76.384584)"
2015,Agosto,Panamá,591,0,1,,1,"(3.893038,-77.067921)"
2015,Agosto,Panamá,591,9352,9499,,18851,"(4.697144,-74.140516)"
2015,Agosto,Panamá,591,498,415,,913,"(4.815061,-75.736532)"
2015,Agosto,Panamá,591,3475,3232,,6707,"(6.171601,-75.427454)"
2015,Agosto,Panamá,591,1,6,,7,"(6.228046,-77.404104)"
2015,Agosto,Panamá,591,7,13,,20,"(7.102626,-77.762647)"
2015,Agosto,Panamá,591,266,213,,479,"(7.128456,-73.183637)"
2015,Agosto,Panamá,591,179,151,,330,"(7.927209,-72.507910)"
2015,Agosto,Panamá,591,0,64,,64,"(8.066966,-76.735404)"
2015,Agosto,Panamá,591,38,122,,160,"(8.635765,-77.346578)"
2015,Agosto,Paraguay,600,0,2,,2,"(0.814836,-77.662532)"
2015,Agosto,Paraguay,600,0,1,,1,"(10.445761,-75.516429)"
2015,Agosto,Paraguay,600,1,0,,1,"(10.886611,-74.776708)"
2015,Agosto,Paraguay,600,10,18,,28,"(3.541112,-76.384584)"
2015,Agosto,Paraguay,600,63,151,,214,"(4.697144,-74.140516)"
2015,Agosto,Paraguay,600,0,1,,1,"(4.815061,-75.736532)"
2015,Agosto,Paraguay,600,7,41,,48,"(6.171601,-75.427454)"
2015,Agosto,Perú,604,126,142,,268,"(-4.197703,-69.941278)"
2015,Agosto,Perú,604,0,1,,1,"(-4.223468,-69.945098)"
2015,Agosto,Perú,604,1,1,,2,"(0.25129,-76.875963)"
2015,Agosto,Perú,604,78,109,,187,"(0.814836,-77.662532)"
2015,Agosto,Perú,604,5,5,,10,"(10.445761,-75.516429)"
2015,Agosto,Perú,604,12,13,,25,"(10.886611,-74.776708)"
2015,Agosto,Perú,604,1,1,,2,"(12.586067,-81.702563)"
2015,Agosto,Perú,604,245,326,,571,"(3.541112,-76.384584)"
2015,Agosto,Perú,604,4892,5759,,10651,"(4.697144,-74.140516)"
2015,Agosto,Perú,604,5,7,,12,"(4.815061,-75.736532)"
2015,Agosto,Perú,604,265,348,,613,"(6.171601,-75.427454)"
2015,Agosto,Perú,604,3,0,,3,"(7.128456,-73.183637)"
2015,Agosto,Polonia,616,3,9,,12,"(4.697144,-74.140516)"
2015,Agosto,Polonia,616,2,0,,2,"(6.171601,-75.427454)"
2015,Agosto,Portugal,620,2,2,,4,"(3.541112,-76.384584)"
2015,Agosto,Portugal,620,152,126,,278,"(4.697144,-74.140516)"
2015,Agosto,Portugal,620,6,1,,7,"(6.171601,-75.427454)"
2015,Agosto,Portugal,620,1,0,,1,"(7.128456,-73.183637)"
2015,Agosto,Puerto Rico/Territorio de Estados Unidos,630,9,11,,20,"(10.445761,-75.516429)"
2015,Agosto,Puerto Rico/Territorio de Estados Unidos,630,38,24,,62,"(10.886611,-74.776708)"
2015,Agosto,Puerto Rico/Territorio de Estados Unidos,630,33,26,,59,"(3.541112,-76.384584)"
2015,Agosto,Puerto Rico/Territorio de Estados Unidos,630,578,544,,1122,"(4.697144,-74.140516)"
2015,Agosto,Puerto Rico/Territorio de Estados Unidos,630,10,10,,20,"(4.815061,-75.736532)"
2015,Agosto,Puerto Rico/Territorio de Estados Unidos,630,44,43,,87,"(6.171601,-75.427454)"
2015,Agosto,Puerto Rico/Territorio de Estados Unidos,630,8,7,,15,"(7.128456,-73.183637)"
2015,Agosto,Puerto Rico/Territorio de Estados Unidos,630,2,3,,5,"(7.927209,-72.507910)"
2015,Agosto,Qatar,634,2,0,,2,"(10.445761,-75.516429)"
2015,Agosto,Qatar,634,15,15,,30,"(4.697144,-74.140516)"
2015,Agosto,Qatar,634,4,6,,10,"(6.171601,-75.427454)"
2015,Agosto,Reino Unido de Gran Bretaña e Irlanda del Norte,826,2,1,,3,"(10.445761,-75.516429)"
2015,Agosto,Reino Unido de Gran Bretaña e Irlanda del Norte,826,1,0,,1,"(10.886611,-74.776708)"
2015,Agosto,Reino Unido de Gran Bretaña e Irlanda del Norte,826,62,38,,100,"(3.541112,-76.384584)"
2015,Agosto,Reino Unido de Gran Bretaña e Irlanda del Norte,826,2096,1445,,3541,"(4.697144,-74.140516)"
2015,Agosto,Reino Unido de Gran Bretaña e Irlanda del Norte,826,38,38,,76,"(6.171601,-75.427454)"
2015,Agosto,República CentroÁfricana,140,1,0,,1,"(3.541112,-76.384584)"
2015,Agosto,República CentroÁfricana,140,3,2,,5,"(4.697144,-74.140516)"
2015,Agosto,Federación de Rusia,643,0,1,,1,"(3.541112,-76.384584)"
2015,Agosto,Federación de Rusia,643,69,86,,155,"(4.697144,-74.140516)"
2015,Agosto,Federación de Rusia,643,3,1,,4,"(6.171601,-75.427454)"
2015,Agosto,República Dominicana,214,21,13,,34,"(10.445761,-75.516429)"
2015,Agosto,República Dominicana,214,44,49,,93,"(10.886611,-74.776708)"
2015,Agosto,República Dominicana,214,1,2,,3,"(12.586067,-81.702563)"
2015,Agosto,República Dominicana,214,197,158,,355,"(3.541112,-76.384584)"
2015,Agosto,República Dominicana,214,2682,2376,,5058,"(4.697144,-74.140516)"
2015,Agosto,República Dominicana,214,80,38,,118,"(4.815061,-75.736532)"
2015,Agosto,República Dominicana,214,371,261,,632,"(6.171601,-75.427454)"
2015,Agosto,República Dominicana,214,68,57,,125,"(7.128456,-73.183637)"
2015,Agosto,República Dominicana,214,23,14,,37,"(7.927209,-72.507910)"
2015,Agosto,Reunión,638,0,1,,1,"(6.171601,-75.427454)"
2015,Agosto,República Democrática Popular de Corea,408,1,0,,1,"(4.697144,-74.140516)"
2015,Agosto,Rumania,642,5,10,,15,"(4.697144,-74.140516)"
2015,Agosto,Rwanda,646,1,0,,1,"(4.697144,-74.140516)"
2015,Agosto,San Cristóbal y Nevis,659,1,4,,5,"(10.445761,-75.516429)"
2015,Agosto,San Marino,674,0,1,,1,"(10.886611,-74.776708)"
2015,Agosto,Senegal,686,0,1,,1,"(4.697144,-74.140516)"
2015,Agosto,Serbia,688,1,1,,2,"(4.697144,-74.140516)"
2015,Agosto,Singapur,702,1,0,,1,"(3.541112,-76.384584)"
2015,Agosto,Singapur,702,18,11,,29,"(4.697144,-74.140516)"
2015,Agosto,Sudáfrica,710,18,19,,37,"(4.697144,-74.140516)"
2015,Agosto,Sudáfrica,710,0,1,,1,"(6.171601,-75.427454)"
2015,Agosto,Sudán,736,3,0,,3,"(4.697144,-74.140516)"
2015,Agosto,Suecia,752,1,0,,1,"(10.445761,-75.516429)"
2015,Agosto,Suecia,752,1,0,,1,"(10.886611,-74.776708)"
2015,Agosto,Suecia,752,26,15,,41,"(3.541112,-76.384584)"
2015,Agosto,Suecia,752,70,76,,146,"(4.697144,-74.140516)"
2015,Agosto,Suecia,752,1,1,,2,"(4.815061,-75.736532)"
2015,Agosto,Suecia,752,12,5,,17,"(6.171601,-75.427454)"
2015,Agosto,Suiza,756,2,0,,2,"(10.886611,-74.776708)"
2015,Agosto,Suiza,756,81,35,,116,"(3.541112,-76.384584)"
2015,Agosto,Suiza,756,370,228,,598,"(4.697144,-74.140516)"
2015,Agosto,Suiza,756,23,9,,32,"(6.171601,-75.427454)"
2015,Agosto,Surinam,740,9,12,,21,"(4.697144,-74.140516)"
2015,Agosto,Surinam,740,0,1,,1,"(7.128456,-73.183637)"
2015,Agosto,Taiwán,158,6,11,,17,"(4.697144,-74.140516)"
2015,Agosto,Tailandia,764,13,16,,29,"(4.697144,-74.140516)"
2015,Agosto,Tanzania,834,0,1,,1,"(4.697144,-74.140516)"
2015,Agosto,Trinidad y Tobago,780,1,1,,2,"(10.445761,-75.516429)"
2015,Agosto,Trinidad y Tobago,780,1,2,,3,"(10.886611,-74.776708)"
2015,Agosto,Trinidad y Tobago,780,10,5,,15,"(3.541112,-76.384584)"
2015,Agosto,Trinidad y Tobago,780,8,32,,40,"(4.697144,-74.140516)"
2015,Agosto,Trinidad y Tobago,780,1,2,,3,"(4.815061,-75.736532)"
2015,Agosto,Trinidad y Tobago,780,5,5,,10,"(6.171601,-75.427454)"
2015,Agosto,Trinidad y Tobago,780,7,1,,8,"(7.128456,-73.183637)"
2015,Agosto,Trinidad y Tobago,780,3,2,,5,"(7.927209,-72.507910)"
2015,Agosto,Túnez,788,1,3,,4,"(4.697144,-74.140516)"
2015,Agosto,Turquía,792,7,8,,15,"(3.541112,-76.384584)"
2015,Agosto,Turquía,792,84,43,,127,"(4.697144,-74.140516)"
2015,Agosto,Turquía,792,5,4,,9,"(6.171601,-75.427454)"
2015,Agosto,Ucrania,804,3,7,,10,"(4.697144,-74.140516)"
2015,Agosto,Uganda,800,1,0,,1,"(3.541112,-76.384584)"
2015,Agosto,Uganda,800,4,3,,7,"(4.697144,-74.140516)"
2015,Agosto,Uruguay,858,0,2,,2,"(0.814836,-77.662532)"
2015,Agosto,Uruguay,858,1,0,,1,"(10.445761,-75.516429)"
2015,Agosto,Uruguay,858,7,18,,25,"(3.541112,-76.384584)"
2015,Agosto,Uruguay,858,41,61,,102,"(4.697144,-74.140516)"
2015,Agosto,Uruguay,858,1,1,,2,"(4.815061,-75.736532)"
2015,Agosto,Uruguay,858,19,20,,39,"(6.171601,-75.427454)"
2015,Agosto,Uruguay,858,0,1,,1,"(7.128456,-73.183637)"
2015,Agosto,Venezuela,862,47,30,,77,"(10.445761,-75.516429)"
2015,Agosto,Venezuela,862,4,15,,19,"(10.886611,-74.776708)"
2015,Agosto,Venezuela,862,8541,6952,,15493,"(11.360009,-72.129330)"
2015,Agosto,Venezuela,862,0,1,,1,"(12.586067,-81.702563)"
2015,Agosto,Venezuela,862,5,25,,30,"(3.541112,-76.384584)"
2015,Agosto,Venezuela,862,20,45,,65,"(3.866713,-67.927521)"
2015,Agosto,Venezuela,862,1086,1406,,2492,"(4.697144,-74.140516)"
2015,Agosto,Venezuela,862,0,3,,3,"(4.815061,-75.736532)"
2015,Agosto,Venezuela,862,202,255,,457,"(6.171601,-75.427454)"
2015,Agosto,Venezuela,862,231,233,,464,"(6.185799,-67.483929)"
2015,Agosto,Venezuela,862,2400,1848,,4248,"(7.088729,-70.740253)"
2015,Agosto,Venezuela,862,8,13,,21,"(7.128456,-73.183637)"
2015,Agosto,Venezuela,862,5259,4447,,9706,"(7.818934,-72.453226)"
2015,Agosto,Venezuela,862,3,7,,10,"(7.927209,-72.507910)"
2015,Agosto,Vietnam,704,4,6,,10,"(4.697144,-74.140516)"
2015,Agosto,Islas Vírgenes Británicas/Territorio Británico de Ultramar,92,1,4,,5,"(3.541112,-76.384584)"
2015,Agosto,Islas Vírgenes Británicas/Territorio Británico de Ultramar,92,1,2,,3,"(6.171601,-75.427454)"
2015,Agosto,Islas Vírgenes Estadounidenses/Territorio de Estados Unidos,850,1,0,,1,"(4.697144,-74.140516)"
2015,Agosto,Desconocido,99999,1,0,,1,"(10.886611,-74.776708)"
2015,Agosto,Desconocido,99999,48,144,,192,"(4.697144,-74.140516)"
2015,Septiembre,Afganistán,4,1,10,,11,"(4.697144,-74.140516)"
2015,Septiembre,Alemania,276,2,1,,3,"(10.445761,-75.516429)"
2015,Septiembre,Alemania,276,5,2,,7,"(10.886611,-74.776708)"
2015,Septiembre,Alemania,276,92,64,,156,"(3.541112,-76.384584)"
2015,Septiembre,Alemania,276,1451,1334,,2785,"(4.697144,-74.140516)"
2015,Septiembre,Alemania,276,0,1,,1,"(4.815061,-75.736532)"
2015,Septiembre,Alemania,276,48,45,,93,"(6.171601,-75.427454)"
2015,Septiembre,Andorra,20,3,0,,3,"(4.697144,-74.140516)"
2015,Septiembre,Angola,24,3,16,,19,"(4.697144,-74.140516)"
2015,Septiembre,Antigua y Barbuda,28,7,5,,12,"(4.697144,-74.140516)"
2015,Septiembre,Antigua y Barbuda,28,0,1,,1,"(6.171601,-75.427454)"
2015,Septiembre,Países Bajos,528,164,96,,260,"(10.886611,-74.776708)"
2015,Septiembre,Países Bajos,528,143,97,,240,"(3.541112,-76.384584)"
2015,Septiembre,Países Bajos,528,758,680,,1438,"(4.697144,-74.140516)"
2015,Septiembre,Países Bajos,528,2,5,,7,"(4.815061,-75.736532)"
2015,Septiembre,Países Bajos,528,193,124,,317,"(6.171601,-75.427454)"
2015,Septiembre,Países Bajos,528,3,2,,5,"(7.128456,-73.183637)"
2015,Septiembre,Países Bajos,528,3,6,,9,"(7.927209,-72.507910)"
2015,Septiembre,Arabia Saudita,682,0,2,,2,"(3.541112,-76.384584)"
2015,Septiembre,Arabia Saudita,682,15,51,,66,"(4.697144,-74.140516)"
2015,Septiembre,Arabia Saudita,682,0,2,,2,"(6.171601,-75.427454)"
2015,Septiembre,Arabia Saudita,682,1,3,,4,"(7.128456,-73.183637)"
2015,Septiembre,Argelia,12,0,1,,1,"(3.541112,-76.384584)"
2015,Septiembre,Argelia,12,0,9,,9,"(4.697144,-74.140516)"
2015,Septiembre,Argentina,32,1,1,,2,"(0.25129,-76.875963)"
2015,Septiembre,Argentina,32,15,12,,27,"(0.814836,-77.662532)"
2015,Septiembre,Argentina,32,12,10,,22,"(10.445761,-75.516429)"
2015,Septiembre,Argentina,32,13,16,,29,"(10.886611,-74.776708)"
2015,Septiembre,Argentina,32,4,2,,6,"(12.586067,-81.702563)"
2015,Septiembre,Argentina,32,172,163,,335,"(3.541112,-76.384584)"
2015,Septiembre,Argentina,32,1980,1970,,3950,"(4.697144,-74.140516)"
2015,Septiembre,Argentina,32,17,29,,46,"(4.815061,-75.736532)"
2015,Septiembre,Argentina,32,153,144,,297,"(6.171601,-75.427454)"
2015,Septiembre,Argentina,32,10,8,,18,"(7.128456,-73.183637)"
2015,Septiembre,Argentina,32,5,3,,8,"(7.927209,-72.507910)"
2015,Septiembre,Aruba,533,1139,732,,1871,"(10.408582,-75.538003)"
2015,Septiembre,Aruba,533,3,5,,8,"(10.445761,-75.516429)"
2015,Septiembre,Aruba,533,20,21,,41,"(10.886611,-74.776708)"
2015,Septiembre,Aruba,533,3,7,,10,"(11.117806,-74.232622)"
2015,Septiembre,Aruba,533,27,34,,61,"(3.541112,-76.384584)"
2015,Septiembre,Aruba,533,1347,1068,,2415,"(4.697144,-74.140516)"
2015,Septiembre,Aruba,533,0,3,,3,"(4.815061,-75.736532)"
2015,Septiembre,Aruba,533,117,69,,186,"(6.171601,-75.427454)"
2015,Septiembre,Aruba,533,13,17,,30,"(7.128456,-73.183637)"
2015,Septiembre,Aruba,533,8,8,,16,"(7.927209,-72.507910)"
2015,Septiembre,Australia,36,1,0,,1,"(10.445761,-75.516429)"
2015,Septiembre,Australia,36,4,4,,8,"(10.886611,-74.776708)"
2015,Septiembre,Australia,36,11,3,,14,"(3.541112,-76.384584)"
2015,Septiembre,Australia,36,204,149,,353,"(4.697144,-74.140516)"
2015,Septiembre,Australia,36,4,2,,6,"(4.815061,-75.736532)"
2015,Septiembre,Australia,36,38,16,,54,"(6.171601,-75.427454)"
2015,Septiembre,Australia,36,1,0,,1,"(7.128456,-73.183637)"
2015,Septiembre,Australia,36,0,1,,1,"(7.927209,-72.507910)"
2015,Septiembre,Austria,40,1,0,,1,"(10.445761,-75.516429)"
2015,Septiembre,Austria,40,2,2,,4,"(3.541112,-76.384584)"
2015,Septiembre,Austria,40,47,67,,114,"(4.697144,-74.140516)"
2015,Septiembre,Austria,40,3,8,,11,"(6.171601,-75.427454)"
2015,Septiembre,Azerbaiyán,31,0,3,,3,"(4.697144,-74.140516)"
2015,Septiembre,Bahamas,44,1,2,,3,"(10.886611,-74.776708)"
2015,Septiembre,Bahamas,44,9,5,,14,"(3.541112,-76.384584)"
2015,Septiembre,Bahamas,44,9,8,,17,"(4.697144,-74.140516)"
2015,Septiembre,Bahamas,44,3,0,,3,"(4.815061,-75.736532)"
2015,Septiembre,Bahamas,44,12,7,,19,"(6.171601,-75.427454)"
2015,Septiembre,Bahréin,48,1,0,,1,"(3.541112,-76.384584)"
2015,Septiembre,Bahréin,48,1,1,,2,"(4.697144,-74.140516)"
2015,Septiembre,Bahréin,48,0,1,,1,"(6.171601,-75.427454)"
2015,Septiembre,Barbados,52,9,7,,16,"(4.697144,-74.140516)"
2015,Septiembre,Bélgica,56,1,0,,1,"(10.886611,-74.776708)"
2015,Septiembre,Bélgica,56,14,9,,23,"(3.541112,-76.384584)"
2015,Septiembre,Bélgica,56,73,72,,145,"(4.697144,-74.140516)"
2015,Septiembre,Bélgica,56,18,8,,26,"(6.171601,-75.427454)"
2015,Septiembre,Belice,84,0,1,,1,"(10.886611,-74.776708)"
2015,Septiembre,Belice,84,0,1,,1,"(3.541112,-76.384584)"
2015,Septiembre,Belice,84,3,6,,9,"(4.697144,-74.140516)"
2015,Septiembre,Belice,84,6,5,,11,"(6.171601,-75.427454)"
2015,Septiembre,Bermudas/Territorio Británico de Ultramar,60,2,1,,3,"(4.697144,-74.140516)"
2015,Septiembre,Bolivia,68,1,8,,9,"(0.814836,-77.662532)"
2015,Septiembre,Bolivia,68,0,5,,5,"(10.445761,-75.516429)"
2015,Septiembre,Bolivia,68,0,3,,3,"(10.886611,-74.776708)"
2015,Septiembre,Bolivia,68,19,55,,74,"(3.541112,-76.384584)"
2015,Septiembre,Bolivia,68,297,498,,795,"(4.697144,-74.140516)"
2015,Septiembre,Bolivia,68,1,1,,2,"(4.815061,-75.736532)"
2015,Septiembre,Bolivia,68,22,28,,50,"(6.171601,-75.427454)"
2015,Septiembre,Bolivia,68,0,5,,5,"(7.128456,-73.183637)"
2015,Septiembre,Bolivia,68,0,1,,1,"(7.927209,-72.507910)"
2015,Septiembre,Brasil,76,101,220,,321,"(-4.197703,-69.941278)"
2015,Septiembre,Brasil,76,1,3,,4,"(-4.223468,-69.945098)"
2015,Septiembre,Brasil,76,1,2,,3,"(0.814836,-77.662532)"
2015,Septiembre,Brasil,76,0,2,,2,"(10.408582,-75.538003)"
2015,Septiembre,Brasil,76,0,3,,3,"(10.445761,-75.516429)"
2015,Septiembre,Brasil,76,1,6,,7,"(10.886611,-74.776708)"
2015,Septiembre,Brasil,76,1,1,,2,"(12.586067,-81.702563)"
2015,Septiembre,Brasil,76,71,103,,174,"(3.541112,-76.384584)"
2015,Septiembre,Brasil,76,2596,3237,,5833,"(4.697144,-74.140516)"
2015,Septiembre,Brasil,76,7,18,,25,"(4.815061,-75.736532)"
2015,Septiembre,Brasil,76,102,127,,229,"(6.171601,-75.427454)"
2015,Septiembre,Brasil,76,3,3,,6,"(7.128456,-73.183637)"
2015,Septiembre,Brasil,76,0,1,,1,"(7.927209,-72.507910)"
2015,Septiembre,Bulgaria,100,1,2,,3,"(4.697144,-74.140516)"
2015,Septiembre,Burkina Faso,854,1,0,,1,"(4.697144,-74.140516)"
2015,Septiembre,Cabo Verde,132,3,0,,3,"(4.697144,-74.140516)"
2015,Septiembre,Islas Caimán/Territorio Británico de Ultramar,136,3,0,,3,"(10.445761,-75.516429)"
2015,Septiembre,Islas Caimán/Territorio Británico de Ultramar,136,0,3,,3,"(12.5744111,-81.703935)"
2015,Septiembre,Islas Caimán/Territorio Británico de Ultramar,136,2,3,,5,"(12.586067,-81.702563)"
2015,Septiembre,Islas Caimán/Territorio Británico de Ultramar,136,0,1,,1,"(3.541112,-76.384584)"
2015,Septiembre,Islas Caimán/Territorio Británico de Ultramar,136,1,2,,3,"(4.697144,-74.140516)"
2015,Septiembre,Islas Caimán/Territorio Británico de Ultramar,136,1,0,,1,"(6.171601,-75.427454)"
2015,Septiembre,Islas Caimán/Territorio Británico de Ultramar,136,1,0,,1,"(7.128456,-73.183637)"
2015,Septiembre,Camboya,116,0,2,,2,"(4.697144,-74.140516)"
2015,Septiembre,Canadá,124,1,0,,1,"(0.814836,-77.662532)"
2015,Septiembre,Canadá,124,27,15,,42,"(10.445761,-75.516429)"
2015,Septiembre,Canadá,124,34,25,,59,"(10.886611,-74.776708)"
2015,Septiembre,Canadá,124,146,87,,233,"(3.541112,-76.384584)"
2015,Septiembre,Canadá,124,1553,1246,,2799,"(4.697144,-74.140516)"
2015,Septiembre,Canadá,124,17,17,,34,"(4.815061,-75.736532)"
2015,Septiembre,Canadá,124,265,215,,480,"(6.171601,-75.427454)"
2015,Septiembre,Canadá,124,12,13,,25,"(7.128456,-73.183637)"
2015,Septiembre,Canadá,124,2,3,,5,"(7.927209,-72.507910)"
2015,Septiembre,Chad,148,2,4,,6,"(4.697144,-74.140516)"
2015,Septiembre,España,724,0,1,,1,"(10.408582,-75.538003)"
2015,Septiembre,España,724,17,11,,28,"(10.445761,-75.516429)"
2015,Septiembre,España,724,24,9,,33,"(10.886611,-74.776708)"
2015,Septiembre,España,724,0,1,,1,"(12.586067,-81.702563)"
2015,Septiembre,España,724,2417,1511,,3928,"(3.541112,-76.384584)"
2015,Septiembre,España,724,8607,6450,,15057,"(4.697144,-74.140516)"
2015,Septiembre,España,724,62,42,,104,"(4.815061,-75.736532)"
2015,Septiembre,España,724,1433,971,,2404,"(6.171601,-75.427454)"
2015,Septiembre,España,724,29,23,,52,"(7.128456,-73.183637)"
2015,Septiembre,España,724,5,2,,7,"(7.927209,-72.507910)"
2015,Septiembre,Colombia,170,43,152,,195,"(4.697144,-74.140516)"
2015,Septiembre,República Del Congo,178,0,1,,1,"(4.697144,-74.140516)"
2015,Septiembre,República Democrática del Congo,180,1,0,,1,"(4.697144,-74.140516)"
2015,Septiembre,República de Corea,410,0,2,,2,"(3.541112,-76.384584)"
2015,Septiembre,República de Corea,410,31,44,,75,"(4.697144,-74.140516)"
2015,Septiembre,República de Corea,410,0,2,,2,"(6.171601,-75.427454)"
2015,Septiembre,República de Corea,410,1,0,,1,"(7.128456,-73.183637)"
2015,Septiembre,Costa de Marfil,384,2,0,,2,"(10.408582,-75.538003)"
2015,Septiembre,Costa de Marfil,384,6,7,,13,"(4.697144,-74.140516)"
2015,Septiembre,Costa Rica,188,811,600,,1411,"(10.408582,-75.538003)"
2015,Septiembre,Costa Rica,188,9,9,,18,"(10.445761,-75.516429)"
2015,Septiembre,Costa Rica,188,18,25,,43,"(10.886611,-74.776708)"
2015,Septiembre,Costa Rica,188,5,42,,47,"(12.5744111,-81.703935)"
2015,Septiembre,Costa Rica,188,18,12,,30,"(12.586067,-81.702563)"
2015,Septiembre,Costa Rica,188,29,43,,72,"(3.541112,-76.384584)"
2015,Septiembre,Costa Rica,188,849,944,,1793,"(4.697144,-74.140516)"
2015,Septiembre,Costa Rica,188,4,4,,8,"(4.815061,-75.736532)"
2015,Septiembre,Costa Rica,188,109,99,,208,"(6.171601,-75.427454)"
2015,Septiembre,Costa Rica,188,7,10,,17,"(7.128456,-73.183637)"
2015,Septiembre,Costa Rica,188,0,2,,2,"(7.927209,-72.507910)"
2015,Septiembre,Croacia,191,5,5,,10,"(4.697144,-74.140516)"
2015,Septiembre,Cuba,192,8,5,,13,"(10.445761,-75.516429)"
2015,Septiembre,Cuba,192,9,7,,16,"(10.886611,-74.776708)"
2015,Septiembre,Cuba,192,2,1,,3,"(12.586067,-81.702563)"
2015,Septiembre,Cuba,192,75,84,,159,"(3.541112,-76.384584)"
2015,Septiembre,Cuba,192,870,901,,1771,"(4.697144,-74.140516)"
2015,Septiembre,Cuba,192,22,14,,36,"(4.815061,-75.736532)"
2015,Septiembre,Cuba,192,123,97,,220,"(6.171601,-75.427454)"
2015,Septiembre,Cuba,192,10,15,,25,"(7.128456,-73.183637)"
2015,Septiembre,Cuba,192,15,6,,21,"(7.927209,-72.507910)"
2015,Septiembre,Curazao,99999,2,39,,41,"(4.697144,-74.140516)"
2015,Septiembre,República Checa,203,10,11,,21,"(4.697144,-74.140516)"
2015,Septiembre,República Checa,203,1,2,,3,"(6.171601,-75.427454)"
2015,Septiembre,Chile,152,139,158,,297,"(0.814836,-77.662532)"
2015,Septiembre,Chile,152,0,1,,1,"(1.813928,-78.763924)"
2015,Septiembre,Chile,152,9,2,,11,"(10.445761,-75.516429)"
2015,Septiembre,Chile,152,13,12,,25,"(10.886611,-74.776708)"
2015,Septiembre,Chile,152,359,254,,613,"(3.541112,-76.384584)"
2015,Septiembre,Chile,152,2830,2590,,5420,"(4.697144,-74.140516)"
2015,Septiembre,Chile,152,56,71,,127,"(4.815061,-75.736532)"
2015,Septiembre,Chile,152,113,122,,235,"(6.171601,-75.427454)"
2015,Septiembre,Chile,152,15,7,,22,"(7.128456,-73.183637)"
2015,Septiembre,Chile,152,5,5,,10,"(7.927209,-72.507910)"
2015,Septiembre,China,156,0,2,,2,"(10.886611,-74.776708)"
2015,Septiembre,China,156,8,13,,21,"(3.541112,-76.384584)"
2015,Septiembre,China,156,176,346,,522,"(4.697144,-74.140516)"
2015,Septiembre,China,156,16,44,,60,"(6.171601,-75.427454)"
2015,Septiembre,China,156,1,0,,1,"(7.128456,-73.183637)"
2015,Septiembre,Chipre,196,0,1,,1,"(4.697144,-74.140516)"
2015,Septiembre,Dinamarca,208,1,1,,2,"(10.445761,-75.516429)"
2015,Septiembre,Dinamarca,208,1,1,,2,"(3.541112,-76.384584)"
2015,Septiembre,Dinamarca,208,17,22,,39,"(4.697144,-74.140516)"
2015,Septiembre,Dominica,212,2,3,,5,"(4.697144,-74.140516)"
2015,Septiembre,Ecuador,218,425,656,,1081,"(0.25129,-76.875963)"
2015,Septiembre,Ecuador,218,13,19,,32,"(0.812436,-77.847006)"
2015,Septiembre,Ecuador,218,5073,5881,,10954,"(0.814836,-77.662532)"
2015,Septiembre,Ecuador,218,150,137,,287,"(1.813928,-78.763924)"
2015,Septiembre,Ecuador,218,0,17,,17,"(10.408582,-75.538003)"
2015,Septiembre,Ecuador,218,3,1,,4,"(10.445761,-75.516429)"
2015,Septiembre,Ecuador,218,3,13,,16,"(10.886611,-74.776708)"
2015,Septiembre,Ecuador,218,1,0,,1,"(12.586067,-81.702563)"
2015,Septiembre,Ecuador,218,275,438,,713,"(3.541112,-76.384584)"
2015,Septiembre,Ecuador,218,2321,4282,,6603,"(4.697144,-74.140516)"
2015,Septiembre,Ecuador,218,4,7,,11,"(4.815061,-75.736532)"
2015,Septiembre,Ecuador,218,63,109,,172,"(6.171601,-75.427454)"
2015,Septiembre,Ecuador,218,4,12,,16,"(7.128456,-73.183637)"
2015,Septiembre,Ecuador,218,0,1,,1,"(7.927209,-72.507910)"
2015,Septiembre,Egipto,818,1,0,,1,"(10.886611,-74.776708)"
2015,Septiembre,Egipto,818,45,32,,77,"(4.697144,-74.140516)"
2015,Septiembre,El Salvador,222,1,2,,3,"(10.445761,-75.516429)"
2015,Septiembre,El Salvador,222,2,3,,5,"(10.886611,-74.776708)"
2015,Septiembre,El Salvador,222,28,50,,78,"(3.541112,-76.384584)"
2015,Septiembre,El Salvador,222,593,918,,1511,"(4.697144,-74.140516)"
2015,Septiembre,El Salvador,222,79,105,,184,"(6.171601,-75.427454)"
2015,Septiembre,Emiratos Árabes,784,3,3,,6,"(3.541112,-76.384584)"
2015,Septiembre,Emiratos Árabes,784,123,156,,279,"(4.697144,-74.140516)"
2015,Septiembre,Emiratos Árabes,784,5,3,,8,"(6.171601,-75.427454)"
2015,Septiembre,Eslovaquia,703,2,0,,2,"(4.697144,-74.140516)"
2015,Septiembre,Eslovenia,705,2,0,,2,"(4.697144,-74.140516)"
2015,Septiembre,Estados Unidos de América,840,2996,2286,,5282,"(10.445761,-75.516429)"
2015,Septiembre,Estados Unidos de América,840,2672,2232,,4904,"(10.886611,-74.776708)"
2015,Septiembre,Estados Unidos de América,840,5,3,,8,"(11.117806,-74.232622)"
2015,Septiembre,Estados Unidos de América,840,27,18,,45,"(12.586067,-81.702563)"
2015,Septiembre,Estados Unidos de América,840,4997,3658,,8655,"(3.541112,-76.384584)"
2015,Septiembre,Estados Unidos de América,840,520,403,,923,"(4.452882,-75.766298)"
2015,Septiembre,Estados Unidos de América,840,30075,27401,,57476,"(4.697144,-74.140516)"
2015,Septiembre,Estados Unidos de América,840,902,631,,1533,"(4.815061,-75.736532)"
2015,Septiembre,Estados Unidos de América,840,8796,6879,,15675,"(6.171601,-75.427454)"
2015,Septiembre,Estados Unidos de América,840,284,200,,484,"(7.128456,-73.183637)"
2015,Septiembre,Estados Unidos de América,840,70,66,,136,"(7.927209,-72.507910)"
2015,Septiembre,Estonia,233,2,1,,3,"(4.697144,-74.140516)"
2015,Septiembre,Etiopia,231,2,1,,3,"(4.697144,-74.140516)"
2015,Septiembre,Filipinas,608,1,0,,1,"(10.445761,-75.516429)"
2015,Septiembre,Filipinas,608,1,2,,3,"(3.541112,-76.384584)"
2015,Septiembre,Filipinas,608,5,6,,11,"(4.697144,-74.140516)"
2015,Septiembre,Filipinas,608,1,0,,1,"(6.171601,-75.427454)"
2015,Septiembre,Finlandia,246,1,0,,1,"(3.541112,-76.384584)"
2015,Septiembre,Finlandia,246,5,2,,7,"(4.697144,-74.140516)"
2015,Septiembre,Francia,250,0,1,,1,"(10.445761,-75.516429)"
2015,Septiembre,Francia,250,3,3,,6,"(10.886611,-74.776708)"
2015,Septiembre,Francia,250,172,92,,264,"(3.541112,-76.384584)"
2015,Septiembre,Francia,250,1649,1240,,2889,"(4.697144,-74.140516)"
2015,Septiembre,Francia,250,2,1,,3,"(4.815061,-75.736532)"
2015,Septiembre,Francia,250,70,53,,123,"(6.171601,-75.427454)"
2015,Septiembre,Francia,250,3,4,,7,"(7.128456,-73.183637)"
2015,Septiembre,Gabón,266,1,1,,2,"(4.697144,-74.140516)"
2015,Septiembre,Georgia,268,3,1,,4,"(4.697144,-74.140516)"
2015,Septiembre,Ghana,288,0,2,,2,"(4.697144,-74.140516)"
2015,Septiembre,Gibraltar/Territorio Británico de Ultramar,292,2,0,,2,"(0.814836,-77.662532)"
2015,Septiembre,Gibraltar/Territorio Británico de Ultramar,292,0,1,,1,"(6.171601,-75.427454)"
2015,Septiembre,Granada,308,0,1,,1,"(3.541112,-76.384584)"
2015,Septiembre,Grecia,300,4,2,,6,"(3.541112,-76.384584)"
2015,Septiembre,Grecia,300,28,22,,50,"(4.697144,-74.140516)"
2015,Septiembre,Guatemala,320,3,3,,6,"(10.445761,-75.516429)"
2015,Septiembre,Guatemala,320,9,12,,21,"(10.886611,-74.776708)"
2015,Septiembre,Guatemala,320,58,109,,167,"(3.541112,-76.384584)"
2015,Septiembre,Guatemala,320,452,643,,1095,"(4.697144,-74.140516)"
2015,Septiembre,Guatemala,320,16,25,,41,"(4.815061,-75.736532)"
2015,Septiembre,Guatemala,320,58,97,,155,"(6.171601,-75.427454)"
2015,Septiembre,Guatemala,320,5,13,,18,"(7.128456,-73.183637)"
2015,Septiembre,Guatemala,320,1,1,,2,"(7.927209,-72.507910)"
2015,Septiembre,Guyana,328,4,5,,9,"(10.886611,-74.776708)"
2015,Septiembre,Guyana,328,3,0,,3,"(3.541112,-76.384584)"
2015,Septiembre,Guyana,328,2,2,,4,"(4.697144,-74.140516)"
2015,Septiembre,Guyana,328,0,1,,1,"(6.171601,-75.427454)"
2015,Septiembre,Guinea Ecuatorial,226,1,0,,1,"(3.541112,-76.384584)"
2015,Septiembre,Guinea Ecuatorial,226,3,5,,8,"(4.697144,-74.140516)"
2015,Septiembre,Guinea Ecuatorial,226,0,1,,1,"(6.171601,-75.427454)"
2015,Septiembre,Guadalupe/Territorio Francés,312,3,2,,5,"(4.697144,-74.140516)"
2015,Septiembre,Guayana Francesa/Departamento de Ultramar Francés,254,1,1,,2,"(3.541112,-76.384584)"
2015,Septiembre,Guayana Francesa/Departamento de Ultramar Francés,254,1,0,,1,"(4.697144,-74.140516)"
2015,Septiembre,Guayana Francesa/Departamento de Ultramar Francés,254,0,2,,2,"(6.171601,-75.427454)"
2015,Septiembre,Haití,332,2,6,,8,"(10.886611,-74.776708)"
2015,Septiembre,Haití,332,1,2,,3,"(3.541112,-76.384584)"
2015,Septiembre,Haití,332,3,8,,11,"(4.697144,-74.140516)"
2015,Septiembre,Haití,332,1,1,,2,"(4.815061,-75.736532)"
2015,Septiembre,Haití,332,8,8,,16,"(6.171601,-75.427454)"
2015,Septiembre,Honduras,340,1,3,,4,"(10.445761,-75.516429)"
2015,Septiembre,Honduras,340,1,4,,5,"(10.886611,-74.776708)"
2015,Septiembre,Honduras,340,1,0,,1,"(12.586067,-81.702563)"
2015,Septiembre,Honduras,340,8,20,,28,"(3.541112,-76.384584)"
2015,Septiembre,Honduras,340,83,140,,223,"(4.697144,-74.140516)"
2015,Septiembre,Honduras,340,0,2,,2,"(4.815061,-75.736532)"
2015,Septiembre,Honduras,340,26,40,,66,"(6.171601,-75.427454)"
2015,Septiembre,Honduras,340,0,2,,2,"(7.128456,-73.183637)"
2015,Septiembre,Honduras,340,1,2,,3,"(7.927209,-72.507910)"
2015,Septiembre,Hong Kong,344,28,42,,70,"(4.697144,-74.140516)"
2015,Septiembre,Hong Kong,344,1,2,,3,"(6.171601,-75.427454)"
2015,Septiembre,Hungría,348,8,7,,15,"(4.697144,-74.140516)"
2015,Septiembre,Hungría,348,0,1,,1,"(7.128456,-73.183637)"
2015,Septiembre,India,356,7,2,,9,"(3.541112,-76.384584)"
2015,Septiembre,India,356,61,33,,94,"(4.697144,-74.140516)"
2015,Septiembre,India,356,9,8,,17,"(6.171601,-75.427454)"
2015,Septiembre,India,356,1,1,,2,"(7.128456,-73.183637)"
2015,Septiembre,Indonesia,360,1,1,,2,"(3.541112,-76.384584)"
2015,Septiembre,Indonesia,360,7,8,,15,"(4.697144,-74.140516)"
2015,Septiembre,Indonesia,360,1,2,,3,"(6.171601,-75.427454)"
2015,Septiembre,Iraq,368,0,12,,12,"(4.697144,-74.140516)"
2015,Septiembre,Iraq,368,0,1,,1,"(6.171601,-75.427454)"
2015,Septiembre,Irán,364,0,1,,1,"(3.541112,-76.384584)"
2015,Septiembre,Irán,364,10,7,,17,"(4.697144,-74.140516)"
2015,Septiembre,República de Irlanda,372,1,1,,2,"(3.541112,-76.384584)"
2015,Septiembre,República de Irlanda,372,13,11,,24,"(4.697144,-74.140516)"
2015,Septiembre,República de Irlanda,372,1,0,,1,"(6.171601,-75.427454)"
2015,Septiembre,Islandia,352,1,0,,1,"(4.697144,-74.140516)"
2015,Septiembre,Islandia,352,1,0,,1,"(6.171601,-75.427454)"
2015,Septiembre,Israel,376,12,12,,24,"(3.541112,-76.384584)"
2015,Septiembre,Israel,376,103,98,,201,"(4.697144,-74.140516)"
2015,Septiembre,Israel,376,4,5,,9,"(6.171601,-75.427454)"
2015,Septiembre,Israel,376,2,1,,3,"(7.128456,-73.183637)"
2015,Septiembre,Israel,376,1,3,,4,"(7.927209,-72.507910)"
2015,Septiembre,Italia,380,10,7,,17,"(10.445761,-75.516429)"
2015,Septiembre,Italia,380,4,2,,6,"(10.886611,-74.776708)"
2015,Septiembre,Italia,380,247,128,,375,"(3.541112,-76.384584)"
2015,Septiembre,Italia,380,794,561,,1355,"(4.697144,-74.140516)"
2015,Septiembre,Italia,380,74,49,,123,"(6.171601,-75.427454)"
2015,Septiembre,Italia,380,2,1,,3,"(7.128456,-73.183637)"
2015,Septiembre,Italia,380,0,1,,1,"(7.927209,-72.507910)"
2015,Septiembre,Jamaica,388,3,8,,11,"(10.445761,-75.516429)"
2015,Septiembre,Jamaica,388,0,4,,4,"(10.886611,-74.776708)"
2015,Septiembre,Jamaica,388,3,2,,5,"(12.586067,-81.702563)"
2015,Septiembre,Jamaica,388,3,9,,12,"(3.541112,-76.384584)"
2015,Septiembre,Jamaica,388,24,32,,56,"(4.697144,-74.140516)"
2015,Septiembre,Jamaica,388,3,3,,6,"(4.815061,-75.736532)"
2015,Septiembre,Jamaica,388,17,12,,29,"(6.171601,-75.427454)"
2015,Septiembre,Jamaica,388,0,3,,3,"(7.128456,-73.183637)"
2015,Septiembre,Jamaica,388,0,1,,1,"(7.927209,-72.507910)"
2015,Septiembre,Japón,392,3,3,,6,"(3.541112,-76.384584)"
2015,Septiembre,Japón,392,71,73,,144,"(4.697144,-74.140516)"
2015,Septiembre,Japón,392,9,5,,14,"(6.171601,-75.427454)"
2015,Septiembre,Jordania,400,5,6,,11,"(4.697144,-74.140516)"
2015,Septiembre,Kazajistán,398,2,5,,7,"(4.697144,-74.140516)"
2015,Septiembre,Kazajistán,398,0,1,,1,"(6.171601,-75.427454)"
2015,Septiembre,Kenia,404,2,3,,5,"(4.697144,-74.140516)"
2015,Septiembre,Kuwait,414,1,0,,1,"(3.541112,-76.384584)"
2015,Septiembre,Kuwait,414,6,2,,8,"(4.697144,-74.140516)"
2015,Septiembre,Lituania,440,0,8,,8,"(4.697144,-74.140516)"
2015,Septiembre,Lituania,440,0,1,,1,"(6.171601,-75.427454)"
2015,Septiembre,Líbano,422,0,2,,2,"(12.586067,-81.702563)"
2015,Septiembre,Líbano,422,28,44,,72,"(4.697144,-74.140516)"
2015,Septiembre,Liberia,430,1,0,,1,"(4.697144,-74.140516)"
2015,Septiembre,Luxemburgo,442,0,1,,1,"(3.541112,-76.384584)"
2015,Septiembre,Luxemburgo,442,6,9,,15,"(4.697144,-74.140516)"
2015,Septiembre,Luxemburgo,442,0,1,,1,"(6.171601,-75.427454)"
2015,Septiembre,Malasia,458,45,74,,119,"(4.697144,-74.140516)"
2015,Septiembre,Malasia,458,1,5,,6,"(6.171601,-75.427454)"
2015,Septiembre,Malí,466,2,2,,4,"(4.697144,-74.140516)"
2015,Septiembre,Malta,470,1,0,,1,"(3.541112,-76.384584)"
2015,Septiembre,Malta,470,17,12,,29,"(4.697144,-74.140516)"
2015,Septiembre,Malta,470,1,0,,1,"(6.171601,-75.427454)"
2015,Septiembre,Marruecos,504,3,0,,3,"(3.541112,-76.384584)"
2015,Septiembre,Marruecos,504,6,6,,12,"(4.697144,-74.140516)"
2015,Septiembre,Mauritania,478,0,1,,1,"(4.697144,-74.140516)"
2015,Septiembre,Martinica/Departamento de Ultramar Francés,474,0,1,,1,"(3.541112,-76.384584)"
2015,Septiembre,Martinica/Departamento de Ultramar Francés,474,1,2,,3,"(4.697144,-74.140516)"
2015,Septiembre,México,484,39,55,,94,"(10.445761,-75.516429)"
2015,Septiembre,México,484,80,79,,159,"(10.886611,-74.776708)"
2015,Septiembre,México,484,1,0,,1,"(12.586067,-81.702563)"
2015,Septiembre,México,484,651,594,,1245,"(3.541112,-76.384584)"
2015,Septiembre,México,484,11293,10268,,21561,"(4.697144,-74.140516)"
2015,Septiembre,México,484,227,234,,461,"(4.815061,-75.736532)"
2015,Septiembre,México,484,1925,1473,,3398,"(6.171601,-75.427454)"
2015,Septiembre,México,484,190,158,,348,"(7.128456,-73.183637)"
2015,Septiembre,México,484,53,40,,93,"(7.927209,-72.507910)"
2015,Septiembre,Mónaco,492,1,0,,1,"(4.697144,-74.140516)"
2015,Septiembre,Montenegro,499,1,0,,1,"(4.697144,-74.140516)"
2015,Septiembre,Nicaragua,558,2,2,,4,"(10.445761,-75.516429)"
2015,Septiembre,Nicaragua,558,2,8,,10,"(10.886611,-74.776708)"
2015,Septiembre,Nicaragua,558,0,1,,1,"(12.586067,-81.702563)"
2015,Septiembre,Nicaragua,558,13,47,,60,"(3.541112,-76.384584)"
2015,Septiembre,Nicaragua,558,40,76,,116,"(4.697144,-74.140516)"
2015,Septiembre,Nicaragua,558,1,6,,7,"(4.815061,-75.736532)"
2015,Septiembre,Nicaragua,558,7,51,,58,"(6.171601,-75.427454)"
2015,Septiembre,Nigeria,566,3,6,,9,"(4.697144,-74.140516)"
2015,Septiembre,Níger,562,1,0,,1,"(4.697144,-74.140516)"
2015,Septiembre,Níger,562,0,1,,1,"(6.171601,-75.427454)"
2015,Septiembre,Noruega,578,1,2,,3,"(10.886611,-74.776708)"
2015,Septiembre,Noruega,578,3,0,,3,"(3.541112,-76.384584)"
2015,Septiembre,Noruega,578,13,20,,33,"(4.697144,-74.140516)"
2015,Septiembre,Noruega,578,0,1,,1,"(4.815061,-75.736532)"
2015,Septiembre,Nueva Zelanda,554,30,20,,50,"(4.697144,-74.140516)"
2015,Septiembre,Nueva Zelanda,554,0,2,,2,"(4.815061,-75.736532)"
2015,Septiembre,Nueva Zelanda,554,3,0,,3,"(6.171601,-75.427454)"
2015,Septiembre,Omán,512,6,9,,15,"(4.697144,-74.140516)"
2015,Septiembre,Pakistán,586,2,1,,3,"(4.697144,-74.140516)"
2015,Septiembre,Panamá,591,18,63,,81,"(10.408582,-75.538003)"
2015,Septiembre,Panamá,591,262,277,,539,"(10.445761,-75.516429)"
2015,Septiembre,Panamá,591,669,723,,1392,"(10.886611,-74.776708)"
2015,Septiembre,Panamá,591,0,1,,1,"(12.5744111,-81.703935)"
2015,Septiembre,Panamá,591,119,99,,218,"(12.586067,-81.702563)"
2015,Septiembre,Panamá,591,1603,1450,,3053,"(3.541112,-76.384584)"
2015,Septiembre,Panamá,591,0,3,,3,"(3.893038,-77.067921)"
2015,Septiembre,Panamá,591,7256,8001,,15257,"(4.697144,-74.140516)"
2015,Septiembre,Panamá,591,518,405,,923,"(4.815061,-75.736532)"
2015,Septiembre,Panamá,591,3022,2865,,5887,"(6.171601,-75.427454)"
2015,Septiembre,Panamá,591,1,3,,4,"(6.228046,-77.404104)"
2015,Septiembre,Panamá,591,1,2,,3,"(7.102626,-77.762647)"
2015,Septiembre,Panamá,591,198,192,,390,"(7.128456,-73.183637)"
2015,Septiembre,Panamá,591,100,100,,200,"(7.927209,-72.507910)"
2015,Septiembre,Panamá,591,1,69,,70,"(8.066966,-76.735404)"
2015,Septiembre,Panamá,591,26,96,,122,"(8.635765,-77.346578)"
2015,Septiembre,Paraguay,600,2,3,,5,"(10.445761,-75.516429)"
2015,Septiembre,Paraguay,600,2,4,,6,"(10.886611,-74.776708)"
2015,Septiembre,Paraguay,600,1,2,,3,"(12.586067,-81.702563)"
2015,Septiembre,Paraguay,600,20,24,,44,"(3.541112,-76.384584)"
2015,Septiembre,Paraguay,600,68,157,,225,"(4.697144,-74.140516)"
2015,Septiembre,Paraguay,600,3,6,,9,"(4.815061,-75.736532)"
2015,Septiembre,Paraguay,600,8,15,,23,"(6.171601,-75.427454)"
2015,Septiembre,Paraguay,600,0,1,,1,"(7.128456,-73.183637)"
2015,Septiembre,Perú,604,75,119,,194,"(-4.197703,-69.941278)"
2015,Septiembre,Perú,604,1,2,,3,"(0.25129,-76.875963)"
2015,Septiembre,Perú,604,49,71,,120,"(0.814836,-77.662532)"
2015,Septiembre,Perú,604,1,3,,4,"(10.445761,-75.516429)"
2015,Septiembre,Perú,604,6,13,,19,"(10.886611,-74.776708)"
2015,Septiembre,Perú,604,0,1,,1,"(12.586067,-81.702563)"
2015,Septiembre,Perú,604,189,295,,484,"(3.541112,-76.384584)"
2015,Septiembre,Perú,604,4296,5217,,9513,"(4.697144,-74.140516)"
2015,Septiembre,Perú,604,4,4,,8,"(4.815061,-75.736532)"
2015,Septiembre,Perú,604,258,386,,644,"(6.171601,-75.427454)"
2015,Septiembre,Perú,604,3,3,,6,"(7.128456,-73.183637)"
2015,Septiembre,Perú,604,2,0,,2,"(7.927209,-72.507910)"
2015,Septiembre,Polonia,616,13,30,,43,"(4.697144,-74.140516)"
2015,Septiembre,Polonia,616,0,1,,1,"(6.171601,-75.427454)"
2015,Septiembre,Portugal,620,1,0,,1,"(10.886611,-74.776708)"
2015,Septiembre,Portugal,620,7,8,,15,"(3.541112,-76.384584)"
2015,Septiembre,Portugal,620,239,255,,494,"(4.697144,-74.140516)"
2015,Septiembre,Portugal,620,0,2,,2,"(4.815061,-75.736532)"
2015,Septiembre,Portugal,620,10,7,,17,"(6.171601,-75.427454)"
2015,Septiembre,Polinesia Francesa/Colectividad de Ultramar Francesa,258,1,0,,1,"(4.697144,-74.140516)"
2015,Septiembre,Puerto Rico/Territorio de Estados Unidos,630,5,3,,8,"(10.445761,-75.516429)"
2015,Septiembre,Puerto Rico/Territorio de Estados Unidos,630,12,11,,23,"(10.886611,-74.776708)"
2015,Septiembre,Puerto Rico/Territorio de Estados Unidos,630,34,11,,45,"(3.541112,-76.384584)"
2015,Septiembre,Puerto Rico/Territorio de Estados Unidos,630,464,460,,924,"(4.697144,-74.140516)"
2015,Septiembre,Puerto Rico/Territorio de Estados Unidos,630,4,5,,9,"(4.815061,-75.736532)"
2015,Septiembre,Puerto Rico/Territorio de Estados Unidos,630,46,58,,104,"(6.171601,-75.427454)"
2015,Septiembre,Puerto Rico/Territorio de Estados Unidos,630,4,2,,6,"(7.128456,-73.183637)"
2015,Septiembre,Puerto Rico/Territorio de Estados Unidos,630,0,1,,1,"(7.927209,-72.507910)"
2015,Septiembre,Qatar,634,5,11,,16,"(4.697144,-74.140516)"
2015,Septiembre,Qatar,634,6,1,,7,"(6.171601,-75.427454)"
2015,Septiembre,Reino Unido de Gran Bretaña e Irlanda del Norte,826,1,0,,1,"(10.445761,-75.516429)"
2015,Septiembre,Reino Unido de Gran Bretaña e Irlanda del Norte,826,1,0,,1,"(10.886611,-74.776708)"
2015,Septiembre,Reino Unido de Gran Bretaña e Irlanda del Norte,826,56,34,,90,"(3.541112,-76.384584)"
2015,Septiembre,Reino Unido de Gran Bretaña e Irlanda del Norte,826,2319,1815,,4134,"(4.697144,-74.140516)"
2015,Septiembre,Reino Unido de Gran Bretaña e Irlanda del Norte,826,1,0,,1,"(4.815061,-75.736532)"
2015,Septiembre,Reino Unido de Gran Bretaña e Irlanda del Norte,826,26,23,,49,"(6.171601,-75.427454)"
2015,Septiembre,República CentroÁfricana,140,1,2,,3,"(4.697144,-74.140516)"
2015,Septiembre,Federación de Rusia,643,1,6,,7,"(3.541112,-76.384584)"
2015,Septiembre,Federación de Rusia,643,64,120,,184,"(4.697144,-74.140516)"
2015,Septiembre,Federación de Rusia,643,1,1,,2,"(6.171601,-75.427454)"
2015,Septiembre,República Dominicana,214,15,12,,27,"(10.445761,-75.516429)"
2015,Septiembre,República Dominicana,214,34,29,,63,"(10.886611,-74.776708)"
2015,Septiembre,República Dominicana,214,2,4,,6,"(11.117806,-74.232622)"
2015,Septiembre,República Dominicana,214,126,107,,233,"(3.541112,-76.384584)"
2015,Septiembre,República Dominicana,214,2545,2339,,4884,"(4.697144,-74.140516)"
2015,Septiembre,República Dominicana,214,35,31,,66,"(4.815061,-75.736532)"
2015,Septiembre,República Dominicana,214,279,249,,528,"(6.171601,-75.427454)"
2015,Septiembre,República Dominicana,214,29,25,,54,"(7.128456,-73.183637)"
2015,Septiembre,República Dominicana,214,19,21,,40,"(7.927209,-72.507910)"
2015,Septiembre,Reunión,638,1,1,,2,"(4.697144,-74.140516)"
2015,Septiembre,Rumania,642,0,1,,1,"(3.541112,-76.384584)"
2015,Septiembre,Rumania,642,11,3,,14,"(4.697144,-74.140516)"
2015,Septiembre,San Cristóbal y Nevis,659,1,0,,1,"(3.541112,-76.384584)"
2015,Septiembre,Santa Elena/Territorio Británico de Ultramar,654,1,1,,2,"(7.088729,-70.740253)"
2015,Septiembre,Senegal,686,1,0,,1,"(4.697144,-74.140516)"
2015,Septiembre,Singapur,702,1,0,,1,"(3.541112,-76.384584)"
2015,Septiembre,Singapur,702,16,11,,27,"(4.697144,-74.140516)"
2015,Septiembre,Singapur,702,0,1,,1,"(4.815061,-75.736532)"
2015,Septiembre,Sudáfrica,710,2,3,,5,"(3.541112,-76.384584)"
2015,Septiembre,Sudáfrica,710,14,16,,30,"(4.697144,-74.140516)"
2015,Septiembre,Sudáfrica,710,0,1,,1,"(6.171601,-75.427454)"
2015,Septiembre,Sudán,736,1,1,,2,"(4.697144,-74.140516)"
2015,Septiembre,Suecia,752,1,2,,3,"(10.445761,-75.516429)"
2015,Septiembre,Suecia,752,0,1,,1,"(10.886611,-74.776708)"
2015,Septiembre,Suecia,752,8,7,,15,"(3.541112,-76.384584)"
2015,Septiembre,Suecia,752,49,67,,116,"(4.697144,-74.140516)"
2015,Septiembre,Suecia,752,0,1,,1,"(4.815061,-75.736532)"
2015,Septiembre,Suecia,752,10,1,,11,"(6.171601,-75.427454)"
2015,Septiembre,Suiza,756,26,10,,36,"(3.541112,-76.384584)"
2015,Septiembre,Suiza,756,204,135,,339,"(4.697144,-74.140516)"
2015,Septiembre,Suiza,756,1,0,,1,"(4.815061,-75.736532)"
2015,Septiembre,Suiza,756,17,15,,32,"(6.171601,-75.427454)"
2015,Septiembre,Suiza,756,1,0,,1,"(7.128456,-73.183637)"
2015,Septiembre,Surinam,740,2,5,,7,"(4.697144,-74.140516)"
2015,Septiembre,Surinam,740,2,0,,2,"(6.171601,-75.427454)"
2015,Septiembre,Taiwán,158,1,1,,2,"(3.541112,-76.384584)"
2015,Septiembre,Taiwán,158,5,4,,9,"(4.697144,-74.140516)"
2015,Septiembre,Tailandia,764,0,1,,1,"(3.541112,-76.384584)"
2015,Septiembre,Tailandia,764,21,27,,48,"(4.697144,-74.140516)"
2015,Septiembre,Tailandia,764,1,3,,4,"(6.171601,-75.427454)"
2015,Septiembre,Tailandia,764,1,1,,2,"(7.128456,-73.183637)"
2015,Septiembre,Tanzania,834,1,2,,3,"(4.697144,-74.140516)"
2015,Septiembre,Trinidad y Tobago,780,4,3,,7,"(10.445761,-75.516429)"
2015,Septiembre,Trinidad y Tobago,780,6,3,,9,"(10.886611,-74.776708)"
2015,Septiembre,Trinidad y Tobago,780,10,8,,18,"(3.541112,-76.384584)"
2015,Septiembre,Trinidad y Tobago,780,14,25,,39,"(4.697144,-74.140516)"
2015,Septiembre,Trinidad y Tobago,780,7,4,,11,"(4.815061,-75.736532)"
2015,Septiembre,Trinidad y Tobago,780,12,14,,26,"(6.171601,-75.427454)"
2015,Septiembre,Trinidad y Tobago,780,3,3,,6,"(7.128456,-73.183637)"
2015,Septiembre,Trinidad y Tobago,780,4,3,,7,"(7.927209,-72.507910)"
2015,Septiembre,Túnez,788,2,0,,2,"(4.697144,-74.140516)"
2015,Septiembre,Turquía,792,4,4,,8,"(3.541112,-76.384584)"
2015,Septiembre,Turquía,792,126,92,,218,"(4.697144,-74.140516)"
2015,Septiembre,Turquía,792,9,4,,13,"(6.171601,-75.427454)"
2015,Septiembre,Turkmenistán,795,1,0,,1,"(4.697144,-74.140516)"
2015,Septiembre,Ucrania,804,1,0,,1,"(4.697144,-74.140516)"
2015,Septiembre,Uganda,800,2,2,,4,"(4.697144,-74.140516)"
2015,Septiembre,Uruguay,858,0,1,,1,"(0.814836,-77.662532)"
2015,Septiembre,Uruguay,858,2,2,,4,"(10.445761,-75.516429)"
2015,Septiembre,Uruguay,858,1,1,,2,"(10.886611,-74.776708)"
2015,Septiembre,Uruguay,858,15,7,,22,"(3.541112,-76.384584)"
2015,Septiembre,Uruguay,858,51,65,,116,"(4.697144,-74.140516)"
2015,Septiembre,Uruguay,858,0,2,,2,"(4.815061,-75.736532)"
2015,Septiembre,Uruguay,858,15,9,,24,"(6.171601,-75.427454)"
2015,Septiembre,Venezuela,862,1,13,,14,"(10.408582,-75.538003)"
2015,Septiembre,Venezuela,862,82,50,,132,"(10.445761,-75.516429)"
2015,Septiembre,Venezuela,862,16,50,,66,"(10.886611,-74.776708)"
2015,Septiembre,Venezuela,862,0,1,,1,"(10.971302,-74.765397)"
2015,Septiembre,Venezuela,862,1478,1314,,2792,"(11.360009,-72.129330)"
2015,Septiembre,Venezuela,862,0,4,,4,"(12.586067,-81.702563)"
2015,Septiembre,Venezuela,862,10,16,,26,"(3.541112,-76.384584)"
2015,Septiembre,Venezuela,862,8,8,,16,"(3.866713,-67.927521)"
2015,Septiembre,Venezuela,862,1160,1493,,2653,"(4.697144,-74.140516)"
2015,Septiembre,Venezuela,862,1,2,,3,"(4.815061,-75.736532)"
2015,Septiembre,Venezuela,862,315,309,,624,"(6.171601,-75.427454)"
2015,Septiembre,Venezuela,862,53,68,,121,"(6.185799,-67.483929)"
2015,Septiembre,Venezuela,862,403,352,,755,"(7.088729,-70.740253)"
2015,Septiembre,Venezuela,862,1,3,,4,"(7.128456,-73.183637)"
2015,Septiembre,Venezuela,862,244,204,,448,"(7.818934,-72.453226)"
2015,Septiembre,Venezuela,862,2,4,,6,"(7.927209,-72.507910)"
2015,Septiembre,Vietnam,704,1,1,,2,"(3.541112,-76.384584)"
2015,Septiembre,Vietnam,704,18,24,,42,"(4.697144,-74.140516)"
2015,Septiembre,Islas Vírgenes Británicas/Territorio Británico de Ultramar,92,1,0,,1,"(6.171601,-75.427454)"
2015,Septiembre,Zambia,894,0,1,,1,"(4.697144,-74.140516)"
2015,Octubre,Afganistán,4,3,4,,7,"(4.697144,-74.140516)"
2015,Octubre,Albania,8,0,1,,1,"(4.697144,-74.140516)"
2015,Octubre,Alemania,276,0,1,,1,"(0.814836,-77.662532)"
2015,Octubre,Alemania,276,1,3,,4,"(10.886611,-74.776708)"
2015,Octubre,Alemania,276,49,34,,83,"(3.541112,-76.384584)"
2015,Octubre,Alemania,276,976,1016,,1992,"(4.697144,-74.140516)"
2015,Octubre,Alemania,276,18,22,,40,"(6.171601,-75.427454)"
2015,Octubre,Angola,24,1,6,,7,"(4.697144,-74.140516)"
2015,Octubre,Antigua y Barbuda,28,2,1,,3,"(4.697144,-74.140516)"
2015,Octubre,Antigua y Barbuda,28,0,1,,1,"(6.171601,-75.427454)"
2015,Octubre,Países Bajos,528,0,1,,1,"(10.408582,-75.538003)"
2015,Octubre,Países Bajos,528,1,0,,1,"(10.445761,-75.516429)"
2015,Octubre,Países Bajos,528,127,74,,201,"(10.886611,-74.776708)"
2015,Octubre,Países Bajos,528,127,67,,194,"(3.541112,-76.384584)"
2015,Octubre,Países Bajos,528,602,603,,1205,"(4.697144,-74.140516)"
2015,Octubre,Países Bajos,528,10,3,,13,"(4.815061,-75.736532)"
2015,Octubre,Países Bajos,528,220,118,,338,"(6.171601,-75.427454)"
2015,Octubre,Países Bajos,528,0,2,,2,"(7.128456,-73.183637)"
2015,Octubre,Países Bajos,528,1,4,,5,"(7.927209,-72.507910)"
2015,Octubre,Arabia Saudita,682,0,1,,1,"(10.886611,-74.776708)"
2015,Octubre,Arabia Saudita,682,1,1,,2,"(3.541112,-76.384584)"
2015,Octubre,Arabia Saudita,682,3,27,,30,"(4.697144,-74.140516)"
2015,Octubre,Arabia Saudita,682,0,4,,4,"(6.171601,-75.427454)"
2015,Octubre,Argelia,12,2,4,,6,"(4.697144,-74.140516)"
2015,Octubre,Argelia,12,0,1,,1,"(6.171601,-75.427454)"
2015,Octubre,Argentina,32,6,14,,20,"(0.814836,-77.662532)"
2015,Octubre,Argentina,32,7,8,,15,"(10.445761,-75.516429)"
2015,Octubre,Argentina,32,22,23,,45,"(10.886611,-74.776708)"
2015,Octubre,Argentina,32,4,5,,9,"(12.586067,-81.702563)"
2015,Octubre,Argentina,32,154,140,,294,"(3.541112,-76.384584)"
2015,Octubre,Argentina,32,2557,2365,,4922,"(4.697144,-74.140516)"
2015,Octubre,Argentina,32,13,18,,31,"(4.815061,-75.736532)"
2015,Octubre,Argentina,32,141,159,,300,"(6.171601,-75.427454)"
2015,Octubre,Argentina,32,10,13,,23,"(7.128456,-73.183637)"
2015,Octubre,Argentina,32,2,0,,2,"(7.927209,-72.507910)"
2015,Octubre,República de Armenia,51,0,1,,1,"(4.697144,-74.140516)"
2015,Octubre,Aruba,533,2007,1350,,3357,"(10.408582,-75.538003)"
2015,Octubre,Aruba,533,3,3,,6,"(10.445761,-75.516429)"
2015,Octubre,Aruba,533,26,19,,45,"(10.886611,-74.776708)"
2015,Octubre,Aruba,533,6,5,,11,"(11.247723,-74.213989)"
2015,Octubre,Aruba,533,35,24,,59,"(3.541112,-76.384584)"
2015,Octubre,Aruba,533,1235,1019,,2254,"(4.697144,-74.140516)"
2015,Octubre,Aruba,533,10,6,,16,"(4.815061,-75.736532)"
2015,Octubre,Aruba,533,143,100,,243,"(6.171601,-75.427454)"
2015,Octubre,Aruba,533,16,24,,40,"(7.128456,-73.183637)"
2015,Octubre,Aruba,533,0,1,,1,"(7.927209,-72.507910)"
2015,Octubre,Australia,36,2,0,,2,"(10.445761,-75.516429)"
2015,Octubre,Australia,36,2,2,,4,"(10.886611,-74.776708)"
2015,Octubre,Australia,36,18,7,,25,"(3.541112,-76.384584)"
2015,Octubre,Australia,36,179,125,,304,"(4.697144,-74.140516)"
2015,Octubre,Australia,36,2,1,,3,"(4.815061,-75.736532)"
2015,Octubre,Australia,36,29,16,,45,"(6.171601,-75.427454)"
2015,Octubre,Australia,36,0,1,,1,"(7.128456,-73.183637)"
2015,Octubre,Austria,40,3,4,,7,"(3.541112,-76.384584)"
2015,Octubre,Austria,40,28,19,,47,"(4.697144,-74.140516)"
2015,Octubre,Austria,40,3,1,,4,"(6.171601,-75.427454)"
2015,Octubre,Azerbaiyán,31,1,1,,2,"(4.697144,-74.140516)"
2015,Octubre,Bahamas,44,1,1,,2,"(10.445761,-75.516429)"
2015,Octubre,Bahamas,44,1,0,,1,"(10.886611,-74.776708)"
2015,Octubre,Bahamas,44,12,8,,20,"(3.541112,-76.384584)"
2015,Octubre,Bahamas,44,17,16,,33,"(4.697144,-74.140516)"
2015,Octubre,Bahamas,44,0,3,,3,"(4.815061,-75.736532)"
2015,Octubre,Bahamas,44,21,16,,37,"(6.171601,-75.427454)"
2015,Octubre,Bahamas,44,1,0,,1,"(7.927209,-72.507910)"
2015,Octubre,Bahréin,48,3,3,,6,"(4.697144,-74.140516)"
2015,Octubre,Bahréin,48,0,1,,1,"(6.171601,-75.427454)"
2015,Octubre,Bangladesh,50,0,1,,1,"(10.886611,-74.776708)"
2015,Octubre,Bangladesh,50,1,2,,3,"(4.697144,-74.140516)"
2015,Octubre,Barbados,52,0,1,,1,"(10.886611,-74.776708)"
2015,Octubre,Barbados,52,1,0,,1,"(3.541112,-76.384584)"
2015,Octubre,Barbados,52,4,4,,8,"(4.697144,-74.140516)"
2015,Octubre,Barbados,52,0,1,,1,"(6.171601,-75.427454)"
2015,Octubre,República de Belarús,112,0,2,,2,"(4.697144,-74.140516)"
2015,Octubre,Bélgica,56,7,6,,13,"(3.541112,-76.384584)"
2015,Octubre,Bélgica,56,63,53,,116,"(4.697144,-74.140516)"
2015,Octubre,Bélgica,56,11,6,,17,"(6.171601,-75.427454)"
2015,Octubre,Belice,84,2,5,,7,"(10.445761,-75.516429)"
2015,Octubre,Belice,84,13,18,,31,"(3.541112,-76.384584)"
2015,Octubre,Belice,84,8,6,,14,"(4.697144,-74.140516)"
2015,Octubre,Belice,84,1,4,,5,"(6.171601,-75.427454)"
2015,Octubre,Bermudas/Territorio Británico de Ultramar,60,1,0,,1,"(4.697144,-74.140516)"
2015,Octubre,Bolivia,68,1,5,,6,"(0.814836,-77.662532)"
2015,Octubre,Bolivia,68,1,0,,1,"(10.408582,-75.538003)"
2015,Octubre,Bolivia,68,0,1,,1,"(10.445761,-75.516429)"
2015,Octubre,Bolivia,68,3,7,,10,"(10.886611,-74.776708)"
2015,Octubre,Bolivia,68,38,59,,97,"(3.541112,-76.384584)"
2015,Octubre,Bolivia,68,296,520,,816,"(4.697144,-74.140516)"
2015,Octubre,Bolivia,68,1,4,,5,"(4.815061,-75.736532)"
2015,Octubre,Bolivia,68,31,64,,95,"(6.171601,-75.427454)"
2015,Octubre,Bolivia,68,0,4,,4,"(7.128456,-73.183637)"
2015,Octubre,Bosnia y Herzegovina,70,0,1,,1,"(3.541112,-76.384584)"
2015,Octubre,Brasil,76,95,197,,292,"(-4.197703,-69.941278)"
2015,Octubre,Brasil,76,0,1,,1,"(-4.223468,-69.945098)"
2015,Octubre,Brasil,76,2,2,,4,"(0.814836,-77.662532)"
2015,Octubre,Brasil,76,2,4,,6,"(10.445761,-75.516429)"
2015,Octubre,Brasil,76,13,17,,30,"(10.886611,-74.776708)"
2015,Octubre,Brasil,76,1,2,,3,"(12.586067,-81.702563)"
2015,Octubre,Brasil,76,74,128,,202,"(3.541112,-76.384584)"
2015,Octubre,Brasil,76,2915,3377,,6292,"(4.697144,-74.140516)"
2015,Octubre,Brasil,76,14,35,,49,"(4.815061,-75.736532)"
2015,Octubre,Brasil,76,132,168,,300,"(6.171601,-75.427454)"
2015,Octubre,Brasil,76,12,4,,16,"(7.128456,-73.183637)"
2015,Octubre,Brasil,76,0,1,,1,"(7.927209,-72.507910)"
2015,Octubre,Bulgaria,100,1,9,,10,"(4.697144,-74.140516)"
2015,Octubre,Islas Caimán/Territorio Británico de Ultramar,136,7,2,,9,"(12.586067,-81.702563)"
2015,Octubre,Islas Caimán/Territorio Británico de Ultramar,136,0,1,,1,"(3.541112,-76.384584)"
2015,Octubre,Islas Caimán/Territorio Británico de Ultramar,136,2,1,,3,"(4.697144,-74.140516)"
2015,Octubre,Islas Caimán/Territorio Británico de Ultramar,136,1,0,,1,"(6.171601,-75.427454)"
2015,Octubre,Camboya,116,1,0,,1,"(3.541112,-76.384584)"
2015,Octubre,Camboya,116,1,1,,2,"(4.697144,-74.140516)"
2015,Octubre,Canadá,124,13,9,,22,"(10.445761,-75.516429)"
2015,Octubre,Canadá,124,23,22,,45,"(10.886611,-74.776708)"
2015,Octubre,Canadá,124,94,66,,160,"(3.541112,-76.384584)"
2015,Octubre,Canadá,124,0,1,,1,"(4.452882,-75.766298)"
2015,Octubre,Canadá,124,995,960,,1955,"(4.697144,-74.140516)"
2015,Octubre,Canadá,124,8,10,,18,"(4.815061,-75.736532)"
2015,Octubre,Canadá,124,194,157,,351,"(6.171601,-75.427454)"
2015,Octubre,Canadá,124,13,15,,28,"(7.128456,-73.183637)"
2015,Octubre,Canadá,124,2,2,,4,"(7.927209,-72.507910)"
2015,Octubre,España,724,8,8,,16,"(10.445761,-75.516429)"
2015,Octubre,España,724,12,6,,18,"(10.886611,-74.776708)"
2015,Octubre,España,724,1,1,,2,"(12.586067,-81.702563)"
2015,Octubre,España,724,1823,1270,,3093,"(3.541112,-76.384584)"
2015,Octubre,España,724,6927,5664,,12591,"(4.697144,-74.140516)"
2015,Octubre,España,724,16,6,,22,"(4.815061,-75.736532)"
2015,Octubre,España,724,1037,715,,1752,"(6.171601,-75.427454)"
2015,Octubre,España,724,6,8,,14,"(7.128456,-73.183637)"
2015,Octubre,España,724,0,1,,1,"(7.927209,-72.507910)"
2015,Octubre,Colombia,170,39,157,,196,"(4.697144,-74.140516)"
2015,Octubre,República Del Congo,178,0,2,,2,"(4.697144,-74.140516)"
2015,Octubre,República de Corea,410,3,1,,4,"(3.541112,-76.384584)"
2015,Octubre,República de Corea,410,26,42,,68,"(4.697144,-74.140516)"
2015,Octubre,República de Corea,410,0,3,,3,"(6.171601,-75.427454)"
2015,Octubre,Costa de Marfil,384,3,4,,7,"(4.697144,-74.140516)"
2015,Octubre,Costa Rica,188,14,15,,29,"(10.445761,-75.516429)"
2015,Octubre,Costa Rica,188,18,32,,50,"(10.886611,-74.776708)"
2015,Octubre,Costa Rica,188,3,29,,32,"(12.5744111,-81.703935)"
2015,Octubre,Costa Rica,188,7,2,,9,"(12.586067,-81.702563)"
2015,Octubre,Costa Rica,188,35,30,,65,"(3.541112,-76.384584)"
2015,Octubre,Costa Rica,188,852,1085,,1937,"(4.697144,-74.140516)"
2015,Octubre,Costa Rica,188,13,15,,28,"(4.815061,-75.736532)"
2015,Octubre,Costa Rica,188,149,115,,264,"(6.171601,-75.427454)"
2015,Octubre,Costa Rica,188,5,10,,15,"(7.128456,-73.183637)"
2015,Octubre,Costa Rica,188,1,0,,1,"(7.927209,-72.507910)"
2015,Octubre,Croacia,191,1,0,,1,"(3.541112,-76.384584)"
2015,Octubre,Croacia,191,3,6,,9,"(4.697144,-74.140516)"
2015,Octubre,Cuba,192,16,28,,44,"(10.445761,-75.516429)"
2015,Octubre,Cuba,192,21,31,,52,"(10.886611,-74.776708)"
2015,Octubre,Cuba,192,3,3,,6,"(12.586067,-81.702563)"
2015,Octubre,Cuba,192,88,71,,159,"(3.541112,-76.384584)"
2015,Octubre,Cuba,192,839,839,,1678,"(4.697144,-74.140516)"
2015,Octubre,Cuba,192,15,13,,28,"(4.815061,-75.736532)"
2015,Octubre,Cuba,192,119,105,,224,"(6.171601,-75.427454)"
2015,Octubre,Cuba,192,15,34,,49,"(7.128456,-73.183637)"
2015,Octubre,Cuba,192,4,7,,11,"(7.927209,-72.507910)"
2015,Octubre,Curazao,99999,7,15,,22,"(4.697144,-74.140516)"
2015,Octubre,República Checa,203,9,6,,15,"(4.697144,-74.140516)"
2015,Octubre,Chile,152,104,95,,199,"(0.814836,-77.662532)"
2015,Octubre,Chile,152,21,14,,35,"(10.445761,-75.516429)"
2015,Octubre,Chile,152,23,26,,49,"(10.886611,-74.776708)"
2015,Octubre,Chile,152,6,4,,10,"(12.586067,-81.702563)"
2015,Octubre,Chile,152,313,278,,591,"(3.541112,-76.384584)"
2015,Octubre,Chile,152,3059,3072,,6131,"(4.697144,-74.140516)"
2015,Octubre,Chile,152,90,98,,188,"(4.815061,-75.736532)"
2015,Octubre,Chile,152,157,150,,307,"(6.171601,-75.427454)"
2015,Octubre,Chile,152,23,17,,40,"(7.128456,-73.183637)"
2015,Octubre,Chile,152,2,2,,4,"(7.927209,-72.507910)"
2015,Octubre,China,156,0,1,,1,"(10.445761,-75.516429)"
2015,Octubre,China,156,4,4,,8,"(10.886611,-74.776708)"
2015,Octubre,China,156,13,19,,32,"(3.541112,-76.384584)"
2015,Octubre,China,156,158,399,,557,"(4.697144,-74.140516)"
2015,Octubre,China,156,24,66,,90,"(6.171601,-75.427454)"
2015,Octubre,China,156,3,3,,6,"(7.128456,-73.183637)"
2015,Octubre,Chipre,196,0,1,,1,"(4.697144,-74.140516)"
2015,Octubre,Dinamarca,208,2,1,,3,"(3.541112,-76.384584)"
2015,Octubre,Dinamarca,208,28,25,,53,"(4.697144,-74.140516)"
2015,Octubre,Dinamarca,208,1,0,,1,"(6.171601,-75.427454)"
2015,Octubre,Ecuador,218,429,676,,1105,"(0.25129,-76.875963)"
2015,Octubre,Ecuador,218,21,34,,55,"(0.812436,-77.847006)"
2015,Octubre,Ecuador,218,5009,6001,,11010,"(0.814836,-77.662532)"
2015,Octubre,Ecuador,218,140,146,,286,"(1.813928,-78.763924)"
2015,Octubre,Ecuador,218,2,2,,4,"(10.445761,-75.516429)"
2015,Octubre,Ecuador,218,8,16,,24,"(10.886611,-74.776708)"
2015,Octubre,Ecuador,218,1,1,,2,"(12.586067,-81.702563)"
2015,Octubre,Ecuador,218,331,377,,708,"(3.541112,-76.384584)"
2015,Octubre,Ecuador,218,0,1,,1,"(3.893038,-77.067921)"
2015,Octubre,Ecuador,218,2371,3857,,6228,"(4.697144,-74.140516)"
2015,Octubre,Ecuador,218,2,8,,10,"(4.815061,-75.736532)"
2015,Octubre,Ecuador,218,50,77,,127,"(6.171601,-75.427454)"
2015,Octubre,Ecuador,218,0,3,,3,"(6.228046,-77.404104)"
2015,Octubre,Ecuador,218,2,8,,10,"(7.128456,-73.183637)"
2015,Octubre,Ecuador,218,0,1,,1,"(7.927209,-72.507910)"
2015,Octubre,Egipto,818,0,1,,1,"(3.541112,-76.384584)"
2015,Octubre,Egipto,818,36,154,,190,"(4.697144,-74.140516)"
2015,Octubre,El Salvador,222,0,2,,2,"(10.445761,-75.516429)"
2015,Octubre,El Salvador,222,4,1,,5,"(10.886611,-74.776708)"
2015,Octubre,El Salvador,222,53,61,,114,"(3.541112,-76.384584)"
2015,Octubre,El Salvador,222,744,922,,1666,"(4.697144,-74.140516)"
2015,Octubre,El Salvador,222,1,0,,1,"(4.815061,-75.736532)"
2015,Octubre,El Salvador,222,68,101,,169,"(6.171601,-75.427454)"
2015,Octubre,El Salvador,222,0,2,,2,"(7.128456,-73.183637)"
2015,Octubre,Emiratos Árabes,784,1,0,,1,"(10.445761,-75.516429)"
2015,Octubre,Emiratos Árabes,784,2,2,,4,"(3.541112,-76.384584)"
2015,Octubre,Emiratos Árabes,784,118,204,,322,"(4.697144,-74.140516)"
2015,Octubre,Emiratos Árabes,784,5,8,,13,"(6.171601,-75.427454)"
2015,Octubre,Eslovaquia,703,1,1,,2,"(4.697144,-74.140516)"
2015,Octubre,Eslovenia,705,1,0,,1,"(3.541112,-76.384584)"
2015,Octubre,Eslovenia,705,0,3,,3,"(4.697144,-74.140516)"
2015,Octubre,Estados Unidos de América,840,1,0,,1,"(0.814836,-77.662532)"
2015,Octubre,Estados Unidos de América,840,0,1,,1,"(10.408582,-75.538003)"
2015,Octubre,Estados Unidos de América,840,3172,2569,,5741,"(10.445761,-75.516429)"
2015,Octubre,Estados Unidos de América,840,2825,2285,,5110,"(10.886611,-74.776708)"
2015,Octubre,Estados Unidos de América,840,0,3,,3,"(10.971302,-74.765397)"
2015,Octubre,Estados Unidos de América,840,5,0,,5,"(11.117806,-74.232622)"
2015,Octubre,Estados Unidos de América,840,38,28,,66,"(12.586067,-81.702563)"
2015,Octubre,Estados Unidos de América,840,4964,3633,,8597,"(3.541112,-76.384584)"
2015,Octubre,Estados Unidos de América,840,484,343,,827,"(4.452882,-75.766298)"
2015,Octubre,Estados Unidos de América,840,30244,27717,,57961,"(4.697144,-74.140516)"
2015,Octubre,Estados Unidos de América,840,827,624,,1451,"(4.815061,-75.736532)"
2015,Octubre,Estados Unidos de América,840,9068,7187,,16255,"(6.171601,-75.427454)"
2015,Octubre,Estados Unidos de América,840,277,213,,490,"(7.128456,-73.183637)"
2015,Octubre,Estados Unidos de América,840,122,83,,205,"(7.927209,-72.507910)"
2015,Octubre,Estonia,233,0,1,,1,"(4.697144,-74.140516)"
2015,Octubre,Etiopia,231,3,5,,8,"(4.697144,-74.140516)"
2015,Octubre,Filipinas,608,0,2,,2,"(3.541112,-76.384584)"
2015,Octubre,Filipinas,608,3,3,,6,"(4.697144,-74.140516)"
2015,Octubre,Finlandia,246,1,0,,1,"(3.541112,-76.384584)"
2015,Octubre,Finlandia,246,1,5,,6,"(4.697144,-74.140516)"
2015,Octubre,Francia,250,1,0,,1,"(10.445761,-75.516429)"
2015,Octubre,Francia,250,1,2,,3,"(10.886611,-74.776708)"
2015,Octubre,Francia,250,67,37,,104,"(3.541112,-76.384584)"
2015,Octubre,Francia,250,997,879,,1876,"(4.697144,-74.140516)"
2015,Octubre,Francia,250,23,29,,52,"(6.171601,-75.427454)"
2015,Octubre,Georgia,268,1,0,,1,"(4.697144,-74.140516)"
2015,Octubre,Ghana,288,2,2,,4,"(4.697144,-74.140516)"
2015,Octubre,Ghana,288,0,1,,1,"(6.171601,-75.427454)"
2015,Octubre,Gibraltar/Territorio Británico de Ultramar,292,1,0,,1,"(0.814836,-77.662532)"
2015,Octubre,Granada,308,1,0,,1,"(4.697144,-74.140516)"
2015,Octubre,Grecia,300,2,0,,2,"(3.541112,-76.384584)"
2015,Octubre,Grecia,300,12,12,,24,"(4.697144,-74.140516)"
2015,Octubre,Grecia,300,1,0,,1,"(6.171601,-75.427454)"
2015,Octubre,Guatemala,320,1,3,,4,"(10.445761,-75.516429)"
2015,Octubre,Guatemala,320,13,6,,19,"(10.886611,-74.776708)"
2015,Octubre,Guatemala,320,1,1,,2,"(12.586067,-81.702563)"
2015,Octubre,Guatemala,320,69,81,,150,"(3.541112,-76.384584)"
2015,Octubre,Guatemala,320,430,627,,1057,"(4.697144,-74.140516)"
2015,Octubre,Guatemala,320,11,17,,28,"(4.815061,-75.736532)"
2015,Octubre,Guatemala,320,101,98,,199,"(6.171601,-75.427454)"
2015,Octubre,Guatemala,320,16,14,,30,"(7.128456,-73.183637)"
2015,Octubre,Guatemala,320,3,5,,8,"(7.927209,-72.507910)"
2015,Octubre,Guyana,328,0,2,,2,"(10.886611,-74.776708)"
2015,Octubre,Guyana,328,0,2,,2,"(4.697144,-74.140516)"
2015,Octubre,Guyana,328,1,1,,2,"(6.171601,-75.427454)"
2015,Octubre,Guyana,328,0,1,,1,"(7.128456,-73.183637)"
2015,Octubre,Guyana,328,0,1,,1,"(7.927209,-72.507910)"
2015,Octubre,Guinea,324,0,1,,1,"(4.697144,-74.140516)"
2015,Octubre,Guinea Ecuatorial,226,2,7,,9,"(3.541112,-76.384584)"
2015,Octubre,Guinea Ecuatorial,226,3,4,,7,"(4.697144,-74.140516)"
2015,Octubre,Guadalupe/Territorio Francés,312,1,1,,2,"(4.697144,-74.140516)"
2015,Octubre,Guayana Francesa/Departamento de Ultramar Francés,254,1,0,,1,"(4.697144,-74.140516)"
2015,Octubre,Guayana Francesa/Departamento de Ultramar Francés,254,1,0,,1,"(6.171601,-75.427454)"
2015,Octubre,Haití,332,1,2,,3,"(10.445761,-75.516429)"
2015,Octubre,Haití,332,1,4,,5,"(10.886611,-74.776708)"
2015,Octubre,Haití,332,0,1,,1,"(3.541112,-76.384584)"
2015,Octubre,Haití,332,7,19,,26,"(4.697144,-74.140516)"
2015,Octubre,Haití,332,1,0,,1,"(4.815061,-75.736532)"
2015,Octubre,Haití,332,1,4,,5,"(6.171601,-75.427454)"
2015,Octubre,Haití,332,0,1,,1,"(7.128456,-73.183637)"
2015,Octubre,Honduras,340,1,1,,2,"(10.445761,-75.516429)"
2015,Octubre,Honduras,340,4,3,,7,"(10.886611,-74.776708)"
2015,Octubre,Honduras,340,0,1,,1,"(12.5744111,-81.703935)"
2015,Octubre,Honduras,340,0,2,,2,"(12.586067,-81.702563)"
2015,Octubre,Honduras,340,11,20,,31,"(3.541112,-76.384584)"
2015,Octubre,Honduras,340,85,148,,233,"(4.697144,-74.140516)"
2015,Octubre,Honduras,340,1,4,,5,"(4.815061,-75.736532)"
2015,Octubre,Honduras,340,26,54,,80,"(6.171601,-75.427454)"
2015,Octubre,Honduras,340,0,2,,2,"(7.128456,-73.183637)"
2015,Octubre,Hong Kong,344,3,2,,5,"(3.541112,-76.384584)"
2015,Octubre,Hong Kong,344,51,66,,117,"(4.697144,-74.140516)"
2015,Octubre,Hong Kong,344,0,4,,4,"(6.171601,-75.427454)"
2015,Octubre,Hungría,348,7,15,,22,"(4.697144,-74.140516)"
2015,Octubre,India,356,2,1,,3,"(3.541112,-76.384584)"
2015,Octubre,India,356,40,32,,72,"(4.697144,-74.140516)"
2015,Octubre,India,356,1,2,,3,"(4.815061,-75.736532)"
2015,Octubre,India,356,8,4,,12,"(6.171601,-75.427454)"
2015,Octubre,Indonesia,360,6,7,,13,"(4.697144,-74.140516)"
2015,Octubre,Iraq,368,2,1,,3,"(3.541112,-76.384584)"
2015,Octubre,Iraq,368,0,3,,3,"(4.697144,-74.140516)"
2015,Octubre,Irán,364,1,3,,4,"(4.697144,-74.140516)"
2015,Octubre,República de Irlanda,372,1,0,,1,"(3.541112,-76.384584)"
2015,Octubre,República de Irlanda,372,17,7,,24,"(4.697144,-74.140516)"
2015,Octubre,República de Irlanda,372,0,1,,1,"(6.171601,-75.427454)"
2015,Octubre,República de Irlanda,372,0,1,,1,"(7.128456,-73.183637)"
2015,Octubre,Islandia,352,3,1,,4,"(4.697144,-74.140516)"
2015,Octubre,Israel,376,0,1,,1,"(10.445761,-75.516429)"
2015,Octubre,Israel,376,9,9,,18,"(3.541112,-76.384584)"
2015,Octubre,Israel,376,205,155,,360,"(4.697144,-74.140516)"
2015,Octubre,Israel,376,4,1,,5,"(6.171601,-75.427454)"
2015,Octubre,Italia,380,3,2,,5,"(10.445761,-75.516429)"
2015,Octubre,Italia,380,1,0,,1,"(10.886611,-74.776708)"
2015,Octubre,Italia,380,153,57,,210,"(3.541112,-76.384584)"
2015,Octubre,Italia,380,516,386,,902,"(4.697144,-74.140516)"
2015,Octubre,Italia,380,44,39,,83,"(6.171601,-75.427454)"
2015,Octubre,Italia,380,2,0,,2,"(7.128456,-73.183637)"
2015,Octubre,Jamaica,388,2,4,,6,"(10.445761,-75.516429)"
2015,Octubre,Jamaica,388,1,2,,3,"(10.886611,-74.776708)"
2015,Octubre,Jamaica,388,2,0,,2,"(12.586067,-81.702563)"
2015,Octubre,Jamaica,388,5,7,,12,"(3.541112,-76.384584)"
2015,Octubre,Jamaica,388,17,27,,44,"(4.697144,-74.140516)"
2015,Octubre,Jamaica,388,2,4,,6,"(4.815061,-75.736532)"
2015,Octubre,Jamaica,388,23,21,,44,"(6.171601,-75.427454)"
2015,Octubre,Jamaica,388,2,3,,5,"(7.128456,-73.183637)"
2015,Octubre,Jamaica,388,1,2,,3,"(7.927209,-72.507910)"
2015,Octubre,Japón,392,0,1,,1,"(0.814836,-77.662532)"
2015,Octubre,Japón,392,1,0,,1,"(3.541112,-76.384584)"
2015,Octubre,Japón,392,53,74,,127,"(4.697144,-74.140516)"
2015,Octubre,Japón,392,5,8,,13,"(6.171601,-75.427454)"
2015,Octubre,Jordania,400,2,4,,6,"(4.697144,-74.140516)"
2015,Octubre,Jordania,400,0,1,,1,"(7.128456,-73.183637)"
2015,Octubre,Kazajistán,398,0,2,,2,"(4.697144,-74.140516)"
2015,Octubre,Kazajistán,398,0,1,,1,"(6.171601,-75.427454)"
2015,Octubre,Kenia,404,0,3,,3,"(4.697144,-74.140516)"
2015,Octubre,Kuwait,414,2,2,,4,"(4.697144,-74.140516)"
2015,Octubre,República Democrática Popular  Lao,418,0,3,,3,"(4.697144,-74.140516)"
2015,Octubre,Letonia,428,1,2,,3,"(4.697144,-74.140516)"
2015,Octubre,Lituania,440,1,34,,35,"(4.697144,-74.140516)"
2015,Octubre,Líbano,422,13,9,,22,"(4.697144,-74.140516)"
2015,Octubre,Liberia,430,1,0,,1,"(4.697144,-74.140516)"
2015,Octubre,Luxemburgo,442,8,4,,12,"(4.697144,-74.140516)"
2015,Octubre,Malasia,458,9,20,,29,"(4.697144,-74.140516)"
2015,Octubre,Malta,470,3,6,,9,"(4.697144,-74.140516)"
2015,Octubre,Marruecos,504,1,0,,1,"(3.541112,-76.384584)"
2015,Octubre,Marruecos,504,7,3,,10,"(4.697144,-74.140516)"
2015,Octubre,Mauritania,478,0,2,,2,"(4.697144,-74.140516)"
2015,Octubre,México,484,1,3,,4,"(0.814836,-77.662532)"
2015,Octubre,México,484,54,40,,94,"(10.445761,-75.516429)"
2015,Octubre,México,484,194,152,,346,"(10.886611,-74.776708)"
2015,Octubre,México,484,5,3,,8,"(12.586067,-81.702563)"
2015,Octubre,México,484,596,506,,1102,"(3.541112,-76.384584)"
2015,Octubre,México,484,13318,12019,,25337,"(4.697144,-74.140516)"
2015,Octubre,México,484,129,110,,239,"(4.815061,-75.736532)"
2015,Octubre,México,484,2221,1887,,4108,"(6.171601,-75.427454)"
2015,Octubre,México,484,197,157,,354,"(7.128456,-73.183637)"
2015,Octubre,México,484,68,55,,123,"(7.927209,-72.507910)"
2015,Octubre,Mónaco,492,1,1,,2,"(4.697144,-74.140516)"
2015,Octubre,Mozambique,508,1,1,,2,"(4.697144,-74.140516)"
2015,Octubre,Myanmar,104,1,0,,1,"(10.886611,-74.776708)"
2015,Octubre,Nicaragua,558,0,13,,13,"(10.408582,-75.538003)"
2015,Octubre,Nicaragua,558,2,21,,23,"(10.445761,-75.516429)"
2015,Octubre,Nicaragua,558,0,4,,4,"(10.886611,-74.776708)"
2015,Octubre,Nicaragua,558,1,2,,3,"(12.5744111,-81.703935)"
2015,Octubre,Nicaragua,558,1,4,,5,"(12.586067,-81.702563)"
2015,Octubre,Nicaragua,558,13,43,,56,"(3.541112,-76.384584)"
2015,Octubre,Nicaragua,558,45,61,,106,"(4.697144,-74.140516)"
2015,Octubre,Nicaragua,558,2,5,,7,"(4.815061,-75.736532)"
2015,Octubre,Nicaragua,558,10,45,,55,"(6.171601,-75.427454)"
2015,Octubre,Nicaragua,558,2,2,,4,"(7.128456,-73.183637)"
2015,Octubre,Nigeria,566,1,3,,4,"(4.697144,-74.140516)"
2015,Octubre,Níger,562,0,3,,3,"(4.697144,-74.140516)"
2015,Octubre,Noruega,578,0,1,,1,"(10.886611,-74.776708)"
2015,Octubre,Noruega,578,4,5,,9,"(3.541112,-76.384584)"
2015,Octubre,Noruega,578,14,16,,30,"(4.697144,-74.140516)"
2015,Octubre,Nueva Zelanda,554,1,0,,1,"(3.541112,-76.384584)"
2015,Octubre,Nueva Zelanda,554,23,20,,43,"(4.697144,-74.140516)"
2015,Octubre,Nueva Zelanda,554,0,1,,1,"(6.171601,-75.427454)"
2015,Octubre,Omán,512,0,3,,3,"(4.697144,-74.140516)"
2015,Octubre,Papúa Nueva Guinea,598,0,1,,1,"(6.171601,-75.427454)"
2015,Octubre,Pakistán,586,0,2,,2,"(4.697144,-74.140516)"
2015,Octubre,Panamá,591,53,93,,146,"(10.408582,-75.538003)"
2015,Octubre,Panamá,591,333,345,,678,"(10.445761,-75.516429)"
2015,Octubre,Panamá,591,874,958,,1832,"(10.886611,-74.776708)"
2015,Octubre,Panamá,591,0,1,,1,"(10.971302,-74.765397)"
2015,Octubre,Panamá,591,0,2,,2,"(11.117806,-74.232622)"
2015,Octubre,Panamá,591,1,2,,3,"(12.5744111,-81.703935)"
2015,Octubre,Panamá,591,163,139,,302,"(12.586067,-81.702563)"
2015,Octubre,Panamá,591,1543,1505,,3048,"(3.541112,-76.384584)"
2015,Octubre,Panamá,591,8576,9151,,17727,"(4.697144,-74.140516)"
2015,Octubre,Panamá,591,504,412,,916,"(4.815061,-75.736532)"
2015,Octubre,Panamá,591,3226,3065,,6291,"(6.171601,-75.427454)"
2015,Octubre,Panamá,591,0,10,,10,"(6.228046,-77.404104)"
2015,Octubre,Panamá,591,13,25,,38,"(7.102626,-77.762647)"
2015,Octubre,Panamá,591,305,260,,565,"(7.128456,-73.183637)"
2015,Octubre,Panamá,591,105,107,,212,"(7.927209,-72.507910)"
2015,Octubre,Panamá,591,0,59,,59,"(8.066966,-76.735404)"
2015,Octubre,Panamá,591,41,66,,107,"(8.635765,-77.346578)"
2015,Octubre,Paraguay,600,0,1,,1,"(10.445761,-75.516429)"
2015,Octubre,Paraguay,600,0,4,,4,"(10.886611,-74.776708)"
2015,Octubre,Paraguay,600,13,23,,36,"(3.541112,-76.384584)"
2015,Octubre,Paraguay,600,46,134,,180,"(4.697144,-74.140516)"
2015,Octubre,Paraguay,600,6,12,,18,"(4.815061,-75.736532)"
2015,Octubre,Paraguay,600,10,22,,32,"(6.171601,-75.427454)"
2015,Octubre,Perú,604,62,96,,158,"(-4.197703,-69.941278)"
2015,Octubre,Perú,604,3,1,,4,"(0.25129,-76.875963)"
2015,Octubre,Perú,604,41,56,,97,"(0.814836,-77.662532)"
2015,Octubre,Perú,604,2,1,,3,"(10.445761,-75.516429)"
2015,Octubre,Perú,604,18,29,,47,"(10.886611,-74.776708)"
2015,Octubre,Perú,604,1,2,,3,"(12.586067,-81.702563)"
2015,Octubre,Perú,604,266,360,,626,"(3.541112,-76.384584)"
2015,Octubre,Perú,604,4802,5280,,10082,"(4.697144,-74.140516)"
2015,Octubre,Perú,604,6,9,,15,"(4.815061,-75.736532)"
2015,Octubre,Perú,604,405,492,,897,"(6.171601,-75.427454)"
2015,Octubre,Perú,604,6,9,,15,"(7.128456,-73.183637)"
2015,Octubre,Palestina,99999,2,0,,2,"(4.697144,-74.140516)"
2015,Octubre,Polonia,616,1,2,,3,"(3.541112,-76.384584)"
2015,Octubre,Polonia,616,5,19,,24,"(4.697144,-74.140516)"
2015,Octubre,Polonia,616,1,1,,2,"(6.171601,-75.427454)"
2015,Octubre,Portugal,620,6,7,,13,"(3.541112,-76.384584)"
2015,Octubre,Portugal,620,179,186,,365,"(4.697144,-74.140516)"
2015,Octubre,Portugal,620,2,5,,7,"(6.171601,-75.427454)"
2015,Octubre,Polinesia Francesa/Colectividad de Ultramar Francesa,258,0,1,,1,"(4.697144,-74.140516)"
2015,Octubre,Puerto Rico/Territorio de Estados Unidos,630,7,3,,10,"(10.445761,-75.516429)"
2015,Octubre,Puerto Rico/Territorio de Estados Unidos,630,11,8,,19,"(10.886611,-74.776708)"
2015,Octubre,Puerto Rico/Territorio de Estados Unidos,630,21,20,,41,"(3.541112,-76.384584)"
2015,Octubre,Puerto Rico/Territorio de Estados Unidos,630,545,475,,1020,"(4.697144,-74.140516)"
2015,Octubre,Puerto Rico/Territorio de Estados Unidos,630,7,4,,11,"(4.815061,-75.736532)"
2015,Octubre,Puerto Rico/Territorio de Estados Unidos,630,33,27,,60,"(6.171601,-75.427454)"
2015,Octubre,Puerto Rico/Territorio de Estados Unidos,630,11,5,,16,"(7.128456,-73.183637)"
2015,Octubre,Puerto Rico/Territorio de Estados Unidos,630,0,1,,1,"(7.927209,-72.507910)"
2015,Octubre,Qatar,634,0,1,,1,"(10.886611,-74.776708)"
2015,Octubre,Qatar,634,3,5,,8,"(4.697144,-74.140516)"
2015,Octubre,Qatar,634,0,1,,1,"(6.171601,-75.427454)"
2015,Octubre,Reino Unido de Gran Bretaña e Irlanda del Norte,826,0,1,,1,"(10.886611,-74.776708)"
2015,Octubre,Reino Unido de Gran Bretaña e Irlanda del Norte,826,36,29,,65,"(3.541112,-76.384584)"
2015,Octubre,Reino Unido de Gran Bretaña e Irlanda del Norte,826,1280,1058,,2338,"(4.697144,-74.140516)"
2015,Octubre,Reino Unido de Gran Bretaña e Irlanda del Norte,826,8,6,,14,"(6.171601,-75.427454)"
2015,Octubre,República CentroÁfricana,140,1,0,,1,"(3.541112,-76.384584)"
2015,Octubre,República CentroÁfricana,140,1,1,,2,"(4.697144,-74.140516)"
2015,Octubre,Federación de Rusia,643,0,2,,2,"(3.541112,-76.384584)"
2015,Octubre,Federación de Rusia,643,30,40,,70,"(4.697144,-74.140516)"
2015,Octubre,Federación de Rusia,643,0,3,,3,"(6.171601,-75.427454)"
2015,Octubre,República Dominicana,214,9,20,,29,"(10.445761,-75.516429)"
2015,Octubre,República Dominicana,214,40,45,,85,"(10.886611,-74.776708)"
2015,Octubre,República Dominicana,214,1,3,,4,"(12.586067,-81.702563)"
2015,Octubre,República Dominicana,214,110,121,,231,"(3.541112,-76.384584)"
2015,Octubre,República Dominicana,214,2872,2741,,5613,"(4.697144,-74.140516)"
2015,Octubre,República Dominicana,214,31,32,,63,"(4.815061,-75.736532)"
2015,Octubre,República Dominicana,214,269,240,,509,"(6.171601,-75.427454)"
2015,Octubre,República Dominicana,214,45,41,,86,"(7.128456,-73.183637)"
2015,Octubre,República Dominicana,214,20,15,,35,"(7.927209,-72.507910)"
2015,Octubre,Reunión,638,1,0,,1,"(4.697144,-74.140516)"
2015,Octubre,República Democrática Popular de Corea,408,0,1,,1,"(4.697144,-74.140516)"
2015,Octubre,Rumania,642,1,0,,1,"(3.541112,-76.384584)"
2015,Octubre,Rumania,642,1,4,,5,"(4.697144,-74.140516)"
2015,Octubre,Rwanda,646,0,1,,1,"(6.171601,-75.427454)"
2015,Octubre,San  Vicente y las Granadinas,670,0,1,,1,"(10.886611,-74.776708)"
2015,Octubre,San  Vicente y las Granadinas,670,2,0,,2,"(6.171601,-75.427454)"
2015,Octubre,Santa Lucia,662,0,2,,2,"(4.697144,-74.140516)"
2015,Octubre,Senegal,686,0,2,,2,"(4.697144,-74.140516)"
2015,Octubre,Serbia,688,1,0,,1,"(3.541112,-76.384584)"
2015,Octubre,Serbia,688,0,1,,1,"(4.697144,-74.140516)"
2015,Octubre,Singapur,702,1,0,,1,"(10.886611,-74.776708)"
2015,Octubre,Singapur,702,1,0,,1,"(3.541112,-76.384584)"
2015,Octubre,Singapur,702,14,12,,26,"(4.697144,-74.140516)"
2015,Octubre,Singapur,702,2,0,,2,"(6.171601,-75.427454)"
2015,Octubre,Sudáfrica,710,1,0,,1,"(3.541112,-76.384584)"
2015,Octubre,Sudáfrica,710,17,11,,28,"(4.697144,-74.140516)"
2015,Octubre,Sudáfrica,710,0,1,,1,"(4.815061,-75.736532)"
2015,Octubre,Sudán,736,0,1,,1,"(4.697144,-74.140516)"
2015,Octubre,Sudán,736,0,1,,1,"(6.171601,-75.427454)"
2015,Octubre,Suecia,752,1,0,,1,"(10.886611,-74.776708)"
2015,Octubre,Suecia,752,10,6,,16,"(3.541112,-76.384584)"
2015,Octubre,Suecia,752,51,62,,113,"(4.697144,-74.140516)"
2015,Octubre,Suecia,752,1,2,,3,"(6.171601,-75.427454)"
2015,Octubre,Suecia,752,1,1,,2,"(7.128456,-73.183637)"
2015,Octubre,Suiza,756,52,22,,74,"(3.541112,-76.384584)"
2015,Octubre,Suiza,756,172,124,,296,"(4.697144,-74.140516)"
2015,Octubre,Suiza,756,12,3,,15,"(6.171601,-75.427454)"
2015,Octubre,Surinam,740,1,0,,1,"(10.886611,-74.776708)"
2015,Octubre,Surinam,740,2,5,,7,"(4.697144,-74.140516)"
2015,Octubre,Surinam,740,0,1,,1,"(6.171601,-75.427454)"
2015,Octubre,Taiwán,158,5,8,,13,"(4.697144,-74.140516)"
2015,Octubre,Taiwán,158,1,5,,6,"(6.171601,-75.427454)"
2015,Octubre,Tailandia,764,2,1,,3,"(3.541112,-76.384584)"
2015,Octubre,Tailandia,764,37,31,,68,"(4.697144,-74.140516)"
2015,Octubre,Tailandia,764,0,6,,6,"(6.171601,-75.427454)"
2015,Octubre,Tanzania,834,2,3,,5,"(4.697144,-74.140516)"
2015,Octubre,Trinidad y Tobago,780,2,1,,3,"(10.445761,-75.516429)"
2015,Octubre,Trinidad y Tobago,780,2,4,,6,"(10.886611,-74.776708)"
2015,Octubre,Trinidad y Tobago,780,13,11,,24,"(3.541112,-76.384584)"
2015,Octubre,Trinidad y Tobago,780,9,18,,27,"(4.697144,-74.140516)"
2015,Octubre,Trinidad y Tobago,780,3,2,,5,"(4.815061,-75.736532)"
2015,Octubre,Trinidad y Tobago,780,1,10,,11,"(6.171601,-75.427454)"
2015,Octubre,Trinidad y Tobago,780,2,1,,3,"(7.128456,-73.183637)"
2015,Octubre,Trinidad y Tobago,780,1,1,,2,"(7.927209,-72.507910)"
2015,Octubre,Turquía,792,1,0,,1,"(10.886611,-74.776708)"
2015,Octubre,Turquía,792,2,3,,5,"(3.541112,-76.384584)"
2015,Octubre,Turquía,792,136,93,,229,"(4.697144,-74.140516)"
2015,Octubre,Turquía,792,9,6,,15,"(6.171601,-75.427454)"
2015,Octubre,Turkmenistán,795,1,0,,1,"(3.541112,-76.384584)"
2015,Octubre,Turkmenistán,795,1,0,,1,"(4.697144,-74.140516)"
2015,Octubre,Ucrania,804,2,1,,3,"(4.697144,-74.140516)"
2015,Octubre,Uganda,800,2,0,,2,"(4.697144,-74.140516)"
2015,Octubre,Uruguay,858,7,6,,13,"(10.445761,-75.516429)"
2015,Octubre,Uruguay,858,14,61,,75,"(10.886611,-74.776708)"
2015,Octubre,Uruguay,858,20,36,,56,"(3.541112,-76.384584)"
2015,Octubre,Uruguay,858,90,136,,226,"(4.697144,-74.140516)"
2015,Octubre,Uruguay,858,1,3,,4,"(4.815061,-75.736532)"
2015,Octubre,Uruguay,858,26,25,,51,"(6.171601,-75.427454)"
2015,Octubre,Uruguay,858,1,1,,2,"(7.128456,-73.183637)"
2015,Octubre,Venezuela,862,1,0,,1,"(10.408582,-75.538003)"
2015,Octubre,Venezuela,862,77,67,,144,"(10.445761,-75.516429)"
2015,Octubre,Venezuela,862,28,36,,64,"(10.886611,-74.776708)"
2015,Octubre,Venezuela,862,575,326,,901,"(11.360009,-72.129330)"
2015,Octubre,Venezuela,862,13,38,,51,"(3.541112,-76.384584)"
2015,Octubre,Venezuela,862,9,9,,18,"(3.866713,-67.927521)"
2015,Octubre,Venezuela,862,1277,1592,,2869,"(4.697144,-74.140516)"
2015,Octubre,Venezuela,862,4,3,,7,"(4.815061,-75.736532)"
2015,Octubre,Venezuela,862,230,284,,514,"(6.171601,-75.427454)"
2015,Octubre,Venezuela,862,17,18,,35,"(6.185799,-67.483929)"
2015,Octubre,Venezuela,862,9,8,,17,"(7.088729,-70.740253)"
2015,Octubre,Venezuela,862,5,9,,14,"(7.128456,-73.183637)"
2015,Octubre,Venezuela,862,292,293,,585,"(7.818934,-72.453226)"
2015,Octubre,Venezuela,862,1,0,,1,"(7.927209,-72.507910)"
2015,Octubre,Vietnam,704,4,2,,6,"(4.697144,-74.140516)"
2015,Octubre,Islas Vírgenes Estadounidenses/Territorio de Estados Unidos,850,1,0,,1,"(4.697144,-74.140516)"
2015,Octubre,Zambia,894,0,1,,1,"(4.697144,-74.140516)"
2015,Noviembre,Afganistán,4,0,3,,3,"(4.697144,-74.140516)"
2015,Noviembre,Afganistán,4,0,1,,1,"(6.171601,-75.427454)"
2015,Noviembre,Alemania,276,2,1,,3,"(10.886611,-74.776708)"
2015,Noviembre,Alemania,276,24,24,,48,"(3.541112,-76.384584)"
2015,Noviembre,Alemania,276,554,595,,1149,"(4.697144,-74.140516)"
2015,Noviembre,Alemania,276,1,0,,1,"(4.815061,-75.736532)"
2015,Noviembre,Alemania,276,20,20,,40,"(6.171601,-75.427454)"
2015,Noviembre,Angola,24,0,14,,14,"(4.697144,-74.140516)"
2015,Noviembre,Países Bajos,528,99,86,,185,"(10.886611,-74.776708)"
2015,Noviembre,Países Bajos,528,94,56,,150,"(3.541112,-76.384584)"
2015,Noviembre,Países Bajos,528,625,565,,1190,"(4.697144,-74.140516)"
2015,Noviembre,Países Bajos,528,11,7,,18,"(4.815061,-75.736532)"
2015,Noviembre,Países Bajos,528,204,125,,329,"(6.171601,-75.427454)"
2015,Noviembre,Países Bajos,528,3,3,,6,"(7.927209,-72.507910)"
2015,Noviembre,Arabia Saudita,682,0,1,,1,"(3.541112,-76.384584)"
2015,Noviembre,Arabia Saudita,682,5,63,,68,"(4.697144,-74.140516)"
2015,Noviembre,Arabia Saudita,682,0,1,,1,"(6.171601,-75.427454)"
2015,Noviembre,Arabia Saudita,682,0,1,,1,"(7.128456,-73.183637)"
2015,Noviembre,Arabia Saudita,682,1,0,,1,"(7.927209,-72.507910)"
2015,Noviembre,Argelia,12,2,0,,2,"(3.541112,-76.384584)"
2015,Noviembre,Argelia,12,4,8,,12,"(4.697144,-74.140516)"
2015,Noviembre,Argentina,32,0,1,,1,"(0.25129,-76.875963)"
2015,Noviembre,Argentina,32,10,16,,26,"(0.814836,-77.662532)"
2015,Noviembre,Argentina,32,10,9,,19,"(10.445761,-75.516429)"
2015,Noviembre,Argentina,32,32,26,,58,"(10.886611,-74.776708)"
2015,Noviembre,Argentina,32,4,1,,5,"(12.586067,-81.702563)"
2015,Noviembre,Argentina,32,200,192,,392,"(3.541112,-76.384584)"
2015,Noviembre,Argentina,32,2454,2545,,4999,"(4.697144,-74.140516)"
2015,Noviembre,Argentina,32,5,30,,35,"(4.815061,-75.736532)"
2015,Noviembre,Argentina,32,206,209,,415,"(6.171601,-75.427454)"
2015,Noviembre,Argentina,32,6,6,,12,"(7.128456,-73.183637)"
2015,Noviembre,Argentina,32,0,1,,1,"(7.927209,-72.507910)"
2015,Noviembre,República de Armenia,51,0,1,,1,"(6.171601,-75.427454)"
2015,Noviembre,Aruba,533,2108,1479,,3587,"(10.408582,-75.538003)"
2015,Noviembre,Aruba,533,4,1,,5,"(10.445761,-75.516429)"
2015,Noviembre,Aruba,533,22,10,,32,"(10.886611,-74.776708)"
2015,Noviembre,Aruba,533,35,21,,56,"(3.541112,-76.384584)"
2015,Noviembre,Aruba,533,1252,1006,,2258,"(4.697144,-74.140516)"
2015,Noviembre,Aruba,533,6,3,,9,"(4.815061,-75.736532)"
2015,Noviembre,Aruba,533,86,62,,148,"(6.171601,-75.427454)"
2015,Noviembre,Aruba,533,24,60,,84,"(7.128456,-73.183637)"
2015,Noviembre,Australia,36,5,2,,7,"(10.886611,-74.776708)"
2015,Noviembre,Australia,36,18,10,,28,"(3.541112,-76.384584)"
2015,Noviembre,Australia,36,314,209,,523,"(4.697144,-74.140516)"
2015,Noviembre,Australia,36,2,4,,6,"(4.815061,-75.736532)"
2015,Noviembre,Australia,36,34,23,,57,"(6.171601,-75.427454)"
2015,Noviembre,Australia,36,5,1,,6,"(7.128456,-73.183637)"
2015,Noviembre,Austria,40,1,0,,1,"(10.445761,-75.516429)"
2015,Noviembre,Austria,40,1,2,,3,"(3.541112,-76.384584)"
2015,Noviembre,Austria,40,22,14,,36,"(4.697144,-74.140516)"
2015,Noviembre,Austria,40,1,1,,2,"(6.171601,-75.427454)"
2015,Noviembre,Azerbaiyán,31,0,3,,3,"(4.697144,-74.140516)"
2015,Noviembre,Bahamas,44,2,1,,3,"(10.886611,-74.776708)"
2015,Noviembre,Bahamas,44,4,4,,8,"(3.541112,-76.384584)"
2015,Noviembre,Bahamas,44,24,18,,42,"(4.697144,-74.140516)"
2015,Noviembre,Bahamas,44,1,1,,2,"(4.815061,-75.736532)"
2015,Noviembre,Bahamas,44,8,6,,14,"(6.171601,-75.427454)"
2015,Noviembre,Bahamas,44,2,1,,3,"(7.128456,-73.183637)"
2015,Noviembre,Bahréin,48,2,3,,5,"(4.697144,-74.140516)"
2015,Noviembre,Bangladesh,50,0,1,,1,"(4.697144,-74.140516)"
2015,Noviembre,Barbados,52,1,0,,1,"(3.541112,-76.384584)"
2015,Noviembre,Barbados,52,1,5,,6,"(4.697144,-74.140516)"
2015,Noviembre,Barbados,52,1,0,,1,"(6.171601,-75.427454)"
2015,Noviembre,República de Belarús,112,0,2,,2,"(11.360009,-72.129330)"
2015,Noviembre,Bélgica,56,5,1,,6,"(3.541112,-76.384584)"
2015,Noviembre,Bélgica,56,36,37,,73,"(4.697144,-74.140516)"
2015,Noviembre,Bélgica,56,10,8,,18,"(6.171601,-75.427454)"
2015,Noviembre,Belice,84,1,6,,7,"(3.541112,-76.384584)"
2015,Noviembre,Belice,84,4,12,,16,"(4.697144,-74.140516)"
2015,Noviembre,Benín,204,3,0,,3,"(4.697144,-74.140516)"
2015,Noviembre,Bermudas/Territorio Británico de Ultramar,60,1,0,,1,"(10.886611,-74.776708)"
2015,Noviembre,Bolivia,68,1,7,,8,"(0.814836,-77.662532)"
2015,Noviembre,Bolivia,68,1,1,,2,"(10.445761,-75.516429)"
2015,Noviembre,Bolivia,68,3,5,,8,"(10.886611,-74.776708)"
2015,Noviembre,Bolivia,68,45,58,,103,"(3.541112,-76.384584)"
2015,Noviembre,Bolivia,68,295,468,,763,"(4.697144,-74.140516)"
2015,Noviembre,Bolivia,68,8,8,,16,"(4.815061,-75.736532)"
2015,Noviembre,Bolivia,68,26,37,,63,"(6.171601,-75.427454)"
2015,Noviembre,Bolivia,68,0,5,,5,"(7.128456,-73.183637)"
2015,Noviembre,Bolivia,68,0,1,,1,"(7.927209,-72.507910)"
2015,Noviembre,Bosnia y Herzegovina,70,0,1,,1,"(4.697144,-74.140516)"
2015,Noviembre,Brasil,76,110,228,,338,"(-4.197703,-69.941278)"
2015,Noviembre,Brasil,76,0,1,,1,"(-4.223468,-69.945098)"
2015,Noviembre,Brasil,76,1,0,,1,"(0.25129,-76.875963)"
2015,Noviembre,Brasil,76,16,13,,29,"(10.445761,-75.516429)"
2015,Noviembre,Brasil,76,23,30,,53,"(10.886611,-74.776708)"
2015,Noviembre,Brasil,76,156,215,,371,"(3.541112,-76.384584)"
2015,Noviembre,Brasil,76,1,0,,1,"(3.866713,-67.927521)"
2015,Noviembre,Brasil,76,3032,3805,,6837,"(4.697144,-74.140516)"
2015,Noviembre,Brasil,76,23,32,,55,"(4.815061,-75.736532)"
2015,Noviembre,Brasil,76,176,235,,411,"(6.171601,-75.427454)"
2015,Noviembre,Brasil,76,14,25,,39,"(7.128456,-73.183637)"
2015,Noviembre,Brasil,76,2,3,,5,"(7.927209,-72.507910)"
2015,Noviembre,Cabo Verde,132,1,2,,3,"(4.697144,-74.140516)"
2015,Noviembre,Islas Caimán/Territorio Británico de Ultramar,136,1,0,,1,"(10.445761,-75.516429)"
2015,Noviembre,Islas Caimán/Territorio Británico de Ultramar,136,3,0,,3,"(12.586067,-81.702563)"
2015,Noviembre,Islas Caimán/Territorio Británico de Ultramar,136,1,0,,1,"(3.541112,-76.384584)"
2015,Noviembre,Islas Caimán/Territorio Británico de Ultramar,136,1,2,,3,"(4.697144,-74.140516)"
2015,Noviembre,Camboya,116,1,0,,1,"(4.697144,-74.140516)"
2015,Noviembre,Camerún,120,0,1,,1,"(4.697144,-74.140516)"
2015,Noviembre,Canadá,124,16,15,,31,"(10.445761,-75.516429)"
2015,Noviembre,Canadá,124,20,20,,40,"(10.886611,-74.776708)"
2015,Noviembre,Canadá,124,0,1,,1,"(12.586067,-81.702563)"
2015,Noviembre,Canadá,124,66,43,,109,"(3.541112,-76.384584)"
2015,Noviembre,Canadá,124,1,0,,1,"(4.452882,-75.766298)"
2015,Noviembre,Canadá,124,915,771,,1686,"(4.697144,-74.140516)"
2015,Noviembre,Canadá,124,9,9,,18,"(4.815061,-75.736532)"
2015,Noviembre,Canadá,124,154,100,,254,"(6.171601,-75.427454)"
2015,Noviembre,Canadá,124,6,9,,15,"(7.128456,-73.183637)"
2015,Noviembre,Canadá,124,1,1,,2,"(7.927209,-72.507910)"
2015,Noviembre,España,724,3,5,,8,"(10.445761,-75.516429)"
2015,Noviembre,España,724,3,0,,3,"(10.886611,-74.776708)"
2015,Noviembre,España,724,1339,915,,2254,"(3.541112,-76.384584)"
2015,Noviembre,España,724,5264,4447,,9711,"(4.697144,-74.140516)"
2015,Noviembre,España,724,12,5,,17,"(4.815061,-75.736532)"
2015,Noviembre,España,724,598,478,,1076,"(6.171601,-75.427454)"
2015,Noviembre,España,724,2,1,,3,"(7.128456,-73.183637)"
2015,Noviembre,Colombia,170,40,138,,178,"(4.697144,-74.140516)"
2015,Noviembre,República Del Congo,178,0,1,,1,"(4.697144,-74.140516)"
2015,Noviembre,República Democrática del Congo,180,1,1,,2,"(4.697144,-74.140516)"
2015,Noviembre,República de Corea,410,9,27,,36,"(4.697144,-74.140516)"
2015,Noviembre,Costa de Marfil,384,3,6,,9,"(4.697144,-74.140516)"
2015,Noviembre,Costa de Marfil,384,1,0,,1,"(6.171601,-75.427454)"
2015,Noviembre,Costa Rica,188,7,4,,11,"(10.445761,-75.516429)"
2015,Noviembre,Costa Rica,188,12,21,,33,"(10.886611,-74.776708)"
2015,Noviembre,Costa Rica,188,4,31,,35,"(12.5744111,-81.703935)"
2015,Noviembre,Costa Rica,188,5,7,,12,"(12.586067,-81.702563)"
2015,Noviembre,Costa Rica,188,0,7,,7,"(13.3387613,-81.372937)"
2015,Noviembre,Costa Rica,188,45,43,,88,"(3.541112,-76.384584)"
2015,Noviembre,Costa Rica,188,983,1149,,2132,"(4.697144,-74.140516)"
2015,Noviembre,Costa Rica,188,7,10,,17,"(4.815061,-75.736532)"
2015,Noviembre,Costa Rica,188,128,158,,286,"(6.171601,-75.427454)"
2015,Noviembre,Costa Rica,188,2,5,,7,"(7.128456,-73.183637)"
2015,Noviembre,Costa Rica,188,2,1,,3,"(7.927209,-72.507910)"
2015,Noviembre,Croacia,191,1,3,,4,"(4.697144,-74.140516)"
2015,Noviembre,Cuba,192,19,20,,39,"(10.445761,-75.516429)"
2015,Noviembre,Cuba,192,18,15,,33,"(10.886611,-74.776708)"
2015,Noviembre,Cuba,192,1,5,,6,"(12.586067,-81.702563)"
2015,Noviembre,Cuba,192,70,71,,141,"(3.541112,-76.384584)"
2015,Noviembre,Cuba,192,633,777,,1410,"(4.697144,-74.140516)"
2015,Noviembre,Cuba,192,18,20,,38,"(4.815061,-75.736532)"
2015,Noviembre,Cuba,192,76,76,,152,"(6.171601,-75.427454)"
2015,Noviembre,Cuba,192,19,19,,38,"(7.128456,-73.183637)"
2015,Noviembre,Cuba,192,0,1,,1,"(7.927209,-72.507910)"
2015,Noviembre,Curazao,99999,7,24,,31,"(4.697144,-74.140516)"
2015,Noviembre,República Checa,203,0,2,,2,"(3.541112,-76.384584)"
2015,Noviembre,República Checa,203,3,6,,9,"(4.697144,-74.140516)"
2015,Noviembre,Chile,152,94,107,,201,"(0.814836,-77.662532)"
2015,Noviembre,Chile,152,9,7,,16,"(10.445761,-75.516429)"
2015,Noviembre,Chile,152,40,39,,79,"(10.886611,-74.776708)"
2015,Noviembre,Chile,152,2,1,,3,"(12.586067,-81.702563)"
2015,Noviembre,Chile,152,401,328,,729,"(3.541112,-76.384584)"
2015,Noviembre,Chile,152,3607,3646,,7253,"(4.697144,-74.140516)"
2015,Noviembre,Chile,152,82,63,,145,"(4.815061,-75.736532)"
2015,Noviembre,Chile,152,189,192,,381,"(6.171601,-75.427454)"
2015,Noviembre,Chile,152,12,13,,25,"(7.128456,-73.183637)"
2015,Noviembre,Chile,152,3,3,,6,"(7.927209,-72.507910)"
2015,Noviembre,China,156,0,6,,6,"(10.886611,-74.776708)"
2015,Noviembre,China,156,3,11,,14,"(3.541112,-76.384584)"
2015,Noviembre,China,156,112,354,,466,"(4.697144,-74.140516)"
2015,Noviembre,China,156,8,33,,41,"(6.171601,-75.427454)"
2015,Noviembre,China,156,0,2,,2,"(7.128456,-73.183637)"
2015,Noviembre,China,156,0,1,,1,"(7.927209,-72.507910)"
2015,Noviembre,Chipre,196,0,1,,1,"(4.697144,-74.140516)"
2015,Noviembre,Dinamarca,208,3,2,,5,"(3.541112,-76.384584)"
2015,Noviembre,Dinamarca,208,24,16,,40,"(4.697144,-74.140516)"
2015,Noviembre,Dinamarca,208,1,0,,1,"(6.171601,-75.427454)"
2015,Noviembre,Dominica,212,0,1,,1,"(4.697144,-74.140516)"
2015,Noviembre,Ecuador,218,383,658,,1041,"(0.25129,-76.875963)"
2015,Noviembre,Ecuador,218,26,46,,72,"(0.812436,-77.847006)"
2015,Noviembre,Ecuador,218,4915,5932,,10847,"(0.814836,-77.662532)"
2015,Noviembre,Ecuador,218,130,141,,271,"(1.813928,-78.763924)"
2015,Noviembre,Ecuador,218,2,1,,3,"(10.445761,-75.516429)"
2015,Noviembre,Ecuador,218,4,11,,15,"(10.886611,-74.776708)"
2015,Noviembre,Ecuador,218,270,406,,676,"(3.541112,-76.384584)"
2015,Noviembre,Ecuador,218,0,1,,1,"(3.893038,-77.067921)"
2015,Noviembre,Ecuador,218,2373,4199,,6572,"(4.697144,-74.140516)"
2015,Noviembre,Ecuador,218,2,8,,10,"(4.815061,-75.736532)"
2015,Noviembre,Ecuador,218,46,100,,146,"(6.171601,-75.427454)"
2015,Noviembre,Ecuador,218,0,3,,3,"(6.228046,-77.404104)"
2015,Noviembre,Ecuador,218,5,16,,21,"(7.128456,-73.183637)"
2015,Noviembre,Ecuador,218,2,2,,4,"(7.927209,-72.507910)"
2015,Noviembre,Egipto,818,0,1,,1,"(3.541112,-76.384584)"
2015,Noviembre,Egipto,818,35,23,,58,"(4.697144,-74.140516)"
2015,Noviembre,El Salvador,222,1,0,,1,"(10.445761,-75.516429)"
2015,Noviembre,El Salvador,222,2,5,,7,"(10.886611,-74.776708)"
2015,Noviembre,El Salvador,222,0,2,,2,"(12.586067,-81.702563)"
2015,Noviembre,El Salvador,222,37,63,,100,"(3.541112,-76.384584)"
2015,Noviembre,El Salvador,222,599,937,,1536,"(4.697144,-74.140516)"
2015,Noviembre,El Salvador,222,1,0,,1,"(4.815061,-75.736532)"
2015,Noviembre,El Salvador,222,98,149,,247,"(6.171601,-75.427454)"
2015,Noviembre,El Salvador,222,4,1,,5,"(7.128456,-73.183637)"
2015,Noviembre,Emiratos Árabes,784,1,0,,1,"(3.541112,-76.384584)"
2015,Noviembre,Emiratos Árabes,784,90,353,,443,"(4.697144,-74.140516)"
2015,Noviembre,Emiratos Árabes,784,3,3,,6,"(6.171601,-75.427454)"
2015,Noviembre,Eritrea,232,2,0,,2,"(4.697144,-74.140516)"
2015,Noviembre,Estados Unidos de América,840,0,1,,1,"(10.408582,-75.538003)"
2015,Noviembre,Estados Unidos de América,840,3718,3115,,6833,"(10.445761,-75.516429)"
2015,Noviembre,Estados Unidos de América,840,3114,2475,,5589,"(10.886611,-74.776708)"
2015,Noviembre,Estados Unidos de América,840,3,7,,10,"(11.117806,-74.232622)"
2015,Noviembre,Estados Unidos de América,840,56,30,,86,"(12.586067,-81.702563)"
2015,Noviembre,Estados Unidos de América,840,4988,3505,,8493,"(3.541112,-76.384584)"
2015,Noviembre,Estados Unidos de América,840,402,286,,688,"(4.452882,-75.766298)"
2015,Noviembre,Estados Unidos de América,840,31454,27569,,59023,"(4.697144,-74.140516)"
2015,Noviembre,Estados Unidos de América,840,764,493,,1257,"(4.815061,-75.736532)"
2015,Noviembre,Estados Unidos de América,840,9310,7137,,16447,"(6.171601,-75.427454)"
2015,Noviembre,Estados Unidos de América,840,300,223,,523,"(7.128456,-73.183637)"
2015,Noviembre,Estados Unidos de América,840,83,86,,169,"(7.927209,-72.507910)"
2015,Noviembre,Estonia,233,1,0,,1,"(4.697144,-74.140516)"
2015,Noviembre,Etiopia,231,2,4,,6,"(4.697144,-74.140516)"
2015,Noviembre,Filipinas,608,1,0,,1,"(10.445761,-75.516429)"
2015,Noviembre,Filipinas,608,1,0,,1,"(3.541112,-76.384584)"
2015,Noviembre,Filipinas,608,20,37,,57,"(4.697144,-74.140516)"
2015,Noviembre,Finlandia,246,2,1,,3,"(3.541112,-76.384584)"
2015,Noviembre,Finlandia,246,6,8,,14,"(4.697144,-74.140516)"
2015,Noviembre,Finlandia,246,1,0,,1,"(6.171601,-75.427454)"
2015,Noviembre,Francia,250,2,1,,3,"(10.886611,-74.776708)"
2015,Noviembre,Francia,250,39,27,,66,"(3.541112,-76.384584)"
2015,Noviembre,Francia,250,764,714,,1478,"(4.697144,-74.140516)"
2015,Noviembre,Francia,250,0,2,,2,"(4.815061,-75.736532)"
2015,Noviembre,Francia,250,24,23,,47,"(6.171601,-75.427454)"
2015,Noviembre,Gabón,266,0,1,,1,"(4.697144,-74.140516)"
2015,Noviembre,Georgia,268,0,1,,1,"(6.171601,-75.427454)"
2015,Noviembre,Ghana,288,3,2,,5,"(4.697144,-74.140516)"
2015,Noviembre,Grecia,300,0,1,,1,"(10.886611,-74.776708)"
2015,Noviembre,Grecia,300,7,6,,13,"(4.697144,-74.140516)"
2015,Noviembre,Grecia,300,0,1,,1,"(6.171601,-75.427454)"
2015,Noviembre,Guatemala,320,3,3,,6,"(10.445761,-75.516429)"
2015,Noviembre,Guatemala,320,13,12,,25,"(10.886611,-74.776708)"
2015,Noviembre,Guatemala,320,2,0,,2,"(12.586067,-81.702563)"
2015,Noviembre,Guatemala,320,58,93,,151,"(3.541112,-76.384584)"
2015,Noviembre,Guatemala,320,522,691,,1213,"(4.697144,-74.140516)"
2015,Noviembre,Guatemala,320,8,9,,17,"(4.815061,-75.736532)"
2015,Noviembre,Guatemala,320,123,169,,292,"(6.171601,-75.427454)"
2015,Noviembre,Guatemala,320,8,12,,20,"(7.128456,-73.183637)"
2015,Noviembre,Guatemala,320,2,2,,4,"(7.927209,-72.507910)"
2015,Noviembre,Guyana,328,3,3,,6,"(4.697144,-74.140516)"
2015,Noviembre,Guinea Ecuatorial,226,1,1,,2,"(3.541112,-76.384584)"
2015,Noviembre,Guinea Ecuatorial,226,2,10,,12,"(4.697144,-74.140516)"
2015,Noviembre,Guinea Ecuatorial,226,0,1,,1,"(6.171601,-75.427454)"
2015,Noviembre,Guadalupe/Territorio Francés,312,2,1,,3,"(4.697144,-74.140516)"
2015,Noviembre,Guayana Francesa/Departamento de Ultramar Francés,254,1,3,,4,"(4.697144,-74.140516)"
2015,Noviembre,Haití,332,2,5,,7,"(10.445761,-75.516429)"
2015,Noviembre,Haití,332,0,1,,1,"(10.886611,-74.776708)"
2015,Noviembre,Haití,332,4,6,,10,"(4.697144,-74.140516)"
2015,Noviembre,Haití,332,2,4,,6,"(6.171601,-75.427454)"
2015,Noviembre,Honduras,340,2,1,,3,"(10.445761,-75.516429)"
2015,Noviembre,Honduras,340,2,7,,9,"(10.886611,-74.776708)"
2015,Noviembre,Honduras,340,2,159,,161,"(10.971302,-74.765397)"
2015,Noviembre,Honduras,340,1,5,,6,"(12.586067,-81.702563)"
2015,Noviembre,Honduras,340,14,31,,45,"(3.541112,-76.384584)"
2015,Noviembre,Honduras,340,93,178,,271,"(4.697144,-74.140516)"
2015,Noviembre,Honduras,340,0,1,,1,"(4.815061,-75.736532)"
2015,Noviembre,Honduras,340,24,44,,68,"(6.171601,-75.427454)"
2015,Noviembre,Honduras,340,1,5,,6,"(7.128456,-73.183637)"
2015,Noviembre,Honduras,340,0,1,,1,"(7.927209,-72.507910)"
2015,Noviembre,Hong Kong,344,2,4,,6,"(3.541112,-76.384584)"
2015,Noviembre,Hong Kong,344,15,28,,43,"(4.697144,-74.140516)"
2015,Noviembre,Hong Kong,344,1,1,,2,"(4.815061,-75.736532)"
2015,Noviembre,Hong Kong,344,0,1,,1,"(6.171601,-75.427454)"
2015,Noviembre,Hungría,348,1,0,,1,"(3.541112,-76.384584)"
2015,Noviembre,Hungría,348,2,3,,5,"(4.697144,-74.140516)"
2015,Noviembre,Hungría,348,0,1,,1,"(6.171601,-75.427454)"
2015,Noviembre,India,356,0,1,,1,"(10.445761,-75.516429)"
2015,Noviembre,India,356,0,1,,1,"(3.541112,-76.384584)"
2015,Noviembre,India,356,35,33,,68,"(4.697144,-74.140516)"
2015,Noviembre,India,356,3,2,,5,"(6.171601,-75.427454)"
2015,Noviembre,Indonesia,360,0,4,,4,"(3.541112,-76.384584)"
2015,Noviembre,Indonesia,360,7,6,,13,"(4.697144,-74.140516)"
2015,Noviembre,Indonesia,360,0,1,,1,"(6.171601,-75.427454)"
2015,Noviembre,Iraq,368,4,13,,17,"(4.697144,-74.140516)"
2015,Noviembre,Iraq,368,0,1,,1,"(6.171601,-75.427454)"
2015,Noviembre,Irán,364,4,3,,7,"(4.697144,-74.140516)"
2015,Noviembre,República de Irlanda,372,11,11,,22,"(4.697144,-74.140516)"
2015,Noviembre,Israel,376,1,0,,1,"(10.445761,-75.516429)"
2015,Noviembre,Israel,376,2,5,,7,"(3.541112,-76.384584)"
2015,Noviembre,Israel,376,104,57,,161,"(4.697144,-74.140516)"
2015,Noviembre,Israel,376,2,2,,4,"(6.171601,-75.427454)"
2015,Noviembre,Italia,380,2,0,,2,"(10.445761,-75.516429)"
2015,Noviembre,Italia,380,3,0,,3,"(10.886611,-74.776708)"
2015,Noviembre,Italia,380,74,37,,111,"(3.541112,-76.384584)"
2015,Noviembre,Italia,380,305,298,,603,"(4.697144,-74.140516)"
2015,Noviembre,Italia,380,3,2,,5,"(4.815061,-75.736532)"
2015,Noviembre,Italia,380,30,51,,81,"(6.171601,-75.427454)"
2015,Noviembre,Italia,380,1,1,,2,"(7.128456,-73.183637)"
2015,Noviembre,Jamaica,388,4,4,,8,"(10.445761,-75.516429)"
2015,Noviembre,Jamaica,388,5,7,,12,"(10.886611,-74.776708)"
2015,Noviembre,Jamaica,388,8,6,,14,"(3.541112,-76.384584)"
2015,Noviembre,Jamaica,388,11,15,,26,"(4.697144,-74.140516)"
2015,Noviembre,Jamaica,388,0,1,,1,"(4.815061,-75.736532)"
2015,Noviembre,Jamaica,388,20,8,,28,"(6.171601,-75.427454)"
2015,Noviembre,Islas Salomón,90,0,1,,1,"(4.697144,-74.140516)"
2015,Noviembre,Japón,392,1,3,,4,"(3.541112,-76.384584)"
2015,Noviembre,Japón,392,43,63,,106,"(4.697144,-74.140516)"
2015,Noviembre,Japón,392,1,3,,4,"(6.171601,-75.427454)"
2015,Noviembre,Jordania,400,0,3,,3,"(4.697144,-74.140516)"
2015,Noviembre,Kazajistán,398,0,3,,3,"(4.697144,-74.140516)"
2015,Noviembre,Kenia,404,1,0,,1,"(10.445761,-75.516429)"
2015,Noviembre,Kenia,404,1,0,,1,"(3.541112,-76.384584)"
2015,Noviembre,Kenia,404,1,7,,8,"(4.697144,-74.140516)"
2015,Noviembre,Kuwait,414,2,2,,4,"(10.886611,-74.776708)"
2015,Noviembre,Kuwait,414,1,7,,8,"(4.697144,-74.140516)"
2015,Noviembre,República Democrática Popular  Lao,418,1,0,,1,"(4.697144,-74.140516)"
2015,Noviembre,Lituania,440,2,11,,13,"(4.697144,-74.140516)"
2015,Noviembre,Líbano,422,15,4,,19,"(4.697144,-74.140516)"
2015,Noviembre,Luxemburgo,442,1,0,,1,"(3.541112,-76.384584)"
2015,Noviembre,Luxemburgo,442,1,4,,5,"(4.697144,-74.140516)"
2015,Noviembre,Malasia,458,6,13,,19,"(4.697144,-74.140516)"
2015,Noviembre,Malasia,458,1,1,,2,"(6.171601,-75.427454)"
2015,Noviembre,Maldivas,462,1,0,,1,"(4.697144,-74.140516)"
2015,Noviembre,Malí,466,0,1,,1,"(4.697144,-74.140516)"
2015,Noviembre,Malta,470,6,4,,10,"(4.697144,-74.140516)"
2015,Noviembre,Marruecos,504,1,1,,2,"(10.445761,-75.516429)"
2015,Noviembre,Marruecos,504,23,15,,38,"(4.697144,-74.140516)"
2015,Noviembre,Marruecos,504,2,3,,5,"(6.171601,-75.427454)"
2015,Noviembre,Martinica/Departamento de Ultramar Francés,474,0,1,,1,"(4.697144,-74.140516)"
2015,Noviembre,México,484,97,94,,191,"(10.445761,-75.516429)"
2015,Noviembre,México,484,139,131,,270,"(10.886611,-74.776708)"
2015,Noviembre,México,484,0,7,,7,"(10.971302,-74.765397)"
2015,Noviembre,México,484,5,7,,12,"(12.586067,-81.702563)"
2015,Noviembre,México,484,418,413,,831,"(3.541112,-76.384584)"
2015,Noviembre,México,484,12025,11446,,23471,"(4.697144,-74.140516)"
2015,Noviembre,México,484,108,97,,205,"(4.815061,-75.736532)"
2015,Noviembre,México,484,2099,1620,,3719,"(6.171601,-75.427454)"
2015,Noviembre,México,484,196,146,,342,"(7.128456,-73.183637)"
2015,Noviembre,México,484,19,19,,38,"(7.927209,-72.507910)"
2015,Noviembre,Mónaco,492,1,2,,3,"(4.697144,-74.140516)"
2015,Noviembre,Mongolia,496,0,1,,1,"(4.697144,-74.140516)"
2015,Noviembre,Micronesia,583,0,1,,1,"(4.697144,-74.140516)"
2015,Noviembre,Mozambique,508,1,0,,1,"(4.697144,-74.140516)"
2015,Noviembre,Nepal,524,2,2,,4,"(3.541112,-76.384584)"
2015,Noviembre,Nicaragua,558,5,10,,15,"(10.445761,-75.516429)"
2015,Noviembre,Nicaragua,558,5,2,,7,"(10.886611,-74.776708)"
2015,Noviembre,Nicaragua,558,3,1,,4,"(12.586067,-81.702563)"
2015,Noviembre,Nicaragua,558,18,49,,67,"(3.541112,-76.384584)"
2015,Noviembre,Nicaragua,558,46,94,,140,"(4.697144,-74.140516)"
2015,Noviembre,Nicaragua,558,5,8,,13,"(4.815061,-75.736532)"
2015,Noviembre,Nicaragua,558,15,47,,62,"(6.171601,-75.427454)"
2015,Noviembre,Nicaragua,558,4,6,,10,"(7.128456,-73.183637)"
2015,Noviembre,Nigeria,566,1,0,,1,"(10.445761,-75.516429)"
2015,Noviembre,Nigeria,566,0,6,,6,"(4.697144,-74.140516)"
2015,Noviembre,Nigeria,566,0,1,,1,"(6.171601,-75.427454)"
2015,Noviembre,Noruega,578,1,0,,1,"(3.541112,-76.384584)"
2015,Noviembre,Noruega,578,20,10,,30,"(4.697144,-74.140516)"
2015,Noviembre,Noruega,578,1,0,,1,"(6.171601,-75.427454)"
2015,Noviembre,Nueva Caledonia/Territorio francés,540,1,0,,1,"(4.697144,-74.140516)"
2015,Noviembre,Nueva Zelanda,554,24,42,,66,"(4.697144,-74.140516)"
2015,Noviembre,Nueva Zelanda,554,3,5,,8,"(6.171601,-75.427454)"
2015,Noviembre,Omán,512,0,1,,1,"(10.886611,-74.776708)"
2015,Noviembre,Omán,512,0,3,,3,"(4.697144,-74.140516)"
2015,Noviembre,Omán,512,0,2,,2,"(6.171601,-75.427454)"
2015,Noviembre,Pakistán,586,0,2,,2,"(4.697144,-74.140516)"
2015,Noviembre,Panamá,591,0,4,,4,"(1.813928,-78.763924)"
2015,Noviembre,Panamá,591,19,61,,80,"(10.408582,-75.538003)"
2015,Noviembre,Panamá,591,380,356,,736,"(10.445761,-75.516429)"
2015,Noviembre,Panamá,591,988,1000,,1988,"(10.886611,-74.776708)"
2015,Noviembre,Panamá,591,1,0,,1,"(10.971302,-74.765397)"
2015,Noviembre,Panamá,591,1,8,,9,"(12.5744111,-81.703935)"
2015,Noviembre,Panamá,591,230,218,,448,"(12.586067,-81.702563)"
2015,Noviembre,Panamá,591,0,7,,7,"(13.3387613,-81.372937)"
2015,Noviembre,Panamá,591,1954,1563,,3517,"(3.541112,-76.384584)"
2015,Noviembre,Panamá,591,8585,9252,,17837,"(4.697144,-74.140516)"
2015,Noviembre,Panamá,591,511,433,,944,"(4.815061,-75.736532)"
2015,Noviembre,Panamá,591,3509,3347,,6856,"(6.171601,-75.427454)"
2015,Noviembre,Panamá,591,0,3,,3,"(6.228046,-77.404104)"
2015,Noviembre,Panamá,591,3,1,,4,"(7.102626,-77.762647)"
2015,Noviembre,Panamá,591,304,291,,595,"(7.128456,-73.183637)"
2015,Noviembre,Panamá,591,118,95,,213,"(7.927209,-72.507910)"
2015,Noviembre,Panamá,591,0,45,,45,"(8.066966,-76.735404)"
2015,Noviembre,Panamá,591,27,82,,109,"(8.635765,-77.346578)"
2015,Noviembre,Paraguay,600,1,2,,3,"(0.814836,-77.662532)"
2015,Noviembre,Paraguay,600,2,2,,4,"(10.886611,-74.776708)"
2015,Noviembre,Paraguay,600,12,19,,31,"(3.541112,-76.384584)"
2015,Noviembre,Paraguay,600,65,196,,261,"(4.697144,-74.140516)"
2015,Noviembre,Paraguay,600,6,12,,18,"(4.815061,-75.736532)"
2015,Noviembre,Paraguay,600,6,12,,18,"(6.171601,-75.427454)"
2015,Noviembre,Paraguay,600,0,2,,2,"(7.927209,-72.507910)"
2015,Noviembre,Perú,604,150,161,,311,"(-4.197703,-69.941278)"
2015,Noviembre,Perú,604,2,3,,5,"(0.25129,-76.875963)"
2015,Noviembre,Perú,604,55,77,,132,"(0.814836,-77.662532)"
2015,Noviembre,Perú,604,0,1,,1,"(1.813928,-78.763924)"
2015,Noviembre,Perú,604,7,6,,13,"(10.445761,-75.516429)"
2015,Noviembre,Perú,604,26,30,,56,"(10.886611,-74.776708)"
2015,Noviembre,Perú,604,0,3,,3,"(12.586067,-81.702563)"
2015,Noviembre,Perú,604,273,404,,677,"(3.541112,-76.384584)"
2015,Noviembre,Perú,604,4669,5780,,10449,"(4.697144,-74.140516)"
2015,Noviembre,Perú,604,9,11,,20,"(4.815061,-75.736532)"
2015,Noviembre,Perú,604,306,425,,731,"(6.171601,-75.427454)"
2015,Noviembre,Perú,604,6,7,,13,"(7.128456,-73.183637)"
2015,Noviembre,Perú,604,2,0,,2,"(7.927209,-72.507910)"
2015,Noviembre,Polonia,616,0,1,,1,"(3.541112,-76.384584)"
2015,Noviembre,Polonia,616,9,8,,17,"(4.697144,-74.140516)"
2015,Noviembre,Polonia,616,1,0,,1,"(6.171601,-75.427454)"
2015,Noviembre,Portugal,620,0,1,,1,"(10.886611,-74.776708)"
2015,Noviembre,Portugal,620,1,1,,2,"(3.541112,-76.384584)"
2015,Noviembre,Portugal,620,154,151,,305,"(4.697144,-74.140516)"
2015,Noviembre,Portugal,620,2,3,,5,"(6.171601,-75.427454)"
2015,Noviembre,Puerto Rico/Territorio de Estados Unidos,630,4,5,,9,"(10.445761,-75.516429)"
2015,Noviembre,Puerto Rico/Territorio de Estados Unidos,630,11,17,,28,"(10.886611,-74.776708)"
2015,Noviembre,Puerto Rico/Territorio de Estados Unidos,630,49,32,,81,"(3.541112,-76.384584)"
2015,Noviembre,Puerto Rico/Territorio de Estados Unidos,630,634,544,,1178,"(4.697144,-74.140516)"
2015,Noviembre,Puerto Rico/Territorio de Estados Unidos,630,8,9,,17,"(4.815061,-75.736532)"
2015,Noviembre,Puerto Rico/Territorio de Estados Unidos,630,46,42,,88,"(6.171601,-75.427454)"
2015,Noviembre,Puerto Rico/Territorio de Estados Unidos,630,4,4,,8,"(7.128456,-73.183637)"
2015,Noviembre,Puerto Rico/Territorio de Estados Unidos,630,1,1,,2,"(7.927209,-72.507910)"
2015,Noviembre,Qatar,634,6,11,,17,"(4.697144,-74.140516)"
2015,Noviembre,Qatar,634,2,0,,2,"(6.171601,-75.427454)"
2015,Noviembre,Reino Unido de Gran Bretaña e Irlanda del Norte,826,1,0,,1,"(10.886611,-74.776708)"
2015,Noviembre,Reino Unido de Gran Bretaña e Irlanda del Norte,826,22,24,,46,"(3.541112,-76.384584)"
2015,Noviembre,Reino Unido de Gran Bretaña e Irlanda del Norte,826,1043,865,,1908,"(4.697144,-74.140516)"
2015,Noviembre,Reino Unido de Gran Bretaña e Irlanda del Norte,826,0,1,,1,"(4.815061,-75.736532)"
2015,Noviembre,Reino Unido de Gran Bretaña e Irlanda del Norte,826,8,4,,12,"(6.171601,-75.427454)"
2015,Noviembre,República CentroÁfricana,140,1,0,,1,"(4.697144,-74.140516)"
2015,Noviembre,Federación de Rusia,643,1,0,,1,"(3.541112,-76.384584)"
2015,Noviembre,Federación de Rusia,643,7,25,,32,"(4.697144,-74.140516)"
2015,Noviembre,Federación de Rusia,643,1,2,,3,"(6.171601,-75.427454)"
2015,Noviembre,República Dominicana,214,20,22,,42,"(10.445761,-75.516429)"
2015,Noviembre,República Dominicana,214,38,54,,92,"(10.886611,-74.776708)"
2015,Noviembre,República Dominicana,214,0,9,,9,"(10.971302,-74.765397)"
2015,Noviembre,República Dominicana,214,10,10,,20,"(11.117806,-74.232622)"
2015,Noviembre,República Dominicana,214,1,0,,1,"(12.586067,-81.702563)"
2015,Noviembre,República Dominicana,214,93,90,,183,"(3.541112,-76.384584)"
2015,Noviembre,República Dominicana,214,2944,2831,,5775,"(4.697144,-74.140516)"
2015,Noviembre,República Dominicana,214,46,45,,91,"(4.815061,-75.736532)"
2015,Noviembre,República Dominicana,214,263,209,,472,"(6.171601,-75.427454)"
2015,Noviembre,República Dominicana,214,51,44,,95,"(7.128456,-73.183637)"
2015,Noviembre,República Dominicana,214,13,19,,32,"(7.927209,-72.507910)"
2015,Noviembre,Reunión,638,2,0,,2,"(4.697144,-74.140516)"
2015,Noviembre,Rumania,642,4,3,,7,"(4.697144,-74.140516)"
2015,Noviembre,Rumania,642,1,0,,1,"(6.171601,-75.427454)"
2015,Noviembre,San  Vicente y las Granadinas,670,1,0,,1,"(4.697144,-74.140516)"
2015,Noviembre,San  Vicente y las Granadinas,670,0,1,,1,"(6.171601,-75.427454)"
2015,Noviembre,Senegal,686,1,1,,2,"(6.171601,-75.427454)"
2015,Noviembre,Serbia,688,0,1,,1,"(4.697144,-74.140516)"
2015,Noviembre,Singapur,702,21,12,,33,"(4.697144,-74.140516)"
2015,Noviembre,Singapur,702,0,1,,1,"(6.171601,-75.427454)"
2015,Noviembre,Sri Lanka,144,0,1,,1,"(4.697144,-74.140516)"
2015,Noviembre,Sudáfrica,710,12,11,,23,"(4.697144,-74.140516)"
2015,Noviembre,Sudáfrica,710,1,0,,1,"(6.171601,-75.427454)"
2015,Noviembre,Suecia,752,4,6,,10,"(3.541112,-76.384584)"
2015,Noviembre,Suecia,752,37,57,,94,"(4.697144,-74.140516)"
2015,Noviembre,Suecia,752,1,3,,4,"(6.171601,-75.427454)"
2015,Noviembre,Suiza,756,1,0,,1,"(10.445761,-75.516429)"
2015,Noviembre,Suiza,756,0,1,,1,"(10.886611,-74.776708)"
2015,Noviembre,Suiza,756,33,8,,41,"(3.541112,-76.384584)"
2015,Noviembre,Suiza,756,157,96,,253,"(4.697144,-74.140516)"
2015,Noviembre,Suiza,756,10,5,,15,"(6.171601,-75.427454)"
2015,Noviembre,Surinam,740,1,7,,8,"(4.697144,-74.140516)"
2015,Noviembre,Surinam,740,2,7,,9,"(6.171601,-75.427454)"
2015,Noviembre,Taiwán,158,0,1,,1,"(10.886611,-74.776708)"
2015,Noviembre,Taiwán,158,12,12,,24,"(4.697144,-74.140516)"
2015,Noviembre,Taiwán,158,0,2,,2,"(6.171601,-75.427454)"
2015,Noviembre,Tailandia,764,1,0,,1,"(3.541112,-76.384584)"
2015,Noviembre,Tailandia,764,19,24,,43,"(4.697144,-74.140516)"
2015,Noviembre,Tailandia,764,3,0,,3,"(6.171601,-75.427454)"
2015,Noviembre,Togo,768,1,0,,1,"(4.697144,-74.140516)"
2015,Noviembre,Trinidad y Tobago,780,3,2,,5,"(10.445761,-75.516429)"
2015,Noviembre,Trinidad y Tobago,780,3,5,,8,"(10.886611,-74.776708)"
2015,Noviembre,Trinidad y Tobago,780,0,1,,1,"(10.971302,-74.765397)"
2015,Noviembre,Trinidad y Tobago,780,11,24,,35,"(3.541112,-76.384584)"
2015,Noviembre,Trinidad y Tobago,780,16,31,,47,"(4.697144,-74.140516)"
2015,Noviembre,Trinidad y Tobago,780,12,19,,31,"(6.171601,-75.427454)"
2015,Noviembre,Trinidad y Tobago,780,2,1,,3,"(7.128456,-73.183637)"
2015,Noviembre,Trinidad y Tobago,780,3,0,,3,"(7.927209,-72.507910)"
2015,Noviembre,Turquía,792,1,0,,1,"(10.886611,-74.776708)"
2015,Noviembre,Turquía,792,0,1,,1,"(3.541112,-76.384584)"
2015,Noviembre,Turquía,792,35,48,,83,"(4.697144,-74.140516)"
2015,Noviembre,Turquía,792,5,3,,8,"(6.171601,-75.427454)"
2015,Noviembre,Turkmenistán,795,0,1,,1,"(4.697144,-74.140516)"
2015,Noviembre,Ucrania,804,1,3,,4,"(4.697144,-74.140516)"
2015,Noviembre,Uganda,800,0,1,,1,"(3.541112,-76.384584)"
2015,Noviembre,Uruguay,858,0,2,,2,"(10.445761,-75.516429)"
2015,Noviembre,Uruguay,858,1,3,,4,"(10.886611,-74.776708)"
2015,Noviembre,Uruguay,858,12,16,,28,"(3.541112,-76.384584)"
2015,Noviembre,Uruguay,858,83,79,,162,"(4.697144,-74.140516)"
2015,Noviembre,Uruguay,858,0,2,,2,"(4.815061,-75.736532)"
2015,Noviembre,Uruguay,858,17,29,,46,"(6.171601,-75.427454)"
2015,Noviembre,Uruguay,858,0,2,,2,"(7.128456,-73.183637)"
2015,Noviembre,Vanuatu,548,1,0,,1,"(4.697144,-74.140516)"
2015,Noviembre,Venezuela,862,77,61,,138,"(10.445761,-75.516429)"
2015,Noviembre,Venezuela,862,22,46,,68,"(10.886611,-74.776708)"
2015,Noviembre,Venezuela,862,365,240,,605,"(11.360009,-72.129330)"
2015,Noviembre,Venezuela,862,7,30,,37,"(3.541112,-76.384584)"
2015,Noviembre,Venezuela,862,6,4,,10,"(3.866713,-67.927521)"
2015,Noviembre,Venezuela,862,1218,1565,,2783,"(4.697144,-74.140516)"
2015,Noviembre,Venezuela,862,1,2,,3,"(4.815061,-75.736532)"
2015,Noviembre,Venezuela,862,211,304,,515,"(6.171601,-75.427454)"
2015,Noviembre,Venezuela,862,6,5,,11,"(6.185799,-67.483929)"
2015,Noviembre,Venezuela,862,11,20,,31,"(7.088729,-70.740253)"
2015,Noviembre,Venezuela,862,8,6,,14,"(7.128456,-73.183637)"
2015,Noviembre,Venezuela,862,340,359,,699,"(7.818934,-72.453226)"
2015,Noviembre,Venezuela,862,5,3,,8,"(7.927209,-72.507910)"
2015,Noviembre,Vietnam,704,2,1,,3,"(4.697144,-74.140516)"
2015,Noviembre,Vietnam,704,1,0,,1,"(6.171601,-75.427454)"
2015,Noviembre,Islas Vírgenes Estadounidenses/Territorio de Estados Unidos,850,1,0,,1,"(3.541112,-76.384584)"
2015,Noviembre,Desconocido,99999,1,5,,6,"(0.812436,-77.847006)"
2015,Diciembre,Afganistán,4,0,1,,1,"(3.541112,-76.384584)"
2015,Diciembre,Afganistán,4,1,2,,3,"(4.697144,-74.140516)"
2015,Diciembre,Albania,8,1,0,,1,"(4.697144,-74.140516)"
2015,Diciembre,Alemania,276,1,0,,1,"(10.445761,-75.516429)"
2015,Diciembre,Alemania,276,6,6,,12,"(10.886611,-74.776708)"
2015,Diciembre,Alemania,276,60,37,,97,"(3.541112,-76.384584)"
2015,Diciembre,Alemania,276,1162,817,,1979,"(4.697144,-74.140516)"
2015,Diciembre,Alemania,276,37,22,,59,"(6.171601,-75.427454)"
2015,Diciembre,Alemania,276,4,0,,4,"(7.927209,-72.507910)"
2015,Diciembre,Andorra,20,0,1,,1,"(4.697144,-74.140516)"
2015,Diciembre,Angola,24,1,6,,7,"(4.697144,-74.140516)"
2015,Diciembre,Antigua y Barbuda,28,1,3,,4,"(4.697144,-74.140516)"
2015,Diciembre,Países Bajos,528,3,1,,4,"(10.445761,-75.516429)"
2015,Diciembre,Países Bajos,528,158,86,,244,"(10.886611,-74.776708)"
2015,Diciembre,Países Bajos,528,182,116,,298,"(3.541112,-76.384584)"
2015,Diciembre,Países Bajos,528,979,781,,1760,"(4.697144,-74.140516)"
2015,Diciembre,Países Bajos,528,11,2,,13,"(4.815061,-75.736532)"
2015,Diciembre,Países Bajos,528,346,216,,562,"(6.171601,-75.427454)"
2015,Diciembre,Países Bajos,528,8,6,,14,"(7.927209,-72.507910)"
2015,Diciembre,Arabia Saudita,682,2,2,,4,"(3.541112,-76.384584)"
2015,Diciembre,Arabia Saudita,682,9,23,,32,"(4.697144,-74.140516)"
2015,Diciembre,Arabia Saudita,682,0,1,,1,"(6.171601,-75.427454)"
2015,Diciembre,Argelia,12,1,7,,8,"(4.697144,-74.140516)"
2015,Diciembre,Argentina,32,0,2,,2,"(0.25129,-76.875963)"
2015,Diciembre,Argentina,32,18,14,,32,"(0.814836,-77.662532)"
2015,Diciembre,Argentina,32,19,11,,30,"(10.445761,-75.516429)"
2015,Diciembre,Argentina,32,19,10,,29,"(10.886611,-74.776708)"
2015,Diciembre,Argentina,32,4,6,,10,"(12.586067,-81.702563)"
2015,Diciembre,Argentina,32,179,135,,314,"(3.541112,-76.384584)"
2015,Diciembre,Argentina,32,3136,2536,,5672,"(4.697144,-74.140516)"
2015,Diciembre,Argentina,32,15,16,,31,"(4.815061,-75.736532)"
2015,Diciembre,Argentina,32,148,136,,284,"(6.171601,-75.427454)"
2015,Diciembre,Argentina,32,4,1,,5,"(7.128456,-73.183637)"
2015,Diciembre,Aruba,533,1371,978,,2349,"(10.408582,-75.538003)"
2015,Diciembre,Aruba,533,12,6,,18,"(10.445761,-75.516429)"
2015,Diciembre,Aruba,533,103,80,,183,"(10.886611,-74.776708)"
2015,Diciembre,Aruba,533,88,61,,149,"(3.541112,-76.384584)"
2015,Diciembre,Aruba,533,1974,1548,,3522,"(4.697144,-74.140516)"
2015,Diciembre,Aruba,533,26,19,,45,"(4.815061,-75.736532)"
2015,Diciembre,Aruba,533,191,117,,308,"(6.171601,-75.427454)"
2015,Diciembre,Aruba,533,15,21,,36,"(7.128456,-73.183637)"
2015,Diciembre,Aruba,533,2,3,,5,"(7.927209,-72.507910)"
2015,Diciembre,Australia,36,1,2,,3,"(10.445761,-75.516429)"
2015,Diciembre,Australia,36,10,7,,17,"(3.541112,-76.384584)"
2015,Diciembre,Australia,36,303,227,,530,"(4.697144,-74.140516)"
2015,Diciembre,Australia,36,2,2,,4,"(4.815061,-75.736532)"
2015,Diciembre,Australia,36,43,22,,65,"(6.171601,-75.427454)"
2015,Diciembre,Australia,36,0,2,,2,"(7.128456,-73.183637)"
2015,Diciembre,Austria,40,1,1,,2,"(10.445761,-75.516429)"
2015,Diciembre,Austria,40,2,0,,2,"(3.541112,-76.384584)"
2015,Diciembre,Austria,40,40,36,,76,"(4.697144,-74.140516)"
2015,Diciembre,Austria,40,3,3,,6,"(6.171601,-75.427454)"
2015,Diciembre,Azerbaiyán,31,0,1,,1,"(4.697144,-74.140516)"
2015,Diciembre,Bahamas,44,1,1,,2,"(10.445761,-75.516429)"
2015,Diciembre,Bahamas,44,7,9,,16,"(10.886611,-74.776708)"
2015,Diciembre,Bahamas,44,3,5,,8,"(3.541112,-76.384584)"
2015,Diciembre,Bahamas,44,17,20,,37,"(4.697144,-74.140516)"
2015,Diciembre,Bahamas,44,1,1,,2,"(4.815061,-75.736532)"
2015,Diciembre,Bahamas,44,23,17,,40,"(6.171601,-75.427454)"
2015,Diciembre,Bahréin,48,1,2,,3,"(4.697144,-74.140516)"
2015,Diciembre,Bangladesh,50,1,1,,2,"(4.697144,-74.140516)"
2015,Diciembre,Barbados,52,188,146,,334,"(4.697144,-74.140516)"
2015,Diciembre,Bélgica,56,10,10,,20,"(3.541112,-76.384584)"
2015,Diciembre,Bélgica,56,73,55,,128,"(4.697144,-74.140516)"
2015,Diciembre,Bélgica,56,11,9,,20,"(6.171601,-75.427454)"
2015,Diciembre,Belice,84,2,1,,3,"(3.541112,-76.384584)"
2015,Diciembre,Belice,84,11,9,,20,"(4.697144,-74.140516)"
2015,Diciembre,Belice,84,1,3,,4,"(6.171601,-75.427454)"
2015,Diciembre,Benín,204,0,1,,1,"(3.541112,-76.384584)"
2015,Diciembre,Bermudas/Territorio Británico de Ultramar,60,0,1,,1,"(3.541112,-76.384584)"
2015,Diciembre,Bermudas/Territorio Británico de Ultramar,60,5,4,,9,"(4.697144,-74.140516)"
2015,Diciembre,Bermudas/Territorio Británico de Ultramar,60,3,2,,5,"(6.171601,-75.427454)"
2015,Diciembre,Bolivia,68,4,8,,12,"(0.814836,-77.662532)"
2015,Diciembre,Bolivia,68,1,1,,2,"(10.445761,-75.516429)"
2015,Diciembre,Bolivia,68,3,1,,4,"(10.886611,-74.776708)"
2015,Diciembre,Bolivia,68,0,2,,2,"(12.586067,-81.702563)"
2015,Diciembre,Bolivia,68,27,57,,84,"(3.541112,-76.384584)"
2015,Diciembre,Bolivia,68,342,395,,737,"(4.697144,-74.140516)"
2015,Diciembre,Bolivia,68,3,2,,5,"(4.815061,-75.736532)"
2015,Diciembre,Bolivia,68,16,22,,38,"(6.171601,-75.427454)"
2015,Diciembre,Bolivia,68,0,2,,2,"(7.128456,-73.183637)"
2015,Diciembre,Brasil,76,161,188,,349,"(-4.197703,-69.941278)"
2015,Diciembre,Brasil,76,0,1,,1,"(-4.223468,-69.945098)"
2015,Diciembre,Brasil,76,1,2,,3,"(0.814836,-77.662532)"
2015,Diciembre,Brasil,76,10,8,,18,"(10.445761,-75.516429)"
2015,Diciembre,Brasil,76,40,34,,74,"(10.886611,-74.776708)"
2015,Diciembre,Brasil,76,2,6,,8,"(12.586067,-81.702563)"
2015,Diciembre,Brasil,76,129,115,,244,"(3.541112,-76.384584)"
2015,Diciembre,Brasil,76,3747,3449,,7196,"(4.697144,-74.140516)"
2015,Diciembre,Brasil,76,52,47,,99,"(4.815061,-75.736532)"
2015,Diciembre,Brasil,76,237,234,,471,"(6.171601,-75.427454)"
2015,Diciembre,Brasil,76,6,13,,19,"(7.128456,-73.183637)"
2015,Diciembre,Brasil,76,4,4,,8,"(7.927209,-72.507910)"
2015,Diciembre,Bulgaria,100,1,0,,1,"(4.697144,-74.140516)"
2015,Diciembre,Cabo Verde,132,0,1,,1,"(4.697144,-74.140516)"
2015,Diciembre,Islas Caimán/Territorio Británico de Ultramar,136,1,0,,1,"(10.445761,-75.516429)"
2015,Diciembre,Islas Caimán/Territorio Británico de Ultramar,136,1,0,,1,"(10.886611,-74.776708)"
2015,Diciembre,Islas Caimán/Territorio Británico de Ultramar,136,3,1,,4,"(12.586067,-81.702563)"
2015,Diciembre,Islas Caimán/Territorio Británico de Ultramar,136,2,1,,3,"(3.541112,-76.384584)"
2015,Diciembre,Islas Caimán/Territorio Británico de Ultramar,136,5,4,,9,"(4.697144,-74.140516)"
2015,Diciembre,Camboya,116,1,0,,1,"(4.697144,-74.140516)"
2015,Diciembre,Camerún,120,1,0,,1,"(4.697144,-74.140516)"
2015,Diciembre,Canadá,124,17,15,,32,"(10.445761,-75.516429)"
2015,Diciembre,Canadá,124,30,24,,54,"(10.886611,-74.776708)"
2015,Diciembre,Canadá,124,2,1,,3,"(12.586067,-81.702563)"
2015,Diciembre,Canadá,124,104,70,,174,"(3.541112,-76.384584)"
2015,Diciembre,Canadá,124,3,2,,5,"(4.452882,-75.766298)"
2015,Diciembre,Canadá,124,1267,944,,2211,"(4.697144,-74.140516)"
2015,Diciembre,Canadá,124,17,11,,28,"(4.815061,-75.736532)"
2015,Diciembre,Canadá,124,193,139,,332,"(6.171601,-75.427454)"
2015,Diciembre,Canadá,124,13,8,,21,"(7.128456,-73.183637)"
2015,Diciembre,Canadá,124,2,3,,5,"(7.927209,-72.507910)"
2015,Diciembre,España,724,0,1,,1,"(0.814836,-77.662532)"
2015,Diciembre,España,724,5,6,,11,"(10.445761,-75.516429)"
2015,Diciembre,España,724,44,25,,69,"(10.886611,-74.776708)"
2015,Diciembre,España,724,2587,1786,,4373,"(3.541112,-76.384584)"
2015,Diciembre,España,724,8305,6182,,14487,"(4.697144,-74.140516)"
2015,Diciembre,España,724,50,34,,84,"(4.815061,-75.736532)"
2015,Diciembre,España,724,1279,849,,2128,"(6.171601,-75.427454)"
2015,Diciembre,España,724,23,19,,42,"(7.128456,-73.183637)"
2015,Diciembre,España,724,5,0,,5,"(7.927209,-72.507910)"
2015,Diciembre,Colombia,170,52,155,,207,"(4.697144,-74.140516)"
2015,Diciembre,República Del Congo,178,0,2,,2,"(4.697144,-74.140516)"
2015,Diciembre,República de Corea,410,14,26,,40,"(4.697144,-74.140516)"
2015,Diciembre,Costa de Marfil,384,0,1,,1,"(10.445761,-75.516429)"
2015,Diciembre,Costa de Marfil,384,0,2,,2,"(4.697144,-74.140516)"
2015,Diciembre,Costa Rica,188,13,11,,24,"(10.445761,-75.516429)"
2015,Diciembre,Costa Rica,188,19,20,,39,"(10.886611,-74.776708)"
2015,Diciembre,Costa Rica,188,2,14,,16,"(12.5744111,-81.703935)"
2015,Diciembre,Costa Rica,188,7,5,,12,"(12.586067,-81.702563)"
2015,Diciembre,Costa Rica,188,49,36,,85,"(3.541112,-76.384584)"
2015,Diciembre,Costa Rica,188,1049,1004,,2053,"(4.697144,-74.140516)"
2015,Diciembre,Costa Rica,188,26,17,,43,"(4.815061,-75.736532)"
2015,Diciembre,Costa Rica,188,155,139,,294,"(6.171601,-75.427454)"
2015,Diciembre,Costa Rica,188,14,10,,24,"(7.128456,-73.183637)"
2015,Diciembre,Costa Rica,188,2,1,,3,"(7.927209,-72.507910)"
2015,Diciembre,Croacia,191,1,0,,1,"(4.697144,-74.140516)"
2015,Diciembre,Cuba,192,12,12,,24,"(10.445761,-75.516429)"
2015,Diciembre,Cuba,192,7,6,,13,"(10.886611,-74.776708)"
2015,Diciembre,Cuba,192,2,1,,3,"(12.586067,-81.702563)"
2015,Diciembre,Cuba,192,46,39,,85,"(3.541112,-76.384584)"
2015,Diciembre,Cuba,192,1315,1140,,2455,"(4.697144,-74.140516)"
2015,Diciembre,Cuba,192,23,13,,36,"(4.815061,-75.736532)"
2015,Diciembre,Cuba,192,144,130,,274,"(6.171601,-75.427454)"
2015,Diciembre,Cuba,192,17,11,,28,"(7.128456,-73.183637)"
2015,Diciembre,Cuba,192,12,9,,21,"(7.927209,-72.507910)"
2015,Diciembre,Curazao,99999,0,14,,14,"(4.697144,-74.140516)"
2015,Diciembre,República Checa,203,0,1,,1,"(3.541112,-76.384584)"
2015,Diciembre,República Checa,203,8,2,,10,"(4.697144,-74.140516)"
2015,Diciembre,Chile,152,98,76,,174,"(0.814836,-77.662532)"
2015,Diciembre,Chile,152,0,1,,1,"(1.813928,-78.763924)"
2015,Diciembre,Chile,152,14,5,,19,"(10.445761,-75.516429)"
2015,Diciembre,Chile,152,39,11,,50,"(10.886611,-74.776708)"
2015,Diciembre,Chile,152,4,1,,5,"(12.586067,-81.702563)"
2015,Diciembre,Chile,152,450,285,,735,"(3.541112,-76.384584)"
2015,Diciembre,Chile,152,4536,3513,,8049,"(4.697144,-74.140516)"
2015,Diciembre,Chile,152,84,66,,150,"(4.815061,-75.736532)"
2015,Diciembre,Chile,152,165,105,,270,"(6.171601,-75.427454)"
2015,Diciembre,Chile,152,28,17,,45,"(7.128456,-73.183637)"
2015,Diciembre,Chile,152,3,1,,4,"(7.927209,-72.507910)"
2015,Diciembre,China,156,1,0,,1,"(10.886611,-74.776708)"
2015,Diciembre,China,156,5,12,,17,"(3.541112,-76.384584)"
2015,Diciembre,China,156,58,98,,156,"(4.697144,-74.140516)"
2015,Diciembre,China,156,0,1,,1,"(4.815061,-75.736532)"
2015,Diciembre,China,156,13,18,,31,"(6.171601,-75.427454)"
2015,Diciembre,Chipre,196,1,0,,1,"(3.541112,-76.384584)"
2015,Diciembre,Dinamarca,208,1,0,,1,"(10.886611,-74.776708)"
2015,Diciembre,Dinamarca,208,34,23,,57,"(4.697144,-74.140516)"
2015,Diciembre,Dinamarca,208,1,0,,1,"(6.171601,-75.427454)"
2015,Diciembre,Dominica,212,8,11,,19,"(4.697144,-74.140516)"
2015,Diciembre,Ecuador,218,596,649,,1245,"(0.25129,-76.875963)"
2015,Diciembre,Ecuador,218,20,25,,45,"(0.812436,-77.847006)"
2015,Diciembre,Ecuador,218,8935,8802,,17737,"(0.814836,-77.662532)"
2015,Diciembre,Ecuador,218,220,220,,440,"(1.813928,-78.763924)"
2015,Diciembre,Ecuador,218,0,12,,12,"(10.408582,-75.538003)"
2015,Diciembre,Ecuador,218,4,2,,6,"(10.445761,-75.516429)"
2015,Diciembre,Ecuador,218,6,2,,8,"(10.886611,-74.776708)"
2015,Diciembre,Ecuador,218,0,1,,1,"(12.586067,-81.702563)"
2015,Diciembre,Ecuador,218,366,342,,708,"(3.541112,-76.384584)"
2015,Diciembre,Ecuador,218,3199,3867,,7066,"(4.697144,-74.140516)"
2015,Diciembre,Ecuador,218,3,2,,5,"(4.815061,-75.736532)"
2015,Diciembre,Ecuador,218,55,46,,101,"(6.171601,-75.427454)"
2015,Diciembre,Ecuador,218,14,11,,25,"(7.128456,-73.183637)"
2015,Diciembre,Ecuador,218,2,1,,3,"(7.927209,-72.507910)"
2015,Diciembre,Egipto,818,0,2,,2,"(3.541112,-76.384584)"
2015,Diciembre,Egipto,818,30,14,,44,"(4.697144,-74.140516)"
2015,Diciembre,Egipto,818,4,2,,6,"(6.171601,-75.427454)"
2015,Diciembre,El Salvador,222,3,2,,5,"(10.445761,-75.516429)"
2015,Diciembre,El Salvador,222,1,1,,2,"(10.886611,-74.776708)"
2015,Diciembre,El Salvador,222,1,0,,1,"(12.586067,-81.702563)"
2015,Diciembre,El Salvador,222,101,115,,216,"(3.541112,-76.384584)"
2015,Diciembre,El Salvador,222,730,752,,1482,"(4.697144,-74.140516)"
2015,Diciembre,El Salvador,222,0,2,,2,"(4.815061,-75.736532)"
2015,Diciembre,El Salvador,222,91,126,,217,"(6.171601,-75.427454)"
2015,Diciembre,El Salvador,222,5,3,,8,"(7.128456,-73.183637)"
2015,Diciembre,Emiratos Árabes,784,4,0,,4,"(10.886611,-74.776708)"
2015,Diciembre,Emiratos Árabes,784,2,6,,8,"(3.541112,-76.384584)"
2015,Diciembre,Emiratos Árabes,784,128,160,,288,"(4.697144,-74.140516)"
2015,Diciembre,Emiratos Árabes,784,11,5,,16,"(6.171601,-75.427454)"
2015,Diciembre,Eslovaquia,703,1,0,,1,"(3.541112,-76.384584)"
2015,Diciembre,Eslovaquia,703,0,1,,1,"(4.697144,-74.140516)"
2015,Diciembre,Eslovenia,705,2,0,,2,"(4.697144,-74.140516)"
2015,Diciembre,Estados Unidos de América,840,1,0,,1,"(10.408582,-75.538003)"
2015,Diciembre,Estados Unidos de América,840,4625,3653,,8278,"(10.445761,-75.516429)"
2015,Diciembre,Estados Unidos de América,840,3358,2529,,5887,"(10.886611,-74.776708)"
2015,Diciembre,Estados Unidos de América,840,6,12,,18,"(11.117806,-74.232622)"
2015,Diciembre,Estados Unidos de América,840,31,24,,55,"(12.586067,-81.702563)"
2015,Diciembre,Estados Unidos de América,840,5936,4233,,10169,"(3.541112,-76.384584)"
2015,Diciembre,Estados Unidos de América,840,618,408,,1026,"(4.452882,-75.766298)"
2015,Diciembre,Estados Unidos de América,840,44914,36391,,81305,"(4.697144,-74.140516)"
2015,Diciembre,Estados Unidos de América,840,945,588,,1533,"(4.815061,-75.736532)"
2015,Diciembre,Estados Unidos de América,840,12842,9913,,22755,"(6.171601,-75.427454)"
2015,Diciembre,Estados Unidos de América,840,411,292,,703,"(7.128456,-73.183637)"
2015,Diciembre,Estados Unidos de América,840,109,99,,208,"(7.927209,-72.507910)"
2015,Diciembre,Estonia,233,3,1,,4,"(4.697144,-74.140516)"
2015,Diciembre,Etiopia,231,1,5,,6,"(4.697144,-74.140516)"
2015,Diciembre,Etiopia,231,1,1,,2,"(6.171601,-75.427454)"
2015,Diciembre,Filipinas,608,0,1,,1,"(10.886611,-74.776708)"
2015,Diciembre,Filipinas,608,3,1,,4,"(4.697144,-74.140516)"
2015,Diciembre,Filipinas,608,1,2,,3,"(6.171601,-75.427454)"
2015,Diciembre,Finlandia,246,1,1,,2,"(3.541112,-76.384584)"
2015,Diciembre,Finlandia,246,12,6,,18,"(4.697144,-74.140516)"
2015,Diciembre,Finlandia,246,1,0,,1,"(6.171601,-75.427454)"
2015,Diciembre,Francia,250,3,0,,3,"(10.445761,-75.516429)"
2015,Diciembre,Francia,250,1,2,,3,"(10.886611,-74.776708)"
2015,Diciembre,Francia,250,88,62,,150,"(3.541112,-76.384584)"
2015,Diciembre,Francia,250,1606,1238,,2844,"(4.697144,-74.140516)"
2015,Diciembre,Francia,250,1,2,,3,"(4.815061,-75.736532)"
2015,Diciembre,Francia,250,61,44,,105,"(6.171601,-75.427454)"
2015,Diciembre,Francia,250,1,0,,1,"(7.128456,-73.183637)"
2015,Diciembre,Gabón,266,0,2,,2,"(4.697144,-74.140516)"
2015,Diciembre,Georgia,268,3,0,,3,"(3.541112,-76.384584)"
2015,Diciembre,Ghana,288,1,0,,1,"(3.541112,-76.384584)"
2015,Diciembre,Ghana,288,0,3,,3,"(4.697144,-74.140516)"
2015,Diciembre,Gibraltar/Territorio Británico de Ultramar,292,2,1,,3,"(0.814836,-77.662532)"
2015,Diciembre,Grecia,300,12,5,,17,"(4.697144,-74.140516)"
2015,Diciembre,Guatemala,320,2,0,,2,"(10.445761,-75.516429)"
2015,Diciembre,Guatemala,320,7,13,,20,"(10.886611,-74.776708)"
2015,Diciembre,Guatemala,320,68,58,,126,"(3.541112,-76.384584)"
2015,Diciembre,Guatemala,320,558,574,,1132,"(4.697144,-74.140516)"
2015,Diciembre,Guatemala,320,13,5,,18,"(4.815061,-75.736532)"
2015,Diciembre,Guatemala,320,83,71,,154,"(6.171601,-75.427454)"
2015,Diciembre,Guatemala,320,12,9,,21,"(7.128456,-73.183637)"
2015,Diciembre,Guatemala,320,0,1,,1,"(7.927209,-72.507910)"
2015,Diciembre,Guyana,328,0,1,,1,"(4.697144,-74.140516)"
2015,Diciembre,Guinea Ecuatorial,226,1,1,,2,"(4.697144,-74.140516)"
2015,Diciembre,Guadalupe/Territorio Francés,312,4,1,,5,"(4.697144,-74.140516)"
2015,Diciembre,Guayana Francesa/Departamento de Ultramar Francés,254,1,3,,4,"(4.697144,-74.140516)"
2015,Diciembre,Haití,332,1,1,,2,"(10.445761,-75.516429)"
2015,Diciembre,Haití,332,0,4,,4,"(10.886611,-74.776708)"
2015,Diciembre,Haití,332,5,7,,12,"(4.697144,-74.140516)"
2015,Diciembre,Haití,332,2,3,,5,"(4.815061,-75.736532)"
2015,Diciembre,Haití,332,1,3,,4,"(6.171601,-75.427454)"
2015,Diciembre,Haití,332,0,1,,1,"(7.128456,-73.183637)"
2015,Diciembre,Honduras,340,0,3,,3,"(10.445761,-75.516429)"
2015,Diciembre,Honduras,340,3,3,,6,"(10.886611,-74.776708)"
2015,Diciembre,Honduras,340,1,1,,2,"(13.3387613,-81.372937)"
2015,Diciembre,Honduras,340,12,22,,34,"(3.541112,-76.384584)"
2015,Diciembre,Honduras,340,98,118,,216,"(4.697144,-74.140516)"
2015,Diciembre,Honduras,340,5,4,,9,"(4.815061,-75.736532)"
2015,Diciembre,Honduras,340,45,42,,87,"(6.171601,-75.427454)"
2015,Diciembre,Honduras,340,0,3,,3,"(7.128456,-73.183637)"
2015,Diciembre,Honduras,340,1,0,,1,"(7.927209,-72.507910)"
2015,Diciembre,Hong Kong,344,0,1,,1,"(10.886611,-74.776708)"
2015,Diciembre,Hong Kong,344,0,1,,1,"(3.541112,-76.384584)"
2015,Diciembre,Hong Kong,344,31,25,,56,"(4.697144,-74.140516)"
2015,Diciembre,Hungría,348,4,0,,4,"(4.697144,-74.140516)"
2015,Diciembre,India,356,1,1,,2,"(3.541112,-76.384584)"
2015,Diciembre,India,356,81,49,,130,"(4.697144,-74.140516)"
2015,Diciembre,India,356,0,4,,4,"(6.171601,-75.427454)"
2015,Diciembre,Indonesia,360,1,2,,3,"(3.541112,-76.384584)"
2015,Diciembre,Indonesia,360,10,7,,17,"(4.697144,-74.140516)"
2015,Diciembre,Indonesia,360,1,2,,3,"(6.171601,-75.427454)"
2015,Diciembre,Iraq,368,0,4,,4,"(4.697144,-74.140516)"
2015,Diciembre,Irán,364,0,1,,1,"(4.697144,-74.140516)"
2015,Diciembre,Irán,364,1,0,,1,"(6.171601,-75.427454)"
2015,Diciembre,República de Irlanda,372,1,2,,3,"(3.541112,-76.384584)"
2015,Diciembre,República de Irlanda,372,18,5,,23,"(4.697144,-74.140516)"
2015,Diciembre,Israel,376,1,0,,1,"(10.886611,-74.776708)"
2015,Diciembre,Israel,376,8,6,,14,"(3.541112,-76.384584)"
2015,Diciembre,Israel,376,141,71,,212,"(4.697144,-74.140516)"
2015,Diciembre,Israel,376,1,2,,3,"(6.171601,-75.427454)"
2015,Diciembre,Italia,380,4,2,,6,"(10.445761,-75.516429)"
2015,Diciembre,Italia,380,6,3,,9,"(10.886611,-74.776708)"
2015,Diciembre,Italia,380,124,60,,184,"(3.541112,-76.384584)"
2015,Diciembre,Italia,380,579,349,,928,"(4.697144,-74.140516)"
2015,Diciembre,Italia,380,2,3,,5,"(4.815061,-75.736532)"
2015,Diciembre,Italia,380,70,44,,114,"(6.171601,-75.427454)"
2015,Diciembre,Italia,380,0,1,,1,"(7.128456,-73.183637)"
2015,Diciembre,Jamaica,388,1,1,,2,"(10.445761,-75.516429)"
2015,Diciembre,Jamaica,388,0,3,,3,"(10.886611,-74.776708)"
2015,Diciembre,Jamaica,388,1,0,,1,"(12.586067,-81.702563)"
2015,Diciembre,Jamaica,388,12,6,,18,"(3.541112,-76.384584)"
2015,Diciembre,Jamaica,388,19,20,,39,"(4.697144,-74.140516)"
2015,Diciembre,Jamaica,388,33,25,,58,"(6.171601,-75.427454)"
2015,Diciembre,Jamaica,388,0,3,,3,"(7.128456,-73.183637)"
2015,Diciembre,Japón,392,1,0,,1,"(10.886611,-74.776708)"
2015,Diciembre,Japón,392,1,0,,1,"(3.541112,-76.384584)"
2015,Diciembre,Japón,392,43,65,,108,"(4.697144,-74.140516)"
2015,Diciembre,Japón,392,2,2,,4,"(6.171601,-75.427454)"
2015,Diciembre,Jordania,400,4,7,,11,"(4.697144,-74.140516)"
2015,Diciembre,Kazajistán,398,0,5,,5,"(4.697144,-74.140516)"
2015,Diciembre,Kenia,404,1,7,,8,"(4.697144,-74.140516)"
2015,Diciembre,Kuwait,414,0,1,,1,"(3.541112,-76.384584)"
2015,Diciembre,Kuwait,414,3,0,,3,"(4.697144,-74.140516)"
2015,Diciembre,República de Kosovo,901,0,1,,1,"(4.697144,-74.140516)"
2015,Diciembre,Lituania,440,2,0,,2,"(4.697144,-74.140516)"
2015,Diciembre,Líbano,422,11,10,,21,"(4.697144,-74.140516)"
2015,Diciembre,Luxemburgo,442,5,5,,10,"(4.697144,-74.140516)"
2015,Diciembre,Luxemburgo,442,2,1,,3,"(7.128456,-73.183637)"
2015,Diciembre,Macedonia,807,0,1,,1,"(4.697144,-74.140516)"
2015,Diciembre,Malasia,458,2,2,,4,"(3.541112,-76.384584)"
2015,Diciembre,Malasia,458,5,5,,10,"(4.697144,-74.140516)"
2015,Diciembre,Malí,466,2,0,,2,"(4.697144,-74.140516)"
2015,Diciembre,Malta,470,7,7,,14,"(4.697144,-74.140516)"
2015,Diciembre,Marruecos,504,8,2,,10,"(3.541112,-76.384584)"
2015,Diciembre,Marruecos,504,7,5,,12,"(4.697144,-74.140516)"
2015,Diciembre,Mauritania,478,1,0,,1,"(4.697144,-74.140516)"
2015,Diciembre,México,484,58,40,,98,"(10.445761,-75.516429)"
2015,Diciembre,México,484,142,101,,243,"(10.886611,-74.776708)"
2015,Diciembre,México,484,1,0,,1,"(12.586067,-81.702563)"
2015,Diciembre,México,484,534,467,,1001,"(3.541112,-76.384584)"
2015,Diciembre,México,484,15630,12707,,28337,"(4.697144,-74.140516)"
2015,Diciembre,México,484,169,141,,310,"(4.815061,-75.736532)"
2015,Diciembre,México,484,2552,1790,,4342,"(6.171601,-75.427454)"
2015,Diciembre,México,484,188,136,,324,"(7.128456,-73.183637)"
2015,Diciembre,México,484,56,36,,92,"(7.927209,-72.507910)"
2015,Diciembre,Montenegro,499,1,0,,1,"(6.171601,-75.427454)"
2015,Diciembre,Mozambique,508,0,1,,1,"(3.541112,-76.384584)"
2015,Diciembre,Mozambique,508,3,0,,3,"(4.697144,-74.140516)"
2015,Diciembre,Myanmar,104,1,1,,2,"(4.697144,-74.140516)"
2015,Diciembre,Nicaragua,558,4,4,,8,"(10.445761,-75.516429)"
2015,Diciembre,Nicaragua,558,5,4,,9,"(10.886611,-74.776708)"
2015,Diciembre,Nicaragua,558,1,1,,2,"(12.586067,-81.702563)"
2015,Diciembre,Nicaragua,558,11,13,,24,"(3.541112,-76.384584)"
2015,Diciembre,Nicaragua,558,42,62,,104,"(4.697144,-74.140516)"
2015,Diciembre,Nicaragua,558,0,3,,3,"(4.815061,-75.736532)"
2015,Diciembre,Nicaragua,558,7,33,,40,"(6.171601,-75.427454)"
2015,Diciembre,Nicaragua,558,4,4,,8,"(7.128456,-73.183637)"
2015,Diciembre,Nigeria,566,0,4,,4,"(4.697144,-74.140516)"
2015,Diciembre,Níger,562,0,1,,1,"(4.697144,-74.140516)"
2015,Diciembre,Noruega,578,0,1,,1,"(10.445761,-75.516429)"
2015,Diciembre,Noruega,578,1,0,,1,"(3.541112,-76.384584)"
2015,Diciembre,Noruega,578,29,25,,54,"(4.697144,-74.140516)"
2015,Diciembre,Noruega,578,4,1,,5,"(6.171601,-75.427454)"
2015,Diciembre,Nueva Zelanda,554,31,22,,53,"(4.697144,-74.140516)"
2015,Diciembre,Nueva Zelanda,554,9,6,,15,"(6.171601,-75.427454)"
2015,Diciembre,Omán,512,6,6,,12,"(4.697144,-74.140516)"
2015,Diciembre,Omán,512,1,0,,1,"(6.171601,-75.427454)"
2015,Diciembre,Papúa Nueva Guinea,598,0,1,,1,"(4.697144,-74.140516)"
2015,Diciembre,Pakistán,586,0,1,,1,"(4.697144,-74.140516)"
2015,Diciembre,Panamá,591,129,127,,256,"(10.408582,-75.538003)"
2015,Diciembre,Panamá,591,417,364,,781,"(10.445761,-75.516429)"
2015,Diciembre,Panamá,591,1024,878,,1902,"(10.886611,-74.776708)"
2015,Diciembre,Panamá,591,0,1,,1,"(10.971302,-74.765397)"
2015,Diciembre,Panamá,591,1,9,,10,"(12.5744111,-81.703935)"
2015,Diciembre,Panamá,591,180,160,,340,"(12.586067,-81.702563)"
2015,Diciembre,Panamá,591,1872,1505,,3377,"(3.541112,-76.384584)"
2015,Diciembre,Panamá,591,0,2,,2,"(3.893038,-77.067921)"
2015,Diciembre,Panamá,591,164,113,,277,"(4.452882,-75.766298)"
2015,Diciembre,Panamá,591,11030,10163,,21193,"(4.697144,-74.140516)"
2015,Diciembre,Panamá,591,512,384,,896,"(4.815061,-75.736532)"
2015,Diciembre,Panamá,591,4452,3727,,8179,"(6.171601,-75.427454)"
2015,Diciembre,Panamá,591,6,9,,15,"(6.228046,-77.404104)"
2015,Diciembre,Panamá,591,0,9,,9,"(7.102626,-77.762647)"
2015,Diciembre,Panamá,591,323,280,,603,"(7.128456,-73.183637)"
2015,Diciembre,Panamá,591,138,115,,253,"(7.927209,-72.507910)"
2015,Diciembre,Panamá,591,0,36,,36,"(8.066966,-76.735404)"
2015,Diciembre,Panamá,591,23,39,,62,"(8.635765,-77.346578)"
2015,Diciembre,Paraguay,600,1,4,,5,"(10.445761,-75.516429)"
2015,Diciembre,Paraguay,600,0,3,,3,"(10.886611,-74.776708)"
2015,Diciembre,Paraguay,600,21,17,,38,"(3.541112,-76.384584)"
2015,Diciembre,Paraguay,600,146,188,,334,"(4.697144,-74.140516)"
2015,Diciembre,Paraguay,600,8,9,,17,"(4.815061,-75.736532)"
2015,Diciembre,Paraguay,600,8,12,,20,"(6.171601,-75.427454)"
2015,Diciembre,Paraguay,600,1,2,,3,"(7.128456,-73.183637)"
2015,Diciembre,Paraguay,600,1,0,,1,"(7.927209,-72.507910)"
2015,Diciembre,Perú,604,156,143,,299,"(-4.197703,-69.941278)"
2015,Diciembre,Perú,604,84,89,,173,"(0.814836,-77.662532)"
2015,Diciembre,Perú,604,7,2,,9,"(10.445761,-75.516429)"
2015,Diciembre,Perú,604,23,15,,38,"(10.886611,-74.776708)"
2015,Diciembre,Perú,604,2,3,,5,"(12.586067,-81.702563)"
2015,Diciembre,Perú,604,325,299,,624,"(3.541112,-76.384584)"
2015,Diciembre,Perú,604,5199,5057,,10256,"(4.697144,-74.140516)"
2015,Diciembre,Perú,604,16,6,,22,"(4.815061,-75.736532)"
2015,Diciembre,Perú,604,389,364,,753,"(6.171601,-75.427454)"
2015,Diciembre,Perú,604,3,2,,5,"(7.128456,-73.183637)"
2015,Diciembre,Polonia,616,1,0,,1,"(3.541112,-76.384584)"
2015,Diciembre,Polonia,616,17,21,,38,"(4.697144,-74.140516)"
2015,Diciembre,Polonia,616,1,1,,2,"(6.171601,-75.427454)"
2015,Diciembre,Portugal,620,8,5,,13,"(3.541112,-76.384584)"
2015,Diciembre,Portugal,620,147,129,,276,"(4.697144,-74.140516)"
2015,Diciembre,Portugal,620,3,2,,5,"(6.171601,-75.427454)"
2015,Diciembre,Portugal,620,2,0,,2,"(7.927209,-72.507910)"
2015,Diciembre,Polinesia Francesa/Colectividad de Ultramar Francesa,258,0,1,,1,"(3.541112,-76.384584)"
2015,Diciembre,Puerto Rico/Territorio de Estados Unidos,630,6,4,,10,"(10.445761,-75.516429)"
2015,Diciembre,Puerto Rico/Territorio de Estados Unidos,630,14,9,,23,"(10.886611,-74.776708)"
2015,Diciembre,Puerto Rico/Territorio de Estados Unidos,630,40,27,,67,"(3.541112,-76.384584)"
2015,Diciembre,Puerto Rico/Territorio de Estados Unidos,630,714,588,,1302,"(4.697144,-74.140516)"
2015,Diciembre,Puerto Rico/Territorio de Estados Unidos,630,14,10,,24,"(4.815061,-75.736532)"
2015,Diciembre,Puerto Rico/Territorio de Estados Unidos,630,64,45,,109,"(6.171601,-75.427454)"
2015,Diciembre,Puerto Rico/Territorio de Estados Unidos,630,7,4,,11,"(7.128456,-73.183637)"
2015,Diciembre,Puerto Rico/Territorio de Estados Unidos,630,3,2,,5,"(7.927209,-72.507910)"
2015,Diciembre,Qatar,634,4,8,,12,"(4.697144,-74.140516)"
2015,Diciembre,Qatar,634,3,8,,11,"(6.171601,-75.427454)"
2015,Diciembre,Reino Unido de Gran Bretaña e Irlanda del Norte,826,1,0,,1,"(10.445761,-75.516429)"
2015,Diciembre,Reino Unido de Gran Bretaña e Irlanda del Norte,826,20,14,,34,"(3.541112,-76.384584)"
2015,Diciembre,Reino Unido de Gran Bretaña e Irlanda del Norte,826,1680,1218,,2898,"(4.697144,-74.140516)"
2015,Diciembre,Reino Unido de Gran Bretaña e Irlanda del Norte,826,0,1,,1,"(4.815061,-75.736532)"
2015,Diciembre,Reino Unido de Gran Bretaña e Irlanda del Norte,826,16,8,,24,"(6.171601,-75.427454)"
2015,Diciembre,Reino Unido de Gran Bretaña e Irlanda del Norte,826,1,0,,1,"(7.927209,-72.507910)"
2015,Diciembre,Federación de Rusia,643,1,2,,3,"(3.541112,-76.384584)"
2015,Diciembre,Federación de Rusia,643,23,35,,58,"(4.697144,-74.140516)"
2015,Diciembre,Federación de Rusia,643,0,1,,1,"(6.171601,-75.427454)"
2015,Diciembre,República Dominicana,214,20,17,,37,"(10.445761,-75.516429)"
2015,Diciembre,República Dominicana,214,48,34,,82,"(10.886611,-74.776708)"
2015,Diciembre,República Dominicana,214,0,1,,1,"(12.586067,-81.702563)"
2015,Diciembre,República Dominicana,214,123,84,,207,"(3.541112,-76.384584)"
2015,Diciembre,República Dominicana,214,4509,3752,,8261,"(4.697144,-74.140516)"
2015,Diciembre,República Dominicana,214,69,40,,109,"(4.815061,-75.736532)"
2015,Diciembre,República Dominicana,214,321,214,,535,"(6.171601,-75.427454)"
2015,Diciembre,República Dominicana,214,81,52,,133,"(7.128456,-73.183637)"
2015,Diciembre,República Dominicana,214,46,25,,71,"(7.927209,-72.507910)"
2015,Diciembre,Reunión,638,1,1,,2,"(4.697144,-74.140516)"
2015,Diciembre,Rumania,642,4,3,,7,"(4.697144,-74.140516)"
2015,Diciembre,San Marino,674,1,2,,3,"(10.886611,-74.776708)"
2015,Diciembre,Serbia,688,0,1,,1,"(4.697144,-74.140516)"
2015,Diciembre,Seychelles,690,1,0,,1,"(4.697144,-74.140516)"
2015,Diciembre,Singapur,702,16,17,,33,"(4.697144,-74.140516)"
2015,Diciembre,Singapur,702,1,0,,1,"(4.815061,-75.736532)"
2015,Diciembre,Singapur,702,0,1,,1,"(6.171601,-75.427454)"
2015,Diciembre,Sudáfrica,710,1,0,,1,"(10.445761,-75.516429)"
2015,Diciembre,Sudáfrica,710,15,14,,29,"(4.697144,-74.140516)"
2015,Diciembre,Suecia,752,1,0,,1,"(10.445761,-75.516429)"
2015,Diciembre,Suecia,752,2,2,,4,"(10.886611,-74.776708)"
2015,Diciembre,Suecia,752,9,11,,20,"(3.541112,-76.384584)"
2015,Diciembre,Suecia,752,65,57,,122,"(4.697144,-74.140516)"
2015,Diciembre,Suecia,752,9,1,,10,"(6.171601,-75.427454)"
2015,Diciembre,Suiza,756,2,0,,2,"(10.886611,-74.776708)"
2015,Diciembre,Suiza,756,48,16,,64,"(3.541112,-76.384584)"
2015,Diciembre,Suiza,756,236,165,,401,"(4.697144,-74.140516)"
2015,Diciembre,Suiza,756,21,15,,36,"(6.171601,-75.427454)"
2015,Diciembre,Surinam,740,0,2,,2,"(4.697144,-74.140516)"
2015,Diciembre,Surinam,740,2,0,,2,"(6.171601,-75.427454)"
2015,Diciembre,Taiwán,158,1,1,,2,"(4.697144,-74.140516)"
2015,Diciembre,República de Tayikistán,762,0,1,,1,"(4.697144,-74.140516)"
2015,Diciembre,Tailandia,764,35,36,,71,"(4.697144,-74.140516)"
2015,Diciembre,Tanzania,834,5,2,,7,"(4.697144,-74.140516)"
2015,Diciembre,Trinidad y Tobago,780,6,9,,15,"(10.445761,-75.516429)"
2015,Diciembre,Trinidad y Tobago,780,2,1,,3,"(10.886611,-74.776708)"
2015,Diciembre,Trinidad y Tobago,780,8,16,,24,"(3.541112,-76.384584)"
2015,Diciembre,Trinidad y Tobago,780,23,29,,52,"(4.697144,-74.140516)"
2015,Diciembre,Trinidad y Tobago,780,8,1,,9,"(4.815061,-75.736532)"
2015,Diciembre,Trinidad y Tobago,780,9,4,,13,"(6.171601,-75.427454)"
2015,Diciembre,Trinidad y Tobago,780,1,1,,2,"(7.128456,-73.183637)"
2015,Diciembre,Trinidad y Tobago,780,1,2,,3,"(7.927209,-72.507910)"
2015,Diciembre,Túnez,788,1,0,,1,"(4.697144,-74.140516)"
2015,Diciembre,Turquía,792,3,4,,7,"(3.541112,-76.384584)"
2015,Diciembre,Turquía,792,41,45,,86,"(4.697144,-74.140516)"
2015,Diciembre,Turquía,792,2,0,,2,"(7.128456,-73.183637)"
2015,Diciembre,Turkmenistán,795,1,0,,1,"(4.697144,-74.140516)"
2015,Diciembre,Ucrania,804,0,2,,2,"(4.697144,-74.140516)"
2015,Diciembre,Uganda,800,0,1,,1,"(10.445761,-75.516429)"
2015,Diciembre,Uganda,800,1,1,,2,"(4.697144,-74.140516)"
2015,Diciembre,Uganda,800,2,0,,2,"(6.171601,-75.427454)"
2015,Diciembre,Uruguay,858,12,24,,36,"(3.541112,-76.384584)"
2015,Diciembre,Uruguay,858,115,81,,196,"(4.697144,-74.140516)"
2015,Diciembre,Uruguay,858,0,3,,3,"(4.815061,-75.736532)"
2015,Diciembre,Uruguay,858,36,31,,67,"(6.171601,-75.427454)"
2015,Diciembre,Uzbekistán,860,0,1,,1,"(4.697144,-74.140516)"
2015,Diciembre,Venezuela,862,92,67,,159,"(10.445761,-75.516429)"
2015,Diciembre,Venezuela,862,66,64,,130,"(10.886611,-74.776708)"
2015,Diciembre,Venezuela,862,83,84,,167,"(11.360009,-72.129330)"
2015,Diciembre,Venezuela,862,0,1,,1,"(12.586067,-81.702563)"
2015,Diciembre,Venezuela,862,17,15,,32,"(3.541112,-76.384584)"
2015,Diciembre,Venezuela,862,5,7,,12,"(3.866713,-67.927521)"
2015,Diciembre,Venezuela,862,1209,1380,,2589,"(4.697144,-74.140516)"
2015,Diciembre,Venezuela,862,8,5,,13,"(4.815061,-75.736532)"
2015,Diciembre,Venezuela,862,234,231,,465,"(6.171601,-75.427454)"
2015,Diciembre,Venezuela,862,0,2,,2,"(6.185799,-67.483929)"
2015,Diciembre,Venezuela,862,6,7,,13,"(7.088729,-70.740253)"
2015,Diciembre,Venezuela,862,14,7,,21,"(7.128456,-73.183637)"
2015,Diciembre,Venezuela,862,474,447,,921,"(7.818934,-72.453226)"
2015,Diciembre,Venezuela,862,285,260,,545,"(7.927209,-72.507910)"
2015,Diciembre,Vietnam,704,1,5,,6,"(4.697144,-74.140516)"
2015,Diciembre,Islas Vírgenes Británicas/Territorio Británico de Ultramar,92,0,5,,5,"(3.541112,-76.384584)"
2015,Diciembre,Zambia,894,0,1,,1,"(4.697144,-74.140516)"
2015,Diciembre,Zimbabue,716,1,0,,1,"(4.697144,-74.140516)"
2015,Diciembre,Islas Turcas y Caicos/Territorio Británico de Ultramar,796,4,3,,7,"(10.445761,-75.516429)"
2016,Enero,Afganistán,4,4,10,,14,"(4.697144,-74.140516)"
2016,Enero,Albania,8,0,2,,2,"(4.697144,-74.140516)"
2016,Enero,Alemania,276,0,2,,2,"(0.814836,-77.662532)"
2016,Enero,Alemania,276,1,1,,2,"(10.445761,-75.516429)"
2016,Enero,Alemania,276,5,15,,20,"(10.886611,-74.776708)"
2016,Enero,Alemania,276,118,62,,180,"(3.541112,-76.384584)"
2016,Enero,Alemania,276,1288,995,,2283,"(4.697144,-74.140516)"
2016,Enero,Alemania,276,2,0,,2,"(4.815061,-75.736532)"
2016,Enero,Alemania,276,62,53,,115,"(6.171601,-75.427454)"
2016,Enero,Andorra,20,1,1,,2,"(4.697144,-74.140516)"
2016,Enero,Angola,24,2,18,,20,"(4.697144,-74.140516)"
2016,Enero,Angola,24,0,1,,1,"(7.128456,-73.183637)"
2016,Enero,Antigua y Barbuda,28,3,1,,4,"(4.697144,-74.140516)"
2016,Enero,Países Bajos,528,8,2,,10,"(10.445761,-75.516429)"
2016,Enero,Países Bajos,528,170,91,,261,"(10.886611,-74.776708)"
2016,Enero,Países Bajos,528,277,151,,428,"(3.541112,-76.384584)"
2016,Enero,Países Bajos,528,864,736,,1600,"(4.697144,-74.140516)"
2016,Enero,Países Bajos,528,6,3,,9,"(4.815061,-75.736532)"
2016,Enero,Países Bajos,528,283,211,,494,"(6.171601,-75.427454)"
2016,Enero,Países Bajos,528,2,0,,2,"(7.128456,-73.183637)"
2016,Enero,Países Bajos,528,0,1,,1,"(7.927209,-72.507910)"
2016,Enero,Arabia Saudita,682,0,1,,1,"(10.445761,-75.516429)"
2016,Enero,Arabia Saudita,682,26,64,,90,"(4.697144,-74.140516)"
2016,Enero,Arabia Saudita,682,3,5,,8,"(6.171601,-75.427454)"
2016,Enero,Arabia Saudita,682,1,2,,3,"(7.128456,-73.183637)"
2016,Enero,Argelia,12,1,0,,1,"(3.541112,-76.384584)"
2016,Enero,Argelia,12,3,7,,10,"(4.697144,-74.140516)"
2016,Enero,Argentina,32,10,24,,34,"(0.814836,-77.662532)"
2016,Enero,Argentina,32,14,14,,28,"(10.445761,-75.516429)"
2016,Enero,Argentina,32,41,40,,81,"(10.886611,-74.776708)"
2016,Enero,Argentina,32,14,12,,26,"(12.586067,-81.702563)"
2016,Enero,Argentina,32,192,175,,367,"(3.541112,-76.384584)"
2016,Enero,Argentina,32,3458,3217,,6675,"(4.697144,-74.140516)"
2016,Enero,Argentina,32,18,15,,33,"(4.815061,-75.736532)"
2016,Enero,Argentina,32,154,158,,312,"(6.171601,-75.427454)"
2016,Enero,Argentina,32,8,8,,16,"(7.128456,-73.183637)"
2016,Enero,Argentina,32,4,1,,5,"(7.927209,-72.507910)"
2016,Enero,Aruba,533,1651,1315,,2966,"(10.408582,-75.538003)"
2016,Enero,Aruba,533,2,1,,3,"(10.445761,-75.516429)"
2016,Enero,Aruba,533,83,67,,150,"(10.886611,-74.776708)"
2016,Enero,Aruba,533,61,44,,105,"(3.541112,-76.384584)"
2016,Enero,Aruba,533,1869,1521,,3390,"(4.697144,-74.140516)"
2016,Enero,Aruba,533,18,9,,27,"(4.815061,-75.736532)"
2016,Enero,Aruba,533,218,152,,370,"(6.171601,-75.427454)"
2016,Enero,Aruba,533,35,57,,92,"(7.128456,-73.183637)"
2016,Enero,Aruba,533,9,11,,20,"(7.927209,-72.507910)"
2016,Enero,Australia,36,2,0,,2,"(10.445761,-75.516429)"
2016,Enero,Australia,36,6,4,,10,"(10.886611,-74.776708)"
2016,Enero,Australia,36,48,26,,74,"(3.541112,-76.384584)"
2016,Enero,Australia,36,573,492,,1065,"(4.697144,-74.140516)"
2016,Enero,Australia,36,7,4,,11,"(4.815061,-75.736532)"
2016,Enero,Australia,36,113,83,,196,"(6.171601,-75.427454)"
2016,Enero,Australia,36,12,12,,24,"(7.128456,-73.183637)"
2016,Enero,Australia,36,0,1,,1,"(7.927209,-72.507910)"
2016,Enero,Austria,40,2,1,,3,"(3.541112,-76.384584)"
2016,Enero,Austria,40,52,34,,86,"(4.697144,-74.140516)"
2016,Enero,Austria,40,1,0,,1,"(4.815061,-75.736532)"
2016,Enero,Austria,40,1,3,,4,"(6.171601,-75.427454)"
2016,Enero,Azerbaiyán,31,9,14,,23,"(4.697144,-74.140516)"
2016,Enero,Bahamas,44,3,3,,6,"(10.445761,-75.516429)"
2016,Enero,Bahamas,44,2,17,,19,"(10.886611,-74.776708)"
2016,Enero,Bahamas,44,1,2,,3,"(12.586067,-81.702563)"
2016,Enero,Bahamas,44,11,2,,13,"(3.541112,-76.384584)"
2016,Enero,Bahamas,44,8,13,,21,"(4.697144,-74.140516)"
2016,Enero,Bahamas,44,1,7,,8,"(4.815061,-75.736532)"
2016,Enero,Bahamas,44,12,18,,30,"(6.171601,-75.427454)"
2016,Enero,Bahamas,44,3,9,,12,"(7.927209,-72.507910)"
2016,Enero,Bahréin,48,5,5,,10,"(4.697144,-74.140516)"
2016,Enero,Bahréin,48,2,0,,2,"(6.171601,-75.427454)"
2016,Enero,Bangladesh,50,1,0,,1,"(4.697144,-74.140516)"
2016,Enero,Barbados,52,1,2,,3,"(3.541112,-76.384584)"
2016,Enero,Barbados,52,134,122,,256,"(4.697144,-74.140516)"
2016,Enero,República de Belarús,112,1,1,,2,"(6.171601,-75.427454)"
2016,Enero,Bélgica,56,2,0,,2,"(10.445761,-75.516429)"
2016,Enero,Bélgica,56,1,1,,2,"(10.886611,-74.776708)"
2016,Enero,Bélgica,56,29,25,,54,"(3.541112,-76.384584)"
2016,Enero,Bélgica,56,162,99,,261,"(4.697144,-74.140516)"
2016,Enero,Bélgica,56,2,1,,3,"(4.815061,-75.736532)"
2016,Enero,Bélgica,56,35,12,,47,"(6.171601,-75.427454)"
2016,Enero,Belice,84,2,1,,3,"(3.541112,-76.384584)"
2016,Enero,Belice,84,11,7,,18,"(4.697144,-74.140516)"
2016,Enero,Belice,84,2,1,,3,"(4.815061,-75.736532)"
2016,Enero,Belice,84,4,3,,7,"(6.171601,-75.427454)"
2016,Enero,Bermudas/Territorio Británico de Ultramar,60,1,0,,1,"(4.697144,-74.140516)"
2016,Enero,Bermudas/Territorio Británico de Ultramar,60,1,0,,1,"(4.815061,-75.736532)"
2016,Enero,Bermudas/Territorio Británico de Ultramar,60,2,0,,2,"(6.171601,-75.427454)"
2016,Enero,Bolivia,68,4,14,,18,"(0.814836,-77.662532)"
2016,Enero,Bolivia,68,0,1,,1,"(10.445761,-75.516429)"
2016,Enero,Bolivia,68,3,5,,8,"(10.886611,-74.776708)"
2016,Enero,Bolivia,68,1,1,,2,"(12.586067,-81.702563)"
2016,Enero,Bolivia,68,37,50,,87,"(3.541112,-76.384584)"
2016,Enero,Bolivia,68,404,646,,1050,"(4.697144,-74.140516)"
2016,Enero,Bolivia,68,10,15,,25,"(4.815061,-75.736532)"
2016,Enero,Bolivia,68,36,62,,98,"(6.171601,-75.427454)"
2016,Enero,Bolivia,68,3,5,,8,"(7.128456,-73.183637)"
2016,Enero,Bolivia,68,0,2,,2,"(7.927209,-72.507910)"
2016,Enero,Botsuana,72,1,0,,1,"(4.697144,-74.140516)"
2016,Enero,Brasil,76,148,233,,381,"(-4.197703,-69.941278)"
2016,Enero,Brasil,76,3,1,,4,"(-4.223468,-69.945098)"
2016,Enero,Brasil,76,1,0,,1,"(0.814836,-77.662532)"
2016,Enero,Brasil,76,8,13,,21,"(10.445761,-75.516429)"
2016,Enero,Brasil,76,29,16,,45,"(10.886611,-74.776708)"
2016,Enero,Brasil,76,0,6,,6,"(11.117806,-74.232622)"
2016,Enero,Brasil,76,1,9,,10,"(12.586067,-81.702563)"
2016,Enero,Brasil,76,196,243,,439,"(3.541112,-76.384584)"
2016,Enero,Brasil,76,3463,4035,,7498,"(4.697144,-74.140516)"
2016,Enero,Brasil,76,29,51,,80,"(4.815061,-75.736532)"
2016,Enero,Brasil,76,214,273,,487,"(6.171601,-75.427454)"
2016,Enero,Brasil,76,12,15,,27,"(7.128456,-73.183637)"
2016,Enero,Brasil,76,14,8,,22,"(7.927209,-72.507910)"
2016,Enero,Brunei Darussalam,96,1,0,,1,"(4.697144,-74.140516)"
2016,Enero,Bulgaria,100,0,1,,1,"(3.541112,-76.384584)"
2016,Enero,Bulgaria,100,1,0,,1,"(4.697144,-74.140516)"
2016,Enero,Bután,64,0,1,,1,"(4.697144,-74.140516)"
2016,Enero,Cabo Verde,132,0,1,,1,"(4.697144,-74.140516)"
2016,Enero,Islas Caimán/Territorio Británico de Ultramar,136,1,2,,3,"(10.408582,-75.538003)"
2016,Enero,Islas Caimán/Territorio Británico de Ultramar,136,2,1,,3,"(10.886611,-74.776708)"
2016,Enero,Islas Caimán/Territorio Británico de Ultramar,136,8,7,,15,"(12.586067,-81.702563)"
2016,Enero,Islas Caimán/Territorio Británico de Ultramar,136,1,1,,2,"(3.541112,-76.384584)"
2016,Enero,Islas Caimán/Territorio Británico de Ultramar,136,1,5,,6,"(4.697144,-74.140516)"
2016,Enero,Islas Caimán/Territorio Británico de Ultramar,136,1,1,,2,"(6.171601,-75.427454)"
2016,Enero,Islas Caimán/Territorio Británico de Ultramar,136,0,1,,1,"(7.927209,-72.507910)"
2016,Enero,Camboya,116,1,0,,1,"(4.697144,-74.140516)"
2016,Enero,Camerún,120,2,2,,4,"(4.697144,-74.140516)"
2016,Enero,Canadá,124,138,102,,240,"(10.445761,-75.516429)"
2016,Enero,Canadá,124,119,106,,225,"(10.886611,-74.776708)"
2016,Enero,Canadá,124,17,14,,31,"(12.586067,-81.702563)"
2016,Enero,Canadá,124,272,230,,502,"(3.541112,-76.384584)"
2016,Enero,Canadá,124,2,1,,3,"(4.452882,-75.766298)"
2016,Enero,Canadá,124,3035,2800,,5835,"(4.697144,-74.140516)"
2016,Enero,Canadá,124,38,37,,75,"(4.815061,-75.736532)"
2016,Enero,Canadá,124,679,565,,1244,"(6.171601,-75.427454)"
2016,Enero,Canadá,124,47,37,,84,"(7.128456,-73.183637)"
2016,Enero,Canadá,124,16,17,,33,"(7.927209,-72.507910)"
2016,Enero,Chad,148,1,1,,2,"(4.697144,-74.140516)"
2016,Enero,España,724,14,4,,18,"(10.445761,-75.516429)"
2016,Enero,España,724,37,22,,59,"(10.886611,-74.776708)"
2016,Enero,España,724,3354,2179,,5533,"(3.541112,-76.384584)"
2016,Enero,España,724,10165,7327,,17492,"(4.697144,-74.140516)"
2016,Enero,España,724,32,25,,57,"(4.815061,-75.736532)"
2016,Enero,España,724,1342,821,,2163,"(6.171601,-75.427454)"
2016,Enero,España,724,19,17,,36,"(7.128456,-73.183637)"
2016,Enero,España,724,1,3,,4,"(7.927209,-72.507910)"
2016,Enero,Colombia,170,28,99,,127,"(4.697144,-74.140516)"
2016,Enero,República Del Congo,178,0,1,,1,"(3.541112,-76.384584)"
2016,Enero,República Del Congo,178,1,2,,3,"(4.697144,-74.140516)"
2016,Enero,República Democrática del Congo,180,2,4,,6,"(4.697144,-74.140516)"
2016,Enero,República de Corea,410,0,1,,1,"(3.541112,-76.384584)"
2016,Enero,República de Corea,410,10,17,,27,"(4.697144,-74.140516)"
2016,Enero,República de Corea,410,2,0,,2,"(6.171601,-75.427454)"
2016,Enero,Costa de Marfil,384,0,6,,6,"(10.408582,-75.538003)"
2016,Enero,Costa de Marfil,384,8,12,,20,"(4.697144,-74.140516)"
2016,Enero,Costa Rica,188,0,7,,7,"(10.408582,-75.538003)"
2016,Enero,Costa Rica,188,13,18,,31,"(10.445761,-75.516429)"
2016,Enero,Costa Rica,188,54,49,,103,"(10.886611,-74.776708)"
2016,Enero,Costa Rica,188,7,58,,65,"(12.5744111,-81.703935)"
2016,Enero,Costa Rica,188,20,15,,35,"(12.586067,-81.702563)"
2016,Enero,Costa Rica,188,118,143,,261,"(3.541112,-76.384584)"
2016,Enero,Costa Rica,188,1351,1416,,2767,"(4.697144,-74.140516)"
2016,Enero,Costa Rica,188,59,37,,96,"(4.815061,-75.736532)"
2016,Enero,Costa Rica,188,391,325,,716,"(6.171601,-75.427454)"
2016,Enero,Costa Rica,188,27,14,,41,"(7.128456,-73.183637)"
2016,Enero,Costa Rica,188,7,4,,11,"(7.927209,-72.507910)"
2016,Enero,Croacia,191,2,2,,4,"(4.697144,-74.140516)"
2016,Enero,Cuba,192,8,7,,15,"(10.445761,-75.516429)"
2016,Enero,Cuba,192,20,13,,33,"(10.886611,-74.776708)"
2016,Enero,Cuba,192,1,3,,4,"(12.586067,-81.702563)"
2016,Enero,Cuba,192,30,41,,71,"(3.541112,-76.384584)"
2016,Enero,Cuba,192,1009,995,,2004,"(4.697144,-74.140516)"
2016,Enero,Cuba,192,8,9,,17,"(4.815061,-75.736532)"
2016,Enero,Cuba,192,105,86,,191,"(6.171601,-75.427454)"
2016,Enero,Cuba,192,17,7,,24,"(7.128456,-73.183637)"
2016,Enero,Cuba,192,3,5,,8,"(7.927209,-72.507910)"
2016,Enero,Curazao,99999,6,44,,50,"(4.697144,-74.140516)"
2016,Enero,República Checa,203,0,1,,1,"(3.541112,-76.384584)"
2016,Enero,República Checa,203,7,10,,17,"(4.697144,-74.140516)"
2016,Enero,República Checa,203,0,1,,1,"(6.171601,-75.427454)"
2016,Enero,Chile,152,260,250,,510,"(0.814836,-77.662532)"
2016,Enero,Chile,152,2,5,,7,"(1.813928,-78.763924)"
2016,Enero,Chile,152,14,12,,26,"(10.445761,-75.516429)"
2016,Enero,Chile,152,29,22,,51,"(10.886611,-74.776708)"
2016,Enero,Chile,152,11,10,,21,"(12.586067,-81.702563)"
2016,Enero,Chile,152,495,352,,847,"(3.541112,-76.384584)"
2016,Enero,Chile,152,6046,4801,,10847,"(4.697144,-74.140516)"
2016,Enero,Chile,152,102,80,,182,"(4.815061,-75.736532)"
2016,Enero,Chile,152,191,192,,383,"(6.171601,-75.427454)"
2016,Enero,Chile,152,13,9,,22,"(7.128456,-73.183637)"
2016,Enero,Chile,152,10,3,,13,"(7.927209,-72.507910)"
2016,Enero,China,156,1,1,,2,"(10.886611,-74.776708)"
2016,Enero,China,156,6,12,,18,"(3.541112,-76.384584)"
2016,Enero,China,156,91,232,,323,"(4.697144,-74.140516)"
2016,Enero,China,156,6,25,,31,"(6.171601,-75.427454)"
2016,Enero,China,156,1,0,,1,"(7.927209,-72.507910)"
2016,Enero,Chipre,196,1,0,,1,"(4.697144,-74.140516)"
2016,Enero,Dinamarca,208,4,3,,7,"(3.541112,-76.384584)"
2016,Enero,Dinamarca,208,45,38,,83,"(4.697144,-74.140516)"
2016,Enero,Dinamarca,208,3,0,,3,"(6.171601,-75.427454)"
2016,Enero,Dominica,212,32,22,,54,"(4.697144,-74.140516)"
2016,Enero,Dominica,212,0,1,,1,"(6.171601,-75.427454)"
2016,Enero,Ecuador,218,719,1231,,1950,"(0.25129,-76.875963)"
2016,Enero,Ecuador,218,22,24,,46,"(0.812436,-77.847006)"
2016,Enero,Ecuador,218,14086,15891,,29977,"(0.814836,-77.662532)"
2016,Enero,Ecuador,218,177,189,,366,"(1.813928,-78.763924)"
2016,Enero,Ecuador,218,0,13,,13,"(10.408582,-75.538003)"
2016,Enero,Ecuador,218,3,4,,7,"(10.445761,-75.516429)"
2016,Enero,Ecuador,218,8,7,,15,"(10.886611,-74.776708)"
2016,Enero,Ecuador,218,1,0,,1,"(12.586067,-81.702563)"
2016,Enero,Ecuador,218,499,583,,1082,"(3.541112,-76.384584)"
2016,Enero,Ecuador,218,3195,4389,,7584,"(4.697144,-74.140516)"
2016,Enero,Ecuador,218,3,5,,8,"(4.815061,-75.736532)"
2016,Enero,Ecuador,218,69,96,,165,"(6.171601,-75.427454)"
2016,Enero,Ecuador,218,2,6,,8,"(7.128456,-73.183637)"
2016,Enero,Egipto,818,1,0,,1,"(10.886611,-74.776708)"
2016,Enero,Egipto,818,1,0,,1,"(3.541112,-76.384584)"
2016,Enero,Egipto,818,4,10,,14,"(4.697144,-74.140516)"
2016,Enero,Egipto,818,0,1,,1,"(6.171601,-75.427454)"
2016,Enero,El Salvador,222,0,10,,10,"(10.408582,-75.538003)"
2016,Enero,El Salvador,222,0,3,,3,"(10.886611,-74.776708)"
2016,Enero,El Salvador,222,0,2,,2,"(12.586067,-81.702563)"
2016,Enero,El Salvador,222,87,97,,184,"(3.541112,-76.384584)"
2016,Enero,El Salvador,222,652,861,,1513,"(4.697144,-74.140516)"
2016,Enero,El Salvador,222,3,5,,8,"(4.815061,-75.736532)"
2016,Enero,El Salvador,222,68,111,,179,"(6.171601,-75.427454)"
2016,Enero,El Salvador,222,1,2,,3,"(7.128456,-73.183637)"
2016,Enero,Emiratos Árabes,784,0,1,,1,"(12.586067,-81.702563)"
2016,Enero,Emiratos Árabes,784,6,4,,10,"(3.541112,-76.384584)"
2016,Enero,Emiratos Árabes,784,123,324,,447,"(4.697144,-74.140516)"
2016,Enero,Emiratos Árabes,784,6,13,,19,"(6.171601,-75.427454)"
2016,Enero,Eslovaquia,703,4,2,,6,"(4.697144,-74.140516)"
2016,Enero,Eslovenia,705,0,2,,2,"(4.697144,-74.140516)"
2016,Enero,Estados Unidos de América,840,3977,3377,,7354,"(10.445761,-75.516429)"
2016,Enero,Estados Unidos de América,840,3011,2377,,5388,"(10.886611,-74.776708)"
2016,Enero,Estados Unidos de América,840,0,2,,2,"(11.117806,-74.232622)"
2016,Enero,Estados Unidos de América,840,1,1,,2,"(11.247723,-74.213989)"
2016,Enero,Estados Unidos de América,840,49,56,,105,"(12.586067,-81.702563)"
2016,Enero,Estados Unidos de América,840,6117,4687,,10804,"(3.541112,-76.384584)"
2016,Enero,Estados Unidos de América,840,625,523,,1148,"(4.452882,-75.766298)"
2016,Enero,Estados Unidos de América,840,36751,32700,,69451,"(4.697144,-74.140516)"
2016,Enero,Estados Unidos de América,840,1232,930,,2162,"(4.815061,-75.736532)"
2016,Enero,Estados Unidos de América,840,12216,10055,,22271,"(6.171601,-75.427454)"
2016,Enero,Estados Unidos de América,840,274,218,,492,"(7.128456,-73.183637)"
2016,Enero,Estados Unidos de América,840,69,54,,123,"(7.927209,-72.507910)"
2016,Enero,Estonia,233,1,2,,3,"(4.697144,-74.140516)"
2016,Enero,Etiopia,231,2,9,,11,"(4.697144,-74.140516)"
2016,Enero,Islas Fiji,242,0,1,,1,"(4.697144,-74.140516)"
2016,Enero,Filipinas,608,1,0,,1,"(10.886611,-74.776708)"
2016,Enero,Filipinas,608,3,7,,10,"(4.697144,-74.140516)"
2016,Enero,Filipinas,608,0,1,,1,"(6.171601,-75.427454)"
2016,Enero,Finlandia,246,1,1,,2,"(3.541112,-76.384584)"
2016,Enero,Finlandia,246,24,9,,33,"(4.697144,-74.140516)"
2016,Enero,Finlandia,246,0,1,,1,"(6.171601,-75.427454)"
2016,Enero,Francia,250,4,1,,5,"(10.445761,-75.516429)"
2016,Enero,Francia,250,22,16,,38,"(10.886611,-74.776708)"
2016,Enero,Francia,250,122,102,,224,"(3.541112,-76.384584)"
2016,Enero,Francia,250,1530,1228,,2758,"(4.697144,-74.140516)"
2016,Enero,Francia,250,5,5,,10,"(4.815061,-75.736532)"
2016,Enero,Francia,250,81,60,,141,"(6.171601,-75.427454)"
2016,Enero,Francia,250,1,1,,2,"(7.128456,-73.183637)"
2016,Enero,Gabón,266,1,0,,1,"(4.697144,-74.140516)"
2016,Enero,Ghana,288,3,3,,6,"(4.697144,-74.140516)"
2016,Enero,Gibraltar/Territorio Británico de Ultramar,292,6,3,,9,"(0.814836,-77.662532)"
2016,Enero,Gibraltar/Territorio Británico de Ultramar,292,0,1,,1,"(4.697144,-74.140516)"
2016,Enero,Gibraltar/Territorio Británico de Ultramar,292,1,0,,1,"(6.171601,-75.427454)"
2016,Enero,Grecia,300,0,6,,6,"(3.541112,-76.384584)"
2016,Enero,Grecia,300,11,4,,15,"(4.697144,-74.140516)"
2016,Enero,Guatemala,320,3,9,,12,"(10.445761,-75.516429)"
2016,Enero,Guatemala,320,9,19,,28,"(10.886611,-74.776708)"
2016,Enero,Guatemala,320,1,0,,1,"(12.5744111,-81.703935)"
2016,Enero,Guatemala,320,6,12,,18,"(12.586067,-81.702563)"
2016,Enero,Guatemala,320,1,0,,1,"(13.3387613,-81.372937)"
2016,Enero,Guatemala,320,90,93,,183,"(3.541112,-76.384584)"
2016,Enero,Guatemala,320,610,754,,1364,"(4.697144,-74.140516)"
2016,Enero,Guatemala,320,25,33,,58,"(4.815061,-75.736532)"
2016,Enero,Guatemala,320,143,151,,294,"(6.171601,-75.427454)"
2016,Enero,Guatemala,320,17,9,,26,"(7.128456,-73.183637)"
2016,Enero,Guatemala,320,3,5,,8,"(7.927209,-72.507910)"
2016,Enero,Guyana,328,0,1,,1,"(10.408582,-75.538003)"
2016,Enero,Guyana,328,5,10,,15,"(10.886611,-74.776708)"
2016,Enero,Guyana,328,3,0,,3,"(3.541112,-76.384584)"
2016,Enero,Guyana,328,1,3,,4,"(4.697144,-74.140516)"
2016,Enero,Guyana,328,1,0,,1,"(6.171601,-75.427454)"
2016,Enero,Guinea,324,1,0,,1,"(0.814836,-77.662532)"
2016,Enero,Guinea,324,1,1,,2,"(4.697144,-74.140516)"
2016,Enero,Guinea Ecuatorial,226,0,1,,1,"(3.541112,-76.384584)"
2016,Enero,Guinea Ecuatorial,226,8,13,,21,"(4.697144,-74.140516)"
2016,Enero,Guinea Ecuatorial,226,0,1,,1,"(6.171601,-75.427454)"
2016,Enero,Guinea Bissau,624,0,2,,2,"(4.697144,-74.140516)"
2016,Enero,Guadalupe/Territorio Francés,312,3,2,,5,"(4.697144,-74.140516)"
2016,Enero,Guayana Francesa/Departamento de Ultramar Francés,254,0,1,,1,"(10.886611,-74.776708)"
2016,Enero,Guayana Francesa/Departamento de Ultramar Francés,254,1,1,,2,"(3.541112,-76.384584)"
2016,Enero,Guayana Francesa/Departamento de Ultramar Francés,254,0,1,,1,"(4.697144,-74.140516)"
2016,Enero,Guayana Francesa/Departamento de Ultramar Francés,254,0,2,,2,"(6.171601,-75.427454)"
2016,Enero,Haití,332,0,1,,1,"(10.408582,-75.538003)"
2016,Enero,Haití,332,2,0,,2,"(10.445761,-75.516429)"
2016,Enero,Haití,332,0,3,,3,"(10.886611,-74.776708)"
2016,Enero,Haití,332,2,2,,4,"(3.541112,-76.384584)"
2016,Enero,Haití,332,4,13,,17,"(4.697144,-74.140516)"
2016,Enero,Haití,332,4,7,,11,"(6.171601,-75.427454)"
2016,Enero,Honduras,340,2,5,,7,"(10.445761,-75.516429)"
2016,Enero,Honduras,340,4,6,,10,"(10.886611,-74.776708)"
2016,Enero,Honduras,340,1,3,,4,"(12.586067,-81.702563)"
2016,Enero,Honduras,340,24,46,,70,"(3.541112,-76.384584)"
2016,Enero,Honduras,340,111,162,,273,"(4.697144,-74.140516)"
2016,Enero,Honduras,340,2,7,,9,"(4.815061,-75.736532)"
2016,Enero,Honduras,340,41,101,,142,"(6.171601,-75.427454)"
2016,Enero,Honduras,340,3,4,,7,"(7.128456,-73.183637)"
2016,Enero,Honduras,340,3,2,,5,"(7.927209,-72.507910)"
2016,Enero,Hong Kong,344,2,3,,5,"(3.541112,-76.384584)"
2016,Enero,Hong Kong,344,28,47,,75,"(4.697144,-74.140516)"
2016,Enero,Hong Kong,344,1,0,,1,"(4.815061,-75.736532)"
2016,Enero,Hong Kong,344,5,6,,11,"(6.171601,-75.427454)"
2016,Enero,Hong Kong,344,1,0,,1,"(7.927209,-72.507910)"
2016,Enero,Hungría,348,4,8,,12,"(4.697144,-74.140516)"
2016,Enero,India,356,40,31,,71,"(4.697144,-74.140516)"
2016,Enero,India,356,6,8,,14,"(6.171601,-75.427454)"
2016,Enero,India,356,0,1,,1,"(7.128456,-73.183637)"
2016,Enero,Indonesia,360,8,18,,26,"(4.697144,-74.140516)"
2016,Enero,Iraq,368,0,3,,3,"(10.408582,-75.538003)"
2016,Enero,Iraq,368,0,10,,10,"(4.697144,-74.140516)"
2016,Enero,Irán,364,0,2,,2,"(4.697144,-74.140516)"
2016,Enero,Irán,364,0,1,,1,"(6.171601,-75.427454)"
2016,Enero,República de Irlanda,372,3,1,,4,"(10.886611,-74.776708)"
2016,Enero,República de Irlanda,372,2,4,,6,"(3.541112,-76.384584)"
2016,Enero,República de Irlanda,372,19,18,,37,"(4.697144,-74.140516)"
2016,Enero,República de Irlanda,372,4,1,,5,"(6.171601,-75.427454)"
2016,Enero,Islandia,352,1,0,,1,"(10.445761,-75.516429)"
2016,Enero,Islandia,352,2,0,,2,"(4.697144,-74.140516)"
2016,Enero,Islandia,352,1,0,,1,"(6.171601,-75.427454)"
2016,Enero,Israel,376,1,0,,1,"(10.886611,-74.776708)"
2016,Enero,Israel,376,16,9,,25,"(3.541112,-76.384584)"
2016,Enero,Israel,376,105,61,,166,"(4.697144,-74.140516)"
2016,Enero,Israel,376,8,1,,9,"(6.171601,-75.427454)"
2016,Enero,Italia,380,11,4,,15,"(10.445761,-75.516429)"
2016,Enero,Italia,380,13,5,,18,"(10.886611,-74.776708)"
2016,Enero,Italia,380,233,103,,336,"(3.541112,-76.384584)"
2016,Enero,Italia,380,878,493,,1371,"(4.697144,-74.140516)"
2016,Enero,Italia,380,2,1,,3,"(4.815061,-75.736532)"
2016,Enero,Italia,380,81,48,,129,"(6.171601,-75.427454)"
2016,Enero,Italia,380,4,0,,4,"(7.128456,-73.183637)"
2016,Enero,Jamaica,388,0,4,,4,"(10.445761,-75.516429)"
2016,Enero,Jamaica,388,3,5,,8,"(10.886611,-74.776708)"
2016,Enero,Jamaica,388,1,1,,2,"(12.586067,-81.702563)"
2016,Enero,Jamaica,388,7,6,,13,"(3.541112,-76.384584)"
2016,Enero,Jamaica,388,11,17,,28,"(4.697144,-74.140516)"
2016,Enero,Jamaica,388,4,1,,5,"(4.815061,-75.736532)"
2016,Enero,Jamaica,388,20,19,,39,"(6.171601,-75.427454)"
2016,Enero,Jamaica,388,0,3,,3,"(7.927209,-72.507910)"
2016,Enero,Japón,392,5,2,,7,"(3.541112,-76.384584)"
2016,Enero,Japón,392,61,61,,122,"(4.697144,-74.140516)"
2016,Enero,Japón,392,7,6,,13,"(6.171601,-75.427454)"
2016,Enero,Jordania,400,2,5,,7,"(4.697144,-74.140516)"
2016,Enero,Jordania,400,1,0,,1,"(6.171601,-75.427454)"
2016,Enero,Kazajistán,398,0,1,,1,"(4.697144,-74.140516)"
2016,Enero,Kenia,404,4,6,,10,"(4.697144,-74.140516)"
2016,Enero,Kenia,404,1,1,,2,"(6.171601,-75.427454)"
2016,Enero,Kirguistán,417,2,0,,2,"(4.697144,-74.140516)"
2016,Enero,Kuwait,414,6,4,,10,"(4.697144,-74.140516)"
2016,Enero,Kuwait,414,0,1,,1,"(4.815061,-75.736532)"
2016,Enero,Kuwait,414,0,1,,1,"(7.128456,-73.183637)"
2016,Enero,República Democrática Popular  Lao,418,0,1,,1,"(4.697144,-74.140516)"
2016,Enero,Lesoto,426,0,1,,1,"(4.697144,-74.140516)"
2016,Enero,Letonia,428,1,0,,1,"(4.697144,-74.140516)"
2016,Enero,Líbano,422,15,26,,41,"(4.697144,-74.140516)"
2016,Enero,Libia,434,1,0,,1,"(4.697144,-74.140516)"
2016,Enero,Liechtenstein,438,1,0,,1,"(6.171601,-75.427454)"
2016,Enero,Luxemburgo,442,0,1,,1,"(3.541112,-76.384584)"
2016,Enero,Luxemburgo,442,3,7,,10,"(4.697144,-74.140516)"
2016,Enero,Macao,446,1,0,,1,"(4.697144,-74.140516)"
2016,Enero,Malasia,458,0,1,,1,"(3.541112,-76.384584)"
2016,Enero,Malasia,458,10,18,,28,"(4.697144,-74.140516)"
2016,Enero,Malasia,458,3,2,,5,"(6.171601,-75.427454)"
2016,Enero,Malawi,454,0,1,,1,"(4.697144,-74.140516)"
2016,Enero,Malí,466,2,1,,3,"(4.697144,-74.140516)"
2016,Enero,Malta,470,1,0,,1,"(3.541112,-76.384584)"
2016,Enero,Malta,470,22,13,,35,"(4.697144,-74.140516)"
2016,Enero,Malta,470,1,0,,1,"(6.171601,-75.427454)"
2016,Enero,Marruecos,504,3,6,,9,"(4.697144,-74.140516)"
2016,Enero,Marruecos,504,2,1,,3,"(6.171601,-75.427454)"
2016,Enero,Mauritania,478,0,2,,2,"(4.697144,-74.140516)"
2016,Enero,Martinica/Departamento de Ultramar Francés,474,1,0,,1,"(4.697144,-74.140516)"
2016,Enero,México,484,65,45,,110,"(10.445761,-75.516429)"
2016,Enero,México,484,139,122,,261,"(10.886611,-74.776708)"
2016,Enero,México,484,14,6,,20,"(12.586067,-81.702563)"
2016,Enero,México,484,465,400,,865,"(3.541112,-76.384584)"
2016,Enero,México,484,14524,13006,,27530,"(4.697144,-74.140516)"
2016,Enero,México,484,148,123,,271,"(4.815061,-75.736532)"
2016,Enero,México,484,1986,1587,,3573,"(6.171601,-75.427454)"
2016,Enero,México,484,203,185,,388,"(7.128456,-73.183637)"
2016,Enero,México,484,78,67,,145,"(7.927209,-72.507910)"
2016,Enero,Mónaco,492,1,0,,1,"(4.697144,-74.140516)"
2016,Enero,Mozambique,508,4,3,,7,"(4.697144,-74.140516)"
2016,Enero,Myanmar,104,0,1,,1,"(4.697144,-74.140516)"
2016,Enero,Nauru,520,1,0,,1,"(6.171601,-75.427454)"
2016,Enero,Namibia,516,0,1,,1,"(4.697144,-74.140516)"
2016,Enero,Nicaragua,558,2,6,,8,"(10.445761,-75.516429)"
2016,Enero,Nicaragua,558,7,29,,36,"(10.886611,-74.776708)"
2016,Enero,Nicaragua,558,2,4,,6,"(12.586067,-81.702563)"
2016,Enero,Nicaragua,558,16,37,,53,"(3.541112,-76.384584)"
2016,Enero,Nicaragua,558,48,91,,139,"(4.697144,-74.140516)"
2016,Enero,Nicaragua,558,3,6,,9,"(4.815061,-75.736532)"
2016,Enero,Nicaragua,558,17,58,,75,"(6.171601,-75.427454)"
2016,Enero,Nicaragua,558,3,4,,7,"(7.128456,-73.183637)"
2016,Enero,Nigeria,566,0,1,,1,"(3.541112,-76.384584)"
2016,Enero,Nigeria,566,1,9,,10,"(4.697144,-74.140516)"
2016,Enero,Nigeria,566,0,2,,2,"(6.171601,-75.427454)"
2016,Enero,Níger,562,0,1,,1,"(4.697144,-74.140516)"
2016,Enero,Noruega,578,3,1,,4,"(10.886611,-74.776708)"
2016,Enero,Noruega,578,7,5,,12,"(3.541112,-76.384584)"
2016,Enero,Noruega,578,37,30,,67,"(4.697144,-74.140516)"
2016,Enero,Noruega,578,5,1,,6,"(6.171601,-75.427454)"
2016,Enero,Nueva Zelanda,554,0,1,,1,"(10.886611,-74.776708)"
2016,Enero,Nueva Zelanda,554,1,3,,4,"(3.541112,-76.384584)"
2016,Enero,Nueva Zelanda,554,55,40,,95,"(4.697144,-74.140516)"
2016,Enero,Nueva Zelanda,554,7,3,,10,"(6.171601,-75.427454)"
2016,Enero,Omán,512,2,9,,11,"(4.697144,-74.140516)"
2016,Enero,Papúa Nueva Guinea,598,0,2,,2,"(4.697144,-74.140516)"
2016,Enero,Pakistán,586,1,2,,3,"(4.697144,-74.140516)"
2016,Enero,Panamá,591,18,65,,83,"(10.408582,-75.538003)"
2016,Enero,Panamá,591,671,461,,1132,"(10.445761,-75.516429)"
2016,Enero,Panamá,591,1126,947,,2073,"(10.886611,-74.776708)"
2016,Enero,Panamá,591,0,7,,7,"(10.971302,-74.765397)"
2016,Enero,Panamá,591,1,2,,3,"(11.117806,-74.232622)"
2016,Enero,Panamá,591,2,0,,2,"(11.247723,-74.213989)"
2016,Enero,Panamá,591,1,7,,8,"(12.5744111,-81.703935)"
2016,Enero,Panamá,591,212,217,,429,"(12.586067,-81.702563)"
2016,Enero,Panamá,591,0,4,,4,"(13.3387613,-81.372937)"
2016,Enero,Panamá,591,1810,1665,,3475,"(3.541112,-76.384584)"
2016,Enero,Panamá,591,0,1,,1,"(3.893038,-77.067921)"
2016,Enero,Panamá,591,486,359,,845,"(4.452882,-75.766298)"
2016,Enero,Panamá,591,11138,11127,,22265,"(4.697144,-74.140516)"
2016,Enero,Panamá,591,662,459,,1121,"(4.815061,-75.736532)"
2016,Enero,Panamá,591,4657,4491,,9148,"(6.171601,-75.427454)"
2016,Enero,Panamá,591,0,12,,12,"(6.228046,-77.404104)"
2016,Enero,Panamá,591,10,5,,15,"(7.102626,-77.762647)"
2016,Enero,Panamá,591,301,267,,568,"(7.128456,-73.183637)"
2016,Enero,Panamá,591,145,136,,281,"(7.927209,-72.507910)"
2016,Enero,Panamá,591,0,16,,16,"(8.066966,-76.735404)"
2016,Enero,Panamá,591,55,117,,172,"(8.635765,-77.346578)"
2016,Enero,Paraguay,600,1,0,,1,"(10.445761,-75.516429)"
2016,Enero,Paraguay,600,2,6,,8,"(10.886611,-74.776708)"
2016,Enero,Paraguay,600,1,1,,2,"(12.586067,-81.702563)"
2016,Enero,Paraguay,600,11,25,,36,"(3.541112,-76.384584)"
2016,Enero,Paraguay,600,49,137,,186,"(4.697144,-74.140516)"
2016,Enero,Paraguay,600,5,13,,18,"(4.815061,-75.736532)"
2016,Enero,Paraguay,600,11,14,,25,"(6.171601,-75.427454)"
2016,Enero,Paraguay,600,1,0,,1,"(7.128456,-73.183637)"
2016,Enero,Paraguay,600,1,11,,12,"(7.927209,-72.507910)"
2016,Enero,Perú,604,110,103,,213,"(-4.197703,-69.941278)"
2016,Enero,Perú,604,55,95,,150,"(0.814836,-77.662532)"
2016,Enero,Perú,604,0,2,,2,"(1.813928,-78.763924)"
2016,Enero,Perú,604,3,3,,6,"(10.445761,-75.516429)"
2016,Enero,Perú,604,10,11,,21,"(10.886611,-74.776708)"
2016,Enero,Perú,604,2,1,,3,"(12.586067,-81.702563)"
2016,Enero,Perú,604,258,333,,591,"(3.541112,-76.384584)"
2016,Enero,Perú,604,4811,5665,,10476,"(4.697144,-74.140516)"
2016,Enero,Perú,604,5,7,,12,"(4.815061,-75.736532)"
2016,Enero,Perú,604,315,358,,673,"(6.171601,-75.427454)"
2016,Enero,Perú,604,6,3,,9,"(7.128456,-73.183637)"
2016,Enero,Perú,604,2,1,,3,"(7.927209,-72.507910)"
2016,Enero,Polonia,616,1,0,,1,"(3.541112,-76.384584)"
2016,Enero,Polonia,616,7,11,,18,"(4.697144,-74.140516)"
2016,Enero,Portugal,620,1,0,,1,"(10.886611,-74.776708)"
2016,Enero,Portugal,620,4,8,,12,"(3.541112,-76.384584)"
2016,Enero,Portugal,620,258,192,,450,"(4.697144,-74.140516)"
2016,Enero,Portugal,620,2,3,,5,"(6.171601,-75.427454)"
2016,Enero,Polinesia Francesa/Colectividad de Ultramar Francesa,258,1,0,,1,"(4.697144,-74.140516)"
2016,Enero,Puerto Rico/Territorio de Estados Unidos,630,16,13,,29,"(10.445761,-75.516429)"
2016,Enero,Puerto Rico/Territorio de Estados Unidos,630,35,29,,64,"(10.886611,-74.776708)"
2016,Enero,Puerto Rico/Territorio de Estados Unidos,630,1,0,,1,"(12.586067,-81.702563)"
2016,Enero,Puerto Rico/Territorio de Estados Unidos,630,52,30,,82,"(3.541112,-76.384584)"
2016,Enero,Puerto Rico/Territorio de Estados Unidos,630,671,641,,1312,"(4.697144,-74.140516)"
2016,Enero,Puerto Rico/Territorio de Estados Unidos,630,21,9,,30,"(4.815061,-75.736532)"
2016,Enero,Puerto Rico/Territorio de Estados Unidos,630,69,54,,123,"(6.171601,-75.427454)"
2016,Enero,Puerto Rico/Territorio de Estados Unidos,630,16,16,,32,"(7.128456,-73.183637)"
2016,Enero,Puerto Rico/Territorio de Estados Unidos,630,1,2,,3,"(7.927209,-72.507910)"
2016,Enero,Qatar,634,0,1,,1,"(3.541112,-76.384584)"
2016,Enero,Qatar,634,7,8,,15,"(4.697144,-74.140516)"
2016,Enero,Qatar,634,1,2,,3,"(6.171601,-75.427454)"
2016,Enero,Reino Unido de Gran Bretaña e Irlanda del Norte,826,1,1,,2,"(10.445761,-75.516429)"
2016,Enero,Reino Unido de Gran Bretaña e Irlanda del Norte,826,44,31,,75,"(10.886611,-74.776708)"
2016,Enero,Reino Unido de Gran Bretaña e Irlanda del Norte,826,124,121,,245,"(3.541112,-76.384584)"
2016,Enero,Reino Unido de Gran Bretaña e Irlanda del Norte,826,2456,1955,,4411,"(4.697144,-74.140516)"
2016,Enero,Reino Unido de Gran Bretaña e Irlanda del Norte,826,50,42,,92,"(6.171601,-75.427454)"
2016,Enero,Reino Unido de Gran Bretaña e Irlanda del Norte,826,1,1,,2,"(7.128456,-73.183637)"
2016,Enero,República CentroÁfricana,140,1,1,,2,"(4.697144,-74.140516)"
2016,Enero,Federación de Rusia,643,1,4,,5,"(3.541112,-76.384584)"
2016,Enero,Federación de Rusia,643,15,23,,38,"(4.697144,-74.140516)"
2016,Enero,Federación de Rusia,643,0,1,,1,"(7.128456,-73.183637)"
2016,Enero,República Dominicana,214,2,1,,3,"(10.408582,-75.538003)"
2016,Enero,República Dominicana,214,14,33,,47,"(10.445761,-75.516429)"
2016,Enero,República Dominicana,214,40,41,,81,"(10.886611,-74.776708)"
2016,Enero,República Dominicana,214,15,16,,31,"(11.117806,-74.232622)"
2016,Enero,República Dominicana,214,0,1,,1,"(12.586067,-81.702563)"
2016,Enero,República Dominicana,214,120,76,,196,"(3.541112,-76.384584)"
2016,Enero,República Dominicana,214,3715,3500,,7215,"(4.697144,-74.140516)"
2016,Enero,República Dominicana,214,44,48,,92,"(4.815061,-75.736532)"
2016,Enero,República Dominicana,214,374,276,,650,"(6.171601,-75.427454)"
2016,Enero,República Dominicana,214,82,76,,158,"(7.128456,-73.183637)"
2016,Enero,República Dominicana,214,67,49,,116,"(7.927209,-72.507910)"
2016,Enero,Reunión,638,0,1,,1,"(3.541112,-76.384584)"
2016,Enero,Reunión,638,1,1,,2,"(4.697144,-74.140516)"
2016,Enero,República Democrática Popular de Corea,408,0,2,,2,"(4.697144,-74.140516)"
2016,Enero,Rumania,642,4,2,,6,"(4.697144,-74.140516)"
2016,Enero,Santa Lucia,662,0,2,,2,"(3.541112,-76.384584)"
2016,Enero,Senegal,686,0,1,,1,"(3.541112,-76.384584)"
2016,Enero,Senegal,686,0,1,,1,"(4.697144,-74.140516)"
2016,Enero,Serbia,688,0,3,,3,"(4.697144,-74.140516)"
2016,Enero,Sierra Leona,694,1,0,,1,"(6.171601,-75.427454)"
2016,Enero,Singapur,702,1,0,,1,"(10.886611,-74.776708)"
2016,Enero,Singapur,702,1,0,,1,"(3.541112,-76.384584)"
2016,Enero,Singapur,702,13,21,,34,"(4.697144,-74.140516)"
2016,Enero,Sri Lanka,144,0,1,,1,"(4.697144,-74.140516)"
2016,Enero,Sudáfrica,710,2,1,,3,"(3.541112,-76.384584)"
2016,Enero,Sudáfrica,710,18,21,,39,"(4.697144,-74.140516)"
2016,Enero,Sudáfrica,710,1,0,,1,"(6.171601,-75.427454)"
2016,Enero,Sudán,736,1,2,,3,"(4.697144,-74.140516)"
2016,Enero,Sudán,736,0,1,,1,"(6.171601,-75.427454)"
2016,Enero,Suecia,752,1,0,,1,"(10.445761,-75.516429)"
2016,Enero,Suecia,752,10,8,,18,"(10.886611,-74.776708)"
2016,Enero,Suecia,752,67,60,,127,"(3.541112,-76.384584)"
2016,Enero,Suecia,752,249,186,,435,"(4.697144,-74.140516)"
2016,Enero,Suecia,752,17,18,,35,"(6.171601,-75.427454)"
2016,Enero,Suecia,752,0,2,,2,"(7.128456,-73.183637)"
2016,Enero,Suiza,756,3,1,,4,"(10.445761,-75.516429)"
2016,Enero,Suiza,756,2,2,,4,"(10.886611,-74.776708)"
2016,Enero,Suiza,756,134,72,,206,"(3.541112,-76.384584)"
2016,Enero,Suiza,756,461,283,,744,"(4.697144,-74.140516)"
2016,Enero,Suiza,756,2,0,,2,"(4.815061,-75.736532)"
2016,Enero,Suiza,756,35,21,,56,"(6.171601,-75.427454)"
2016,Enero,Suiza,756,1,1,,2,"(7.128456,-73.183637)"
2016,Enero,Surinam,740,1,1,,2,"(10.886611,-74.776708)"
2016,Enero,Surinam,740,3,6,,9,"(4.697144,-74.140516)"
2016,Enero,Surinam,740,3,1,,4,"(6.171601,-75.427454)"
2016,Enero,Taiwán,158,2,8,,10,"(4.697144,-74.140516)"
2016,Enero,Taiwán,158,0,2,,2,"(6.171601,-75.427454)"
2016,Enero,Tailandia,764,0,1,,1,"(3.541112,-76.384584)"
2016,Enero,Tailandia,764,20,13,,33,"(4.697144,-74.140516)"
2016,Enero,Tailandia,764,1,0,,1,"(6.171601,-75.427454)"
2016,Enero,Trinidad y Tobago,780,6,4,,10,"(10.445761,-75.516429)"
2016,Enero,Trinidad y Tobago,780,2,3,,5,"(10.886611,-74.776708)"
2016,Enero,Trinidad y Tobago,780,12,42,,54,"(3.541112,-76.384584)"
2016,Enero,Trinidad y Tobago,780,26,40,,66,"(4.697144,-74.140516)"
2016,Enero,Trinidad y Tobago,780,3,8,,11,"(4.815061,-75.736532)"
2016,Enero,Trinidad y Tobago,780,18,11,,29,"(6.171601,-75.427454)"
2016,Enero,Trinidad y Tobago,780,5,1,,6,"(7.128456,-73.183637)"
2016,Enero,Trinidad y Tobago,780,5,5,,10,"(7.927209,-72.507910)"
2016,Enero,Túnez,788,1,1,,2,"(4.697144,-74.140516)"
2016,Enero,Turquía,792,2,2,,4,"(3.541112,-76.384584)"
2016,Enero,Turquía,792,17,21,,38,"(4.697144,-74.140516)"
2016,Enero,Turquía,792,3,1,,4,"(6.171601,-75.427454)"
2016,Enero,Ucrania,804,1,1,,2,"(4.697144,-74.140516)"
2016,Enero,Uganda,800,0,2,,2,"(4.697144,-74.140516)"
2016,Enero,Uruguay,858,0,1,,1,"(0.814836,-77.662532)"
2016,Enero,Uruguay,858,1,2,,3,"(10.445761,-75.516429)"
2016,Enero,Uruguay,858,2,1,,3,"(10.886611,-74.776708)"
2016,Enero,Uruguay,858,26,13,,39,"(3.541112,-76.384584)"
2016,Enero,Uruguay,858,112,112,,224,"(4.697144,-74.140516)"
2016,Enero,Uruguay,858,0,6,,6,"(4.815061,-75.736532)"
2016,Enero,Uruguay,858,13,9,,22,"(6.171601,-75.427454)"
2016,Enero,Uruguay,858,0,1,,1,"(7.128456,-73.183637)"
2016,Enero,Venezuela,862,147,86,,233,"(10.445761,-75.516429)"
2016,Enero,Venezuela,862,39,48,,87,"(10.886611,-74.776708)"
2016,Enero,Venezuela,862,72,144,,216,"(11.360009,-72.129330)"
2016,Enero,Venezuela,862,1,3,,4,"(12.586067,-81.702563)"
2016,Enero,Venezuela,862,25,40,,65,"(3.541112,-76.384584)"
2016,Enero,Venezuela,862,4,4,,8,"(3.866713,-67.927521)"
2016,Enero,Venezuela,862,1634,1696,,3330,"(4.697144,-74.140516)"
2016,Enero,Venezuela,862,9,8,,17,"(4.815061,-75.736532)"
2016,Enero,Venezuela,862,666,581,,1247,"(6.171601,-75.427454)"
2016,Enero,Venezuela,862,1,5,,6,"(6.185799,-67.483929)"
2016,Enero,Venezuela,862,15,10,,25,"(7.088729,-70.740253)"
2016,Enero,Venezuela,862,9,19,,28,"(7.128456,-73.183637)"
2016,Enero,Venezuela,862,847,894,,1741,"(7.818934,-72.453226)"
2016,Enero,Venezuela,862,633,533,,1166,"(7.927209,-72.507910)"
2016,Enero,Vietnam,704,1,1,,2,"(4.697144,-74.140516)"
2016,Enero,Vietnam,704,2,1,,3,"(6.171601,-75.427454)"
2016,Enero,Desconocido,99999,1,1,,2,"(0.812436,-77.847006)"
2016,Febrero,Afganistán,4,2,3,,5,"(4.697144,-74.140516)"
2016,Febrero,Afganistán,4,1,1,,2,"(6.171601,-75.427454)"
2016,Febrero,Albania,8,0,2,,2,"(4.697144,-74.140516)"
2016,Febrero,Alemania,276,2,1,,3,"(10.445761,-75.516429)"
2016,Febrero,Alemania,276,1,1,,2,"(10.886611,-74.776708)"
2016,Febrero,Alemania,276,68,40,,108,"(3.541112,-76.384584)"
2016,Febrero,Alemania,276,841,753,,1594,"(4.697144,-74.140516)"
2016,Febrero,Alemania,276,44,28,,72,"(6.171601,-75.427454)"
2016,Febrero,Andorra,20,0,1,,1,"(4.697144,-74.140516)"
2016,Febrero,Angola,24,0,1,,1,"(3.541112,-76.384584)"
2016,Febrero,Angola,24,3,10,,13,"(4.697144,-74.140516)"
2016,Febrero,Antigua y Barbuda,28,1,2,,3,"(10.886611,-74.776708)"
2016,Febrero,Antigua y Barbuda,28,2,0,,2,"(4.697144,-74.140516)"
2016,Febrero,Países Bajos,528,0,3,,3,"(10.445761,-75.516429)"
2016,Febrero,Países Bajos,528,108,78,,186,"(10.886611,-74.776708)"
2016,Febrero,Países Bajos,528,151,90,,241,"(3.541112,-76.384584)"
2016,Febrero,Países Bajos,528,661,619,,1280,"(4.697144,-74.140516)"
2016,Febrero,Países Bajos,528,12,2,,14,"(4.815061,-75.736532)"
2016,Febrero,Países Bajos,528,152,83,,235,"(6.171601,-75.427454)"
2016,Febrero,Países Bajos,528,0,1,,1,"(7.927209,-72.507910)"
2016,Febrero,Arabia Saudita,682,5,36,,41,"(4.697144,-74.140516)"
2016,Febrero,Arabia Saudita,682,0,2,,2,"(6.171601,-75.427454)"
2016,Febrero,Argelia,12,0,2,,2,"(4.697144,-74.140516)"
2016,Febrero,Argentina,32,36,84,,120,"(0.814836,-77.662532)"
2016,Febrero,Argentina,32,10,10,,20,"(10.445761,-75.516429)"
2016,Febrero,Argentina,32,35,32,,67,"(10.886611,-74.776708)"
2016,Febrero,Argentina,32,20,18,,38,"(12.586067,-81.702563)"
2016,Febrero,Argentina,32,120,111,,231,"(3.541112,-76.384584)"
2016,Febrero,Argentina,32,2451,2387,,4838,"(4.697144,-74.140516)"
2016,Febrero,Argentina,32,20,16,,36,"(4.815061,-75.736532)"
2016,Febrero,Argentina,32,130,107,,237,"(6.171601,-75.427454)"
2016,Febrero,Argentina,32,2,2,,4,"(7.128456,-73.183637)"
2016,Febrero,Argentina,32,2,3,,5,"(7.927209,-72.507910)"
2016,Febrero,República de Armenia,51,0,1,,1,"(4.697144,-74.140516)"
2016,Febrero,Aruba,533,701,481,,1182,"(10.408582,-75.538003)"
2016,Febrero,Aruba,533,4,0,,4,"(10.445761,-75.516429)"
2016,Febrero,Aruba,533,30,21,,51,"(10.886611,-74.776708)"
2016,Febrero,Aruba,533,1,0,,1,"(11.247723,-74.213989)"
2016,Febrero,Aruba,533,30,15,,45,"(3.541112,-76.384584)"
2016,Febrero,Aruba,533,1267,1100,,2367,"(4.697144,-74.140516)"
2016,Febrero,Aruba,533,11,7,,18,"(4.815061,-75.736532)"
2016,Febrero,Aruba,533,41,20,,61,"(6.171601,-75.427454)"
2016,Febrero,Aruba,533,17,33,,50,"(7.128456,-73.183637)"
2016,Febrero,Aruba,533,1,1,,2,"(7.927209,-72.507910)"
2016,Febrero,Australia,36,0,1,,1,"(10.445761,-75.516429)"
2016,Febrero,Australia,36,3,3,,6,"(10.886611,-74.776708)"
2016,Febrero,Australia,36,28,19,,47,"(3.541112,-76.384584)"
2016,Febrero,Australia,36,348,263,,611,"(4.697144,-74.140516)"
2016,Febrero,Australia,36,5,7,,12,"(4.815061,-75.736532)"
2016,Febrero,Australia,36,76,63,,139,"(6.171601,-75.427454)"
2016,Febrero,Australia,36,4,0,,4,"(7.128456,-73.183637)"
2016,Febrero,Australia,36,0,1,,1,"(7.927209,-72.507910)"
2016,Febrero,Austria,40,0,1,,1,"(10.445761,-75.516429)"
2016,Febrero,Austria,40,1,3,,4,"(3.541112,-76.384584)"
2016,Febrero,Austria,40,39,37,,76,"(4.697144,-74.140516)"
2016,Febrero,Austria,40,1,0,,1,"(6.171601,-75.427454)"
2016,Febrero,Azerbaiyán,31,2,2,,4,"(4.697144,-74.140516)"
2016,Febrero,Bahamas,44,0,1,,1,"(10.445761,-75.516429)"
2016,Febrero,Bahamas,44,1,0,,1,"(12.586067,-81.702563)"
2016,Febrero,Bahamas,44,8,3,,11,"(3.541112,-76.384584)"
2016,Febrero,Bahamas,44,14,12,,26,"(4.697144,-74.140516)"
2016,Febrero,Bahamas,44,4,2,,6,"(4.815061,-75.736532)"
2016,Febrero,Bahamas,44,8,9,,17,"(6.171601,-75.427454)"
2016,Febrero,Bahréin,48,1,2,,3,"(4.697144,-74.140516)"
2016,Febrero,Barbados,52,1,3,,4,"(3.541112,-76.384584)"
2016,Febrero,Barbados,52,79,73,,152,"(4.697144,-74.140516)"
2016,Febrero,Barbados,52,0,1,,1,"(6.171601,-75.427454)"
2016,Febrero,República de Belarús,112,1,0,,1,"(4.697144,-74.140516)"
2016,Febrero,Bélgica,56,1,0,,1,"(10.886611,-74.776708)"
2016,Febrero,Bélgica,56,23,11,,34,"(3.541112,-76.384584)"
2016,Febrero,Bélgica,56,61,56,,117,"(4.697144,-74.140516)"
2016,Febrero,Bélgica,56,1,0,,1,"(4.815061,-75.736532)"
2016,Febrero,Bélgica,56,17,11,,28,"(6.171601,-75.427454)"
2016,Febrero,Belice,84,1,0,,1,"(3.541112,-76.384584)"
2016,Febrero,Belice,84,5,9,,14,"(4.697144,-74.140516)"
2016,Febrero,Belice,84,4,2,,6,"(6.171601,-75.427454)"
2016,Febrero,Benín,204,1,1,,2,"(4.697144,-74.140516)"
2016,Febrero,Bermudas/Territorio Británico de Ultramar,60,1,1,,2,"(4.697144,-74.140516)"
2016,Febrero,Bolivia,68,6,13,,19,"(0.814836,-77.662532)"
2016,Febrero,Bolivia,68,0,2,,2,"(10.445761,-75.516429)"
2016,Febrero,Bolivia,68,6,2,,8,"(10.886611,-74.776708)"
2016,Febrero,Bolivia,68,31,86,,117,"(3.541112,-76.384584)"
2016,Febrero,Bolivia,68,290,561,,851,"(4.697144,-74.140516)"
2016,Febrero,Bolivia,68,2,4,,6,"(4.815061,-75.736532)"
2016,Febrero,Bolivia,68,23,36,,59,"(6.171601,-75.427454)"
2016,Febrero,Bolivia,68,1,3,,4,"(7.128456,-73.183637)"
2016,Febrero,Bolivia,68,1,2,,3,"(7.927209,-72.507910)"
2016,Febrero,Brasil,76,183,285,,468,"(-4.197703,-69.941278)"
2016,Febrero,Brasil,76,1,1,,2,"(0.814836,-77.662532)"
2016,Febrero,Brasil,76,11,15,,26,"(10.445761,-75.516429)"
2016,Febrero,Brasil,76,22,26,,48,"(10.886611,-74.776708)"
2016,Febrero,Brasil,76,1,10,,11,"(12.586067,-81.702563)"
2016,Febrero,Brasil,76,194,240,,434,"(3.541112,-76.384584)"
2016,Febrero,Brasil,76,2745,3273,,6018,"(4.697144,-74.140516)"
2016,Febrero,Brasil,76,23,60,,83,"(4.815061,-75.736532)"
2016,Febrero,Brasil,76,151,247,,398,"(6.171601,-75.427454)"
2016,Febrero,Brasil,76,27,34,,61,"(7.128456,-73.183637)"
2016,Febrero,Brasil,76,4,12,,16,"(7.927209,-72.507910)"
2016,Febrero,Bulgaria,100,1,0,,1,"(3.541112,-76.384584)"
2016,Febrero,Bulgaria,100,0,1,,1,"(4.697144,-74.140516)"
2016,Febrero,Cabo Verde,132,1,0,,1,"(4.697144,-74.140516)"
2016,Febrero,Islas Caimán/Territorio Británico de Ultramar,136,0,1,,1,"(10.408582,-75.538003)"
2016,Febrero,Islas Caimán/Territorio Británico de Ultramar,136,1,0,,1,"(10.445761,-75.516429)"
2016,Febrero,Islas Caimán/Territorio Británico de Ultramar,136,3,1,,4,"(12.586067,-81.702563)"
2016,Febrero,Islas Caimán/Territorio Británico de Ultramar,136,0,1,,1,"(3.541112,-76.384584)"
2016,Febrero,Camboya,116,3,3,,6,"(4.697144,-74.140516)"
2016,Febrero,Antártida,10,0,1,,1,"(10.886611,-74.776708)"
2016,Febrero,Canadá,124,50,31,,81,"(10.445761,-75.516429)"
2016,Febrero,Canadá,124,49,32,,81,"(10.886611,-74.776708)"
2016,Febrero,Canadá,124,11,10,,21,"(12.586067,-81.702563)"
2016,Febrero,Canadá,124,133,83,,216,"(3.541112,-76.384584)"
2016,Febrero,Canadá,124,2,1,,3,"(4.452882,-75.766298)"
2016,Febrero,Canadá,124,1233,1081,,2314,"(4.697144,-74.140516)"
2016,Febrero,Canadá,124,16,16,,32,"(4.815061,-75.736532)"
2016,Febrero,Canadá,124,239,174,,413,"(6.171601,-75.427454)"
2016,Febrero,Canadá,124,16,12,,28,"(7.128456,-73.183637)"
2016,Febrero,Canadá,124,8,12,,20,"(7.927209,-72.507910)"
2016,Febrero,Chad,148,0,2,,2,"(4.697144,-74.140516)"
2016,Febrero,España,724,4,3,,7,"(10.445761,-75.516429)"
2016,Febrero,España,724,22,15,,37,"(10.886611,-74.776708)"
2016,Febrero,España,724,2936,1849,,4785,"(3.541112,-76.384584)"
2016,Febrero,España,724,7801,5971,,13772,"(4.697144,-74.140516)"
2016,Febrero,España,724,15,8,,23,"(4.815061,-75.736532)"
2016,Febrero,España,724,1108,743,,1851,"(6.171601,-75.427454)"
2016,Febrero,España,724,6,1,,7,"(7.128456,-73.183637)"
2016,Febrero,España,724,1,1,,2,"(7.927209,-72.507910)"
2016,Febrero,Colombia,170,35,129,,164,"(4.697144,-74.140516)"
2016,Febrero,República Democrática del Congo,180,0,1,,1,"(4.697144,-74.140516)"
2016,Febrero,República de Corea,410,1,0,,1,"(10.445761,-75.516429)"
2016,Febrero,República de Corea,410,1,0,,1,"(3.541112,-76.384584)"
2016,Febrero,República de Corea,410,25,24,,49,"(4.697144,-74.140516)"
2016,Febrero,República de Corea,410,0,3,,3,"(6.171601,-75.427454)"
2016,Febrero,Costa de Marfil,384,2,1,,3,"(4.697144,-74.140516)"
2016,Febrero,Costa Rica,188,0,2,,2,"(10.408582,-75.538003)"
2016,Febrero,Costa Rica,188,9,6,,15,"(10.445761,-75.516429)"
2016,Febrero,Costa Rica,188,35,28,,63,"(10.886611,-74.776708)"
2016,Febrero,Costa Rica,188,7,56,,63,"(12.5744111,-81.703935)"
2016,Febrero,Costa Rica,188,8,11,,19,"(12.586067,-81.702563)"
2016,Febrero,Costa Rica,188,68,59,,127,"(3.541112,-76.384584)"
2016,Febrero,Costa Rica,188,822,981,,1803,"(4.697144,-74.140516)"
2016,Febrero,Costa Rica,188,14,19,,33,"(4.815061,-75.736532)"
2016,Febrero,Costa Rica,188,126,126,,252,"(6.171601,-75.427454)"
2016,Febrero,Costa Rica,188,6,11,,17,"(7.128456,-73.183637)"
2016,Febrero,Croacia,191,1,0,,1,"(3.541112,-76.384584)"
2016,Febrero,Croacia,191,3,3,,6,"(4.697144,-74.140516)"
2016,Febrero,Croacia,191,0,1,,1,"(6.171601,-75.427454)"
2016,Febrero,Cuba,192,6,7,,13,"(10.445761,-75.516429)"
2016,Febrero,Cuba,192,18,19,,37,"(10.886611,-74.776708)"
2016,Febrero,Cuba,192,27,53,,80,"(3.541112,-76.384584)"
2016,Febrero,Cuba,192,517,615,,1132,"(4.697144,-74.140516)"
2016,Febrero,Cuba,192,7,9,,16,"(4.815061,-75.736532)"
2016,Febrero,Cuba,192,66,68,,134,"(6.171601,-75.427454)"
2016,Febrero,Cuba,192,2,1,,3,"(7.128456,-73.183637)"
2016,Febrero,Cuba,192,2,3,,5,"(7.927209,-72.507910)"
2016,Febrero,Curazao,99999,9,40,,49,"(4.697144,-74.140516)"
2016,Febrero,República Checa,203,2,5,,7,"(4.697144,-74.140516)"
2016,Febrero,República Checa,203,1,0,,1,"(6.171601,-75.427454)"
2016,Febrero,Chile,152,0,1,,1,"(0.25129,-76.875963)"
2016,Febrero,Chile,152,503,419,,922,"(0.814836,-77.662532)"
2016,Febrero,Chile,152,16,4,,20,"(10.445761,-75.516429)"
2016,Febrero,Chile,152,40,19,,59,"(10.886611,-74.776708)"
2016,Febrero,Chile,152,8,2,,10,"(12.586067,-81.702563)"
2016,Febrero,Chile,152,466,302,,768,"(3.541112,-76.384584)"
2016,Febrero,Chile,152,3121,2514,,5635,"(4.697144,-74.140516)"
2016,Febrero,Chile,152,92,76,,168,"(4.815061,-75.736532)"
2016,Febrero,Chile,152,160,106,,266,"(6.171601,-75.427454)"
2016,Febrero,Chile,152,23,14,,37,"(7.128456,-73.183637)"
2016,Febrero,Chile,152,2,3,,5,"(7.927209,-72.507910)"
2016,Febrero,China,156,0,1,,1,"(10.445761,-75.516429)"
2016,Febrero,China,156,2,3,,5,"(10.886611,-74.776708)"
2016,Febrero,China,156,5,25,,30,"(3.541112,-76.384584)"
2016,Febrero,China,156,130,308,,438,"(4.697144,-74.140516)"
2016,Febrero,China,156,23,48,,71,"(6.171601,-75.427454)"
2016,Febrero,Dinamarca,208,4,0,,4,"(3.541112,-76.384584)"
2016,Febrero,Dinamarca,208,14,20,,34,"(4.697144,-74.140516)"
2016,Febrero,Dinamarca,208,2,0,,2,"(6.171601,-75.427454)"
2016,Febrero,Dominica,212,2,2,,4,"(4.697144,-74.140516)"
2016,Febrero,Ecuador,218,1,4,,5,"(-0.193180,-74.784874)"
2016,Febrero,Ecuador,218,347,594,,941,"(0.25129,-76.875963)"
2016,Febrero,Ecuador,218,14,16,,30,"(0.812436,-77.847006)"
2016,Febrero,Ecuador,218,5965,7495,,13460,"(0.814836,-77.662532)"
2016,Febrero,Ecuador,218,105,149,,254,"(1.813928,-78.763924)"
2016,Febrero,Ecuador,218,0,6,,6,"(10.408582,-75.538003)"
2016,Febrero,Ecuador,218,4,1,,5,"(10.445761,-75.516429)"
2016,Febrero,Ecuador,218,4,6,,10,"(10.886611,-74.776708)"
2016,Febrero,Ecuador,218,231,291,,522,"(3.541112,-76.384584)"
2016,Febrero,Ecuador,218,2287,3971,,6258,"(4.697144,-74.140516)"
2016,Febrero,Ecuador,218,1,1,,2,"(4.815061,-75.736532)"
2016,Febrero,Ecuador,218,52,67,,119,"(6.171601,-75.427454)"
2016,Febrero,Ecuador,218,0,2,,2,"(7.128456,-73.183637)"
2016,Febrero,Ecuador,218,2,0,,2,"(7.927209,-72.507910)"
2016,Febrero,Egipto,818,9,31,,40,"(4.697144,-74.140516)"
2016,Febrero,El Salvador,222,1,0,,1,"(10.445761,-75.516429)"
2016,Febrero,El Salvador,222,0,1,,1,"(10.886611,-74.776708)"
2016,Febrero,El Salvador,222,40,52,,92,"(3.541112,-76.384584)"
2016,Febrero,El Salvador,222,443,722,,1165,"(4.697144,-74.140516)"
2016,Febrero,El Salvador,222,2,1,,3,"(4.815061,-75.736532)"
2016,Febrero,El Salvador,222,54,89,,143,"(6.171601,-75.427454)"
2016,Febrero,El Salvador,222,2,2,,4,"(7.128456,-73.183637)"
2016,Febrero,Emiratos Árabes,784,3,3,,6,"(3.541112,-76.384584)"
2016,Febrero,Emiratos Árabes,784,56,349,,405,"(4.697144,-74.140516)"
2016,Febrero,Emiratos Árabes,784,7,4,,11,"(6.171601,-75.427454)"
2016,Febrero,Eritrea,232,1,0,,1,"(4.697144,-74.140516)"
2016,Febrero,Eslovaquia,703,0,2,,2,"(4.697144,-74.140516)"
2016,Febrero,Eslovenia,705,2,0,,2,"(4.697144,-74.140516)"
2016,Febrero,Estados Unidos de América,840,2812,2351,,5163,"(10.445761,-75.516429)"
2016,Febrero,Estados Unidos de América,840,2413,2038,,4451,"(10.886611,-74.776708)"
2016,Febrero,Estados Unidos de América,840,0,7,,7,"(11.117806,-74.232622)"
2016,Febrero,Estados Unidos de América,840,13,17,,30,"(12.586067,-81.702563)"
2016,Febrero,Estados Unidos de América,840,3600,2685,,6285,"(3.541112,-76.384584)"
2016,Febrero,Estados Unidos de América,840,458,366,,824,"(4.452882,-75.766298)"
2016,Febrero,Estados Unidos de América,840,23084,22057,,45141,"(4.697144,-74.140516)"
2016,Febrero,Estados Unidos de América,840,772,605,,1377,"(4.815061,-75.736532)"
2016,Febrero,Estados Unidos de América,840,7509,6332,,13841,"(6.171601,-75.427454)"
2016,Febrero,Estados Unidos de América,840,95,54,,149,"(7.128456,-73.183637)"
2016,Febrero,Estados Unidos de América,840,29,25,,54,"(7.927209,-72.507910)"
2016,Febrero,Estonia,233,1,0,,1,"(4.697144,-74.140516)"
2016,Febrero,Etiopia,231,1,2,,3,"(4.697144,-74.140516)"
2016,Febrero,Filipinas,608,2,7,,9,"(4.697144,-74.140516)"
2016,Febrero,Filipinas,608,1,0,,1,"(6.171601,-75.427454)"
2016,Febrero,Finlandia,246,0,1,,1,"(10.886611,-74.776708)"
2016,Febrero,Finlandia,246,1,1,,2,"(3.541112,-76.384584)"
2016,Febrero,Finlandia,246,7,5,,12,"(4.697144,-74.140516)"
2016,Febrero,Francia,250,1,0,,1,"(10.445761,-75.516429)"
2016,Febrero,Francia,250,4,1,,5,"(10.886611,-74.776708)"
2016,Febrero,Francia,250,85,55,,140,"(3.541112,-76.384584)"
2016,Febrero,Francia,250,840,772,,1612,"(4.697144,-74.140516)"
2016,Febrero,Francia,250,1,1,,2,"(4.815061,-75.736532)"
2016,Febrero,Francia,250,53,37,,90,"(6.171601,-75.427454)"
2016,Febrero,Gabón,266,0,1,,1,"(4.697144,-74.140516)"
2016,Febrero,Georgia,268,2,1,,3,"(4.697144,-74.140516)"
2016,Febrero,Ghana,288,0,2,,2,"(4.697144,-74.140516)"
2016,Febrero,Gibraltar/Territorio Británico de Ultramar,292,0,1,,1,"(0.814836,-77.662532)"
2016,Febrero,Grecia,300,10,9,,19,"(4.697144,-74.140516)"
2016,Febrero,Grecia,300,2,0,,2,"(6.171601,-75.427454)"
2016,Febrero,Groenlandia,304,1,2,,3,"(4.697144,-74.140516)"
2016,Febrero,Guatemala,320,1,4,,5,"(10.445761,-75.516429)"
2016,Febrero,Guatemala,320,8,7,,15,"(10.886611,-74.776708)"
2016,Febrero,Guatemala,320,1,0,,1,"(12.586067,-81.702563)"
2016,Febrero,Guatemala,320,52,66,,118,"(3.541112,-76.384584)"
2016,Febrero,Guatemala,320,471,702,,1173,"(4.697144,-74.140516)"
2016,Febrero,Guatemala,320,9,15,,24,"(4.815061,-75.736532)"
2016,Febrero,Guatemala,320,59,113,,172,"(6.171601,-75.427454)"
2016,Febrero,Guatemala,320,6,6,,12,"(7.128456,-73.183637)"
2016,Febrero,Guatemala,320,1,3,,4,"(7.927209,-72.507910)"
2016,Febrero,Guyana,328,2,1,,3,"(10.445761,-75.516429)"
2016,Febrero,Guyana,328,1,0,,1,"(3.541112,-76.384584)"
2016,Febrero,Guyana,328,0,1,,1,"(4.697144,-74.140516)"
2016,Febrero,Guyana,328,0,1,,1,"(6.171601,-75.427454)"
2016,Febrero,Guyana,328,0,1,,1,"(7.128456,-73.183637)"
2016,Febrero,Guinea,324,2,0,,2,"(0.814836,-77.662532)"
2016,Febrero,Guinea Ecuatorial,226,0,4,,4,"(3.541112,-76.384584)"
2016,Febrero,Guinea Ecuatorial,226,2,2,,4,"(4.697144,-74.140516)"
2016,Febrero,Guadalupe/Territorio Francés,312,1,1,,2,"(4.697144,-74.140516)"
2016,Febrero,Guadalupe/Territorio Francés,312,1,0,,1,"(6.171601,-75.427454)"
2016,Febrero,Guayana Francesa/Departamento de Ultramar Francés,254,0,1,,1,"(4.697144,-74.140516)"
2016,Febrero,Haití,332,2,0,,2,"(10.445761,-75.516429)"
2016,Febrero,Haití,332,1,7,,8,"(10.886611,-74.776708)"
2016,Febrero,Haití,332,0,2,,2,"(3.541112,-76.384584)"
2016,Febrero,Haití,332,5,4,,9,"(4.697144,-74.140516)"
2016,Febrero,Haití,332,4,8,,12,"(6.171601,-75.427454)"
2016,Febrero,Honduras,340,0,5,,5,"(10.445761,-75.516429)"
2016,Febrero,Honduras,340,2,4,,6,"(10.886611,-74.776708)"
2016,Febrero,Honduras,340,14,26,,40,"(3.541112,-76.384584)"
2016,Febrero,Honduras,340,59,130,,189,"(4.697144,-74.140516)"
2016,Febrero,Honduras,340,2,4,,6,"(4.815061,-75.736532)"
2016,Febrero,Honduras,340,18,44,,62,"(6.171601,-75.427454)"
2016,Febrero,Hong Kong,344,27,44,,71,"(4.697144,-74.140516)"
2016,Febrero,Hong Kong,344,0,1,,1,"(4.815061,-75.736532)"
2016,Febrero,Hong Kong,344,4,7,,11,"(6.171601,-75.427454)"
2016,Febrero,Hungría,348,4,3,,7,"(4.697144,-74.140516)"
2016,Febrero,Hungría,348,0,1,,1,"(7.128456,-73.183637)"
2016,Febrero,India,356,0,1,,1,"(10.886611,-74.776708)"
2016,Febrero,India,356,1,3,,4,"(3.541112,-76.384584)"
2016,Febrero,India,356,49,23,,72,"(4.697144,-74.140516)"
2016,Febrero,India,356,2,0,,2,"(4.815061,-75.736532)"
2016,Febrero,India,356,4,13,,17,"(6.171601,-75.427454)"
2016,Febrero,India,356,0,2,,2,"(7.128456,-73.183637)"
2016,Febrero,Indonesia,360,10,5,,15,"(4.697144,-74.140516)"
2016,Febrero,Indonesia,360,1,0,,1,"(6.171601,-75.427454)"
2016,Febrero,Iraq,368,1,4,,5,"(4.697144,-74.140516)"
2016,Febrero,Irán,364,3,5,,8,"(4.697144,-74.140516)"
2016,Febrero,Irán,364,0,3,,3,"(6.171601,-75.427454)"
2016,Febrero,República de Irlanda,372,1,1,,2,"(3.541112,-76.384584)"
2016,Febrero,República de Irlanda,372,8,6,,14,"(4.697144,-74.140516)"
2016,Febrero,Islandia,352,2,2,,4,"(4.697144,-74.140516)"
2016,Febrero,Israel,376,1,0,,1,"(10.445761,-75.516429)"
2016,Febrero,Israel,376,1,0,,1,"(10.886611,-74.776708)"
2016,Febrero,Israel,376,5,7,,12,"(3.541112,-76.384584)"
2016,Febrero,Israel,376,85,110,,195,"(4.697144,-74.140516)"
2016,Febrero,Israel,376,2,3,,5,"(6.171601,-75.427454)"
2016,Febrero,Italia,380,4,1,,5,"(10.445761,-75.516429)"
2016,Febrero,Italia,380,5,2,,7,"(10.886611,-74.776708)"
2016,Febrero,Italia,380,258,131,,389,"(3.541112,-76.384584)"
2016,Febrero,Italia,380,652,410,,1062,"(4.697144,-74.140516)"
2016,Febrero,Italia,380,1,0,,1,"(4.815061,-75.736532)"
2016,Febrero,Italia,380,80,49,,129,"(6.171601,-75.427454)"
2016,Febrero,Italia,380,1,1,,2,"(7.128456,-73.183637)"
2016,Febrero,Jamaica,388,0,8,,8,"(10.408582,-75.538003)"
2016,Febrero,Jamaica,388,0,2,,2,"(10.445761,-75.516429)"
2016,Febrero,Jamaica,388,1,3,,4,"(10.886611,-74.776708)"
2016,Febrero,Jamaica,388,0,1,,1,"(11.247723,-74.213989)"
2016,Febrero,Jamaica,388,3,5,,8,"(3.541112,-76.384584)"
2016,Febrero,Jamaica,388,10,15,,25,"(4.697144,-74.140516)"
2016,Febrero,Jamaica,388,0,4,,4,"(4.815061,-75.736532)"
2016,Febrero,Jamaica,388,3,5,,8,"(6.171601,-75.427454)"
2016,Febrero,Jamaica,388,1,1,,2,"(7.927209,-72.507910)"
2016,Febrero,Japón,392,4,2,,6,"(3.541112,-76.384584)"
2016,Febrero,Japón,392,37,44,,81,"(4.697144,-74.140516)"
2016,Febrero,Japón,392,1,2,,3,"(6.171601,-75.427454)"
2016,Febrero,Jordania,400,1,1,,2,"(4.697144,-74.140516)"
2016,Febrero,Kazajistán,398,0,6,,6,"(4.697144,-74.140516)"
2016,Febrero,Kenia,404,4,1,,5,"(4.697144,-74.140516)"
2016,Febrero,Kuwait,414,0,2,,2,"(4.697144,-74.140516)"
2016,Febrero,República Democrática Popular  Lao,418,1,0,,1,"(4.697144,-74.140516)"
2016,Febrero,Líbano,422,1,1,,2,"(10.886611,-74.776708)"
2016,Febrero,Líbano,422,0,1,,1,"(3.541112,-76.384584)"
2016,Febrero,Líbano,422,9,24,,33,"(4.697144,-74.140516)"
2016,Febrero,Luxemburgo,442,2,0,,2,"(3.541112,-76.384584)"
2016,Febrero,Luxemburgo,442,4,2,,6,"(4.697144,-74.140516)"
2016,Febrero,Luxemburgo,442,1,0,,1,"(6.171601,-75.427454)"
2016,Febrero,Macedonia,807,1,0,,1,"(4.697144,-74.140516)"
2016,Febrero,Madagascar,450,1,0,,1,"(4.697144,-74.140516)"
2016,Febrero,Madagascar,450,0,1,,1,"(6.171601,-75.427454)"
2016,Febrero,Malasia,458,1,0,,1,"(10.886611,-74.776708)"
2016,Febrero,Malasia,458,3,11,,14,"(4.697144,-74.140516)"
2016,Febrero,Malasia,458,0,2,,2,"(6.171601,-75.427454)"
2016,Febrero,Malawi,454,1,0,,1,"(4.697144,-74.140516)"
2016,Febrero,Malí,466,1,0,,1,"(4.697144,-74.140516)"
2016,Febrero,Malta,470,23,10,,33,"(4.697144,-74.140516)"
2016,Febrero,Marruecos,504,1,0,,1,"(3.541112,-76.384584)"
2016,Febrero,Marruecos,504,6,2,,8,"(4.697144,-74.140516)"
2016,Febrero,Mauricio,480,1,1,,2,"(4.697144,-74.140516)"
2016,Febrero,México,484,15,17,,32,"(10.445761,-75.516429)"
2016,Febrero,México,484,78,62,,140,"(10.886611,-74.776708)"
2016,Febrero,México,484,4,2,,6,"(12.586067,-81.702563)"
2016,Febrero,México,484,274,276,,550,"(3.541112,-76.384584)"
2016,Febrero,México,484,8370,8293,,16663,"(4.697144,-74.140516)"
2016,Febrero,México,484,99,76,,175,"(4.815061,-75.736532)"
2016,Febrero,México,484,880,751,,1631,"(6.171601,-75.427454)"
2016,Febrero,México,484,41,41,,82,"(7.128456,-73.183637)"
2016,Febrero,México,484,18,27,,45,"(7.927209,-72.507910)"
2016,Febrero,República de Moldavia,498,1,0,,1,"(4.697144,-74.140516)"
2016,Febrero,Mónaco,492,0,1,,1,"(4.697144,-74.140516)"
2016,Febrero,Mozambique,508,5,1,,6,"(4.697144,-74.140516)"
2016,Febrero,Nepal,524,1,1,,2,"(4.697144,-74.140516)"
2016,Febrero,Nicaragua,558,6,4,,10,"(10.445761,-75.516429)"
2016,Febrero,Nicaragua,558,4,5,,9,"(10.886611,-74.776708)"
2016,Febrero,Nicaragua,558,1,2,,3,"(12.586067,-81.702563)"
2016,Febrero,Nicaragua,558,9,36,,45,"(3.541112,-76.384584)"
2016,Febrero,Nicaragua,558,35,70,,105,"(4.697144,-74.140516)"
2016,Febrero,Nicaragua,558,0,6,,6,"(4.815061,-75.736532)"
2016,Febrero,Nicaragua,558,14,41,,55,"(6.171601,-75.427454)"
2016,Febrero,Nicaragua,558,2,0,,2,"(7.128456,-73.183637)"
2016,Febrero,Nigeria,566,1,0,,1,"(3.541112,-76.384584)"
2016,Febrero,Nigeria,566,1,5,,6,"(4.697144,-74.140516)"
2016,Febrero,Níger,562,0,1,,1,"(4.697144,-74.140516)"
2016,Febrero,Noruega,578,3,0,,3,"(10.886611,-74.776708)"
2016,Febrero,Noruega,578,6,1,,7,"(3.541112,-76.384584)"
2016,Febrero,Noruega,578,19,20,,39,"(4.697144,-74.140516)"
2016,Febrero,Noruega,578,2,3,,5,"(6.171601,-75.427454)"
2016,Febrero,Nueva Zelanda,554,1,1,,2,"(3.541112,-76.384584)"
2016,Febrero,Nueva Zelanda,554,36,29,,65,"(4.697144,-74.140516)"
2016,Febrero,Nueva Zelanda,554,1,0,,1,"(4.815061,-75.736532)"
2016,Febrero,Nueva Zelanda,554,6,6,,12,"(6.171601,-75.427454)"
2016,Febrero,Omán,512,1,0,,1,"(4.697144,-74.140516)"
2016,Febrero,Panamá,591,30,73,,103,"(10.408582,-75.538003)"
2016,Febrero,Panamá,591,318,274,,592,"(10.445761,-75.516429)"
2016,Febrero,Panamá,591,1018,840,,1858,"(10.886611,-74.776708)"
2016,Febrero,Panamá,591,0,3,,3,"(10.971302,-74.765397)"
2016,Febrero,Panamá,591,1,3,,4,"(11.247723,-74.213989)"
2016,Febrero,Panamá,591,2,25,,27,"(12.5744111,-81.703935)"
2016,Febrero,Panamá,591,128,129,,257,"(12.586067,-81.702563)"
2016,Febrero,Panamá,591,1625,1483,,3108,"(3.541112,-76.384584)"
2016,Febrero,Panamá,591,0,5,,5,"(3.893038,-77.067921)"
2016,Febrero,Panamá,591,411,291,,702,"(4.452882,-75.766298)"
2016,Febrero,Panamá,591,7136,7835,,14971,"(4.697144,-74.140516)"
2016,Febrero,Panamá,591,670,492,,1162,"(4.815061,-75.736532)"
2016,Febrero,Panamá,591,3154,3057,,6211,"(6.171601,-75.427454)"
2016,Febrero,Panamá,591,0,4,,4,"(6.228046,-77.404104)"
2016,Febrero,Panamá,591,6,5,,11,"(7.102626,-77.762647)"
2016,Febrero,Panamá,591,180,191,,371,"(7.128456,-73.183637)"
2016,Febrero,Panamá,591,123,138,,261,"(7.927209,-72.507910)"
2016,Febrero,Panamá,591,0,53,,53,"(8.066966,-76.735404)"
2016,Febrero,Panamá,591,24,84,,108,"(8.635765,-77.346578)"
2016,Febrero,Paraguay,600,1,1,,2,"(0.814836,-77.662532)"
2016,Febrero,Paraguay,600,1,0,,1,"(10.445761,-75.516429)"
2016,Febrero,Paraguay,600,0,4,,4,"(10.886611,-74.776708)"
2016,Febrero,Paraguay,600,1,0,,1,"(12.586067,-81.702563)"
2016,Febrero,Paraguay,600,25,45,,70,"(3.541112,-76.384584)"
2016,Febrero,Paraguay,600,50,157,,207,"(4.697144,-74.140516)"
2016,Febrero,Paraguay,600,12,31,,43,"(4.815061,-75.736532)"
2016,Febrero,Paraguay,600,9,19,,28,"(6.171601,-75.427454)"
2016,Febrero,Paraguay,600,5,1,,6,"(7.128456,-73.183637)"
2016,Febrero,Paraguay,600,3,2,,5,"(7.927209,-72.507910)"
2016,Febrero,Perú,604,4,2,,6,"(-0.193180,-74.784874)"
2016,Febrero,Perú,604,95,120,,215,"(-4.197703,-69.941278)"
2016,Febrero,Perú,604,93,110,,203,"(0.814836,-77.662532)"
2016,Febrero,Perú,604,3,3,,6,"(10.445761,-75.516429)"
2016,Febrero,Perú,604,8,7,,15,"(10.886611,-74.776708)"
2016,Febrero,Perú,604,1,4,,5,"(12.586067,-81.702563)"
2016,Febrero,Perú,604,183,275,,458,"(3.541112,-76.384584)"
2016,Febrero,Perú,604,3663,4482,,8145,"(4.697144,-74.140516)"
2016,Febrero,Perú,604,7,7,,14,"(4.815061,-75.736532)"
2016,Febrero,Perú,604,208,305,,513,"(6.171601,-75.427454)"
2016,Febrero,Perú,604,2,1,,3,"(7.128456,-73.183637)"
2016,Febrero,Perú,604,4,0,,4,"(7.927209,-72.507910)"
2016,Febrero,Polonia,616,11,12,,23,"(4.697144,-74.140516)"
2016,Febrero,Portugal,620,12,7,,19,"(3.541112,-76.384584)"
2016,Febrero,Portugal,620,137,200,,337,"(4.697144,-74.140516)"
2016,Febrero,Portugal,620,2,1,,3,"(4.815061,-75.736532)"
2016,Febrero,Portugal,620,6,2,,8,"(6.171601,-75.427454)"
2016,Febrero,Portugal,620,2,2,,4,"(7.927209,-72.507910)"
2016,Febrero,Polinesia Francesa/Colectividad de Ultramar Francesa,258,1,2,,3,"(4.697144,-74.140516)"
2016,Febrero,Puerto Rico/Territorio de Estados Unidos,630,6,4,,10,"(10.445761,-75.516429)"
2016,Febrero,Puerto Rico/Territorio de Estados Unidos,630,16,16,,32,"(10.886611,-74.776708)"
2016,Febrero,Puerto Rico/Territorio de Estados Unidos,630,18,13,,31,"(3.541112,-76.384584)"
2016,Febrero,Puerto Rico/Territorio de Estados Unidos,630,325,342,,667,"(4.697144,-74.140516)"
2016,Febrero,Puerto Rico/Territorio de Estados Unidos,630,8,4,,12,"(4.815061,-75.736532)"
2016,Febrero,Puerto Rico/Territorio de Estados Unidos,630,27,21,,48,"(6.171601,-75.427454)"
2016,Febrero,Puerto Rico/Territorio de Estados Unidos,630,2,2,,4,"(7.128456,-73.183637)"
2016,Febrero,Qatar,634,3,3,,6,"(4.697144,-74.140516)"
2016,Febrero,Reino Unido de Gran Bretaña e Irlanda del Norte,826,1,0,,1,"(10.886611,-74.776708)"
2016,Febrero,Reino Unido de Gran Bretaña e Irlanda del Norte,826,25,14,,39,"(3.541112,-76.384584)"
2016,Febrero,Reino Unido de Gran Bretaña e Irlanda del Norte,826,1319,994,,2313,"(4.697144,-74.140516)"
2016,Febrero,Reino Unido de Gran Bretaña e Irlanda del Norte,826,12,10,,22,"(6.171601,-75.427454)"
2016,Febrero,República CentroÁfricana,140,1,2,,3,"(4.697144,-74.140516)"
2016,Febrero,Federación de Rusia,643,1,0,,1,"(3.541112,-76.384584)"
2016,Febrero,Federación de Rusia,643,21,35,,56,"(4.697144,-74.140516)"
2016,Febrero,Federación de Rusia,643,0,1,,1,"(6.171601,-75.427454)"
2016,Febrero,República Dominicana,214,13,25,,38,"(10.445761,-75.516429)"
2016,Febrero,República Dominicana,214,34,40,,74,"(10.886611,-74.776708)"
2016,Febrero,República Dominicana,214,0,1,,1,"(12.586067,-81.702563)"
2016,Febrero,República Dominicana,214,74,56,,130,"(3.541112,-76.384584)"
2016,Febrero,República Dominicana,214,1679,1687,,3366,"(4.697144,-74.140516)"
2016,Febrero,República Dominicana,214,30,19,,49,"(4.815061,-75.736532)"
2016,Febrero,República Dominicana,214,127,120,,247,"(6.171601,-75.427454)"
2016,Febrero,República Dominicana,214,37,32,,69,"(7.128456,-73.183637)"
2016,Febrero,República Dominicana,214,12,5,,17,"(7.927209,-72.507910)"
2016,Febrero,Reunión,638,1,1,,2,"(4.697144,-74.140516)"
2016,Febrero,Rumania,642,3,4,,7,"(4.697144,-74.140516)"
2016,Febrero,Rwanda,646,1,0,,1,"(4.697144,-74.140516)"
2016,Febrero,Santa Sede/Ciudad del Vaticano,336,0,1,,1,"(6.171601,-75.427454)"
2016,Febrero,Singapur,702,6,8,,14,"(4.697144,-74.140516)"
2016,Febrero,Sudáfrica,710,0,1,,1,"(3.541112,-76.384584)"
2016,Febrero,Sudáfrica,710,6,10,,16,"(4.697144,-74.140516)"
2016,Febrero,Sudáfrica,710,1,1,,2,"(6.171601,-75.427454)"
2016,Febrero,Suecia,752,1,1,,2,"(10.445761,-75.516429)"
2016,Febrero,Suecia,752,3,2,,5,"(10.886611,-74.776708)"
2016,Febrero,Suecia,752,33,23,,56,"(3.541112,-76.384584)"
2016,Febrero,Suecia,752,72,72,,144,"(4.697144,-74.140516)"
2016,Febrero,Suecia,752,1,0,,1,"(4.815061,-75.736532)"
2016,Febrero,Suecia,752,5,3,,8,"(6.171601,-75.427454)"
2016,Febrero,Suiza,756,2,0,,2,"(10.445761,-75.516429)"
2016,Febrero,Suiza,756,2,1,,3,"(10.886611,-74.776708)"
2016,Febrero,Suiza,756,58,35,,93,"(3.541112,-76.384584)"
2016,Febrero,Suiza,756,235,141,,376,"(4.697144,-74.140516)"
2016,Febrero,Suiza,756,2,0,,2,"(4.815061,-75.736532)"
2016,Febrero,Suiza,756,29,19,,48,"(6.171601,-75.427454)"
2016,Febrero,Surinam,740,0,1,,1,"(10.408582,-75.538003)"
2016,Febrero,Surinam,740,4,3,,7,"(4.697144,-74.140516)"
2016,Febrero,Surinam,740,1,3,,4,"(6.171601,-75.427454)"
2016,Febrero,Taiwán,158,4,10,,14,"(4.697144,-74.140516)"
2016,Febrero,Taiwán,158,0,3,,3,"(6.171601,-75.427454)"
2016,Febrero,Taiwán,158,1,1,,2,"(7.128456,-73.183637)"
2016,Febrero,Tailandia,764,0,2,,2,"(3.541112,-76.384584)"
2016,Febrero,Tailandia,764,15,25,,40,"(4.697144,-74.140516)"
2016,Febrero,Tailandia,764,5,3,,8,"(6.171601,-75.427454)"
2016,Febrero,Tanzania,834,0,2,,2,"(4.697144,-74.140516)"
2016,Febrero,Trinidad y Tobago,780,1,3,,4,"(10.445761,-75.516429)"
2016,Febrero,Trinidad y Tobago,780,2,5,,7,"(10.886611,-74.776708)"
2016,Febrero,Trinidad y Tobago,780,8,15,,23,"(3.541112,-76.384584)"
2016,Febrero,Trinidad y Tobago,780,10,20,,30,"(4.697144,-74.140516)"
2016,Febrero,Trinidad y Tobago,780,3,4,,7,"(4.815061,-75.736532)"
2016,Febrero,Trinidad y Tobago,780,5,7,,12,"(6.171601,-75.427454)"
2016,Febrero,Trinidad y Tobago,780,3,6,,9,"(7.128456,-73.183637)"
2016,Febrero,Trinidad y Tobago,780,2,2,,4,"(7.927209,-72.507910)"
2016,Febrero,Túnez,788,0,1,,1,"(4.697144,-74.140516)"
2016,Febrero,Turquía,792,1,1,,2,"(3.541112,-76.384584)"
2016,Febrero,Turquía,792,12,14,,26,"(4.697144,-74.140516)"
2016,Febrero,Turquía,792,7,1,,8,"(6.171601,-75.427454)"
2016,Febrero,Turkmenistán,795,1,0,,1,"(4.697144,-74.140516)"
2016,Febrero,Uganda,800,0,1,,1,"(10.886611,-74.776708)"
2016,Febrero,Uganda,800,1,0,,1,"(4.697144,-74.140516)"
2016,Febrero,Uruguay,858,0,3,,3,"(0.814836,-77.662532)"
2016,Febrero,Uruguay,858,1,2,,3,"(10.445761,-75.516429)"
2016,Febrero,Uruguay,858,3,1,,4,"(10.886611,-74.776708)"
2016,Febrero,Uruguay,858,2,0,,2,"(12.586067,-81.702563)"
2016,Febrero,Uruguay,858,19,33,,52,"(3.541112,-76.384584)"
2016,Febrero,Uruguay,858,66,95,,161,"(4.697144,-74.140516)"
2016,Febrero,Uruguay,858,0,4,,4,"(4.815061,-75.736532)"
2016,Febrero,Uruguay,858,15,25,,40,"(6.171601,-75.427454)"
2016,Febrero,Venezuela,862,10,5,,15,"(10.445761,-75.516429)"
2016,Febrero,Venezuela,862,25,34,,59,"(10.886611,-74.776708)"
2016,Febrero,Venezuela,862,0,2,,2,"(11.117806,-74.232622)"
2016,Febrero,Venezuela,862,62,65,,127,"(11.360009,-72.129330)"
2016,Febrero,Venezuela,862,2,2,,4,"(12.586067,-81.702563)"
2016,Febrero,Venezuela,862,16,32,,48,"(3.541112,-76.384584)"
2016,Febrero,Venezuela,862,7,3,,10,"(3.866713,-67.927521)"
2016,Febrero,Venezuela,862,1007,1350,,2357,"(4.697144,-74.140516)"
2016,Febrero,Venezuela,862,5,5,,10,"(4.815061,-75.736532)"
2016,Febrero,Venezuela,862,169,174,,343,"(6.171601,-75.427454)"
2016,Febrero,Venezuela,862,3,2,,5,"(6.185799,-67.483929)"
2016,Febrero,Venezuela,862,14,23,,37,"(7.088729,-70.740253)"
2016,Febrero,Venezuela,862,9,3,,12,"(7.128456,-73.183637)"
2016,Febrero,Venezuela,862,435,453,,888,"(7.818934,-72.453226)"
2016,Febrero,Venezuela,862,130,95,,225,"(7.927209,-72.507910)"
2016,Febrero,Vietnam,704,1,4,,5,"(4.697144,-74.140516)"
2016,Febrero,Vietnam,704,1,0,,1,"(6.171601,-75.427454)"
2016,Febrero,Islas Vírgenes Británicas/Territorio Británico de Ultramar,92,0,1,,1,"(10.408582,-75.538003)"
2016,Febrero,Islas Vírgenes Británicas/Territorio Británico de Ultramar,92,0,4,,4,"(4.697144,-74.140516)"
2016,Febrero,Zambia,894,1,0,,1,"(4.697144,-74.140516)"
2016,Febrero,Zimbabue,716,2,0,,2,"(4.697144,-74.140516)"
2016,Febrero,Desconocido,99999,0,2,,2,"(11.528919,-72.919681)"
2016,Febrero,Desconocido,99999,0,1,,1,"(4.697144,-74.140516)"
2016,Marzo,Afganistán,4,1,4,,5,"(4.697144,-74.140516)"
2016,Marzo,Alemania,276,2,0,,2,"(0.814836,-77.662532)"
2016,Marzo,Alemania,276,4,1,,5,"(10.445761,-75.516429)"
2016,Marzo,Alemania,276,7,4,,11,"(10.886611,-74.776708)"
2016,Marzo,Alemania,276,108,63,,171,"(3.541112,-76.384584)"
2016,Marzo,Alemania,276,1275,1224,,2499,"(4.697144,-74.140516)"
2016,Marzo,Alemania,276,1,0,,1,"(4.815061,-75.736532)"
2016,Marzo,Alemania,276,54,43,,97,"(6.171601,-75.427454)"
2016,Marzo,Alemania,276,0,1,,1,"(7.128456,-73.183637)"
2016,Marzo,Andorra,20,2,1,,3,"(4.697144,-74.140516)"
2016,Marzo,Angola,24,2,8,,10,"(4.697144,-74.140516)"
2016,Marzo,Antigua y Barbuda,28,2,0,,2,"(4.697144,-74.140516)"
2016,Marzo,Países Bajos,528,11,13,,24,"(10.445761,-75.516429)"
2016,Marzo,Países Bajos,528,124,73,,197,"(10.886611,-74.776708)"
2016,Marzo,Países Bajos,528,180,111,,291,"(3.541112,-76.384584)"
2016,Marzo,Países Bajos,528,814,550,,1364,"(4.697144,-74.140516)"
2016,Marzo,Países Bajos,528,7,3,,10,"(4.815061,-75.736532)"
2016,Marzo,Países Bajos,528,179,110,,289,"(6.171601,-75.427454)"
2016,Marzo,Países Bajos,528,3,3,,6,"(7.128456,-73.183637)"
2016,Marzo,Países Bajos,528,1,1,,2,"(7.927209,-72.507910)"
2016,Marzo,Arabia Saudita,682,1,1,,2,"(3.541112,-76.384584)"
2016,Marzo,Arabia Saudita,682,3,39,,42,"(4.697144,-74.140516)"
2016,Marzo,Arabia Saudita,682,0,2,,2,"(6.171601,-75.427454)"
2016,Marzo,Argelia,12,1,0,,1,"(3.541112,-76.384584)"
2016,Marzo,Argelia,12,3,2,,5,"(4.697144,-74.140516)"
2016,Marzo,Argentina,32,31,56,,87,"(0.814836,-77.662532)"
2016,Marzo,Argentina,32,15,6,,21,"(10.445761,-75.516429)"
2016,Marzo,Argentina,32,34,27,,61,"(10.886611,-74.776708)"
2016,Marzo,Argentina,32,37,23,,60,"(12.586067,-81.702563)"
2016,Marzo,Argentina,32,211,209,,420,"(3.541112,-76.384584)"
2016,Marzo,Argentina,32,3154,2823,,5977,"(4.697144,-74.140516)"
2016,Marzo,Argentina,32,20,16,,36,"(4.815061,-75.736532)"
2016,Marzo,Argentina,32,165,145,,310,"(6.171601,-75.427454)"
2016,Marzo,Argentina,32,6,4,,10,"(7.128456,-73.183637)"
2016,Marzo,Argentina,32,0,3,,3,"(7.927209,-72.507910)"
2016,Marzo,Aruba,533,843,655,,1498,"(10.408582,-75.538003)"
2016,Marzo,Aruba,533,5,1,,6,"(10.445761,-75.516429)"
2016,Marzo,Aruba,533,43,30,,73,"(10.886611,-74.776708)"
2016,Marzo,Aruba,533,0,1,,1,"(11.247723,-74.213989)"
2016,Marzo,Aruba,533,32,20,,52,"(3.541112,-76.384584)"
2016,Marzo,Aruba,533,1653,1267,,2920,"(4.697144,-74.140516)"
2016,Marzo,Aruba,533,11,8,,19,"(4.815061,-75.736532)"
2016,Marzo,Aruba,533,54,45,,99,"(6.171601,-75.427454)"
2016,Marzo,Aruba,533,20,40,,60,"(7.128456,-73.183637)"
2016,Marzo,Aruba,533,1,1,,2,"(7.927209,-72.507910)"
2016,Marzo,Australia,36,2,1,,3,"(10.445761,-75.516429)"
2016,Marzo,Australia,36,3,1,,4,"(10.886611,-74.776708)"
2016,Marzo,Australia,36,19,13,,32,"(3.541112,-76.384584)"
2016,Marzo,Australia,36,239,166,,405,"(4.697144,-74.140516)"
2016,Marzo,Australia,36,2,1,,3,"(4.815061,-75.736532)"
2016,Marzo,Australia,36,53,38,,91,"(6.171601,-75.427454)"
2016,Marzo,Australia,36,0,2,,2,"(7.128456,-73.183637)"
2016,Marzo,Austria,40,1,0,,1,"(10.886611,-74.776708)"
2016,Marzo,Austria,40,3,2,,5,"(3.541112,-76.384584)"
2016,Marzo,Austria,40,29,40,,69,"(4.697144,-74.140516)"
2016,Marzo,Austria,40,4,4,,8,"(6.171601,-75.427454)"
2016,Marzo,Azerbaiyán,31,0,4,,4,"(4.697144,-74.140516)"
2016,Marzo,Bahamas,44,3,2,,5,"(10.445761,-75.516429)"
2016,Marzo,Bahamas,44,7,5,,12,"(10.886611,-74.776708)"
2016,Marzo,Bahamas,44,13,2,,15,"(3.541112,-76.384584)"
2016,Marzo,Bahamas,44,17,19,,36,"(4.697144,-74.140516)"
2016,Marzo,Bahamas,44,1,2,,3,"(4.815061,-75.736532)"
2016,Marzo,Bahamas,44,15,12,,27,"(6.171601,-75.427454)"
2016,Marzo,Bahréin,48,0,1,,1,"(10.408582,-75.538003)"
2016,Marzo,Bahréin,48,1,2,,3,"(4.697144,-74.140516)"
2016,Marzo,Bangladesh,50,3,2,,5,"(3.541112,-76.384584)"
2016,Marzo,Bangladesh,50,0,1,,1,"(4.697144,-74.140516)"
2016,Marzo,Barbados,52,141,134,,275,"(4.697144,-74.140516)"
2016,Marzo,República de Belarús,112,0,1,,1,"(4.697144,-74.140516)"
2016,Marzo,Bélgica,56,14,10,,24,"(3.541112,-76.384584)"
2016,Marzo,Bélgica,56,68,52,,120,"(4.697144,-74.140516)"
2016,Marzo,Bélgica,56,16,3,,19,"(6.171601,-75.427454)"
2016,Marzo,Belice,84,4,4,,8,"(3.541112,-76.384584)"
2016,Marzo,Belice,84,10,10,,20,"(4.697144,-74.140516)"
2016,Marzo,Belice,84,3,4,,7,"(6.171601,-75.427454)"
2016,Marzo,Benín,204,2,2,,4,"(4.697144,-74.140516)"
2016,Marzo,Bolivia,68,1,6,,7,"(0.814836,-77.662532)"
2016,Marzo,Bolivia,68,1,3,,4,"(10.445761,-75.516429)"
2016,Marzo,Bolivia,68,2,8,,10,"(10.886611,-74.776708)"
2016,Marzo,Bolivia,68,2,3,,5,"(12.586067,-81.702563)"
2016,Marzo,Bolivia,68,20,64,,84,"(3.541112,-76.384584)"
2016,Marzo,Bolivia,68,334,670,,1004,"(4.697144,-74.140516)"
2016,Marzo,Bolivia,68,4,11,,15,"(4.815061,-75.736532)"
2016,Marzo,Bolivia,68,28,41,,69,"(6.171601,-75.427454)"
2016,Marzo,Bolivia,68,0,2,,2,"(7.128456,-73.183637)"
2016,Marzo,Bolivia,68,1,0,,1,"(7.927209,-72.507910)"
2016,Marzo,Bosnia y Herzegovina,70,1,2,,3,"(4.697144,-74.140516)"
2016,Marzo,Brasil,76,105,186,,291,"(-4.197703,-69.941278)"
2016,Marzo,Brasil,76,0,6,,6,"(0.814836,-77.662532)"
2016,Marzo,Brasil,76,12,7,,19,"(10.445761,-75.516429)"
2016,Marzo,Brasil,76,30,39,,69,"(10.886611,-74.776708)"
2016,Marzo,Brasil,76,1,0,,1,"(12.586067,-81.702563)"
2016,Marzo,Brasil,76,131,206,,337,"(3.541112,-76.384584)"
2016,Marzo,Brasil,76,3292,3901,,7193,"(4.697144,-74.140516)"
2016,Marzo,Brasil,76,20,43,,63,"(4.815061,-75.736532)"
2016,Marzo,Brasil,76,160,268,,428,"(6.171601,-75.427454)"
2016,Marzo,Brasil,76,12,10,,22,"(7.128456,-73.183637)"
2016,Marzo,Brasil,76,5,2,,7,"(7.927209,-72.507910)"
2016,Marzo,Bulgaria,100,0,2,,2,"(4.697144,-74.140516)"
2016,Marzo,Cabo Verde,132,0,1,,1,"(7.128456,-73.183637)"
2016,Marzo,Islas Caimán/Territorio Británico de Ultramar,136,1,2,,3,"(10.886611,-74.776708)"
2016,Marzo,Islas Caimán/Territorio Británico de Ultramar,136,3,0,,3,"(12.586067,-81.702563)"
2016,Marzo,Islas Caimán/Territorio Británico de Ultramar,136,1,3,,4,"(4.697144,-74.140516)"
2016,Marzo,Camerún,120,2,2,,4,"(4.697144,-74.140516)"
2016,Marzo,Canadá,124,1,0,,1,"(0.814836,-77.662532)"
2016,Marzo,Canadá,124,77,44,,121,"(10.445761,-75.516429)"
2016,Marzo,Canadá,124,46,31,,77,"(10.886611,-74.776708)"
2016,Marzo,Canadá,124,11,5,,16,"(12.586067,-81.702563)"
2016,Marzo,Canadá,124,112,86,,198,"(3.541112,-76.384584)"
2016,Marzo,Canadá,124,0,1,,1,"(4.452882,-75.766298)"
2016,Marzo,Canadá,124,1390,1152,,2542,"(4.697144,-74.140516)"
2016,Marzo,Canadá,124,18,13,,31,"(4.815061,-75.736532)"
2016,Marzo,Canadá,124,264,210,,474,"(6.171601,-75.427454)"
2016,Marzo,Canadá,124,7,3,,10,"(7.128456,-73.183637)"
2016,Marzo,Canadá,124,14,7,,21,"(7.927209,-72.507910)"
2016,Marzo,España,724,7,7,,14,"(10.445761,-75.516429)"
2016,Marzo,España,724,26,16,,42,"(10.886611,-74.776708)"
2016,Marzo,España,724,0,1,,1,"(12.586067,-81.702563)"
2016,Marzo,España,724,3197,2038,,5235,"(3.541112,-76.384584)"
2016,Marzo,España,724,8943,7110,,16053,"(4.697144,-74.140516)"
2016,Marzo,España,724,31,18,,49,"(4.815061,-75.736532)"
2016,Marzo,España,724,1452,999,,2451,"(6.171601,-75.427454)"
2016,Marzo,España,724,9,8,,17,"(7.128456,-73.183637)"
2016,Marzo,España,724,6,6,,12,"(7.927209,-72.507910)"
2016,Marzo,Colombia,170,62,187,,249,"(4.697144,-74.140516)"
2016,Marzo,República Del Congo,178,0,1,,1,"(4.697144,-74.140516)"
2016,Marzo,República de Corea,410,0,1,,1,"(3.541112,-76.384584)"
2016,Marzo,República de Corea,410,11,18,,29,"(4.697144,-74.140516)"
2016,Marzo,Costa de Marfil,384,0,1,,1,"(3.541112,-76.384584)"
2016,Marzo,Costa de Marfil,384,2,1,,3,"(4.697144,-74.140516)"
2016,Marzo,Costa Rica,188,6,9,,15,"(10.445761,-75.516429)"
2016,Marzo,Costa Rica,188,22,28,,50,"(10.886611,-74.776708)"
2016,Marzo,Costa Rica,188,5,35,,40,"(12.5744111,-81.703935)"
2016,Marzo,Costa Rica,188,17,14,,31,"(12.586067,-81.702563)"
2016,Marzo,Costa Rica,188,43,50,,93,"(3.541112,-76.384584)"
2016,Marzo,Costa Rica,188,881,962,,1843,"(4.697144,-74.140516)"
2016,Marzo,Costa Rica,188,24,8,,32,"(4.815061,-75.736532)"
2016,Marzo,Costa Rica,188,125,98,,223,"(6.171601,-75.427454)"
2016,Marzo,Costa Rica,188,5,5,,10,"(7.128456,-73.183637)"
2016,Marzo,Costa Rica,188,4,2,,6,"(7.927209,-72.507910)"
2016,Marzo,Croacia,191,1,0,,1,"(3.541112,-76.384584)"
2016,Marzo,Croacia,191,3,1,,4,"(4.697144,-74.140516)"
2016,Marzo,Cuba,192,14,12,,26,"(10.445761,-75.516429)"
2016,Marzo,Cuba,192,7,12,,19,"(10.886611,-74.776708)"
2016,Marzo,Cuba,192,1,2,,3,"(12.586067,-81.702563)"
2016,Marzo,Cuba,192,69,83,,152,"(3.541112,-76.384584)"
2016,Marzo,Cuba,192,1332,1349,,2681,"(4.697144,-74.140516)"
2016,Marzo,Cuba,192,12,10,,22,"(4.815061,-75.736532)"
2016,Marzo,Cuba,192,248,224,,472,"(6.171601,-75.427454)"
2016,Marzo,Cuba,192,16,8,,24,"(7.128456,-73.183637)"
2016,Marzo,Cuba,192,3,4,,7,"(7.927209,-72.507910)"
2016,Marzo,Curazao,99999,8,31,,39,"(4.697144,-74.140516)"
2016,Marzo,República Checa,203,1,1,,2,"(10.886611,-74.776708)"
2016,Marzo,República Checa,203,0,1,,1,"(3.541112,-76.384584)"
2016,Marzo,República Checa,203,9,7,,16,"(4.697144,-74.140516)"
2016,Marzo,Chile,152,416,401,,817,"(0.814836,-77.662532)"
2016,Marzo,Chile,152,3,0,,3,"(1.813928,-78.763924)"
2016,Marzo,Chile,152,27,14,,41,"(10.445761,-75.516429)"
2016,Marzo,Chile,152,49,43,,92,"(10.886611,-74.776708)"
2016,Marzo,Chile,152,6,4,,10,"(12.586067,-81.702563)"
2016,Marzo,Chile,152,531,343,,874,"(3.541112,-76.384584)"
2016,Marzo,Chile,152,4270,3691,,7961,"(4.697144,-74.140516)"
2016,Marzo,Chile,152,144,92,,236,"(4.815061,-75.736532)"
2016,Marzo,Chile,152,216,167,,383,"(6.171601,-75.427454)"
2016,Marzo,Chile,152,25,15,,40,"(7.128456,-73.183637)"
2016,Marzo,Chile,152,12,6,,18,"(7.927209,-72.507910)"
2016,Marzo,China,156,0,1,,1,"(10.445761,-75.516429)"
2016,Marzo,China,156,2,11,,13,"(10.886611,-74.776708)"
2016,Marzo,China,156,25,67,,92,"(3.541112,-76.384584)"
2016,Marzo,China,156,260,670,,930,"(4.697144,-74.140516)"
2016,Marzo,China,156,33,66,,99,"(6.171601,-75.427454)"
2016,Marzo,China,156,0,1,,1,"(7.927209,-72.507910)"
2016,Marzo,Chipre,196,1,0,,1,"(4.697144,-74.140516)"
2016,Marzo,Dinamarca,208,3,0,,3,"(3.541112,-76.384584)"
2016,Marzo,Dinamarca,208,15,22,,37,"(4.697144,-74.140516)"
2016,Marzo,Dinamarca,208,3,2,,5,"(6.171601,-75.427454)"
2016,Marzo,Dominica,212,0,3,,3,"(6.171601,-75.427454)"
2016,Marzo,Ecuador,218,0,6,,6,"(-0.193180,-74.784874)"
2016,Marzo,Ecuador,218,489,702,,1191,"(0.25129,-76.875963)"
2016,Marzo,Ecuador,218,14,18,,32,"(0.812436,-77.847006)"
2016,Marzo,Ecuador,218,8341,9076,,17417,"(0.814836,-77.662532)"
2016,Marzo,Ecuador,218,161,164,,325,"(1.813928,-78.763924)"
2016,Marzo,Ecuador,218,0,10,,10,"(10.408582,-75.538003)"
2016,Marzo,Ecuador,218,2,3,,5,"(10.445761,-75.516429)"
2016,Marzo,Ecuador,218,6,10,,16,"(10.886611,-74.776708)"
2016,Marzo,Ecuador,218,320,354,,674,"(3.541112,-76.384584)"
2016,Marzo,Ecuador,218,2928,4177,,7105,"(4.697144,-74.140516)"
2016,Marzo,Ecuador,218,0,1,,1,"(4.815061,-75.736532)"
2016,Marzo,Ecuador,218,31,48,,79,"(6.171601,-75.427454)"
2016,Marzo,Ecuador,218,0,3,,3,"(6.228046,-77.404104)"
2016,Marzo,Ecuador,218,4,3,,7,"(7.128456,-73.183637)"
2016,Marzo,Egipto,818,1,1,,2,"(3.541112,-76.384584)"
2016,Marzo,Egipto,818,14,8,,22,"(4.697144,-74.140516)"
2016,Marzo,El Salvador,222,0,2,,2,"(10.445761,-75.516429)"
2016,Marzo,El Salvador,222,0,2,,2,"(10.886611,-74.776708)"
2016,Marzo,El Salvador,222,62,104,,166,"(3.541112,-76.384584)"
2016,Marzo,El Salvador,222,622,882,,1504,"(4.697144,-74.140516)"
2016,Marzo,El Salvador,222,1,0,,1,"(4.815061,-75.736532)"
2016,Marzo,El Salvador,222,60,92,,152,"(6.171601,-75.427454)"
2016,Marzo,Emiratos Árabes,784,0,1,,1,"(10.886611,-74.776708)"
2016,Marzo,Emiratos Árabes,784,7,8,,15,"(3.541112,-76.384584)"
2016,Marzo,Emiratos Árabes,784,78,292,,370,"(4.697144,-74.140516)"
2016,Marzo,Emiratos Árabes,784,0,3,,3,"(4.815061,-75.736532)"
2016,Marzo,Emiratos Árabes,784,8,7,,15,"(6.171601,-75.427454)"
2016,Marzo,Eslovenia,705,1,0,,1,"(6.171601,-75.427454)"
2016,Marzo,Estados Unidos de América,840,1,0,,1,"(10.408582,-75.538003)"
2016,Marzo,Estados Unidos de América,840,3495,2898,,6393,"(10.445761,-75.516429)"
2016,Marzo,Estados Unidos de América,840,2775,2208,,4983,"(10.886611,-74.776708)"
2016,Marzo,Estados Unidos de América,840,0,2,,2,"(11.117806,-74.232622)"
2016,Marzo,Estados Unidos de América,840,28,18,,46,"(12.586067,-81.702563)"
2016,Marzo,Estados Unidos de América,840,4952,3583,,8535,"(3.541112,-76.384584)"
2016,Marzo,Estados Unidos de América,840,584,464,,1048,"(4.452882,-75.766298)"
2016,Marzo,Estados Unidos de América,840,32786,29465,,62251,"(4.697144,-74.140516)"
2016,Marzo,Estados Unidos de América,840,920,740,,1660,"(4.815061,-75.736532)"
2016,Marzo,Estados Unidos de América,840,10323,8738,,19061,"(6.171601,-75.427454)"
2016,Marzo,Estados Unidos de América,840,167,134,,301,"(7.128456,-73.183637)"
2016,Marzo,Estados Unidos de América,840,61,49,,110,"(7.927209,-72.507910)"
2016,Marzo,Estonia,233,1,2,,3,"(4.697144,-74.140516)"
2016,Marzo,Estonia,233,2,0,,2,"(6.171601,-75.427454)"
2016,Marzo,Etiopia,231,0,1,,1,"(4.697144,-74.140516)"
2016,Marzo,Filipinas,608,0,1,,1,"(10.886611,-74.776708)"
2016,Marzo,Filipinas,608,0,1,,1,"(3.541112,-76.384584)"
2016,Marzo,Filipinas,608,1,8,,9,"(4.697144,-74.140516)"
2016,Marzo,Finlandia,246,2,0,,2,"(3.541112,-76.384584)"
2016,Marzo,Finlandia,246,5,2,,7,"(4.697144,-74.140516)"
2016,Marzo,Finlandia,246,1,0,,1,"(6.171601,-75.427454)"
2016,Marzo,Francia,250,1,1,,2,"(10.445761,-75.516429)"
2016,Marzo,Francia,250,0,1,,1,"(10.886611,-74.776708)"
2016,Marzo,Francia,250,115,67,,182,"(3.541112,-76.384584)"
2016,Marzo,Francia,250,1353,1188,,2541,"(4.697144,-74.140516)"
2016,Marzo,Francia,250,0,1,,1,"(4.815061,-75.736532)"
2016,Marzo,Francia,250,73,56,,129,"(6.171601,-75.427454)"
2016,Marzo,Gibraltar/Territorio Británico de Ultramar,292,3,4,,7,"(0.814836,-77.662532)"
2016,Marzo,Grecia,300,15,4,,19,"(4.697144,-74.140516)"
2016,Marzo,Grecia,300,1,1,,2,"(7.128456,-73.183637)"
2016,Marzo,Guatemala,320,4,2,,6,"(10.445761,-75.516429)"
2016,Marzo,Guatemala,320,4,13,,17,"(10.886611,-74.776708)"
2016,Marzo,Guatemala,320,0,1,,1,"(12.586067,-81.702563)"
2016,Marzo,Guatemala,320,61,80,,141,"(3.541112,-76.384584)"
2016,Marzo,Guatemala,320,534,678,,1212,"(4.697144,-74.140516)"
2016,Marzo,Guatemala,320,9,7,,16,"(4.815061,-75.736532)"
2016,Marzo,Guatemala,320,103,129,,232,"(6.171601,-75.427454)"
2016,Marzo,Guatemala,320,6,4,,10,"(7.128456,-73.183637)"
2016,Marzo,Guatemala,320,2,4,,6,"(7.927209,-72.507910)"
2016,Marzo,Guyana,328,0,4,,4,"(10.408582,-75.538003)"
2016,Marzo,Guyana,328,0,1,,1,"(10.886611,-74.776708)"
2016,Marzo,Guyana,328,1,0,,1,"(3.541112,-76.384584)"
2016,Marzo,Guyana,328,3,7,,10,"(4.697144,-74.140516)"
2016,Marzo,Guinea Ecuatorial,226,1,1,,2,"(3.541112,-76.384584)"
2016,Marzo,Guinea Ecuatorial,226,3,2,,5,"(4.697144,-74.140516)"
2016,Marzo,Guinea Bissau,624,0,1,,1,"(4.697144,-74.140516)"
2016,Marzo,Guadalupe/Territorio Francés,312,1,1,,2,"(4.697144,-74.140516)"
2016,Marzo,Guadalupe/Territorio Francés,312,1,0,,1,"(6.171601,-75.427454)"
2016,Marzo,Guayana Francesa/Departamento de Ultramar Francés,254,2,0,,2,"(4.697144,-74.140516)"
2016,Marzo,Guayana Francesa/Departamento de Ultramar Francés,254,0,1,,1,"(6.171601,-75.427454)"
2016,Marzo,Haití,332,0,1,,1,"(10.445761,-75.516429)"
2016,Marzo,Haití,332,2,6,,8,"(10.886611,-74.776708)"
2016,Marzo,Haití,332,0,10,,10,"(3.541112,-76.384584)"
2016,Marzo,Haití,332,6,9,,15,"(4.697144,-74.140516)"
2016,Marzo,Haití,332,4,11,,15,"(6.171601,-75.427454)"
2016,Marzo,Honduras,340,2,3,,5,"(10.445761,-75.516429)"
2016,Marzo,Honduras,340,5,7,,12,"(10.886611,-74.776708)"
2016,Marzo,Honduras,340,0,1,,1,"(12.5744111,-81.703935)"
2016,Marzo,Honduras,340,7,21,,28,"(3.541112,-76.384584)"
2016,Marzo,Honduras,340,79,115,,194,"(4.697144,-74.140516)"
2016,Marzo,Honduras,340,28,48,,76,"(6.171601,-75.427454)"
2016,Marzo,Hong Kong,344,0,1,,1,"(10.886611,-74.776708)"
2016,Marzo,Hong Kong,344,1,2,,3,"(3.541112,-76.384584)"
2016,Marzo,Hong Kong,344,40,69,,109,"(4.697144,-74.140516)"
2016,Marzo,Hong Kong,344,1,2,,3,"(4.815061,-75.736532)"
2016,Marzo,Hong Kong,344,1,0,,1,"(6.171601,-75.427454)"
2016,Marzo,Hungría,348,1,1,,2,"(4.697144,-74.140516)"
2016,Marzo,India,356,2,2,,4,"(3.541112,-76.384584)"
2016,Marzo,India,356,49,32,,81,"(4.697144,-74.140516)"
2016,Marzo,India,356,9,6,,15,"(6.171601,-75.427454)"
2016,Marzo,Indonesia,360,1,2,,3,"(4.697144,-74.140516)"
2016,Marzo,Iraq,368,1,6,,7,"(4.697144,-74.140516)"
2016,Marzo,Irán,364,1,0,,1,"(4.697144,-74.140516)"
2016,Marzo,Irán,364,0,1,,1,"(4.815061,-75.736532)"
2016,Marzo,República de Irlanda,372,1,0,,1,"(3.541112,-76.384584)"
2016,Marzo,República de Irlanda,372,10,3,,13,"(4.697144,-74.140516)"
2016,Marzo,República de Irlanda,372,2,0,,2,"(6.171601,-75.427454)"
2016,Marzo,Islandia,352,0,1,,1,"(3.541112,-76.384584)"
2016,Marzo,Islandia,352,2,0,,2,"(4.697144,-74.140516)"
2016,Marzo,Israel,376,0,1,,1,"(10.445761,-75.516429)"
2016,Marzo,Israel,376,7,5,,12,"(3.541112,-76.384584)"
2016,Marzo,Israel,376,95,72,,167,"(4.697144,-74.140516)"
2016,Marzo,Israel,376,7,0,,7,"(6.171601,-75.427454)"
2016,Marzo,Israel,376,1,0,,1,"(7.128456,-73.183637)"
2016,Marzo,Italia,380,5,3,,8,"(10.445761,-75.516429)"
2016,Marzo,Italia,380,4,1,,5,"(10.886611,-74.776708)"
2016,Marzo,Italia,380,189,96,,285,"(3.541112,-76.384584)"
2016,Marzo,Italia,380,609,379,,988,"(4.697144,-74.140516)"
2016,Marzo,Italia,380,1,0,,1,"(4.815061,-75.736532)"
2016,Marzo,Italia,380,78,33,,111,"(6.171601,-75.427454)"
2016,Marzo,Italia,380,0,1,,1,"(7.927209,-72.507910)"
2016,Marzo,Jamaica,388,4,2,,6,"(10.445761,-75.516429)"
2016,Marzo,Jamaica,388,2,2,,4,"(10.886611,-74.776708)"
2016,Marzo,Jamaica,388,3,3,,6,"(3.541112,-76.384584)"
2016,Marzo,Jamaica,388,14,18,,32,"(4.697144,-74.140516)"
2016,Marzo,Jamaica,388,1,1,,2,"(4.815061,-75.736532)"
2016,Marzo,Jamaica,388,5,4,,9,"(6.171601,-75.427454)"
2016,Marzo,Jamaica,388,1,1,,2,"(7.927209,-72.507910)"
2016,Marzo,Japón,392,6,1,,7,"(3.541112,-76.384584)"
2016,Marzo,Japón,392,54,55,,109,"(4.697144,-74.140516)"
2016,Marzo,Japón,392,11,12,,23,"(6.171601,-75.427454)"
2016,Marzo,Japón,392,1,0,,1,"(7.128456,-73.183637)"
2016,Marzo,Jordania,400,1,0,,1,"(3.541112,-76.384584)"
2016,Marzo,Jordania,400,2,2,,4,"(4.697144,-74.140516)"
2016,Marzo,Kazajistán,398,1,2,,3,"(4.697144,-74.140516)"
2016,Marzo,Kenia,404,1,0,,1,"(10.886611,-74.776708)"
2016,Marzo,Kenia,404,0,1,,1,"(3.541112,-76.384584)"
2016,Marzo,Kenia,404,1,0,,1,"(4.697144,-74.140516)"
2016,Marzo,Kuwait,414,4,6,,10,"(4.697144,-74.140516)"
2016,Marzo,República Democrática Popular  Lao,418,2,1,,3,"(4.697144,-74.140516)"
2016,Marzo,Letonia,428,1,0,,1,"(4.697144,-74.140516)"
2016,Marzo,Lituania,440,0,4,,4,"(4.697144,-74.140516)"
2016,Marzo,Líbano,422,8,16,,24,"(4.697144,-74.140516)"
2016,Marzo,Luxemburgo,442,6,8,,14,"(4.697144,-74.140516)"
2016,Marzo,Luxemburgo,442,1,0,,1,"(6.171601,-75.427454)"
2016,Marzo,Malasia,458,3,5,,8,"(4.697144,-74.140516)"
2016,Marzo,Malí,466,4,1,,5,"(4.697144,-74.140516)"
2016,Marzo,Malta,470,1,0,,1,"(3.541112,-76.384584)"
2016,Marzo,Malta,470,21,11,,32,"(4.697144,-74.140516)"
2016,Marzo,Malta,470,1,1,,2,"(6.171601,-75.427454)"
2016,Marzo,Marruecos,504,10,7,,17,"(4.697144,-74.140516)"
2016,Marzo,Marruecos,504,3,0,,3,"(6.171601,-75.427454)"
2016,Marzo,Mauricio,480,0,1,,1,"(4.697144,-74.140516)"
2016,Marzo,Mauritania,478,0,1,,1,"(4.697144,-74.140516)"
2016,Marzo,México,484,70,47,,117,"(10.445761,-75.516429)"
2016,Marzo,México,484,110,110,,220,"(10.886611,-74.776708)"
2016,Marzo,México,484,3,3,,6,"(12.586067,-81.702563)"
2016,Marzo,México,484,477,400,,877,"(3.541112,-76.384584)"
2016,Marzo,México,484,11060,10174,,21234,"(4.697144,-74.140516)"
2016,Marzo,México,484,104,86,,190,"(4.815061,-75.736532)"
2016,Marzo,México,484,1148,977,,2125,"(6.171601,-75.427454)"
2016,Marzo,México,484,76,61,,137,"(7.128456,-73.183637)"
2016,Marzo,México,484,44,44,,88,"(7.927209,-72.507910)"
2016,Marzo,Mónaco,492,2,1,,3,"(4.697144,-74.140516)"
2016,Marzo,Mozambique,508,1,0,,1,"(4.697144,-74.140516)"
2016,Marzo,Myanmar,104,1,1,,2,"(4.697144,-74.140516)"
2016,Marzo,Namibia,516,1,0,,1,"(4.697144,-74.140516)"
2016,Marzo,Nepal,524,2,1,,3,"(4.697144,-74.140516)"
2016,Marzo,Nicaragua,558,1,2,,3,"(10.445761,-75.516429)"
2016,Marzo,Nicaragua,558,3,3,,6,"(10.886611,-74.776708)"
2016,Marzo,Nicaragua,558,4,4,,8,"(12.586067,-81.702563)"
2016,Marzo,Nicaragua,558,14,24,,38,"(3.541112,-76.384584)"
2016,Marzo,Nicaragua,558,42,59,,101,"(4.697144,-74.140516)"
2016,Marzo,Nicaragua,558,6,7,,13,"(4.815061,-75.736532)"
2016,Marzo,Nicaragua,558,9,40,,49,"(6.171601,-75.427454)"
2016,Marzo,Nicaragua,558,5,2,,7,"(7.927209,-72.507910)"
2016,Marzo,Nigeria,566,0,1,,1,"(3.541112,-76.384584)"
2016,Marzo,Nigeria,566,0,6,,6,"(4.697144,-74.140516)"
2016,Marzo,Noruega,578,0,1,,1,"(10.445761,-75.516429)"
2016,Marzo,Noruega,578,1,0,,1,"(10.886611,-74.776708)"
2016,Marzo,Noruega,578,3,5,,8,"(3.541112,-76.384584)"
2016,Marzo,Noruega,578,21,14,,35,"(4.697144,-74.140516)"
2016,Marzo,Noruega,578,1,0,,1,"(4.815061,-75.736532)"
2016,Marzo,Noruega,578,2,0,,2,"(6.171601,-75.427454)"
2016,Marzo,Nueva Caledonia/Territorio francés,540,1,0,,1,"(6.171601,-75.427454)"
2016,Marzo,Nueva Zelanda,554,26,22,,48,"(4.697144,-74.140516)"
2016,Marzo,Nueva Zelanda,554,2,2,,4,"(6.171601,-75.427454)"
2016,Marzo,Omán,512,2,3,,5,"(4.697144,-74.140516)"
2016,Marzo,Panamá,591,102,150,,252,"(10.408582,-75.538003)"
2016,Marzo,Panamá,591,389,384,,773,"(10.445761,-75.516429)"
2016,Marzo,Panamá,591,875,820,,1695,"(10.886611,-74.776708)"
2016,Marzo,Panamá,591,0,1,,1,"(12.5744111,-81.703935)"
2016,Marzo,Panamá,591,136,125,,261,"(12.586067,-81.702563)"
2016,Marzo,Panamá,591,1392,1334,,2726,"(3.541112,-76.384584)"
2016,Marzo,Panamá,591,333,288,,621,"(4.452882,-75.766298)"
2016,Marzo,Panamá,591,8127,8757,,16884,"(4.697144,-74.140516)"
2016,Marzo,Panamá,591,644,443,,1087,"(4.815061,-75.736532)"
2016,Marzo,Panamá,591,3132,3121,,6253,"(6.171601,-75.427454)"
2016,Marzo,Panamá,591,1,10,,11,"(6.228046,-77.404104)"
2016,Marzo,Panamá,591,5,3,,8,"(7.102626,-77.762647)"
2016,Marzo,Panamá,591,184,212,,396,"(7.128456,-73.183637)"
2016,Marzo,Panamá,591,150,159,,309,"(7.927209,-72.507910)"
2016,Marzo,Panamá,591,0,15,,15,"(8.066966,-76.735404)"
2016,Marzo,Panamá,591,38,92,,130,"(8.635765,-77.346578)"
2016,Marzo,Paraguay,600,2,0,,2,"(10.445761,-75.516429)"
2016,Marzo,Paraguay,600,0,3,,3,"(10.886611,-74.776708)"
2016,Marzo,Paraguay,600,31,41,,72,"(3.541112,-76.384584)"
2016,Marzo,Paraguay,600,75,147,,222,"(4.697144,-74.140516)"
2016,Marzo,Paraguay,600,11,20,,31,"(4.815061,-75.736532)"
2016,Marzo,Paraguay,600,11,15,,26,"(6.171601,-75.427454)"
2016,Marzo,Paraguay,600,0,1,,1,"(7.128456,-73.183637)"
2016,Marzo,Paraguay,600,1,0,,1,"(7.927209,-72.507910)"
2016,Marzo,Perú,604,3,3,,6,"(-0.193180,-74.784874)"
2016,Marzo,Perú,604,60,98,,158,"(-4.197703,-69.941278)"
2016,Marzo,Perú,604,102,118,,220,"(0.814836,-77.662532)"
2016,Marzo,Perú,604,3,3,,6,"(1.813928,-78.763924)"
2016,Marzo,Perú,604,0,1,,1,"(10.408582,-75.538003)"
2016,Marzo,Perú,604,3,9,,12,"(10.445761,-75.516429)"
2016,Marzo,Perú,604,9,5,,14,"(10.886611,-74.776708)"
2016,Marzo,Perú,604,268,285,,553,"(3.541112,-76.384584)"
2016,Marzo,Perú,604,4846,5261,,10107,"(4.697144,-74.140516)"
2016,Marzo,Perú,604,9,5,,14,"(4.815061,-75.736532)"
2016,Marzo,Perú,604,262,365,,627,"(6.171601,-75.427454)"
2016,Marzo,Perú,604,0,2,,2,"(7.128456,-73.183637)"
2016,Marzo,Polonia,616,7,14,,21,"(4.697144,-74.140516)"
2016,Marzo,Polonia,616,0,1,,1,"(6.171601,-75.427454)"
2016,Marzo,Portugal,620,0,1,,1,"(10.886611,-74.776708)"
2016,Marzo,Portugal,620,7,8,,15,"(3.541112,-76.384584)"
2016,Marzo,Portugal,620,233,232,,465,"(4.697144,-74.140516)"
2016,Marzo,Portugal,620,11,7,,18,"(6.171601,-75.427454)"
2016,Marzo,Puerto Rico/Territorio de Estados Unidos,630,5,4,,9,"(10.445761,-75.516429)"
2016,Marzo,Puerto Rico/Territorio de Estados Unidos,630,20,16,,36,"(10.886611,-74.776708)"
2016,Marzo,Puerto Rico/Territorio de Estados Unidos,630,44,34,,78,"(3.541112,-76.384584)"
2016,Marzo,Puerto Rico/Territorio de Estados Unidos,630,521,473,,994,"(4.697144,-74.140516)"
2016,Marzo,Puerto Rico/Territorio de Estados Unidos,630,12,6,,18,"(4.815061,-75.736532)"
2016,Marzo,Puerto Rico/Territorio de Estados Unidos,630,36,29,,65,"(6.171601,-75.427454)"
2016,Marzo,Puerto Rico/Territorio de Estados Unidos,630,2,5,,7,"(7.128456,-73.183637)"
2016,Marzo,Puerto Rico/Territorio de Estados Unidos,630,0,1,,1,"(7.927209,-72.507910)"
2016,Marzo,Qatar,634,1,2,,3,"(3.541112,-76.384584)"
2016,Marzo,Qatar,634,4,5,,9,"(4.697144,-74.140516)"
2016,Marzo,Qatar,634,3,2,,5,"(6.171601,-75.427454)"
2016,Marzo,Reino Unido de Gran Bretaña e Irlanda del Norte,826,1,0,,1,"(10.445761,-75.516429)"
2016,Marzo,Reino Unido de Gran Bretaña e Irlanda del Norte,826,47,29,,76,"(3.541112,-76.384584)"
2016,Marzo,Reino Unido de Gran Bretaña e Irlanda del Norte,826,1494,1186,,2680,"(4.697144,-74.140516)"
2016,Marzo,Reino Unido de Gran Bretaña e Irlanda del Norte,826,13,11,,24,"(6.171601,-75.427454)"
2016,Marzo,República CentroÁfricana,140,1,1,,2,"(4.697144,-74.140516)"
2016,Marzo,Federación de Rusia,643,1,0,,1,"(10.886611,-74.776708)"
2016,Marzo,Federación de Rusia,643,0,1,,1,"(3.541112,-76.384584)"
2016,Marzo,Federación de Rusia,643,37,38,,75,"(4.697144,-74.140516)"
2016,Marzo,República Dominicana,214,23,25,,48,"(10.445761,-75.516429)"
2016,Marzo,República Dominicana,214,33,42,,75,"(10.886611,-74.776708)"
2016,Marzo,República Dominicana,214,2,4,,6,"(12.586067,-81.702563)"
2016,Marzo,República Dominicana,214,106,79,,185,"(3.541112,-76.384584)"
2016,Marzo,República Dominicana,214,2597,2469,,5066,"(4.697144,-74.140516)"
2016,Marzo,República Dominicana,214,28,34,,62,"(4.815061,-75.736532)"
2016,Marzo,República Dominicana,214,188,161,,349,"(6.171601,-75.427454)"
2016,Marzo,República Dominicana,214,12,15,,27,"(7.128456,-73.183637)"
2016,Marzo,República Dominicana,214,19,19,,38,"(7.927209,-72.507910)"
2016,Marzo,Rumania,642,2,4,,6,"(4.697144,-74.140516)"
2016,Marzo,San  Vicente y las Granadinas,670,1,0,,1,"(4.815061,-75.736532)"
2016,Marzo,Santa Lucia,662,1,0,,1,"(10.886611,-74.776708)"
2016,Marzo,Senegal,686,1,1,,2,"(4.697144,-74.140516)"
2016,Marzo,Singapur,702,0,1,,1,"(10.886611,-74.776708)"
2016,Marzo,Singapur,702,1,1,,2,"(3.541112,-76.384584)"
2016,Marzo,Singapur,702,5,13,,18,"(4.697144,-74.140516)"
2016,Marzo,Singapur,702,2,3,,5,"(6.171601,-75.427454)"
2016,Marzo,Sri Lanka,144,0,1,,1,"(4.697144,-74.140516)"
2016,Marzo,Sudáfrica,710,0,1,,1,"(10.886611,-74.776708)"
2016,Marzo,Sudáfrica,710,0,1,,1,"(3.541112,-76.384584)"
2016,Marzo,Sudáfrica,710,19,14,,33,"(4.697144,-74.140516)"
2016,Marzo,Sudáfrica,710,7,8,,15,"(6.171601,-75.427454)"
2016,Marzo,Sudán,736,0,1,,1,"(4.697144,-74.140516)"
2016,Marzo,Sudán,736,0,1,,1,"(6.171601,-75.427454)"
2016,Marzo,Suecia,752,1,0,,1,"(10.445761,-75.516429)"
2016,Marzo,Suecia,752,2,0,,2,"(10.886611,-74.776708)"
2016,Marzo,Suecia,752,12,17,,29,"(3.541112,-76.384584)"
2016,Marzo,Suecia,752,72,62,,134,"(4.697144,-74.140516)"
2016,Marzo,Suecia,752,4,3,,7,"(6.171601,-75.427454)"
2016,Marzo,Suiza,756,0,2,,2,"(10.886611,-74.776708)"
2016,Marzo,Suiza,756,78,30,,108,"(3.541112,-76.384584)"
2016,Marzo,Suiza,756,202,122,,324,"(4.697144,-74.140516)"
2016,Marzo,Suiza,756,12,17,,29,"(6.171601,-75.427454)"
2016,Marzo,Surinam,740,1,0,,1,"(10.886611,-74.776708)"
2016,Marzo,Surinam,740,2,8,,10,"(4.697144,-74.140516)"
2016,Marzo,Surinam,740,2,2,,4,"(6.171601,-75.427454)"
2016,Marzo,Surinam,740,2,3,,5,"(7.128456,-73.183637)"
2016,Marzo,Taiwán,158,4,2,,6,"(4.697144,-74.140516)"
2016,Marzo,Tailandia,764,17,20,,37,"(4.697144,-74.140516)"
2016,Marzo,Tailandia,764,0,2,,2,"(6.171601,-75.427454)"
2016,Marzo,Tanzania,834,0,2,,2,"(4.697144,-74.140516)"
2016,Marzo,Trinidad y Tobago,780,0,1,,1,"(10.445761,-75.516429)"
2016,Marzo,Trinidad y Tobago,780,1,3,,4,"(11.117806,-74.232622)"
2016,Marzo,Trinidad y Tobago,780,7,6,,13,"(3.541112,-76.384584)"
2016,Marzo,Trinidad y Tobago,780,23,45,,68,"(4.697144,-74.140516)"
2016,Marzo,Trinidad y Tobago,780,0,4,,4,"(4.815061,-75.736532)"
2016,Marzo,Trinidad y Tobago,780,4,5,,9,"(6.171601,-75.427454)"
2016,Marzo,Trinidad y Tobago,780,1,0,,1,"(7.128456,-73.183637)"
2016,Marzo,Trinidad y Tobago,780,1,0,,1,"(7.927209,-72.507910)"
2016,Marzo,Túnez,788,1,0,,1,"(4.697144,-74.140516)"
2016,Marzo,Turquía,792,5,8,,13,"(3.541112,-76.384584)"
2016,Marzo,Turquía,792,28,26,,54,"(4.697144,-74.140516)"
2016,Marzo,Turquía,792,1,2,,3,"(6.171601,-75.427454)"
2016,Marzo,Turkmenistán,795,0,1,,1,"(3.541112,-76.384584)"
2016,Marzo,Ucrania,804,0,6,,6,"(4.697144,-74.140516)"
2016,Marzo,Uganda,800,0,1,,1,"(4.697144,-74.140516)"
2016,Marzo,Uruguay,858,2,2,,4,"(0.814836,-77.662532)"
2016,Marzo,Uruguay,858,4,3,,7,"(10.886611,-74.776708)"
2016,Marzo,Uruguay,858,11,18,,29,"(3.541112,-76.384584)"
2016,Marzo,Uruguay,858,78,102,,180,"(4.697144,-74.140516)"
2016,Marzo,Uruguay,858,1,0,,1,"(4.815061,-75.736532)"
2016,Marzo,Uruguay,858,22,46,,68,"(6.171601,-75.427454)"
2016,Marzo,Uruguay,858,2,2,,4,"(7.128456,-73.183637)"
2016,Marzo,Venezuela,862,9,5,,14,"(10.445761,-75.516429)"
2016,Marzo,Venezuela,862,12,33,,45,"(10.886611,-74.776708)"
2016,Marzo,Venezuela,862,0,2,,2,"(11.117806,-74.232622)"
2016,Marzo,Venezuela,862,55,75,,130,"(11.360009,-72.129330)"
2016,Marzo,Venezuela,862,0,1,,1,"(12.586067,-81.702563)"
2016,Marzo,Venezuela,862,24,28,,52,"(3.541112,-76.384584)"
2016,Marzo,Venezuela,862,2,1,,3,"(3.866713,-67.927521)"
2016,Marzo,Venezuela,862,1473,1739,,3212,"(4.697144,-74.140516)"
2016,Marzo,Venezuela,862,9,3,,12,"(4.815061,-75.736532)"
2016,Marzo,Venezuela,862,184,221,,405,"(6.171601,-75.427454)"
2016,Marzo,Venezuela,862,0,1,,1,"(6.185799,-67.483929)"
2016,Marzo,Venezuela,862,14,11,,25,"(7.088729,-70.740253)"
2016,Marzo,Venezuela,862,4,5,,9,"(7.128456,-73.183637)"
2016,Marzo,Venezuela,862,449,390,,839,"(7.818934,-72.453226)"
2016,Marzo,Venezuela,862,216,189,,405,"(7.927209,-72.507910)"
2016,Marzo,Vietnam,704,0,6,,6,"(4.697144,-74.140516)"
2016,Marzo,Islas Vírgenes Británicas/Territorio Británico de Ultramar,92,0,4,,4,"(4.697144,-74.140516)"
2016,Abril,Afganistán,4,0,5,,5,"(4.697144,-74.140516)"
2016,Abril,Alemania,276,0,1,,1,"(0.814836,-77.662532)"
2016,Abril,Alemania,276,0,2,,2,"(10.886611,-74.776708)"
2016,Abril,Alemania,276,87,91,,178,"(3.541112,-76.384584)"
2016,Abril,Alemania,276,1112,1239,,2351,"(4.697144,-74.140516)"
2016,Abril,Alemania,276,3,1,,4,"(4.815061,-75.736532)"
2016,Abril,Alemania,276,47,55,,102,"(6.171601,-75.427454)"
2016,Abril,Alemania,276,1,0,,1,"(7.128456,-73.183637)"
2016,Abril,Angola,24,0,5,,5,"(4.697144,-74.140516)"
2016,Abril,Angola,24,0,1,,1,"(6.171601,-75.427454)"
2016,Abril,Antigua y Barbuda,28,2,0,,2,"(4.697144,-74.140516)"
2016,Abril,Países Bajos,528,1,0,,1,"(10.445761,-75.516429)"
2016,Abril,Países Bajos,528,124,62,,186,"(10.886611,-74.776708)"
2016,Abril,Países Bajos,528,178,88,,266,"(3.541112,-76.384584)"
2016,Abril,Países Bajos,528,728,671,,1399,"(4.697144,-74.140516)"
2016,Abril,Países Bajos,528,13,5,,18,"(4.815061,-75.736532)"
2016,Abril,Países Bajos,528,160,98,,258,"(6.171601,-75.427454)"
2016,Abril,Países Bajos,528,0,2,,2,"(7.927209,-72.507910)"
2016,Abril,Arabia Saudita,682,1,0,,1,"(10.886611,-74.776708)"
2016,Abril,Arabia Saudita,682,8,30,,38,"(4.697144,-74.140516)"
2016,Abril,Arabia Saudita,682,1,1,,2,"(6.171601,-75.427454)"
2016,Abril,Argelia,12,1,1,,2,"(3.541112,-76.384584)"
2016,Abril,Argentina,32,18,21,,39,"(0.814836,-77.662532)"
2016,Abril,Argentina,32,4,11,,15,"(10.445761,-75.516429)"
2016,Abril,Argentina,32,11,12,,23,"(10.886611,-74.776708)"
2016,Abril,Argentina,32,5,11,,16,"(12.586067,-81.702563)"
2016,Abril,Argentina,32,100,137,,237,"(3.541112,-76.384584)"
2016,Abril,Argentina,32,2010,2099,,4109,"(4.697144,-74.140516)"
2016,Abril,Argentina,32,13,24,,37,"(4.815061,-75.736532)"
2016,Abril,Argentina,32,98,121,,219,"(6.171601,-75.427454)"
2016,Abril,Argentina,32,3,2,,5,"(7.128456,-73.183637)"
2016,Abril,Argentina,32,3,3,,6,"(7.927209,-72.507910)"
2016,Abril,República de Armenia,51,1,0,,1,"(4.697144,-74.140516)"
2016,Abril,Aruba,533,960,641,,1601,"(10.408582,-75.538003)"
2016,Abril,Aruba,533,0,1,,1,"(10.445761,-75.516429)"
2016,Abril,Aruba,533,60,35,,95,"(10.886611,-74.776708)"
2016,Abril,Aruba,533,37,21,,58,"(3.541112,-76.384584)"
2016,Abril,Aruba,533,1366,1020,,2386,"(4.697144,-74.140516)"
2016,Abril,Aruba,533,13,5,,18,"(4.815061,-75.736532)"
2016,Abril,Aruba,533,67,45,,112,"(6.171601,-75.427454)"
2016,Abril,Aruba,533,29,57,,86,"(7.128456,-73.183637)"
2016,Abril,Aruba,533,1,0,,1,"(7.927209,-72.507910)"
2016,Abril,Australia,36,1,2,,3,"(10.886611,-74.776708)"
2016,Abril,Australia,36,9,5,,14,"(3.541112,-76.384584)"
2016,Abril,Australia,36,229,166,,395,"(4.697144,-74.140516)"
2016,Abril,Australia,36,3,0,,3,"(4.815061,-75.736532)"
2016,Abril,Australia,36,43,33,,76,"(6.171601,-75.427454)"
2016,Abril,Australia,36,1,1,,2,"(7.128456,-73.183637)"
2016,Abril,Austria,40,4,1,,5,"(3.541112,-76.384584)"
2016,Abril,Austria,40,28,20,,48,"(4.697144,-74.140516)"
2016,Abril,Austria,40,2,3,,5,"(6.171601,-75.427454)"
2016,Abril,Azerbaiyán,31,0,1,,1,"(3.541112,-76.384584)"
2016,Abril,Azerbaiyán,31,0,2,,2,"(4.697144,-74.140516)"
2016,Abril,Bahamas,44,0,1,,1,"(10.445761,-75.516429)"
2016,Abril,Bahamas,44,3,0,,3,"(10.886611,-74.776708)"
2016,Abril,Bahamas,44,0,1,,1,"(12.586067,-81.702563)"
2016,Abril,Bahamas,44,8,2,,10,"(3.541112,-76.384584)"
2016,Abril,Bahamas,44,7,15,,22,"(4.697144,-74.140516)"
2016,Abril,Bahamas,44,4,1,,5,"(4.815061,-75.736532)"
2016,Abril,Bahamas,44,5,8,,13,"(6.171601,-75.427454)"
2016,Abril,Bahréin,48,1,4,,5,"(4.697144,-74.140516)"
2016,Abril,Bahréin,48,0,1,,1,"(6.171601,-75.427454)"
2016,Abril,Barbados,52,112,105,,217,"(4.697144,-74.140516)"
2016,Abril,República de Belarús,112,1,0,,1,"(6.171601,-75.427454)"
2016,Abril,Bélgica,56,1,0,,1,"(10.445761,-75.516429)"
2016,Abril,Bélgica,56,20,12,,32,"(3.541112,-76.384584)"
2016,Abril,Bélgica,56,76,46,,122,"(4.697144,-74.140516)"
2016,Abril,Bélgica,56,1,1,,2,"(4.815061,-75.736532)"
2016,Abril,Bélgica,56,22,18,,40,"(6.171601,-75.427454)"
2016,Abril,Bélgica,56,1,0,,1,"(7.128456,-73.183637)"
2016,Abril,Belice,84,0,1,,1,"(3.541112,-76.384584)"
2016,Abril,Belice,84,5,6,,11,"(4.697144,-74.140516)"
2016,Abril,Belice,84,0,1,,1,"(6.171601,-75.427454)"
2016,Abril,Benín,204,1,1,,2,"(4.697144,-74.140516)"
2016,Abril,Bermudas/Territorio Británico de Ultramar,60,1,0,,1,"(3.541112,-76.384584)"
2016,Abril,Bermudas/Territorio Británico de Ultramar,60,0,1,,1,"(6.171601,-75.427454)"
2016,Abril,Bolivia,68,3,5,,8,"(0.814836,-77.662532)"
2016,Abril,Bolivia,68,2,1,,3,"(10.445761,-75.516429)"
2016,Abril,Bolivia,68,1,0,,1,"(10.886611,-74.776708)"
2016,Abril,Bolivia,68,23,55,,78,"(3.541112,-76.384584)"
2016,Abril,Bolivia,68,221,481,,702,"(4.697144,-74.140516)"
2016,Abril,Bolivia,68,5,2,,7,"(4.815061,-75.736532)"
2016,Abril,Bolivia,68,27,51,,78,"(6.171601,-75.427454)"
2016,Abril,Bolivia,68,3,2,,5,"(7.128456,-73.183637)"
2016,Abril,Bosnia y Herzegovina,70,2,2,,4,"(4.697144,-74.140516)"
2016,Abril,Brasil,76,110,198,,308,"(-4.197703,-69.941278)"
2016,Abril,Brasil,76,1,3,,4,"(0.814836,-77.662532)"
2016,Abril,Brasil,76,2,5,,7,"(10.445761,-75.516429)"
2016,Abril,Brasil,76,15,23,,38,"(10.886611,-74.776708)"
2016,Abril,Brasil,76,3,1,,4,"(12.586067,-81.702563)"
2016,Abril,Brasil,76,83,116,,199,"(3.541112,-76.384584)"
2016,Abril,Brasil,76,1,0,,1,"(3.866713,-67.927521)"
2016,Abril,Brasil,76,2486,3207,,5693,"(4.697144,-74.140516)"
2016,Abril,Brasil,76,12,15,,27,"(4.815061,-75.736532)"
2016,Abril,Brasil,76,113,206,,319,"(6.171601,-75.427454)"
2016,Abril,Brasil,76,4,1,,5,"(7.128456,-73.183637)"
2016,Abril,Brasil,76,0,1,,1,"(7.927209,-72.507910)"
2016,Abril,Bulgaria,100,2,5,,7,"(4.697144,-74.140516)"
2016,Abril,Burkina Faso,854,0,1,,1,"(4.697144,-74.140516)"
2016,Abril,Islas Caimán/Territorio Británico de Ultramar,136,2,0,,2,"(12.586067,-81.702563)"
2016,Abril,Islas Caimán/Territorio Británico de Ultramar,136,0,1,,1,"(3.541112,-76.384584)"
2016,Abril,Islas Caimán/Territorio Británico de Ultramar,136,8,3,,11,"(4.697144,-74.140516)"
2016,Abril,Islas Caimán/Territorio Británico de Ultramar,136,0,1,,1,"(6.171601,-75.427454)"
2016,Abril,Camboya,116,1,0,,1,"(4.697144,-74.140516)"
2016,Abril,Camerún,120,0,1,,1,"(4.697144,-74.140516)"
2016,Abril,Camerún,120,0,1,,1,"(6.171601,-75.427454)"
2016,Abril,Canadá,124,22,8,,30,"(10.445761,-75.516429)"
2016,Abril,Canadá,124,31,28,,59,"(10.886611,-74.776708)"
2016,Abril,Canadá,124,2,0,,2,"(12.586067,-81.702563)"
2016,Abril,Canadá,124,126,85,,211,"(3.541112,-76.384584)"
2016,Abril,Canadá,124,0,1,,1,"(4.452882,-75.766298)"
2016,Abril,Canadá,124,1272,1024,,2296,"(4.697144,-74.140516)"
2016,Abril,Canadá,124,16,12,,28,"(4.815061,-75.736532)"
2016,Abril,Canadá,124,290,255,,545,"(6.171601,-75.427454)"
2016,Abril,Canadá,124,5,6,,11,"(7.128456,-73.183637)"
2016,Abril,Canadá,124,2,3,,5,"(7.927209,-72.507910)"
2016,Abril,Chad,148,0,1,,1,"(4.697144,-74.140516)"
2016,Abril,España,724,10,4,,14,"(10.445761,-75.516429)"
2016,Abril,España,724,14,23,,37,"(10.886611,-74.776708)"
2016,Abril,España,724,2847,1910,,4757,"(3.541112,-76.384584)"
2016,Abril,España,724,8001,6447,,14448,"(4.697144,-74.140516)"
2016,Abril,España,724,19,16,,35,"(4.815061,-75.736532)"
2016,Abril,España,724,1325,927,,2252,"(6.171601,-75.427454)"
2016,Abril,España,724,6,4,,10,"(7.128456,-73.183637)"
2016,Abril,Colombia,170,55,185,,240,"(4.697144,-74.140516)"
2016,Abril,Colombia,170,1,0,,1,"(6.171601,-75.427454)"
2016,Abril,República Del Congo,178,0,1,,1,"(4.697144,-74.140516)"
2016,Abril,República de Corea,410,1,0,,1,"(3.541112,-76.384584)"
2016,Abril,República de Corea,410,17,15,,32,"(4.697144,-74.140516)"
2016,Abril,República de Corea,410,0,2,,2,"(6.171601,-75.427454)"
2016,Abril,Costa de Marfil,384,3,6,,9,"(4.697144,-74.140516)"
2016,Abril,Costa Rica,188,11,7,,18,"(10.445761,-75.516429)"
2016,Abril,Costa Rica,188,15,25,,40,"(10.886611,-74.776708)"
2016,Abril,Costa Rica,188,2,15,,17,"(12.5744111,-81.703935)"
2016,Abril,Costa Rica,188,7,8,,15,"(12.586067,-81.702563)"
2016,Abril,Costa Rica,188,40,41,,81,"(3.541112,-76.384584)"
2016,Abril,Costa Rica,188,830,1095,,1925,"(4.697144,-74.140516)"
2016,Abril,Costa Rica,188,21,11,,32,"(4.815061,-75.736532)"
2016,Abril,Costa Rica,188,129,163,,292,"(6.171601,-75.427454)"
2016,Abril,Costa Rica,188,7,7,,14,"(7.128456,-73.183637)"
2016,Abril,Costa Rica,188,2,2,,4,"(7.927209,-72.507910)"
2016,Abril,Costa Rica,188,1,0,,1,"(8.635765,-77.346578)"
2016,Abril,Croacia,191,3,7,,10,"(4.697144,-74.140516)"
2016,Abril,Cuba,192,1,0,,1,"(0.814836,-77.662532)"
2016,Abril,Cuba,192,0,1,,1,"(10.408582,-75.538003)"
2016,Abril,Cuba,192,5,7,,12,"(10.445761,-75.516429)"
2016,Abril,Cuba,192,17,5,,22,"(10.886611,-74.776708)"
2016,Abril,Cuba,192,1,0,,1,"(12.586067,-81.702563)"
2016,Abril,Cuba,192,47,58,,105,"(3.541112,-76.384584)"
2016,Abril,Cuba,192,650,718,,1368,"(4.697144,-74.140516)"
2016,Abril,Cuba,192,5,7,,12,"(4.815061,-75.736532)"
2016,Abril,Cuba,192,89,97,,186,"(6.171601,-75.427454)"
2016,Abril,Cuba,192,2,3,,5,"(7.128456,-73.183637)"
2016,Abril,Curazao,99999,8,45,,53,"(4.697144,-74.140516)"
2016,Abril,República Checa,203,0,1,,1,"(10.886611,-74.776708)"
2016,Abril,República Checa,203,0,1,,1,"(3.541112,-76.384584)"
2016,Abril,República Checa,203,6,8,,14,"(4.697144,-74.140516)"
2016,Abril,Chile,152,362,419,,781,"(0.814836,-77.662532)"
2016,Abril,Chile,152,0,2,,2,"(1.813928,-78.763924)"
2016,Abril,Chile,152,15,14,,29,"(10.445761,-75.516429)"
2016,Abril,Chile,152,34,25,,59,"(10.886611,-74.776708)"
2016,Abril,Chile,152,3,5,,8,"(12.586067,-81.702563)"
2016,Abril,Chile,152,393,270,,663,"(3.541112,-76.384584)"
2016,Abril,Chile,152,3190,3135,,6325,"(4.697144,-74.140516)"
2016,Abril,Chile,152,83,68,,151,"(4.815061,-75.736532)"
2016,Abril,Chile,152,128,105,,233,"(6.171601,-75.427454)"
2016,Abril,Chile,152,5,7,,12,"(7.128456,-73.183637)"
2016,Abril,Chile,152,6,6,,12,"(7.927209,-72.507910)"
2016,Abril,China,156,0,4,,4,"(10.445761,-75.516429)"
2016,Abril,China,156,2,11,,13,"(10.886611,-74.776708)"
2016,Abril,China,156,29,64,,93,"(3.541112,-76.384584)"
2016,Abril,China,156,225,735,,960,"(4.697144,-74.140516)"
2016,Abril,China,156,0,2,,2,"(4.815061,-75.736532)"
2016,Abril,China,156,25,57,,82,"(6.171601,-75.427454)"
2016,Abril,Chipre,196,1,0,,1,"(4.697144,-74.140516)"
2016,Abril,Dinamarca,208,2,0,,2,"(3.541112,-76.384584)"
2016,Abril,Dinamarca,208,15,7,,22,"(4.697144,-74.140516)"
2016,Abril,Dinamarca,208,1,0,,1,"(6.171601,-75.427454)"
2016,Abril,Dominica,212,2,4,,6,"(4.697144,-74.140516)"
2016,Abril,Ecuador,218,1,4,,5,"(-0.193180,-74.784874)"
2016,Abril,Ecuador,218,310,515,,825,"(0.25129,-76.875963)"
2016,Abril,Ecuador,218,16,23,,39,"(0.812436,-77.847006)"
2016,Abril,Ecuador,218,4373,5894,,10267,"(0.814836,-77.662532)"
2016,Abril,Ecuador,218,125,134,,259,"(1.813928,-78.763924)"
2016,Abril,Ecuador,218,0,10,,10,"(10.408582,-75.538003)"
2016,Abril,Ecuador,218,10,8,,18,"(10.445761,-75.516429)"
2016,Abril,Ecuador,218,5,8,,13,"(10.886611,-74.776708)"
2016,Abril,Ecuador,218,285,336,,621,"(3.541112,-76.384584)"
2016,Abril,Ecuador,218,1992,3654,,5646,"(4.697144,-74.140516)"
2016,Abril,Ecuador,218,7,12,,19,"(4.815061,-75.736532)"
2016,Abril,Ecuador,218,45,84,,129,"(6.171601,-75.427454)"
2016,Abril,Ecuador,218,0,2,,2,"(6.228046,-77.404104)"
2016,Abril,Ecuador,218,3,6,,9,"(7.128456,-73.183637)"
2016,Abril,Ecuador,218,0,1,,1,"(7.927209,-72.507910)"
2016,Abril,Egipto,818,0,1,,1,"(10.408582,-75.538003)"
2016,Abril,Egipto,818,1,0,,1,"(10.886611,-74.776708)"
2016,Abril,Egipto,818,9,6,,15,"(4.697144,-74.140516)"
2016,Abril,Egipto,818,0,1,,1,"(4.815061,-75.736532)"
2016,Abril,El Salvador,222,2,6,,8,"(10.445761,-75.516429)"
2016,Abril,El Salvador,222,1,2,,3,"(10.886611,-74.776708)"
2016,Abril,El Salvador,222,0,1,,1,"(12.586067,-81.702563)"
2016,Abril,El Salvador,222,43,65,,108,"(3.541112,-76.384584)"
2016,Abril,El Salvador,222,468,835,,1303,"(4.697144,-74.140516)"
2016,Abril,El Salvador,222,46,67,,113,"(6.171601,-75.427454)"
2016,Abril,El Salvador,222,0,1,,1,"(7.927209,-72.507910)"
2016,Abril,Emiratos Árabes,784,6,1,,7,"(3.541112,-76.384584)"
2016,Abril,Emiratos Árabes,784,59,121,,180,"(4.697144,-74.140516)"
2016,Abril,Emiratos Árabes,784,7,4,,11,"(6.171601,-75.427454)"
2016,Abril,Eslovaquia,703,0,2,,2,"(4.697144,-74.140516)"
2016,Abril,Eslovaquia,703,2,1,,3,"(6.171601,-75.427454)"
2016,Abril,Eslovenia,705,2,0,,2,"(4.697144,-74.140516)"
2016,Abril,Estados Unidos de América,840,2848,2329,,5177,"(10.445761,-75.516429)"
2016,Abril,Estados Unidos de América,840,1999,1621,,3620,"(10.886611,-74.776708)"
2016,Abril,Estados Unidos de América,840,32,16,,48,"(12.586067,-81.702563)"
2016,Abril,Estados Unidos de América,840,4437,3147,,7584,"(3.541112,-76.384584)"
2016,Abril,Estados Unidos de América,840,589,453,,1042,"(4.452882,-75.766298)"
2016,Abril,Estados Unidos de América,840,28121,25396,,53517,"(4.697144,-74.140516)"
2016,Abril,Estados Unidos de América,840,856,678,,1534,"(4.815061,-75.736532)"
2016,Abril,Estados Unidos de América,840,8696,6835,,15531,"(6.171601,-75.427454)"
2016,Abril,Estados Unidos de América,840,101,92,,193,"(7.128456,-73.183637)"
2016,Abril,Estados Unidos de América,840,35,26,,61,"(7.927209,-72.507910)"
2016,Abril,Etiopia,231,0,5,,5,"(4.697144,-74.140516)"
2016,Abril,Etiopia,231,0,1,,1,"(6.171601,-75.427454)"
2016,Abril,Filipinas,608,0,1,,1,"(4.697144,-74.140516)"
2016,Abril,Finlandia,246,0,1,,1,"(10.886611,-74.776708)"
2016,Abril,Finlandia,246,2,1,,3,"(3.541112,-76.384584)"
2016,Abril,Finlandia,246,3,4,,7,"(4.697144,-74.140516)"
2016,Abril,Finlandia,246,1,0,,1,"(6.171601,-75.427454)"
2016,Abril,Francia,250,4,1,,5,"(10.445761,-75.516429)"
2016,Abril,Francia,250,4,3,,7,"(10.886611,-74.776708)"
2016,Abril,Francia,250,93,69,,162,"(3.541112,-76.384584)"
2016,Abril,Francia,250,1130,1124,,2254,"(4.697144,-74.140516)"
2016,Abril,Francia,250,65,41,,106,"(6.171601,-75.427454)"
2016,Abril,Georgia,268,0,1,,1,"(4.697144,-74.140516)"
2016,Abril,Ghana,288,0,2,,2,"(3.541112,-76.384584)"
2016,Abril,Gibraltar/Territorio Británico de Ultramar,292,0,3,,3,"(0.814836,-77.662532)"
2016,Abril,Granada,308,0,1,,1,"(4.697144,-74.140516)"
2016,Abril,Grecia,300,1,0,,1,"(3.541112,-76.384584)"
2016,Abril,Grecia,300,21,17,,38,"(4.697144,-74.140516)"
2016,Abril,Grecia,300,3,1,,4,"(6.171601,-75.427454)"
2016,Abril,Guatemala,320,1,1,,2,"(10.445761,-75.516429)"
2016,Abril,Guatemala,320,10,13,,23,"(10.886611,-74.776708)"
2016,Abril,Guatemala,320,0,2,,2,"(12.586067,-81.702563)"
2016,Abril,Guatemala,320,59,88,,147,"(3.541112,-76.384584)"
2016,Abril,Guatemala,320,462,651,,1113,"(4.697144,-74.140516)"
2016,Abril,Guatemala,320,6,7,,13,"(4.815061,-75.736532)"
2016,Abril,Guatemala,320,66,99,,165,"(6.171601,-75.427454)"
2016,Abril,Guatemala,320,5,4,,9,"(7.128456,-73.183637)"
2016,Abril,Guyana,328,1,1,,2,"(4.697144,-74.140516)"
2016,Abril,Guyana,328,0,1,,1,"(7.128456,-73.183637)"
2016,Abril,Guinea Ecuatorial,226,0,2,,2,"(3.541112,-76.384584)"
2016,Abril,Guadalupe/Territorio Francés,312,1,0,,1,"(3.541112,-76.384584)"
2016,Abril,Guadalupe/Territorio Francés,312,2,0,,2,"(4.697144,-74.140516)"
2016,Abril,Guadalupe/Territorio Francés,312,1,0,,1,"(4.815061,-75.736532)"
2016,Abril,Guayana Francesa/Departamento de Ultramar Francés,254,0,6,,6,"(11.117806,-74.232622)"
2016,Abril,Guayana Francesa/Departamento de Ultramar Francés,254,0,1,,1,"(4.697144,-74.140516)"
2016,Abril,Guayana Francesa/Departamento de Ultramar Francés,254,0,1,,1,"(6.171601,-75.427454)"
2016,Abril,Guayana Francesa/Departamento de Ultramar Francés,254,0,1,,1,"(7.927209,-72.507910)"
2016,Abril,Haití,332,1,0,,1,"(10.445761,-75.516429)"
2016,Abril,Haití,332,0,1,,1,"(10.886611,-74.776708)"
2016,Abril,Haití,332,6,10,,16,"(4.697144,-74.140516)"
2016,Abril,Haití,332,1,4,,5,"(6.171601,-75.427454)"
2016,Abril,Haití,332,1,4,,5,"(7.128456,-73.183637)"
2016,Abril,Honduras,340,2,0,,2,"(10.445761,-75.516429)"
2016,Abril,Honduras,340,0,4,,4,"(10.886611,-74.776708)"
2016,Abril,Honduras,340,10,21,,31,"(3.541112,-76.384584)"
2016,Abril,Honduras,340,55,133,,188,"(4.697144,-74.140516)"
2016,Abril,Honduras,340,0,4,,4,"(4.815061,-75.736532)"
2016,Abril,Honduras,340,24,51,,75,"(6.171601,-75.427454)"
2016,Abril,Honduras,340,0,1,,1,"(7.128456,-73.183637)"
2016,Abril,Hong Kong,344,0,2,,2,"(10.886611,-74.776708)"
2016,Abril,Hong Kong,344,5,4,,9,"(3.541112,-76.384584)"
2016,Abril,Hong Kong,344,49,124,,173,"(4.697144,-74.140516)"
2016,Abril,Hong Kong,344,2,4,,6,"(6.171601,-75.427454)"
2016,Abril,Hong Kong,344,1,1,,2,"(7.128456,-73.183637)"
2016,Abril,Hungría,348,2,2,,4,"(4.697144,-74.140516)"
2016,Abril,India,356,0,1,,1,"(10.886611,-74.776708)"
2016,Abril,India,356,3,7,,10,"(3.541112,-76.384584)"
2016,Abril,India,356,25,32,,57,"(4.697144,-74.140516)"
2016,Abril,India,356,9,8,,17,"(6.171601,-75.427454)"
2016,Abril,Indonesia,360,0,1,,1,"(3.541112,-76.384584)"
2016,Abril,Indonesia,360,4,9,,13,"(4.697144,-74.140516)"
2016,Abril,Indonesia,360,1,3,,4,"(6.171601,-75.427454)"
2016,Abril,Iraq,368,1,7,,8,"(4.697144,-74.140516)"
2016,Abril,Irán,364,0,2,,2,"(10.408582,-75.538003)"
2016,Abril,Irán,364,2,0,,2,"(4.697144,-74.140516)"
2016,Abril,República de Irlanda,372,1,0,,1,"(3.541112,-76.384584)"
2016,Abril,República de Irlanda,372,21,14,,35,"(4.697144,-74.140516)"
2016,Abril,República de Irlanda,372,1,0,,1,"(6.171601,-75.427454)"
2016,Abril,Islandia,352,1,2,,3,"(10.445761,-75.516429)"
2016,Abril,Islandia,352,0,1,,1,"(4.697144,-74.140516)"
2016,Abril,Israel,376,2,3,,5,"(3.541112,-76.384584)"
2016,Abril,Israel,376,51,40,,91,"(4.697144,-74.140516)"
2016,Abril,Israel,376,4,1,,5,"(6.171601,-75.427454)"
2016,Abril,Italia,380,9,0,,9,"(10.445761,-75.516429)"
2016,Abril,Italia,380,5,1,,6,"(10.886611,-74.776708)"
2016,Abril,Italia,380,1,0,,1,"(12.586067,-81.702563)"
2016,Abril,Italia,380,215,108,,323,"(3.541112,-76.384584)"
2016,Abril,Italia,380,567,366,,933,"(4.697144,-74.140516)"
2016,Abril,Italia,380,2,1,,3,"(4.815061,-75.736532)"
2016,Abril,Italia,380,70,37,,107,"(6.171601,-75.427454)"
2016,Abril,Italia,380,1,1,,2,"(7.128456,-73.183637)"
2016,Abril,Italia,380,0,1,,1,"(7.927209,-72.507910)"
2016,Abril,Jamaica,388,1,3,,4,"(10.445761,-75.516429)"
2016,Abril,Jamaica,388,1,2,,3,"(10.886611,-74.776708)"
2016,Abril,Jamaica,388,4,4,,8,"(3.541112,-76.384584)"
2016,Abril,Jamaica,388,11,23,,34,"(4.697144,-74.140516)"
2016,Abril,Jamaica,388,3,2,,5,"(4.815061,-75.736532)"
2016,Abril,Jamaica,388,13,11,,24,"(6.171601,-75.427454)"
2016,Abril,Jamaica,388,1,0,,1,"(7.927209,-72.507910)"
2016,Abril,Japón,392,4,3,,7,"(3.541112,-76.384584)"
2016,Abril,Japón,392,73,78,,151,"(4.697144,-74.140516)"
2016,Abril,Japón,392,1,1,,2,"(4.815061,-75.736532)"
2016,Abril,Japón,392,2,2,,4,"(6.171601,-75.427454)"
2016,Abril,Jordania,400,3,2,,5,"(4.697144,-74.140516)"
2016,Abril,Kenia,404,0,2,,2,"(3.541112,-76.384584)"
2016,Abril,Kenia,404,3,2,,5,"(4.697144,-74.140516)"
2016,Abril,Kuwait,414,1,4,,5,"(4.697144,-74.140516)"
2016,Abril,República Democrática Popular  Lao,418,0,1,,1,"(4.697144,-74.140516)"
2016,Abril,Letonia,428,0,3,,3,"(4.697144,-74.140516)"
2016,Abril,Lituania,440,1,8,,9,"(4.697144,-74.140516)"
2016,Abril,Líbano,422,2,0,,2,"(3.541112,-76.384584)"
2016,Abril,Líbano,422,6,14,,20,"(4.697144,-74.140516)"
2016,Abril,Luxemburgo,442,1,0,,1,"(10.886611,-74.776708)"
2016,Abril,Luxemburgo,442,2,1,,3,"(3.541112,-76.384584)"
2016,Abril,Luxemburgo,442,7,6,,13,"(4.697144,-74.140516)"
2016,Abril,Luxemburgo,442,1,0,,1,"(6.171601,-75.427454)"
2016,Abril,Macao,446,1,1,,2,"(4.697144,-74.140516)"
2016,Abril,Malasia,458,1,2,,3,"(3.541112,-76.384584)"
2016,Abril,Malasia,458,3,2,,5,"(4.697144,-74.140516)"
2016,Abril,Malasia,458,3,2,,5,"(6.171601,-75.427454)"
2016,Abril,Malawi,454,0,1,,1,"(4.697144,-74.140516)"
2016,Abril,Malta,470,1,0,,1,"(3.541112,-76.384584)"
2016,Abril,Malta,470,11,10,,21,"(4.697144,-74.140516)"
2016,Abril,Malta,470,1,1,,2,"(6.171601,-75.427454)"
2016,Abril,Marruecos,504,9,13,,22,"(4.697144,-74.140516)"
2016,Abril,Marruecos,504,2,4,,6,"(6.171601,-75.427454)"
2016,Abril,Mauricio,480,1,1,,2,"(4.697144,-74.140516)"
2016,Abril,México,484,0,1,,1,"(0.814836,-77.662532)"
2016,Abril,México,484,41,31,,72,"(10.445761,-75.516429)"
2016,Abril,México,484,107,116,,223,"(10.886611,-74.776708)"
2016,Abril,México,484,1,0,,1,"(12.586067,-81.702563)"
2016,Abril,México,484,406,383,,789,"(3.541112,-76.384584)"
2016,Abril,México,484,8924,8841,,17765,"(4.697144,-74.140516)"
2016,Abril,México,484,101,80,,181,"(4.815061,-75.736532)"
2016,Abril,México,484,1185,1077,,2262,"(6.171601,-75.427454)"
2016,Abril,México,484,69,53,,122,"(7.128456,-73.183637)"
2016,Abril,México,484,24,16,,40,"(7.927209,-72.507910)"
2016,Abril,Mónaco,492,1,0,,1,"(4.697144,-74.140516)"
2016,Abril,Mongolia,496,0,2,,2,"(4.697144,-74.140516)"
2016,Abril,Montenegro,499,0,1,,1,"(4.697144,-74.140516)"
2016,Abril,Mozambique,508,0,1,,1,"(4.697144,-74.140516)"
2016,Abril,Myanmar,104,0,1,,1,"(4.697144,-74.140516)"
2016,Abril,Nepal,524,0,1,,1,"(4.697144,-74.140516)"
2016,Abril,Nicaragua,558,1,0,,1,"(10.445761,-75.516429)"
2016,Abril,Nicaragua,558,2,8,,10,"(10.886611,-74.776708)"
2016,Abril,Nicaragua,558,2,7,,9,"(12.5744111,-81.703935)"
2016,Abril,Nicaragua,558,0,2,,2,"(12.586067,-81.702563)"
2016,Abril,Nicaragua,558,15,34,,49,"(3.541112,-76.384584)"
2016,Abril,Nicaragua,558,26,53,,79,"(4.697144,-74.140516)"
2016,Abril,Nicaragua,558,7,6,,13,"(4.815061,-75.736532)"
2016,Abril,Nicaragua,558,9,43,,52,"(6.171601,-75.427454)"
2016,Abril,Nicaragua,558,0,1,,1,"(7.128456,-73.183637)"
2016,Abril,Nicaragua,558,1,0,,1,"(7.927209,-72.507910)"
2016,Abril,Nigeria,566,1,9,,10,"(4.697144,-74.140516)"
2016,Abril,Noruega,578,1,0,,1,"(10.445761,-75.516429)"
2016,Abril,Noruega,578,1,0,,1,"(10.886611,-74.776708)"
2016,Abril,Noruega,578,0,1,,1,"(3.541112,-76.384584)"
2016,Abril,Noruega,578,21,28,,49,"(4.697144,-74.140516)"
2016,Abril,Noruega,578,1,1,,2,"(6.171601,-75.427454)"
2016,Abril,Nueva Zelanda,554,32,34,,66,"(4.697144,-74.140516)"
2016,Abril,Nueva Zelanda,554,3,4,,7,"(6.171601,-75.427454)"
2016,Abril,Omán,512,0,4,,4,"(4.697144,-74.140516)"
2016,Abril,Papúa Nueva Guinea,598,0,1,,1,"(3.541112,-76.384584)"
2016,Abril,Papúa Nueva Guinea,598,1,1,,2,"(4.697144,-74.140516)"
2016,Abril,Pakistán,586,1,2,,3,"(4.697144,-74.140516)"
2016,Abril,Panamá,591,10,63,,73,"(10.408582,-75.538003)"
2016,Abril,Panamá,591,359,361,,720,"(10.445761,-75.516429)"
2016,Abril,Panamá,591,682,692,,1374,"(10.886611,-74.776708)"
2016,Abril,Panamá,591,0,1,,1,"(12.5744111,-81.703935)"
2016,Abril,Panamá,591,106,124,,230,"(12.586067,-81.702563)"
2016,Abril,Panamá,591,1409,1446,,2855,"(3.541112,-76.384584)"
2016,Abril,Panamá,591,0,9,,9,"(3.893038,-77.067921)"
2016,Abril,Panamá,591,224,155,,379,"(4.452882,-75.766298)"
2016,Abril,Panamá,591,6414,7854,,14268,"(4.697144,-74.140516)"
2016,Abril,Panamá,591,545,451,,996,"(4.815061,-75.736532)"
2016,Abril,Panamá,591,2597,2748,,5345,"(6.171601,-75.427454)"
2016,Abril,Panamá,591,3,5,,8,"(6.228046,-77.404104)"
2016,Abril,Panamá,591,1,1,,2,"(7.102626,-77.762647)"
2016,Abril,Panamá,591,177,201,,378,"(7.128456,-73.183637)"
2016,Abril,Panamá,591,86,102,,188,"(7.927209,-72.507910)"
2016,Abril,Panamá,591,0,54,,54,"(8.066966,-76.735404)"
2016,Abril,Panamá,591,24,99,,123,"(8.635765,-77.346578)"
2016,Abril,Paraguay,600,1,3,,4,"(10.445761,-75.516429)"
2016,Abril,Paraguay,600,4,4,,8,"(10.886611,-74.776708)"
2016,Abril,Paraguay,600,0,1,,1,"(12.586067,-81.702563)"
2016,Abril,Paraguay,600,15,28,,43,"(3.541112,-76.384584)"
2016,Abril,Paraguay,600,49,178,,227,"(4.697144,-74.140516)"
2016,Abril,Paraguay,600,6,14,,20,"(4.815061,-75.736532)"
2016,Abril,Paraguay,600,10,25,,35,"(6.171601,-75.427454)"
2016,Abril,Paraguay,600,0,1,,1,"(7.128456,-73.183637)"
2016,Abril,Paraguay,600,0,1,,1,"(7.927209,-72.507910)"
2016,Abril,Perú,604,1,2,,3,"(-0.193180,-74.784874)"
2016,Abril,Perú,604,102,122,,224,"(-4.197703,-69.941278)"
2016,Abril,Perú,604,98,266,,364,"(0.814836,-77.662532)"
2016,Abril,Perú,604,3,10,,13,"(10.445761,-75.516429)"
2016,Abril,Perú,604,3,10,,13,"(10.886611,-74.776708)"
2016,Abril,Perú,604,195,240,,435,"(3.541112,-76.384584)"
2016,Abril,Perú,604,3714,4791,,8505,"(4.697144,-74.140516)"
2016,Abril,Perú,604,4,6,,10,"(4.815061,-75.736532)"
2016,Abril,Perú,604,232,381,,613,"(6.171601,-75.427454)"
2016,Abril,Perú,604,0,1,,1,"(7.128456,-73.183637)"
2016,Abril,Perú,604,1,1,,2,"(7.927209,-72.507910)"
2016,Abril,Palestina,99999,1,1,,2,"(4.697144,-74.140516)"
2016,Abril,Polonia,616,1,0,,1,"(3.541112,-76.384584)"
2016,Abril,Polonia,616,3,6,,9,"(4.697144,-74.140516)"
2016,Abril,Portugal,620,9,12,,21,"(3.541112,-76.384584)"
2016,Abril,Portugal,620,107,120,,227,"(4.697144,-74.140516)"
2016,Abril,Portugal,620,9,4,,13,"(6.171601,-75.427454)"
2016,Abril,Puerto Rico/Territorio de Estados Unidos,630,3,2,,5,"(10.445761,-75.516429)"
2016,Abril,Puerto Rico/Territorio de Estados Unidos,630,13,10,,23,"(10.886611,-74.776708)"
2016,Abril,Puerto Rico/Territorio de Estados Unidos,630,30,17,,47,"(3.541112,-76.384584)"
2016,Abril,Puerto Rico/Territorio de Estados Unidos,630,416,365,,781,"(4.697144,-74.140516)"
2016,Abril,Puerto Rico/Territorio de Estados Unidos,630,6,4,,10,"(4.815061,-75.736532)"
2016,Abril,Puerto Rico/Territorio de Estados Unidos,630,24,28,,52,"(6.171601,-75.427454)"
2016,Abril,Puerto Rico/Territorio de Estados Unidos,630,1,2,,3,"(7.128456,-73.183637)"
2016,Abril,Puerto Rico/Territorio de Estados Unidos,630,1,0,,1,"(7.927209,-72.507910)"
2016,Abril,Qatar,634,0,1,,1,"(3.541112,-76.384584)"
2016,Abril,Qatar,634,1,0,,1,"(4.697144,-74.140516)"
2016,Abril,Qatar,634,1,6,,7,"(6.171601,-75.427454)"
2016,Abril,Reino Unido de Gran Bretaña e Irlanda del Norte,826,1,1,,2,"(10.886611,-74.776708)"
2016,Abril,Reino Unido de Gran Bretaña e Irlanda del Norte,826,38,26,,64,"(3.541112,-76.384584)"
2016,Abril,Reino Unido de Gran Bretaña e Irlanda del Norte,826,1498,1078,,2576,"(4.697144,-74.140516)"
2016,Abril,Reino Unido de Gran Bretaña e Irlanda del Norte,826,9,16,,25,"(6.171601,-75.427454)"
2016,Abril,Federación de Rusia,643,1,0,,1,"(10.886611,-74.776708)"
2016,Abril,Federación de Rusia,643,2,2,,4,"(3.541112,-76.384584)"
2016,Abril,Federación de Rusia,643,10,26,,36,"(4.697144,-74.140516)"
2016,Abril,República Dominicana,214,1,1,,2,"(10.408582,-75.538003)"
2016,Abril,República Dominicana,214,0,1,,1,"(10.433609,-73.247863)"
2016,Abril,República Dominicana,214,10,24,,34,"(10.445761,-75.516429)"
2016,Abril,República Dominicana,214,30,41,,71,"(10.886611,-74.776708)"
2016,Abril,República Dominicana,214,80,71,,151,"(3.541112,-76.384584)"
2016,Abril,República Dominicana,214,2100,1843,,3943,"(4.697144,-74.140516)"
2016,Abril,República Dominicana,214,82,47,,129,"(4.815061,-75.736532)"
2016,Abril,República Dominicana,214,218,146,,364,"(6.171601,-75.427454)"
2016,Abril,República Dominicana,214,17,20,,37,"(7.128456,-73.183637)"
2016,Abril,República Dominicana,214,16,11,,27,"(7.927209,-72.507910)"
2016,Abril,Reunión,638,1,0,,1,"(3.541112,-76.384584)"
2016,Abril,Rumania,642,1,0,,1,"(10.886611,-74.776708)"
2016,Abril,Rumania,642,1,0,,1,"(3.541112,-76.384584)"
2016,Abril,Rumania,642,4,1,,5,"(4.697144,-74.140516)"
2016,Abril,Rumania,642,1,2,,3,"(6.171601,-75.427454)"
2016,Abril,San Cristóbal y Nevis,659,1,0,,1,"(3.541112,-76.384584)"
2016,Abril,San  Vicente y las Granadinas,670,1,0,,1,"(4.697144,-74.140516)"
2016,Abril,Santa Lucia,662,0,3,,3,"(3.541112,-76.384584)"
2016,Abril,Senegal,686,0,1,,1,"(6.171601,-75.427454)"
2016,Abril,Serbia,688,1,0,,1,"(3.541112,-76.384584)"
2016,Abril,Sierra Leona,694,1,0,,1,"(3.541112,-76.384584)"
2016,Abril,Singapur,702,1,0,,1,"(10.445761,-75.516429)"
2016,Abril,Singapur,702,2,0,,2,"(3.541112,-76.384584)"
2016,Abril,Singapur,702,11,12,,23,"(4.697144,-74.140516)"
2016,Abril,Singapur,702,2,0,,2,"(6.171601,-75.427454)"
2016,Abril,Sri Lanka,144,0,1,,1,"(4.697144,-74.140516)"
2016,Abril,Sri Lanka,144,2,0,,2,"(6.171601,-75.427454)"
2016,Abril,Sudáfrica,710,13,8,,21,"(4.697144,-74.140516)"
2016,Abril,Sudáfrica,710,3,0,,3,"(6.171601,-75.427454)"
2016,Abril,Sudán,736,0,1,,1,"(4.697144,-74.140516)"
2016,Abril,Suecia,752,1,0,,1,"(10.445761,-75.516429)"
2016,Abril,Suecia,752,3,1,,4,"(10.886611,-74.776708)"
2016,Abril,Suecia,752,5,10,,15,"(3.541112,-76.384584)"
2016,Abril,Suecia,752,45,45,,90,"(4.697144,-74.140516)"
2016,Abril,Suecia,752,3,3,,6,"(6.171601,-75.427454)"
2016,Abril,Suiza,756,1,0,,1,"(10.445761,-75.516429)"
2016,Abril,Suiza,756,1,0,,1,"(10.886611,-74.776708)"
2016,Abril,Suiza,756,68,34,,102,"(3.541112,-76.384584)"
2016,Abril,Suiza,756,214,141,,355,"(4.697144,-74.140516)"
2016,Abril,Suiza,756,1,3,,4,"(4.815061,-75.736532)"
2016,Abril,Suiza,756,23,11,,34,"(6.171601,-75.427454)"
2016,Abril,Suiza,756,0,1,,1,"(7.128456,-73.183637)"
2016,Abril,Suiza,756,0,1,,1,"(7.927209,-72.507910)"
2016,Abril,Surinam,740,1,3,,4,"(4.697144,-74.140516)"
2016,Abril,Surinam,740,1,3,,4,"(6.171601,-75.427454)"
2016,Abril,Taiwán,158,0,1,,1,"(10.886611,-74.776708)"
2016,Abril,Taiwán,158,1,8,,9,"(4.697144,-74.140516)"
2016,Abril,Taiwán,158,1,1,,2,"(6.171601,-75.427454)"
2016,Abril,Tailandia,764,0,2,,2,"(3.541112,-76.384584)"
2016,Abril,Tailandia,764,6,12,,18,"(4.697144,-74.140516)"
2016,Abril,Tailandia,764,2,0,,2,"(6.171601,-75.427454)"
2016,Abril,Tanzania,834,0,1,,1,"(4.697144,-74.140516)"
2016,Abril,Trinidad y Tobago,780,0,1,,1,"(10.408582,-75.538003)"
2016,Abril,Trinidad y Tobago,780,3,4,,7,"(10.445761,-75.516429)"
2016,Abril,Trinidad y Tobago,780,1,4,,5,"(10.886611,-74.776708)"
2016,Abril,Trinidad y Tobago,780,10,39,,49,"(3.541112,-76.384584)"
2016,Abril,Trinidad y Tobago,780,32,88,,120,"(4.697144,-74.140516)"
2016,Abril,Trinidad y Tobago,780,2,11,,13,"(4.815061,-75.736532)"
2016,Abril,Trinidad y Tobago,780,8,6,,14,"(6.171601,-75.427454)"
2016,Abril,Trinidad y Tobago,780,1,3,,4,"(7.128456,-73.183637)"
2016,Abril,Trinidad y Tobago,780,3,4,,7,"(7.927209,-72.507910)"
2016,Abril,Turquía,792,10,13,,23,"(3.541112,-76.384584)"
2016,Abril,Turquía,792,25,32,,57,"(4.697144,-74.140516)"
2016,Abril,Turquía,792,4,3,,7,"(6.171601,-75.427454)"
2016,Abril,Ucrania,804,0,1,,1,"(4.697144,-74.140516)"
2016,Abril,Uruguay,858,4,0,,4,"(10.445761,-75.516429)"
2016,Abril,Uruguay,858,6,10,,16,"(3.541112,-76.384584)"
2016,Abril,Uruguay,858,57,85,,142,"(4.697144,-74.140516)"
2016,Abril,Uruguay,858,1,0,,1,"(4.815061,-75.736532)"
2016,Abril,Uruguay,858,8,11,,19,"(6.171601,-75.427454)"
2016,Abril,Venezuela,862,9,11,,20,"(10.445761,-75.516429)"
2016,Abril,Venezuela,862,17,42,,59,"(10.886611,-74.776708)"
2016,Abril,Venezuela,862,1,0,,1,"(11.117806,-74.232622)"
2016,Abril,Venezuela,862,41,80,,121,"(11.360009,-72.129330)"
2016,Abril,Venezuela,862,0,1,,1,"(12.586067,-81.702563)"
2016,Abril,Venezuela,862,20,18,,38,"(3.541112,-76.384584)"
2016,Abril,Venezuela,862,1367,1674,,3041,"(4.697144,-74.140516)"
2016,Abril,Venezuela,862,1,4,,5,"(4.815061,-75.736532)"
2016,Abril,Venezuela,862,217,198,,415,"(6.171601,-75.427454)"
2016,Abril,Venezuela,862,4,1,,5,"(6.185799,-67.483929)"
2016,Abril,Venezuela,862,31,18,,49,"(7.088729,-70.740253)"
2016,Abril,Venezuela,862,3,2,,5,"(7.128456,-73.183637)"
2016,Abril,Venezuela,862,314,293,,607,"(7.818934,-72.453226)"
2016,Abril,Venezuela,862,1,1,,2,"(7.927209,-72.507910)"
2016,Abril,Vietnam,704,7,8,,15,"(4.697144,-74.140516)"
2016,Abril,Islas Vírgenes Estadounidenses/Territorio de Estados Unidos,850,0,1,,1,"(4.697144,-74.140516)"
2016,Abril,Zimbabue,716,1,0,,1,"(4.697144,-74.140516)"
2016,Mayo,Afganistán,4,0,6,,6,"(4.697144,-74.140516)"
2016,Mayo,Albania,8,0,1,,1,"(4.697144,-74.140516)"
2016,Mayo,Alemania,276,2,3,,5,"(10.445761,-75.516429)"
2016,Mayo,Alemania,276,3,8,,11,"(10.886611,-74.776708)"
2016,Mayo,Alemania,276,79,60,,139,"(3.541112,-76.384584)"
2016,Mayo,Alemania,276,1371,1503,,2874,"(4.697144,-74.140516)"
2016,Mayo,Alemania,276,60,49,,109,"(6.171601,-75.427454)"
2016,Mayo,Alemania,276,1,0,,1,"(7.128456,-73.183637)"
2016,Mayo,Andorra,20,0,1,,1,"(3.541112,-76.384584)"
2016,Mayo,Andorra,20,1,0,,1,"(4.697144,-74.140516)"
2016,Mayo,Angola,24,2,10,,12,"(4.697144,-74.140516)"
2016,Mayo,Antigua y Barbuda,28,2,8,,10,"(4.697144,-74.140516)"
2016,Mayo,Países Bajos,528,0,1,,1,"(10.408582,-75.538003)"
2016,Mayo,Países Bajos,528,1,2,,3,"(10.445761,-75.516429)"
2016,Mayo,Países Bajos,528,144,58,,202,"(10.886611,-74.776708)"
2016,Mayo,Países Bajos,528,1,0,,1,"(12.586067,-81.702563)"
2016,Mayo,Países Bajos,528,250,160,,410,"(3.541112,-76.384584)"
2016,Mayo,Países Bajos,528,940,719,,1659,"(4.697144,-74.140516)"
2016,Mayo,Países Bajos,528,12,8,,20,"(4.815061,-75.736532)"
2016,Mayo,Países Bajos,528,172,76,,248,"(6.171601,-75.427454)"
2016,Mayo,Países Bajos,528,1,1,,2,"(7.128456,-73.183637)"
2016,Mayo,Países Bajos,528,1,3,,4,"(7.927209,-72.507910)"
2016,Mayo,Arabia Saudita,682,4,35,,39,"(4.697144,-74.140516)"
2016,Mayo,Arabia Saudita,682,0,4,,4,"(6.171601,-75.427454)"
2016,Mayo,Argelia,12,0,7,,7,"(4.697144,-74.140516)"
2016,Mayo,Argentina,32,9,21,,30,"(0.814836,-77.662532)"
2016,Mayo,Argentina,32,3,5,,8,"(10.445761,-75.516429)"
2016,Mayo,Argentina,32,13,8,,21,"(10.886611,-74.776708)"
2016,Mayo,Argentina,32,5,5,,10,"(12.586067,-81.702563)"
2016,Mayo,Argentina,32,117,124,,241,"(3.541112,-76.384584)"
2016,Mayo,Argentina,32,1882,1958,,3840,"(4.697144,-74.140516)"
2016,Mayo,Argentina,32,16,11,,27,"(4.815061,-75.736532)"
2016,Mayo,Argentina,32,136,178,,314,"(6.171601,-75.427454)"
2016,Mayo,Argentina,32,6,4,,10,"(7.128456,-73.183637)"
2016,Mayo,Argentina,32,1,3,,4,"(7.927209,-72.507910)"
2016,Mayo,República de Armenia,51,0,1,,1,"(4.697144,-74.140516)"
2016,Mayo,República de Armenia,51,0,1,,1,"(6.171601,-75.427454)"
2016,Mayo,Aruba,533,983,661,,1644,"(10.408582,-75.538003)"
2016,Mayo,Aruba,533,3,5,,8,"(10.445761,-75.516429)"
2016,Mayo,Aruba,533,49,29,,78,"(10.886611,-74.776708)"
2016,Mayo,Aruba,533,0,1,,1,"(12.586067,-81.702563)"
2016,Mayo,Aruba,533,39,26,,65,"(3.541112,-76.384584)"
2016,Mayo,Aruba,533,1703,1205,,2908,"(4.697144,-74.140516)"
2016,Mayo,Aruba,533,12,4,,16,"(4.815061,-75.736532)"
2016,Mayo,Aruba,533,118,72,,190,"(6.171601,-75.427454)"
2016,Mayo,Aruba,533,30,50,,80,"(7.128456,-73.183637)"
2016,Mayo,Aruba,533,1,2,,3,"(7.927209,-72.507910)"
2016,Mayo,Australia,36,1,0,,1,"(10.445761,-75.516429)"
2016,Mayo,Australia,36,4,2,,6,"(10.886611,-74.776708)"
2016,Mayo,Australia,36,9,9,,18,"(3.541112,-76.384584)"
2016,Mayo,Australia,36,230,166,,396,"(4.697144,-74.140516)"
2016,Mayo,Australia,36,25,16,,41,"(6.171601,-75.427454)"
2016,Mayo,Australia,36,4,3,,7,"(7.128456,-73.183637)"
2016,Mayo,Austria,40,2,1,,3,"(3.541112,-76.384584)"
2016,Mayo,Austria,40,39,35,,74,"(4.697144,-74.140516)"
2016,Mayo,Austria,40,4,0,,4,"(6.171601,-75.427454)"
2016,Mayo,Azerbaiyán,31,2,0,,2,"(3.541112,-76.384584)"
2016,Mayo,Bahamas,44,2,1,,3,"(10.445761,-75.516429)"
2016,Mayo,Bahamas,44,6,4,,10,"(3.541112,-76.384584)"
2016,Mayo,Bahamas,44,17,11,,28,"(4.697144,-74.140516)"
2016,Mayo,Bahamas,44,4,1,,5,"(4.815061,-75.736532)"
2016,Mayo,Bahamas,44,19,11,,30,"(6.171601,-75.427454)"
2016,Mayo,Bahréin,48,0,4,,4,"(4.697144,-74.140516)"
2016,Mayo,Bahréin,48,2,0,,2,"(6.171601,-75.427454)"
2016,Mayo,Bangladesh,50,1,2,,3,"(4.697144,-74.140516)"
2016,Mayo,Bangladesh,50,0,1,,1,"(6.171601,-75.427454)"
2016,Mayo,Bangladesh,50,0,1,,1,"(7.927209,-72.507910)"
2016,Mayo,Barbados,52,164,118,,282,"(4.697144,-74.140516)"
2016,Mayo,Bélgica,56,0,1,,1,"(10.886611,-74.776708)"
2016,Mayo,Bélgica,56,8,6,,14,"(3.541112,-76.384584)"
2016,Mayo,Bélgica,56,47,54,,101,"(4.697144,-74.140516)"
2016,Mayo,Bélgica,56,2,0,,2,"(4.815061,-75.736532)"
2016,Mayo,Bélgica,56,12,11,,23,"(6.171601,-75.427454)"
2016,Mayo,Belice,84,2,5,,7,"(3.541112,-76.384584)"
2016,Mayo,Belice,84,6,1,,7,"(4.697144,-74.140516)"
2016,Mayo,Belice,84,3,1,,4,"(6.171601,-75.427454)"
2016,Mayo,Bermudas/Territorio Británico de Ultramar,60,1,0,,1,"(4.697144,-74.140516)"
2016,Mayo,Bermudas/Territorio Británico de Ultramar,60,0,1,,1,"(6.171601,-75.427454)"
2016,Mayo,Bolivia,68,2,7,,9,"(0.814836,-77.662532)"
2016,Mayo,Bolivia,68,0,2,,2,"(10.445761,-75.516429)"
2016,Mayo,Bolivia,68,2,2,,4,"(10.886611,-74.776708)"
2016,Mayo,Bolivia,68,27,59,,86,"(3.541112,-76.384584)"
2016,Mayo,Bolivia,68,247,454,,701,"(4.697144,-74.140516)"
2016,Mayo,Bolivia,68,3,3,,6,"(4.815061,-75.736532)"
2016,Mayo,Bolivia,68,26,47,,73,"(6.171601,-75.427454)"
2016,Mayo,Bolivia,68,1,0,,1,"(7.128456,-73.183637)"
2016,Mayo,Brasil,76,123,229,,352,"(-4.197703,-69.941278)"
2016,Mayo,Brasil,76,3,12,,15,"(10.445761,-75.516429)"
2016,Mayo,Brasil,76,11,22,,33,"(10.886611,-74.776708)"
2016,Mayo,Brasil,76,0,3,,3,"(12.586067,-81.702563)"
2016,Mayo,Brasil,76,67,127,,194,"(3.541112,-76.384584)"
2016,Mayo,Brasil,76,2485,3134,,5619,"(4.697144,-74.140516)"
2016,Mayo,Brasil,76,11,15,,26,"(4.815061,-75.736532)"
2016,Mayo,Brasil,76,107,132,,239,"(6.171601,-75.427454)"
2016,Mayo,Brasil,76,2,3,,5,"(7.128456,-73.183637)"
2016,Mayo,Brasil,76,1,7,,8,"(7.927209,-72.507910)"
2016,Mayo,Bulgaria,100,5,6,,11,"(4.697144,-74.140516)"
2016,Mayo,Islas Caimán/Territorio Británico de Ultramar,136,1,1,,2,"(10.445761,-75.516429)"
2016,Mayo,Islas Caimán/Territorio Británico de Ultramar,136,1,0,,1,"(10.886611,-74.776708)"
2016,Mayo,Islas Caimán/Territorio Británico de Ultramar,136,5,0,,5,"(12.586067,-81.702563)"
2016,Mayo,Islas Caimán/Territorio Británico de Ultramar,136,1,0,,1,"(4.697144,-74.140516)"
2016,Mayo,Camboya,116,1,1,,2,"(4.697144,-74.140516)"
2016,Mayo,Camerún,120,0,1,,1,"(4.697144,-74.140516)"
2016,Mayo,Canadá,124,27,17,,44,"(10.445761,-75.516429)"
2016,Mayo,Canadá,124,29,31,,60,"(10.886611,-74.776708)"
2016,Mayo,Canadá,124,1,0,,1,"(12.586067,-81.702563)"
2016,Mayo,Canadá,124,153,90,,243,"(3.541112,-76.384584)"
2016,Mayo,Canadá,124,1,1,,2,"(4.452882,-75.766298)"
2016,Mayo,Canadá,124,1581,1287,,2868,"(4.697144,-74.140516)"
2016,Mayo,Canadá,124,8,9,,17,"(4.815061,-75.736532)"
2016,Mayo,Canadá,124,309,247,,556,"(6.171601,-75.427454)"
2016,Mayo,Canadá,124,3,6,,9,"(7.128456,-73.183637)"
2016,Mayo,Canadá,124,8,4,,12,"(7.927209,-72.507910)"
2016,Mayo,España,724,0,1,,1,"(0.814836,-77.662532)"
2016,Mayo,España,724,24,18,,42,"(10.445761,-75.516429)"
2016,Mayo,España,724,28,25,,53,"(10.886611,-74.776708)"
2016,Mayo,España,724,1,1,,2,"(12.586067,-81.702563)"
2016,Mayo,España,724,3525,2321,,5846,"(3.541112,-76.384584)"
2016,Mayo,España,724,10204,7872,,18076,"(4.697144,-74.140516)"
2016,Mayo,España,724,73,47,,120,"(4.815061,-75.736532)"
2016,Mayo,España,724,1562,1058,,2620,"(6.171601,-75.427454)"
2016,Mayo,España,724,17,17,,34,"(7.128456,-73.183637)"
2016,Mayo,España,724,2,3,,5,"(7.927209,-72.507910)"
2016,Mayo,Colombia,170,0,1,,1,"(10.445761,-75.516429)"
2016,Mayo,Colombia,170,58,185,,243,"(4.697144,-74.140516)"
2016,Mayo,República Del Congo,178,1,2,,3,"(4.697144,-74.140516)"
2016,Mayo,República de Corea,410,2,0,,2,"(3.541112,-76.384584)"
2016,Mayo,República de Corea,410,14,37,,51,"(4.697144,-74.140516)"
2016,Mayo,Costa de Marfil,384,4,0,,4,"(4.697144,-74.140516)"
2016,Mayo,Costa de Marfil,384,1,1,,2,"(6.171601,-75.427454)"
2016,Mayo,Costa Rica,188,11,11,,22,"(10.445761,-75.516429)"
2016,Mayo,Costa Rica,188,19,22,,41,"(10.886611,-74.776708)"
2016,Mayo,Costa Rica,188,2,40,,42,"(12.5744111,-81.703935)"
2016,Mayo,Costa Rica,188,14,10,,24,"(12.586067,-81.702563)"
2016,Mayo,Costa Rica,188,59,57,,116,"(3.541112,-76.384584)"
2016,Mayo,Costa Rica,188,739,1037,,1776,"(4.697144,-74.140516)"
2016,Mayo,Costa Rica,188,18,6,,24,"(4.815061,-75.736532)"
2016,Mayo,Costa Rica,188,161,145,,306,"(6.171601,-75.427454)"
2016,Mayo,Costa Rica,188,2,1,,3,"(7.128456,-73.183637)"
2016,Mayo,Costa Rica,188,1,1,,2,"(7.927209,-72.507910)"
2016,Mayo,Costa Rica,188,0,1,,1,"(8.635765,-77.346578)"
2016,Mayo,Croacia,191,8,6,,14,"(4.697144,-74.140516)"
2016,Mayo,Croacia,191,0,1,,1,"(6.171601,-75.427454)"
2016,Mayo,Cuba,192,11,11,,22,"(10.445761,-75.516429)"
2016,Mayo,Cuba,192,15,15,,30,"(10.886611,-74.776708)"
2016,Mayo,Cuba,192,0,1,,1,"(12.586067,-81.702563)"
2016,Mayo,Cuba,192,32,47,,79,"(3.541112,-76.384584)"
2016,Mayo,Cuba,192,938,1003,,1941,"(4.697144,-74.140516)"
2016,Mayo,Cuba,192,10,9,,19,"(4.815061,-75.736532)"
2016,Mayo,Cuba,192,133,99,,232,"(6.171601,-75.427454)"
2016,Mayo,Cuba,192,5,5,,10,"(7.128456,-73.183637)"
2016,Mayo,Cuba,192,3,1,,4,"(7.927209,-72.507910)"
2016,Mayo,Curazao,99999,0,1,,1,"(10.445761,-75.516429)"
2016,Mayo,Curazao,99999,22,71,,93,"(4.697144,-74.140516)"
2016,Mayo,República Checa,203,0,1,,1,"(3.541112,-76.384584)"
2016,Mayo,República Checa,203,8,7,,15,"(4.697144,-74.140516)"
2016,Mayo,República Checa,203,2,2,,4,"(6.171601,-75.427454)"
2016,Mayo,República Checa,203,0,1,,1,"(7.128456,-73.183637)"
2016,Mayo,Chile,152,242,247,,489,"(0.814836,-77.662532)"
2016,Mayo,Chile,152,17,15,,32,"(10.445761,-75.516429)"
2016,Mayo,Chile,152,18,18,,36,"(10.886611,-74.776708)"
2016,Mayo,Chile,152,8,2,,10,"(12.586067,-81.702563)"
2016,Mayo,Chile,152,406,320,,726,"(3.541112,-76.384584)"
2016,Mayo,Chile,152,3178,3207,,6385,"(4.697144,-74.140516)"
2016,Mayo,Chile,152,70,61,,131,"(4.815061,-75.736532)"
2016,Mayo,Chile,152,107,100,,207,"(6.171601,-75.427454)"
2016,Mayo,Chile,152,6,7,,13,"(7.128456,-73.183637)"
2016,Mayo,Chile,152,2,0,,2,"(7.927209,-72.507910)"
2016,Mayo,China,156,0,1,,1,"(10.445761,-75.516429)"
2016,Mayo,China,156,2,3,,5,"(10.886611,-74.776708)"
2016,Mayo,China,156,6,13,,19,"(3.541112,-76.384584)"
2016,Mayo,China,156,203,401,,604,"(4.697144,-74.140516)"
2016,Mayo,China,156,7,33,,40,"(6.171601,-75.427454)"
2016,Mayo,Chipre,196,1,1,,2,"(4.697144,-74.140516)"
2016,Mayo,Dinamarca,208,1,0,,1,"(10.445761,-75.516429)"
2016,Mayo,Dinamarca,208,1,0,,1,"(10.886611,-74.776708)"
2016,Mayo,Dinamarca,208,2,1,,3,"(3.541112,-76.384584)"
2016,Mayo,Dinamarca,208,39,23,,62,"(4.697144,-74.140516)"
2016,Mayo,Dinamarca,208,1,2,,3,"(6.171601,-75.427454)"
2016,Mayo,Ecuador,218,7,2,,9,"(-0.193180,-74.784874)"
2016,Mayo,Ecuador,218,373,606,,979,"(0.25129,-76.875963)"
2016,Mayo,Ecuador,218,13,10,,23,"(0.812436,-77.847006)"
2016,Mayo,Ecuador,218,4136,5257,,9393,"(0.814836,-77.662532)"
2016,Mayo,Ecuador,218,124,128,,252,"(1.813928,-78.763924)"
2016,Mayo,Ecuador,218,2,1,,3,"(10.445761,-75.516429)"
2016,Mayo,Ecuador,218,15,10,,25,"(10.886611,-74.776708)"
2016,Mayo,Ecuador,218,2,2,,4,"(12.586067,-81.702563)"
2016,Mayo,Ecuador,218,285,348,,633,"(3.541112,-76.384584)"
2016,Mayo,Ecuador,218,2369,3878,,6247,"(4.697144,-74.140516)"
2016,Mayo,Ecuador,218,1,8,,9,"(4.815061,-75.736532)"
2016,Mayo,Ecuador,218,35,47,,82,"(6.171601,-75.427454)"
2016,Mayo,Ecuador,218,0,1,,1,"(6.228046,-77.404104)"
2016,Mayo,Ecuador,218,1,4,,5,"(7.128456,-73.183637)"
2016,Mayo,Egipto,818,22,10,,32,"(4.697144,-74.140516)"
2016,Mayo,El Salvador,222,1,2,,3,"(10.445761,-75.516429)"
2016,Mayo,El Salvador,222,5,1,,6,"(10.886611,-74.776708)"
2016,Mayo,El Salvador,222,85,89,,174,"(3.541112,-76.384584)"
2016,Mayo,El Salvador,222,634,963,,1597,"(4.697144,-74.140516)"
2016,Mayo,El Salvador,222,60,110,,170,"(6.171601,-75.427454)"
2016,Mayo,Emiratos Árabes,784,1,1,,2,"(10.445761,-75.516429)"
2016,Mayo,Emiratos Árabes,784,1,1,,2,"(10.886611,-74.776708)"
2016,Mayo,Emiratos Árabes,784,4,2,,6,"(3.541112,-76.384584)"
2016,Mayo,Emiratos Árabes,784,53,181,,234,"(4.697144,-74.140516)"
2016,Mayo,Emiratos Árabes,784,5,7,,12,"(6.171601,-75.427454)"
2016,Mayo,Eritrea,232,1,0,,1,"(4.697144,-74.140516)"
2016,Mayo,Eslovaquia,703,0,1,,1,"(3.541112,-76.384584)"
2016,Mayo,Eslovaquia,703,1,0,,1,"(4.697144,-74.140516)"
2016,Mayo,Eslovenia,705,2,1,,3,"(4.697144,-74.140516)"
2016,Mayo,Estados Unidos de América,840,0,1,,1,"(10.433609,-73.247863)"
2016,Mayo,Estados Unidos de América,840,3148,2458,,5606,"(10.445761,-75.516429)"
2016,Mayo,Estados Unidos de América,840,2578,2096,,4674,"(10.886611,-74.776708)"
2016,Mayo,Estados Unidos de América,840,5,2,,7,"(11.117806,-74.232622)"
2016,Mayo,Estados Unidos de América,840,38,39,,77,"(12.586067,-81.702563)"
2016,Mayo,Estados Unidos de América,840,5434,3647,,9081,"(3.541112,-76.384584)"
2016,Mayo,Estados Unidos de América,840,818,626,,1444,"(4.452882,-75.766298)"
2016,Mayo,Estados Unidos de América,840,33706,30283,,63989,"(4.697144,-74.140516)"
2016,Mayo,Estados Unidos de América,840,1061,673,,1734,"(4.815061,-75.736532)"
2016,Mayo,Estados Unidos de América,840,10429,7993,,18422,"(6.171601,-75.427454)"
2016,Mayo,Estados Unidos de América,840,193,160,,353,"(7.128456,-73.183637)"
2016,Mayo,Estados Unidos de América,840,69,61,,130,"(7.927209,-72.507910)"
2016,Mayo,Etiopia,231,1,1,,2,"(4.697144,-74.140516)"
2016,Mayo,Finlandia,246,1,1,,2,"(3.541112,-76.384584)"
2016,Mayo,Finlandia,246,5,10,,15,"(4.697144,-74.140516)"
2016,Mayo,Finlandia,246,1,0,,1,"(6.171601,-75.427454)"
2016,Mayo,Francia,250,4,6,,10,"(10.445761,-75.516429)"
2016,Mayo,Francia,250,3,4,,7,"(10.886611,-74.776708)"
2016,Mayo,Francia,250,111,83,,194,"(3.541112,-76.384584)"
2016,Mayo,Francia,250,1709,1552,,3261,"(4.697144,-74.140516)"
2016,Mayo,Francia,250,5,5,,10,"(4.815061,-75.736532)"
2016,Mayo,Francia,250,77,45,,122,"(6.171601,-75.427454)"
2016,Mayo,Francia,250,0,1,,1,"(7.128456,-73.183637)"
2016,Mayo,Francia,250,0,2,,2,"(7.927209,-72.507910)"
2016,Mayo,Georgia,268,1,2,,3,"(4.697144,-74.140516)"
2016,Mayo,Ghana,288,1,0,,1,"(3.541112,-76.384584)"
2016,Mayo,Ghana,288,0,1,,1,"(4.697144,-74.140516)"
2016,Mayo,Gibraltar/Territorio Británico de Ultramar,292,1,2,,3,"(0.814836,-77.662532)"
2016,Mayo,Granada,308,0,2,,2,"(4.697144,-74.140516)"
2016,Mayo,Grecia,300,3,4,,7,"(3.541112,-76.384584)"
2016,Mayo,Grecia,300,51,25,,76,"(4.697144,-74.140516)"
2016,Mayo,Grecia,300,2,3,,5,"(6.171601,-75.427454)"
2016,Mayo,Guatemala,320,5,1,,6,"(10.445761,-75.516429)"
2016,Mayo,Guatemala,320,1,6,,7,"(10.886611,-74.776708)"
2016,Mayo,Guatemala,320,55,66,,121,"(3.541112,-76.384584)"
2016,Mayo,Guatemala,320,566,612,,1178,"(4.697144,-74.140516)"
2016,Mayo,Guatemala,320,7,9,,16,"(4.815061,-75.736532)"
2016,Mayo,Guatemala,320,80,153,,233,"(6.171601,-75.427454)"
2016,Mayo,Guatemala,320,6,7,,13,"(7.128456,-73.183637)"
2016,Mayo,Guatemala,320,1,1,,2,"(7.927209,-72.507910)"
2016,Mayo,Guyana,328,0,3,,3,"(10.408582,-75.538003)"
2016,Mayo,Guyana,328,1,0,,1,"(10.886611,-74.776708)"
2016,Mayo,Guyana,328,0,1,,1,"(3.541112,-76.384584)"
2016,Mayo,Guyana,328,2,2,,4,"(4.697144,-74.140516)"
2016,Mayo,Guinea,324,2,1,,3,"(4.697144,-74.140516)"
2016,Mayo,Guinea Ecuatorial,226,1,1,,2,"(4.697144,-74.140516)"
2016,Mayo,Guadalupe/Territorio Francés,312,1,0,,1,"(4.697144,-74.140516)"
2016,Mayo,Guayana Francesa/Departamento de Ultramar Francés,254,0,2,,2,"(10.408582,-75.538003)"
2016,Mayo,Guayana Francesa/Departamento de Ultramar Francés,254,0,1,,1,"(4.697144,-74.140516)"
2016,Mayo,Haití,332,0,1,,1,"(10.445761,-75.516429)"
2016,Mayo,Haití,332,0,5,,5,"(10.886611,-74.776708)"
2016,Mayo,Haití,332,0,1,,1,"(3.541112,-76.384584)"
2016,Mayo,Haití,332,6,9,,15,"(4.697144,-74.140516)"
2016,Mayo,Haití,332,1,1,,2,"(4.815061,-75.736532)"
2016,Mayo,Haití,332,1,5,,6,"(6.171601,-75.427454)"
2016,Mayo,Haití,332,2,1,,3,"(7.128456,-73.183637)"
2016,Mayo,Honduras,340,1,5,,6,"(10.445761,-75.516429)"
2016,Mayo,Honduras,340,2,7,,9,"(10.886611,-74.776708)"
2016,Mayo,Honduras,340,0,4,,4,"(12.5744111,-81.703935)"
2016,Mayo,Honduras,340,12,19,,31,"(3.541112,-76.384584)"
2016,Mayo,Honduras,340,61,164,,225,"(4.697144,-74.140516)"
2016,Mayo,Honduras,340,3,2,,5,"(4.815061,-75.736532)"
2016,Mayo,Honduras,340,23,63,,86,"(6.171601,-75.427454)"
2016,Mayo,Honduras,340,2,1,,3,"(7.128456,-73.183637)"
2016,Mayo,Honduras,340,0,1,,1,"(7.927209,-72.507910)"
2016,Mayo,Hong Kong,344,24,41,,65,"(4.697144,-74.140516)"
2016,Mayo,Hong Kong,344,4,2,,6,"(6.171601,-75.427454)"
2016,Mayo,Hungría,348,5,2,,7,"(4.697144,-74.140516)"
2016,Mayo,Hungría,348,1,0,,1,"(6.171601,-75.427454)"
2016,Mayo,India,356,0,1,,1,"(10.886611,-74.776708)"
2016,Mayo,India,356,4,3,,7,"(3.541112,-76.384584)"
2016,Mayo,India,356,26,14,,40,"(4.697144,-74.140516)"
2016,Mayo,India,356,0,1,,1,"(4.815061,-75.736532)"
2016,Mayo,India,356,2,1,,3,"(6.171601,-75.427454)"
2016,Mayo,Indonesia,360,5,2,,7,"(4.697144,-74.140516)"
2016,Mayo,Iraq,368,0,3,,3,"(4.697144,-74.140516)"
2016,Mayo,Iraq,368,0,1,,1,"(4.815061,-75.736532)"
2016,Mayo,Irán,364,0,3,,3,"(4.697144,-74.140516)"
2016,Mayo,República de Irlanda,372,17,11,,28,"(4.697144,-74.140516)"
2016,Mayo,República de Irlanda,372,1,1,,2,"(6.171601,-75.427454)"
2016,Mayo,Islandia,352,2,1,,3,"(4.697144,-74.140516)"
2016,Mayo,Islandia,352,1,0,,1,"(6.171601,-75.427454)"
2016,Mayo,Israel,376,1,0,,1,"(10.445761,-75.516429)"
2016,Mayo,Israel,376,4,5,,9,"(3.541112,-76.384584)"
2016,Mayo,Israel,376,89,115,,204,"(4.697144,-74.140516)"
2016,Mayo,Israel,376,7,5,,12,"(6.171601,-75.427454)"
2016,Mayo,Italia,380,5,2,,7,"(10.445761,-75.516429)"
2016,Mayo,Italia,380,5,8,,13,"(10.886611,-74.776708)"
2016,Mayo,Italia,380,170,91,,261,"(3.541112,-76.384584)"
2016,Mayo,Italia,380,621,503,,1124,"(4.697144,-74.140516)"
2016,Mayo,Italia,380,5,2,,7,"(4.815061,-75.736532)"
2016,Mayo,Italia,380,94,58,,152,"(6.171601,-75.427454)"
2016,Mayo,Italia,380,3,2,,5,"(7.128456,-73.183637)"
2016,Mayo,Italia,380,0,1,,1,"(7.927209,-72.507910)"
2016,Mayo,Jamaica,388,1,6,,7,"(10.445761,-75.516429)"
2016,Mayo,Jamaica,388,8,0,,8,"(10.886611,-74.776708)"
2016,Mayo,Jamaica,388,4,4,,8,"(3.541112,-76.384584)"
2016,Mayo,Jamaica,388,36,21,,57,"(4.697144,-74.140516)"
2016,Mayo,Jamaica,388,8,4,,12,"(4.815061,-75.736532)"
2016,Mayo,Jamaica,388,13,4,,17,"(6.171601,-75.427454)"
2016,Mayo,Jamaica,388,1,0,,1,"(7.128456,-73.183637)"
2016,Mayo,Japón,392,1,1,,2,"(10.886611,-74.776708)"
2016,Mayo,Japón,392,3,1,,4,"(3.541112,-76.384584)"
2016,Mayo,Japón,392,53,56,,109,"(4.697144,-74.140516)"
2016,Mayo,Japón,392,6,5,,11,"(6.171601,-75.427454)"
2016,Mayo,Jordania,400,1,6,,7,"(4.697144,-74.140516)"
2016,Mayo,Kazajistán,398,0,1,,1,"(3.541112,-76.384584)"
2016,Mayo,Kazajistán,398,2,3,,5,"(4.697144,-74.140516)"
2016,Mayo,Kenia,404,5,4,,9,"(4.697144,-74.140516)"
2016,Mayo,Kuwait,414,1,0,,1,"(4.697144,-74.140516)"
2016,Mayo,República Democrática Popular  Lao,418,0,2,,2,"(4.697144,-74.140516)"
2016,Mayo,Letonia,428,0,1,,1,"(4.697144,-74.140516)"
2016,Mayo,Lituania,440,0,2,,2,"(4.697144,-74.140516)"
2016,Mayo,Líbano,422,1,0,,1,"(3.541112,-76.384584)"
2016,Mayo,Líbano,422,27,31,,58,"(4.697144,-74.140516)"
2016,Mayo,Luxemburgo,442,1,0,,1,"(3.541112,-76.384584)"
2016,Mayo,Luxemburgo,442,5,1,,6,"(4.697144,-74.140516)"
2016,Mayo,Malasia,458,6,9,,15,"(4.697144,-74.140516)"
2016,Mayo,Malasia,458,1,2,,3,"(6.171601,-75.427454)"
2016,Mayo,Malta,470,12,6,,18,"(4.697144,-74.140516)"
2016,Mayo,Malta,470,0,1,,1,"(6.171601,-75.427454)"
2016,Mayo,Malta,470,0,1,,1,"(7.927209,-72.507910)"
2016,Mayo,Marruecos,504,2,1,,3,"(3.541112,-76.384584)"
2016,Mayo,Marruecos,504,9,4,,13,"(4.697144,-74.140516)"
2016,Mayo,Marruecos,504,2,0,,2,"(6.171601,-75.427454)"
2016,Mayo,Martinica/Departamento de Ultramar Francés,474,1,1,,2,"(4.697144,-74.140516)"
2016,Mayo,México,484,0,15,,15,"(10.408582,-75.538003)"
2016,Mayo,México,484,50,47,,97,"(10.445761,-75.516429)"
2016,Mayo,México,484,150,123,,273,"(10.886611,-74.776708)"
2016,Mayo,México,484,4,3,,7,"(12.586067,-81.702563)"
2016,Mayo,México,484,649,562,,1211,"(3.541112,-76.384584)"
2016,Mayo,México,484,11099,10230,,21329,"(4.697144,-74.140516)"
2016,Mayo,México,484,173,153,,326,"(4.815061,-75.736532)"
2016,Mayo,México,484,1673,1455,,3128,"(6.171601,-75.427454)"
2016,Mayo,México,484,161,105,,266,"(7.128456,-73.183637)"
2016,Mayo,México,484,27,17,,44,"(7.927209,-72.507910)"
2016,Mayo,México,484,0,1,,1,"(8.635765,-77.346578)"
2016,Mayo,Mónaco,492,1,0,,1,"(3.541112,-76.384584)"
2016,Mayo,Mónaco,492,1,0,,1,"(4.697144,-74.140516)"
2016,Mayo,Mozambique,508,0,1,,1,"(4.697144,-74.140516)"
2016,Mayo,Namibia,516,0,1,,1,"(4.697144,-74.140516)"
2016,Mayo,Nepal,524,1,0,,1,"(4.697144,-74.140516)"
2016,Mayo,Nicaragua,558,0,3,,3,"(10.445761,-75.516429)"
2016,Mayo,Nicaragua,558,3,5,,8,"(10.886611,-74.776708)"
2016,Mayo,Nicaragua,558,0,2,,2,"(12.5744111,-81.703935)"
2016,Mayo,Nicaragua,558,0,2,,2,"(12.586067,-81.702563)"
2016,Mayo,Nicaragua,558,12,36,,48,"(3.541112,-76.384584)"
2016,Mayo,Nicaragua,558,30,48,,78,"(4.697144,-74.140516)"
2016,Mayo,Nicaragua,558,4,9,,13,"(4.815061,-75.736532)"
2016,Mayo,Nicaragua,558,14,42,,56,"(6.171601,-75.427454)"
2016,Mayo,Nigeria,566,2,5,,7,"(4.697144,-74.140516)"
2016,Mayo,Noruega,578,0,1,,1,"(10.445761,-75.516429)"
2016,Mayo,Noruega,578,2,1,,3,"(3.541112,-76.384584)"
2016,Mayo,Noruega,578,16,19,,35,"(4.697144,-74.140516)"
2016,Mayo,Noruega,578,2,0,,2,"(6.171601,-75.427454)"
2016,Mayo,Nueva Caledonia/Territorio francés,540,1,0,,1,"(4.697144,-74.140516)"
2016,Mayo,Nueva Zelanda,554,1,1,,2,"(3.541112,-76.384584)"
2016,Mayo,Nueva Zelanda,554,18,15,,33,"(4.697144,-74.140516)"
2016,Mayo,Nueva Zelanda,554,0,1,,1,"(6.171601,-75.427454)"
2016,Mayo,Omán,512,0,2,,2,"(4.697144,-74.140516)"
2016,Mayo,Omán,512,1,0,,1,"(4.815061,-75.736532)"
2016,Mayo,Omán,512,0,1,,1,"(6.171601,-75.427454)"
2016,Mayo,Pakistán,586,0,2,,2,"(4.697144,-74.140516)"
2016,Mayo,Panamá,591,5,133,,138,"(10.408582,-75.538003)"
2016,Mayo,Panamá,591,442,461,,903,"(10.445761,-75.516429)"
2016,Mayo,Panamá,591,735,774,,1509,"(10.886611,-74.776708)"
2016,Mayo,Panamá,591,0,1,,1,"(10.971302,-74.765397)"
2016,Mayo,Panamá,591,1,5,,6,"(11.117806,-74.232622)"
2016,Mayo,Panamá,591,0,8,,8,"(12.5744111,-81.703935)"
2016,Mayo,Panamá,591,140,155,,295,"(12.586067,-81.702563)"
2016,Mayo,Panamá,591,1606,1500,,3106,"(3.541112,-76.384584)"
2016,Mayo,Panamá,591,259,169,,428,"(4.452882,-75.766298)"
2016,Mayo,Panamá,591,7982,8890,,16872,"(4.697144,-74.140516)"
2016,Mayo,Panamá,591,686,527,,1213,"(4.815061,-75.736532)"
2016,Mayo,Panamá,591,3295,3081,,6376,"(6.171601,-75.427454)"
2016,Mayo,Panamá,591,1,1,,2,"(6.228046,-77.404104)"
2016,Mayo,Panamá,591,4,2,,6,"(7.102626,-77.762647)"
2016,Mayo,Panamá,591,185,218,,403,"(7.128456,-73.183637)"
2016,Mayo,Panamá,591,125,106,,231,"(7.927209,-72.507910)"
2016,Mayo,Panamá,591,0,23,,23,"(8.066966,-76.735404)"
2016,Mayo,Panamá,591,21,69,,90,"(8.635765,-77.346578)"
2016,Mayo,Paraguay,600,2,3,,5,"(10.445761,-75.516429)"
2016,Mayo,Paraguay,600,2,1,,3,"(10.886611,-74.776708)"
2016,Mayo,Paraguay,600,1,1,,2,"(12.586067,-81.702563)"
2016,Mayo,Paraguay,600,10,22,,32,"(3.541112,-76.384584)"
2016,Mayo,Paraguay,600,47,144,,191,"(4.697144,-74.140516)"
2016,Mayo,Paraguay,600,3,10,,13,"(4.815061,-75.736532)"
2016,Mayo,Paraguay,600,14,20,,34,"(6.171601,-75.427454)"
2016,Mayo,Paraguay,600,0,1,,1,"(7.128456,-73.183637)"
2016,Mayo,Perú,604,2,2,,4,"(-0.193180,-74.784874)"
2016,Mayo,Perú,604,46,101,,147,"(-4.197703,-69.941278)"
2016,Mayo,Perú,604,92,115,,207,"(0.814836,-77.662532)"
2016,Mayo,Perú,604,5,4,,9,"(10.445761,-75.516429)"
2016,Mayo,Perú,604,17,17,,34,"(10.886611,-74.776708)"
2016,Mayo,Perú,604,209,268,,477,"(3.541112,-76.384584)"
2016,Mayo,Perú,604,4446,5497,,9943,"(4.697144,-74.140516)"
2016,Mayo,Perú,604,5,8,,13,"(4.815061,-75.736532)"
2016,Mayo,Perú,604,300,350,,650,"(6.171601,-75.427454)"
2016,Mayo,Perú,604,8,2,,10,"(7.128456,-73.183637)"
2016,Mayo,Palestina,99999,0,1,,1,"(4.697144,-74.140516)"
2016,Mayo,Polonia,616,0,1,,1,"(10.886611,-74.776708)"
2016,Mayo,Polonia,616,1,2,,3,"(3.541112,-76.384584)"
2016,Mayo,Polonia,616,6,16,,22,"(4.697144,-74.140516)"
2016,Mayo,Polonia,616,1,0,,1,"(6.171601,-75.427454)"
2016,Mayo,Portugal,620,1,0,,1,"(10.445761,-75.516429)"
2016,Mayo,Portugal,620,5,4,,9,"(3.541112,-76.384584)"
2016,Mayo,Portugal,620,85,129,,214,"(4.697144,-74.140516)"
2016,Mayo,Portugal,620,8,9,,17,"(6.171601,-75.427454)"
2016,Mayo,Polinesia Francesa/Colectividad de Ultramar Francesa,258,0,2,,2,"(4.697144,-74.140516)"
2016,Mayo,Puerto Rico/Territorio de Estados Unidos,630,6,5,,11,"(10.445761,-75.516429)"
2016,Mayo,Puerto Rico/Territorio de Estados Unidos,630,23,13,,36,"(10.886611,-74.776708)"
2016,Mayo,Puerto Rico/Territorio de Estados Unidos,630,44,25,,69,"(3.541112,-76.384584)"
2016,Mayo,Puerto Rico/Territorio de Estados Unidos,630,578,510,,1088,"(4.697144,-74.140516)"
2016,Mayo,Puerto Rico/Territorio de Estados Unidos,630,5,2,,7,"(4.815061,-75.736532)"
2016,Mayo,Puerto Rico/Territorio de Estados Unidos,630,39,38,,77,"(6.171601,-75.427454)"
2016,Mayo,Puerto Rico/Territorio de Estados Unidos,630,6,5,,11,"(7.128456,-73.183637)"
2016,Mayo,Puerto Rico/Territorio de Estados Unidos,630,1,1,,2,"(7.927209,-72.507910)"
2016,Mayo,Qatar,634,4,3,,7,"(4.697144,-74.140516)"
2016,Mayo,Qatar,634,1,2,,3,"(6.171601,-75.427454)"
2016,Mayo,Reino Unido de Gran Bretaña e Irlanda del Norte,826,11,23,,34,"(10.445761,-75.516429)"
2016,Mayo,Reino Unido de Gran Bretaña e Irlanda del Norte,826,3,2,,5,"(10.886611,-74.776708)"
2016,Mayo,Reino Unido de Gran Bretaña e Irlanda del Norte,826,28,27,,55,"(3.541112,-76.384584)"
2016,Mayo,Reino Unido de Gran Bretaña e Irlanda del Norte,826,1480,1207,,2687,"(4.697144,-74.140516)"
2016,Mayo,Reino Unido de Gran Bretaña e Irlanda del Norte,826,2,3,,5,"(4.815061,-75.736532)"
2016,Mayo,Reino Unido de Gran Bretaña e Irlanda del Norte,826,13,8,,21,"(6.171601,-75.427454)"
2016,Mayo,República CentroÁfricana,140,1,2,,3,"(4.697144,-74.140516)"
2016,Mayo,Federación de Rusia,643,0,3,,3,"(3.541112,-76.384584)"
2016,Mayo,Federación de Rusia,643,26,41,,67,"(4.697144,-74.140516)"
2016,Mayo,Federación de Rusia,643,6,2,,8,"(6.171601,-75.427454)"
2016,Mayo,República Dominicana,214,11,17,,28,"(10.445761,-75.516429)"
2016,Mayo,República Dominicana,214,39,40,,79,"(10.886611,-74.776708)"
2016,Mayo,República Dominicana,214,16,2,,18,"(11.117806,-74.232622)"
2016,Mayo,República Dominicana,214,121,86,,207,"(3.541112,-76.384584)"
2016,Mayo,República Dominicana,214,2390,2170,,4560,"(4.697144,-74.140516)"
2016,Mayo,República Dominicana,214,57,53,,110,"(4.815061,-75.736532)"
2016,Mayo,República Dominicana,214,273,231,,504,"(6.171601,-75.427454)"
2016,Mayo,República Dominicana,214,53,42,,95,"(7.128456,-73.183637)"
2016,Mayo,República Dominicana,214,11,7,,18,"(7.927209,-72.507910)"
2016,Mayo,República Democrática Popular de Corea,408,1,4,,5,"(4.697144,-74.140516)"
2016,Mayo,Rumania,642,5,9,,14,"(4.697144,-74.140516)"
2016,Mayo,San  Vicente y las Granadinas,670,3,4,,7,"(10.445761,-75.516429)"
2016,Mayo,Santa Lucia,662,0,1,,1,"(4.697144,-74.140516)"
2016,Mayo,Singapur,702,0,1,,1,"(10.886611,-74.776708)"
2016,Mayo,Singapur,702,11,9,,20,"(4.697144,-74.140516)"
2016,Mayo,República Árabe Siria,760,0,1,,1,"(4.697144,-74.140516)"
2016,Mayo,Sri Lanka,144,1,0,,1,"(4.697144,-74.140516)"
2016,Mayo,Sudáfrica,710,6,9,,15,"(4.697144,-74.140516)"
2016,Mayo,Sudáfrica,710,1,0,,1,"(6.171601,-75.427454)"
2016,Mayo,Sudán,736,0,1,,1,"(3.541112,-76.384584)"
2016,Mayo,Sudán,736,0,1,,1,"(4.697144,-74.140516)"
2016,Mayo,Suecia,752,1,0,,1,"(10.886611,-74.776708)"
2016,Mayo,Suecia,752,17,11,,28,"(3.541112,-76.384584)"
2016,Mayo,Suecia,752,79,51,,130,"(4.697144,-74.140516)"
2016,Mayo,Suecia,752,6,5,,11,"(6.171601,-75.427454)"
2016,Mayo,Suiza,756,1,1,,2,"(10.445761,-75.516429)"
2016,Mayo,Suiza,756,2,3,,5,"(10.886611,-74.776708)"
2016,Mayo,Suiza,756,51,27,,78,"(3.541112,-76.384584)"
2016,Mayo,Suiza,756,238,174,,412,"(4.697144,-74.140516)"
2016,Mayo,Suiza,756,0,1,,1,"(4.815061,-75.736532)"
2016,Mayo,Suiza,756,24,18,,42,"(6.171601,-75.427454)"
2016,Mayo,Surinam,740,1,5,,6,"(4.697144,-74.140516)"
2016,Mayo,Taiwán,158,11,9,,20,"(4.697144,-74.140516)"
2016,Mayo,Taiwán,158,0,1,,1,"(6.171601,-75.427454)"
2016,Mayo,Tailandia,764,1,0,,1,"(3.541112,-76.384584)"
2016,Mayo,Tailandia,764,19,21,,40,"(4.697144,-74.140516)"
2016,Mayo,Tanzania,834,1,1,,2,"(4.697144,-74.140516)"
2016,Mayo,Togo,768,0,1,,1,"(6.171601,-75.427454)"
2016,Mayo,Trinidad y Tobago,780,0,1,,1,"(10.408582,-75.538003)"
2016,Mayo,Trinidad y Tobago,780,2,2,,4,"(10.445761,-75.516429)"
2016,Mayo,Trinidad y Tobago,780,0,8,,8,"(10.886611,-74.776708)"
2016,Mayo,Trinidad y Tobago,780,4,8,,12,"(3.541112,-76.384584)"
2016,Mayo,Trinidad y Tobago,780,23,21,,44,"(4.697144,-74.140516)"
2016,Mayo,Trinidad y Tobago,780,4,3,,7,"(4.815061,-75.736532)"
2016,Mayo,Trinidad y Tobago,780,1,6,,7,"(6.171601,-75.427454)"
2016,Mayo,Trinidad y Tobago,780,1,2,,3,"(7.128456,-73.183637)"
2016,Mayo,Trinidad y Tobago,780,4,1,,5,"(7.927209,-72.507910)"
2016,Mayo,Túnez,788,2,0,,2,"(4.697144,-74.140516)"
2016,Mayo,Túnez,788,0,1,,1,"(6.171601,-75.427454)"
2016,Mayo,Turquía,792,1,0,,1,"(10.445761,-75.516429)"
2016,Mayo,Turquía,792,1,1,,2,"(10.886611,-74.776708)"
2016,Mayo,Turquía,792,1,1,,2,"(3.541112,-76.384584)"
2016,Mayo,Turquía,792,373,357,,730,"(4.697144,-74.140516)"
2016,Mayo,Turquía,792,5,6,,11,"(6.171601,-75.427454)"
2016,Mayo,Turkmenistán,795,1,2,,3,"(4.697144,-74.140516)"
2016,Mayo,Ucrania,804,1,2,,3,"(4.697144,-74.140516)"
2016,Mayo,Uruguay,858,1,0,,1,"(10.445761,-75.516429)"
2016,Mayo,Uruguay,858,0,2,,2,"(10.886611,-74.776708)"
2016,Mayo,Uruguay,858,16,11,,27,"(3.541112,-76.384584)"
2016,Mayo,Uruguay,858,50,93,,143,"(4.697144,-74.140516)"
2016,Mayo,Uruguay,858,1,0,,1,"(4.815061,-75.736532)"
2016,Mayo,Uruguay,858,12,20,,32,"(6.171601,-75.427454)"
2016,Mayo,Venezuela,862,8,5,,13,"(10.445761,-75.516429)"
2016,Mayo,Venezuela,862,15,24,,39,"(10.886611,-74.776708)"
2016,Mayo,Venezuela,862,1,0,,1,"(11.117806,-74.232622)"
2016,Mayo,Venezuela,862,66,76,,142,"(11.360009,-72.129330)"
2016,Mayo,Venezuela,862,11,16,,27,"(3.541112,-76.384584)"
2016,Mayo,Venezuela,862,1,1,,2,"(3.866713,-67.927521)"
2016,Mayo,Venezuela,862,1475,1645,,3120,"(4.697144,-74.140516)"
2016,Mayo,Venezuela,862,4,2,,6,"(4.815061,-75.736532)"
2016,Mayo,Venezuela,862,166,187,,353,"(6.171601,-75.427454)"
2016,Mayo,Venezuela,862,3,6,,9,"(6.185799,-67.483929)"
2016,Mayo,Venezuela,862,7,22,,29,"(7.088729,-70.740253)"
2016,Mayo,Venezuela,862,1,0,,1,"(7.128456,-73.183637)"
2016,Mayo,Venezuela,862,250,273,,523,"(7.818934,-72.453226)"
2016,Mayo,Vietnam,704,1,6,,7,"(4.697144,-74.140516)"
2016,Mayo,Islas Vírgenes Británicas/Territorio Británico de Ultramar,92,0,1,,1,"(10.445761,-75.516429)"
2016,Mayo,Islas Vírgenes Británicas/Territorio Británico de Ultramar,92,1,0,,1,"(4.697144,-74.140516)"
2016,Mayo,Islas Vírgenes Estadounidenses/Territorio de Estados Unidos,850,0,5,,5,"(4.697144,-74.140516)"
2016,Junio,Afganistán,4,0,7,,7,"(4.697144,-74.140516)"
2016,Junio,Albania,8,0,1,,1,"(10.886611,-74.776708)"
2016,Junio,Alemania,276,9,4,,13,"(10.445761,-75.516429)"
2016,Junio,Alemania,276,22,20,,42,"(10.886611,-74.776708)"
2016,Junio,Alemania,276,93,67,,160,"(3.541112,-76.384584)"
2016,Junio,Alemania,276,1827,1647,,3474,"(4.697144,-74.140516)"
2016,Junio,Alemania,276,1,2,,3,"(4.815061,-75.736532)"
2016,Junio,Alemania,276,115,74,,189,"(6.171601,-75.427454)"
2016,Junio,Alemania,276,1,1,,2,"(7.927209,-72.507910)"
2016,Junio,Andorra,20,1,0,,1,"(4.697144,-74.140516)"
2016,Junio,Angola,24,2,10,,12,"(4.697144,-74.140516)"
2016,Junio,Antigua y Barbuda,28,2,4,,6,"(4.697144,-74.140516)"
2016,Junio,Países Bajos,528,10,10,,20,"(10.445761,-75.516429)"
2016,Junio,Países Bajos,528,138,95,,233,"(10.886611,-74.776708)"
2016,Junio,Países Bajos,528,261,188,,449,"(3.541112,-76.384584)"
2016,Junio,Países Bajos,528,1071,872,,1943,"(4.697144,-74.140516)"
2016,Junio,Países Bajos,528,14,5,,19,"(4.815061,-75.736532)"
2016,Junio,Países Bajos,528,209,137,,346,"(6.171601,-75.427454)"
2016,Junio,Países Bajos,528,4,1,,5,"(7.128456,-73.183637)"
2016,Junio,Países Bajos,528,9,5,,14,"(7.927209,-72.507910)"
2016,Junio,Arabia Saudita,682,1,1,,2,"(10.886611,-74.776708)"
2016,Junio,Arabia Saudita,682,9,25,,34,"(4.697144,-74.140516)"
2016,Junio,Arabia Saudita,682,1,0,,1,"(6.171601,-75.427454)"
2016,Junio,Argelia,12,2,2,,4,"(4.697144,-74.140516)"
2016,Junio,Argentina,32,9,18,,27,"(0.814836,-77.662532)"
2016,Junio,Argentina,32,6,6,,12,"(10.445761,-75.516429)"
2016,Junio,Argentina,32,14,10,,24,"(10.886611,-74.776708)"
2016,Junio,Argentina,32,15,6,,21,"(12.586067,-81.702563)"
2016,Junio,Argentina,32,121,107,,228,"(3.541112,-76.384584)"
2016,Junio,Argentina,32,2505,2302,,4807,"(4.697144,-74.140516)"
2016,Junio,Argentina,32,7,16,,23,"(4.815061,-75.736532)"
2016,Junio,Argentina,32,68,88,,156,"(6.171601,-75.427454)"
2016,Junio,Argentina,32,6,6,,12,"(7.128456,-73.183637)"
2016,Junio,Argentina,32,1,3,,4,"(7.927209,-72.507910)"
2016,Junio,República de Armenia,51,0,1,,1,"(4.697144,-74.140516)"
2016,Junio,Aruba,533,15,20,,35,"(10.445761,-75.516429)"
2016,Junio,Aruba,533,87,63,,150,"(10.886611,-74.776708)"
2016,Junio,Aruba,533,0,1,,1,"(11.247723,-74.213989)"
2016,Junio,Aruba,533,66,58,,124,"(3.541112,-76.384584)"
2016,Junio,Aruba,533,2161,1605,,3766,"(4.697144,-74.140516)"
2016,Junio,Aruba,533,18,14,,32,"(4.815061,-75.736532)"
2016,Junio,Aruba,533,247,217,,464,"(6.171601,-75.427454)"
2016,Junio,Aruba,533,33,64,,97,"(7.128456,-73.183637)"
2016,Junio,Aruba,533,20,21,,41,"(7.927209,-72.507910)"
2016,Junio,Australia,36,2,1,,3,"(10.886611,-74.776708)"
2016,Junio,Australia,36,20,14,,34,"(3.541112,-76.384584)"
2016,Junio,Australia,36,285,236,,521,"(4.697144,-74.140516)"
2016,Junio,Australia,36,1,1,,2,"(4.815061,-75.736532)"
2016,Junio,Australia,36,36,37,,73,"(6.171601,-75.427454)"
2016,Junio,Australia,36,5,2,,7,"(7.128456,-73.183637)"
2016,Junio,Austria,40,2,5,,7,"(10.886611,-74.776708)"
2016,Junio,Austria,40,3,6,,9,"(3.541112,-76.384584)"
2016,Junio,Austria,40,46,30,,76,"(4.697144,-74.140516)"
2016,Junio,Austria,40,0,1,,1,"(4.815061,-75.736532)"
2016,Junio,Austria,40,2,3,,5,"(6.171601,-75.427454)"
2016,Junio,Azerbaiyán,31,2,2,,4,"(4.697144,-74.140516)"
2016,Junio,Bahamas,44,2,3,,5,"(10.445761,-75.516429)"
2016,Junio,Bahamas,44,2,4,,6,"(10.886611,-74.776708)"
2016,Junio,Bahamas,44,1,5,,6,"(12.586067,-81.702563)"
2016,Junio,Bahamas,44,7,2,,9,"(3.541112,-76.384584)"
2016,Junio,Bahamas,44,12,18,,30,"(4.697144,-74.140516)"
2016,Junio,Bahamas,44,1,1,,2,"(4.815061,-75.736532)"
2016,Junio,Bahamas,44,43,34,,77,"(6.171601,-75.427454)"
2016,Junio,Bahamas,44,4,3,,7,"(7.128456,-73.183637)"
2016,Junio,Bahamas,44,3,4,,7,"(7.927209,-72.507910)"
2016,Junio,Bahréin,48,2,0,,2,"(10.445761,-75.516429)"
2016,Junio,Bahréin,48,1,0,,1,"(12.586067,-81.702563)"
2016,Junio,Bahréin,48,1,2,,3,"(4.697144,-74.140516)"
2016,Junio,Bahréin,48,0,1,,1,"(6.171601,-75.427454)"
2016,Junio,Barbados,52,120,109,,229,"(4.697144,-74.140516)"
2016,Junio,Barbados,52,0,1,,1,"(6.171601,-75.427454)"
2016,Junio,República de Belarús,112,2,1,,3,"(4.697144,-74.140516)"
2016,Junio,Bélgica,56,19,11,,30,"(3.541112,-76.384584)"
2016,Junio,Bélgica,56,0,1,,1,"(4.452882,-75.766298)"
2016,Junio,Bélgica,56,77,67,,144,"(4.697144,-74.140516)"
2016,Junio,Bélgica,56,2,0,,2,"(4.815061,-75.736532)"
2016,Junio,Bélgica,56,26,13,,39,"(6.171601,-75.427454)"
2016,Junio,Bélgica,56,0,1,,1,"(7.128456,-73.183637)"
2016,Junio,Belice,84,0,1,,1,"(12.586067,-81.702563)"
2016,Junio,Belice,84,3,3,,6,"(3.541112,-76.384584)"
2016,Junio,Belice,84,11,8,,19,"(4.697144,-74.140516)"
2016,Junio,Belice,84,6,4,,10,"(6.171601,-75.427454)"
2016,Junio,Benín,204,1,0,,1,"(4.697144,-74.140516)"
2016,Junio,Bermudas/Territorio Británico de Ultramar,60,1,0,,1,"(4.697144,-74.140516)"
2016,Junio,Bermudas/Territorio Británico de Ultramar,60,0,1,,1,"(6.171601,-75.427454)"
2016,Junio,Bolivia,68,0,1,,1,"(0.25129,-76.875963)"
2016,Junio,Bolivia,68,9,6,,15,"(0.814836,-77.662532)"
2016,Junio,Bolivia,68,0,2,,2,"(10.445761,-75.516429)"
2016,Junio,Bolivia,68,1,2,,3,"(10.886611,-74.776708)"
2016,Junio,Bolivia,68,15,35,,50,"(3.541112,-76.384584)"
2016,Junio,Bolivia,68,289,470,,759,"(4.697144,-74.140516)"
2016,Junio,Bolivia,68,2,6,,8,"(4.815061,-75.736532)"
2016,Junio,Bolivia,68,22,40,,62,"(6.171601,-75.427454)"
2016,Junio,Bosnia y Herzegovina,70,1,0,,1,"(4.697144,-74.140516)"
2016,Junio,Brasil,76,192,262,,454,"(-4.197703,-69.941278)"
2016,Junio,Brasil,76,1,0,,1,"(0.25129,-76.875963)"
2016,Junio,Brasil,76,1,10,,11,"(0.814836,-77.662532)"
2016,Junio,Brasil,76,5,6,,11,"(10.445761,-75.516429)"
2016,Junio,Brasil,76,11,11,,22,"(10.886611,-74.776708)"
2016,Junio,Brasil,76,2,1,,3,"(12.586067,-81.702563)"
2016,Junio,Brasil,76,87,127,,214,"(3.541112,-76.384584)"
2016,Junio,Brasil,76,3538,4024,,7562,"(4.697144,-74.140516)"
2016,Junio,Brasil,76,11,26,,37,"(4.815061,-75.736532)"
2016,Junio,Brasil,76,150,164,,314,"(6.171601,-75.427454)"
2016,Junio,Brasil,76,3,4,,7,"(7.128456,-73.183637)"
2016,Junio,Brasil,76,12,8,,20,"(7.927209,-72.507910)"
2016,Junio,Bulgaria,100,2,2,,4,"(3.541112,-76.384584)"
2016,Junio,Bulgaria,100,0,2,,2,"(4.697144,-74.140516)"
2016,Junio,Cabo Verde,132,1,0,,1,"(4.697144,-74.140516)"
2016,Junio,Islas Caimán/Territorio Británico de Ultramar,136,3,4,,7,"(12.586067,-81.702563)"
2016,Junio,Islas Caimán/Territorio Británico de Ultramar,136,1,1,,2,"(3.541112,-76.384584)"
2016,Junio,Islas Caimán/Territorio Británico de Ultramar,136,1,1,,2,"(4.697144,-74.140516)"
2016,Junio,Islas Caimán/Territorio Británico de Ultramar,136,1,0,,1,"(4.815061,-75.736532)"
2016,Junio,Islas Caimán/Territorio Británico de Ultramar,136,1,1,,2,"(6.171601,-75.427454)"
2016,Junio,Camboya,116,0,1,,1,"(4.697144,-74.140516)"
2016,Junio,Camerún,120,0,1,,1,"(4.697144,-74.140516)"
2016,Junio,Canadá,124,26,19,,45,"(10.445761,-75.516429)"
2016,Junio,Canadá,124,65,42,,107,"(10.886611,-74.776708)"
2016,Junio,Canadá,124,2,0,,2,"(12.586067,-81.702563)"
2016,Junio,Canadá,124,178,123,,301,"(3.541112,-76.384584)"
2016,Junio,Canadá,124,2265,1711,,3976,"(4.697144,-74.140516)"
2016,Junio,Canadá,124,14,12,,26,"(4.815061,-75.736532)"
2016,Junio,Canadá,124,344,252,,596,"(6.171601,-75.427454)"
2016,Junio,Canadá,124,16,5,,21,"(7.128456,-73.183637)"
2016,Junio,Canadá,124,2,2,,4,"(7.927209,-72.507910)"
2016,Junio,España,724,79,50,,129,"(10.445761,-75.516429)"
2016,Junio,España,724,67,44,,111,"(10.886611,-74.776708)"
2016,Junio,España,724,0,1,,1,"(12.586067,-81.702563)"
2016,Junio,España,724,3845,2449,,6294,"(3.541112,-76.384584)"
2016,Junio,España,724,13579,9814,,23393,"(4.697144,-74.140516)"
2016,Junio,España,724,137,106,,243,"(4.815061,-75.736532)"
2016,Junio,España,724,2054,1485,,3539,"(6.171601,-75.427454)"
2016,Junio,España,724,29,27,,56,"(7.128456,-73.183637)"
2016,Junio,España,724,8,13,,21,"(7.927209,-72.507910)"
2016,Junio,Colombia,170,1,6,,7,"(10.445761,-75.516429)"
2016,Junio,Colombia,170,72,221,,293,"(4.697144,-74.140516)"
2016,Junio,República de Corea,410,0,1,,1,"(3.541112,-76.384584)"
2016,Junio,República de Corea,410,17,28,,45,"(4.697144,-74.140516)"
2016,Junio,República de Corea,410,1,3,,4,"(6.171601,-75.427454)"
2016,Junio,Costa de Marfil,384,0,3,,3,"(3.541112,-76.384584)"
2016,Junio,Costa de Marfil,384,3,4,,7,"(4.697144,-74.140516)"
2016,Junio,Costa de Marfil,384,0,1,,1,"(6.171601,-75.427454)"
2016,Junio,Costa Rica,188,8,7,,15,"(10.445761,-75.516429)"
2016,Junio,Costa Rica,188,27,23,,50,"(10.886611,-74.776708)"
2016,Junio,Costa Rica,188,0,5,,5,"(11.117806,-74.232622)"
2016,Junio,Costa Rica,188,1,8,,9,"(12.5744111,-81.703935)"
2016,Junio,Costa Rica,188,14,10,,24,"(12.586067,-81.702563)"
2016,Junio,Costa Rica,188,41,42,,83,"(3.541112,-76.384584)"
2016,Junio,Costa Rica,188,1043,1179,,2222,"(4.697144,-74.140516)"
2016,Junio,Costa Rica,188,13,13,,26,"(4.815061,-75.736532)"
2016,Junio,Costa Rica,188,127,127,,254,"(6.171601,-75.427454)"
2016,Junio,Costa Rica,188,3,2,,5,"(7.128456,-73.183637)"
2016,Junio,Costa Rica,188,0,2,,2,"(8.066966,-76.735404)"
2016,Junio,Croacia,191,1,3,,4,"(3.541112,-76.384584)"
2016,Junio,Croacia,191,2,9,,11,"(4.697144,-74.140516)"
2016,Junio,Croacia,191,1,0,,1,"(6.171601,-75.427454)"
2016,Junio,Cuba,192,41,20,,61,"(10.445761,-75.516429)"
2016,Junio,Cuba,192,34,25,,59,"(10.886611,-74.776708)"
2016,Junio,Cuba,192,14,3,,17,"(12.586067,-81.702563)"
2016,Junio,Cuba,192,93,83,,176,"(3.541112,-76.384584)"
2016,Junio,Cuba,192,1469,1427,,2896,"(4.697144,-74.140516)"
2016,Junio,Cuba,192,21,13,,34,"(4.815061,-75.736532)"
2016,Junio,Cuba,192,197,144,,341,"(6.171601,-75.427454)"
2016,Junio,Cuba,192,6,6,,12,"(7.128456,-73.183637)"
2016,Junio,Cuba,192,4,4,,8,"(7.927209,-72.507910)"
2016,Junio,Curazao,99999,7,41,,48,"(4.697144,-74.140516)"
2016,Junio,República Checa,203,1,0,,1,"(3.541112,-76.384584)"
2016,Junio,República Checa,203,21,12,,33,"(4.697144,-74.140516)"
2016,Junio,República Checa,203,1,0,,1,"(6.171601,-75.427454)"
2016,Junio,Chile,152,138,132,,270,"(0.814836,-77.662532)"
2016,Junio,Chile,152,11,7,,18,"(10.445761,-75.516429)"
2016,Junio,Chile,152,25,17,,42,"(10.886611,-74.776708)"
2016,Junio,Chile,152,6,6,,12,"(12.586067,-81.702563)"
2016,Junio,Chile,152,305,233,,538,"(3.541112,-76.384584)"
2016,Junio,Chile,152,4169,3605,,7774,"(4.697144,-74.140516)"
2016,Junio,Chile,152,39,30,,69,"(4.815061,-75.736532)"
2016,Junio,Chile,152,97,84,,181,"(6.171601,-75.427454)"
2016,Junio,Chile,152,9,7,,16,"(7.128456,-73.183637)"
2016,Junio,Chile,152,5,6,,11,"(7.927209,-72.507910)"
2016,Junio,China,156,0,7,,7,"(10.445761,-75.516429)"
2016,Junio,China,156,0,4,,4,"(10.886611,-74.776708)"
2016,Junio,China,156,7,28,,35,"(3.541112,-76.384584)"
2016,Junio,China,156,232,342,,574,"(4.697144,-74.140516)"
2016,Junio,China,156,11,23,,34,"(6.171601,-75.427454)"
2016,Junio,Chipre,196,6,2,,8,"(3.541112,-76.384584)"
2016,Junio,Dinamarca,208,2,0,,2,"(10.445761,-75.516429)"
2016,Junio,Dinamarca,208,3,2,,5,"(10.886611,-74.776708)"
2016,Junio,Dinamarca,208,6,2,,8,"(3.541112,-76.384584)"
2016,Junio,Dinamarca,208,49,48,,97,"(4.697144,-74.140516)"
2016,Junio,Dinamarca,208,3,1,,4,"(6.171601,-75.427454)"
2016,Junio,Dominica,212,1,0,,1,"(4.697144,-74.140516)"
2016,Junio,Ecuador,218,1,5,,6,"(-0.193180,-74.784874)"
2016,Junio,Ecuador,218,407,694,,1101,"(0.25129,-76.875963)"
2016,Junio,Ecuador,218,27,25,,52,"(0.812436,-77.847006)"
2016,Junio,Ecuador,218,5491,5972,,11463,"(0.814836,-77.662532)"
2016,Junio,Ecuador,218,190,206,,396,"(1.813928,-78.763924)"
2016,Junio,Ecuador,218,0,10,,10,"(10.408582,-75.538003)"
2016,Junio,Ecuador,218,5,4,,9,"(10.445761,-75.516429)"
2016,Junio,Ecuador,218,8,16,,24,"(10.886611,-74.776708)"
2016,Junio,Ecuador,218,0,1,,1,"(11.117806,-74.232622)"
2016,Junio,Ecuador,218,363,370,,733,"(3.541112,-76.384584)"
2016,Junio,Ecuador,218,2659,3988,,6647,"(4.697144,-74.140516)"
2016,Junio,Ecuador,218,6,3,,9,"(4.815061,-75.736532)"
2016,Junio,Ecuador,218,32,38,,70,"(6.171601,-75.427454)"
2016,Junio,Ecuador,218,0,1,,1,"(6.228046,-77.404104)"
2016,Junio,Ecuador,218,1,7,,8,"(7.128456,-73.183637)"
2016,Junio,Egipto,818,2,2,,4,"(3.541112,-76.384584)"
2016,Junio,Egipto,818,31,14,,45,"(4.697144,-74.140516)"
2016,Junio,El Salvador,222,1,4,,5,"(10.445761,-75.516429)"
2016,Junio,El Salvador,222,1,5,,6,"(10.886611,-74.776708)"
2016,Junio,El Salvador,222,2,0,,2,"(12.586067,-81.702563)"
2016,Junio,El Salvador,222,106,125,,231,"(3.541112,-76.384584)"
2016,Junio,El Salvador,222,819,1136,,1955,"(4.697144,-74.140516)"
2016,Junio,El Salvador,222,1,2,,3,"(4.815061,-75.736532)"
2016,Junio,El Salvador,222,66,104,,170,"(6.171601,-75.427454)"
2016,Junio,El Salvador,222,0,2,,2,"(7.128456,-73.183637)"
2016,Junio,El Salvador,222,4,2,,6,"(7.927209,-72.507910)"
2016,Junio,Emiratos Árabes,784,1,1,,2,"(3.541112,-76.384584)"
2016,Junio,Emiratos Árabes,784,53,161,,214,"(4.697144,-74.140516)"
2016,Junio,Emiratos Árabes,784,7,8,,15,"(6.171601,-75.427454)"
2016,Junio,Eritrea,232,0,1,,1,"(4.697144,-74.140516)"
2016,Junio,Eslovaquia,703,1,0,,1,"(3.541112,-76.384584)"
2016,Junio,Eslovaquia,703,1,0,,1,"(4.697144,-74.140516)"
2016,Junio,Eslovaquia,703,1,0,,1,"(6.171601,-75.427454)"
2016,Junio,Eslovenia,705,4,5,,9,"(4.697144,-74.140516)"
2016,Junio,Eslovenia,705,0,2,,2,"(4.815061,-75.736532)"
2016,Junio,Estados Unidos de América,840,14,129,,143,"(10.408582,-75.538003)"
2016,Junio,Estados Unidos de América,840,4607,3588,,8195,"(10.445761,-75.516429)"
2016,Junio,Estados Unidos de América,840,3849,2893,,6742,"(10.886611,-74.776708)"
2016,Junio,Estados Unidos de América,840,44,34,,78,"(12.586067,-81.702563)"
2016,Junio,Estados Unidos de América,840,6201,4480,,10681,"(3.541112,-76.384584)"
2016,Junio,Estados Unidos de América,840,892,681,,1573,"(4.452882,-75.766298)"
2016,Junio,Estados Unidos de América,840,41579,35409,,76988,"(4.697144,-74.140516)"
2016,Junio,Estados Unidos de América,840,1117,731,,1848,"(4.815061,-75.736532)"
2016,Junio,Estados Unidos de América,840,14086,11000,,25086,"(6.171601,-75.427454)"
2016,Junio,Estados Unidos de América,840,305,217,,522,"(7.128456,-73.183637)"
2016,Junio,Estados Unidos de América,840,188,142,,330,"(7.927209,-72.507910)"
2016,Junio,Estonia,233,1,2,,3,"(4.697144,-74.140516)"
2016,Junio,Estonia,233,1,0,,1,"(7.927209,-72.507910)"
2016,Junio,Etiopia,231,1,3,,4,"(4.697144,-74.140516)"
2016,Junio,Filipinas,608,1,0,,1,"(3.541112,-76.384584)"
2016,Junio,Filipinas,608,2,6,,8,"(4.697144,-74.140516)"
2016,Junio,Filipinas,608,1,1,,2,"(6.171601,-75.427454)"
2016,Junio,Finlandia,246,3,2,,5,"(10.445761,-75.516429)"
2016,Junio,Finlandia,246,1,0,,1,"(10.886611,-74.776708)"
2016,Junio,Finlandia,246,0,3,,3,"(3.541112,-76.384584)"
2016,Junio,Finlandia,246,17,12,,29,"(4.697144,-74.140516)"
2016,Junio,Finlandia,246,1,1,,2,"(6.171601,-75.427454)"
2016,Junio,Francia,250,12,7,,19,"(10.445761,-75.516429)"
2016,Junio,Francia,250,8,5,,13,"(10.886611,-74.776708)"
2016,Junio,Francia,250,141,90,,231,"(3.541112,-76.384584)"
2016,Junio,Francia,250,2505,2009,,4514,"(4.697144,-74.140516)"
2016,Junio,Francia,250,16,3,,19,"(4.815061,-75.736532)"
2016,Junio,Francia,250,97,65,,162,"(6.171601,-75.427454)"
2016,Junio,Francia,250,4,5,,9,"(7.128456,-73.183637)"
2016,Junio,Francia,250,2,2,,4,"(7.927209,-72.507910)"
2016,Junio,Gabón,266,1,0,,1,"(4.697144,-74.140516)"
2016,Junio,Georgia,268,0,9,,9,"(4.697144,-74.140516)"
2016,Junio,Ghana,288,0,1,,1,"(10.886611,-74.776708)"
2016,Junio,Ghana,288,3,3,,6,"(4.697144,-74.140516)"
2016,Junio,Gibraltar/Territorio Británico de Ultramar,292,4,8,,12,"(0.814836,-77.662532)"
2016,Junio,Grecia,300,2,0,,2,"(10.445761,-75.516429)"
2016,Junio,Grecia,300,41,40,,81,"(4.697144,-74.140516)"
2016,Junio,Grecia,300,2,1,,3,"(6.171601,-75.427454)"
2016,Junio,Guatemala,320,4,8,,12,"(10.445761,-75.516429)"
2016,Junio,Guatemala,320,5,9,,14,"(10.886611,-74.776708)"
2016,Junio,Guatemala,320,46,81,,127,"(3.541112,-76.384584)"
2016,Junio,Guatemala,320,603,744,,1347,"(4.697144,-74.140516)"
2016,Junio,Guatemala,320,7,6,,13,"(4.815061,-75.736532)"
2016,Junio,Guatemala,320,90,118,,208,"(6.171601,-75.427454)"
2016,Junio,Guatemala,320,8,2,,10,"(7.128456,-73.183637)"
2016,Junio,Guatemala,320,3,1,,4,"(7.927209,-72.507910)"
2016,Junio,Guyana,328,1,0,,1,"(3.541112,-76.384584)"
2016,Junio,Guyana,328,0,1,,1,"(6.171601,-75.427454)"
2016,Junio,Guinea,324,0,1,,1,"(4.697144,-74.140516)"
2016,Junio,Guinea Ecuatorial,226,1,3,,4,"(4.697144,-74.140516)"
2016,Junio,Guinea Bissau,624,0,1,,1,"(6.171601,-75.427454)"
2016,Junio,Guadalupe/Territorio Francés,312,1,0,,1,"(4.697144,-74.140516)"
2016,Junio,Guayana Francesa/Departamento de Ultramar Francés,254,1,1,,2,"(4.697144,-74.140516)"
2016,Junio,Guayana Francesa/Departamento de Ultramar Francés,254,4,7,,11,"(6.171601,-75.427454)"
2016,Junio,Haití,332,1,3,,4,"(10.886611,-74.776708)"
2016,Junio,Haití,332,1,1,,2,"(12.586067,-81.702563)"
2016,Junio,Haití,332,0,1,,1,"(3.541112,-76.384584)"
2016,Junio,Haití,332,4,13,,17,"(4.697144,-74.140516)"
2016,Junio,Haití,332,1,5,,6,"(6.171601,-75.427454)"
2016,Junio,Haití,332,2,1,,3,"(7.128456,-73.183637)"
2016,Junio,Honduras,340,3,2,,5,"(10.445761,-75.516429)"
2016,Junio,Honduras,340,6,8,,14,"(10.886611,-74.776708)"
2016,Junio,Honduras,340,1,0,,1,"(12.586067,-81.702563)"
2016,Junio,Honduras,340,1,0,,1,"(13.3387613,-81.372937)"
2016,Junio,Honduras,340,10,12,,22,"(3.541112,-76.384584)"
2016,Junio,Honduras,340,79,153,,232,"(4.697144,-74.140516)"
2016,Junio,Honduras,340,1,4,,5,"(4.815061,-75.736532)"
2016,Junio,Honduras,340,38,72,,110,"(6.171601,-75.427454)"
2016,Junio,Honduras,340,1,2,,3,"(7.128456,-73.183637)"
2016,Junio,Honduras,340,1,0,,1,"(7.927209,-72.507910)"
2016,Junio,Hong Kong,344,0,1,,1,"(10.445761,-75.516429)"
2016,Junio,Hong Kong,344,0,1,,1,"(3.541112,-76.384584)"
2016,Junio,Hong Kong,344,45,50,,95,"(4.697144,-74.140516)"
2016,Junio,Hong Kong,344,1,2,,3,"(6.171601,-75.427454)"
2016,Junio,Hungría,348,4,7,,11,"(4.697144,-74.140516)"
2016,Junio,Hungría,348,0,1,,1,"(6.171601,-75.427454)"
2016,Junio,India,356,0,1,,1,"(10.445761,-75.516429)"
2016,Junio,India,356,1,2,,3,"(3.541112,-76.384584)"
2016,Junio,India,356,27,23,,50,"(4.697144,-74.140516)"
2016,Junio,India,356,1,0,,1,"(4.815061,-75.736532)"
2016,Junio,India,356,3,2,,5,"(6.171601,-75.427454)"
2016,Junio,Indonesia,360,7,9,,16,"(4.697144,-74.140516)"
2016,Junio,Indonesia,360,1,1,,2,"(6.171601,-75.427454)"
2016,Junio,Iraq,368,0,6,,6,"(4.697144,-74.140516)"
2016,Junio,Irán,364,4,0,,4,"(4.697144,-74.140516)"
2016,Junio,República de Irlanda,372,2,1,,3,"(3.541112,-76.384584)"
2016,Junio,República de Irlanda,372,18,21,,39,"(4.697144,-74.140516)"
2016,Junio,República de Irlanda,372,1,0,,1,"(6.171601,-75.427454)"
2016,Junio,Islandia,352,1,0,,1,"(4.697144,-74.140516)"
2016,Junio,Islandia,352,3,2,,5,"(6.171601,-75.427454)"
2016,Junio,Israel,376,1,0,,1,"(10.445761,-75.516429)"
2016,Junio,Israel,376,5,2,,7,"(3.541112,-76.384584)"
2016,Junio,Israel,376,113,65,,178,"(4.697144,-74.140516)"
2016,Junio,Israel,376,3,2,,5,"(6.171601,-75.427454)"
2016,Junio,Israel,376,1,0,,1,"(7.128456,-73.183637)"
2016,Junio,Italia,380,30,6,,36,"(10.445761,-75.516429)"
2016,Junio,Italia,380,13,8,,21,"(10.886611,-74.776708)"
2016,Junio,Italia,380,202,90,,292,"(3.541112,-76.384584)"
2016,Junio,Italia,380,859,676,,1535,"(4.697144,-74.140516)"
2016,Junio,Italia,380,4,6,,10,"(4.815061,-75.736532)"
2016,Junio,Italia,380,145,66,,211,"(6.171601,-75.427454)"
2016,Junio,Italia,380,7,2,,9,"(7.128456,-73.183637)"
2016,Junio,Italia,380,2,0,,2,"(7.927209,-72.507910)"
2016,Junio,Jamaica,388,0,2,,2,"(10.445761,-75.516429)"
2016,Junio,Jamaica,388,1,1,,2,"(10.886611,-74.776708)"
2016,Junio,Jamaica,388,1,5,,6,"(11.247723,-74.213989)"
2016,Junio,Jamaica,388,1,0,,1,"(12.586067,-81.702563)"
2016,Junio,Jamaica,388,21,6,,27,"(3.541112,-76.384584)"
2016,Junio,Jamaica,388,26,31,,57,"(4.697144,-74.140516)"
2016,Junio,Jamaica,388,0,2,,2,"(4.815061,-75.736532)"
2016,Junio,Jamaica,388,6,13,,19,"(6.171601,-75.427454)"
2016,Junio,Jamaica,388,5,4,,9,"(7.927209,-72.507910)"
2016,Junio,Japón,392,1,0,,1,"(3.541112,-76.384584)"
2016,Junio,Japón,392,82,88,,170,"(4.697144,-74.140516)"
2016,Junio,Japón,392,10,7,,17,"(6.171601,-75.427454)"
2016,Junio,Jordania,400,2,4,,6,"(4.697144,-74.140516)"
2016,Junio,Kazajistán,398,3,0,,3,"(3.541112,-76.384584)"
2016,Junio,Kenia,404,1,0,,1,"(3.541112,-76.384584)"
2016,Junio,Kenia,404,9,3,,12,"(4.697144,-74.140516)"
2016,Junio,Kirguistán,417,1,0,,1,"(4.697144,-74.140516)"
2016,Junio,Kuwait,414,0,1,,1,"(3.541112,-76.384584)"
2016,Junio,Kuwait,414,0,1,,1,"(4.697144,-74.140516)"
2016,Junio,República Democrática Popular  Lao,418,0,1,,1,"(4.697144,-74.140516)"
2016,Junio,Letonia,428,0,1,,1,"(4.697144,-74.140516)"
2016,Junio,Letonia,428,1,1,,2,"(6.171601,-75.427454)"
2016,Junio,Lituania,440,1,0,,1,"(4.697144,-74.140516)"
2016,Junio,Líbano,422,26,34,,60,"(4.697144,-74.140516)"
2016,Junio,Líbano,422,0,2,,2,"(6.171601,-75.427454)"
2016,Junio,Liberia,430,1,1,,2,"(3.541112,-76.384584)"
2016,Junio,Luxemburgo,442,2,3,,5,"(4.697144,-74.140516)"
2016,Junio,Luxemburgo,442,0,2,,2,"(6.171601,-75.427454)"
2016,Junio,Madagascar,450,0,1,,1,"(4.697144,-74.140516)"
2016,Junio,Malasia,458,3,5,,8,"(4.697144,-74.140516)"
2016,Junio,Malí,466,0,1,,1,"(4.697144,-74.140516)"
2016,Junio,Malta,470,1,2,,3,"(10.886611,-74.776708)"
2016,Junio,Malta,470,1,1,,2,"(3.541112,-76.384584)"
2016,Junio,Malta,470,18,14,,32,"(4.697144,-74.140516)"
2016,Junio,Malta,470,0,1,,1,"(6.171601,-75.427454)"
2016,Junio,Marruecos,504,13,11,,24,"(4.697144,-74.140516)"
2016,Junio,México,484,119,110,,229,"(10.445761,-75.516429)"
2016,Junio,México,484,149,132,,281,"(10.886611,-74.776708)"
2016,Junio,México,484,5,5,,10,"(12.586067,-81.702563)"
2016,Junio,México,484,1151,912,,2063,"(3.541112,-76.384584)"
2016,Junio,México,484,15459,13451,,28910,"(4.697144,-74.140516)"
2016,Junio,México,484,277,202,,479,"(4.815061,-75.736532)"
2016,Junio,México,484,2758,2148,,4906,"(6.171601,-75.427454)"
2016,Junio,México,484,143,102,,245,"(7.128456,-73.183637)"
2016,Junio,México,484,79,64,,143,"(7.927209,-72.507910)"
2016,Junio,Mónaco,492,1,1,,2,"(4.697144,-74.140516)"
2016,Junio,Mónaco,492,0,1,,1,"(6.171601,-75.427454)"
2016,Junio,Mongolia,496,0,1,,1,"(4.697144,-74.140516)"
2016,Junio,Mozambique,508,1,0,,1,"(3.541112,-76.384584)"
2016,Junio,Mozambique,508,0,1,,1,"(4.697144,-74.140516)"
2016,Junio,Nicaragua,558,1,3,,4,"(10.445761,-75.516429)"
2016,Junio,Nicaragua,558,3,5,,8,"(10.886611,-74.776708)"
2016,Junio,Nicaragua,558,1,4,,5,"(12.586067,-81.702563)"
2016,Junio,Nicaragua,558,8,47,,55,"(3.541112,-76.384584)"
2016,Junio,Nicaragua,558,28,64,,92,"(4.697144,-74.140516)"
2016,Junio,Nicaragua,558,1,7,,8,"(4.815061,-75.736532)"
2016,Junio,Nicaragua,558,19,45,,64,"(6.171601,-75.427454)"
2016,Junio,Nicaragua,558,0,1,,1,"(7.128456,-73.183637)"
2016,Junio,Nicaragua,558,1,0,,1,"(7.927209,-72.507910)"
2016,Junio,Nigeria,566,3,6,,9,"(4.697144,-74.140516)"
2016,Junio,Noruega,578,2,0,,2,"(10.445761,-75.516429)"
2016,Junio,Noruega,578,4,2,,6,"(10.886611,-74.776708)"
2016,Junio,Noruega,578,10,2,,12,"(3.541112,-76.384584)"
2016,Junio,Noruega,578,45,34,,79,"(4.697144,-74.140516)"
2016,Junio,Noruega,578,1,1,,2,"(6.171601,-75.427454)"
2016,Junio,Nueva Zelanda,554,1,0,,1,"(3.541112,-76.384584)"
2016,Junio,Nueva Zelanda,554,40,24,,64,"(4.697144,-74.140516)"
2016,Junio,Nueva Zelanda,554,3,4,,7,"(6.171601,-75.427454)"
2016,Junio,Omán,512,0,4,,4,"(4.697144,-74.140516)"
2016,Junio,Omán,512,0,1,,1,"(6.171601,-75.427454)"
2016,Junio,Panamá,591,11,56,,67,"(10.408582,-75.538003)"
2016,Junio,Panamá,591,644,616,,1260,"(10.445761,-75.516429)"
2016,Junio,Panamá,591,939,957,,1896,"(10.886611,-74.776708)"
2016,Junio,Panamá,591,1,1,,2,"(10.971302,-74.765397)"
2016,Junio,Panamá,591,1,2,,3,"(11.117806,-74.232622)"
2016,Junio,Panamá,591,1,1,,2,"(11.247723,-74.213989)"
2016,Junio,Panamá,591,2,16,,18,"(12.5744111,-81.703935)"
2016,Junio,Panamá,591,169,169,,338,"(12.586067,-81.702563)"
2016,Junio,Panamá,591,1814,1675,,3489,"(3.541112,-76.384584)"
2016,Junio,Panamá,591,329,213,,542,"(4.452882,-75.766298)"
2016,Junio,Panamá,591,9917,10080,,19997,"(4.697144,-74.140516)"
2016,Junio,Panamá,591,633,490,,1123,"(4.815061,-75.736532)"
2016,Junio,Panamá,591,4313,3900,,8213,"(6.171601,-75.427454)"
2016,Junio,Panamá,591,3,4,,7,"(7.102626,-77.762647)"
2016,Junio,Panamá,591,203,211,,414,"(7.128456,-73.183637)"
2016,Junio,Panamá,591,134,147,,281,"(7.927209,-72.507910)"
2016,Junio,Panamá,591,0,7,,7,"(8.066966,-76.735404)"
2016,Junio,Panamá,591,14,51,,65,"(8.635765,-77.346578)"
2016,Junio,Paraguay,600,2,0,,2,"(10.445761,-75.516429)"
2016,Junio,Paraguay,600,3,13,,16,"(10.886611,-74.776708)"
2016,Junio,Paraguay,600,19,27,,46,"(3.541112,-76.384584)"
2016,Junio,Paraguay,600,49,114,,163,"(4.697144,-74.140516)"
2016,Junio,Paraguay,600,1,10,,11,"(4.815061,-75.736532)"
2016,Junio,Paraguay,600,13,34,,47,"(6.171601,-75.427454)"
2016,Junio,Paraguay,600,0,1,,1,"(7.927209,-72.507910)"
2016,Junio,Perú,604,1,1,,2,"(-0.193180,-74.784874)"
2016,Junio,Perú,604,108,179,,287,"(-4.197703,-69.941278)"
2016,Junio,Perú,604,72,68,,140,"(0.814836,-77.662532)"
2016,Junio,Perú,604,8,7,,15,"(10.445761,-75.516429)"
2016,Junio,Perú,604,9,8,,17,"(10.886611,-74.776708)"
2016,Junio,Perú,604,1,1,,2,"(12.586067,-81.702563)"
2016,Junio,Perú,604,304,296,,600,"(3.541112,-76.384584)"
2016,Junio,Perú,604,5334,5743,,11077,"(4.697144,-74.140516)"
2016,Junio,Perú,604,4,4,,8,"(4.815061,-75.736532)"
2016,Junio,Perú,604,359,373,,732,"(6.171601,-75.427454)"
2016,Junio,Perú,604,1,0,,1,"(7.128456,-73.183637)"
2016,Junio,Perú,604,5,2,,7,"(7.927209,-72.507910)"
2016,Junio,Palestina,99999,0,1,,1,"(4.697144,-74.140516)"
2016,Junio,Polonia,616,24,38,,62,"(4.697144,-74.140516)"
2016,Junio,Polonia,616,1,2,,3,"(6.171601,-75.427454)"
2016,Junio,Polonia,616,2,0,,2,"(7.128456,-73.183637)"
2016,Junio,Portugal,620,8,2,,10,"(3.541112,-76.384584)"
2016,Junio,Portugal,620,98,142,,240,"(4.697144,-74.140516)"
2016,Junio,Portugal,620,4,8,,12,"(6.171601,-75.427454)"
2016,Junio,Portugal,620,0,3,,3,"(7.128456,-73.183637)"
2016,Junio,Puerto Rico/Territorio de Estados Unidos,630,6,4,,10,"(10.445761,-75.516429)"
2016,Junio,Puerto Rico/Territorio de Estados Unidos,630,26,17,,43,"(10.886611,-74.776708)"
2016,Junio,Puerto Rico/Territorio de Estados Unidos,630,21,13,,34,"(3.541112,-76.384584)"
2016,Junio,Puerto Rico/Territorio de Estados Unidos,630,607,559,,1166,"(4.697144,-74.140516)"
2016,Junio,Puerto Rico/Territorio de Estados Unidos,630,5,8,,13,"(4.815061,-75.736532)"
2016,Junio,Puerto Rico/Territorio de Estados Unidos,630,28,29,,57,"(6.171601,-75.427454)"
2016,Junio,Puerto Rico/Territorio de Estados Unidos,630,3,5,,8,"(7.128456,-73.183637)"
2016,Junio,Puerto Rico/Territorio de Estados Unidos,630,3,3,,6,"(7.927209,-72.507910)"
2016,Junio,Qatar,634,5,6,,11,"(4.697144,-74.140516)"
2016,Junio,Qatar,634,2,1,,3,"(6.171601,-75.427454)"
2016,Junio,Reino Unido de Gran Bretaña e Irlanda del Norte,826,1,0,,1,"(10.886611,-74.776708)"
2016,Junio,Reino Unido de Gran Bretaña e Irlanda del Norte,826,22,24,,46,"(3.541112,-76.384584)"
2016,Junio,Reino Unido de Gran Bretaña e Irlanda del Norte,826,2523,1798,,4321,"(4.697144,-74.140516)"
2016,Junio,Reino Unido de Gran Bretaña e Irlanda del Norte,826,6,8,,14,"(4.815061,-75.736532)"
2016,Junio,Reino Unido de Gran Bretaña e Irlanda del Norte,826,22,24,,46,"(6.171601,-75.427454)"
2016,Junio,Reino Unido de Gran Bretaña e Irlanda del Norte,826,2,0,,2,"(7.128456,-73.183637)"
2016,Junio,República CentroÁfricana,140,1,0,,1,"(4.697144,-74.140516)"
2016,Junio,Federación de Rusia,643,0,1,,1,"(10.445761,-75.516429)"
2016,Junio,Federación de Rusia,643,3,3,,6,"(3.541112,-76.384584)"
2016,Junio,Federación de Rusia,643,56,60,,116,"(4.697144,-74.140516)"
2016,Junio,Federación de Rusia,643,0,3,,3,"(6.171601,-75.427454)"
2016,Junio,República Dominicana,214,14,20,,34,"(10.445761,-75.516429)"
2016,Junio,República Dominicana,214,37,34,,71,"(10.886611,-74.776708)"
2016,Junio,República Dominicana,214,2,2,,4,"(12.586067,-81.702563)"
2016,Junio,República Dominicana,214,160,117,,277,"(3.541112,-76.384584)"
2016,Junio,República Dominicana,214,3250,3006,,6256,"(4.697144,-74.140516)"
2016,Junio,República Dominicana,214,37,24,,61,"(4.815061,-75.736532)"
2016,Junio,República Dominicana,214,478,366,,844,"(6.171601,-75.427454)"
2016,Junio,República Dominicana,214,33,25,,58,"(7.128456,-73.183637)"
2016,Junio,República Dominicana,214,35,25,,60,"(7.927209,-72.507910)"
2016,Junio,Rumania,642,6,4,,10,"(4.697144,-74.140516)"
2016,Junio,Samoa Occidental,882,1,0,,1,"(3.541112,-76.384584)"
2016,Junio,Santa Lucia,662,1,0,,1,"(10.886611,-74.776708)"
2016,Junio,Santa Lucia,662,0,1,,1,"(3.541112,-76.384584)"
2016,Junio,Santa Sede/Ciudad del Vaticano,336,1,1,,2,"(4.697144,-74.140516)"
2016,Junio,Serbia,688,0,1,,1,"(4.697144,-74.140516)"
2016,Junio,Singapur,702,2,1,,3,"(10.886611,-74.776708)"
2016,Junio,Singapur,702,1,0,,1,"(3.541112,-76.384584)"
2016,Junio,Singapur,702,14,8,,22,"(4.697144,-74.140516)"
2016,Junio,Singapur,702,1,0,,1,"(6.171601,-75.427454)"
2016,Junio,Sri Lanka,144,1,0,,1,"(4.697144,-74.140516)"
2016,Junio,Sudáfrica,710,13,15,,28,"(4.697144,-74.140516)"
2016,Junio,Sudáfrica,710,0,1,,1,"(6.171601,-75.427454)"
2016,Junio,Suecia,752,2,2,,4,"(10.445761,-75.516429)"
2016,Junio,Suecia,752,4,3,,7,"(10.886611,-74.776708)"
2016,Junio,Suecia,752,12,9,,21,"(3.541112,-76.384584)"
2016,Junio,Suecia,752,103,80,,183,"(4.697144,-74.140516)"
2016,Junio,Suecia,752,1,0,,1,"(4.815061,-75.736532)"
2016,Junio,Suecia,752,12,4,,16,"(6.171601,-75.427454)"
2016,Junio,Suecia,752,0,2,,2,"(7.128456,-73.183637)"
2016,Junio,Suecia,752,2,0,,2,"(7.927209,-72.507910)"
2016,Junio,Suiza,756,9,2,,11,"(10.445761,-75.516429)"
2016,Junio,Suiza,756,4,1,,5,"(10.886611,-74.776708)"
2016,Junio,Suiza,756,80,50,,130,"(3.541112,-76.384584)"
2016,Junio,Suiza,756,324,211,,535,"(4.697144,-74.140516)"
2016,Junio,Suiza,756,1,2,,3,"(4.815061,-75.736532)"
2016,Junio,Suiza,756,29,14,,43,"(6.171601,-75.427454)"
2016,Junio,Suiza,756,2,0,,2,"(7.128456,-73.183637)"
2016,Junio,Surinam,740,1,2,,3,"(10.445761,-75.516429)"
2016,Junio,Surinam,740,3,4,,7,"(4.697144,-74.140516)"
2016,Junio,Surinam,740,3,2,,5,"(6.171601,-75.427454)"
2016,Junio,Taiwán,158,1,1,,2,"(4.697144,-74.140516)"
2016,Junio,Taiwán,158,1,0,,1,"(7.128456,-73.183637)"
2016,Junio,República de Tayikistán,762,0,1,,1,"(4.697144,-74.140516)"
2016,Junio,Tailandia,764,1,0,,1,"(3.541112,-76.384584)"
2016,Junio,Tailandia,764,16,14,,30,"(4.697144,-74.140516)"
2016,Junio,Tailandia,764,3,1,,4,"(6.171601,-75.427454)"
2016,Junio,Tanzania,834,0,1,,1,"(4.697144,-74.140516)"
2016,Junio,Trinidad y Tobago,780,1,2,,3,"(10.445761,-75.516429)"
2016,Junio,Trinidad y Tobago,780,2,2,,4,"(10.886611,-74.776708)"
2016,Junio,Trinidad y Tobago,780,14,15,,29,"(3.541112,-76.384584)"
2016,Junio,Trinidad y Tobago,780,17,30,,47,"(4.697144,-74.140516)"
2016,Junio,Trinidad y Tobago,780,4,4,,8,"(4.815061,-75.736532)"
2016,Junio,Trinidad y Tobago,780,5,18,,23,"(6.171601,-75.427454)"
2016,Junio,Trinidad y Tobago,780,6,3,,9,"(7.128456,-73.183637)"
2016,Junio,Trinidad y Tobago,780,3,2,,5,"(7.927209,-72.507910)"
2016,Junio,Túnez,788,2,0,,2,"(4.697144,-74.140516)"
2016,Junio,Turquía,792,10,9,,19,"(3.541112,-76.384584)"
2016,Junio,Turquía,792,351,284,,635,"(4.697144,-74.140516)"
2016,Junio,Turquía,792,2,3,,5,"(6.171601,-75.427454)"
2016,Junio,Turkmenistán,795,3,3,,6,"(4.697144,-74.140516)"
2016,Junio,Ucrania,804,1,5,,6,"(4.697144,-74.140516)"
2016,Junio,Uruguay,858,0,7,,7,"(0.814836,-77.662532)"
2016,Junio,Uruguay,858,0,2,,2,"(10.445761,-75.516429)"
2016,Junio,Uruguay,858,10,12,,22,"(3.541112,-76.384584)"
2016,Junio,Uruguay,858,72,64,,136,"(4.697144,-74.140516)"
2016,Junio,Uruguay,858,1,1,,2,"(4.815061,-75.736532)"
2016,Junio,Uruguay,858,9,9,,18,"(6.171601,-75.427454)"
2016,Junio,Venezuela,862,9,9,,18,"(10.445761,-75.516429)"
2016,Junio,Venezuela,862,22,60,,82,"(10.886611,-74.776708)"
2016,Junio,Venezuela,862,1,0,,1,"(11.117806,-74.232622)"
2016,Junio,Venezuela,862,45,70,,115,"(11.360009,-72.129330)"
2016,Junio,Venezuela,862,3,1,,4,"(12.586067,-81.702563)"
2016,Junio,Venezuela,862,12,23,,35,"(3.541112,-76.384584)"
2016,Junio,Venezuela,862,0,1,,1,"(3.866713,-67.927521)"
2016,Junio,Venezuela,862,1441,1667,,3108,"(4.697144,-74.140516)"
2016,Junio,Venezuela,862,6,3,,9,"(4.815061,-75.736532)"
2016,Junio,Venezuela,862,345,339,,684,"(6.171601,-75.427454)"
2016,Junio,Venezuela,862,2,1,,3,"(6.185799,-67.483929)"
2016,Junio,Venezuela,862,14,12,,26,"(7.088729,-70.740253)"
2016,Junio,Venezuela,862,7,5,,12,"(7.128456,-73.183637)"
2016,Junio,Venezuela,862,244,284,,528,"(7.818934,-72.453226)"
2016,Junio,Venezuela,862,3,5,,8,"(7.927209,-72.507910)"
2016,Junio,Vietnam,704,3,2,,5,"(3.541112,-76.384584)"
2016,Junio,Vietnam,704,1,1,,2,"(4.697144,-74.140516)"
2016,Junio,Vietnam,704,1,0,,1,"(6.171601,-75.427454)"
2016,Junio,Islas Vírgenes Británicas/Territorio Británico de Ultramar,92,0,1,,1,"(4.697144,-74.140516)"
2016,Julio,Afganistán,4,2,4,,6,"(4.697144,-74.140516)"
2016,Julio,Albania,8,1,0,,1,"(3.541112,-76.384584)"
2016,Julio,Albania,8,0,4,,4,"(4.697144,-74.140516)"
2016,Julio,Alemania,276,2,2,,4,"(0.814836,-77.662532)"
2016,Julio,Alemania,276,5,6,,11,"(10.445761,-75.516429)"
2016,Julio,Alemania,276,21,12,,33,"(10.886611,-74.776708)"
2016,Julio,Alemania,276,95,53,,148,"(3.541112,-76.384584)"
2016,Julio,Alemania,276,1498,1218,,2716,"(4.697144,-74.140516)"
2016,Julio,Alemania,276,2,2,,4,"(4.815061,-75.736532)"
2016,Julio,Alemania,276,61,65,,126,"(6.171601,-75.427454)"
2016,Julio,Andorra,20,1,0,,1,"(4.697144,-74.140516)"
2016,Julio,Angola,24,1,13,,14,"(4.697144,-74.140516)"
2016,Julio,Antigua y Barbuda,28,2,0,,2,"(10.886611,-74.776708)"
2016,Julio,Antigua y Barbuda,28,2,6,,8,"(4.697144,-74.140516)"
2016,Julio,Países Bajos,528,4,1,,5,"(10.445761,-75.516429)"
2016,Julio,Países Bajos,528,190,125,,315,"(10.886611,-74.776708)"
2016,Julio,Países Bajos,528,0,7,,7,"(10.971302,-74.765397)"
2016,Julio,Países Bajos,528,334,229,,563,"(3.541112,-76.384584)"
2016,Julio,Países Bajos,528,926,812,,1738,"(4.697144,-74.140516)"
2016,Julio,Países Bajos,528,4,4,,8,"(4.815061,-75.736532)"
2016,Julio,Países Bajos,528,187,120,,307,"(6.171601,-75.427454)"
2016,Julio,Países Bajos,528,1,1,,2,"(7.128456,-73.183637)"
2016,Julio,Países Bajos,528,2,0,,2,"(7.927209,-72.507910)"
2016,Julio,Arabia Saudita,682,2,1,,3,"(3.541112,-76.384584)"
2016,Julio,Arabia Saudita,682,18,49,,67,"(4.697144,-74.140516)"
2016,Julio,Arabia Saudita,682,1,3,,4,"(6.171601,-75.427454)"
2016,Julio,Argelia,12,1,0,,1,"(3.541112,-76.384584)"
2016,Julio,Argelia,12,2,9,,11,"(4.697144,-74.140516)"
2016,Julio,Argelia,12,1,1,,2,"(6.171601,-75.427454)"
2016,Julio,Argentina,32,9,34,,43,"(0.814836,-77.662532)"
2016,Julio,Argentina,32,3,2,,5,"(10.445761,-75.516429)"
2016,Julio,Argentina,32,12,9,,21,"(10.886611,-74.776708)"
2016,Julio,Argentina,32,9,9,,18,"(12.586067,-81.702563)"
2016,Julio,Argentina,32,122,103,,225,"(3.541112,-76.384584)"
2016,Julio,Argentina,32,2282,2169,,4451,"(4.697144,-74.140516)"
2016,Julio,Argentina,32,8,23,,31,"(4.815061,-75.736532)"
2016,Julio,Argentina,32,45,51,,96,"(6.171601,-75.427454)"
2016,Julio,Argentina,32,3,0,,3,"(7.128456,-73.183637)"
2016,Julio,Argentina,32,0,2,,2,"(7.927209,-72.507910)"
2016,Julio,Aruba,533,8,9,,17,"(10.445761,-75.516429)"
2016,Julio,Aruba,533,72,58,,130,"(10.886611,-74.776708)"
2016,Julio,Aruba,533,0,1,,1,"(11.117806,-74.232622)"
2016,Julio,Aruba,533,70,44,,114,"(3.541112,-76.384584)"
2016,Julio,Aruba,533,1699,1372,,3071,"(4.697144,-74.140516)"
2016,Julio,Aruba,533,14,12,,26,"(4.815061,-75.736532)"
2016,Julio,Aruba,533,180,128,,308,"(6.171601,-75.427454)"
2016,Julio,Aruba,533,27,54,,81,"(7.128456,-73.183637)"
2016,Julio,Aruba,533,5,4,,9,"(7.927209,-72.507910)"
2016,Julio,Australia,36,2,0,,2,"(10.445761,-75.516429)"
2016,Julio,Australia,36,1,2,,3,"(10.886611,-74.776708)"
2016,Julio,Australia,36,15,8,,23,"(3.541112,-76.384584)"
2016,Julio,Australia,36,261,222,,483,"(4.697144,-74.140516)"
2016,Julio,Australia,36,39,31,,70,"(6.171601,-75.427454)"
2016,Julio,Australia,36,1,1,,2,"(7.128456,-73.183637)"
2016,Julio,Australia,36,1,0,,1,"(7.927209,-72.507910)"
2016,Julio,Austria,40,1,0,,1,"(10.886611,-74.776708)"
2016,Julio,Austria,40,6,1,,7,"(3.541112,-76.384584)"
2016,Julio,Austria,40,35,26,,61,"(4.697144,-74.140516)"
2016,Julio,Austria,40,4,3,,7,"(6.171601,-75.427454)"
2016,Julio,Austria,40,1,0,,1,"(7.128456,-73.183637)"
2016,Julio,Azerbaiyán,31,1,6,,7,"(4.697144,-74.140516)"
2016,Julio,Bahamas,44,2,1,,3,"(10.445761,-75.516429)"
2016,Julio,Bahamas,44,5,3,,8,"(10.886611,-74.776708)"
2016,Julio,Bahamas,44,1,1,,2,"(12.586067,-81.702563)"
2016,Julio,Bahamas,44,21,12,,33,"(3.541112,-76.384584)"
2016,Julio,Bahamas,44,6,15,,21,"(4.697144,-74.140516)"
2016,Julio,Bahamas,44,5,0,,5,"(4.815061,-75.736532)"
2016,Julio,Bahamas,44,17,9,,26,"(6.171601,-75.427454)"
2016,Julio,Bahamas,44,1,1,,2,"(7.927209,-72.507910)"
2016,Julio,Bahréin,48,3,3,,6,"(4.697144,-74.140516)"
2016,Julio,Bahréin,48,1,0,,1,"(6.171601,-75.427454)"
2016,Julio,Bangladesh,50,0,2,,2,"(4.697144,-74.140516)"
2016,Julio,Barbados,52,142,121,,263,"(4.697144,-74.140516)"
2016,Julio,Bélgica,56,2,0,,2,"(10.445761,-75.516429)"
2016,Julio,Bélgica,56,3,1,,4,"(10.886611,-74.776708)"
2016,Julio,Bélgica,56,25,17,,42,"(3.541112,-76.384584)"
2016,Julio,Bélgica,56,105,74,,179,"(4.697144,-74.140516)"
2016,Julio,Bélgica,56,43,26,,69,"(6.171601,-75.427454)"
2016,Julio,Belice,84,0,1,,1,"(3.541112,-76.384584)"
2016,Julio,Belice,84,7,9,,16,"(4.697144,-74.140516)"
2016,Julio,Belice,84,5,7,,12,"(6.171601,-75.427454)"
2016,Julio,Benín,204,0,1,,1,"(4.697144,-74.140516)"
2016,Julio,Bermudas/Territorio Británico de Ultramar,60,3,0,,3,"(4.697144,-74.140516)"
2016,Julio,Bolivia,68,4,12,,16,"(0.814836,-77.662532)"
2016,Julio,Bolivia,68,0,4,,4,"(10.445761,-75.516429)"
2016,Julio,Bolivia,68,1,1,,2,"(10.886611,-74.776708)"
2016,Julio,Bolivia,68,0,2,,2,"(12.586067,-81.702563)"
2016,Julio,Bolivia,68,36,49,,85,"(3.541112,-76.384584)"
2016,Julio,Bolivia,68,295,430,,725,"(4.697144,-74.140516)"
2016,Julio,Bolivia,68,6,10,,16,"(4.815061,-75.736532)"
2016,Julio,Bolivia,68,15,31,,46,"(6.171601,-75.427454)"
2016,Julio,Botsuana,72,0,1,,1,"(4.697144,-74.140516)"
2016,Julio,Brasil,76,112,268,,380,"(-4.197703,-69.941278)"
2016,Julio,Brasil,76,0,2,,2,"(-4.223468,-69.945098)"
2016,Julio,Brasil,76,1,7,,8,"(0.814836,-77.662532)"
2016,Julio,Brasil,76,12,9,,21,"(10.445761,-75.516429)"
2016,Julio,Brasil,76,12,11,,23,"(10.886611,-74.776708)"
2016,Julio,Brasil,76,17,14,,31,"(12.586067,-81.702563)"
2016,Julio,Brasil,76,98,134,,232,"(3.541112,-76.384584)"
2016,Julio,Brasil,76,2957,3761,,6718,"(4.697144,-74.140516)"
2016,Julio,Brasil,76,6,24,,30,"(4.815061,-75.736532)"
2016,Julio,Brasil,76,124,251,,375,"(6.171601,-75.427454)"
2016,Julio,Brasil,76,2,1,,3,"(7.128456,-73.183637)"
2016,Julio,Brasil,76,1,0,,1,"(7.927209,-72.507910)"
2016,Julio,Bulgaria,100,1,0,,1,"(10.886611,-74.776708)"
2016,Julio,Bulgaria,100,1,2,,3,"(4.697144,-74.140516)"
2016,Julio,Islas Caimán/Territorio Británico de Ultramar,136,0,1,,1,"(10.445761,-75.516429)"
2016,Julio,Islas Caimán/Territorio Británico de Ultramar,136,1,2,,3,"(12.586067,-81.702563)"
2016,Julio,Islas Caimán/Territorio Británico de Ultramar,136,1,0,,1,"(3.541112,-76.384584)"
2016,Julio,Islas Caimán/Territorio Británico de Ultramar,136,4,1,,5,"(4.697144,-74.140516)"
2016,Julio,Islas Caimán/Territorio Británico de Ultramar,136,2,0,,2,"(6.171601,-75.427454)"
2016,Julio,Camboya,116,1,0,,1,"(4.697144,-74.140516)"
2016,Julio,Camerún,120,2,2,,4,"(4.697144,-74.140516)"
2016,Julio,Canadá,124,46,33,,79,"(10.445761,-75.516429)"
2016,Julio,Canadá,124,39,36,,75,"(10.886611,-74.776708)"
2016,Julio,Canadá,124,2,3,,5,"(12.586067,-81.702563)"
2016,Julio,Canadá,124,179,104,,283,"(3.541112,-76.384584)"
2016,Julio,Canadá,124,2160,1681,,3841,"(4.697144,-74.140516)"
2016,Julio,Canadá,124,23,13,,36,"(4.815061,-75.736532)"
2016,Julio,Canadá,124,312,262,,574,"(6.171601,-75.427454)"
2016,Julio,Canadá,124,21,17,,38,"(7.128456,-73.183637)"
2016,Julio,Canadá,124,10,10,,20,"(7.927209,-72.507910)"
2016,Julio,España,724,23,11,,34,"(10.445761,-75.516429)"
2016,Julio,España,724,73,36,,109,"(10.886611,-74.776708)"
2016,Julio,España,724,3567,2234,,5801,"(3.541112,-76.384584)"
2016,Julio,España,724,11468,8448,,19916,"(4.697144,-74.140516)"
2016,Julio,España,724,92,58,,150,"(4.815061,-75.736532)"
2016,Julio,España,724,1574,1120,,2694,"(6.171601,-75.427454)"
2016,Julio,España,724,13,12,,25,"(7.128456,-73.183637)"
2016,Julio,España,724,5,3,,8,"(7.927209,-72.507910)"
2016,Julio,Colombia,170,0,4,,4,"(10.445761,-75.516429)"
2016,Julio,Colombia,170,76,208,,284,"(4.697144,-74.140516)"
2016,Julio,República Del Congo,178,0,1,,1,"(4.697144,-74.140516)"
2016,Julio,República de Corea,410,1,0,,1,"(3.541112,-76.384584)"
2016,Julio,República de Corea,410,19,12,,31,"(4.697144,-74.140516)"
2016,Julio,República de Corea,410,1,0,,1,"(6.171601,-75.427454)"
2016,Julio,Costa de Marfil,384,3,4,,7,"(4.697144,-74.140516)"
2016,Julio,Costa de Marfil,384,0,1,,1,"(6.171601,-75.427454)"
2016,Julio,Costa Rica,188,13,18,,31,"(10.445761,-75.516429)"
2016,Julio,Costa Rica,188,18,24,,42,"(10.886611,-74.776708)"
2016,Julio,Costa Rica,188,3,24,,27,"(12.5744111,-81.703935)"
2016,Julio,Costa Rica,188,7,12,,19,"(12.586067,-81.702563)"
2016,Julio,Costa Rica,188,50,51,,101,"(3.541112,-76.384584)"
2016,Julio,Costa Rica,188,1098,1252,,2350,"(4.697144,-74.140516)"
2016,Julio,Costa Rica,188,21,17,,38,"(4.815061,-75.736532)"
2016,Julio,Costa Rica,188,180,205,,385,"(6.171601,-75.427454)"
2016,Julio,Costa Rica,188,6,7,,13,"(7.128456,-73.183637)"
2016,Julio,Costa Rica,188,0,1,,1,"(7.927209,-72.507910)"
2016,Julio,Croacia,191,3,5,,8,"(4.697144,-74.140516)"
2016,Julio,Cuba,192,13,13,,26,"(10.445761,-75.516429)"
2016,Julio,Cuba,192,9,19,,28,"(10.886611,-74.776708)"
2016,Julio,Cuba,192,2,3,,5,"(12.586067,-81.702563)"
2016,Julio,Cuba,192,110,88,,198,"(3.541112,-76.384584)"
2016,Julio,Cuba,192,1260,1154,,2414,"(4.697144,-74.140516)"
2016,Julio,Cuba,192,10,8,,18,"(4.815061,-75.736532)"
2016,Julio,Cuba,192,117,105,,222,"(6.171601,-75.427454)"
2016,Julio,Cuba,192,2,4,,6,"(7.128456,-73.183637)"
2016,Julio,Cuba,192,2,3,,5,"(7.927209,-72.507910)"
2016,Julio,Curazao,99999,6,51,,57,"(4.697144,-74.140516)"
2016,Julio,República Checa,203,2,3,,5,"(10.886611,-74.776708)"
2016,Julio,República Checa,203,0,2,,2,"(3.541112,-76.384584)"
2016,Julio,República Checa,203,7,5,,12,"(4.697144,-74.140516)"
2016,Julio,República Checa,203,1,0,,1,"(6.171601,-75.427454)"
2016,Julio,Chile,152,200,195,,395,"(0.814836,-77.662532)"
2016,Julio,Chile,152,11,10,,21,"(10.445761,-75.516429)"
2016,Julio,Chile,152,17,16,,33,"(10.886611,-74.776708)"
2016,Julio,Chile,152,10,11,,21,"(12.586067,-81.702563)"
2016,Julio,Chile,152,224,157,,381,"(3.541112,-76.384584)"
2016,Julio,Chile,152,3871,3469,,7340,"(4.697144,-74.140516)"
2016,Julio,Chile,152,39,35,,74,"(4.815061,-75.736532)"
2016,Julio,Chile,152,99,77,,176,"(6.171601,-75.427454)"
2016,Julio,Chile,152,9,8,,17,"(7.128456,-73.183637)"
2016,Julio,Chile,152,3,2,,5,"(7.927209,-72.507910)"
2016,Julio,China,156,2,5,,7,"(10.886611,-74.776708)"
2016,Julio,China,156,5,15,,20,"(3.541112,-76.384584)"
2016,Julio,China,156,179,344,,523,"(4.697144,-74.140516)"
2016,Julio,China,156,1,4,,5,"(4.815061,-75.736532)"
2016,Julio,China,156,15,29,,44,"(6.171601,-75.427454)"
2016,Julio,Chipre,196,1,1,,2,"(4.697144,-74.140516)"
2016,Julio,Dinamarca,208,3,0,,3,"(10.886611,-74.776708)"
2016,Julio,Dinamarca,208,8,2,,10,"(3.541112,-76.384584)"
2016,Julio,Dinamarca,208,55,41,,96,"(4.697144,-74.140516)"
2016,Julio,Dinamarca,208,7,0,,7,"(6.171601,-75.427454)"
2016,Julio,Dominica,212,4,10,,14,"(4.697144,-74.140516)"
2016,Julio,Ecuador,218,8,4,,12,"(-0.193180,-74.784874)"
2016,Julio,Ecuador,218,461,729,,1190,"(0.25129,-76.875963)"
2016,Julio,Ecuador,218,20,33,,53,"(0.812436,-77.847006)"
2016,Julio,Ecuador,218,7332,10105,,17437,"(0.814836,-77.662532)"
2016,Julio,Ecuador,218,4,13,,17,"(1.812361,-78.751529)"
2016,Julio,Ecuador,218,168,169,,337,"(1.813928,-78.763924)"
2016,Julio,Ecuador,218,0,10,,10,"(10.408582,-75.538003)"
2016,Julio,Ecuador,218,6,7,,13,"(10.445761,-75.516429)"
2016,Julio,Ecuador,218,4,16,,20,"(10.886611,-74.776708)"
2016,Julio,Ecuador,218,3,1,,4,"(12.586067,-81.702563)"
2016,Julio,Ecuador,218,312,384,,696,"(3.541112,-76.384584)"
2016,Julio,Ecuador,218,2691,4533,,7224,"(4.697144,-74.140516)"
2016,Julio,Ecuador,218,11,40,,51,"(4.815061,-75.736532)"
2016,Julio,Ecuador,218,175,699,,874,"(6.171601,-75.427454)"
2016,Julio,Ecuador,218,0,1,,1,"(6.228046,-77.404104)"
2016,Julio,Ecuador,218,4,0,,4,"(7.128456,-73.183637)"
2016,Julio,Ecuador,218,1,0,,1,"(7.927209,-72.507910)"
2016,Julio,Egipto,818,1,1,,2,"(3.541112,-76.384584)"
2016,Julio,Egipto,818,14,10,,24,"(4.697144,-74.140516)"
2016,Julio,Egipto,818,2,1,,3,"(6.171601,-75.427454)"
2016,Julio,El Salvador,222,1,3,,4,"(10.445761,-75.516429)"
2016,Julio,El Salvador,222,2,5,,7,"(10.886611,-74.776708)"
2016,Julio,El Salvador,222,1,0,,1,"(12.586067,-81.702563)"
2016,Julio,El Salvador,222,120,114,,234,"(3.541112,-76.384584)"
2016,Julio,El Salvador,222,760,1003,,1763,"(4.697144,-74.140516)"
2016,Julio,El Salvador,222,1,0,,1,"(4.815061,-75.736532)"
2016,Julio,El Salvador,222,62,112,,174,"(6.171601,-75.427454)"
2016,Julio,El Salvador,222,1,2,,3,"(7.128456,-73.183637)"
2016,Julio,El Salvador,222,0,1,,1,"(7.927209,-72.507910)"
2016,Julio,Emiratos Árabes,784,0,1,,1,"(10.886611,-74.776708)"
2016,Julio,Emiratos Árabes,784,3,3,,6,"(3.541112,-76.384584)"
2016,Julio,Emiratos Árabes,784,89,271,,360,"(4.697144,-74.140516)"
2016,Julio,Emiratos Árabes,784,5,6,,11,"(6.171601,-75.427454)"
2016,Julio,Eritrea,232,0,1,,1,"(4.697144,-74.140516)"
2016,Julio,Eslovaquia,703,0,4,,4,"(4.697144,-74.140516)"
2016,Julio,Eslovenia,705,0,1,,1,"(3.541112,-76.384584)"
2016,Julio,Eslovenia,705,1,4,,5,"(4.697144,-74.140516)"
2016,Julio,Estados Unidos de América,840,1,0,,1,"(0.814836,-77.662532)"
2016,Julio,Estados Unidos de América,840,4878,3832,,8710,"(10.445761,-75.516429)"
2016,Julio,Estados Unidos de América,840,3736,2823,,6559,"(10.886611,-74.776708)"
2016,Julio,Estados Unidos de América,840,2,5,,7,"(11.117806,-74.232622)"
2016,Julio,Estados Unidos de América,840,54,48,,102,"(12.586067,-81.702563)"
2016,Julio,Estados Unidos de América,840,6950,4679,,11629,"(3.541112,-76.384584)"
2016,Julio,Estados Unidos de América,840,761,579,,1340,"(4.452882,-75.766298)"
2016,Julio,Estados Unidos de América,840,36906,30786,,67692,"(4.697144,-74.140516)"
2016,Julio,Estados Unidos de América,840,927,580,,1507,"(4.815061,-75.736532)"
2016,Julio,Estados Unidos de América,840,11790,9509,,21299,"(6.171601,-75.427454)"
2016,Julio,Estados Unidos de América,840,257,179,,436,"(7.128456,-73.183637)"
2016,Julio,Estados Unidos de América,840,61,65,,126,"(7.927209,-72.507910)"
2016,Julio,Estonia,233,0,2,,2,"(4.697144,-74.140516)"
2016,Julio,Etiopia,231,0,6,,6,"(4.697144,-74.140516)"
2016,Julio,Filipinas,608,1,0,,1,"(10.445761,-75.516429)"
2016,Julio,Filipinas,608,0,1,,1,"(3.541112,-76.384584)"
2016,Julio,Filipinas,608,3,2,,5,"(4.697144,-74.140516)"
2016,Julio,Filipinas,608,2,1,,3,"(6.171601,-75.427454)"
2016,Julio,Finlandia,246,1,0,,1,"(10.445761,-75.516429)"
2016,Julio,Finlandia,246,0,1,,1,"(10.886611,-74.776708)"
2016,Julio,Finlandia,246,1,0,,1,"(3.541112,-76.384584)"
2016,Julio,Finlandia,246,13,15,,28,"(4.697144,-74.140516)"
2016,Julio,Francia,250,5,3,,8,"(10.445761,-75.516429)"
2016,Julio,Francia,250,12,3,,15,"(10.886611,-74.776708)"
2016,Julio,Francia,250,135,84,,219,"(3.541112,-76.384584)"
2016,Julio,Francia,250,2103,1760,,3863,"(4.697144,-74.140516)"
2016,Julio,Francia,250,8,3,,11,"(4.815061,-75.736532)"
2016,Julio,Francia,250,92,69,,161,"(6.171601,-75.427454)"
2016,Julio,Francia,250,2,1,,3,"(7.128456,-73.183637)"
2016,Julio,Francia,250,1,1,,2,"(8.635765,-77.346578)"
2016,Julio,Georgia,268,0,1,,1,"(4.697144,-74.140516)"
2016,Julio,Ghana,288,4,1,,5,"(4.697144,-74.140516)"
2016,Julio,Gibraltar/Territorio Británico de Ultramar,292,3,2,,5,"(0.814836,-77.662532)"
2016,Julio,Gibraltar/Territorio Británico de Ultramar,292,1,2,,3,"(4.697144,-74.140516)"
2016,Julio,Granada,308,0,1,,1,"(4.697144,-74.140516)"
2016,Julio,Grecia,300,1,2,,3,"(3.541112,-76.384584)"
2016,Julio,Grecia,300,27,10,,37,"(4.697144,-74.140516)"
2016,Julio,Grecia,300,3,1,,4,"(6.171601,-75.427454)"
2016,Julio,Guatemala,320,8,19,,27,"(10.445761,-75.516429)"
2016,Julio,Guatemala,320,7,16,,23,"(10.886611,-74.776708)"
2016,Julio,Guatemala,320,1,2,,3,"(11.117806,-74.232622)"
2016,Julio,Guatemala,320,2,2,,4,"(12.586067,-81.702563)"
2016,Julio,Guatemala,320,38,87,,125,"(3.541112,-76.384584)"
2016,Julio,Guatemala,320,582,738,,1320,"(4.697144,-74.140516)"
2016,Julio,Guatemala,320,7,5,,12,"(4.815061,-75.736532)"
2016,Julio,Guatemala,320,125,154,,279,"(6.171601,-75.427454)"
2016,Julio,Guatemala,320,6,6,,12,"(7.128456,-73.183637)"
2016,Julio,Guatemala,320,2,0,,2,"(7.927209,-72.507910)"
2016,Julio,Guyana,328,2,5,,7,"(10.886611,-74.776708)"
2016,Julio,Guyana,328,0,1,,1,"(3.541112,-76.384584)"
2016,Julio,Guyana,328,2,2,,4,"(4.697144,-74.140516)"
2016,Julio,Guinea Ecuatorial,226,1,0,,1,"(3.541112,-76.384584)"
2016,Julio,Guinea Ecuatorial,226,2,4,,6,"(4.697144,-74.140516)"
2016,Julio,Guinea Ecuatorial,226,0,1,,1,"(6.171601,-75.427454)"
2016,Julio,Guadalupe/Territorio Francés,312,0,1,,1,"(4.697144,-74.140516)"
2016,Julio,Guayana Francesa/Departamento de Ultramar Francés,254,2,0,,2,"(4.697144,-74.140516)"
2016,Julio,Guayana Francesa/Departamento de Ultramar Francés,254,0,1,,1,"(4.815061,-75.736532)"
2016,Julio,Haití,332,0,1,,1,"(10.445761,-75.516429)"
2016,Julio,Haití,332,0,4,,4,"(10.886611,-74.776708)"
2016,Julio,Haití,332,5,6,,11,"(4.697144,-74.140516)"
2016,Julio,Haití,332,0,4,,4,"(6.171601,-75.427454)"
2016,Julio,Haití,332,0,1,,1,"(7.128456,-73.183637)"
2016,Julio,Honduras,340,7,2,,9,"(10.445761,-75.516429)"
2016,Julio,Honduras,340,0,1,,1,"(10.886611,-74.776708)"
2016,Julio,Honduras,340,0,2,,2,"(12.5744111,-81.703935)"
2016,Julio,Honduras,340,1,1,,2,"(12.586067,-81.702563)"
2016,Julio,Honduras,340,10,19,,29,"(3.541112,-76.384584)"
2016,Julio,Honduras,340,78,150,,228,"(4.697144,-74.140516)"
2016,Julio,Honduras,340,0,1,,1,"(4.815061,-75.736532)"
2016,Julio,Honduras,340,33,41,,74,"(6.171601,-75.427454)"
2016,Julio,Honduras,340,1,0,,1,"(7.128456,-73.183637)"
2016,Julio,Hong Kong,344,0,1,,1,"(10.886611,-74.776708)"
2016,Julio,Hong Kong,344,1,1,,2,"(3.541112,-76.384584)"
2016,Julio,Hong Kong,344,24,50,,74,"(4.697144,-74.140516)"
2016,Julio,Hong Kong,344,1,2,,3,"(4.815061,-75.736532)"
2016,Julio,Hong Kong,344,0,1,,1,"(6.171601,-75.427454)"
2016,Julio,Hungría,348,1,0,,1,"(3.541112,-76.384584)"
2016,Julio,Hungría,348,4,5,,9,"(4.697144,-74.140516)"
2016,Julio,Hungría,348,1,3,,4,"(6.171601,-75.427454)"
2016,Julio,India,356,1,4,,5,"(3.541112,-76.384584)"
2016,Julio,India,356,25,22,,47,"(4.697144,-74.140516)"
2016,Julio,India,356,1,1,,2,"(6.171601,-75.427454)"
2016,Julio,Indonesia,360,1,1,,2,"(3.541112,-76.384584)"
2016,Julio,Indonesia,360,8,5,,13,"(4.697144,-74.140516)"
2016,Julio,Indonesia,360,1,4,,5,"(6.171601,-75.427454)"
2016,Julio,Iraq,368,1,5,,6,"(4.697144,-74.140516)"
2016,Julio,Irán,364,0,4,,4,"(4.697144,-74.140516)"
2016,Julio,República de Irlanda,372,2,0,,2,"(3.541112,-76.384584)"
2016,Julio,República de Irlanda,372,23,13,,36,"(4.697144,-74.140516)"
2016,Julio,República de Irlanda,372,3,2,,5,"(6.171601,-75.427454)"
2016,Julio,Islandia,352,2,2,,4,"(4.697144,-74.140516)"
2016,Julio,Israel,376,1,0,,1,"(10.445761,-75.516429)"
2016,Julio,Israel,376,22,18,,40,"(3.541112,-76.384584)"
2016,Julio,Israel,376,80,63,,143,"(4.697144,-74.140516)"
2016,Julio,Israel,376,5,4,,9,"(6.171601,-75.427454)"
2016,Julio,Israel,376,0,1,,1,"(7.128456,-73.183637)"
2016,Julio,Italia,380,12,7,,19,"(10.445761,-75.516429)"
2016,Julio,Italia,380,15,7,,22,"(10.886611,-74.776708)"
2016,Julio,Italia,380,205,105,,310,"(3.541112,-76.384584)"
2016,Julio,Italia,380,652,470,,1122,"(4.697144,-74.140516)"
2016,Julio,Italia,380,4,7,,11,"(4.815061,-75.736532)"
2016,Julio,Italia,380,87,46,,133,"(6.171601,-75.427454)"
2016,Julio,Italia,380,0,1,,1,"(7.128456,-73.183637)"
2016,Julio,Italia,380,1,0,,1,"(7.927209,-72.507910)"
2016,Julio,Jamaica,388,1,6,,7,"(10.445761,-75.516429)"
2016,Julio,Jamaica,388,0,4,,4,"(10.886611,-74.776708)"
2016,Julio,Jamaica,388,3,1,,4,"(12.586067,-81.702563)"
2016,Julio,Jamaica,388,7,10,,17,"(3.541112,-76.384584)"
2016,Julio,Jamaica,388,26,26,,52,"(4.697144,-74.140516)"
2016,Julio,Jamaica,388,0,1,,1,"(4.815061,-75.736532)"
2016,Julio,Jamaica,388,14,18,,32,"(6.171601,-75.427454)"
2016,Julio,Jamaica,388,1,1,,2,"(7.128456,-73.183637)"
2016,Julio,Jamaica,388,0,1,,1,"(7.927209,-72.507910)"
2016,Julio,Japón,392,1,7,,8,"(10.445761,-75.516429)"
2016,Julio,Japón,392,1,4,,5,"(10.886611,-74.776708)"
2016,Julio,Japón,392,4,3,,7,"(3.541112,-76.384584)"
2016,Julio,Japón,392,48,64,,112,"(4.697144,-74.140516)"
2016,Julio,Japón,392,11,9,,20,"(6.171601,-75.427454)"
2016,Julio,Jordania,400,1,3,,4,"(4.697144,-74.140516)"
2016,Julio,Kazajistán,398,0,1,,1,"(3.541112,-76.384584)"
2016,Julio,Kazajistán,398,1,2,,3,"(4.697144,-74.140516)"
2016,Julio,Kazajistán,398,0,1,,1,"(6.171601,-75.427454)"
2016,Julio,Kenia,404,0,1,,1,"(3.541112,-76.384584)"
2016,Julio,Kenia,404,5,3,,8,"(4.697144,-74.140516)"
2016,Julio,Kenia,404,1,0,,1,"(6.171601,-75.427454)"
2016,Julio,Kuwait,414,2,2,,4,"(4.697144,-74.140516)"
2016,Julio,Líbano,422,2,2,,4,"(10.886611,-74.776708)"
2016,Julio,Líbano,422,0,1,,1,"(12.586067,-81.702563)"
2016,Julio,Líbano,422,42,50,,92,"(4.697144,-74.140516)"
2016,Julio,Liberia,430,1,1,,2,"(4.697144,-74.140516)"
2016,Julio,Luxemburgo,442,1,2,,3,"(4.697144,-74.140516)"
2016,Julio,Luxemburgo,442,4,0,,4,"(6.171601,-75.427454)"
2016,Julio,Macao,446,1,0,,1,"(4.697144,-74.140516)"
2016,Julio,Madagascar,450,1,0,,1,"(4.697144,-74.140516)"
2016,Julio,Malasia,458,4,4,,8,"(4.697144,-74.140516)"
2016,Julio,Malasia,458,0,3,,3,"(6.171601,-75.427454)"
2016,Julio,Maldivas,462,0,1,,1,"(4.697144,-74.140516)"
2016,Julio,Malta,470,16,12,,28,"(4.697144,-74.140516)"
2016,Julio,Malta,470,1,0,,1,"(6.171601,-75.427454)"
2016,Julio,Marruecos,504,0,1,,1,"(3.541112,-76.384584)"
2016,Julio,Marruecos,504,9,6,,15,"(4.697144,-74.140516)"
2016,Julio,Marruecos,504,1,1,,2,"(6.171601,-75.427454)"
2016,Julio,Mauricio,480,3,0,,3,"(4.697144,-74.140516)"
2016,Julio,México,484,66,56,,122,"(10.445761,-75.516429)"
2016,Julio,México,484,158,119,,277,"(10.886611,-74.776708)"
2016,Julio,México,484,2,1,,3,"(12.586067,-81.702563)"
2016,Julio,México,484,1100,830,,1930,"(3.541112,-76.384584)"
2016,Julio,México,484,13590,11966,,25556,"(4.697144,-74.140516)"
2016,Julio,México,484,140,104,,244,"(4.815061,-75.736532)"
2016,Julio,México,484,1722,1541,,3263,"(6.171601,-75.427454)"
2016,Julio,México,484,74,55,,129,"(7.128456,-73.183637)"
2016,Julio,México,484,26,12,,38,"(7.927209,-72.507910)"
2016,Julio,México,484,0,2,,2,"(8.635765,-77.346578)"
2016,Julio,Mónaco,492,1,0,,1,"(4.697144,-74.140516)"
2016,Julio,Mongolia,496,1,0,,1,"(10.445761,-75.516429)"
2016,Julio,Micronesia,583,1,0,,1,"(6.171601,-75.427454)"
2016,Julio,Myanmar,104,4,0,,4,"(4.697144,-74.140516)"
2016,Julio,Namibia,516,0,1,,1,"(4.697144,-74.140516)"
2016,Julio,Nicaragua,558,1,5,,6,"(10.445761,-75.516429)"
2016,Julio,Nicaragua,558,2,12,,14,"(10.886611,-74.776708)"
2016,Julio,Nicaragua,558,1,3,,4,"(12.586067,-81.702563)"
2016,Julio,Nicaragua,558,10,39,,49,"(3.541112,-76.384584)"
2016,Julio,Nicaragua,558,45,79,,124,"(4.697144,-74.140516)"
2016,Julio,Nicaragua,558,7,8,,15,"(4.815061,-75.736532)"
2016,Julio,Nicaragua,558,10,53,,63,"(6.171601,-75.427454)"
2016,Julio,Nicaragua,558,0,2,,2,"(7.128456,-73.183637)"
2016,Julio,Nicaragua,558,0,2,,2,"(7.927209,-72.507910)"
2016,Julio,Nigeria,566,1,7,,8,"(4.697144,-74.140516)"
2016,Julio,Noruega,578,3,1,,4,"(10.886611,-74.776708)"
2016,Julio,Noruega,578,10,3,,13,"(3.541112,-76.384584)"
2016,Julio,Noruega,578,25,22,,47,"(4.697144,-74.140516)"
2016,Julio,Noruega,578,2,0,,2,"(4.815061,-75.736532)"
2016,Julio,Noruega,578,4,4,,8,"(6.171601,-75.427454)"
2016,Julio,Nueva Zelanda,554,31,20,,51,"(4.697144,-74.140516)"
2016,Julio,Nueva Zelanda,554,3,2,,5,"(6.171601,-75.427454)"
2016,Julio,Omán,512,4,7,,11,"(4.697144,-74.140516)"
2016,Julio,Pakistán,586,0,2,,2,"(3.541112,-76.384584)"
2016,Julio,Pakistán,586,0,2,,2,"(4.697144,-74.140516)"
2016,Julio,Panamá,591,7,82,,89,"(10.408582,-75.538003)"
2016,Julio,Panamá,591,570,511,,1081,"(10.445761,-75.516429)"
2016,Julio,Panamá,591,1028,1009,,2037,"(10.886611,-74.776708)"
2016,Julio,Panamá,591,0,1,,1,"(10.971302,-74.765397)"
2016,Julio,Panamá,591,1,0,,1,"(11.247723,-74.213989)"
2016,Julio,Panamá,591,4,20,,24,"(12.5744111,-81.703935)"
2016,Julio,Panamá,591,132,152,,284,"(12.586067,-81.702563)"
2016,Julio,Panamá,591,2072,1741,,3813,"(3.541112,-76.384584)"
2016,Julio,Panamá,591,2,1,,3,"(3.893038,-77.067921)"
2016,Julio,Panamá,591,319,202,,521,"(4.452882,-75.766298)"
2016,Julio,Panamá,591,9659,10144,,19803,"(4.697144,-74.140516)"
2016,Julio,Panamá,591,638,497,,1135,"(4.815061,-75.736532)"
2016,Julio,Panamá,591,3202,3058,,6260,"(6.171601,-75.427454)"
2016,Julio,Panamá,591,4,10,,14,"(7.102626,-77.762647)"
2016,Julio,Panamá,591,212,212,,424,"(7.128456,-73.183637)"
2016,Julio,Panamá,591,129,134,,263,"(7.927209,-72.507910)"
2016,Julio,Panamá,591,0,72,,72,"(8.066966,-76.735404)"
2016,Julio,Panamá,591,28,69,,97,"(8.635765,-77.346578)"
2016,Julio,Paraguay,600,1,2,,3,"(10.445761,-75.516429)"
2016,Julio,Paraguay,600,8,2,,10,"(10.886611,-74.776708)"
2016,Julio,Paraguay,600,32,29,,61,"(3.541112,-76.384584)"
2016,Julio,Paraguay,600,47,135,,182,"(4.697144,-74.140516)"
2016,Julio,Paraguay,600,8,21,,29,"(4.815061,-75.736532)"
2016,Julio,Paraguay,600,18,14,,32,"(6.171601,-75.427454)"
2016,Julio,Paraguay,600,0,2,,2,"(7.927209,-72.507910)"
2016,Julio,Perú,604,2,3,,5,"(-0.193180,-74.784874)"
2016,Julio,Perú,604,89,127,,216,"(-4.197703,-69.941278)"
2016,Julio,Perú,604,0,1,,1,"(0.25129,-76.875963)"
2016,Julio,Perú,604,108,94,,202,"(0.814836,-77.662532)"
2016,Julio,Perú,604,0,3,,3,"(1.813928,-78.763924)"
2016,Julio,Perú,604,3,5,,8,"(10.445761,-75.516429)"
2016,Julio,Perú,604,5,9,,14,"(10.886611,-74.776708)"
2016,Julio,Perú,604,0,1,,1,"(12.586067,-81.702563)"
2016,Julio,Perú,604,309,332,,641,"(3.541112,-76.384584)"
2016,Julio,Perú,604,0,9,,9,"(3.893038,-77.067921)"
2016,Julio,Perú,604,5210,5861,,11071,"(4.697144,-74.140516)"
2016,Julio,Perú,604,8,3,,11,"(4.815061,-75.736532)"
2016,Julio,Perú,604,273,339,,612,"(6.171601,-75.427454)"
2016,Julio,Perú,604,1,1,,2,"(7.128456,-73.183637)"
2016,Julio,Perú,604,1,0,,1,"(7.927209,-72.507910)"
2016,Julio,Palestina,99999,0,1,,1,"(4.697144,-74.140516)"
2016,Julio,Polonia,616,0,3,,3,"(10.886611,-74.776708)"
2016,Julio,Polonia,616,12,7,,19,"(3.541112,-76.384584)"
2016,Julio,Polonia,616,183,126,,309,"(4.697144,-74.140516)"
2016,Julio,Polonia,616,15,11,,26,"(6.171601,-75.427454)"
2016,Julio,Polonia,616,0,3,,3,"(7.927209,-72.507910)"
2016,Julio,Portugal,620,0,2,,2,"(10.445761,-75.516429)"
2016,Julio,Portugal,620,2,5,,7,"(10.886611,-74.776708)"
2016,Julio,Portugal,620,4,7,,11,"(3.541112,-76.384584)"
2016,Julio,Portugal,620,101,128,,229,"(4.697144,-74.140516)"
2016,Julio,Portugal,620,7,2,,9,"(6.171601,-75.427454)"
2016,Julio,Polinesia Francesa/Colectividad de Ultramar Francesa,258,0,1,,1,"(4.697144,-74.140516)"
2016,Julio,Polinesia Francesa/Colectividad de Ultramar Francesa,258,0,1,,1,"(6.171601,-75.427454)"
2016,Julio,Puerto Rico/Territorio de Estados Unidos,630,13,24,,37,"(10.445761,-75.516429)"
2016,Julio,Puerto Rico/Territorio de Estados Unidos,630,21,16,,37,"(10.886611,-74.776708)"
2016,Julio,Puerto Rico/Territorio de Estados Unidos,630,43,42,,85,"(3.541112,-76.384584)"
2016,Julio,Puerto Rico/Territorio de Estados Unidos,630,663,581,,1244,"(4.697144,-74.140516)"
2016,Julio,Puerto Rico/Territorio de Estados Unidos,630,8,11,,19,"(4.815061,-75.736532)"
2016,Julio,Puerto Rico/Territorio de Estados Unidos,630,68,65,,133,"(6.171601,-75.427454)"
2016,Julio,Puerto Rico/Territorio de Estados Unidos,630,5,2,,7,"(7.128456,-73.183637)"
2016,Julio,Puerto Rico/Territorio de Estados Unidos,630,1,0,,1,"(7.927209,-72.507910)"
2016,Julio,Qatar,634,0,1,,1,"(3.541112,-76.384584)"
2016,Julio,Qatar,634,7,4,,11,"(4.697144,-74.140516)"
2016,Julio,Qatar,634,2,1,,3,"(6.171601,-75.427454)"
2016,Julio,Reino Unido de Gran Bretaña e Irlanda del Norte,826,2,0,,2,"(10.445761,-75.516429)"
2016,Julio,Reino Unido de Gran Bretaña e Irlanda del Norte,826,0,1,,1,"(10.886611,-74.776708)"
2016,Julio,Reino Unido de Gran Bretaña e Irlanda del Norte,826,32,22,,54,"(3.541112,-76.384584)"
2016,Julio,Reino Unido de Gran Bretaña e Irlanda del Norte,826,1770,1413,,3183,"(4.697144,-74.140516)"
2016,Julio,Reino Unido de Gran Bretaña e Irlanda del Norte,826,1,2,,3,"(4.815061,-75.736532)"
2016,Julio,Reino Unido de Gran Bretaña e Irlanda del Norte,826,22,15,,37,"(6.171601,-75.427454)"
2016,Julio,República CentroÁfricana,140,2,1,,3,"(3.541112,-76.384584)"
2016,Julio,República CentroÁfricana,140,0,2,,2,"(4.697144,-74.140516)"
2016,Julio,Federación de Rusia,643,0,1,,1,"(10.886611,-74.776708)"
2016,Julio,Federación de Rusia,643,1,0,,1,"(3.541112,-76.384584)"
2016,Julio,Federación de Rusia,643,43,44,,87,"(4.697144,-74.140516)"
2016,Julio,Federación de Rusia,643,3,2,,5,"(6.171601,-75.427454)"
2016,Julio,República Dominicana,214,30,35,,65,"(10.445761,-75.516429)"
2016,Julio,República Dominicana,214,34,42,,76,"(10.886611,-74.776708)"
2016,Julio,República Dominicana,214,3,3,,6,"(12.586067,-81.702563)"
2016,Julio,República Dominicana,214,135,120,,255,"(3.541112,-76.384584)"
2016,Julio,República Dominicana,214,2978,2846,,5824,"(4.697144,-74.140516)"
2016,Julio,República Dominicana,214,45,45,,90,"(4.815061,-75.736532)"
2016,Julio,República Dominicana,214,224,204,,428,"(6.171601,-75.427454)"
2016,Julio,República Dominicana,214,49,43,,92,"(7.128456,-73.183637)"
2016,Julio,República Dominicana,214,9,11,,20,"(7.927209,-72.507910)"
2016,Julio,Reunión,638,1,0,,1,"(4.697144,-74.140516)"
2016,Julio,Rumania,642,3,5,,8,"(4.697144,-74.140516)"
2016,Julio,Sahara Occidental/Desierto Sahara,732,0,1,,1,"(4.697144,-74.140516)"
2016,Julio,Santo Tomé y Príncipe,678,0,1,,1,"(4.697144,-74.140516)"
2016,Julio,Senegal,686,0,1,,1,"(4.697144,-74.140516)"
2016,Julio,Serbia,688,1,0,,1,"(10.886611,-74.776708)"
2016,Julio,Serbia,688,1,0,,1,"(4.697144,-74.140516)"
2016,Julio,Singapur,702,7,6,,13,"(4.697144,-74.140516)"
2016,Julio,Singapur,702,1,0,,1,"(6.171601,-75.427454)"
2016,Julio,República Árabe Siria,760,0,1,,1,"(4.697144,-74.140516)"
2016,Julio,Sudáfrica,710,1,0,,1,"(3.541112,-76.384584)"
2016,Julio,Sudáfrica,710,11,14,,25,"(4.697144,-74.140516)"
2016,Julio,Sudáfrica,710,1,0,,1,"(4.815061,-75.736532)"
2016,Julio,Sudáfrica,710,0,1,,1,"(6.171601,-75.427454)"
2016,Julio,Sudán,736,0,2,,2,"(6.171601,-75.427454)"
2016,Julio,Suecia,752,1,0,,1,"(10.445761,-75.516429)"
2016,Julio,Suecia,752,5,6,,11,"(10.886611,-74.776708)"
2016,Julio,Suecia,752,35,21,,56,"(3.541112,-76.384584)"
2016,Julio,Suecia,752,112,89,,201,"(4.697144,-74.140516)"
2016,Julio,Suecia,752,1,0,,1,"(4.815061,-75.736532)"
2016,Julio,Suecia,752,16,10,,26,"(6.171601,-75.427454)"
2016,Julio,Suiza,756,0,1,,1,"(10.445761,-75.516429)"
2016,Julio,Suiza,756,4,2,,6,"(10.886611,-74.776708)"
2016,Julio,Suiza,756,0,1,,1,"(12.586067,-81.702563)"
2016,Julio,Suiza,756,81,43,,124,"(3.541112,-76.384584)"
2016,Julio,Suiza,756,261,171,,432,"(4.697144,-74.140516)"
2016,Julio,Suiza,756,3,0,,3,"(4.815061,-75.736532)"
2016,Julio,Suiza,756,42,19,,61,"(6.171601,-75.427454)"
2016,Julio,Surinam,740,0,1,,1,"(10.886611,-74.776708)"
2016,Julio,Surinam,740,1,4,,5,"(4.697144,-74.140516)"
2016,Julio,Surinam,740,2,1,,3,"(6.171601,-75.427454)"
2016,Julio,Taiwán,158,3,4,,7,"(4.697144,-74.140516)"
2016,Julio,Taiwán,158,0,2,,2,"(6.171601,-75.427454)"
2016,Julio,Tailandia,764,3,0,,3,"(3.541112,-76.384584)"
2016,Julio,Tailandia,764,20,25,,45,"(4.697144,-74.140516)"
2016,Julio,Tanzania,834,2,3,,5,"(4.697144,-74.140516)"
2016,Julio,Tonga,776,1,0,,1,"(10.886611,-74.776708)"
2016,Julio,Trinidad y Tobago,780,1,4,,5,"(10.445761,-75.516429)"
2016,Julio,Trinidad y Tobago,780,3,4,,7,"(10.886611,-74.776708)"
2016,Julio,Trinidad y Tobago,780,5,10,,15,"(3.541112,-76.384584)"
2016,Julio,Trinidad y Tobago,780,27,28,,55,"(4.697144,-74.140516)"
2016,Julio,Trinidad y Tobago,780,4,3,,7,"(4.815061,-75.736532)"
2016,Julio,Trinidad y Tobago,780,12,13,,25,"(6.171601,-75.427454)"
2016,Julio,Trinidad y Tobago,780,2,1,,3,"(7.128456,-73.183637)"
2016,Julio,Trinidad y Tobago,780,0,1,,1,"(7.927209,-72.507910)"
2016,Julio,Túnez,788,1,1,,2,"(4.697144,-74.140516)"
2016,Julio,Turquía,792,0,1,,1,"(10.886611,-74.776708)"
2016,Julio,Turquía,792,1,1,,2,"(3.541112,-76.384584)"
2016,Julio,Turquía,792,240,217,,457,"(4.697144,-74.140516)"
2016,Julio,Turquía,792,2,1,,3,"(6.171601,-75.427454)"
2016,Julio,Turkmenistán,795,1,6,,7,"(4.697144,-74.140516)"
2016,Julio,Ucrania,804,1,0,,1,"(3.541112,-76.384584)"
2016,Julio,Ucrania,804,1,1,,2,"(4.697144,-74.140516)"
2016,Julio,Uganda,800,1,0,,1,"(4.697144,-74.140516)"
2016,Julio,Uruguay,858,1,3,,4,"(10.445761,-75.516429)"
2016,Julio,Uruguay,858,1,0,,1,"(10.886611,-74.776708)"
2016,Julio,Uruguay,858,8,17,,25,"(3.541112,-76.384584)"
2016,Julio,Uruguay,858,104,111,,215,"(4.697144,-74.140516)"
2016,Julio,Uruguay,858,0,3,,3,"(4.815061,-75.736532)"
2016,Julio,Uruguay,858,16,21,,37,"(6.171601,-75.427454)"
2016,Julio,Venezuela,862,0,8,,8,"(10.408582,-75.538003)"
2016,Julio,Venezuela,862,17,9,,26,"(10.445761,-75.516429)"
2016,Julio,Venezuela,862,39,24,,63,"(10.886611,-74.776708)"
2016,Julio,Venezuela,862,0,1,,1,"(10.971302,-74.765397)"
2016,Julio,Venezuela,862,2,1,,3,"(11.117806,-74.232622)"
2016,Julio,Venezuela,862,58,108,,166,"(11.360009,-72.129330)"
2016,Julio,Venezuela,862,0,2,,2,"(12.586067,-81.702563)"
2016,Julio,Venezuela,862,23,28,,51,"(3.541112,-76.384584)"
2016,Julio,Venezuela,862,2,0,,2,"(3.866713,-67.927521)"
2016,Julio,Venezuela,862,1446,1713,,3159,"(4.697144,-74.140516)"
2016,Julio,Venezuela,862,7,2,,9,"(4.815061,-75.736532)"
2016,Julio,Venezuela,862,258,353,,611,"(6.171601,-75.427454)"
2016,Julio,Venezuela,862,2,0,,2,"(6.185799,-67.483929)"
2016,Julio,Venezuela,862,7,7,,14,"(7.088729,-70.740253)"
2016,Julio,Venezuela,862,13,10,,23,"(7.128456,-73.183637)"
2016,Julio,Venezuela,862,284,287,,571,"(7.818934,-72.453226)"
2016,Julio,Venezuela,862,1,4,,5,"(7.927209,-72.507910)"
2016,Julio,Vietnam,704,1,0,,1,"(3.541112,-76.384584)"
2016,Julio,Vietnam,704,1,3,,4,"(4.697144,-74.140516)"
2016,Agosto,Afganistán,4,0,8,,8,"(4.697144,-74.140516)"
2016,Agosto,Afganistán,4,1,0,,1,"(6.171601,-75.427454)"
2016,Agosto,Albania,8,0,11,,11,"(4.697144,-74.140516)"
2016,Agosto,Alemania,276,0,1,,1,"(0.814836,-77.662532)"
2016,Agosto,Alemania,276,3,4,,7,"(10.445761,-75.516429)"
2016,Agosto,Alemania,276,8,4,,12,"(10.886611,-74.776708)"
2016,Agosto,Alemania,276,78,40,,118,"(3.541112,-76.384584)"
2016,Agosto,Alemania,276,1171,869,,2040,"(4.697144,-74.140516)"
2016,Agosto,Alemania,276,0,1,,1,"(4.815061,-75.736532)"
2016,Agosto,Alemania,276,76,45,,121,"(6.171601,-75.427454)"
2016,Agosto,Alemania,276,0,1,,1,"(7.128456,-73.183637)"
2016,Agosto,Andorra,20,2,2,,4,"(4.697144,-74.140516)"
2016,Agosto,Angola,24,1,10,,11,"(4.697144,-74.140516)"
2016,Agosto,Antigua y Barbuda,28,0,1,,1,"(10.886611,-74.776708)"
2016,Agosto,Antigua y Barbuda,28,0,1,,1,"(3.541112,-76.384584)"
2016,Agosto,Antigua y Barbuda,28,1,0,,1,"(4.697144,-74.140516)"
2016,Agosto,Países Bajos,528,9,6,,15,"(10.445761,-75.516429)"
2016,Agosto,Países Bajos,528,240,162,,402,"(10.886611,-74.776708)"
2016,Agosto,Países Bajos,528,285,162,,447,"(3.541112,-76.384584)"
2016,Agosto,Países Bajos,528,970,762,,1732,"(4.697144,-74.140516)"
2016,Agosto,Países Bajos,528,11,2,,13,"(4.815061,-75.736532)"
2016,Agosto,Países Bajos,528,255,143,,398,"(6.171601,-75.427454)"
2016,Agosto,Países Bajos,528,1,0,,1,"(7.128456,-73.183637)"
2016,Agosto,Arabia Saudita,682,1,0,,1,"(10.445761,-75.516429)"
2016,Agosto,Arabia Saudita,682,1,3,,4,"(3.541112,-76.384584)"
2016,Agosto,Arabia Saudita,682,46,71,,117,"(4.697144,-74.140516)"
2016,Agosto,Arabia Saudita,682,2,1,,3,"(6.171601,-75.427454)"
2016,Agosto,Arabia Saudita,682,2,4,,6,"(7.128456,-73.183637)"
2016,Agosto,Argelia,12,1,0,,1,"(3.541112,-76.384584)"
2016,Agosto,Argelia,12,2,4,,6,"(4.697144,-74.140516)"
2016,Agosto,Argentina,32,1,0,,1,"(0.25129,-76.875963)"
2016,Agosto,Argentina,32,12,45,,57,"(0.814836,-77.662532)"
2016,Agosto,Argentina,32,7,4,,11,"(10.445761,-75.516429)"
2016,Agosto,Argentina,32,12,7,,19,"(10.886611,-74.776708)"
2016,Agosto,Argentina,32,18,14,,32,"(12.586067,-81.702563)"
2016,Agosto,Argentina,32,88,97,,185,"(3.541112,-76.384584)"
2016,Agosto,Argentina,32,2660,2875,,5535,"(4.697144,-74.140516)"
2016,Agosto,Argentina,32,15,16,,31,"(4.815061,-75.736532)"
2016,Agosto,Argentina,32,49,71,,120,"(6.171601,-75.427454)"
2016,Agosto,Argentina,32,5,6,,11,"(7.128456,-73.183637)"
2016,Agosto,Argentina,32,1,1,,2,"(7.927209,-72.507910)"
2016,Agosto,República de Armenia,51,1,2,,3,"(4.697144,-74.140516)"
2016,Agosto,Aruba,533,6,3,,9,"(10.445761,-75.516429)"
2016,Agosto,Aruba,533,87,80,,167,"(10.886611,-74.776708)"
2016,Agosto,Aruba,533,0,3,,3,"(10.971302,-74.765397)"
2016,Agosto,Aruba,533,102,75,,177,"(3.541112,-76.384584)"
2016,Agosto,Aruba,533,1904,1360,,3264,"(4.697144,-74.140516)"
2016,Agosto,Aruba,533,22,39,,61,"(4.815061,-75.736532)"
2016,Agosto,Aruba,533,197,138,,335,"(6.171601,-75.427454)"
2016,Agosto,Aruba,533,19,32,,51,"(7.128456,-73.183637)"
2016,Agosto,Aruba,533,6,9,,15,"(7.927209,-72.507910)"
2016,Agosto,Australia,36,1,0,,1,"(10.445761,-75.516429)"
2016,Agosto,Australia,36,2,1,,3,"(10.886611,-74.776708)"
2016,Agosto,Australia,36,8,9,,17,"(3.541112,-76.384584)"
2016,Agosto,Australia,36,271,174,,445,"(4.697144,-74.140516)"
2016,Agosto,Australia,36,0,2,,2,"(4.815061,-75.736532)"
2016,Agosto,Australia,36,33,31,,64,"(6.171601,-75.427454)"
2016,Agosto,Austria,40,1,0,,1,"(10.886611,-74.776708)"
2016,Agosto,Austria,40,11,1,,12,"(3.541112,-76.384584)"
2016,Agosto,Austria,40,33,31,,64,"(4.697144,-74.140516)"
2016,Agosto,Austria,40,4,4,,8,"(6.171601,-75.427454)"
2016,Agosto,Azerbaiyán,31,10,6,,16,"(4.697144,-74.140516)"
2016,Agosto,Bahamas,44,1,1,,2,"(10.445761,-75.516429)"
2016,Agosto,Bahamas,44,6,3,,9,"(10.886611,-74.776708)"
2016,Agosto,Bahamas,44,7,2,,9,"(3.541112,-76.384584)"
2016,Agosto,Bahamas,44,11,11,,22,"(4.697144,-74.140516)"
2016,Agosto,Bahamas,44,4,2,,6,"(4.815061,-75.736532)"
2016,Agosto,Bahamas,44,6,11,,17,"(6.171601,-75.427454)"
2016,Agosto,Bahamas,44,2,0,,2,"(7.128456,-73.183637)"
2016,Agosto,Bahréin,48,2,5,,7,"(4.697144,-74.140516)"
2016,Agosto,Bangladesh,50,1,1,,2,"(4.697144,-74.140516)"
2016,Agosto,Barbados,52,113,105,,218,"(4.697144,-74.140516)"
2016,Agosto,República de Belarús,112,0,1,,1,"(4.697144,-74.140516)"
2016,Agosto,Bélgica,56,1,0,,1,"(10.445761,-75.516429)"
2016,Agosto,Bélgica,56,9,1,,10,"(10.886611,-74.776708)"
2016,Agosto,Bélgica,56,35,27,,62,"(3.541112,-76.384584)"
2016,Agosto,Bélgica,56,127,81,,208,"(4.697144,-74.140516)"
2016,Agosto,Bélgica,56,6,3,,9,"(4.815061,-75.736532)"
2016,Agosto,Bélgica,56,52,27,,79,"(6.171601,-75.427454)"
2016,Agosto,Belice,84,1,0,,1,"(10.445761,-75.516429)"
2016,Agosto,Belice,84,0,1,,1,"(3.541112,-76.384584)"
2016,Agosto,Belice,84,13,9,,22,"(4.697144,-74.140516)"
2016,Agosto,Belice,84,1,1,,2,"(6.171601,-75.427454)"
2016,Agosto,Benín,204,1,1,,2,"(4.697144,-74.140516)"
2016,Agosto,Bermudas/Territorio Británico de Ultramar,60,1,0,,1,"(3.541112,-76.384584)"
2016,Agosto,Bermudas/Territorio Británico de Ultramar,60,3,0,,3,"(4.697144,-74.140516)"
2016,Agosto,Bolivia,68,3,5,,8,"(0.814836,-77.662532)"
2016,Agosto,Bolivia,68,1,1,,2,"(10.445761,-75.516429)"
2016,Agosto,Bolivia,68,1,4,,5,"(10.886611,-74.776708)"
2016,Agosto,Bolivia,68,26,32,,58,"(3.541112,-76.384584)"
2016,Agosto,Bolivia,68,307,554,,861,"(4.697144,-74.140516)"
2016,Agosto,Bolivia,68,4,3,,7,"(4.815061,-75.736532)"
2016,Agosto,Bolivia,68,20,90,,110,"(6.171601,-75.427454)"
2016,Agosto,Bolivia,68,2,1,,3,"(7.128456,-73.183637)"
2016,Agosto,Bosnia y Herzegovina,70,0,1,,1,"(4.697144,-74.140516)"
2016,Agosto,Brasil,76,158,302,,460,"(-4.197703,-69.941278)"
2016,Agosto,Brasil,76,4,1,,5,"(0.814836,-77.662532)"
2016,Agosto,Brasil,76,1,4,,5,"(10.445761,-75.516429)"
2016,Agosto,Brasil,76,10,13,,23,"(10.886611,-74.776708)"
2016,Agosto,Brasil,76,4,2,,6,"(12.586067,-81.702563)"
2016,Agosto,Brasil,76,72,91,,163,"(3.541112,-76.384584)"
2016,Agosto,Brasil,76,1,1,,2,"(3.866713,-67.927521)"
2016,Agosto,Brasil,76,3067,4121,,7188,"(4.697144,-74.140516)"
2016,Agosto,Brasil,76,6,11,,17,"(4.815061,-75.736532)"
2016,Agosto,Brasil,76,91,155,,246,"(6.171601,-75.427454)"
2016,Agosto,Brasil,76,3,3,,6,"(7.128456,-73.183637)"
2016,Agosto,Bulgaria,100,1,3,,4,"(4.697144,-74.140516)"
2016,Agosto,Cabo Verde,132,1,0,,1,"(4.697144,-74.140516)"
2016,Agosto,Islas Caimán/Territorio Británico de Ultramar,136,1,0,,1,"(10.445761,-75.516429)"
2016,Agosto,Islas Caimán/Territorio Británico de Ultramar,136,4,0,,4,"(12.586067,-81.702563)"
2016,Agosto,Islas Caimán/Territorio Británico de Ultramar,136,9,8,,17,"(4.697144,-74.140516)"
2016,Agosto,Islas Caimán/Territorio Británico de Ultramar,136,1,0,,1,"(6.171601,-75.427454)"
2016,Agosto,Camboya,116,1,0,,1,"(4.697144,-74.140516)"
2016,Agosto,Camerún,120,1,0,,1,"(3.541112,-76.384584)"
2016,Agosto,Camerún,120,0,2,,2,"(4.697144,-74.140516)"
2016,Agosto,Canadá,124,0,1,,1,"(0.814836,-77.662532)"
2016,Agosto,Canadá,124,50,38,,88,"(10.445761,-75.516429)"
2016,Agosto,Canadá,124,57,51,,108,"(10.886611,-74.776708)"
2016,Agosto,Canadá,124,1,0,,1,"(12.586067,-81.702563)"
2016,Agosto,Canadá,124,200,127,,327,"(3.541112,-76.384584)"
2016,Agosto,Canadá,124,1,1,,2,"(4.452882,-75.766298)"
2016,Agosto,Canadá,124,2257,1720,,3977,"(4.697144,-74.140516)"
2016,Agosto,Canadá,124,28,19,,47,"(4.815061,-75.736532)"
2016,Agosto,Canadá,124,411,301,,712,"(6.171601,-75.427454)"
2016,Agosto,Canadá,124,38,25,,63,"(7.128456,-73.183637)"
2016,Agosto,Canadá,124,2,3,,5,"(7.927209,-72.507910)"
2016,Agosto,España,724,18,11,,29,"(10.445761,-75.516429)"
2016,Agosto,España,724,42,29,,71,"(10.886611,-74.776708)"
2016,Agosto,España,724,2768,1672,,4440,"(3.541112,-76.384584)"
2016,Agosto,España,724,10421,7160,,17581,"(4.697144,-74.140516)"
2016,Agosto,España,724,68,49,,117,"(4.815061,-75.736532)"
2016,Agosto,España,724,1470,912,,2382,"(6.171601,-75.427454)"
2016,Agosto,España,724,10,4,,14,"(7.128456,-73.183637)"
2016,Agosto,España,724,2,0,,2,"(7.927209,-72.507910)"
2016,Agosto,Colombia,170,0,9,,9,"(10.445761,-75.516429)"
2016,Agosto,Colombia,170,54,186,,240,"(4.697144,-74.140516)"
2016,Agosto,República Del Congo,178,1,3,,4,"(4.697144,-74.140516)"
2016,Agosto,República Democrática del Congo,180,0,1,,1,"(3.541112,-76.384584)"
2016,Agosto,República de Corea,410,0,1,,1,"(3.541112,-76.384584)"
2016,Agosto,República de Corea,410,28,32,,60,"(4.697144,-74.140516)"
2016,Agosto,República de Corea,410,2,4,,6,"(6.171601,-75.427454)"
2016,Agosto,Costa de Marfil,384,1,2,,3,"(3.541112,-76.384584)"
2016,Agosto,Costa de Marfil,384,5,4,,9,"(4.697144,-74.140516)"
2016,Agosto,Costa de Marfil,384,1,0,,1,"(6.171601,-75.427454)"
2016,Agosto,Costa Rica,188,7,7,,14,"(10.445761,-75.516429)"
2016,Agosto,Costa Rica,188,10,23,,33,"(10.886611,-74.776708)"
2016,Agosto,Costa Rica,188,6,46,,52,"(12.5744111,-81.703935)"
2016,Agosto,Costa Rica,188,4,11,,15,"(12.586067,-81.702563)"
2016,Agosto,Costa Rica,188,0,6,,6,"(13.3387613,-81.372937)"
2016,Agosto,Costa Rica,188,22,34,,56,"(3.541112,-76.384584)"
2016,Agosto,Costa Rica,188,1010,1238,,2248,"(4.697144,-74.140516)"
2016,Agosto,Costa Rica,188,15,9,,24,"(4.815061,-75.736532)"
2016,Agosto,Costa Rica,188,118,148,,266,"(6.171601,-75.427454)"
2016,Agosto,Costa Rica,188,6,3,,9,"(7.128456,-73.183637)"
2016,Agosto,Costa Rica,188,3,2,,5,"(7.927209,-72.507910)"
2016,Agosto,Croacia,191,1,0,,1,"(3.541112,-76.384584)"
2016,Agosto,Croacia,191,8,8,,16,"(4.697144,-74.140516)"
2016,Agosto,Croacia,191,0,2,,2,"(6.171601,-75.427454)"
2016,Agosto,Cuba,192,10,10,,20,"(10.445761,-75.516429)"
2016,Agosto,Cuba,192,16,12,,28,"(10.886611,-74.776708)"
2016,Agosto,Cuba,192,4,2,,6,"(12.586067,-81.702563)"
2016,Agosto,Cuba,192,59,45,,104,"(3.541112,-76.384584)"
2016,Agosto,Cuba,192,1055,1071,,2126,"(4.697144,-74.140516)"
2016,Agosto,Cuba,192,13,12,,25,"(4.815061,-75.736532)"
2016,Agosto,Cuba,192,100,106,,206,"(6.171601,-75.427454)"
2016,Agosto,Cuba,192,9,9,,18,"(7.128456,-73.183637)"
2016,Agosto,Curazao,99999,18,71,,89,"(4.697144,-74.140516)"
2016,Agosto,República Checa,203,0,1,,1,"(3.541112,-76.384584)"
2016,Agosto,República Checa,203,9,5,,14,"(4.697144,-74.140516)"
2016,Agosto,Chile,152,0,1,,1,"(0.25129,-76.875963)"
2016,Agosto,Chile,152,166,162,,328,"(0.814836,-77.662532)"
2016,Agosto,Chile,152,6,5,,11,"(10.445761,-75.516429)"
2016,Agosto,Chile,152,15,10,,25,"(10.886611,-74.776708)"
2016,Agosto,Chile,152,21,14,,35,"(12.586067,-81.702563)"
2016,Agosto,Chile,152,231,173,,404,"(3.541112,-76.384584)"
2016,Agosto,Chile,152,4242,3920,,8162,"(4.697144,-74.140516)"
2016,Agosto,Chile,152,26,14,,40,"(4.815061,-75.736532)"
2016,Agosto,Chile,152,72,65,,137,"(6.171601,-75.427454)"
2016,Agosto,Chile,152,5,8,,13,"(7.128456,-73.183637)"
2016,Agosto,Chile,152,4,3,,7,"(7.927209,-72.507910)"
2016,Agosto,China,156,1,6,,7,"(10.445761,-75.516429)"
2016,Agosto,China,156,2,9,,11,"(10.886611,-74.776708)"
2016,Agosto,China,156,5,23,,28,"(3.541112,-76.384584)"
2016,Agosto,China,156,207,511,,718,"(4.697144,-74.140516)"
2016,Agosto,China,156,1,0,,1,"(4.815061,-75.736532)"
2016,Agosto,China,156,21,40,,61,"(6.171601,-75.427454)"
2016,Agosto,China,156,0,1,,1,"(7.128456,-73.183637)"
2016,Agosto,Chipre,196,0,1,,1,"(4.697144,-74.140516)"
2016,Agosto,Dinamarca,208,3,2,,5,"(3.541112,-76.384584)"
2016,Agosto,Dinamarca,208,31,23,,54,"(4.697144,-74.140516)"
2016,Agosto,Dinamarca,208,1,0,,1,"(4.815061,-75.736532)"
2016,Agosto,Dinamarca,208,2,2,,4,"(6.171601,-75.427454)"
2016,Agosto,Ecuador,218,4,3,,7,"(-0.193180,-74.784874)"
2016,Agosto,Ecuador,218,407,642,,1049,"(0.25129,-76.875963)"
2016,Agosto,Ecuador,218,33,28,,61,"(0.812436,-77.847006)"
2016,Agosto,Ecuador,218,5510,7043,,12553,"(0.814836,-77.662532)"
2016,Agosto,Ecuador,218,143,177,,320,"(1.813928,-78.763924)"
2016,Agosto,Ecuador,218,0,11,,11,"(10.408582,-75.538003)"
2016,Agosto,Ecuador,218,8,9,,17,"(10.445761,-75.516429)"
2016,Agosto,Ecuador,218,7,15,,22,"(10.886611,-74.776708)"
2016,Agosto,Ecuador,218,343,436,,779,"(3.541112,-76.384584)"
2016,Agosto,Ecuador,218,2782,4280,,7062,"(4.697144,-74.140516)"
2016,Agosto,Ecuador,218,6,9,,15,"(4.815061,-75.736532)"
2016,Agosto,Ecuador,218,45,54,,99,"(6.171601,-75.427454)"
2016,Agosto,Ecuador,218,0,2,,2,"(7.128456,-73.183637)"
2016,Agosto,Ecuador,218,0,1,,1,"(8.635765,-77.346578)"
2016,Agosto,Egipto,818,2,1,,3,"(3.541112,-76.384584)"
2016,Agosto,Egipto,818,13,58,,71,"(4.697144,-74.140516)"
2016,Agosto,El Salvador,222,3,4,,7,"(10.445761,-75.516429)"
2016,Agosto,El Salvador,222,1,3,,4,"(10.886611,-74.776708)"
2016,Agosto,El Salvador,222,1,0,,1,"(12.586067,-81.702563)"
2016,Agosto,El Salvador,222,122,134,,256,"(3.541112,-76.384584)"
2016,Agosto,El Salvador,222,745,1080,,1825,"(4.697144,-74.140516)"
2016,Agosto,El Salvador,222,73,90,,163,"(6.171601,-75.427454)"
2016,Agosto,Emiratos Árabes,784,147,191,,338,"(4.697144,-74.140516)"
2016,Agosto,Emiratos Árabes,784,12,9,,21,"(6.171601,-75.427454)"
2016,Agosto,Eslovaquia,703,1,0,,1,"(3.541112,-76.384584)"
2016,Agosto,Eslovaquia,703,2,2,,4,"(4.697144,-74.140516)"
2016,Agosto,Eslovenia,705,0,2,,2,"(4.697144,-74.140516)"
2016,Agosto,Estados Unidos de América,840,4476,3349,,7825,"(10.445761,-75.516429)"
2016,Agosto,Estados Unidos de América,840,3387,2531,,5918,"(10.886611,-74.776708)"
2016,Agosto,Estados Unidos de América,840,91,48,,139,"(12.586067,-81.702563)"
2016,Agosto,Estados Unidos de América,840,6727,4338,,11065,"(3.541112,-76.384584)"
2016,Agosto,Estados Unidos de América,840,841,634,,1475,"(4.452882,-75.766298)"
2016,Agosto,Estados Unidos de América,840,34217,28256,,62473,"(4.697144,-74.140516)"
2016,Agosto,Estados Unidos de América,840,1086,610,,1696,"(4.815061,-75.736532)"
2016,Agosto,Estados Unidos de América,840,11662,9014,,20676,"(6.171601,-75.427454)"
2016,Agosto,Estados Unidos de América,840,221,131,,352,"(7.128456,-73.183637)"
2016,Agosto,Estados Unidos de América,840,48,29,,77,"(7.927209,-72.507910)"
2016,Agosto,Estonia,233,0,2,,2,"(4.697144,-74.140516)"
2016,Agosto,Etiopia,231,0,1,,1,"(4.697144,-74.140516)"
2016,Agosto,Etiopia,231,0,1,,1,"(6.171601,-75.427454)"
2016,Agosto,Filipinas,608,0,1,,1,"(3.541112,-76.384584)"
2016,Agosto,Filipinas,608,5,1,,6,"(4.697144,-74.140516)"
2016,Agosto,Finlandia,246,0,1,,1,"(10.886611,-74.776708)"
2016,Agosto,Finlandia,246,3,0,,3,"(3.541112,-76.384584)"
2016,Agosto,Finlandia,246,8,7,,15,"(4.697144,-74.140516)"
2016,Agosto,Finlandia,246,0,2,,2,"(6.171601,-75.427454)"
2016,Agosto,Francia,250,10,4,,14,"(10.445761,-75.516429)"
2016,Agosto,Francia,250,23,10,,33,"(10.886611,-74.776708)"
2016,Agosto,Francia,250,232,142,,374,"(3.541112,-76.384584)"
2016,Agosto,Francia,250,2368,1710,,4078,"(4.697144,-74.140516)"
2016,Agosto,Francia,250,20,19,,39,"(4.815061,-75.736532)"
2016,Agosto,Francia,250,125,82,,207,"(6.171601,-75.427454)"
2016,Agosto,Francia,250,3,1,,4,"(7.128456,-73.183637)"
2016,Agosto,Francia,250,4,2,,6,"(7.927209,-72.507910)"
2016,Agosto,Gabón,266,2,2,,4,"(4.697144,-74.140516)"
2016,Agosto,Georgia,268,0,1,,1,"(4.697144,-74.140516)"
2016,Agosto,Ghana,288,1,2,,3,"(4.697144,-74.140516)"
2016,Agosto,Ghana,288,0,1,,1,"(6.171601,-75.427454)"
2016,Agosto,Grecia,300,36,15,,51,"(4.697144,-74.140516)"
2016,Agosto,Grecia,300,3,2,,5,"(6.171601,-75.427454)"
2016,Agosto,Guatemala,320,5,6,,11,"(10.445761,-75.516429)"
2016,Agosto,Guatemala,320,7,18,,25,"(10.886611,-74.776708)"
2016,Agosto,Guatemala,320,2,5,,7,"(12.586067,-81.702563)"
2016,Agosto,Guatemala,320,53,63,,116,"(3.541112,-76.384584)"
2016,Agosto,Guatemala,320,535,767,,1302,"(4.697144,-74.140516)"
2016,Agosto,Guatemala,320,7,8,,15,"(4.815061,-75.736532)"
2016,Agosto,Guatemala,320,102,129,,231,"(6.171601,-75.427454)"
2016,Agosto,Guatemala,320,7,12,,19,"(7.128456,-73.183637)"
2016,Agosto,Guyana,328,1,5,,6,"(10.886611,-74.776708)"
2016,Agosto,Guyana,328,0,1,,1,"(3.541112,-76.384584)"
2016,Agosto,Guyana,328,0,2,,2,"(4.697144,-74.140516)"
2016,Agosto,Guyana,328,0,1,,1,"(4.815061,-75.736532)"
2016,Agosto,Guyana,328,3,2,,5,"(6.171601,-75.427454)"
2016,Agosto,Guinea Ecuatorial,226,0,1,,1,"(3.541112,-76.384584)"
2016,Agosto,Guinea Ecuatorial,226,3,2,,5,"(4.697144,-74.140516)"
2016,Agosto,Guinea Bissau,624,1,0,,1,"(4.697144,-74.140516)"
2016,Agosto,Guadalupe/Territorio Francés,312,1,1,,2,"(3.541112,-76.384584)"
2016,Agosto,Guadalupe/Territorio Francés,312,2,2,,4,"(4.697144,-74.140516)"
2016,Agosto,Guadalupe/Territorio Francés,312,1,0,,1,"(6.171601,-75.427454)"
2016,Agosto,Guayana Francesa/Departamento de Ultramar Francés,254,0,2,,2,"(-4.197703,-69.941278)"
2016,Agosto,Guayana Francesa/Departamento de Ultramar Francés,254,2,0,,2,"(4.697144,-74.140516)"
2016,Agosto,Guayana Francesa/Departamento de Ultramar Francés,254,1,3,,4,"(6.171601,-75.427454)"
2016,Agosto,Haití,332,2,0,,2,"(10.445761,-75.516429)"
2016,Agosto,Haití,332,1,2,,3,"(10.886611,-74.776708)"
2016,Agosto,Haití,332,1,1,,2,"(3.541112,-76.384584)"
2016,Agosto,Haití,332,4,9,,13,"(4.697144,-74.140516)"
2016,Agosto,Haití,332,0,5,,5,"(6.171601,-75.427454)"
2016,Agosto,Honduras,340,0,7,,7,"(10.408582,-75.538003)"
2016,Agosto,Honduras,340,2,3,,5,"(10.445761,-75.516429)"
2016,Agosto,Honduras,340,1,5,,6,"(10.886611,-74.776708)"
2016,Agosto,Honduras,340,10,16,,26,"(3.541112,-76.384584)"
2016,Agosto,Honduras,340,93,178,,271,"(4.697144,-74.140516)"
2016,Agosto,Honduras,340,4,4,,8,"(4.815061,-75.736532)"
2016,Agosto,Honduras,340,27,78,,105,"(6.171601,-75.427454)"
2016,Agosto,Honduras,340,6,7,,13,"(7.128456,-73.183637)"
2016,Agosto,Hong Kong,344,1,0,,1,"(3.541112,-76.384584)"
2016,Agosto,Hong Kong,344,26,31,,57,"(4.697144,-74.140516)"
2016,Agosto,Hong Kong,344,3,3,,6,"(6.171601,-75.427454)"
2016,Agosto,Hungría,348,2,2,,4,"(3.541112,-76.384584)"
2016,Agosto,Hungría,348,4,4,,8,"(4.697144,-74.140516)"
2016,Agosto,India,356,1,1,,2,"(10.886611,-74.776708)"
2016,Agosto,India,356,3,3,,6,"(3.541112,-76.384584)"
2016,Agosto,India,356,32,36,,68,"(4.697144,-74.140516)"
2016,Agosto,India,356,4,4,,8,"(6.171601,-75.427454)"
2016,Agosto,India,356,0,1,,1,"(7.128456,-73.183637)"
2016,Agosto,Indonesia,360,6,11,,17,"(4.697144,-74.140516)"
2016,Agosto,Indonesia,360,1,4,,5,"(6.171601,-75.427454)"
2016,Agosto,Iraq,368,0,2,,2,"(4.697144,-74.140516)"
2016,Agosto,Iraq,368,0,1,,1,"(7.128456,-73.183637)"
2016,Agosto,Irán,364,4,1,,5,"(4.697144,-74.140516)"
2016,Agosto,República de Irlanda,372,1,0,,1,"(3.541112,-76.384584)"
2016,Agosto,República de Irlanda,372,10,9,,19,"(4.697144,-74.140516)"
2016,Agosto,República de Irlanda,372,3,1,,4,"(4.815061,-75.736532)"
2016,Agosto,República de Irlanda,372,2,3,,5,"(6.171601,-75.427454)"
2016,Agosto,Islandia,352,4,0,,4,"(3.541112,-76.384584)"
2016,Agosto,Islandia,352,5,3,,8,"(4.697144,-74.140516)"
2016,Agosto,Israel,376,3,1,,4,"(10.445761,-75.516429)"
2016,Agosto,Israel,376,2,1,,3,"(10.886611,-74.776708)"
2016,Agosto,Israel,376,5,6,,11,"(3.541112,-76.384584)"
2016,Agosto,Israel,376,79,86,,165,"(4.697144,-74.140516)"
2016,Agosto,Israel,376,8,6,,14,"(6.171601,-75.427454)"
2016,Agosto,Italia,380,16,3,,19,"(10.445761,-75.516429)"
2016,Agosto,Italia,380,10,11,,21,"(10.886611,-74.776708)"
2016,Agosto,Italia,380,166,89,,255,"(3.541112,-76.384584)"
2016,Agosto,Italia,380,672,439,,1111,"(4.697144,-74.140516)"
2016,Agosto,Italia,380,6,5,,11,"(4.815061,-75.736532)"
2016,Agosto,Italia,380,96,41,,137,"(6.171601,-75.427454)"
2016,Agosto,Italia,380,1,0,,1,"(7.128456,-73.183637)"
2016,Agosto,Italia,380,1,1,,2,"(7.927209,-72.507910)"
2016,Agosto,Jamaica,388,1,4,,5,"(10.445761,-75.516429)"
2016,Agosto,Jamaica,388,9,47,,56,"(10.886611,-74.776708)"
2016,Agosto,Jamaica,388,1,1,,2,"(12.586067,-81.702563)"
2016,Agosto,Jamaica,388,3,3,,6,"(3.541112,-76.384584)"
2016,Agosto,Jamaica,388,39,23,,62,"(4.697144,-74.140516)"
2016,Agosto,Jamaica,388,1,1,,2,"(4.815061,-75.736532)"
2016,Agosto,Jamaica,388,4,7,,11,"(6.171601,-75.427454)"
2016,Agosto,Jamaica,388,1,1,,2,"(7.128456,-73.183637)"
2016,Agosto,Japón,392,0,1,,1,"(10.445761,-75.516429)"
2016,Agosto,Japón,392,1,0,,1,"(10.886611,-74.776708)"
2016,Agosto,Japón,392,3,6,,9,"(3.541112,-76.384584)"
2016,Agosto,Japón,392,70,88,,158,"(4.697144,-74.140516)"
2016,Agosto,Japón,392,5,5,,10,"(6.171601,-75.427454)"
2016,Agosto,Jordania,400,0,2,,2,"(10.408582,-75.538003)"
2016,Agosto,Jordania,400,1,3,,4,"(4.697144,-74.140516)"
2016,Agosto,Kazajistán,398,2,2,,4,"(4.697144,-74.140516)"
2016,Agosto,Kenia,404,5,2,,7,"(4.697144,-74.140516)"
2016,Agosto,Kenia,404,1,0,,1,"(6.171601,-75.427454)"
2016,Agosto,Kuwait,414,5,3,,8,"(4.697144,-74.140516)"
2016,Agosto,República Democrática Popular  Lao,418,1,1,,2,"(4.697144,-74.140516)"
2016,Agosto,Lesoto,426,0,1,,1,"(4.697144,-74.140516)"
2016,Agosto,Letonia,428,0,1,,1,"(4.697144,-74.140516)"
2016,Agosto,Letonia,428,1,0,,1,"(4.815061,-75.736532)"
2016,Agosto,Lituania,440,0,2,,2,"(4.697144,-74.140516)"
2016,Agosto,Lituania,440,1,0,,1,"(6.171601,-75.427454)"
2016,Agosto,Líbano,422,0,4,,4,"(10.886611,-74.776708)"
2016,Agosto,Líbano,422,1,0,,1,"(3.541112,-76.384584)"
2016,Agosto,Líbano,422,24,25,,49,"(4.697144,-74.140516)"
2016,Agosto,Luxemburgo,442,4,3,,7,"(4.697144,-74.140516)"
2016,Agosto,Luxemburgo,442,1,0,,1,"(6.171601,-75.427454)"
2016,Agosto,Macao,446,1,0,,1,"(4.697144,-74.140516)"
2016,Agosto,Malasia,458,1,0,,1,"(3.541112,-76.384584)"
2016,Agosto,Malasia,458,8,4,,12,"(4.697144,-74.140516)"
2016,Agosto,Malasia,458,0,1,,1,"(4.815061,-75.736532)"
2016,Agosto,Malasia,458,2,1,,3,"(6.171601,-75.427454)"
2016,Agosto,Malí,466,0,2,,2,"(4.697144,-74.140516)"
2016,Agosto,Malta,470,0,1,,1,"(3.541112,-76.384584)"
2016,Agosto,Malta,470,12,9,,21,"(4.697144,-74.140516)"
2016,Agosto,Malta,470,0,1,,1,"(6.171601,-75.427454)"
2016,Agosto,Marruecos,504,1,0,,1,"(3.541112,-76.384584)"
2016,Agosto,Marruecos,504,8,4,,12,"(4.697144,-74.140516)"
2016,Agosto,Marruecos,504,2,1,,3,"(6.171601,-75.427454)"
2016,Agosto,Martinica/Departamento de Ultramar Francés,474,2,2,,4,"(4.697144,-74.140516)"
2016,Agosto,México,484,1,0,,1,"(0.814836,-77.662532)"
2016,Agosto,México,484,64,57,,121,"(10.445761,-75.516429)"
2016,Agosto,México,484,135,101,,236,"(10.886611,-74.776708)"
2016,Agosto,México,484,4,3,,7,"(12.586067,-81.702563)"
2016,Agosto,México,484,1081,878,,1959,"(3.541112,-76.384584)"
2016,Agosto,México,484,13683,12088,,25771,"(4.697144,-74.140516)"
2016,Agosto,México,484,152,120,,272,"(4.815061,-75.736532)"
2016,Agosto,México,484,2109,1604,,3713,"(6.171601,-75.427454)"
2016,Agosto,México,484,127,74,,201,"(7.128456,-73.183637)"
2016,Agosto,México,484,12,18,,30,"(7.927209,-72.507910)"
2016,Agosto,Mónaco,492,1,0,,1,"(4.697144,-74.140516)"
2016,Agosto,Mónaco,492,1,0,,1,"(6.171601,-75.427454)"
2016,Agosto,Mongolia,496,0,1,,1,"(4.697144,-74.140516)"
2016,Agosto,Montenegro,499,0,2,,2,"(4.697144,-74.140516)"
2016,Agosto,Namibia,516,1,0,,1,"(4.697144,-74.140516)"
2016,Agosto,Nepal,524,2,0,,2,"(4.697144,-74.140516)"
2016,Agosto,Nicaragua,558,3,7,,10,"(10.445761,-75.516429)"
2016,Agosto,Nicaragua,558,2,2,,4,"(10.886611,-74.776708)"
2016,Agosto,Nicaragua,558,1,2,,3,"(12.586067,-81.702563)"
2016,Agosto,Nicaragua,558,12,31,,43,"(3.541112,-76.384584)"
2016,Agosto,Nicaragua,558,32,71,,103,"(4.697144,-74.140516)"
2016,Agosto,Nicaragua,558,5,7,,12,"(4.815061,-75.736532)"
2016,Agosto,Nicaragua,558,22,77,,99,"(6.171601,-75.427454)"
2016,Agosto,Nicaragua,558,0,1,,1,"(7.128456,-73.183637)"
2016,Agosto,Nigeria,566,0,8,,8,"(4.697144,-74.140516)"
2016,Agosto,Nigeria,566,0,1,,1,"(6.171601,-75.427454)"
2016,Agosto,Noruega,578,2,2,,4,"(10.886611,-74.776708)"
2016,Agosto,Noruega,578,5,5,,10,"(3.541112,-76.384584)"
2016,Agosto,Noruega,578,27,36,,63,"(4.697144,-74.140516)"
2016,Agosto,Noruega,578,4,3,,7,"(6.171601,-75.427454)"
2016,Agosto,Noruega,578,0,1,,1,"(7.128456,-73.183637)"
2016,Agosto,Nueva Zelanda,554,36,15,,51,"(4.697144,-74.140516)"
2016,Agosto,Nueva Zelanda,554,4,4,,8,"(6.171601,-75.427454)"
2016,Agosto,Nueva Zelanda,554,0,1,,1,"(7.128456,-73.183637)"
2016,Agosto,Omán,512,9,12,,21,"(4.697144,-74.140516)"
2016,Agosto,Omán,512,2,1,,3,"(6.171601,-75.427454)"
2016,Agosto,Papúa Nueva Guinea,598,1,0,,1,"(4.697144,-74.140516)"
2016,Agosto,Panamá,591,8,79,,87,"(10.408582,-75.538003)"
2016,Agosto,Panamá,591,649,597,,1246,"(10.445761,-75.516429)"
2016,Agosto,Panamá,591,1058,1062,,2120,"(10.886611,-74.776708)"
2016,Agosto,Panamá,591,0,11,,11,"(10.971302,-74.765397)"
2016,Agosto,Panamá,591,1,3,,4,"(11.247723,-74.213989)"
2016,Agosto,Panamá,591,2,16,,18,"(12.5744111,-81.703935)"
2016,Agosto,Panamá,591,140,150,,290,"(12.586067,-81.702563)"
2016,Agosto,Panamá,591,2058,1781,,3839,"(3.541112,-76.384584)"
2016,Agosto,Panamá,591,295,253,,548,"(4.452882,-75.766298)"
2016,Agosto,Panamá,591,9075,9832,,18907,"(4.697144,-74.140516)"
2016,Agosto,Panamá,591,646,482,,1128,"(4.815061,-75.736532)"
2016,Agosto,Panamá,591,3579,3354,,6933,"(6.171601,-75.427454)"
2016,Agosto,Panamá,591,7,9,,16,"(7.102626,-77.762647)"
2016,Agosto,Panamá,591,212,207,,419,"(7.128456,-73.183637)"
2016,Agosto,Panamá,591,80,112,,192,"(7.927209,-72.507910)"
2016,Agosto,Panamá,591,0,42,,42,"(8.066966,-76.735404)"
2016,Agosto,Panamá,591,55,84,,139,"(8.635765,-77.346578)"
2016,Agosto,Paraguay,600,2,3,,5,"(10.445761,-75.516429)"
2016,Agosto,Paraguay,600,3,5,,8,"(10.886611,-74.776708)"
2016,Agosto,Paraguay,600,0,1,,1,"(12.586067,-81.702563)"
2016,Agosto,Paraguay,600,48,48,,96,"(3.541112,-76.384584)"
2016,Agosto,Paraguay,600,56,145,,201,"(4.697144,-74.140516)"
2016,Agosto,Paraguay,600,7,15,,22,"(4.815061,-75.736532)"
2016,Agosto,Paraguay,600,19,28,,47,"(6.171601,-75.427454)"
2016,Agosto,Paraguay,600,1,0,,1,"(7.128456,-73.183637)"
2016,Agosto,Perú,604,1,2,,3,"(-0.193180,-74.784874)"
2016,Agosto,Perú,604,116,111,,227,"(-4.197703,-69.941278)"
2016,Agosto,Perú,604,65,91,,156,"(0.814836,-77.662532)"
2016,Agosto,Perú,604,4,8,,12,"(10.445761,-75.516429)"
2016,Agosto,Perú,604,20,24,,44,"(10.886611,-74.776708)"
2016,Agosto,Perú,604,2,3,,5,"(12.586067,-81.702563)"
2016,Agosto,Perú,604,276,288,,564,"(3.541112,-76.384584)"
2016,Agosto,Perú,604,5135,5992,,11127,"(4.697144,-74.140516)"
2016,Agosto,Perú,604,6,14,,20,"(4.815061,-75.736532)"
2016,Agosto,Perú,604,359,383,,742,"(6.171601,-75.427454)"
2016,Agosto,Perú,604,3,3,,6,"(7.128456,-73.183637)"
2016,Agosto,Perú,604,1,0,,1,"(7.927209,-72.507910)"
2016,Agosto,Polonia,616,0,1,,1,"(3.541112,-76.384584)"
2016,Agosto,Polonia,616,26,20,,46,"(4.697144,-74.140516)"
2016,Agosto,Portugal,620,0,3,,3,"(10.445761,-75.516429)"
2016,Agosto,Portugal,620,1,1,,2,"(10.886611,-74.776708)"
2016,Agosto,Portugal,620,5,8,,13,"(3.541112,-76.384584)"
2016,Agosto,Portugal,620,78,112,,190,"(4.697144,-74.140516)"
2016,Agosto,Portugal,620,2,2,,4,"(4.815061,-75.736532)"
2016,Agosto,Portugal,620,6,10,,16,"(6.171601,-75.427454)"
2016,Agosto,Puerto Rico/Territorio de Estados Unidos,630,9,10,,19,"(10.445761,-75.516429)"
2016,Agosto,Puerto Rico/Territorio de Estados Unidos,630,19,15,,34,"(10.886611,-74.776708)"
2016,Agosto,Puerto Rico/Territorio de Estados Unidos,630,47,36,,83,"(3.541112,-76.384584)"
2016,Agosto,Puerto Rico/Territorio de Estados Unidos,630,606,527,,1133,"(4.697144,-74.140516)"
2016,Agosto,Puerto Rico/Territorio de Estados Unidos,630,10,12,,22,"(4.815061,-75.736532)"
2016,Agosto,Puerto Rico/Territorio de Estados Unidos,630,41,42,,83,"(6.171601,-75.427454)"
2016,Agosto,Puerto Rico/Territorio de Estados Unidos,630,2,5,,7,"(7.128456,-73.183637)"
2016,Agosto,Puerto Rico/Territorio de Estados Unidos,630,1,1,,2,"(7.927209,-72.507910)"
2016,Agosto,Qatar,634,20,12,,32,"(4.697144,-74.140516)"
2016,Agosto,Qatar,634,5,3,,8,"(6.171601,-75.427454)"
2016,Agosto,Reino Unido de Gran Bretaña e Irlanda del Norte,826,2,0,,2,"(10.445761,-75.516429)"
2016,Agosto,Reino Unido de Gran Bretaña e Irlanda del Norte,826,2,3,,5,"(10.886611,-74.776708)"
2016,Agosto,Reino Unido de Gran Bretaña e Irlanda del Norte,826,128,100,,228,"(3.541112,-76.384584)"
2016,Agosto,Reino Unido de Gran Bretaña e Irlanda del Norte,826,1789,1211,,3000,"(4.697144,-74.140516)"
2016,Agosto,Reino Unido de Gran Bretaña e Irlanda del Norte,826,64,41,,105,"(6.171601,-75.427454)"
2016,Agosto,Reino Unido de Gran Bretaña e Irlanda del Norte,826,1,0,,1,"(7.128456,-73.183637)"
2016,Agosto,República CentroÁfricana,140,2,0,,2,"(3.541112,-76.384584)"
2016,Agosto,República CentroÁfricana,140,2,1,,3,"(4.697144,-74.140516)"
2016,Agosto,Federación de Rusia,643,0,2,,2,"(10.886611,-74.776708)"
2016,Agosto,Federación de Rusia,643,3,3,,6,"(3.541112,-76.384584)"
2016,Agosto,Federación de Rusia,643,57,59,,116,"(4.697144,-74.140516)"
2016,Agosto,Federación de Rusia,643,4,2,,6,"(6.171601,-75.427454)"
2016,Agosto,Federación de Rusia,643,0,1,,1,"(7.128456,-73.183637)"
2016,Agosto,República Dominicana,214,20,31,,51,"(10.445761,-75.516429)"
2016,Agosto,República Dominicana,214,55,96,,151,"(10.886611,-74.776708)"
2016,Agosto,República Dominicana,214,1,11,,12,"(10.971302,-74.765397)"
2016,Agosto,República Dominicana,214,2,9,,11,"(12.586067,-81.702563)"
2016,Agosto,República Dominicana,214,237,179,,416,"(3.541112,-76.384584)"
2016,Agosto,República Dominicana,214,2952,2634,,5586,"(4.697144,-74.140516)"
2016,Agosto,República Dominicana,214,107,80,,187,"(4.815061,-75.736532)"
2016,Agosto,República Dominicana,214,314,269,,583,"(6.171601,-75.427454)"
2016,Agosto,República Dominicana,214,51,39,,90,"(7.128456,-73.183637)"
2016,Agosto,República Dominicana,214,4,3,,7,"(7.927209,-72.507910)"
2016,Agosto,República Democrática Popular de Corea,408,0,1,,1,"(4.697144,-74.140516)"
2016,Agosto,Rumania,642,7,4,,11,"(4.697144,-74.140516)"
2016,Agosto,Rumania,642,0,1,,1,"(6.171601,-75.427454)"
2016,Agosto,San  Vicente y las Granadinas,670,0,1,,1,"(4.697144,-74.140516)"
2016,Agosto,Santa Lucia,662,1,1,,2,"(6.171601,-75.427454)"
2016,Agosto,Senegal,686,1,1,,2,"(4.697144,-74.140516)"
2016,Agosto,Serbia,688,2,1,,3,"(4.697144,-74.140516)"
2016,Agosto,Singapur,702,0,1,,1,"(3.541112,-76.384584)"
2016,Agosto,Singapur,702,20,15,,35,"(4.697144,-74.140516)"
2016,Agosto,Sudáfrica,710,18,15,,33,"(4.697144,-74.140516)"
2016,Agosto,Sudáfrica,710,0,1,,1,"(6.171601,-75.427454)"
2016,Agosto,Sudán,736,0,1,,1,"(10.445761,-75.516429)"
2016,Agosto,Suecia,752,2,3,,5,"(10.445761,-75.516429)"
2016,Agosto,Suecia,752,3,1,,4,"(10.886611,-74.776708)"
2016,Agosto,Suecia,752,22,16,,38,"(3.541112,-76.384584)"
2016,Agosto,Suecia,752,81,64,,145,"(4.697144,-74.140516)"
2016,Agosto,Suecia,752,1,1,,2,"(4.815061,-75.736532)"
2016,Agosto,Suecia,752,21,14,,35,"(6.171601,-75.427454)"
2016,Agosto,Suiza,756,0,1,,1,"(10.445761,-75.516429)"
2016,Agosto,Suiza,756,5,3,,8,"(10.886611,-74.776708)"
2016,Agosto,Suiza,756,109,43,,152,"(3.541112,-76.384584)"
2016,Agosto,Suiza,756,349,195,,544,"(4.697144,-74.140516)"
2016,Agosto,Suiza,756,42,39,,81,"(6.171601,-75.427454)"
2016,Agosto,Surinam,740,0,2,,2,"(10.408582,-75.538003)"
2016,Agosto,Surinam,740,0,2,,2,"(10.886611,-74.776708)"
2016,Agosto,Surinam,740,3,1,,4,"(4.697144,-74.140516)"
2016,Agosto,Surinam,740,1,3,,4,"(6.171601,-75.427454)"
2016,Agosto,Taiwán,158,0,1,,1,"(10.886611,-74.776708)"
2016,Agosto,Taiwán,158,0,1,,1,"(3.541112,-76.384584)"
2016,Agosto,Taiwán,158,1,3,,4,"(4.697144,-74.140516)"
2016,Agosto,Tailandia,764,1,0,,1,"(3.541112,-76.384584)"
2016,Agosto,Tailandia,764,13,18,,31,"(4.697144,-74.140516)"
2016,Agosto,Tailandia,764,1,0,,1,"(6.171601,-75.427454)"
2016,Agosto,Tanzania,834,4,3,,7,"(4.697144,-74.140516)"
2016,Agosto,Trinidad y Tobago,780,0,11,,11,"(10.408582,-75.538003)"
2016,Agosto,Trinidad y Tobago,780,4,2,,6,"(10.445761,-75.516429)"
2016,Agosto,Trinidad y Tobago,780,1,4,,5,"(10.886611,-74.776708)"
2016,Agosto,Trinidad y Tobago,780,11,10,,21,"(3.541112,-76.384584)"
2016,Agosto,Trinidad y Tobago,780,15,28,,43,"(4.697144,-74.140516)"
2016,Agosto,Trinidad y Tobago,780,4,7,,11,"(4.815061,-75.736532)"
2016,Agosto,Trinidad y Tobago,780,14,14,,28,"(6.171601,-75.427454)"
2016,Agosto,Trinidad y Tobago,780,2,1,,3,"(7.128456,-73.183637)"
2016,Agosto,Trinidad y Tobago,780,1,2,,3,"(7.927209,-72.507910)"
2016,Agosto,Túnez,788,2,0,,2,"(6.171601,-75.427454)"
2016,Agosto,Turquía,792,8,5,,13,"(3.541112,-76.384584)"
2016,Agosto,Turquía,792,213,171,,384,"(4.697144,-74.140516)"
2016,Agosto,Turquía,792,3,4,,7,"(6.171601,-75.427454)"
2016,Agosto,Turkmenistán,795,2,4,,6,"(4.697144,-74.140516)"
2016,Agosto,Turkmenistán,795,0,1,,1,"(6.171601,-75.427454)"
2016,Agosto,Ucrania,804,5,6,,11,"(4.697144,-74.140516)"
2016,Agosto,Uganda,800,2,0,,2,"(3.541112,-76.384584)"
2016,Agosto,Uganda,800,7,4,,11,"(4.697144,-74.140516)"
2016,Agosto,Uruguay,858,1,0,,1,"(10.445761,-75.516429)"
2016,Agosto,Uruguay,858,3,1,,4,"(10.886611,-74.776708)"
2016,Agosto,Uruguay,858,5,14,,19,"(3.541112,-76.384584)"
2016,Agosto,Uruguay,858,62,124,,186,"(4.697144,-74.140516)"
2016,Agosto,Uruguay,858,0,2,,2,"(4.815061,-75.736532)"
2016,Agosto,Uruguay,858,11,17,,28,"(6.171601,-75.427454)"
2016,Agosto,Vanuatu,548,1,0,,1,"(4.697144,-74.140516)"
2016,Agosto,Venezuela,862,8,9,,17,"(10.445761,-75.516429)"
2016,Agosto,Venezuela,862,14,70,,84,"(10.886611,-74.776708)"
2016,Agosto,Venezuela,862,937,940,,1877,"(11.360009,-72.129330)"
2016,Agosto,Venezuela,862,14,32,,46,"(3.541112,-76.384584)"
2016,Agosto,Venezuela,862,5,8,,13,"(3.866713,-67.927521)"
2016,Agosto,Venezuela,862,1329,1580,,2909,"(4.697144,-74.140516)"
2016,Agosto,Venezuela,862,3,2,,5,"(4.815061,-75.736532)"
2016,Agosto,Venezuela,862,242,283,,525,"(6.171601,-75.427454)"
2016,Agosto,Venezuela,862,39,53,,92,"(6.185799,-67.483929)"
2016,Agosto,Venezuela,862,1867,1564,,3431,"(7.088729,-70.740253)"
2016,Agosto,Venezuela,862,2,4,,6,"(7.128456,-73.183637)"
2016,Agosto,Venezuela,862,1390,1481,,2871,"(7.818934,-72.453226)"
2016,Agosto,Venezuela,862,0,1,,1,"(7.927209,-72.507910)"
2016,Agosto,Venezuela,862,12,11,,23,"(8.36068,-72.409396)"
2016,Agosto,Vietnam,704,3,3,,6,"(4.697144,-74.140516)"
2016,Agosto,Islas Vírgenes Británicas/Territorio Británico de Ultramar,92,1,0,,1,"(4.697144,-74.140516)"
2016,Agosto,Islas Vírgenes Británicas/Territorio Británico de Ultramar,92,1,2,,3,"(6.171601,-75.427454)"
2016,Agosto,Islas Vírgenes Estadounidenses/Territorio de Estados Unidos,850,1,1,,2,"(4.697144,-74.140516)"
2016,Agosto,Zambia,894,0,1,,1,"(4.697144,-74.140516)"
2016,Agosto,Anguila/Territorio Británico de Ultramar,660,1,0,,1,"(4.697144,-74.140516)"
2016,Agosto,Islas Turcas y Caicos/Territorio Británico de Ultramar,796,3,6,,9,"(10.886611,-74.776708)"
2016,Septiembre,Afganistán,4,0,5,,5,"(4.697144,-74.140516)"
2016,Septiembre,Albania,8,0,2,,2,"(4.697144,-74.140516)"
2016,Septiembre,Alemania,276,3,0,,3,"(10.445761,-75.516429)"
2016,Septiembre,Alemania,276,13,11,,24,"(10.886611,-74.776708)"
2016,Septiembre,Alemania,276,1,0,,1,"(12.586067,-81.702563)"
2016,Septiembre,Alemania,276,94,58,,152,"(3.541112,-76.384584)"
2016,Septiembre,Alemania,276,1538,1444,,2982,"(4.697144,-74.140516)"
2016,Septiembre,Alemania,276,1,0,,1,"(4.815061,-75.736532)"
2016,Septiembre,Alemania,276,65,56,,121,"(6.171601,-75.427454)"
2016,Septiembre,Alemania,276,1,1,,2,"(7.128456,-73.183637)"
2016,Septiembre,Andorra,20,1,2,,3,"(4.697144,-74.140516)"
2016,Septiembre,Angola,24,3,5,,8,"(4.697144,-74.140516)"
2016,Septiembre,Antigua y Barbuda,28,1,2,,3,"(4.697144,-74.140516)"
2016,Septiembre,Países Bajos,528,5,4,,9,"(10.445761,-75.516429)"
2016,Septiembre,Países Bajos,528,167,108,,275,"(10.886611,-74.776708)"
2016,Septiembre,Países Bajos,528,210,155,,365,"(3.541112,-76.384584)"
2016,Septiembre,Países Bajos,528,873,742,,1615,"(4.697144,-74.140516)"
2016,Septiembre,Países Bajos,528,6,1,,7,"(4.815061,-75.736532)"
2016,Septiembre,Países Bajos,528,180,122,,302,"(6.171601,-75.427454)"
2016,Septiembre,Países Bajos,528,1,1,,2,"(7.128456,-73.183637)"
2016,Septiembre,Países Bajos,528,2,2,,4,"(7.927209,-72.507910)"
2016,Septiembre,Arabia Saudita,682,0,1,,1,"(10.886611,-74.776708)"
2016,Septiembre,Arabia Saudita,682,0,1,,1,"(3.541112,-76.384584)"
2016,Septiembre,Arabia Saudita,682,9,30,,39,"(4.697144,-74.140516)"
2016,Septiembre,Arabia Saudita,682,1,1,,2,"(6.171601,-75.427454)"
2016,Septiembre,Argelia,12,0,7,,7,"(4.697144,-74.140516)"
2016,Septiembre,Argelia,12,0,1,,1,"(6.171601,-75.427454)"
2016,Septiembre,Argentina,32,15,18,,33,"(0.814836,-77.662532)"
2016,Septiembre,Argentina,32,4,5,,9,"(10.445761,-75.516429)"
2016,Septiembre,Argentina,32,14,10,,24,"(10.886611,-74.776708)"
2016,Septiembre,Argentina,32,4,3,,7,"(12.586067,-81.702563)"
2016,Septiembre,Argentina,32,98,118,,216,"(3.541112,-76.384584)"
2016,Septiembre,Argentina,32,1936,1986,,3922,"(4.697144,-74.140516)"
2016,Septiembre,Argentina,32,8,12,,20,"(4.815061,-75.736532)"
2016,Septiembre,Argentina,32,110,89,,199,"(6.171601,-75.427454)"
2016,Septiembre,Argentina,32,5,5,,10,"(7.128456,-73.183637)"
2016,Septiembre,República de Armenia,51,0,1,,1,"(4.697144,-74.140516)"
2016,Septiembre,Aruba,533,4,7,,11,"(10.445761,-75.516429)"
2016,Septiembre,Aruba,533,34,21,,55,"(10.886611,-74.776708)"
2016,Septiembre,Aruba,533,17,21,,38,"(11.117806,-74.232622)"
2016,Septiembre,Aruba,533,0,5,,5,"(11.247723,-74.213989)"
2016,Septiembre,Aruba,533,1,1,,2,"(12.586067,-81.702563)"
2016,Septiembre,Aruba,533,47,34,,81,"(3.541112,-76.384584)"
2016,Septiembre,Aruba,533,1564,1237,,2801,"(4.697144,-74.140516)"
2016,Septiembre,Aruba,533,14,6,,20,"(4.815061,-75.736532)"
2016,Septiembre,Aruba,533,115,71,,186,"(6.171601,-75.427454)"
2016,Septiembre,Aruba,533,19,34,,53,"(7.128456,-73.183637)"
2016,Septiembre,Aruba,533,0,1,,1,"(7.927209,-72.507910)"
2016,Septiembre,Australia,36,1,0,,1,"(10.445761,-75.516429)"
2016,Septiembre,Australia,36,1,2,,3,"(10.886611,-74.776708)"
2016,Septiembre,Australia,36,10,9,,19,"(3.541112,-76.384584)"
2016,Septiembre,Australia,36,244,178,,422,"(4.697144,-74.140516)"
2016,Septiembre,Australia,36,3,3,,6,"(4.815061,-75.736532)"
2016,Septiembre,Australia,36,36,25,,61,"(6.171601,-75.427454)"
2016,Septiembre,Australia,36,1,0,,1,"(7.128456,-73.183637)"
2016,Septiembre,Austria,40,0,2,,2,"(10.886611,-74.776708)"
2016,Septiembre,Austria,40,8,4,,12,"(3.541112,-76.384584)"
2016,Septiembre,Austria,40,60,57,,117,"(4.697144,-74.140516)"
2016,Septiembre,Austria,40,5,5,,10,"(6.171601,-75.427454)"
2016,Septiembre,Azerbaiyán,31,2,8,,10,"(4.697144,-74.140516)"
2016,Septiembre,Bahamas,44,1,1,,2,"(10.445761,-75.516429)"
2016,Septiembre,Bahamas,44,1,6,,7,"(10.886611,-74.776708)"
2016,Septiembre,Bahamas,44,0,1,,1,"(12.586067,-81.702563)"
2016,Septiembre,Bahamas,44,8,6,,14,"(3.541112,-76.384584)"
2016,Septiembre,Bahamas,44,13,22,,35,"(4.697144,-74.140516)"
2016,Septiembre,Bahamas,44,1,1,,2,"(4.815061,-75.736532)"
2016,Septiembre,Bahamas,44,15,29,,44,"(6.171601,-75.427454)"
2016,Septiembre,Bahamas,44,0,1,,1,"(7.128456,-73.183637)"
2016,Septiembre,Bahréin,48,3,1,,4,"(4.697144,-74.140516)"
2016,Septiembre,Barbados,52,0,1,,1,"(10.445761,-75.516429)"
2016,Septiembre,Barbados,52,3,7,,10,"(3.541112,-76.384584)"
2016,Septiembre,Barbados,52,66,64,,130,"(4.697144,-74.140516)"
2016,Septiembre,Bélgica,56,2,1,,3,"(10.445761,-75.516429)"
2016,Septiembre,Bélgica,56,24,8,,32,"(3.541112,-76.384584)"
2016,Septiembre,Bélgica,56,80,56,,136,"(4.697144,-74.140516)"
2016,Septiembre,Bélgica,56,1,0,,1,"(4.815061,-75.736532)"
2016,Septiembre,Bélgica,56,24,25,,49,"(6.171601,-75.427454)"
2016,Septiembre,Belice,84,6,2,,8,"(3.541112,-76.384584)"
2016,Septiembre,Belice,84,6,7,,13,"(4.697144,-74.140516)"
2016,Septiembre,Belice,84,1,1,,2,"(4.815061,-75.736532)"
2016,Septiembre,Belice,84,4,1,,5,"(6.171601,-75.427454)"
2016,Septiembre,Bermudas/Territorio Británico de Ultramar,60,1,0,,1,"(4.697144,-74.140516)"
2016,Septiembre,Bermudas/Territorio Británico de Ultramar,60,3,1,,4,"(6.171601,-75.427454)"
2016,Septiembre,Bolivia,68,1,8,,9,"(0.814836,-77.662532)"
2016,Septiembre,Bolivia,68,0,2,,2,"(10.445761,-75.516429)"
2016,Septiembre,Bolivia,68,4,4,,8,"(10.886611,-74.776708)"
2016,Septiembre,Bolivia,68,17,54,,71,"(3.541112,-76.384584)"
2016,Septiembre,Bolivia,68,298,453,,751,"(4.697144,-74.140516)"
2016,Septiembre,Bolivia,68,4,6,,10,"(4.815061,-75.736532)"
2016,Septiembre,Bolivia,68,22,62,,84,"(6.171601,-75.427454)"
2016,Septiembre,Bolivia,68,1,3,,4,"(7.128456,-73.183637)"
2016,Septiembre,Bolivia,68,1,1,,2,"(7.927209,-72.507910)"
2016,Septiembre,Bosnia y Herzegovina,70,0,1,,1,"(4.697144,-74.140516)"
2016,Septiembre,Brasil,76,170,381,,551,"(-4.197703,-69.941278)"
2016,Septiembre,Brasil,76,0,3,,3,"(0.814836,-77.662532)"
2016,Septiembre,Brasil,76,4,10,,14,"(10.445761,-75.516429)"
2016,Septiembre,Brasil,76,16,80,,96,"(10.886611,-74.776708)"
2016,Septiembre,Brasil,76,3,2,,5,"(12.586067,-81.702563)"
2016,Septiembre,Brasil,76,65,103,,168,"(3.541112,-76.384584)"
2016,Septiembre,Brasil,76,2376,3094,,5470,"(4.697144,-74.140516)"
2016,Septiembre,Brasil,76,10,15,,25,"(4.815061,-75.736532)"
2016,Septiembre,Brasil,76,84,125,,209,"(6.171601,-75.427454)"
2016,Septiembre,Brasil,76,2,2,,4,"(7.128456,-73.183637)"
2016,Septiembre,Bulgaria,100,1,1,,2,"(4.697144,-74.140516)"
2016,Septiembre,Cabo Verde,132,1,0,,1,"(4.697144,-74.140516)"
2016,Septiembre,Islas Caimán/Territorio Británico de Ultramar,136,5,2,,7,"(12.586067,-81.702563)"
2016,Septiembre,Islas Caimán/Territorio Británico de Ultramar,136,3,2,,5,"(4.697144,-74.140516)"
2016,Septiembre,Camboya,116,1,0,,1,"(4.697144,-74.140516)"
2016,Septiembre,Camerún,120,1,0,,1,"(3.541112,-76.384584)"
2016,Septiembre,Camerún,120,0,2,,2,"(4.697144,-74.140516)"
2016,Septiembre,Canadá,124,36,29,,65,"(10.445761,-75.516429)"
2016,Septiembre,Canadá,124,44,26,,70,"(10.886611,-74.776708)"
2016,Septiembre,Canadá,124,122,111,,233,"(3.541112,-76.384584)"
2016,Septiembre,Canadá,124,1,1,,2,"(4.452882,-75.766298)"
2016,Septiembre,Canadá,124,1830,1391,,3221,"(4.697144,-74.140516)"
2016,Septiembre,Canadá,124,10,11,,21,"(4.815061,-75.736532)"
2016,Septiembre,Canadá,124,299,208,,507,"(6.171601,-75.427454)"
2016,Septiembre,Canadá,124,24,15,,39,"(7.128456,-73.183637)"
2016,Septiembre,Canadá,124,0,1,,1,"(7.927209,-72.507910)"
2016,Septiembre,Chad,148,1,0,,1,"(4.697144,-74.140516)"
2016,Septiembre,España,724,0,1,,1,"(10.408582,-75.538003)"
2016,Septiembre,España,724,22,11,,33,"(10.445761,-75.516429)"
2016,Septiembre,España,724,25,15,,40,"(10.886611,-74.776708)"
2016,Septiembre,España,724,3361,2163,,5524,"(3.541112,-76.384584)"
2016,Septiembre,España,724,13239,9665,,22904,"(4.697144,-74.140516)"
2016,Septiembre,España,724,51,36,,87,"(4.815061,-75.736532)"
2016,Septiembre,España,724,1544,1106,,2650,"(6.171601,-75.427454)"
2016,Septiembre,España,724,13,6,,19,"(7.128456,-73.183637)"
2016,Septiembre,España,724,1,1,,2,"(7.927209,-72.507910)"
2016,Septiembre,Colombia,170,0,6,,6,"(10.445761,-75.516429)"
2016,Septiembre,Colombia,170,81,260,,341,"(4.697144,-74.140516)"
2016,Septiembre,Colombia,170,8,20,,28,"(7.088729,-70.740253)"
2016,Septiembre,República Del Congo,178,0,1,,1,"(4.697144,-74.140516)"
2016,Septiembre,República Democrática del Congo,180,0,2,,2,"(4.697144,-74.140516)"
2016,Septiembre,República de Corea,410,1,0,,1,"(10.445761,-75.516429)"
2016,Septiembre,República de Corea,410,0,3,,3,"(3.541112,-76.384584)"
2016,Septiembre,República de Corea,410,21,20,,41,"(4.697144,-74.140516)"
2016,Septiembre,Costa de Marfil,384,0,1,,1,"(10.886611,-74.776708)"
2016,Septiembre,Costa de Marfil,384,5,6,,11,"(4.697144,-74.140516)"
2016,Septiembre,Costa Rica,188,17,10,,27,"(10.445761,-75.516429)"
2016,Septiembre,Costa Rica,188,12,21,,33,"(10.886611,-74.776708)"
2016,Septiembre,Costa Rica,188,7,56,,63,"(12.5744111,-81.703935)"
2016,Septiembre,Costa Rica,188,7,4,,11,"(12.586067,-81.702563)"
2016,Septiembre,Costa Rica,188,0,1,,1,"(13.3387613,-81.372937)"
2016,Septiembre,Costa Rica,188,41,43,,84,"(3.541112,-76.384584)"
2016,Septiembre,Costa Rica,188,835,1050,,1885,"(4.697144,-74.140516)"
2016,Septiembre,Costa Rica,188,15,9,,24,"(4.815061,-75.736532)"
2016,Septiembre,Costa Rica,188,115,140,,255,"(6.171601,-75.427454)"
2016,Septiembre,Costa Rica,188,3,3,,6,"(7.128456,-73.183637)"
2016,Septiembre,Costa Rica,188,0,1,,1,"(7.927209,-72.507910)"
2016,Septiembre,Croacia,191,0,3,,3,"(3.541112,-76.384584)"
2016,Septiembre,Croacia,191,5,3,,8,"(4.697144,-74.140516)"
2016,Septiembre,Croacia,191,0,1,,1,"(4.815061,-75.736532)"
2016,Septiembre,Croacia,191,1,3,,4,"(6.171601,-75.427454)"
2016,Septiembre,Cuba,192,10,12,,22,"(10.445761,-75.516429)"
2016,Septiembre,Cuba,192,5,10,,15,"(10.886611,-74.776708)"
2016,Septiembre,Cuba,192,3,3,,6,"(12.586067,-81.702563)"
2016,Septiembre,Cuba,192,78,57,,135,"(3.541112,-76.384584)"
2016,Septiembre,Cuba,192,992,990,,1982,"(4.697144,-74.140516)"
2016,Septiembre,Cuba,192,12,13,,25,"(4.815061,-75.736532)"
2016,Septiembre,Cuba,192,119,94,,213,"(6.171601,-75.427454)"
2016,Septiembre,Cuba,192,6,9,,15,"(7.128456,-73.183637)"
2016,Septiembre,Cuba,192,0,1,,1,"(7.927209,-72.507910)"
2016,Septiembre,Curazao,99999,23,54,,77,"(4.697144,-74.140516)"
2016,Septiembre,República Checa,203,15,26,,41,"(4.697144,-74.140516)"
2016,Septiembre,República Checa,203,1,0,,1,"(6.171601,-75.427454)"
2016,Septiembre,Chile,152,164,193,,357,"(0.814836,-77.662532)"
2016,Septiembre,Chile,152,1,0,,1,"(1.813928,-78.763924)"
2016,Septiembre,Chile,152,4,4,,8,"(10.445761,-75.516429)"
2016,Septiembre,Chile,152,14,16,,30,"(10.886611,-74.776708)"
2016,Septiembre,Chile,152,5,1,,6,"(12.586067,-81.702563)"
2016,Septiembre,Chile,152,217,176,,393,"(3.541112,-76.384584)"
2016,Septiembre,Chile,152,4070,3444,,7514,"(4.697144,-74.140516)"
2016,Septiembre,Chile,152,43,28,,71,"(4.815061,-75.736532)"
2016,Septiembre,Chile,152,84,76,,160,"(6.171601,-75.427454)"
2016,Septiembre,Chile,152,6,6,,12,"(7.128456,-73.183637)"
2016,Septiembre,Chile,152,2,2,,4,"(7.927209,-72.507910)"
2016,Septiembre,China,156,1,1,,2,"(10.445761,-75.516429)"
2016,Septiembre,China,156,3,2,,5,"(10.886611,-74.776708)"
2016,Septiembre,China,156,13,26,,39,"(3.541112,-76.384584)"
2016,Septiembre,China,156,195,426,,621,"(4.697144,-74.140516)"
2016,Septiembre,China,156,20,32,,52,"(6.171601,-75.427454)"
2016,Septiembre,Chipre,196,0,1,,1,"(3.541112,-76.384584)"
2016,Septiembre,Chipre,196,0,2,,2,"(4.697144,-74.140516)"
2016,Septiembre,Dinamarca,208,1,0,,1,"(3.541112,-76.384584)"
2016,Septiembre,Dinamarca,208,24,29,,53,"(4.697144,-74.140516)"
2016,Septiembre,Dinamarca,208,3,5,,8,"(6.171601,-75.427454)"
2016,Septiembre,Dominica,212,10,10,,20,"(4.697144,-74.140516)"
2016,Septiembre,Dominica,212,0,1,,1,"(6.171601,-75.427454)"
2016,Septiembre,Ecuador,218,2,1,,3,"(-0.193180,-74.784874)"
2016,Septiembre,Ecuador,218,378,631,,1009,"(0.25129,-76.875963)"
2016,Septiembre,Ecuador,218,10,14,,24,"(0.812436,-77.847006)"
2016,Septiembre,Ecuador,218,4817,5901,,10718,"(0.814836,-77.662532)"
2016,Septiembre,Ecuador,218,177,204,,381,"(1.813928,-78.763924)"
2016,Septiembre,Ecuador,218,0,11,,11,"(10.408582,-75.538003)"
2016,Septiembre,Ecuador,218,0,7,,7,"(10.445761,-75.516429)"
2016,Septiembre,Ecuador,218,7,9,,16,"(10.886611,-74.776708)"
2016,Septiembre,Ecuador,218,307,347,,654,"(3.541112,-76.384584)"
2016,Septiembre,Ecuador,218,2489,4145,,6634,"(4.697144,-74.140516)"
2016,Septiembre,Ecuador,218,4,6,,10,"(4.815061,-75.736532)"
2016,Septiembre,Ecuador,218,60,59,,119,"(6.171601,-75.427454)"
2016,Septiembre,Ecuador,218,2,4,,6,"(7.128456,-73.183637)"
2016,Septiembre,Ecuador,218,0,1,,1,"(7.927209,-72.507910)"
2016,Septiembre,Egipto,818,18,12,,30,"(4.697144,-74.140516)"
2016,Septiembre,Egipto,818,0,1,,1,"(6.171601,-75.427454)"
2016,Septiembre,El Salvador,222,2,3,,5,"(10.445761,-75.516429)"
2016,Septiembre,El Salvador,222,2,2,,4,"(10.886611,-74.776708)"
2016,Septiembre,El Salvador,222,1,1,,2,"(12.586067,-81.702563)"
2016,Septiembre,El Salvador,222,141,137,,278,"(3.541112,-76.384584)"
2016,Septiembre,El Salvador,222,741,1057,,1798,"(4.697144,-74.140516)"
2016,Septiembre,El Salvador,222,2,0,,2,"(4.815061,-75.736532)"
2016,Septiembre,El Salvador,222,74,78,,152,"(6.171601,-75.427454)"
2016,Septiembre,El Salvador,222,0,1,,1,"(7.128456,-73.183637)"
2016,Septiembre,Emiratos Árabes,784,1,0,,1,"(3.541112,-76.384584)"
2016,Septiembre,Emiratos Árabes,784,95,169,,264,"(4.697144,-74.140516)"
2016,Septiembre,Emiratos Árabes,784,5,8,,13,"(6.171601,-75.427454)"
2016,Septiembre,Eritrea,232,2,0,,2,"(4.697144,-74.140516)"
2016,Septiembre,Eslovenia,705,2,5,,7,"(4.697144,-74.140516)"
2016,Septiembre,Estados Unidos de América,840,0,1,,1,"(10.408582,-75.538003)"
2016,Septiembre,Estados Unidos de América,840,3256,2623,,5879,"(10.445761,-75.516429)"
2016,Septiembre,Estados Unidos de América,840,2395,1947,,4342,"(10.886611,-74.776708)"
2016,Septiembre,Estados Unidos de América,840,58,33,,91,"(12.586067,-81.702563)"
2016,Septiembre,Estados Unidos de América,840,5135,3604,,8739,"(3.541112,-76.384584)"
2016,Septiembre,Estados Unidos de América,840,813,593,,1406,"(4.452882,-75.766298)"
2016,Septiembre,Estados Unidos de América,840,30747,27290,,58037,"(4.697144,-74.140516)"
2016,Septiembre,Estados Unidos de América,840,808,538,,1346,"(4.815061,-75.736532)"
2016,Septiembre,Estados Unidos de América,840,9314,7395,,16709,"(6.171601,-75.427454)"
2016,Septiembre,Estados Unidos de América,840,194,151,,345,"(7.128456,-73.183637)"
2016,Septiembre,Estados Unidos de América,840,37,34,,71,"(7.927209,-72.507910)"
2016,Septiembre,Estonia,233,1,1,,2,"(4.697144,-74.140516)"
2016,Septiembre,Etiopia,231,0,3,,3,"(4.697144,-74.140516)"
2016,Septiembre,Etiopia,231,1,0,,1,"(6.171601,-75.427454)"
2016,Septiembre,Islas Fiji,242,2,0,,2,"(4.697144,-74.140516)"
2016,Septiembre,Filipinas,608,1,0,,1,"(3.541112,-76.384584)"
2016,Septiembre,Filipinas,608,5,0,,5,"(4.697144,-74.140516)"
2016,Septiembre,Filipinas,608,0,1,,1,"(6.171601,-75.427454)"
2016,Septiembre,Finlandia,246,0,1,,1,"(10.445761,-75.516429)"
2016,Septiembre,Finlandia,246,1,0,,1,"(10.886611,-74.776708)"
2016,Septiembre,Finlandia,246,6,6,,12,"(4.697144,-74.140516)"
2016,Septiembre,Francia,250,2,1,,3,"(10.445761,-75.516429)"
2016,Septiembre,Francia,250,7,10,,17,"(10.886611,-74.776708)"
2016,Septiembre,Francia,250,147,98,,245,"(3.541112,-76.384584)"
2016,Septiembre,Francia,250,2182,1766,,3948,"(4.697144,-74.140516)"
2016,Septiembre,Francia,250,18,9,,27,"(4.815061,-75.736532)"
2016,Septiembre,Francia,250,94,69,,163,"(6.171601,-75.427454)"
2016,Septiembre,Francia,250,0,1,,1,"(7.927209,-72.507910)"
2016,Septiembre,Gabón,266,1,0,,1,"(4.697144,-74.140516)"
2016,Septiembre,Georgia,268,0,1,,1,"(4.697144,-74.140516)"
2016,Septiembre,Ghana,288,1,1,,2,"(4.697144,-74.140516)"
2016,Septiembre,Grecia,300,2,2,,4,"(3.541112,-76.384584)"
2016,Septiembre,Grecia,300,25,29,,54,"(4.697144,-74.140516)"
2016,Septiembre,Grecia,300,2,4,,6,"(6.171601,-75.427454)"
2016,Septiembre,Guatemala,320,3,8,,11,"(10.445761,-75.516429)"
2016,Septiembre,Guatemala,320,5,6,,11,"(10.886611,-74.776708)"
2016,Septiembre,Guatemala,320,0,1,,1,"(12.586067,-81.702563)"
2016,Septiembre,Guatemala,320,43,59,,102,"(3.541112,-76.384584)"
2016,Septiembre,Guatemala,320,513,655,,1168,"(4.697144,-74.140516)"
2016,Septiembre,Guatemala,320,6,6,,12,"(4.815061,-75.736532)"
2016,Septiembre,Guatemala,320,64,116,,180,"(6.171601,-75.427454)"
2016,Septiembre,Guatemala,320,2,5,,7,"(7.128456,-73.183637)"
2016,Septiembre,Guatemala,320,1,0,,1,"(7.927209,-72.507910)"
2016,Septiembre,Guyana,328,0,2,,2,"(10.408582,-75.538003)"
2016,Septiembre,Guyana,328,1,2,,3,"(10.886611,-74.776708)"
2016,Septiembre,Guyana,328,1,1,,2,"(3.541112,-76.384584)"
2016,Septiembre,Guyana,328,2,6,,8,"(4.697144,-74.140516)"
2016,Septiembre,Guinea,324,2,0,,2,"(0.814836,-77.662532)"
2016,Septiembre,Guinea Ecuatorial,226,3,2,,5,"(3.541112,-76.384584)"
2016,Septiembre,Guinea Ecuatorial,226,3,3,,6,"(4.697144,-74.140516)"
2016,Septiembre,Guadalupe/Territorio Francés,312,2,0,,2,"(4.697144,-74.140516)"
2016,Septiembre,Guam/Territorio no incorporado de Estados Unidos,316,0,2,,2,"(4.697144,-74.140516)"
2016,Septiembre,Guayana Francesa/Departamento de Ultramar Francés,254,0,1,,1,"(10.886611,-74.776708)"
2016,Septiembre,Guayana Francesa/Departamento de Ultramar Francés,254,1,1,,2,"(4.697144,-74.140516)"
2016,Septiembre,Haití,332,2,4,,6,"(10.886611,-74.776708)"
2016,Septiembre,Haití,332,5,25,,30,"(4.697144,-74.140516)"
2016,Septiembre,Haití,332,3,5,,8,"(6.171601,-75.427454)"
2016,Septiembre,Haití,332,1,0,,1,"(7.927209,-72.507910)"
2016,Septiembre,Honduras,340,1,5,,6,"(10.445761,-75.516429)"
2016,Septiembre,Honduras,340,0,8,,8,"(10.886611,-74.776708)"
2016,Septiembre,Honduras,340,9,17,,26,"(3.541112,-76.384584)"
2016,Septiembre,Honduras,340,77,162,,239,"(4.697144,-74.140516)"
2016,Septiembre,Honduras,340,1,1,,2,"(4.815061,-75.736532)"
2016,Septiembre,Honduras,340,26,55,,81,"(6.171601,-75.427454)"
2016,Septiembre,Honduras,340,1,2,,3,"(7.128456,-73.183637)"
2016,Septiembre,Honduras,340,1,1,,2,"(7.927209,-72.507910)"
2016,Septiembre,Hong Kong,344,3,3,,6,"(3.541112,-76.384584)"
2016,Septiembre,Hong Kong,344,28,47,,75,"(4.697144,-74.140516)"
2016,Septiembre,Hong Kong,344,0,1,,1,"(4.815061,-75.736532)"
2016,Septiembre,Hong Kong,344,2,3,,5,"(6.171601,-75.427454)"
2016,Septiembre,Hungría,348,0,2,,2,"(3.541112,-76.384584)"
2016,Septiembre,Hungría,348,9,1,,10,"(4.697144,-74.140516)"
2016,Septiembre,Hungría,348,0,1,,1,"(6.171601,-75.427454)"
2016,Septiembre,India,356,1,1,,2,"(10.886611,-74.776708)"
2016,Septiembre,India,356,8,6,,14,"(3.541112,-76.384584)"
2016,Septiembre,India,356,47,42,,89,"(4.697144,-74.140516)"
2016,Septiembre,India,356,2,0,,2,"(4.815061,-75.736532)"
2016,Septiembre,India,356,7,7,,14,"(6.171601,-75.427454)"
2016,Septiembre,India,356,0,1,,1,"(7.128456,-73.183637)"
2016,Septiembre,Indonesia,360,7,5,,12,"(4.697144,-74.140516)"
2016,Septiembre,Indonesia,360,0,1,,1,"(6.171601,-75.427454)"
2016,Septiembre,Iraq,368,0,1,,1,"(10.408582,-75.538003)"
2016,Septiembre,Iraq,368,2,9,,11,"(4.697144,-74.140516)"
2016,Septiembre,Irán,364,12,7,,19,"(4.697144,-74.140516)"
2016,Septiembre,República de Irlanda,372,1,1,,2,"(3.541112,-76.384584)"
2016,Septiembre,República de Irlanda,372,10,8,,18,"(4.697144,-74.140516)"
2016,Septiembre,República de Irlanda,372,3,1,,4,"(6.171601,-75.427454)"
2016,Septiembre,Israel,376,1,2,,3,"(10.886611,-74.776708)"
2016,Septiembre,Israel,376,11,9,,20,"(3.541112,-76.384584)"
2016,Septiembre,Israel,376,171,100,,271,"(4.697144,-74.140516)"
2016,Septiembre,Israel,376,2,1,,3,"(4.815061,-75.736532)"
2016,Septiembre,Israel,376,6,4,,10,"(6.171601,-75.427454)"
2016,Septiembre,Islas Aland/Provincia de Finlandia,248,1,0,,1,"(4.697144,-74.140516)"
2016,Septiembre,Italia,380,6,8,,14,"(10.445761,-75.516429)"
2016,Septiembre,Italia,380,18,9,,27,"(10.886611,-74.776708)"
2016,Septiembre,Italia,380,227,107,,334,"(3.541112,-76.384584)"
2016,Septiembre,Italia,380,867,668,,1535,"(4.697144,-74.140516)"
2016,Septiembre,Italia,380,4,2,,6,"(4.815061,-75.736532)"
2016,Septiembre,Italia,380,92,66,,158,"(6.171601,-75.427454)"
2016,Septiembre,Italia,380,2,1,,3,"(7.128456,-73.183637)"
2016,Septiembre,Jamaica,388,5,1,,6,"(10.445761,-75.516429)"
2016,Septiembre,Jamaica,388,2,3,,5,"(10.886611,-74.776708)"
2016,Septiembre,Jamaica,388,0,2,,2,"(13.3387613,-81.372937)"
2016,Septiembre,Jamaica,388,2,4,,6,"(3.541112,-76.384584)"
2016,Septiembre,Jamaica,388,21,30,,51,"(4.697144,-74.140516)"
2016,Septiembre,Jamaica,388,3,6,,9,"(4.815061,-75.736532)"
2016,Septiembre,Jamaica,388,4,2,,6,"(6.171601,-75.427454)"
2016,Septiembre,Jamaica,388,0,1,,1,"(7.128456,-73.183637)"
2016,Septiembre,Japón,392,3,3,,6,"(3.541112,-76.384584)"
2016,Septiembre,Japón,392,100,106,,206,"(4.697144,-74.140516)"
2016,Septiembre,Japón,392,6,6,,12,"(6.171601,-75.427454)"
2016,Septiembre,Jordania,400,3,3,,6,"(4.697144,-74.140516)"
2016,Septiembre,Kazajistán,398,1,3,,4,"(4.697144,-74.140516)"
2016,Septiembre,Kenia,404,0,1,,1,"(3.541112,-76.384584)"
2016,Septiembre,Kenia,404,8,2,,10,"(4.697144,-74.140516)"
2016,Septiembre,Kuwait,414,1,1,,2,"(4.697144,-74.140516)"
2016,Septiembre,Líbano,422,17,17,,34,"(4.697144,-74.140516)"
2016,Septiembre,Liberia,430,0,1,,1,"(4.815061,-75.736532)"
2016,Septiembre,Luxemburgo,442,6,9,,15,"(4.697144,-74.140516)"
2016,Septiembre,Luxemburgo,442,2,1,,3,"(6.171601,-75.427454)"
2016,Septiembre,Madagascar,450,2,2,,4,"(4.697144,-74.140516)"
2016,Septiembre,Malasia,458,2,6,,8,"(4.697144,-74.140516)"
2016,Septiembre,Maldivas,462,1,2,,3,"(4.697144,-74.140516)"
2016,Septiembre,Malta,470,2,0,,2,"(3.541112,-76.384584)"
2016,Septiembre,Malta,470,18,9,,27,"(4.697144,-74.140516)"
2016,Septiembre,Malta,470,2,0,,2,"(6.171601,-75.427454)"
2016,Septiembre,Marruecos,504,3,1,,4,"(3.541112,-76.384584)"
2016,Septiembre,Marruecos,504,9,6,,15,"(4.697144,-74.140516)"
2016,Septiembre,Marruecos,504,3,0,,3,"(6.171601,-75.427454)"
2016,Septiembre,Mauricio,480,0,1,,1,"(4.697144,-74.140516)"
2016,Septiembre,Martinica/Departamento de Ultramar Francés,474,1,0,,1,"(3.541112,-76.384584)"
2016,Septiembre,México,484,54,45,,99,"(10.445761,-75.516429)"
2016,Septiembre,México,484,111,78,,189,"(10.886611,-74.776708)"
2016,Septiembre,México,484,2,2,,4,"(12.586067,-81.702563)"
2016,Septiembre,México,484,732,603,,1335,"(3.541112,-76.384584)"
2016,Septiembre,México,484,13295,11549,,24844,"(4.697144,-74.140516)"
2016,Septiembre,México,484,145,115,,260,"(4.815061,-75.736532)"
2016,Septiembre,México,484,1959,1609,,3568,"(6.171601,-75.427454)"
2016,Septiembre,México,484,90,65,,155,"(7.128456,-73.183637)"
2016,Septiembre,México,484,5,0,,5,"(7.927209,-72.507910)"
2016,Septiembre,Micronesia,583,1,0,,1,"(6.171601,-75.427454)"
2016,Septiembre,Mozambique,508,4,1,,5,"(4.697144,-74.140516)"
2016,Septiembre,Myanmar,104,0,1,,1,"(6.171601,-75.427454)"
2016,Septiembre,Nauru,520,1,0,,1,"(4.697144,-74.140516)"
2016,Septiembre,Nepal,524,1,1,,2,"(3.541112,-76.384584)"
2016,Septiembre,Nepal,524,1,0,,1,"(4.697144,-74.140516)"
2016,Septiembre,Nicaragua,558,1,2,,3,"(10.445761,-75.516429)"
2016,Septiembre,Nicaragua,558,1,4,,5,"(10.886611,-74.776708)"
2016,Septiembre,Nicaragua,558,0,3,,3,"(12.586067,-81.702563)"
2016,Septiembre,Nicaragua,558,12,58,,70,"(3.541112,-76.384584)"
2016,Septiembre,Nicaragua,558,44,74,,118,"(4.697144,-74.140516)"
2016,Septiembre,Nicaragua,558,3,4,,7,"(4.815061,-75.736532)"
2016,Septiembre,Nicaragua,558,16,45,,61,"(6.171601,-75.427454)"
2016,Septiembre,Nicaragua,558,0,2,,2,"(7.128456,-73.183637)"
2016,Septiembre,Nigeria,566,3,6,,9,"(4.697144,-74.140516)"
2016,Septiembre,Noruega,578,1,1,,2,"(10.886611,-74.776708)"
2016,Septiembre,Noruega,578,5,2,,7,"(3.541112,-76.384584)"
2016,Septiembre,Noruega,578,20,8,,28,"(4.697144,-74.140516)"
2016,Septiembre,Noruega,578,1,2,,3,"(6.171601,-75.427454)"
2016,Septiembre,Nueva Zelanda,554,0,1,,1,"(3.541112,-76.384584)"
2016,Septiembre,Nueva Zelanda,554,46,32,,78,"(4.697144,-74.140516)"
2016,Septiembre,Nueva Zelanda,554,3,2,,5,"(6.171601,-75.427454)"
2016,Septiembre,Omán,512,4,7,,11,"(4.697144,-74.140516)"
2016,Septiembre,Omán,512,0,1,,1,"(6.171601,-75.427454)"
2016,Septiembre,Pakistán,586,0,5,,5,"(4.697144,-74.140516)"
2016,Septiembre,Panamá,591,10,77,,87,"(10.408582,-75.538003)"
2016,Septiembre,Panamá,591,397,441,,838,"(10.445761,-75.516429)"
2016,Septiembre,Panamá,591,734,820,,1554,"(10.886611,-74.776708)"
2016,Septiembre,Panamá,591,0,3,,3,"(10.971302,-74.765397)"
2016,Septiembre,Panamá,591,0,2,,2,"(11.247723,-74.213989)"
2016,Septiembre,Panamá,591,2,8,,10,"(12.5744111,-81.703935)"
2016,Septiembre,Panamá,591,96,105,,201,"(12.586067,-81.702563)"
2016,Septiembre,Panamá,591,1983,1719,,3702,"(3.541112,-76.384584)"
2016,Septiembre,Panamá,591,232,167,,399,"(4.452882,-75.766298)"
2016,Septiembre,Panamá,591,7962,8612,,16574,"(4.697144,-74.140516)"
2016,Septiembre,Panamá,591,619,472,,1091,"(4.815061,-75.736532)"
2016,Septiembre,Panamá,591,3055,3019,,6074,"(6.171601,-75.427454)"
2016,Septiembre,Panamá,591,1,4,,5,"(6.228046,-77.404104)"
2016,Septiembre,Panamá,591,1,2,,3,"(7.102626,-77.762647)"
2016,Septiembre,Panamá,591,218,238,,456,"(7.128456,-73.183637)"
2016,Septiembre,Panamá,591,80,90,,170,"(7.927209,-72.507910)"
2016,Septiembre,Panamá,591,0,66,,66,"(8.066966,-76.735404)"
2016,Septiembre,Panamá,591,20,44,,64,"(8.635765,-77.346578)"
2016,Septiembre,Paraguay,600,0,3,,3,"(0.814836,-77.662532)"
2016,Septiembre,Paraguay,600,2,3,,5,"(10.445761,-75.516429)"
2016,Septiembre,Paraguay,600,1,8,,9,"(10.886611,-74.776708)"
2016,Septiembre,Paraguay,600,9,18,,27,"(3.541112,-76.384584)"
2016,Septiembre,Paraguay,600,69,191,,260,"(4.697144,-74.140516)"
2016,Septiembre,Paraguay,600,4,20,,24,"(4.815061,-75.736532)"
2016,Septiembre,Paraguay,600,8,80,,88,"(6.171601,-75.427454)"
2016,Septiembre,Paraguay,600,4,2,,6,"(7.128456,-73.183637)"
2016,Septiembre,Paraguay,600,1,3,,4,"(7.927209,-72.507910)"
2016,Septiembre,Perú,604,10,12,,22,"(-0.193180,-74.784874)"
2016,Septiembre,Perú,604,48,103,,151,"(-4.197703,-69.941278)"
2016,Septiembre,Perú,604,50,64,,114,"(0.814836,-77.662532)"
2016,Septiembre,Perú,604,0,1,,1,"(1.813928,-78.763924)"
2016,Septiembre,Perú,604,4,5,,9,"(10.445761,-75.516429)"
2016,Septiembre,Perú,604,5,9,,14,"(10.886611,-74.776708)"
2016,Septiembre,Perú,604,0,1,,1,"(12.586067,-81.702563)"
2016,Septiembre,Perú,604,239,335,,574,"(3.541112,-76.384584)"
2016,Septiembre,Perú,604,5150,5891,,11041,"(4.697144,-74.140516)"
2016,Septiembre,Perú,604,5,5,,10,"(4.815061,-75.736532)"
2016,Septiembre,Perú,604,349,481,,830,"(6.171601,-75.427454)"
2016,Septiembre,Perú,604,3,2,,5,"(7.128456,-73.183637)"
2016,Septiembre,Polonia,616,1,0,,1,"(10.445761,-75.516429)"
2016,Septiembre,Polonia,616,0,4,,4,"(3.541112,-76.384584)"
2016,Septiembre,Polonia,616,18,28,,46,"(4.697144,-74.140516)"
2016,Septiembre,Polonia,616,1,1,,2,"(6.171601,-75.427454)"
2016,Septiembre,Portugal,620,0,1,,1,"(10.886611,-74.776708)"
2016,Septiembre,Portugal,620,9,4,,13,"(3.541112,-76.384584)"
2016,Septiembre,Portugal,620,115,152,,267,"(4.697144,-74.140516)"
2016,Septiembre,Portugal,620,0,1,,1,"(4.815061,-75.736532)"
2016,Septiembre,Portugal,620,11,13,,24,"(6.171601,-75.427454)"
2016,Septiembre,Polinesia Francesa/Colectividad de Ultramar Francesa,258,1,1,,2,"(4.697144,-74.140516)"
2016,Septiembre,Puerto Rico/Territorio de Estados Unidos,630,5,8,,13,"(10.445761,-75.516429)"
2016,Septiembre,Puerto Rico/Territorio de Estados Unidos,630,8,8,,16,"(10.886611,-74.776708)"
2016,Septiembre,Puerto Rico/Territorio de Estados Unidos,630,30,21,,51,"(3.541112,-76.384584)"
2016,Septiembre,Puerto Rico/Territorio de Estados Unidos,630,544,457,,1001,"(4.697144,-74.140516)"
2016,Septiembre,Puerto Rico/Territorio de Estados Unidos,630,8,2,,10,"(4.815061,-75.736532)"
2016,Septiembre,Puerto Rico/Territorio de Estados Unidos,630,46,46,,92,"(6.171601,-75.427454)"
2016,Septiembre,Puerto Rico/Territorio de Estados Unidos,630,7,6,,13,"(7.128456,-73.183637)"
2016,Septiembre,Qatar,634,6,5,,11,"(4.697144,-74.140516)"
2016,Septiembre,Qatar,634,1,1,,2,"(6.171601,-75.427454)"
2016,Septiembre,Reino Unido de Gran Bretaña e Irlanda del Norte,826,0,1,,1,"(10.445761,-75.516429)"
2016,Septiembre,Reino Unido de Gran Bretaña e Irlanda del Norte,826,0,1,,1,"(10.886611,-74.776708)"
2016,Septiembre,Reino Unido de Gran Bretaña e Irlanda del Norte,826,97,65,,162,"(3.541112,-76.384584)"
2016,Septiembre,Reino Unido de Gran Bretaña e Irlanda del Norte,826,2085,1612,,3697,"(4.697144,-74.140516)"
2016,Septiembre,Reino Unido de Gran Bretaña e Irlanda del Norte,826,1,1,,2,"(4.815061,-75.736532)"
2016,Septiembre,Reino Unido de Gran Bretaña e Irlanda del Norte,826,45,39,,84,"(6.171601,-75.427454)"
2016,Septiembre,Reino Unido de Gran Bretaña e Irlanda del Norte,826,1,0,,1,"(7.128456,-73.183637)"
2016,Septiembre,Federación de Rusia,643,0,1,,1,"(10.445761,-75.516429)"
2016,Septiembre,Federación de Rusia,643,1,0,,1,"(10.886611,-74.776708)"
2016,Septiembre,Federación de Rusia,643,3,7,,10,"(3.541112,-76.384584)"
2016,Septiembre,Federación de Rusia,643,75,94,,169,"(4.697144,-74.140516)"
2016,Septiembre,Federación de Rusia,643,4,1,,5,"(6.171601,-75.427454)"
2016,Septiembre,República Dominicana,214,8,11,,19,"(10.445761,-75.516429)"
2016,Septiembre,República Dominicana,214,36,47,,83,"(10.886611,-74.776708)"
2016,Septiembre,República Dominicana,214,6,7,,13,"(11.117806,-74.232622)"
2016,Septiembre,República Dominicana,214,114,98,,212,"(3.541112,-76.384584)"
2016,Septiembre,República Dominicana,214,3218,2844,,6062,"(4.697144,-74.140516)"
2016,Septiembre,República Dominicana,214,48,37,,85,"(4.815061,-75.736532)"
2016,Septiembre,República Dominicana,214,297,208,,505,"(6.171601,-75.427454)"
2016,Septiembre,República Dominicana,214,59,38,,97,"(7.128456,-73.183637)"
2016,Septiembre,República Dominicana,214,1,2,,3,"(7.927209,-72.507910)"
2016,Septiembre,Reunión,638,1,0,,1,"(6.171601,-75.427454)"
2016,Septiembre,Rumania,642,1,0,,1,"(3.541112,-76.384584)"
2016,Septiembre,Rumania,642,1,1,,2,"(4.697144,-74.140516)"
2016,Septiembre,Rwanda,646,0,1,,1,"(4.697144,-74.140516)"
2016,Septiembre,Santa Lucia,662,1,1,,2,"(3.541112,-76.384584)"
2016,Septiembre,Senegal,686,0,1,,1,"(4.697144,-74.140516)"
2016,Septiembre,Serbia,688,0,1,,1,"(4.697144,-74.140516)"
2016,Septiembre,Singapur,702,1,0,,1,"(10.445761,-75.516429)"
2016,Septiembre,Singapur,702,8,8,,16,"(4.697144,-74.140516)"
2016,Septiembre,Singapur,702,1,0,,1,"(6.171601,-75.427454)"
2016,Septiembre,Sudáfrica,710,0,1,,1,"(3.541112,-76.384584)"
2016,Septiembre,Sudáfrica,710,11,8,,19,"(4.697144,-74.140516)"
2016,Septiembre,Sudáfrica,710,2,0,,2,"(6.171601,-75.427454)"
2016,Septiembre,Sudán,736,1,1,,2,"(4.697144,-74.140516)"
2016,Septiembre,Suecia,752,1,1,,2,"(10.886611,-74.776708)"
2016,Septiembre,Suecia,752,17,8,,25,"(3.541112,-76.384584)"
2016,Septiembre,Suecia,752,38,49,,87,"(4.697144,-74.140516)"
2016,Septiembre,Suecia,752,2,0,,2,"(4.815061,-75.736532)"
2016,Septiembre,Suecia,752,10,4,,14,"(6.171601,-75.427454)"
2016,Septiembre,Suiza,756,1,1,,2,"(10.445761,-75.516429)"
2016,Septiembre,Suiza,756,50,17,,67,"(3.541112,-76.384584)"
2016,Septiembre,Suiza,756,197,141,,338,"(4.697144,-74.140516)"
2016,Septiembre,Suiza,756,24,18,,42,"(6.171601,-75.427454)"
2016,Septiembre,Surinam,740,0,4,,4,"(10.408582,-75.538003)"
2016,Septiembre,Surinam,740,2,5,,7,"(4.697144,-74.140516)"
2016,Septiembre,Surinam,740,3,0,,3,"(6.171601,-75.427454)"
2016,Septiembre,Taiwán,158,1,0,,1,"(3.541112,-76.384584)"
2016,Septiembre,Taiwán,158,3,6,,9,"(4.697144,-74.140516)"
2016,Septiembre,Tailandia,764,1,0,,1,"(3.541112,-76.384584)"
2016,Septiembre,Tailandia,764,26,16,,42,"(4.697144,-74.140516)"
2016,Septiembre,Tailandia,764,1,1,,2,"(6.171601,-75.427454)"
2016,Septiembre,Tanzania,834,0,2,,2,"(4.697144,-74.140516)"
2016,Septiembre,Tanzania,834,0,1,,1,"(6.171601,-75.427454)"
2016,Septiembre,Trinidad y Tobago,780,1,3,,4,"(10.445761,-75.516429)"
2016,Septiembre,Trinidad y Tobago,780,4,6,,10,"(10.886611,-74.776708)"
2016,Septiembre,Trinidad y Tobago,780,5,12,,17,"(3.541112,-76.384584)"
2016,Septiembre,Trinidad y Tobago,780,30,27,,57,"(4.697144,-74.140516)"
2016,Septiembre,Trinidad y Tobago,780,0,6,,6,"(4.815061,-75.736532)"
2016,Septiembre,Trinidad y Tobago,780,5,6,,11,"(6.171601,-75.427454)"
2016,Septiembre,Trinidad y Tobago,780,2,3,,5,"(7.128456,-73.183637)"
2016,Septiembre,Turquía,792,1,0,,1,"(10.886611,-74.776708)"
2016,Septiembre,Turquía,792,2,3,,5,"(3.541112,-76.384584)"
2016,Septiembre,Turquía,792,254,166,,420,"(4.697144,-74.140516)"
2016,Septiembre,Turquía,792,3,3,,6,"(6.171601,-75.427454)"
2016,Septiembre,Turkmenistán,795,1,2,,3,"(4.697144,-74.140516)"
2016,Septiembre,Ucrania,804,1,7,,8,"(4.697144,-74.140516)"
2016,Septiembre,Ucrania,804,1,0,,1,"(6.171601,-75.427454)"
2016,Septiembre,Uruguay,858,0,2,,2,"(10.445761,-75.516429)"
2016,Septiembre,Uruguay,858,3,20,,23,"(10.886611,-74.776708)"
2016,Septiembre,Uruguay,858,11,16,,27,"(3.541112,-76.384584)"
2016,Septiembre,Uruguay,858,91,119,,210,"(4.697144,-74.140516)"
2016,Septiembre,Uruguay,858,22,25,,47,"(6.171601,-75.427454)"
2016,Septiembre,Uruguay,858,1,0,,1,"(7.927209,-72.507910)"
2016,Septiembre,Venezuela,862,0,16,,16,"(10.408582,-75.538003)"
2016,Septiembre,Venezuela,862,7,4,,11,"(10.445761,-75.516429)"
2016,Septiembre,Venezuela,862,14,40,,54,"(10.886611,-74.776708)"
2016,Septiembre,Venezuela,862,1,3,,4,"(11.117806,-74.232622)"
2016,Septiembre,Venezuela,862,2135,1814,,3949,"(11.360009,-72.129330)"
2016,Septiembre,Venezuela,862,2,1,,3,"(12.586067,-81.702563)"
2016,Septiembre,Venezuela,862,19,27,,46,"(3.541112,-76.384584)"
2016,Septiembre,Venezuela,862,2,5,,7,"(3.866713,-67.927521)"
2016,Septiembre,Venezuela,862,1275,1392,,2667,"(4.697144,-74.140516)"
2016,Septiembre,Venezuela,862,6,1,,7,"(4.815061,-75.736532)"
2016,Septiembre,Venezuela,862,292,275,,567,"(6.171601,-75.427454)"
2016,Septiembre,Venezuela,862,65,67,,132,"(6.185799,-67.483929)"
2016,Septiembre,Venezuela,862,0,2,,2,"(6.228046,-77.404104)"
2016,Septiembre,Venezuela,862,1240,1098,,2338,"(7.088729,-70.740253)"
2016,Septiembre,Venezuela,862,0,3,,3,"(7.128456,-73.183637)"
2016,Septiembre,Venezuela,862,1915,1988,,3903,"(7.818934,-72.453226)"
2016,Septiembre,Venezuela,862,1,12,,13,"(7.927209,-72.507910)"
2016,Septiembre,Venezuela,862,12,12,,24,"(8.36068,-72.409396)"
2016,Septiembre,Vietnam,704,0,1,,1,"(3.541112,-76.384584)"
2016,Septiembre,Vietnam,704,2,3,,5,"(4.697144,-74.140516)"
2016,Septiembre,Anguila/Territorio Británico de Ultramar,660,1,0,,1,"(6.171601,-75.427454)"
2016,Septiembre,Islas Turcas y Caicos/Territorio Británico de Ultramar,796,1,0,,1,"(4.697144,-74.140516)"
2016,Octubre,Afganistán,4,0,7,,7,"(4.697144,-74.140516)"
2016,Octubre,Afganistán,4,0,1,,1,"(6.185799,-67.483929)"
2016,Octubre,Albania,8,1,0,,1,"(4.697144,-74.140516)"
2016,Octubre,Alemania,276,3,1,,4,"(10.445761,-75.516429)"
2016,Octubre,Alemania,276,14,8,,22,"(10.886611,-74.776708)"
2016,Octubre,Alemania,276,66,59,,125,"(3.541112,-76.384584)"
2016,Octubre,Alemania,276,1227,1334,,2561,"(4.697144,-74.140516)"
2016,Octubre,Alemania,276,2,1,,3,"(4.815061,-75.736532)"
2016,Octubre,Alemania,276,40,50,,90,"(6.171601,-75.427454)"
2016,Octubre,Alemania,276,0,2,,2,"(7.128456,-73.183637)"
2016,Octubre,Alemania,276,0,1,,1,"(7.927209,-72.507910)"
2016,Octubre,Andorra,20,0,1,,1,"(4.697144,-74.140516)"
2016,Octubre,Angola,24,0,8,,8,"(4.697144,-74.140516)"
2016,Octubre,Antigua y Barbuda,28,1,2,,3,"(4.697144,-74.140516)"
2016,Octubre,Países Bajos,528,0,5,,5,"(10.408582,-75.538003)"
2016,Octubre,Países Bajos,528,6,1,,7,"(10.445761,-75.516429)"
2016,Octubre,Países Bajos,528,89,72,,161,"(10.886611,-74.776708)"
2016,Octubre,Países Bajos,528,156,121,,277,"(3.541112,-76.384584)"
2016,Octubre,Países Bajos,528,780,716,,1496,"(4.697144,-74.140516)"
2016,Octubre,Países Bajos,528,4,0,,4,"(4.815061,-75.736532)"
2016,Octubre,Países Bajos,528,194,88,,282,"(6.171601,-75.427454)"
2016,Octubre,Países Bajos,528,3,4,,7,"(7.128456,-73.183637)"
2016,Octubre,Arabia Saudita,682,3,28,,31,"(4.697144,-74.140516)"
2016,Octubre,Arabia Saudita,682,1,0,,1,"(4.815061,-75.736532)"
2016,Octubre,Arabia Saudita,682,0,1,,1,"(6.171601,-75.427454)"
2016,Octubre,Argelia,12,1,3,,4,"(4.697144,-74.140516)"
2016,Octubre,Argentina,32,10,21,,31,"(0.814836,-77.662532)"
2016,Octubre,Argentina,32,8,8,,16,"(10.445761,-75.516429)"
2016,Octubre,Argentina,32,16,16,,32,"(10.886611,-74.776708)"
2016,Octubre,Argentina,32,6,9,,15,"(12.586067,-81.702563)"
2016,Octubre,Argentina,32,196,177,,373,"(3.541112,-76.384584)"
2016,Octubre,Argentina,32,2646,2480,,5126,"(4.697144,-74.140516)"
2016,Octubre,Argentina,32,17,19,,36,"(4.815061,-75.736532)"
2016,Octubre,Argentina,32,167,161,,328,"(6.171601,-75.427454)"
2016,Octubre,Argentina,32,6,6,,12,"(7.128456,-73.183637)"
2016,Octubre,Aruba,533,2030,1369,,3399,"(10.408582,-75.538003)"
2016,Octubre,Aruba,533,2,0,,2,"(10.445761,-75.516429)"
2016,Octubre,Aruba,533,46,34,,80,"(10.886611,-74.776708)"
2016,Octubre,Aruba,533,0,3,,3,"(10.971302,-74.765397)"
2016,Octubre,Aruba,533,0,3,,3,"(11.247723,-74.213989)"
2016,Octubre,Aruba,533,41,26,,67,"(3.541112,-76.384584)"
2016,Octubre,Aruba,533,1632,1290,,2922,"(4.697144,-74.140516)"
2016,Octubre,Aruba,533,17,5,,22,"(4.815061,-75.736532)"
2016,Octubre,Aruba,533,151,98,,249,"(6.171601,-75.427454)"
2016,Octubre,Aruba,533,23,34,,57,"(7.128456,-73.183637)"
2016,Octubre,Aruba,533,4,1,,5,"(7.927209,-72.507910)"
2016,Octubre,Australia,36,1,0,,1,"(10.445761,-75.516429)"
2016,Octubre,Australia,36,4,1,,5,"(10.886611,-74.776708)"
2016,Octubre,Australia,36,1,0,,1,"(12.586067,-81.702563)"
2016,Octubre,Australia,36,10,9,,19,"(3.541112,-76.384584)"
2016,Octubre,Australia,36,226,187,,413,"(4.697144,-74.140516)"
2016,Octubre,Australia,36,2,0,,2,"(4.815061,-75.736532)"
2016,Octubre,Australia,36,28,19,,47,"(6.171601,-75.427454)"
2016,Octubre,Australia,36,1,0,,1,"(7.128456,-73.183637)"
2016,Octubre,Austria,40,1,0,,1,"(10.445761,-75.516429)"
2016,Octubre,Austria,40,3,1,,4,"(10.886611,-74.776708)"
2016,Octubre,Austria,40,2,4,,6,"(3.541112,-76.384584)"
2016,Octubre,Austria,40,31,49,,80,"(4.697144,-74.140516)"
2016,Octubre,Austria,40,0,1,,1,"(4.815061,-75.736532)"
2016,Octubre,Austria,40,5,2,,7,"(6.171601,-75.427454)"
2016,Octubre,Azerbaiyán,31,0,3,,3,"(4.697144,-74.140516)"
2016,Octubre,Bahamas,44,0,1,,1,"(10.445761,-75.516429)"
2016,Octubre,Bahamas,44,4,3,,7,"(10.886611,-74.776708)"
2016,Octubre,Bahamas,44,11,6,,17,"(3.541112,-76.384584)"
2016,Octubre,Bahamas,44,69,68,,137,"(4.697144,-74.140516)"
2016,Octubre,Bahamas,44,1,1,,2,"(4.815061,-75.736532)"
2016,Octubre,Bahamas,44,17,30,,47,"(6.171601,-75.427454)"
2016,Octubre,Bahréin,48,0,2,,2,"(4.697144,-74.140516)"
2016,Octubre,Bangladesh,50,1,1,,2,"(4.697144,-74.140516)"
2016,Octubre,Barbados,52,0,1,,1,"(10.445761,-75.516429)"
2016,Octubre,Barbados,52,96,110,,206,"(4.697144,-74.140516)"
2016,Octubre,Barbados,52,0,1,,1,"(6.171601,-75.427454)"
2016,Octubre,República de Belarús,112,0,1,,1,"(4.697144,-74.140516)"
2016,Octubre,Bélgica,56,1,0,,1,"(10.445761,-75.516429)"
2016,Octubre,Bélgica,56,2,0,,2,"(10.886611,-74.776708)"
2016,Octubre,Bélgica,56,9,13,,22,"(3.541112,-76.384584)"
2016,Octubre,Bélgica,56,58,52,,110,"(4.697144,-74.140516)"
2016,Octubre,Bélgica,56,8,3,,11,"(6.171601,-75.427454)"
2016,Octubre,Belice,84,0,1,,1,"(3.541112,-76.384584)"
2016,Octubre,Belice,84,6,6,,12,"(4.697144,-74.140516)"
2016,Octubre,Belice,84,0,2,,2,"(6.171601,-75.427454)"
2016,Octubre,Benín,204,1,0,,1,"(4.697144,-74.140516)"
2016,Octubre,Benín,204,1,0,,1,"(6.171601,-75.427454)"
2016,Octubre,Bermudas/Territorio Británico de Ultramar,60,1,0,,1,"(4.697144,-74.140516)"
2016,Octubre,Bolivia,68,0,8,,8,"(0.814836,-77.662532)"
2016,Octubre,Bolivia,68,2,3,,5,"(10.886611,-74.776708)"
2016,Octubre,Bolivia,68,23,40,,63,"(3.541112,-76.384584)"
2016,Octubre,Bolivia,68,319,487,,806,"(4.697144,-74.140516)"
2016,Octubre,Bolivia,68,8,10,,18,"(4.815061,-75.736532)"
2016,Octubre,Bolivia,68,32,39,,71,"(6.171601,-75.427454)"
2016,Octubre,Bolivia,68,0,1,,1,"(7.128456,-73.183637)"
2016,Octubre,Bosnia y Herzegovina,70,3,0,,3,"(4.697144,-74.140516)"
2016,Octubre,Brasil,76,128,266,,394,"(-4.197703,-69.941278)"
2016,Octubre,Brasil,76,1,0,,1,"(0.814836,-77.662532)"
2016,Octubre,Brasil,76,0,1,,1,"(10.408582,-75.538003)"
2016,Octubre,Brasil,76,6,7,,13,"(10.445761,-75.516429)"
2016,Octubre,Brasil,76,6,13,,19,"(10.886611,-74.776708)"
2016,Octubre,Brasil,76,1,3,,4,"(12.586067,-81.702563)"
2016,Octubre,Brasil,76,100,146,,246,"(3.541112,-76.384584)"
2016,Octubre,Brasil,76,2528,3253,,5781,"(4.697144,-74.140516)"
2016,Octubre,Brasil,76,10,16,,26,"(4.815061,-75.736532)"
2016,Octubre,Brasil,76,97,129,,226,"(6.171601,-75.427454)"
2016,Octubre,Brasil,76,2,4,,6,"(7.128456,-73.183637)"
2016,Octubre,Bulgaria,100,0,1,,1,"(10.886611,-74.776708)"
2016,Octubre,Bulgaria,100,1,1,,2,"(4.697144,-74.140516)"
2016,Octubre,Burkina Faso,854,1,0,,1,"(4.697144,-74.140516)"
2016,Octubre,Islas Caimán/Territorio Británico de Ultramar,136,2,3,,5,"(10.445761,-75.516429)"
2016,Octubre,Islas Caimán/Territorio Británico de Ultramar,136,3,2,,5,"(12.586067,-81.702563)"
2016,Octubre,Islas Caimán/Territorio Británico de Ultramar,136,2,1,,3,"(4.697144,-74.140516)"
2016,Octubre,Islas Caimán/Territorio Británico de Ultramar,136,1,0,,1,"(6.171601,-75.427454)"
2016,Octubre,Camboya,116,1,6,,7,"(4.697144,-74.140516)"
2016,Octubre,Canadá,124,16,11,,27,"(10.445761,-75.516429)"
2016,Octubre,Canadá,124,29,22,,51,"(10.886611,-74.776708)"
2016,Octubre,Canadá,124,99,72,,171,"(3.541112,-76.384584)"
2016,Octubre,Canadá,124,1317,1141,,2458,"(4.697144,-74.140516)"
2016,Octubre,Canadá,124,3,2,,5,"(4.815061,-75.736532)"
2016,Octubre,Canadá,124,223,156,,379,"(6.171601,-75.427454)"
2016,Octubre,Canadá,124,9,11,,20,"(7.128456,-73.183637)"
2016,Octubre,Chad,148,0,1,,1,"(4.697144,-74.140516)"
2016,Octubre,España,724,3,2,,5,"(10.445761,-75.516429)"
2016,Octubre,España,724,15,7,,22,"(10.886611,-74.776708)"
2016,Octubre,España,724,3019,2086,,5105,"(3.541112,-76.384584)"
2016,Octubre,España,724,11264,8565,,19829,"(4.697144,-74.140516)"
2016,Octubre,España,724,21,16,,37,"(4.815061,-75.736532)"
2016,Octubre,España,724,1464,991,,2455,"(6.171601,-75.427454)"
2016,Octubre,España,724,0,2,,2,"(7.128456,-73.183637)"
2016,Octubre,Colombia,170,2,5,,7,"(10.445761,-75.516429)"
2016,Octubre,Colombia,170,90,276,,366,"(4.697144,-74.140516)"
2016,Octubre,Colombia,170,1,0,,1,"(7.088729,-70.740253)"
2016,Octubre,República Del Congo,178,0,2,,2,"(4.697144,-74.140516)"
2016,Octubre,República Democrática del Congo,180,1,0,,1,"(4.697144,-74.140516)"
2016,Octubre,República de Corea,410,25,30,,55,"(4.697144,-74.140516)"
2016,Octubre,República de Corea,410,0,2,,2,"(6.171601,-75.427454)"
2016,Octubre,Costa de Marfil,384,0,21,,21,"(4.697144,-74.140516)"
2016,Octubre,Costa Rica,188,1,1,,2,"(10.408582,-75.538003)"
2016,Octubre,Costa Rica,188,11,7,,18,"(10.445761,-75.516429)"
2016,Octubre,Costa Rica,188,40,37,,77,"(10.886611,-74.776708)"
2016,Octubre,Costa Rica,188,3,25,,28,"(12.5744111,-81.703935)"
2016,Octubre,Costa Rica,188,11,9,,20,"(12.586067,-81.702563)"
2016,Octubre,Costa Rica,188,33,47,,80,"(3.541112,-76.384584)"
2016,Octubre,Costa Rica,188,908,1086,,1994,"(4.697144,-74.140516)"
2016,Octubre,Costa Rica,188,22,12,,34,"(4.815061,-75.736532)"
2016,Octubre,Costa Rica,188,111,108,,219,"(6.171601,-75.427454)"
2016,Octubre,Costa Rica,188,6,2,,8,"(7.128456,-73.183637)"
2016,Octubre,Croacia,191,0,1,,1,"(3.541112,-76.384584)"
2016,Octubre,Croacia,191,5,9,,14,"(4.697144,-74.140516)"
2016,Octubre,Cuba,192,14,9,,23,"(10.445761,-75.516429)"
2016,Octubre,Cuba,192,25,17,,42,"(10.886611,-74.776708)"
2016,Octubre,Cuba,192,1,0,,1,"(12.586067,-81.702563)"
2016,Octubre,Cuba,192,124,78,,202,"(3.541112,-76.384584)"
2016,Octubre,Cuba,192,1320,1188,,2508,"(4.697144,-74.140516)"
2016,Octubre,Cuba,192,43,24,,67,"(4.815061,-75.736532)"
2016,Octubre,Cuba,192,122,139,,261,"(6.171601,-75.427454)"
2016,Octubre,Cuba,192,16,27,,43,"(7.128456,-73.183637)"
2016,Octubre,Curazao,99999,7,38,,45,"(4.697144,-74.140516)"
2016,Octubre,República Checa,203,0,1,,1,"(10.445761,-75.516429)"
2016,Octubre,República Checa,203,0,1,,1,"(3.541112,-76.384584)"
2016,Octubre,República Checa,203,8,9,,17,"(4.697144,-74.140516)"
2016,Octubre,Chile,152,162,183,,345,"(0.814836,-77.662532)"
2016,Octubre,Chile,152,0,2,,2,"(1.813928,-78.763924)"
2016,Octubre,Chile,152,11,9,,20,"(10.445761,-75.516429)"
2016,Octubre,Chile,152,16,18,,34,"(10.886611,-74.776708)"
2016,Octubre,Chile,152,6,3,,9,"(12.586067,-81.702563)"
2016,Octubre,Chile,152,238,181,,419,"(3.541112,-76.384584)"
2016,Octubre,Chile,152,4025,3676,,7701,"(4.697144,-74.140516)"
2016,Octubre,Chile,152,57,55,,112,"(4.815061,-75.736532)"
2016,Octubre,Chile,152,82,86,,168,"(6.171601,-75.427454)"
2016,Octubre,Chile,152,5,3,,8,"(7.128456,-73.183637)"
2016,Octubre,China,156,0,1,,1,"(10.445761,-75.516429)"
2016,Octubre,China,156,4,17,,21,"(10.886611,-74.776708)"
2016,Octubre,China,156,8,21,,29,"(3.541112,-76.384584)"
2016,Octubre,China,156,258,614,,872,"(4.697144,-74.140516)"
2016,Octubre,China,156,0,1,,1,"(4.815061,-75.736532)"
2016,Octubre,China,156,13,42,,55,"(6.171601,-75.427454)"
2016,Octubre,China,156,2,0,,2,"(7.128456,-73.183637)"
2016,Octubre,Chipre,196,0,6,,6,"(4.697144,-74.140516)"
2016,Octubre,Chipre,196,1,0,,1,"(6.171601,-75.427454)"
2016,Octubre,Dinamarca,208,0,1,,1,"(10.445761,-75.516429)"
2016,Octubre,Dinamarca,208,1,0,,1,"(10.886611,-74.776708)"
2016,Octubre,Dinamarca,208,2,0,,2,"(3.541112,-76.384584)"
2016,Octubre,Dinamarca,208,25,40,,65,"(4.697144,-74.140516)"
2016,Octubre,Dinamarca,208,2,1,,3,"(6.171601,-75.427454)"
2016,Octubre,Dominica,212,3,9,,12,"(4.697144,-74.140516)"
2016,Octubre,Ecuador,218,10,6,,16,"(-0.193180,-74.784874)"
2016,Octubre,Ecuador,218,447,644,,1091,"(0.25129,-76.875963)"
2016,Octubre,Ecuador,218,16,20,,36,"(0.812436,-77.847006)"
2016,Octubre,Ecuador,218,5399,6643,,12042,"(0.814836,-77.662532)"
2016,Octubre,Ecuador,218,174,177,,351,"(1.813928,-78.763924)"
2016,Octubre,Ecuador,218,1,8,,9,"(10.445761,-75.516429)"
2016,Octubre,Ecuador,218,8,18,,26,"(10.886611,-74.776708)"
2016,Octubre,Ecuador,218,14,9,,23,"(12.586067,-81.702563)"
2016,Octubre,Ecuador,218,313,394,,707,"(3.541112,-76.384584)"
2016,Octubre,Ecuador,218,3260,4759,,8019,"(4.697144,-74.140516)"
2016,Octubre,Ecuador,218,5,1,,6,"(4.815061,-75.736532)"
2016,Octubre,Ecuador,218,54,86,,140,"(6.171601,-75.427454)"
2016,Octubre,Ecuador,218,0,4,,4,"(7.128456,-73.183637)"
2016,Octubre,Egipto,818,11,12,,23,"(4.697144,-74.140516)"
2016,Octubre,Egipto,818,0,1,,1,"(4.815061,-75.736532)"
2016,Octubre,El Salvador,222,4,3,,7,"(10.445761,-75.516429)"
2016,Octubre,El Salvador,222,5,2,,7,"(10.886611,-74.776708)"
2016,Octubre,El Salvador,222,1,0,,1,"(12.586067,-81.702563)"
2016,Octubre,El Salvador,222,117,112,,229,"(3.541112,-76.384584)"
2016,Octubre,El Salvador,222,905,1132,,2037,"(4.697144,-74.140516)"
2016,Octubre,El Salvador,222,57,73,,130,"(6.171601,-75.427454)"
2016,Octubre,Emiratos Árabes,784,1,3,,4,"(3.541112,-76.384584)"
2016,Octubre,Emiratos Árabes,784,82,112,,194,"(4.697144,-74.140516)"
2016,Octubre,Emiratos Árabes,784,4,4,,8,"(6.171601,-75.427454)"
2016,Octubre,Eritrea,232,1,0,,1,"(4.697144,-74.140516)"
2016,Octubre,Eslovaquia,703,2,0,,2,"(4.697144,-74.140516)"
2016,Octubre,Eslovenia,705,1,4,,5,"(4.697144,-74.140516)"
2016,Octubre,Estados Unidos de América,840,1,0,,1,"(0.814836,-77.662532)"
2016,Octubre,Estados Unidos de América,840,0,4,,4,"(10.408582,-75.538003)"
2016,Octubre,Estados Unidos de América,840,3710,3080,,6790,"(10.445761,-75.516429)"
2016,Octubre,Estados Unidos de América,840,2508,2147,,4655,"(10.886611,-74.776708)"
2016,Octubre,Estados Unidos de América,840,8,1,,9,"(11.117806,-74.232622)"
2016,Octubre,Estados Unidos de América,840,58,44,,102,"(12.586067,-81.702563)"
2016,Octubre,Estados Unidos de América,840,4927,3582,,8509,"(3.541112,-76.384584)"
2016,Octubre,Estados Unidos de América,840,741,593,,1334,"(4.452882,-75.766298)"
2016,Octubre,Estados Unidos de América,840,33519,29856,,63375,"(4.697144,-74.140516)"
2016,Octubre,Estados Unidos de América,840,687,528,,1215,"(4.815061,-75.736532)"
2016,Octubre,Estados Unidos de América,840,9431,7658,,17089,"(6.171601,-75.427454)"
2016,Octubre,Estados Unidos de América,840,214,151,,365,"(7.128456,-73.183637)"
2016,Octubre,Estados Unidos de América,840,14,5,,19,"(7.927209,-72.507910)"
2016,Octubre,Estonia,233,1,1,,2,"(3.541112,-76.384584)"
2016,Octubre,Estonia,233,0,1,,1,"(4.697144,-74.140516)"
2016,Octubre,Etiopia,231,1,2,,3,"(4.697144,-74.140516)"
2016,Octubre,Filipinas,608,0,1,,1,"(3.541112,-76.384584)"
2016,Octubre,Filipinas,608,6,4,,10,"(4.697144,-74.140516)"
2016,Octubre,Filipinas,608,0,1,,1,"(6.171601,-75.427454)"
2016,Octubre,Finlandia,246,0,1,,1,"(10.886611,-74.776708)"
2016,Octubre,Finlandia,246,1,0,,1,"(3.541112,-76.384584)"
2016,Octubre,Finlandia,246,10,6,,16,"(4.697144,-74.140516)"
2016,Octubre,Finlandia,246,1,1,,2,"(6.171601,-75.427454)"
2016,Octubre,Francia,250,3,2,,5,"(10.445761,-75.516429)"
2016,Octubre,Francia,250,5,0,,5,"(10.886611,-74.776708)"
2016,Octubre,Francia,250,94,75,,169,"(3.541112,-76.384584)"
2016,Octubre,Francia,250,1671,1463,,3134,"(4.697144,-74.140516)"
2016,Octubre,Francia,250,2,3,,5,"(4.815061,-75.736532)"
2016,Octubre,Francia,250,61,48,,109,"(6.171601,-75.427454)"
2016,Octubre,Francia,250,1,1,,2,"(7.128456,-73.183637)"
2016,Octubre,Gabón,266,0,1,,1,"(4.697144,-74.140516)"
2016,Octubre,Georgia,268,0,1,,1,"(3.541112,-76.384584)"
2016,Octubre,Georgia,268,0,7,,7,"(4.697144,-74.140516)"
2016,Octubre,Ghana,288,0,1,,1,"(3.541112,-76.384584)"
2016,Octubre,Ghana,288,1,0,,1,"(4.697144,-74.140516)"
2016,Octubre,Grecia,300,1,0,,1,"(10.886611,-74.776708)"
2016,Octubre,Grecia,300,5,1,,6,"(3.541112,-76.384584)"
2016,Octubre,Grecia,300,25,13,,38,"(4.697144,-74.140516)"
2016,Octubre,Grecia,300,1,1,,2,"(6.171601,-75.427454)"
2016,Octubre,Guatemala,320,5,3,,8,"(10.445761,-75.516429)"
2016,Octubre,Guatemala,320,3,13,,16,"(10.886611,-74.776708)"
2016,Octubre,Guatemala,320,1,4,,5,"(12.586067,-81.702563)"
2016,Octubre,Guatemala,320,54,82,,136,"(3.541112,-76.384584)"
2016,Octubre,Guatemala,320,655,726,,1381,"(4.697144,-74.140516)"
2016,Octubre,Guatemala,320,8,14,,22,"(4.815061,-75.736532)"
2016,Octubre,Guatemala,320,107,134,,241,"(6.171601,-75.427454)"
2016,Octubre,Guatemala,320,14,3,,17,"(7.128456,-73.183637)"
2016,Octubre,Guyana,328,0,4,,4,"(10.886611,-74.776708)"
2016,Octubre,Guyana,328,0,2,,2,"(4.697144,-74.140516)"
2016,Octubre,Guyana,328,0,1,,1,"(7.128456,-73.183637)"
2016,Octubre,Guinea Ecuatorial,226,2,2,,4,"(3.541112,-76.384584)"
2016,Octubre,Guinea Ecuatorial,226,0,6,,6,"(4.697144,-74.140516)"
2016,Octubre,Guadalupe/Territorio Francés,312,1,0,,1,"(3.541112,-76.384584)"
2016,Octubre,Guadalupe/Territorio Francés,312,3,0,,3,"(4.697144,-74.140516)"
2016,Octubre,Haití,332,2,3,,5,"(10.886611,-74.776708)"
2016,Octubre,Haití,332,0,2,,2,"(3.541112,-76.384584)"
2016,Octubre,Haití,332,1,15,,16,"(4.697144,-74.140516)"
2016,Octubre,Haití,332,5,10,,15,"(6.171601,-75.427454)"
2016,Octubre,Haití,332,0,2,,2,"(7.128456,-73.183637)"
2016,Octubre,Honduras,340,0,3,,3,"(10.445761,-75.516429)"
2016,Octubre,Honduras,340,2,11,,13,"(10.886611,-74.776708)"
2016,Octubre,Honduras,340,7,22,,29,"(3.541112,-76.384584)"
2016,Octubre,Honduras,340,112,182,,294,"(4.697144,-74.140516)"
2016,Octubre,Honduras,340,5,8,,13,"(4.815061,-75.736532)"
2016,Octubre,Honduras,340,34,59,,93,"(6.171601,-75.427454)"
2016,Octubre,Honduras,340,2,2,,4,"(7.128456,-73.183637)"
2016,Octubre,Hong Kong,344,0,1,,1,"(10.886611,-74.776708)"
2016,Octubre,Hong Kong,344,1,2,,3,"(3.541112,-76.384584)"
2016,Octubre,Hong Kong,344,32,55,,87,"(4.697144,-74.140516)"
2016,Octubre,Hong Kong,344,4,4,,8,"(6.171601,-75.427454)"
2016,Octubre,Hungría,348,0,1,,1,"(3.541112,-76.384584)"
2016,Octubre,Hungría,348,5,4,,9,"(4.697144,-74.140516)"
2016,Octubre,Hungría,348,0,1,,1,"(6.171601,-75.427454)"
2016,Octubre,India,356,1,0,,1,"(10.886611,-74.776708)"
2016,Octubre,India,356,5,4,,9,"(3.541112,-76.384584)"
2016,Octubre,India,356,79,61,,140,"(4.697144,-74.140516)"
2016,Octubre,India,356,1,0,,1,"(4.815061,-75.736532)"
2016,Octubre,India,356,2,2,,4,"(6.171601,-75.427454)"
2016,Octubre,Indonesia,360,0,1,,1,"(10.886611,-74.776708)"
2016,Octubre,Indonesia,360,5,10,,15,"(4.697144,-74.140516)"
2016,Octubre,Indonesia,360,2,2,,4,"(7.128456,-73.183637)"
2016,Octubre,Iraq,368,1,3,,4,"(4.697144,-74.140516)"
2016,Octubre,Irán,364,1,3,,4,"(4.697144,-74.140516)"
2016,Octubre,República de Irlanda,372,1,0,,1,"(10.886611,-74.776708)"
2016,Octubre,República de Irlanda,372,0,2,,2,"(3.541112,-76.384584)"
2016,Octubre,República de Irlanda,372,13,7,,20,"(4.697144,-74.140516)"
2016,Octubre,República de Irlanda,372,2,4,,6,"(6.171601,-75.427454)"
2016,Octubre,República de Irlanda,372,0,1,,1,"(7.128456,-73.183637)"
2016,Octubre,Islandia,352,1,0,,1,"(4.697144,-74.140516)"
2016,Octubre,Islandia,352,1,0,,1,"(6.171601,-75.427454)"
2016,Octubre,Israel,376,1,0,,1,"(10.445761,-75.516429)"
2016,Octubre,Israel,376,0,1,,1,"(10.886611,-74.776708)"
2016,Octubre,Israel,376,12,8,,20,"(3.541112,-76.384584)"
2016,Octubre,Israel,376,123,75,,198,"(4.697144,-74.140516)"
2016,Octubre,Israel,376,0,2,,2,"(4.815061,-75.736532)"
2016,Octubre,Israel,376,16,1,,17,"(6.171601,-75.427454)"
2016,Octubre,Israel,376,1,1,,2,"(7.927209,-72.507910)"
2016,Octubre,Italia,380,3,1,,4,"(10.445761,-75.516429)"
2016,Octubre,Italia,380,6,5,,11,"(10.886611,-74.776708)"
2016,Octubre,Italia,380,166,83,,249,"(3.541112,-76.384584)"
2016,Octubre,Italia,380,602,464,,1066,"(4.697144,-74.140516)"
2016,Octubre,Italia,380,1,0,,1,"(4.815061,-75.736532)"
2016,Octubre,Italia,380,63,32,,95,"(6.171601,-75.427454)"
2016,Octubre,Islas Feroe/Región Autónoma de Dinamarca,234,1,0,,1,"(4.697144,-74.140516)"
2016,Octubre,Jamaica,388,321,232,,553,"(10.408582,-75.538003)"
2016,Octubre,Jamaica,388,3,13,,16,"(10.445761,-75.516429)"
2016,Octubre,Jamaica,388,5,5,,10,"(10.886611,-74.776708)"
2016,Octubre,Jamaica,388,1,0,,1,"(12.586067,-81.702563)"
2016,Octubre,Jamaica,388,3,4,,7,"(3.541112,-76.384584)"
2016,Octubre,Jamaica,388,32,38,,70,"(4.697144,-74.140516)"
2016,Octubre,Jamaica,388,0,5,,5,"(4.815061,-75.736532)"
2016,Octubre,Jamaica,388,12,16,,28,"(6.171601,-75.427454)"
2016,Octubre,Jamaica,388,5,6,,11,"(7.128456,-73.183637)"
2016,Octubre,Japón,392,6,2,,8,"(3.541112,-76.384584)"
2016,Octubre,Japón,392,63,90,,153,"(4.697144,-74.140516)"
2016,Octubre,Japón,392,12,10,,22,"(6.171601,-75.427454)"
2016,Octubre,Jordania,400,1,2,,3,"(4.697144,-74.140516)"
2016,Octubre,Kazajistán,398,3,3,,6,"(4.697144,-74.140516)"
2016,Octubre,Kenia,404,2,2,,4,"(4.697144,-74.140516)"
2016,Octubre,Kuwait,414,1,0,,1,"(4.697144,-74.140516)"
2016,Octubre,Lituania,440,1,8,,9,"(4.697144,-74.140516)"
2016,Octubre,Líbano,422,5,16,,21,"(4.697144,-74.140516)"
2016,Octubre,Liberia,430,1,0,,1,"(4.697144,-74.140516)"
2016,Octubre,Liechtenstein,438,1,0,,1,"(4.697144,-74.140516)"
2016,Octubre,Luxemburgo,442,1,0,,1,"(3.541112,-76.384584)"
2016,Octubre,Luxemburgo,442,4,3,,7,"(4.697144,-74.140516)"
2016,Octubre,Madagascar,450,0,1,,1,"(4.697144,-74.140516)"
2016,Octubre,Malasia,458,0,1,,1,"(10.886611,-74.776708)"
2016,Octubre,Malasia,458,12,23,,35,"(4.697144,-74.140516)"
2016,Octubre,Malasia,458,1,1,,2,"(4.815061,-75.736532)"
2016,Octubre,Maldivas,462,1,0,,1,"(6.171601,-75.427454)"
2016,Octubre,Malí,466,1,1,,2,"(4.697144,-74.140516)"
2016,Octubre,Malí,466,1,0,,1,"(6.171601,-75.427454)"
2016,Octubre,Malta,470,0,1,,1,"(3.541112,-76.384584)"
2016,Octubre,Malta,470,10,5,,15,"(4.697144,-74.140516)"
2016,Octubre,Marruecos,504,1,0,,1,"(3.541112,-76.384584)"
2016,Octubre,Marruecos,504,47,24,,71,"(4.697144,-74.140516)"
2016,Octubre,Marruecos,504,4,0,,4,"(6.171601,-75.427454)"
2016,Octubre,Martinica/Departamento de Ultramar Francés,474,1,0,,1,"(10.886611,-74.776708)"
2016,Octubre,Martinica/Departamento de Ultramar Francés,474,2,0,,2,"(6.171601,-75.427454)"
2016,Octubre,México,484,1,1,,2,"(0.814836,-77.662532)"
2016,Octubre,México,484,74,56,,130,"(10.445761,-75.516429)"
2016,Octubre,México,484,148,120,,268,"(10.886611,-74.776708)"
2016,Octubre,México,484,17,18,,35,"(12.586067,-81.702563)"
2016,Octubre,México,484,673,586,,1259,"(3.541112,-76.384584)"
2016,Octubre,México,484,15520,14053,,29573,"(4.697144,-74.140516)"
2016,Octubre,México,484,138,116,,254,"(4.815061,-75.736532)"
2016,Octubre,México,484,2276,2086,,4362,"(6.171601,-75.427454)"
2016,Octubre,México,484,118,89,,207,"(7.128456,-73.183637)"
2016,Octubre,México,484,3,0,,3,"(7.927209,-72.507910)"
2016,Octubre,Montenegro,499,0,1,,1,"(6.171601,-75.427454)"
2016,Octubre,Myanmar,104,0,1,,1,"(4.697144,-74.140516)"
2016,Octubre,Nepal,524,0,1,,1,"(4.697144,-74.140516)"
2016,Octubre,Nicaragua,558,4,14,,18,"(10.445761,-75.516429)"
2016,Octubre,Nicaragua,558,3,2,,5,"(10.886611,-74.776708)"
2016,Octubre,Nicaragua,558,31,46,,77,"(3.541112,-76.384584)"
2016,Octubre,Nicaragua,558,30,74,,104,"(4.697144,-74.140516)"
2016,Octubre,Nicaragua,558,0,5,,5,"(4.815061,-75.736532)"
2016,Octubre,Nicaragua,558,29,59,,88,"(6.171601,-75.427454)"
2016,Octubre,Nicaragua,558,1,1,,2,"(7.128456,-73.183637)"
2016,Octubre,Nigeria,566,1,8,,9,"(4.697144,-74.140516)"
2016,Octubre,Noruega,578,1,1,,2,"(10.445761,-75.516429)"
2016,Octubre,Noruega,578,1,0,,1,"(10.886611,-74.776708)"
2016,Octubre,Noruega,578,2,1,,3,"(3.541112,-76.384584)"
2016,Octubre,Noruega,578,17,18,,35,"(4.697144,-74.140516)"
2016,Octubre,Noruega,578,2,1,,3,"(6.171601,-75.427454)"
2016,Octubre,Nueva Zelanda,554,1,0,,1,"(3.541112,-76.384584)"
2016,Octubre,Nueva Zelanda,554,24,15,,39,"(4.697144,-74.140516)"
2016,Octubre,Nueva Zelanda,554,1,3,,4,"(6.171601,-75.427454)"
2016,Octubre,Nueva Zelanda,554,0,1,,1,"(7.128456,-73.183637)"
2016,Octubre,Omán,512,0,1,,1,"(10.886611,-74.776708)"
2016,Octubre,Omán,512,1,3,,4,"(4.697144,-74.140516)"
2016,Octubre,Pakistán,586,2,3,,5,"(4.697144,-74.140516)"
2016,Octubre,Panamá,591,207,246,,453,"(10.408582,-75.538003)"
2016,Octubre,Panamá,591,563,557,,1120,"(10.445761,-75.516429)"
2016,Octubre,Panamá,591,961,924,,1885,"(10.886611,-74.776708)"
2016,Octubre,Panamá,591,0,2,,2,"(10.971302,-74.765397)"
2016,Octubre,Panamá,591,2,14,,16,"(12.5744111,-81.703935)"
2016,Octubre,Panamá,591,131,143,,274,"(12.586067,-81.702563)"
2016,Octubre,Panamá,591,1936,1717,,3653,"(3.541112,-76.384584)"
2016,Octubre,Panamá,591,248,228,,476,"(4.452882,-75.766298)"
2016,Octubre,Panamá,591,8707,9713,,18420,"(4.697144,-74.140516)"
2016,Octubre,Panamá,591,576,489,,1065,"(4.815061,-75.736532)"
2016,Octubre,Panamá,591,3304,3215,,6519,"(6.171601,-75.427454)"
2016,Octubre,Panamá,591,1,2,,3,"(6.228046,-77.404104)"
2016,Octubre,Panamá,591,4,4,,8,"(7.102626,-77.762647)"
2016,Octubre,Panamá,591,211,187,,398,"(7.128456,-73.183637)"
2016,Octubre,Panamá,591,76,58,,134,"(7.927209,-72.507910)"
2016,Octubre,Panamá,591,0,54,,54,"(8.066966,-76.735404)"
2016,Octubre,Panamá,591,14,39,,53,"(8.635765,-77.346578)"
2016,Octubre,Paraguay,600,1,3,,4,"(10.445761,-75.516429)"
2016,Octubre,Paraguay,600,3,4,,7,"(10.886611,-74.776708)"
2016,Octubre,Paraguay,600,22,37,,59,"(3.541112,-76.384584)"
2016,Octubre,Paraguay,600,84,273,,357,"(4.697144,-74.140516)"
2016,Octubre,Paraguay,600,13,14,,27,"(4.815061,-75.736532)"
2016,Octubre,Paraguay,600,22,106,,128,"(6.171601,-75.427454)"
2016,Octubre,Perú,604,2,1,,3,"(-0.193180,-74.784874)"
2016,Octubre,Perú,604,63,90,,153,"(-4.197703,-69.941278)"
2016,Octubre,Perú,604,0,1,,1,"(0.25129,-76.875963)"
2016,Octubre,Perú,604,67,67,,134,"(0.814836,-77.662532)"
2016,Octubre,Perú,604,5,13,,18,"(10.445761,-75.516429)"
2016,Octubre,Perú,604,10,10,,20,"(10.886611,-74.776708)"
2016,Octubre,Perú,604,1,2,,3,"(12.586067,-81.702563)"
2016,Octubre,Perú,604,267,346,,613,"(3.541112,-76.384584)"
2016,Octubre,Perú,604,5510,6313,,11823,"(4.697144,-74.140516)"
2016,Octubre,Perú,604,6,5,,11,"(4.815061,-75.736532)"
2016,Octubre,Perú,604,380,409,,789,"(6.171601,-75.427454)"
2016,Octubre,Perú,604,3,0,,3,"(7.128456,-73.183637)"
2016,Octubre,Perú,604,1,0,,1,"(7.927209,-72.507910)"
2016,Octubre,Polonia,616,13,12,,25,"(4.697144,-74.140516)"
2016,Octubre,Portugal,620,1,0,,1,"(10.886611,-74.776708)"
2016,Octubre,Portugal,620,10,5,,15,"(3.541112,-76.384584)"
2016,Octubre,Portugal,620,115,153,,268,"(4.697144,-74.140516)"
2016,Octubre,Portugal,620,0,1,,1,"(4.815061,-75.736532)"
2016,Octubre,Portugal,620,5,8,,13,"(6.171601,-75.427454)"
2016,Octubre,Puerto Rico/Territorio de Estados Unidos,630,5,11,,16,"(10.445761,-75.516429)"
2016,Octubre,Puerto Rico/Territorio de Estados Unidos,630,13,13,,26,"(10.886611,-74.776708)"
2016,Octubre,Puerto Rico/Territorio de Estados Unidos,630,2,1,,3,"(12.586067,-81.702563)"
2016,Octubre,Puerto Rico/Territorio de Estados Unidos,630,41,37,,78,"(3.541112,-76.384584)"
2016,Octubre,Puerto Rico/Territorio de Estados Unidos,630,594,510,,1104,"(4.697144,-74.140516)"
2016,Octubre,Puerto Rico/Territorio de Estados Unidos,630,5,6,,11,"(4.815061,-75.736532)"
2016,Octubre,Puerto Rico/Territorio de Estados Unidos,630,47,54,,101,"(6.171601,-75.427454)"
2016,Octubre,Puerto Rico/Territorio de Estados Unidos,630,8,8,,16,"(7.128456,-73.183637)"
2016,Octubre,Qatar,634,4,6,,10,"(4.697144,-74.140516)"
2016,Octubre,Qatar,634,1,2,,3,"(6.171601,-75.427454)"
2016,Octubre,Reino Unido de Gran Bretaña e Irlanda del Norte,826,16,34,,50,"(10.445761,-75.516429)"
2016,Octubre,Reino Unido de Gran Bretaña e Irlanda del Norte,826,1,0,,1,"(10.886611,-74.776708)"
2016,Octubre,Reino Unido de Gran Bretaña e Irlanda del Norte,826,8,10,,18,"(11.117806,-74.232622)"
2016,Octubre,Reino Unido de Gran Bretaña e Irlanda del Norte,826,25,16,,41,"(3.541112,-76.384584)"
2016,Octubre,Reino Unido de Gran Bretaña e Irlanda del Norte,826,1445,1244,,2689,"(4.697144,-74.140516)"
2016,Octubre,Reino Unido de Gran Bretaña e Irlanda del Norte,826,10,6,,16,"(6.171601,-75.427454)"
2016,Octubre,República CentroÁfricana,140,1,1,,2,"(4.697144,-74.140516)"
2016,Octubre,Federación de Rusia,643,0,1,,1,"(10.445761,-75.516429)"
2016,Octubre,Federación de Rusia,643,0,2,,2,"(3.541112,-76.384584)"
2016,Octubre,Federación de Rusia,643,18,31,,49,"(4.697144,-74.140516)"
2016,Octubre,Federación de Rusia,643,2,1,,3,"(6.171601,-75.427454)"
2016,Octubre,República Dominicana,214,28,33,,61,"(10.445761,-75.516429)"
2016,Octubre,República Dominicana,214,121,97,,218,"(10.886611,-74.776708)"
2016,Octubre,República Dominicana,214,7,5,,12,"(11.117806,-74.232622)"
2016,Octubre,República Dominicana,214,86,97,,183,"(3.541112,-76.384584)"
2016,Octubre,República Dominicana,214,3280,2918,,6198,"(4.697144,-74.140516)"
2016,Octubre,República Dominicana,214,56,31,,87,"(4.815061,-75.736532)"
2016,Octubre,República Dominicana,214,320,264,,584,"(6.171601,-75.427454)"
2016,Octubre,República Dominicana,214,41,32,,73,"(7.128456,-73.183637)"
2016,Octubre,República Dominicana,214,5,5,,10,"(7.927209,-72.507910)"
2016,Octubre,República Democrática Popular de Corea,408,0,1,,1,"(3.541112,-76.384584)"
2016,Octubre,República Democrática Popular de Corea,408,0,1,,1,"(4.697144,-74.140516)"
2016,Octubre,Rumania,642,1,4,,5,"(4.697144,-74.140516)"
2016,Octubre,Senegal,686,1,0,,1,"(4.697144,-74.140516)"
2016,Octubre,Serbia,688,0,1,,1,"(4.697144,-74.140516)"
2016,Octubre,Singapur,702,1,0,,1,"(10.886611,-74.776708)"
2016,Octubre,Singapur,702,15,13,,28,"(4.697144,-74.140516)"
2016,Octubre,Singapur,702,1,0,,1,"(6.171601,-75.427454)"
2016,Octubre,Sri Lanka,144,0,1,,1,"(4.697144,-74.140516)"
2016,Octubre,Sudáfrica,710,0,1,,1,"(3.541112,-76.384584)"
2016,Octubre,Sudáfrica,710,20,24,,44,"(4.697144,-74.140516)"
2016,Octubre,Suecia,752,2,0,,2,"(10.445761,-75.516429)"
2016,Octubre,Suecia,752,5,9,,14,"(3.541112,-76.384584)"
2016,Octubre,Suecia,752,45,53,,98,"(4.697144,-74.140516)"
2016,Octubre,Suecia,752,6,5,,11,"(6.171601,-75.427454)"
2016,Octubre,Suiza,756,40,29,,69,"(3.541112,-76.384584)"
2016,Octubre,Suiza,756,191,156,,347,"(4.697144,-74.140516)"
2016,Octubre,Suiza,756,0,1,,1,"(4.815061,-75.736532)"
2016,Octubre,Suiza,756,18,9,,27,"(6.171601,-75.427454)"
2016,Octubre,Suiza,756,0,1,,1,"(7.128456,-73.183637)"
2016,Octubre,Surinam,740,0,1,,1,"(10.408582,-75.538003)"
2016,Octubre,Surinam,740,1,2,,3,"(10.886611,-74.776708)"
2016,Octubre,Surinam,740,1,11,,12,"(4.697144,-74.140516)"
2016,Octubre,Surinam,740,2,1,,3,"(6.171601,-75.427454)"
2016,Octubre,Taiwán,158,4,4,,8,"(4.697144,-74.140516)"
2016,Octubre,Tailandia,764,0,1,,1,"(3.541112,-76.384584)"
2016,Octubre,Tailandia,764,50,56,,106,"(4.697144,-74.140516)"
2016,Octubre,Tailandia,764,0,1,,1,"(6.171601,-75.427454)"
2016,Octubre,Tanzania,834,1,0,,1,"(6.171601,-75.427454)"
2016,Octubre,Trinidad y Tobago,780,1,4,,5,"(10.445761,-75.516429)"
2016,Octubre,Trinidad y Tobago,780,4,2,,6,"(10.886611,-74.776708)"
2016,Octubre,Trinidad y Tobago,780,1,26,,27,"(3.541112,-76.384584)"
2016,Octubre,Trinidad y Tobago,780,17,31,,48,"(4.697144,-74.140516)"
2016,Octubre,Trinidad y Tobago,780,4,7,,11,"(4.815061,-75.736532)"
2016,Octubre,Trinidad y Tobago,780,5,18,,23,"(6.171601,-75.427454)"
2016,Octubre,Trinidad y Tobago,780,1,2,,3,"(7.128456,-73.183637)"
2016,Octubre,Túnez,788,0,1,,1,"(4.697144,-74.140516)"
2016,Octubre,Turquía,792,1,2,,3,"(3.541112,-76.384584)"
2016,Octubre,Turquía,792,156,172,,328,"(4.697144,-74.140516)"
2016,Octubre,Turquía,792,4,4,,8,"(6.171601,-75.427454)"
2016,Octubre,Tuvalu,798,0,1,,1,"(4.697144,-74.140516)"
2016,Octubre,Turkmenistán,795,0,1,,1,"(3.541112,-76.384584)"
2016,Octubre,Turkmenistán,795,4,0,,4,"(4.697144,-74.140516)"
2016,Octubre,Turkmenistán,795,0,1,,1,"(6.171601,-75.427454)"
2016,Octubre,Ucrania,804,1,0,,1,"(4.697144,-74.140516)"
2016,Octubre,Uganda,800,0,1,,1,"(4.697144,-74.140516)"
2016,Octubre,Uruguay,858,2,1,,3,"(10.886611,-74.776708)"
2016,Octubre,Uruguay,858,0,1,,1,"(12.586067,-81.702563)"
2016,Octubre,Uruguay,858,14,19,,33,"(3.541112,-76.384584)"
2016,Octubre,Uruguay,858,102,134,,236,"(4.697144,-74.140516)"
2016,Octubre,Uruguay,858,2,3,,5,"(4.815061,-75.736532)"
2016,Octubre,Uruguay,858,25,27,,52,"(6.171601,-75.427454)"
2016,Octubre,Venezuela,862,11,11,,22,"(10.445761,-75.516429)"
2016,Octubre,Venezuela,862,8,18,,26,"(10.886611,-74.776708)"
2016,Octubre,Venezuela,862,2532,2265,,4797,"(11.360009,-72.129330)"
2016,Octubre,Venezuela,862,0,3,,3,"(12.586067,-81.702563)"
2016,Octubre,Venezuela,862,10,28,,38,"(3.541112,-76.384584)"
2016,Octubre,Venezuela,862,2,5,,7,"(3.866713,-67.927521)"
2016,Octubre,Venezuela,862,1322,1552,,2874,"(4.697144,-74.140516)"
2016,Octubre,Venezuela,862,4,2,,6,"(4.815061,-75.736532)"
2016,Octubre,Venezuela,862,325,334,,659,"(6.171601,-75.427454)"
2016,Octubre,Venezuela,862,67,71,,138,"(6.185799,-67.483929)"
2016,Octubre,Venezuela,862,795,639,,1434,"(7.088729,-70.740253)"
2016,Octubre,Venezuela,862,4,2,,6,"(7.128456,-73.183637)"
2016,Octubre,Venezuela,862,2630,2433,,5063,"(7.818934,-72.453226)"
2016,Octubre,Venezuela,862,14,16,,30,"(8.36068,-72.409396)"
2016,Octubre,Vietnam,704,4,3,,7,"(4.697144,-74.140516)"
2016,Octubre,Islas Vírgenes Británicas/Territorio Británico de Ultramar,92,0,1,,1,"(3.541112,-76.384584)"
2016,Octubre,Zimbabue,716,0,3,,3,"(10.886611,-74.776708)"
2016,Octubre,Islas Turcas y Caicos/Territorio Británico de Ultramar,796,0,1,,1,"(10.445761,-75.516429)"
2016,Noviembre,Afganistán,4,1,3,,4,"(4.697144,-74.140516)"
2016,Noviembre,Afganistán,4,0,1,,1,"(6.171601,-75.427454)"
2016,Noviembre,Albania,8,1,0,,1,"(3.541112,-76.384584)"
2016,Noviembre,Albania,8,0,3,,3,"(4.697144,-74.140516)"
2016,Noviembre,Alemania,276,0,1,,1,"(0.814836,-77.662532)"
2016,Noviembre,Alemania,276,3,1,,4,"(10.445761,-75.516429)"
2016,Noviembre,Alemania,276,5,7,,12,"(10.886611,-74.776708)"
2016,Noviembre,Alemania,276,84,56,,140,"(3.541112,-76.384584)"
2016,Noviembre,Alemania,276,747,736,,1483,"(4.697144,-74.140516)"
2016,Noviembre,Alemania,276,6,0,,6,"(4.815061,-75.736532)"
2016,Noviembre,Alemania,276,35,33,,68,"(6.171601,-75.427454)"
2016,Noviembre,Andorra,20,2,1,,3,"(3.541112,-76.384584)"
2016,Noviembre,Andorra,20,3,0,,3,"(4.697144,-74.140516)"
2016,Noviembre,Angola,24,1,8,,9,"(4.697144,-74.140516)"
2016,Noviembre,Antigua y Barbuda,28,2,2,,4,"(4.697144,-74.140516)"
2016,Noviembre,Países Bajos,528,0,1,,1,"(10.445761,-75.516429)"
2016,Noviembre,Países Bajos,528,117,72,,189,"(10.886611,-74.776708)"
2016,Noviembre,Países Bajos,528,121,81,,202,"(3.541112,-76.384584)"
2016,Noviembre,Países Bajos,528,732,627,,1359,"(4.697144,-74.140516)"
2016,Noviembre,Países Bajos,528,0,4,,4,"(4.815061,-75.736532)"
2016,Noviembre,Países Bajos,528,157,101,,258,"(6.171601,-75.427454)"
2016,Noviembre,Países Bajos,528,1,2,,3,"(7.128456,-73.183637)"
2016,Noviembre,Arabia Saudita,682,0,2,,2,"(3.541112,-76.384584)"
2016,Noviembre,Arabia Saudita,682,1,24,,25,"(4.697144,-74.140516)"
2016,Noviembre,Arabia Saudita,682,0,1,,1,"(6.171601,-75.427454)"
2016,Noviembre,Argelia,12,2,0,,2,"(3.541112,-76.384584)"
2016,Noviembre,Argelia,12,1,3,,4,"(4.697144,-74.140516)"
2016,Noviembre,Argentina,32,13,20,,33,"(0.814836,-77.662532)"
2016,Noviembre,Argentina,32,5,4,,9,"(10.445761,-75.516429)"
2016,Noviembre,Argentina,32,25,74,,99,"(10.886611,-74.776708)"
2016,Noviembre,Argentina,32,1,2,,3,"(12.586067,-81.702563)"
2016,Noviembre,Argentina,32,167,168,,335,"(3.541112,-76.384584)"
2016,Noviembre,Argentina,32,2778,3136,,5914,"(4.697144,-74.140516)"
2016,Noviembre,Argentina,32,11,19,,30,"(4.815061,-75.736532)"
2016,Noviembre,Argentina,32,172,193,,365,"(6.171601,-75.427454)"
2016,Noviembre,Argentina,32,4,2,,6,"(7.128456,-73.183637)"
2016,Noviembre,Aruba,533,1,1,,2,"(10.408582,-75.538003)"
2016,Noviembre,Aruba,533,3,4,,7,"(10.445761,-75.516429)"
2016,Noviembre,Aruba,533,23,24,,47,"(10.886611,-74.776708)"
2016,Noviembre,Aruba,533,2,1,,3,"(12.586067,-81.702563)"
2016,Noviembre,Aruba,533,60,37,,97,"(3.541112,-76.384584)"
2016,Noviembre,Aruba,533,1725,1306,,3031,"(4.697144,-74.140516)"
2016,Noviembre,Aruba,533,15,7,,22,"(4.815061,-75.736532)"
2016,Noviembre,Aruba,533,94,63,,157,"(6.171601,-75.427454)"
2016,Noviembre,Aruba,533,9,36,,45,"(7.128456,-73.183637)"
2016,Noviembre,Australia,36,1,3,,4,"(10.886611,-74.776708)"
2016,Noviembre,Australia,36,17,16,,33,"(3.541112,-76.384584)"
2016,Noviembre,Australia,36,307,207,,514,"(4.697144,-74.140516)"
2016,Noviembre,Australia,36,2,2,,4,"(4.815061,-75.736532)"
2016,Noviembre,Australia,36,32,23,,55,"(6.171601,-75.427454)"
2016,Noviembre,Australia,36,2,4,,6,"(7.128456,-73.183637)"
2016,Noviembre,Austria,40,2,0,,2,"(10.445761,-75.516429)"
2016,Noviembre,Austria,40,1,1,,2,"(3.541112,-76.384584)"
2016,Noviembre,Austria,40,26,26,,52,"(4.697144,-74.140516)"
2016,Noviembre,Austria,40,0,1,,1,"(4.815061,-75.736532)"
2016,Noviembre,Austria,40,3,3,,6,"(6.171601,-75.427454)"
2016,Noviembre,Azerbaiyán,31,14,2,,16,"(4.697144,-74.140516)"
2016,Noviembre,Bahamas,44,4,1,,5,"(10.445761,-75.516429)"
2016,Noviembre,Bahamas,44,1,2,,3,"(10.886611,-74.776708)"
2016,Noviembre,Bahamas,44,4,4,,8,"(3.541112,-76.384584)"
2016,Noviembre,Bahamas,44,4,9,,13,"(4.697144,-74.140516)"
2016,Noviembre,Bahamas,44,3,5,,8,"(4.815061,-75.736532)"
2016,Noviembre,Bahamas,44,7,23,,30,"(6.171601,-75.427454)"
2016,Noviembre,Bahréin,48,1,0,,1,"(4.697144,-74.140516)"
2016,Noviembre,Bahréin,48,1,1,,2,"(6.171601,-75.427454)"
2016,Noviembre,Barbados,52,92,80,,172,"(4.697144,-74.140516)"
2016,Noviembre,Barbados,52,0,1,,1,"(6.171601,-75.427454)"
2016,Noviembre,República de Belarús,112,0,2,,2,"(4.697144,-74.140516)"
2016,Noviembre,Bélgica,56,0,1,,1,"(10.886611,-74.776708)"
2016,Noviembre,Bélgica,56,15,10,,25,"(3.541112,-76.384584)"
2016,Noviembre,Bélgica,56,48,39,,87,"(4.697144,-74.140516)"
2016,Noviembre,Bélgica,56,15,10,,25,"(6.171601,-75.427454)"
2016,Noviembre,Belice,84,0,1,,1,"(10.408582,-75.538003)"
2016,Noviembre,Belice,84,1,1,,2,"(3.541112,-76.384584)"
2016,Noviembre,Belice,84,3,4,,7,"(4.697144,-74.140516)"
2016,Noviembre,Belice,84,1,1,,2,"(6.171601,-75.427454)"
2016,Noviembre,Benín,204,1,0,,1,"(4.697144,-74.140516)"
2016,Noviembre,Bermudas/Territorio Británico de Ultramar,60,0,1,,1,"(4.697144,-74.140516)"
2016,Noviembre,Bolivia,68,2,5,,7,"(0.814836,-77.662532)"
2016,Noviembre,Bolivia,68,8,7,,15,"(10.445761,-75.516429)"
2016,Noviembre,Bolivia,68,1,6,,7,"(10.886611,-74.776708)"
2016,Noviembre,Bolivia,68,17,41,,58,"(3.541112,-76.384584)"
2016,Noviembre,Bolivia,68,264,489,,753,"(4.697144,-74.140516)"
2016,Noviembre,Bolivia,68,11,10,,21,"(4.815061,-75.736532)"
2016,Noviembre,Bolivia,68,27,50,,77,"(6.171601,-75.427454)"
2016,Noviembre,Bolivia,68,3,4,,7,"(7.128456,-73.183637)"
2016,Noviembre,Brasil,76,152,252,,404,"(-4.197703,-69.941278)"
2016,Noviembre,Brasil,76,1,2,,3,"(0.814836,-77.662532)"
2016,Noviembre,Brasil,76,0,1,,1,"(10.408582,-75.538003)"
2016,Noviembre,Brasil,76,3,4,,7,"(10.445761,-75.516429)"
2016,Noviembre,Brasil,76,12,19,,31,"(10.886611,-74.776708)"
2016,Noviembre,Brasil,76,3,4,,7,"(12.586067,-81.702563)"
2016,Noviembre,Brasil,76,93,110,,203,"(3.541112,-76.384584)"
2016,Noviembre,Brasil,76,1,0,,1,"(3.866713,-67.927521)"
2016,Noviembre,Brasil,76,2416,3253,,5669,"(4.697144,-74.140516)"
2016,Noviembre,Brasil,76,10,23,,33,"(4.815061,-75.736532)"
2016,Noviembre,Brasil,76,96,119,,215,"(6.171601,-75.427454)"
2016,Noviembre,Brasil,76,5,4,,9,"(7.128456,-73.183637)"
2016,Noviembre,Bulgaria,100,0,3,,3,"(3.541112,-76.384584)"
2016,Noviembre,Bulgaria,100,2,2,,4,"(4.697144,-74.140516)"
2016,Noviembre,Cabo Verde,132,0,1,,1,"(10.445761,-75.516429)"
2016,Noviembre,Islas Caimán/Territorio Británico de Ultramar,136,0,1,,1,"(10.886611,-74.776708)"
2016,Noviembre,Islas Caimán/Territorio Británico de Ultramar,136,3,0,,3,"(12.586067,-81.702563)"
2016,Noviembre,Islas Caimán/Territorio Británico de Ultramar,136,0,1,,1,"(3.541112,-76.384584)"
2016,Noviembre,Islas Caimán/Territorio Británico de Ultramar,136,1,0,,1,"(4.697144,-74.140516)"
2016,Noviembre,Camboya,116,1,0,,1,"(3.541112,-76.384584)"
2016,Noviembre,Camboya,116,1,0,,1,"(4.697144,-74.140516)"
2016,Noviembre,Camerún,120,1,1,,2,"(4.697144,-74.140516)"
2016,Noviembre,Canadá,124,11,11,,22,"(10.445761,-75.516429)"
2016,Noviembre,Canadá,124,18,17,,35,"(10.886611,-74.776708)"
2016,Noviembre,Canadá,124,66,46,,112,"(3.541112,-76.384584)"
2016,Noviembre,Canadá,124,1095,909,,2004,"(4.697144,-74.140516)"
2016,Noviembre,Canadá,124,6,4,,10,"(4.815061,-75.736532)"
2016,Noviembre,Canadá,124,130,88,,218,"(6.171601,-75.427454)"
2016,Noviembre,Canadá,124,4,6,,10,"(7.128456,-73.183637)"
2016,Noviembre,España,724,1,0,,1,"(10.445761,-75.516429)"
2016,Noviembre,España,724,4,7,,11,"(10.886611,-74.776708)"
2016,Noviembre,España,724,2839,2045,,4884,"(3.541112,-76.384584)"
2016,Noviembre,España,724,9158,7389,,16547,"(4.697144,-74.140516)"
2016,Noviembre,España,724,7,3,,10,"(4.815061,-75.736532)"
2016,Noviembre,España,724,1028,796,,1824,"(6.171601,-75.427454)"
2016,Noviembre,España,724,1,0,,1,"(7.128456,-73.183637)"
2016,Noviembre,Colombia,170,0,4,,4,"(10.445761,-75.516429)"
2016,Noviembre,Colombia,170,82,271,,353,"(4.697144,-74.140516)"
2016,Noviembre,República Del Congo,178,1,1,,2,"(4.697144,-74.140516)"
2016,Noviembre,República Democrática del Congo,180,0,1,,1,"(4.697144,-74.140516)"
2016,Noviembre,República de Corea,410,0,2,,2,"(3.541112,-76.384584)"
2016,Noviembre,República de Corea,410,25,27,,52,"(4.697144,-74.140516)"
2016,Noviembre,República de Corea,410,0,3,,3,"(6.171601,-75.427454)"
2016,Noviembre,Costa de Marfil,384,1,1,,2,"(3.541112,-76.384584)"
2016,Noviembre,Costa de Marfil,384,3,6,,9,"(4.697144,-74.140516)"
2016,Noviembre,Costa Rica,188,7,4,,11,"(10.445761,-75.516429)"
2016,Noviembre,Costa Rica,188,19,18,,37,"(10.886611,-74.776708)"
2016,Noviembre,Costa Rica,188,0,5,,5,"(11.117806,-74.232622)"
2016,Noviembre,Costa Rica,188,0,1,,1,"(11.247723,-74.213989)"
2016,Noviembre,Costa Rica,188,4,29,,33,"(12.5744111,-81.703935)"
2016,Noviembre,Costa Rica,188,4,7,,11,"(12.586067,-81.702563)"
2016,Noviembre,Costa Rica,188,36,62,,98,"(3.541112,-76.384584)"
2016,Noviembre,Costa Rica,188,965,1261,,2226,"(4.697144,-74.140516)"
2016,Noviembre,Costa Rica,188,13,5,,18,"(4.815061,-75.736532)"
2016,Noviembre,Costa Rica,188,93,120,,213,"(6.171601,-75.427454)"
2016,Noviembre,Costa Rica,188,4,5,,9,"(7.128456,-73.183637)"
2016,Noviembre,Croacia,191,0,1,,1,"(3.541112,-76.384584)"
2016,Noviembre,Croacia,191,0,1,,1,"(4.697144,-74.140516)"
2016,Noviembre,Croacia,191,2,0,,2,"(4.815061,-75.736532)"
2016,Noviembre,Cuba,192,33,16,,49,"(10.445761,-75.516429)"
2016,Noviembre,Cuba,192,11,8,,19,"(10.886611,-74.776708)"
2016,Noviembre,Cuba,192,2,4,,6,"(12.586067,-81.702563)"
2016,Noviembre,Cuba,192,53,65,,118,"(3.541112,-76.384584)"
2016,Noviembre,Cuba,192,1141,1012,,2153,"(4.697144,-74.140516)"
2016,Noviembre,Cuba,192,12,12,,24,"(4.815061,-75.736532)"
2016,Noviembre,Cuba,192,154,121,,275,"(6.171601,-75.427454)"
2016,Noviembre,Cuba,192,1,5,,6,"(7.128456,-73.183637)"
2016,Noviembre,Curazao,99999,8,53,,61,"(4.697144,-74.140516)"
2016,Noviembre,República Checa,203,7,3,,10,"(4.697144,-74.140516)"
2016,Noviembre,Chile,152,98,108,,206,"(0.814836,-77.662532)"
2016,Noviembre,Chile,152,0,2,,2,"(1.813928,-78.763924)"
2016,Noviembre,Chile,152,13,23,,36,"(10.445761,-75.516429)"
2016,Noviembre,Chile,152,24,23,,47,"(10.886611,-74.776708)"
2016,Noviembre,Chile,152,2,3,,5,"(12.586067,-81.702563)"
2016,Noviembre,Chile,152,340,228,,568,"(3.541112,-76.384584)"
2016,Noviembre,Chile,152,4223,4111,,8334,"(4.697144,-74.140516)"
2016,Noviembre,Chile,152,107,73,,180,"(4.815061,-75.736532)"
2016,Noviembre,Chile,152,110,108,,218,"(6.171601,-75.427454)"
2016,Noviembre,Chile,152,14,11,,25,"(7.128456,-73.183637)"
2016,Noviembre,China,156,1,4,,5,"(10.886611,-74.776708)"
2016,Noviembre,China,156,2,9,,11,"(3.541112,-76.384584)"
2016,Noviembre,China,156,122,281,,403,"(4.697144,-74.140516)"
2016,Noviembre,China,156,12,30,,42,"(6.171601,-75.427454)"
2016,Noviembre,Chipre,196,0,1,,1,"(4.697144,-74.140516)"
2016,Noviembre,Chipre,196,1,0,,1,"(4.815061,-75.736532)"
2016,Noviembre,Dinamarca,208,18,12,,30,"(4.697144,-74.140516)"
2016,Noviembre,Dinamarca,208,1,0,,1,"(7.128456,-73.183637)"
2016,Noviembre,Dominica,212,0,1,,1,"(4.697144,-74.140516)"
2016,Noviembre,Ecuador,218,10,10,,20,"(-0.193180,-74.784874)"
2016,Noviembre,Ecuador,218,414,697,,1111,"(0.25129,-76.875963)"
2016,Noviembre,Ecuador,218,13,12,,25,"(0.812436,-77.847006)"
2016,Noviembre,Ecuador,218,5112,5837,,10949,"(0.814836,-77.662532)"
2016,Noviembre,Ecuador,218,134,190,,324,"(1.813928,-78.763924)"
2016,Noviembre,Ecuador,218,0,11,,11,"(10.408582,-75.538003)"
2016,Noviembre,Ecuador,218,7,4,,11,"(10.445761,-75.516429)"
2016,Noviembre,Ecuador,218,7,17,,24,"(10.886611,-74.776708)"
2016,Noviembre,Ecuador,218,359,417,,776,"(3.541112,-76.384584)"
2016,Noviembre,Ecuador,218,2808,4498,,7306,"(4.697144,-74.140516)"
2016,Noviembre,Ecuador,218,0,3,,3,"(4.815061,-75.736532)"
2016,Noviembre,Ecuador,218,56,72,,128,"(6.171601,-75.427454)"
2016,Noviembre,Ecuador,218,1,1,,2,"(7.128456,-73.183637)"
2016,Noviembre,Egipto,818,0,1,,1,"(3.541112,-76.384584)"
2016,Noviembre,Egipto,818,21,19,,40,"(4.697144,-74.140516)"
2016,Noviembre,El Salvador,222,3,1,,4,"(10.445761,-75.516429)"
2016,Noviembre,El Salvador,222,5,6,,11,"(10.886611,-74.776708)"
2016,Noviembre,El Salvador,222,91,132,,223,"(3.541112,-76.384584)"
2016,Noviembre,El Salvador,222,777,1008,,1785,"(4.697144,-74.140516)"
2016,Noviembre,El Salvador,222,0,1,,1,"(4.815061,-75.736532)"
2016,Noviembre,El Salvador,222,53,90,,143,"(6.171601,-75.427454)"
2016,Noviembre,Emiratos Árabes,784,1,0,,1,"(10.445761,-75.516429)"
2016,Noviembre,Emiratos Árabes,784,1,0,,1,"(10.886611,-74.776708)"
2016,Noviembre,Emiratos Árabes,784,1,1,,2,"(3.541112,-76.384584)"
2016,Noviembre,Emiratos Árabes,784,68,187,,255,"(4.697144,-74.140516)"
2016,Noviembre,Emiratos Árabes,784,7,7,,14,"(6.171601,-75.427454)"
2016,Noviembre,Eritrea,232,0,1,,1,"(4.697144,-74.140516)"
2016,Noviembre,Eslovaquia,703,0,2,,2,"(3.541112,-76.384584)"
2016,Noviembre,Eslovaquia,703,1,1,,2,"(4.697144,-74.140516)"
2016,Noviembre,Eslovenia,705,1,0,,1,"(4.697144,-74.140516)"
2016,Noviembre,Estados Unidos de América,840,3706,3158,,6864,"(10.445761,-75.516429)"
2016,Noviembre,Estados Unidos de América,840,3085,2445,,5530,"(10.886611,-74.776708)"
2016,Noviembre,Estados Unidos de América,840,1,2,,3,"(11.117806,-74.232622)"
2016,Noviembre,Estados Unidos de América,840,58,35,,93,"(12.586067,-81.702563)"
2016,Noviembre,Estados Unidos de América,840,5170,3558,,8728,"(3.541112,-76.384584)"
2016,Noviembre,Estados Unidos de América,840,635,450,,1085,"(4.452882,-75.766298)"
2016,Noviembre,Estados Unidos de América,840,32302,27801,,60103,"(4.697144,-74.140516)"
2016,Noviembre,Estados Unidos de América,840,706,458,,1164,"(4.815061,-75.736532)"
2016,Noviembre,Estados Unidos de América,840,8849,6951,,15800,"(6.171601,-75.427454)"
2016,Noviembre,Estados Unidos de América,840,231,176,,407,"(7.128456,-73.183637)"
2016,Noviembre,Estonia,233,1,1,,2,"(4.697144,-74.140516)"
2016,Noviembre,Etiopia,231,2,4,,6,"(4.697144,-74.140516)"
2016,Noviembre,Filipinas,608,3,3,,6,"(4.697144,-74.140516)"
2016,Noviembre,Filipinas,608,2,1,,3,"(6.171601,-75.427454)"
2016,Noviembre,Finlandia,246,4,3,,7,"(4.697144,-74.140516)"
2016,Noviembre,Finlandia,246,0,2,,2,"(6.171601,-75.427454)"
2016,Noviembre,Francia,250,0,2,,2,"(10.445761,-75.516429)"
2016,Noviembre,Francia,250,2,0,,2,"(10.886611,-74.776708)"
2016,Noviembre,Francia,250,85,67,,152,"(3.541112,-76.384584)"
2016,Noviembre,Francia,250,998,1038,,2036,"(4.697144,-74.140516)"
2016,Noviembre,Francia,250,2,5,,7,"(4.815061,-75.736532)"
2016,Noviembre,Francia,250,41,35,,76,"(6.171601,-75.427454)"
2016,Noviembre,Ghana,288,0,3,,3,"(4.697144,-74.140516)"
2016,Noviembre,Gibraltar/Territorio Británico de Ultramar,292,2,4,,6,"(0.814836,-77.662532)"
2016,Noviembre,Gibraltar/Territorio Británico de Ultramar,292,1,0,,1,"(4.815061,-75.736532)"
2016,Noviembre,Grecia,300,1,3,,4,"(3.541112,-76.384584)"
2016,Noviembre,Grecia,300,6,6,,12,"(4.697144,-74.140516)"
2016,Noviembre,Grecia,300,1,0,,1,"(6.171601,-75.427454)"
2016,Noviembre,Guatemala,320,4,3,,7,"(10.445761,-75.516429)"
2016,Noviembre,Guatemala,320,11,19,,30,"(10.886611,-74.776708)"
2016,Noviembre,Guatemala,320,1,2,,3,"(12.586067,-81.702563)"
2016,Noviembre,Guatemala,320,81,116,,197,"(3.541112,-76.384584)"
2016,Noviembre,Guatemala,320,599,689,,1288,"(4.697144,-74.140516)"
2016,Noviembre,Guatemala,320,15,24,,39,"(4.815061,-75.736532)"
2016,Noviembre,Guatemala,320,96,135,,231,"(6.171601,-75.427454)"
2016,Noviembre,Guatemala,320,9,6,,15,"(7.128456,-73.183637)"
2016,Noviembre,Guyana,328,1,1,,2,"(10.886611,-74.776708)"
2016,Noviembre,Guyana,328,2,0,,2,"(3.541112,-76.384584)"
2016,Noviembre,Guyana,328,0,2,,2,"(4.697144,-74.140516)"
2016,Noviembre,Guinea Ecuatorial,226,0,1,,1,"(3.541112,-76.384584)"
2016,Noviembre,Guadalupe/Territorio Francés,312,0,1,,1,"(4.697144,-74.140516)"
2016,Noviembre,Guadalupe/Territorio Francés,312,2,0,,2,"(6.171601,-75.427454)"
2016,Noviembre,Guayana Francesa/Departamento de Ultramar Francés,254,1,1,,2,"(4.697144,-74.140516)"
2016,Noviembre,Guayana Francesa/Departamento de Ultramar Francés,254,0,10,,10,"(6.171601,-75.427454)"
2016,Noviembre,Haití,332,0,1,,1,"(10.408582,-75.538003)"
2016,Noviembre,Haití,332,1,5,,6,"(10.886611,-74.776708)"
2016,Noviembre,Haití,332,0,1,,1,"(3.541112,-76.384584)"
2016,Noviembre,Haití,332,1,13,,14,"(4.697144,-74.140516)"
2016,Noviembre,Haití,332,3,6,,9,"(6.171601,-75.427454)"
2016,Noviembre,Honduras,340,2,0,,2,"(10.445761,-75.516429)"
2016,Noviembre,Honduras,340,3,11,,14,"(10.886611,-74.776708)"
2016,Noviembre,Honduras,340,0,1,,1,"(12.5744111,-81.703935)"
2016,Noviembre,Honduras,340,10,36,,46,"(3.541112,-76.384584)"
2016,Noviembre,Honduras,340,92,144,,236,"(4.697144,-74.140516)"
2016,Noviembre,Honduras,340,2,6,,8,"(4.815061,-75.736532)"
2016,Noviembre,Honduras,340,32,53,,85,"(6.171601,-75.427454)"
2016,Noviembre,Honduras,340,4,3,,7,"(7.128456,-73.183637)"
2016,Noviembre,Hong Kong,344,2,2,,4,"(3.541112,-76.384584)"
2016,Noviembre,Hong Kong,344,20,32,,52,"(4.697144,-74.140516)"
2016,Noviembre,Hong Kong,344,4,7,,11,"(6.171601,-75.427454)"
2016,Noviembre,Hungría,348,1,1,,2,"(3.541112,-76.384584)"
2016,Noviembre,Hungría,348,2,3,,5,"(4.697144,-74.140516)"
2016,Noviembre,India,356,5,9,,14,"(10.886611,-74.776708)"
2016,Noviembre,India,356,1,2,,3,"(3.541112,-76.384584)"
2016,Noviembre,India,356,21,27,,48,"(4.697144,-74.140516)"
2016,Noviembre,India,356,1,0,,1,"(4.815061,-75.736532)"
2016,Noviembre,India,356,6,1,,7,"(6.171601,-75.427454)"
2016,Noviembre,Indonesia,360,1,1,,2,"(3.541112,-76.384584)"
2016,Noviembre,Indonesia,360,9,12,,21,"(4.697144,-74.140516)"
2016,Noviembre,Iraq,368,2,5,,7,"(4.697144,-74.140516)"
2016,Noviembre,Irán,364,2,4,,6,"(4.697144,-74.140516)"
2016,Noviembre,República de Irlanda,372,1,1,,2,"(3.541112,-76.384584)"
2016,Noviembre,República de Irlanda,372,9,8,,17,"(4.697144,-74.140516)"
2016,Noviembre,Islandia,352,1,2,,3,"(4.697144,-74.140516)"
2016,Noviembre,Islandia,352,2,2,,4,"(6.171601,-75.427454)"
2016,Noviembre,Islas Pitcairn/Territorio Británico de Ultramar,612,1,1,,2,"(10.408582,-75.538003)"
2016,Noviembre,Israel,376,1,0,,1,"(10.886611,-74.776708)"
2016,Noviembre,Israel,376,7,5,,12,"(3.541112,-76.384584)"
2016,Noviembre,Israel,376,115,95,,210,"(4.697144,-74.140516)"
2016,Noviembre,Israel,376,5,2,,7,"(6.171601,-75.427454)"
2016,Noviembre,Italia,380,3,0,,3,"(10.445761,-75.516429)"
2016,Noviembre,Italia,380,4,2,,6,"(10.886611,-74.776708)"
2016,Noviembre,Italia,380,129,52,,181,"(3.541112,-76.384584)"
2016,Noviembre,Italia,380,436,351,,787,"(4.697144,-74.140516)"
2016,Noviembre,Italia,380,2,1,,3,"(4.815061,-75.736532)"
2016,Noviembre,Italia,380,46,31,,77,"(6.171601,-75.427454)"
2016,Noviembre,Jamaica,388,2768,1812,,4580,"(10.408582,-75.538003)"
2016,Noviembre,Jamaica,388,3,4,,7,"(10.445761,-75.516429)"
2016,Noviembre,Jamaica,388,5,7,,12,"(10.886611,-74.776708)"
2016,Noviembre,Jamaica,388,1,0,,1,"(12.586067,-81.702563)"
2016,Noviembre,Jamaica,388,5,7,,12,"(3.541112,-76.384584)"
2016,Noviembre,Jamaica,388,16,24,,40,"(4.697144,-74.140516)"
2016,Noviembre,Jamaica,388,1,3,,4,"(4.815061,-75.736532)"
2016,Noviembre,Jamaica,388,16,12,,28,"(6.171601,-75.427454)"
2016,Noviembre,Jamaica,388,0,1,,1,"(7.128456,-73.183637)"
2016,Noviembre,Japón,392,0,1,,1,"(10.445761,-75.516429)"
2016,Noviembre,Japón,392,1,0,,1,"(10.886611,-74.776708)"
2016,Noviembre,Japón,392,3,1,,4,"(3.541112,-76.384584)"
2016,Noviembre,Japón,392,62,86,,148,"(4.697144,-74.140516)"
2016,Noviembre,Japón,392,2,3,,5,"(6.171601,-75.427454)"
2016,Noviembre,Jordania,400,0,1,,1,"(4.697144,-74.140516)"
2016,Noviembre,Jordania,400,0,1,,1,"(6.171601,-75.427454)"
2016,Noviembre,Kenia,404,0,1,,1,"(10.886611,-74.776708)"
2016,Noviembre,Kenia,404,3,1,,4,"(3.541112,-76.384584)"
2016,Noviembre,Kenia,404,9,6,,15,"(4.697144,-74.140516)"
2016,Noviembre,Kenia,404,3,0,,3,"(6.171601,-75.427454)"
2016,Noviembre,Kuwait,414,1,4,,5,"(4.697144,-74.140516)"
2016,Noviembre,República Democrática Popular  Lao,418,0,1,,1,"(4.697144,-74.140516)"
2016,Noviembre,Letonia,428,1,1,,2,"(4.697144,-74.140516)"
2016,Noviembre,Lituania,440,1,2,,3,"(4.697144,-74.140516)"
2016,Noviembre,Líbano,422,0,1,,1,"(10.886611,-74.776708)"
2016,Noviembre,Líbano,422,7,9,,16,"(4.697144,-74.140516)"
2016,Noviembre,Luxemburgo,442,1,1,,2,"(3.541112,-76.384584)"
2016,Noviembre,Luxemburgo,442,4,4,,8,"(4.697144,-74.140516)"
2016,Noviembre,Luxemburgo,442,1,0,,1,"(6.171601,-75.427454)"
2016,Noviembre,Madagascar,450,1,0,,1,"(4.697144,-74.140516)"
2016,Noviembre,Malasia,458,5,5,,10,"(4.697144,-74.140516)"
2016,Noviembre,Malawi,454,0,1,,1,"(4.697144,-74.140516)"
2016,Noviembre,Malta,470,1,1,,2,"(3.541112,-76.384584)"
2016,Noviembre,Malta,470,8,12,,20,"(4.697144,-74.140516)"
2016,Noviembre,Marruecos,504,1,4,,5,"(3.541112,-76.384584)"
2016,Noviembre,Marruecos,504,13,21,,34,"(4.697144,-74.140516)"
2016,Noviembre,Marruecos,504,0,1,,1,"(6.171601,-75.427454)"
2016,Noviembre,Mauricio,480,2,1,,3,"(4.697144,-74.140516)"
2016,Noviembre,Mauritania,478,0,2,,2,"(4.697144,-74.140516)"
2016,Noviembre,Martinica/Departamento de Ultramar Francés,474,1,0,,1,"(4.815061,-75.736532)"
2016,Noviembre,México,484,53,48,,101,"(10.445761,-75.516429)"
2016,Noviembre,México,484,110,99,,209,"(10.886611,-74.776708)"
2016,Noviembre,México,484,1,0,,1,"(12.586067,-81.702563)"
2016,Noviembre,México,484,836,736,,1572,"(3.541112,-76.384584)"
2016,Noviembre,México,484,14838,12739,,27577,"(4.697144,-74.140516)"
2016,Noviembre,México,484,106,77,,183,"(4.815061,-75.736532)"
2016,Noviembre,México,484,2110,1757,,3867,"(6.171601,-75.427454)"
2016,Noviembre,México,484,71,46,,117,"(7.128456,-73.183637)"
2016,Noviembre,Mónaco,492,1,0,,1,"(3.541112,-76.384584)"
2016,Noviembre,Mónaco,492,1,0,,1,"(4.697144,-74.140516)"
2016,Noviembre,Montenegro,499,1,0,,1,"(4.697144,-74.140516)"
2016,Noviembre,Mozambique,508,2,1,,3,"(4.697144,-74.140516)"
2016,Noviembre,Nepal,524,1,1,,2,"(4.697144,-74.140516)"
2016,Noviembre,Nicaragua,558,0,2,,2,"(10.445761,-75.516429)"
2016,Noviembre,Nicaragua,558,3,3,,6,"(10.886611,-74.776708)"
2016,Noviembre,Nicaragua,558,1,4,,5,"(12.586067,-81.702563)"
2016,Noviembre,Nicaragua,558,14,62,,76,"(3.541112,-76.384584)"
2016,Noviembre,Nicaragua,558,39,84,,123,"(4.697144,-74.140516)"
2016,Noviembre,Nicaragua,558,2,5,,7,"(4.815061,-75.736532)"
2016,Noviembre,Nicaragua,558,10,44,,54,"(6.171601,-75.427454)"
2016,Noviembre,Nicaragua,558,0,1,,1,"(7.128456,-73.183637)"
2016,Noviembre,Nigeria,566,0,1,,1,"(3.541112,-76.384584)"
2016,Noviembre,Nigeria,566,0,4,,4,"(4.697144,-74.140516)"
2016,Noviembre,Noruega,578,3,0,,3,"(10.886611,-74.776708)"
2016,Noviembre,Noruega,578,5,2,,7,"(3.541112,-76.384584)"
2016,Noviembre,Noruega,578,19,24,,43,"(4.697144,-74.140516)"
2016,Noviembre,Nueva Caledonia/Territorio francés,540,0,1,,1,"(6.171601,-75.427454)"
2016,Noviembre,Nueva Zelanda,554,38,20,,58,"(4.697144,-74.140516)"
2016,Noviembre,Nueva Zelanda,554,0,1,,1,"(6.171601,-75.427454)"
2016,Noviembre,Omán,512,1,3,,4,"(4.697144,-74.140516)"
2016,Noviembre,Papúa Nueva Guinea,598,1,1,,2,"(4.697144,-74.140516)"
2016,Noviembre,Panamá,591,32,102,,134,"(10.408582,-75.538003)"
2016,Noviembre,Panamá,591,598,514,,1112,"(10.445761,-75.516429)"
2016,Noviembre,Panamá,591,790,759,,1549,"(10.886611,-74.776708)"
2016,Noviembre,Panamá,591,1,3,,4,"(11.247723,-74.213989)"
2016,Noviembre,Panamá,591,179,159,,338,"(12.586067,-81.702563)"
2016,Noviembre,Panamá,591,1807,1575,,3382,"(3.541112,-76.384584)"
2016,Noviembre,Panamá,591,260,255,,515,"(4.452882,-75.766298)"
2016,Noviembre,Panamá,591,8380,8936,,17316,"(4.697144,-74.140516)"
2016,Noviembre,Panamá,591,585,477,,1062,"(4.815061,-75.736532)"
2016,Noviembre,Panamá,591,3435,3232,,6667,"(6.171601,-75.427454)"
2016,Noviembre,Panamá,591,0,3,,3,"(6.228046,-77.404104)"
2016,Noviembre,Panamá,591,17,22,,39,"(7.102626,-77.762647)"
2016,Noviembre,Panamá,591,217,203,,420,"(7.128456,-73.183637)"
2016,Noviembre,Panamá,591,0,61,,61,"(8.066966,-76.735404)"
2016,Noviembre,Panamá,591,19,48,,67,"(8.635765,-77.346578)"
2016,Noviembre,Paraguay,600,3,4,,7,"(10.445761,-75.516429)"
2016,Noviembre,Paraguay,600,1,11,,12,"(10.886611,-74.776708)"
2016,Noviembre,Paraguay,600,1,1,,2,"(12.586067,-81.702563)"
2016,Noviembre,Paraguay,600,11,26,,37,"(3.541112,-76.384584)"
2016,Noviembre,Paraguay,600,58,142,,200,"(4.697144,-74.140516)"
2016,Noviembre,Paraguay,600,8,13,,21,"(4.815061,-75.736532)"
2016,Noviembre,Paraguay,600,8,38,,46,"(6.171601,-75.427454)"
2016,Noviembre,Paraguay,600,0,2,,2,"(7.128456,-73.183637)"
2016,Noviembre,Perú,604,1,2,,3,"(-0.193180,-74.784874)"
2016,Noviembre,Perú,604,193,242,,435,"(-4.197703,-69.941278)"
2016,Noviembre,Perú,604,35,60,,95,"(0.814836,-77.662532)"
2016,Noviembre,Perú,604,1,0,,1,"(1.813928,-78.763924)"
2016,Noviembre,Perú,604,4,5,,9,"(10.445761,-75.516429)"
2016,Noviembre,Perú,604,10,21,,31,"(10.886611,-74.776708)"
2016,Noviembre,Perú,604,1,3,,4,"(12.586067,-81.702563)"
2016,Noviembre,Perú,604,254,294,,548,"(3.541112,-76.384584)"
2016,Noviembre,Perú,604,5913,6554,,12467,"(4.697144,-74.140516)"
2016,Noviembre,Perú,604,9,9,,18,"(4.815061,-75.736532)"
2016,Noviembre,Perú,604,393,485,,878,"(6.171601,-75.427454)"
2016,Noviembre,Perú,604,1,2,,3,"(7.128456,-73.183637)"
2016,Noviembre,Palestina,99999,1,0,,1,"(4.697144,-74.140516)"
2016,Noviembre,Polonia,616,0,1,,1,"(3.541112,-76.384584)"
2016,Noviembre,Polonia,616,6,15,,21,"(4.697144,-74.140516)"
2016,Noviembre,Polonia,616,1,1,,2,"(6.171601,-75.427454)"
2016,Noviembre,Portugal,620,0,1,,1,"(10.886611,-74.776708)"
2016,Noviembre,Portugal,620,10,8,,18,"(3.541112,-76.384584)"
2016,Noviembre,Portugal,620,86,136,,222,"(4.697144,-74.140516)"
2016,Noviembre,Portugal,620,1,0,,1,"(4.815061,-75.736532)"
2016,Noviembre,Portugal,620,7,1,,8,"(6.171601,-75.427454)"
2016,Noviembre,Puerto Rico/Territorio de Estados Unidos,630,9,12,,21,"(10.445761,-75.516429)"
2016,Noviembre,Puerto Rico/Territorio de Estados Unidos,630,22,22,,44,"(10.886611,-74.776708)"
2016,Noviembre,Puerto Rico/Territorio de Estados Unidos,630,53,59,,112,"(3.541112,-76.384584)"
2016,Noviembre,Puerto Rico/Territorio de Estados Unidos,630,764,634,,1398,"(4.697144,-74.140516)"
2016,Noviembre,Puerto Rico/Territorio de Estados Unidos,630,13,4,,17,"(4.815061,-75.736532)"
2016,Noviembre,Puerto Rico/Territorio de Estados Unidos,630,44,47,,91,"(6.171601,-75.427454)"
2016,Noviembre,Puerto Rico/Territorio de Estados Unidos,630,3,2,,5,"(7.128456,-73.183637)"
2016,Noviembre,Qatar,634,1,3,,4,"(4.697144,-74.140516)"
2016,Noviembre,Qatar,634,1,0,,1,"(6.171601,-75.427454)"
2016,Noviembre,Reino Unido de Gran Bretaña e Irlanda del Norte,826,1,0,,1,"(10.886611,-74.776708)"
2016,Noviembre,Reino Unido de Gran Bretaña e Irlanda del Norte,826,3,7,,10,"(11.117806,-74.232622)"
2016,Noviembre,Reino Unido de Gran Bretaña e Irlanda del Norte,826,0,1,,1,"(12.586067,-81.702563)"
2016,Noviembre,Reino Unido de Gran Bretaña e Irlanda del Norte,826,17,15,,32,"(3.541112,-76.384584)"
2016,Noviembre,Reino Unido de Gran Bretaña e Irlanda del Norte,826,1138,976,,2114,"(4.697144,-74.140516)"
2016,Noviembre,Reino Unido de Gran Bretaña e Irlanda del Norte,826,11,5,,16,"(6.171601,-75.427454)"
2016,Noviembre,República CentroÁfricana,140,1,1,,2,"(4.697144,-74.140516)"
2016,Noviembre,República CentroÁfricana,140,0,1,,1,"(6.171601,-75.427454)"
2016,Noviembre,Federación de Rusia,643,0,8,,8,"(10.886611,-74.776708)"
2016,Noviembre,Federación de Rusia,643,1,1,,2,"(3.541112,-76.384584)"
2016,Noviembre,Federación de Rusia,643,14,25,,39,"(4.697144,-74.140516)"
2016,Noviembre,Federación de Rusia,643,0,1,,1,"(6.171601,-75.427454)"
2016,Noviembre,República Dominicana,214,1,0,,1,"(10.408582,-75.538003)"
2016,Noviembre,República Dominicana,214,10,20,,30,"(10.445761,-75.516429)"
2016,Noviembre,República Dominicana,214,27,35,,62,"(10.886611,-74.776708)"
2016,Noviembre,República Dominicana,214,2,0,,2,"(12.586067,-81.702563)"
2016,Noviembre,República Dominicana,214,82,94,,176,"(3.541112,-76.384584)"
2016,Noviembre,República Dominicana,214,3475,2880,,6355,"(4.697144,-74.140516)"
2016,Noviembre,República Dominicana,214,59,41,,100,"(4.815061,-75.736532)"
2016,Noviembre,República Dominicana,214,263,199,,462,"(6.171601,-75.427454)"
2016,Noviembre,República Dominicana,214,41,29,,70,"(7.128456,-73.183637)"
2016,Noviembre,República Democrática Popular de Corea,408,1,1,,2,"(4.697144,-74.140516)"
2016,Noviembre,Rumania,642,0,3,,3,"(4.697144,-74.140516)"
2016,Noviembre,Santa Lucia,662,1,1,,2,"(4.697144,-74.140516)"
2016,Noviembre,Singapur,702,1,1,,2,"(3.541112,-76.384584)"
2016,Noviembre,Singapur,702,11,10,,21,"(4.697144,-74.140516)"
2016,Noviembre,Sudáfrica,710,13,10,,23,"(4.697144,-74.140516)"
2016,Noviembre,Sudáfrica,710,1,0,,1,"(6.171601,-75.427454)"
2016,Noviembre,Suecia,752,1,1,,2,"(10.886611,-74.776708)"
2016,Noviembre,Suecia,752,11,8,,19,"(3.541112,-76.384584)"
2016,Noviembre,Suecia,752,56,53,,109,"(4.697144,-74.140516)"
2016,Noviembre,Suecia,752,6,1,,7,"(6.171601,-75.427454)"
2016,Noviembre,Suiza,756,48,27,,75,"(3.541112,-76.384584)"
2016,Noviembre,Suiza,756,158,119,,277,"(4.697144,-74.140516)"
2016,Noviembre,Suiza,756,15,13,,28,"(6.171601,-75.427454)"
2016,Noviembre,Surinam,740,1,3,,4,"(10.886611,-74.776708)"
2016,Noviembre,Surinam,740,1,5,,6,"(4.697144,-74.140516)"
2016,Noviembre,Surinam,740,0,1,,1,"(6.171601,-75.427454)"
2016,Noviembre,Tailandia,764,3,3,,6,"(3.541112,-76.384584)"
2016,Noviembre,Tailandia,764,65,46,,111,"(4.697144,-74.140516)"
2016,Noviembre,Tailandia,764,5,2,,7,"(6.171601,-75.427454)"
2016,Noviembre,Tanzania,834,2,2,,4,"(4.697144,-74.140516)"
2016,Noviembre,Tanzania,834,1,0,,1,"(6.171601,-75.427454)"
2016,Noviembre,República Democrática de Timor Oriental,626,1,0,,1,"(4.697144,-74.140516)"
2016,Noviembre,Trinidad y Tobago,780,1,0,,1,"(10.445761,-75.516429)"
2016,Noviembre,Trinidad y Tobago,780,1,4,,5,"(10.886611,-74.776708)"
2016,Noviembre,Trinidad y Tobago,780,4,11,,15,"(3.541112,-76.384584)"
2016,Noviembre,Trinidad y Tobago,780,14,25,,39,"(4.697144,-74.140516)"
2016,Noviembre,Trinidad y Tobago,780,2,8,,10,"(4.815061,-75.736532)"
2016,Noviembre,Trinidad y Tobago,780,10,21,,31,"(6.171601,-75.427454)"
2016,Noviembre,Trinidad y Tobago,780,1,0,,1,"(7.128456,-73.183637)"
2016,Noviembre,Turquía,792,1,2,,3,"(3.541112,-76.384584)"
2016,Noviembre,Turquía,792,131,114,,245,"(4.697144,-74.140516)"
2016,Noviembre,Turkmenistán,795,1,0,,1,"(4.697144,-74.140516)"
2016,Noviembre,Ucrania,804,1,0,,1,"(4.697144,-74.140516)"
2016,Noviembre,Uruguay,858,0,1,,1,"(10.445761,-75.516429)"
2016,Noviembre,Uruguay,858,1,2,,3,"(10.886611,-74.776708)"
2016,Noviembre,Uruguay,858,12,23,,35,"(3.541112,-76.384584)"
2016,Noviembre,Uruguay,858,148,173,,321,"(4.697144,-74.140516)"
2016,Noviembre,Uruguay,858,2,5,,7,"(4.815061,-75.736532)"
2016,Noviembre,Uruguay,858,35,34,,69,"(6.171601,-75.427454)"
2016,Noviembre,Uruguay,858,0,1,,1,"(7.128456,-73.183637)"
2016,Noviembre,Venezuela,862,4,5,,9,"(10.445761,-75.516429)"
2016,Noviembre,Venezuela,862,8,31,,39,"(10.886611,-74.776708)"
2016,Noviembre,Venezuela,862,1,4,,5,"(11.117806,-74.232622)"
2016,Noviembre,Venezuela,862,2630,2415,,5045,"(11.360009,-72.129330)"
2016,Noviembre,Venezuela,862,1,1,,2,"(12.586067,-81.702563)"
2016,Noviembre,Venezuela,862,8,18,,26,"(3.541112,-76.384584)"
2016,Noviembre,Venezuela,862,10,12,,22,"(3.866713,-67.927521)"
2016,Noviembre,Venezuela,862,1379,1533,,2912,"(4.697144,-74.140516)"
2016,Noviembre,Venezuela,862,4,3,,7,"(4.815061,-75.736532)"
2016,Noviembre,Venezuela,862,288,333,,621,"(6.171601,-75.427454)"
2016,Noviembre,Venezuela,862,107,129,,236,"(6.185799,-67.483929)"
2016,Noviembre,Venezuela,862,858,718,,1576,"(7.088729,-70.740253)"
2016,Noviembre,Venezuela,862,1,4,,5,"(7.128456,-73.183637)"
2016,Noviembre,Venezuela,862,2690,2577,,5267,"(7.818934,-72.453226)"
2016,Noviembre,Venezuela,862,14,13,,27,"(8.36068,-72.409396)"
2016,Noviembre,Vietnam,704,4,0,,4,"(3.541112,-76.384584)"
2016,Noviembre,Vietnam,704,5,8,,13,"(4.697144,-74.140516)"
2016,Noviembre,Vietnam,704,1,1,,2,"(6.171601,-75.427454)"
2016,Diciembre,Afganistán,4,0,5,,5,"(4.697144,-74.140516)"
2016,Diciembre,Albania,8,0,5,,5,"(4.697144,-74.140516)"
2016,Diciembre,Alemania,276,1,0,,1,"(0.814836,-77.662532)"
2016,Diciembre,Alemania,276,1,3,,4,"(10.445761,-75.516429)"
2016,Diciembre,Alemania,276,15,8,,23,"(10.886611,-74.776708)"
2016,Diciembre,Alemania,276,103,60,,163,"(3.541112,-76.384584)"
2016,Diciembre,Alemania,276,1095,916,,2011,"(4.697144,-74.140516)"
2016,Diciembre,Alemania,276,3,3,,6,"(4.815061,-75.736532)"
2016,Diciembre,Alemania,276,66,55,,121,"(6.171601,-75.427454)"
2016,Diciembre,Andorra,20,0,1,,1,"(4.697144,-74.140516)"
2016,Diciembre,Angola,24,2,6,,8,"(4.697144,-74.140516)"
2016,Diciembre,Antigua y Barbuda,28,2,1,,3,"(4.697144,-74.140516)"
2016,Diciembre,Países Bajos,528,0,7,,7,"(10.408582,-75.538003)"
2016,Diciembre,Países Bajos,528,3,2,,5,"(10.445761,-75.516429)"
2016,Diciembre,Países Bajos,528,211,160,,371,"(10.886611,-74.776708)"
2016,Diciembre,Países Bajos,528,162,88,,250,"(3.541112,-76.384584)"
2016,Diciembre,Países Bajos,528,947,785,,1732,"(4.697144,-74.140516)"
2016,Diciembre,Países Bajos,528,5,0,,5,"(4.815061,-75.736532)"
2016,Diciembre,Países Bajos,528,282,207,,489,"(6.171601,-75.427454)"
2016,Diciembre,Países Bajos,528,3,6,,9,"(7.128456,-73.183637)"
2016,Diciembre,Arabia Saudita,682,8,19,,27,"(4.697144,-74.140516)"
2016,Diciembre,Argelia,12,3,3,,6,"(4.697144,-74.140516)"
2016,Diciembre,Argentina,32,1,1,,2,"(0.25129,-76.875963)"
2016,Diciembre,Argentina,32,9,16,,25,"(0.814836,-77.662532)"
2016,Diciembre,Argentina,32,11,1,,12,"(10.445761,-75.516429)"
2016,Diciembre,Argentina,32,6,6,,12,"(10.886611,-74.776708)"
2016,Diciembre,Argentina,32,2,1,,3,"(12.586067,-81.702563)"
2016,Diciembre,Argentina,32,169,149,,318,"(3.541112,-76.384584)"
2016,Diciembre,Argentina,32,4168,3325,,7493,"(4.697144,-74.140516)"
2016,Diciembre,Argentina,32,6,8,,14,"(4.815061,-75.736532)"
2016,Diciembre,Argentina,32,142,110,,252,"(6.171601,-75.427454)"
2016,Diciembre,Argentina,32,6,3,,9,"(7.128456,-73.183637)"
2016,Diciembre,República de Armenia,51,2,0,,2,"(6.171601,-75.427454)"
2016,Diciembre,Aruba,533,1,0,,1,"(10.408582,-75.538003)"
2016,Diciembre,Aruba,533,2,1,,3,"(10.445761,-75.516429)"
2016,Diciembre,Aruba,533,81,50,,131,"(10.886611,-74.776708)"
2016,Diciembre,Aruba,533,5,6,,11,"(11.117806,-74.232622)"
2016,Diciembre,Aruba,533,0,3,,3,"(11.247723,-74.213989)"
2016,Diciembre,Aruba,533,106,79,,185,"(3.541112,-76.384584)"
2016,Diciembre,Aruba,533,2464,1930,,4394,"(4.697144,-74.140516)"
2016,Diciembre,Aruba,533,30,18,,48,"(4.815061,-75.736532)"
2016,Diciembre,Aruba,533,173,110,,283,"(6.171601,-75.427454)"
2016,Diciembre,Aruba,533,21,50,,71,"(7.128456,-73.183637)"
2016,Diciembre,Australia,36,1,1,,2,"(10.445761,-75.516429)"
2016,Diciembre,Australia,36,1,2,,3,"(10.886611,-74.776708)"
2016,Diciembre,Australia,36,21,12,,33,"(3.541112,-76.384584)"
2016,Diciembre,Australia,36,289,191,,480,"(4.697144,-74.140516)"
2016,Diciembre,Australia,36,1,0,,1,"(4.815061,-75.736532)"
2016,Diciembre,Australia,36,41,29,,70,"(6.171601,-75.427454)"
2016,Diciembre,Australia,36,1,1,,2,"(7.128456,-73.183637)"
2016,Diciembre,Austria,40,1,2,,3,"(10.445761,-75.516429)"
2016,Diciembre,Austria,40,0,1,,1,"(10.886611,-74.776708)"
2016,Diciembre,Austria,40,3,3,,6,"(3.541112,-76.384584)"
2016,Diciembre,Austria,40,33,31,,64,"(4.697144,-74.140516)"
2016,Diciembre,Austria,40,7,4,,11,"(6.171601,-75.427454)"
2016,Diciembre,Azerbaiyán,31,1,4,,5,"(4.697144,-74.140516)"
2016,Diciembre,Bahamas,44,8,3,,11,"(10.886611,-74.776708)"
2016,Diciembre,Bahamas,44,0,1,,1,"(12.586067,-81.702563)"
2016,Diciembre,Bahamas,44,17,8,,25,"(3.541112,-76.384584)"
2016,Diciembre,Bahamas,44,150,147,,297,"(4.697144,-74.140516)"
2016,Diciembre,Bahamas,44,3,1,,4,"(4.815061,-75.736532)"
2016,Diciembre,Bahamas,44,17,10,,27,"(6.171601,-75.427454)"
2016,Diciembre,Bahréin,48,1,0,,1,"(10.445761,-75.516429)"
2016,Diciembre,Bahréin,48,3,1,,4,"(4.697144,-74.140516)"
2016,Diciembre,Bahréin,48,1,4,,5,"(6.171601,-75.427454)"
2016,Diciembre,Bangladesh,50,1,0,,1,"(10.886611,-74.776708)"
2016,Diciembre,Bangladesh,50,1,2,,3,"(3.541112,-76.384584)"
2016,Diciembre,Bangladesh,50,0,1,,1,"(4.697144,-74.140516)"
2016,Diciembre,Barbados,52,138,132,,270,"(4.697144,-74.140516)"
2016,Diciembre,Barbados,52,2,0,,2,"(6.171601,-75.427454)"
2016,Diciembre,República de Belarús,112,0,1,,1,"(11.360009,-72.129330)"
2016,Diciembre,República de Belarús,112,1,1,,2,"(4.697144,-74.140516)"
2016,Diciembre,Bélgica,56,1,0,,1,"(10.445761,-75.516429)"
2016,Diciembre,Bélgica,56,1,1,,2,"(10.886611,-74.776708)"
2016,Diciembre,Bélgica,56,18,11,,29,"(3.541112,-76.384584)"
2016,Diciembre,Bélgica,56,94,51,,145,"(4.697144,-74.140516)"
2016,Diciembre,Bélgica,56,28,15,,43,"(6.171601,-75.427454)"
2016,Diciembre,Belice,84,4,2,,6,"(3.541112,-76.384584)"
2016,Diciembre,Belice,84,12,15,,27,"(4.697144,-74.140516)"
2016,Diciembre,Belice,84,1,0,,1,"(4.815061,-75.736532)"
2016,Diciembre,Belice,84,2,2,,4,"(6.171601,-75.427454)"
2016,Diciembre,Benín,204,0,1,,1,"(4.697144,-74.140516)"
2016,Diciembre,Bermudas/Territorio Británico de Ultramar,60,1,2,,3,"(4.697144,-74.140516)"
2016,Diciembre,Bermudas/Territorio Británico de Ultramar,60,2,2,,4,"(6.171601,-75.427454)"
2016,Diciembre,Bolivia,68,0,8,,8,"(0.814836,-77.662532)"
2016,Diciembre,Bolivia,68,0,2,,2,"(10.445761,-75.516429)"
2016,Diciembre,Bolivia,68,0,1,,1,"(10.886611,-74.776708)"
2016,Diciembre,Bolivia,68,24,30,,54,"(3.541112,-76.384584)"
2016,Diciembre,Bolivia,68,320,362,,682,"(4.697144,-74.140516)"
2016,Diciembre,Bolivia,68,3,4,,7,"(4.815061,-75.736532)"
2016,Diciembre,Bolivia,68,20,29,,49,"(6.171601,-75.427454)"
2016,Diciembre,Bolivia,68,0,1,,1,"(7.128456,-73.183637)"
2016,Diciembre,Bosnia y Herzegovina,70,1,1,,2,"(4.697144,-74.140516)"
2016,Diciembre,Brasil,76,182,203,,385,"(-4.197703,-69.941278)"
2016,Diciembre,Brasil,76,1,0,,1,"(0.814836,-77.662532)"
2016,Diciembre,Brasil,76,7,9,,16,"(10.445761,-75.516429)"
2016,Diciembre,Brasil,76,7,5,,12,"(10.886611,-74.776708)"
2016,Diciembre,Brasil,76,0,1,,1,"(12.586067,-81.702563)"
2016,Diciembre,Brasil,76,122,117,,239,"(3.541112,-76.384584)"
2016,Diciembre,Brasil,76,3192,3061,,6253,"(4.697144,-74.140516)"
2016,Diciembre,Brasil,76,15,18,,33,"(4.815061,-75.736532)"
2016,Diciembre,Brasil,76,139,151,,290,"(6.171601,-75.427454)"
2016,Diciembre,Brasil,76,1,0,,1,"(7.128456,-73.183637)"
2016,Diciembre,Bulgaria,100,0,2,,2,"(4.697144,-74.140516)"
2016,Diciembre,Burundi,108,1,0,,1,"(4.697144,-74.140516)"
2016,Diciembre,Cabo Verde,132,0,2,,2,"(4.697144,-74.140516)"
2016,Diciembre,Islas Caimán/Territorio Británico de Ultramar,136,1,1,,2,"(10.445761,-75.516429)"
2016,Diciembre,Islas Caimán/Territorio Británico de Ultramar,136,1,0,,1,"(10.886611,-74.776708)"
2016,Diciembre,Islas Caimán/Territorio Británico de Ultramar,136,90,77,,167,"(12.586067,-81.702563)"
2016,Diciembre,Islas Caimán/Territorio Británico de Ultramar,136,2,0,,2,"(4.697144,-74.140516)"
2016,Diciembre,Islas Caimán/Territorio Británico de Ultramar,136,2,0,,2,"(6.171601,-75.427454)"
2016,Diciembre,Camboya,116,1,0,,1,"(3.541112,-76.384584)"
2016,Diciembre,Camerún,120,0,2,,2,"(4.697144,-74.140516)"
2016,Diciembre,Canadá,124,28,21,,49,"(10.445761,-75.516429)"
2016,Diciembre,Canadá,124,28,27,,55,"(10.886611,-74.776708)"
2016,Diciembre,Canadá,124,4,2,,6,"(12.586067,-81.702563)"
2016,Diciembre,Canadá,124,106,66,,172,"(3.541112,-76.384584)"
2016,Diciembre,Canadá,124,1,0,,1,"(4.452882,-75.766298)"
2016,Diciembre,Canadá,124,1670,1302,,2972,"(4.697144,-74.140516)"
2016,Diciembre,Canadá,124,6,3,,9,"(4.815061,-75.736532)"
2016,Diciembre,Canadá,124,229,175,,404,"(6.171601,-75.427454)"
2016,Diciembre,Canadá,124,6,5,,11,"(7.128456,-73.183637)"
2016,Diciembre,España,724,1,0,,1,"(0.814836,-77.662532)"
2016,Diciembre,España,724,1,1,,2,"(10.445761,-75.516429)"
2016,Diciembre,España,724,12,11,,23,"(10.886611,-74.776708)"
2016,Diciembre,España,724,3816,2645,,6461,"(3.541112,-76.384584)"
2016,Diciembre,España,724,12349,9570,,21919,"(4.697144,-74.140516)"
2016,Diciembre,España,724,4,3,,7,"(4.815061,-75.736532)"
2016,Diciembre,España,724,1649,1267,,2916,"(6.171601,-75.427454)"
2016,Diciembre,España,724,4,2,,6,"(7.128456,-73.183637)"
2016,Diciembre,Colombia,170,0,1,,1,"(0.25129,-76.875963)"
2016,Diciembre,Colombia,170,0,5,,5,"(10.445761,-75.516429)"
2016,Diciembre,Colombia,170,102,305,,407,"(4.697144,-74.140516)"
2016,Diciembre,República Del Congo,178,0,1,,1,"(4.697144,-74.140516)"
2016,Diciembre,República Democrática del Congo,180,0,3,,3,"(4.697144,-74.140516)"
2016,Diciembre,República de Corea,410,0,1,,1,"(3.541112,-76.384584)"
2016,Diciembre,República de Corea,410,12,7,,19,"(4.697144,-74.140516)"
2016,Diciembre,República de Corea,410,1,1,,2,"(6.171601,-75.427454)"
2016,Diciembre,Costa de Marfil,384,1,1,,2,"(3.541112,-76.384584)"
2016,Diciembre,Costa de Marfil,384,1,4,,5,"(4.697144,-74.140516)"
2016,Diciembre,Costa de Marfil,384,0,1,,1,"(4.815061,-75.736532)"
2016,Diciembre,Costa de Marfil,384,1,0,,1,"(6.171601,-75.427454)"
2016,Diciembre,Costa Rica,188,9,7,,16,"(10.445761,-75.516429)"
2016,Diciembre,Costa Rica,188,10,17,,27,"(10.886611,-74.776708)"
2016,Diciembre,Costa Rica,188,6,49,,55,"(12.5744111,-81.703935)"
2016,Diciembre,Costa Rica,188,19,10,,29,"(12.586067,-81.702563)"
2016,Diciembre,Costa Rica,188,30,37,,67,"(3.541112,-76.384584)"
2016,Diciembre,Costa Rica,188,1220,1116,,2336,"(4.697144,-74.140516)"
2016,Diciembre,Costa Rica,188,26,12,,38,"(4.815061,-75.736532)"
2016,Diciembre,Costa Rica,188,96,77,,173,"(6.171601,-75.427454)"
2016,Diciembre,Costa Rica,188,8,2,,10,"(7.128456,-73.183637)"
2016,Diciembre,Croacia,191,2,0,,2,"(4.697144,-74.140516)"
2016,Diciembre,Cuba,192,0,1,,1,"(0.814836,-77.662532)"
2016,Diciembre,Cuba,192,0,1,,1,"(10.408582,-75.538003)"
2016,Diciembre,Cuba,192,24,11,,35,"(10.445761,-75.516429)"
2016,Diciembre,Cuba,192,18,26,,44,"(10.886611,-74.776708)"
2016,Diciembre,Cuba,192,3,1,,4,"(12.586067,-81.702563)"
2016,Diciembre,Cuba,192,52,48,,100,"(3.541112,-76.384584)"
2016,Diciembre,Cuba,192,1789,1572,,3361,"(4.697144,-74.140516)"
2016,Diciembre,Cuba,192,8,7,,15,"(4.815061,-75.736532)"
2016,Diciembre,Cuba,192,168,119,,287,"(6.171601,-75.427454)"
2016,Diciembre,Cuba,192,5,4,,9,"(7.128456,-73.183637)"
2016,Diciembre,Curazao,99999,9,39,,48,"(4.697144,-74.140516)"
2016,Diciembre,República Checa,203,4,2,,6,"(4.697144,-74.140516)"
2016,Diciembre,Chile,152,1,0,,1,"(0.25129,-76.875963)"
2016,Diciembre,Chile,152,120,136,,256,"(0.814836,-77.662532)"
2016,Diciembre,Chile,152,7,78,,85,"(10.408582,-75.538003)"
2016,Diciembre,Chile,152,34,22,,56,"(10.445761,-75.516429)"
2016,Diciembre,Chile,152,56,26,,82,"(10.886611,-74.776708)"
2016,Diciembre,Chile,152,6,3,,9,"(12.586067,-81.702563)"
2016,Diciembre,Chile,152,482,301,,783,"(3.541112,-76.384584)"
2016,Diciembre,Chile,152,6390,4687,,11077,"(4.697144,-74.140516)"
2016,Diciembre,Chile,152,112,60,,172,"(4.815061,-75.736532)"
2016,Diciembre,Chile,152,194,151,,345,"(6.171601,-75.427454)"
2016,Diciembre,Chile,152,13,11,,24,"(7.128456,-73.183637)"
2016,Diciembre,China,156,1,1,,2,"(10.886611,-74.776708)"
2016,Diciembre,China,156,4,8,,12,"(3.541112,-76.384584)"
2016,Diciembre,China,156,76,134,,210,"(4.697144,-74.140516)"
2016,Diciembre,China,156,7,12,,19,"(6.171601,-75.427454)"
2016,Diciembre,Chipre,196,0,2,,2,"(4.697144,-74.140516)"
2016,Diciembre,Dinamarca,208,1,0,,1,"(10.886611,-74.776708)"
2016,Diciembre,Dinamarca,208,4,1,,5,"(3.541112,-76.384584)"
2016,Diciembre,Dinamarca,208,15,10,,25,"(4.697144,-74.140516)"
2016,Diciembre,Dinamarca,208,1,0,,1,"(6.171601,-75.427454)"
2016,Diciembre,Ecuador,218,7,5,,12,"(-0.193180,-74.784874)"
2016,Diciembre,Ecuador,218,737,902,,1639,"(0.25129,-76.875963)"
2016,Diciembre,Ecuador,218,38,28,,66,"(0.812436,-77.847006)"
2016,Diciembre,Ecuador,218,8213,8269,,16482,"(0.814836,-77.662532)"
2016,Diciembre,Ecuador,218,194,217,,411,"(1.813928,-78.763924)"
2016,Diciembre,Ecuador,218,0,13,,13,"(10.408582,-75.538003)"
2016,Diciembre,Ecuador,218,1,2,,3,"(10.445761,-75.516429)"
2016,Diciembre,Ecuador,218,3,3,,6,"(10.886611,-74.776708)"
2016,Diciembre,Ecuador,218,1,2,,3,"(12.586067,-81.702563)"
2016,Diciembre,Ecuador,218,429,355,,784,"(3.541112,-76.384584)"
2016,Diciembre,Ecuador,218,3990,4491,,8481,"(4.697144,-74.140516)"
2016,Diciembre,Ecuador,218,27,35,,62,"(6.171601,-75.427454)"
2016,Diciembre,Ecuador,218,3,1,,4,"(7.128456,-73.183637)"
2016,Diciembre,Egipto,818,1,0,,1,"(10.886611,-74.776708)"
2016,Diciembre,Egipto,818,0,2,,2,"(3.541112,-76.384584)"
2016,Diciembre,Egipto,818,37,26,,63,"(4.697144,-74.140516)"
2016,Diciembre,Egipto,818,1,2,,3,"(6.171601,-75.427454)"
2016,Diciembre,El Salvador,222,2,1,,3,"(10.445761,-75.516429)"
2016,Diciembre,El Salvador,222,2,1,,3,"(10.886611,-74.776708)"
2016,Diciembre,El Salvador,222,137,103,,240,"(3.541112,-76.384584)"
2016,Diciembre,El Salvador,222,1023,1056,,2079,"(4.697144,-74.140516)"
2016,Diciembre,El Salvador,222,1,3,,4,"(4.815061,-75.736532)"
2016,Diciembre,El Salvador,222,72,74,,146,"(6.171601,-75.427454)"
2016,Diciembre,Emiratos Árabes,784,6,0,,6,"(3.541112,-76.384584)"
2016,Diciembre,Emiratos Árabes,784,128,164,,292,"(4.697144,-74.140516)"
2016,Diciembre,Emiratos Árabes,784,5,1,,6,"(4.815061,-75.736532)"
2016,Diciembre,Emiratos Árabes,784,10,7,,17,"(6.171601,-75.427454)"
2016,Diciembre,Eritrea,232,1,0,,1,"(4.697144,-74.140516)"
2016,Diciembre,Eslovaquia,703,2,2,,4,"(4.697144,-74.140516)"
2016,Diciembre,Eslovenia,705,3,2,,5,"(4.697144,-74.140516)"
2016,Diciembre,Estados Unidos de América,840,5405,4287,,9692,"(10.445761,-75.516429)"
2016,Diciembre,Estados Unidos de América,840,3809,3019,,6828,"(10.886611,-74.776708)"
2016,Diciembre,Estados Unidos de América,840,0,2,,2,"(11.117806,-74.232622)"
2016,Diciembre,Estados Unidos de América,840,99,61,,160,"(12.586067,-81.702563)"
2016,Diciembre,Estados Unidos de América,840,7590,5500,,13090,"(3.541112,-76.384584)"
2016,Diciembre,Estados Unidos de América,840,688,472,,1160,"(4.452882,-75.766298)"
2016,Diciembre,Estados Unidos de América,840,42062,34202,,76264,"(4.697144,-74.140516)"
2016,Diciembre,Estados Unidos de América,840,1002,629,,1631,"(4.815061,-75.736532)"
2016,Diciembre,Estados Unidos de América,840,12856,9975,,22831,"(6.171601,-75.427454)"
2016,Diciembre,Estados Unidos de América,840,367,255,,622,"(7.128456,-73.183637)"
2016,Diciembre,Etiopia,231,0,3,,3,"(4.697144,-74.140516)"
2016,Diciembre,Filipinas,608,1,1,,2,"(3.541112,-76.384584)"
2016,Diciembre,Filipinas,608,1,1,,2,"(4.697144,-74.140516)"
2016,Diciembre,Filipinas,608,1,0,,1,"(6.171601,-75.427454)"
2016,Diciembre,Finlandia,246,2,0,,2,"(3.541112,-76.384584)"
2016,Diciembre,Finlandia,246,22,6,,28,"(4.697144,-74.140516)"
2016,Diciembre,Francia,250,1,1,,2,"(10.445761,-75.516429)"
2016,Diciembre,Francia,250,9,5,,14,"(10.886611,-74.776708)"
2016,Diciembre,Francia,250,142,86,,228,"(3.541112,-76.384584)"
2016,Diciembre,Francia,250,2054,1539,,3593,"(4.697144,-74.140516)"
2016,Diciembre,Francia,250,7,4,,11,"(4.815061,-75.736532)"
2016,Diciembre,Francia,250,68,45,,113,"(6.171601,-75.427454)"
2016,Diciembre,Georgia,268,0,1,,1,"(4.697144,-74.140516)"
2016,Diciembre,Ghana,288,0,1,,1,"(3.541112,-76.384584)"
2016,Diciembre,Gibraltar/Territorio Británico de Ultramar,292,5,6,,11,"(0.814836,-77.662532)"
2016,Diciembre,Grecia,300,3,2,,5,"(3.541112,-76.384584)"
2016,Diciembre,Grecia,300,7,4,,11,"(4.697144,-74.140516)"
2016,Diciembre,Grecia,300,1,1,,2,"(6.171601,-75.427454)"
2016,Diciembre,Guatemala,320,4,6,,10,"(10.445761,-75.516429)"
2016,Diciembre,Guatemala,320,3,8,,11,"(10.886611,-74.776708)"
2016,Diciembre,Guatemala,320,2,1,,3,"(12.586067,-81.702563)"
2016,Diciembre,Guatemala,320,56,67,,123,"(3.541112,-76.384584)"
2016,Diciembre,Guatemala,320,608,540,,1148,"(4.697144,-74.140516)"
2016,Diciembre,Guatemala,320,5,3,,8,"(4.815061,-75.736532)"
2016,Diciembre,Guatemala,320,109,96,,205,"(6.171601,-75.427454)"
2016,Diciembre,Guatemala,320,13,12,,25,"(7.128456,-73.183637)"
2016,Diciembre,Guyana,328,1,3,,4,"(10.886611,-74.776708)"
2016,Diciembre,Guyana,328,2,1,,3,"(3.541112,-76.384584)"
2016,Diciembre,Guyana,328,1,2,,3,"(4.697144,-74.140516)"
2016,Diciembre,Guinea,324,1,0,,1,"(4.697144,-74.140516)"
2016,Diciembre,Guinea Ecuatorial,226,1,0,,1,"(3.541112,-76.384584)"
2016,Diciembre,Guadalupe/Territorio Francés,312,0,2,,2,"(4.697144,-74.140516)"
2016,Diciembre,Guadalupe/Territorio Francés,312,1,0,,1,"(4.815061,-75.736532)"
2016,Diciembre,Guayana Francesa/Departamento de Ultramar Francés,254,0,1,,1,"(10.445761,-75.516429)"
2016,Diciembre,Guayana Francesa/Departamento de Ultramar Francés,254,0,1,,1,"(3.541112,-76.384584)"
2016,Diciembre,Guayana Francesa/Departamento de Ultramar Francés,254,1,0,,1,"(4.697144,-74.140516)"
2016,Diciembre,Haití,332,1,2,,3,"(10.445761,-75.516429)"
2016,Diciembre,Haití,332,0,2,,2,"(10.886611,-74.776708)"
2016,Diciembre,Haití,332,7,7,,14,"(4.697144,-74.140516)"
2016,Diciembre,Haití,332,1,6,,7,"(6.171601,-75.427454)"
2016,Diciembre,Honduras,340,4,5,,9,"(10.445761,-75.516429)"
2016,Diciembre,Honduras,340,0,3,,3,"(10.886611,-74.776708)"
2016,Diciembre,Honduras,340,14,17,,31,"(3.541112,-76.384584)"
2016,Diciembre,Honduras,340,94,126,,220,"(4.697144,-74.140516)"
2016,Diciembre,Honduras,340,9,2,,11,"(4.815061,-75.736532)"
2016,Diciembre,Honduras,340,40,64,,104,"(6.171601,-75.427454)"
2016,Diciembre,Honduras,340,1,1,,2,"(7.128456,-73.183637)"
2016,Diciembre,Hong Kong,344,1,1,,2,"(3.541112,-76.384584)"
2016,Diciembre,Hong Kong,344,13,20,,33,"(4.697144,-74.140516)"
2016,Diciembre,Hungría,348,0,1,,1,"(3.541112,-76.384584)"
2016,Diciembre,Hungría,348,6,9,,15,"(4.697144,-74.140516)"
2016,Diciembre,Hungría,348,0,1,,1,"(6.171601,-75.427454)"
2016,Diciembre,India,356,8,8,,16,"(3.541112,-76.384584)"
2016,Diciembre,India,356,45,36,,81,"(4.697144,-74.140516)"
2016,Diciembre,India,356,7,13,,20,"(6.171601,-75.427454)"
2016,Diciembre,Indonesia,360,0,1,,1,"(3.541112,-76.384584)"
2016,Diciembre,Indonesia,360,3,0,,3,"(4.697144,-74.140516)"
2016,Diciembre,Indonesia,360,2,2,,4,"(6.171601,-75.427454)"
2016,Diciembre,Iraq,368,0,1,,1,"(4.697144,-74.140516)"
2016,Diciembre,Irán,364,6,5,,11,"(4.697144,-74.140516)"
2016,Diciembre,República de Irlanda,372,1,0,,1,"(10.886611,-74.776708)"
2016,Diciembre,República de Irlanda,372,0,1,,1,"(3.541112,-76.384584)"
2016,Diciembre,República de Irlanda,372,19,4,,23,"(4.697144,-74.140516)"
2016,Diciembre,República de Irlanda,372,1,0,,1,"(6.171601,-75.427454)"
2016,Diciembre,Islandia,352,1,1,,2,"(6.171601,-75.427454)"
2016,Diciembre,Islas Pitcairn/Territorio Británico de Ultramar,612,1,0,,1,"(10.408582,-75.538003)"
2016,Diciembre,Israel,376,2,2,,4,"(10.886611,-74.776708)"
2016,Diciembre,Israel,376,9,9,,18,"(3.541112,-76.384584)"
2016,Diciembre,Israel,376,169,182,,351,"(4.697144,-74.140516)"
2016,Diciembre,Israel,376,0,1,,1,"(4.815061,-75.736532)"
2016,Diciembre,Israel,376,4,3,,7,"(6.171601,-75.427454)"
2016,Diciembre,Italia,380,1,0,,1,"(10.445761,-75.516429)"
2016,Diciembre,Italia,380,13,6,,19,"(10.886611,-74.776708)"
2016,Diciembre,Italia,380,116,66,,182,"(3.541112,-76.384584)"
2016,Diciembre,Italia,380,624,358,,982,"(4.697144,-74.140516)"
2016,Diciembre,Italia,380,1,1,,2,"(4.815061,-75.736532)"
2016,Diciembre,Italia,380,82,52,,134,"(6.171601,-75.427454)"
2016,Diciembre,Italia,380,0,1,,1,"(7.128456,-73.183637)"
2016,Diciembre,Jamaica,388,2653,1894,,4547,"(10.408582,-75.538003)"
2016,Diciembre,Jamaica,388,2,8,,10,"(10.445761,-75.516429)"
2016,Diciembre,Jamaica,388,2,6,,8,"(10.886611,-74.776708)"
2016,Diciembre,Jamaica,388,8,11,,19,"(3.541112,-76.384584)"
2016,Diciembre,Jamaica,388,28,25,,53,"(4.697144,-74.140516)"
2016,Diciembre,Jamaica,388,5,3,,8,"(4.815061,-75.736532)"
2016,Diciembre,Jamaica,388,4,6,,10,"(6.171601,-75.427454)"
2016,Diciembre,Jamaica,388,5,5,,10,"(7.128456,-73.183637)"
2016,Diciembre,Japón,392,1,11,,12,"(3.541112,-76.384584)"
2016,Diciembre,Japón,392,212,541,,753,"(4.697144,-74.140516)"
2016,Diciembre,Japón,392,96,274,,370,"(6.171601,-75.427454)"
2016,Diciembre,Jordania,400,3,2,,5,"(4.697144,-74.140516)"
2016,Diciembre,Kazajistán,398,0,1,,1,"(4.697144,-74.140516)"
2016,Diciembre,Kenia,404,8,3,,11,"(4.697144,-74.140516)"
2016,Diciembre,Kenia,404,1,0,,1,"(6.171601,-75.427454)"
2016,Diciembre,Kuwait,414,0,3,,3,"(4.697144,-74.140516)"
2016,Diciembre,Lituania,440,1,0,,1,"(10.886611,-74.776708)"
2016,Diciembre,Lituania,440,0,4,,4,"(4.697144,-74.140516)"
2016,Diciembre,Líbano,422,10,13,,23,"(4.697144,-74.140516)"
2016,Diciembre,Liechtenstein,438,1,0,,1,"(4.697144,-74.140516)"
2016,Diciembre,Luxemburgo,442,1,0,,1,"(10.886611,-74.776708)"
2016,Diciembre,Luxemburgo,442,2,0,,2,"(3.541112,-76.384584)"
2016,Diciembre,Luxemburgo,442,9,3,,12,"(4.697144,-74.140516)"
2016,Diciembre,Malasia,458,5,3,,8,"(4.697144,-74.140516)"
2016,Diciembre,Malta,470,1,0,,1,"(3.541112,-76.384584)"
2016,Diciembre,Malta,470,14,8,,22,"(4.697144,-74.140516)"
2016,Diciembre,Malta,470,1,0,,1,"(6.171601,-75.427454)"
2016,Diciembre,Marruecos,504,2,0,,2,"(3.541112,-76.384584)"
2016,Diciembre,Marruecos,504,9,12,,21,"(4.697144,-74.140516)"
2016,Diciembre,Marruecos,504,2,3,,5,"(6.171601,-75.427454)"
2016,Diciembre,Mauritania,478,0,1,,1,"(4.697144,-74.140516)"
2016,Diciembre,México,484,67,55,,122,"(10.445761,-75.516429)"
2016,Diciembre,México,484,126,92,,218,"(10.886611,-74.776708)"
2016,Diciembre,México,484,4,4,,8,"(12.586067,-81.702563)"
2016,Diciembre,México,484,629,555,,1184,"(3.541112,-76.384584)"
2016,Diciembre,México,484,18962,15311,,34273,"(4.697144,-74.140516)"
2016,Diciembre,México,484,114,83,,197,"(4.815061,-75.736532)"
2016,Diciembre,México,484,2444,1785,,4229,"(6.171601,-75.427454)"
2016,Diciembre,México,484,53,40,,93,"(7.128456,-73.183637)"
2016,Diciembre,República de Moldavia,498,1,0,,1,"(4.697144,-74.140516)"
2016,Diciembre,Mónaco,492,1,1,,2,"(4.697144,-74.140516)"
2016,Diciembre,Mozambique,508,1,0,,1,"(4.697144,-74.140516)"
2016,Diciembre,Nepal,524,1,0,,1,"(3.541112,-76.384584)"
2016,Diciembre,Nepal,524,1,0,,1,"(4.697144,-74.140516)"
2016,Diciembre,Nicaragua,558,0,1,,1,"(10.445761,-75.516429)"
2016,Diciembre,Nicaragua,558,5,6,,11,"(10.886611,-74.776708)"
2016,Diciembre,Nicaragua,558,11,9,,20,"(12.586067,-81.702563)"
2016,Diciembre,Nicaragua,558,20,30,,50,"(3.541112,-76.384584)"
2016,Diciembre,Nicaragua,558,51,61,,112,"(4.697144,-74.140516)"
2016,Diciembre,Nicaragua,558,5,1,,6,"(4.815061,-75.736532)"
2016,Diciembre,Nicaragua,558,12,29,,41,"(6.171601,-75.427454)"
2016,Diciembre,Nigeria,566,0,3,,3,"(4.697144,-74.140516)"
2016,Diciembre,Noruega,578,2,1,,3,"(10.886611,-74.776708)"
2016,Diciembre,Noruega,578,4,5,,9,"(3.541112,-76.384584)"
2016,Diciembre,Noruega,578,37,28,,65,"(4.697144,-74.140516)"
2016,Diciembre,Noruega,578,4,3,,7,"(6.171601,-75.427454)"
2016,Diciembre,Nueva Caledonia/Territorio francés,540,0,3,,3,"(4.697144,-74.140516)"
2016,Diciembre,Nueva Zelanda,554,1,0,,1,"(10.886611,-74.776708)"
2016,Diciembre,Nueva Zelanda,554,0,1,,1,"(3.541112,-76.384584)"
2016,Diciembre,Nueva Zelanda,554,45,35,,80,"(4.697144,-74.140516)"
2016,Diciembre,Nueva Zelanda,554,9,4,,13,"(6.171601,-75.427454)"
2016,Diciembre,Omán,512,7,2,,9,"(4.697144,-74.140516)"
2016,Diciembre,Panamá,591,0,2,,2,"(0.814836,-77.662532)"
2016,Diciembre,Panamá,591,13,93,,106,"(10.408582,-75.538003)"
2016,Diciembre,Panamá,591,717,550,,1267,"(10.445761,-75.516429)"
2016,Diciembre,Panamá,591,907,823,,1730,"(10.886611,-74.776708)"
2016,Diciembre,Panamá,591,1,0,,1,"(11.117806,-74.232622)"
2016,Diciembre,Panamá,591,1,2,,3,"(11.247723,-74.213989)"
2016,Diciembre,Panamá,591,4,25,,29,"(12.5744111,-81.703935)"
2016,Diciembre,Panamá,591,81,72,,153,"(12.586067,-81.702563)"
2016,Diciembre,Panamá,591,2453,1984,,4437,"(3.541112,-76.384584)"
2016,Diciembre,Panamá,591,260,194,,454,"(4.452882,-75.766298)"
2016,Diciembre,Panamá,591,11539,10569,,22108,"(4.697144,-74.140516)"
2016,Diciembre,Panamá,591,614,432,,1046,"(4.815061,-75.736532)"
2016,Diciembre,Panamá,591,3997,3307,,7304,"(6.171601,-75.427454)"
2016,Diciembre,Panamá,591,1,0,,1,"(6.228046,-77.404104)"
2016,Diciembre,Panamá,591,13,15,,28,"(7.102626,-77.762647)"
2016,Diciembre,Panamá,591,160,118,,278,"(7.128456,-73.183637)"
2016,Diciembre,Panamá,591,0,44,,44,"(8.066966,-76.735404)"
2016,Diciembre,Panamá,591,30,68,,98,"(8.635765,-77.346578)"
2016,Diciembre,Paraguay,600,8,3,,11,"(10.445761,-75.516429)"
2016,Diciembre,Paraguay,600,2,13,,15,"(10.886611,-74.776708)"
2016,Diciembre,Paraguay,600,1,2,,3,"(12.586067,-81.702563)"
2016,Diciembre,Paraguay,600,18,13,,31,"(3.541112,-76.384584)"
2016,Diciembre,Paraguay,600,55,120,,175,"(4.697144,-74.140516)"
2016,Diciembre,Paraguay,600,6,2,,8,"(4.815061,-75.736532)"
2016,Diciembre,Paraguay,600,14,11,,25,"(6.171601,-75.427454)"
2016,Diciembre,Perú,604,1,3,,4,"(-0.193180,-74.784874)"
2016,Diciembre,Perú,604,126,142,,268,"(-4.197703,-69.941278)"
2016,Diciembre,Perú,604,1,0,,1,"(0.25129,-76.875963)"
2016,Diciembre,Perú,604,71,64,,135,"(0.814836,-77.662532)"
2016,Diciembre,Perú,604,4,1,,5,"(10.445761,-75.516429)"
2016,Diciembre,Perú,604,22,12,,34,"(10.886611,-74.776708)"
2016,Diciembre,Perú,604,0,2,,2,"(12.586067,-81.702563)"
2016,Diciembre,Perú,604,325,282,,607,"(3.541112,-76.384584)"
2016,Diciembre,Perú,604,7238,6659,,13897,"(4.697144,-74.140516)"
2016,Diciembre,Perú,604,4,7,,11,"(4.815061,-75.736532)"
2016,Diciembre,Perú,604,480,380,,860,"(6.171601,-75.427454)"
2016,Diciembre,Perú,604,2,4,,6,"(7.128456,-73.183637)"
2016,Diciembre,Polonia,616,1,0,,1,"(10.445761,-75.516429)"
2016,Diciembre,Polonia,616,1,1,,2,"(3.541112,-76.384584)"
2016,Diciembre,Polonia,616,8,14,,22,"(4.697144,-74.140516)"
2016,Diciembre,Polonia,616,1,1,,2,"(6.171601,-75.427454)"
2016,Diciembre,Portugal,620,8,4,,12,"(3.541112,-76.384584)"
2016,Diciembre,Portugal,620,83,137,,220,"(4.697144,-74.140516)"
2016,Diciembre,Portugal,620,11,9,,20,"(6.171601,-75.427454)"
2016,Diciembre,Puerto Rico/Territorio de Estados Unidos,630,14,5,,19,"(10.445761,-75.516429)"
2016,Diciembre,Puerto Rico/Territorio de Estados Unidos,630,36,26,,62,"(10.886611,-74.776708)"
2016,Diciembre,Puerto Rico/Territorio de Estados Unidos,630,63,38,,101,"(3.541112,-76.384584)"
2016,Diciembre,Puerto Rico/Territorio de Estados Unidos,630,958,767,,1725,"(4.697144,-74.140516)"
2016,Diciembre,Puerto Rico/Territorio de Estados Unidos,630,12,3,,15,"(4.815061,-75.736532)"
2016,Diciembre,Puerto Rico/Territorio de Estados Unidos,630,87,58,,145,"(6.171601,-75.427454)"
2016,Diciembre,Puerto Rico/Territorio de Estados Unidos,630,10,6,,16,"(7.128456,-73.183637)"
2016,Diciembre,Qatar,634,2,1,,3,"(4.697144,-74.140516)"
2016,Diciembre,Qatar,634,3,0,,3,"(6.171601,-75.427454)"
2016,Diciembre,Reino Unido de Gran Bretaña e Irlanda del Norte,826,1,0,,1,"(10.886611,-74.776708)"
2016,Diciembre,Reino Unido de Gran Bretaña e Irlanda del Norte,826,24,16,,40,"(3.541112,-76.384584)"
2016,Diciembre,Reino Unido de Gran Bretaña e Irlanda del Norte,826,1788,1361,,3149,"(4.697144,-74.140516)"
2016,Diciembre,Reino Unido de Gran Bretaña e Irlanda del Norte,826,13,10,,23,"(6.171601,-75.427454)"
2016,Diciembre,República CentroÁfricana,140,6,3,,9,"(4.697144,-74.140516)"
2016,Diciembre,Federación de Rusia,643,2,3,,5,"(3.541112,-76.384584)"
2016,Diciembre,Federación de Rusia,643,12,18,,30,"(4.697144,-74.140516)"
2016,Diciembre,Federación de Rusia,643,0,2,,2,"(6.171601,-75.427454)"
2016,Diciembre,República Dominicana,214,18,19,,37,"(10.445761,-75.516429)"
2016,Diciembre,República Dominicana,214,49,53,,102,"(10.886611,-74.776708)"
2016,Diciembre,República Dominicana,214,22,52,,74,"(12.586067,-81.702563)"
2016,Diciembre,República Dominicana,214,104,100,,204,"(3.541112,-76.384584)"
2016,Diciembre,República Dominicana,214,4362,3697,,8059,"(4.697144,-74.140516)"
2016,Diciembre,República Dominicana,214,39,41,,80,"(4.815061,-75.736532)"
2016,Diciembre,República Dominicana,214,338,232,,570,"(6.171601,-75.427454)"
2016,Diciembre,República Dominicana,214,33,26,,59,"(7.128456,-73.183637)"
2016,Diciembre,Reunión,638,3,2,,5,"(4.697144,-74.140516)"
2016,Diciembre,Rumania,642,5,5,,10,"(4.697144,-74.140516)"
2016,Diciembre,Santa Lucia,662,0,1,,1,"(4.697144,-74.140516)"
2016,Diciembre,Senegal,686,0,1,,1,"(6.171601,-75.427454)"
2016,Diciembre,Serbia,688,3,0,,3,"(4.697144,-74.140516)"
2016,Diciembre,Sierra Leona,694,0,1,,1,"(4.697144,-74.140516)"
2016,Diciembre,Singapur,702,13,18,,31,"(4.697144,-74.140516)"
2016,Diciembre,Singapur,702,2,0,,2,"(4.815061,-75.736532)"
2016,Diciembre,Singapur,702,3,1,,4,"(6.171601,-75.427454)"
2016,Diciembre,Sudáfrica,710,0,1,,1,"(3.541112,-76.384584)"
2016,Diciembre,Sudáfrica,710,12,12,,24,"(4.697144,-74.140516)"
2016,Diciembre,Sudáfrica,710,1,1,,2,"(6.171601,-75.427454)"
2016,Diciembre,Suecia,752,12,6,,18,"(3.541112,-76.384584)"
2016,Diciembre,Suecia,752,72,49,,121,"(4.697144,-74.140516)"
2016,Diciembre,Suecia,752,1,0,,1,"(4.815061,-75.736532)"
2016,Diciembre,Suecia,752,11,4,,15,"(6.171601,-75.427454)"
2016,Diciembre,Suiza,756,9,6,,15,"(10.886611,-74.776708)"
2016,Diciembre,Suiza,756,64,33,,97,"(3.541112,-76.384584)"
2016,Diciembre,Suiza,756,228,162,,390,"(4.697144,-74.140516)"
2016,Diciembre,Suiza,756,3,1,,4,"(4.815061,-75.736532)"
2016,Diciembre,Suiza,756,20,16,,36,"(6.171601,-75.427454)"
2016,Diciembre,Surinam,740,0,1,,1,"(4.697144,-74.140516)"
2016,Diciembre,Taiwán,158,2,1,,3,"(3.541112,-76.384584)"
2016,Diciembre,Taiwán,158,2,2,,4,"(4.697144,-74.140516)"
2016,Diciembre,Tailandia,764,1,2,,3,"(3.541112,-76.384584)"
2016,Diciembre,Tailandia,764,42,31,,73,"(4.697144,-74.140516)"
2016,Diciembre,Tailandia,764,7,2,,9,"(6.171601,-75.427454)"
2016,Diciembre,Tanzania,834,1,1,,2,"(4.697144,-74.140516)"
2016,Diciembre,Trinidad y Tobago,780,1,2,,3,"(10.445761,-75.516429)"
2016,Diciembre,Trinidad y Tobago,780,3,3,,6,"(10.886611,-74.776708)"
2016,Diciembre,Trinidad y Tobago,780,0,1,,1,"(3.541112,-76.384584)"
2016,Diciembre,Trinidad y Tobago,780,20,19,,39,"(4.697144,-74.140516)"
2016,Diciembre,Trinidad y Tobago,780,2,4,,6,"(4.815061,-75.736532)"
2016,Diciembre,Trinidad y Tobago,780,10,8,,18,"(6.171601,-75.427454)"
2016,Diciembre,Turquía,792,1,0,,1,"(10.886611,-74.776708)"
2016,Diciembre,Turquía,792,3,1,,4,"(3.541112,-76.384584)"
2016,Diciembre,Turquía,792,215,161,,376,"(4.697144,-74.140516)"
2016,Diciembre,Turquía,792,2,3,,5,"(6.171601,-75.427454)"
2016,Diciembre,Turkmenistán,795,2,3,,5,"(4.697144,-74.140516)"
2016,Diciembre,Ucrania,804,1,7,,8,"(4.697144,-74.140516)"
2016,Diciembre,Ucrania,804,1,0,,1,"(6.171601,-75.427454)"
2016,Diciembre,Uruguay,858,1,1,,2,"(10.445761,-75.516429)"
2016,Diciembre,Uruguay,858,13,18,,31,"(3.541112,-76.384584)"
2016,Diciembre,Uruguay,858,163,146,,309,"(4.697144,-74.140516)"
2016,Diciembre,Uruguay,858,1,0,,1,"(4.815061,-75.736532)"
2016,Diciembre,Uruguay,858,18,19,,37,"(6.171601,-75.427454)"
2016,Diciembre,Venezuela,862,5,6,,11,"(10.445761,-75.516429)"
2016,Diciembre,Venezuela,862,6,16,,22,"(10.886611,-74.776708)"
2016,Diciembre,Venezuela,862,1,0,,1,"(11.117806,-74.232622)"
2016,Diciembre,Venezuela,862,2129,2116,,4245,"(11.360009,-72.129330)"
2016,Diciembre,Venezuela,862,0,2,,2,"(12.586067,-81.702563)"
2016,Diciembre,Venezuela,862,9,15,,24,"(3.541112,-76.384584)"
2016,Diciembre,Venezuela,862,14,13,,27,"(3.866713,-67.927521)"
2016,Diciembre,Venezuela,862,2023,1799,,3822,"(4.697144,-74.140516)"
2016,Diciembre,Venezuela,862,0,1,,1,"(4.815061,-75.736532)"
2016,Diciembre,Venezuela,862,549,471,,1020,"(6.171601,-75.427454)"
2016,Diciembre,Venezuela,862,144,132,,276,"(6.185799,-67.483929)"
2016,Diciembre,Venezuela,862,789,715,,1504,"(7.088729,-70.740253)"
2016,Diciembre,Venezuela,862,4,2,,6,"(7.128456,-73.183637)"
2016,Diciembre,Venezuela,862,3247,3037,,6284,"(7.818934,-72.453226)"
2016,Diciembre,Venezuela,862,173,173,,346,"(8.36068,-72.409396)"
2016,Diciembre,Vietnam,704,1,4,,5,"(3.541112,-76.384584)"
2016,Diciembre,Vietnam,704,7,8,,15,"(4.697144,-74.140516)"
2016,Diciembre,Vietnam,704,0,1,,1,"(6.171601,-75.427454)"
2016,Diciembre,Islas Vírgenes Británicas/Territorio Británico de Ultramar,92,2,0,,2,"(6.171601,-75.427454)"
2016,Diciembre,Desconocido,99999,3,2,,5,"(0.25129,-76.875963)"
2017,Enero,Afganistán,4,3,6,,9,"(4.697144,-74.140516)"
2017,Enero,Albania,8,2,14,,16,"(4.697144,-74.140516)"
2017,Enero,Alemania,276,1,4,,5,"(0.814836,-77.662532)"
2017,Enero,Alemania,276,5,4,,9,"(10.445761,-75.516429)"
2017,Enero,Alemania,276,28,26,,54,"(10.886611,-74.776708)"
2017,Enero,Alemania,276,122,78,,200,"(3.541112,-76.384584)"
2017,Enero,Alemania,276,1249,1093,,2342,"(4.697144,-74.140516)"
2017,Enero,Alemania,276,2,2,,4,"(4.815061,-75.736532)"
2017,Enero,Alemania,276,64,50,,114,"(6.171601,-75.427454)"
2017,Enero,Alemania,276,1,0,,1,"(7.128456,-73.183637)"
2017,Enero,Andorra,20,1,0,,1,"(4.697144,-74.140516)"
2017,Enero,Angola,24,4,23,,27,"(4.697144,-74.140516)"
2017,Enero,Angola,24,0,1,,1,"(7.128456,-73.183637)"
2017,Enero,Antigua y Barbuda,28,1,0,,1,"(10.886611,-74.776708)"
2017,Enero,Antigua y Barbuda,28,1,0,,1,"(3.541112,-76.384584)"
2017,Enero,Antigua y Barbuda,28,2,2,,4,"(4.697144,-74.140516)"
2017,Enero,Países Bajos,528,2,2,,4,"(10.445761,-75.516429)"
2017,Enero,Países Bajos,528,264,168,,432,"(10.886611,-74.776708)"
2017,Enero,Países Bajos,528,0,2,,2,"(11.117806,-74.232622)"
2017,Enero,Países Bajos,528,228,139,,367,"(3.541112,-76.384584)"
2017,Enero,Países Bajos,528,1162,895,,2057,"(4.697144,-74.140516)"
2017,Enero,Países Bajos,528,14,3,,17,"(4.815061,-75.736532)"
2017,Enero,Países Bajos,528,318,219,,537,"(6.171601,-75.427454)"
2017,Enero,Países Bajos,528,1,0,,1,"(7.128456,-73.183637)"
2017,Enero,Arabia Saudita,682,3,3,,6,"(3.541112,-76.384584)"
2017,Enero,Arabia Saudita,682,25,68,,93,"(4.697144,-74.140516)"
2017,Enero,Arabia Saudita,682,5,3,,8,"(6.171601,-75.427454)"
2017,Enero,Arabia Saudita,682,1,2,,3,"(7.128456,-73.183637)"
2017,Enero,Argelia,12,0,1,,1,"(3.541112,-76.384584)"
2017,Enero,Argelia,12,4,4,,8,"(4.697144,-74.140516)"
2017,Enero,Argelia,12,0,1,,1,"(6.171601,-75.427454)"
2017,Enero,Argentina,32,0,1,,1,"(-4.197703,-69.941278)"
2017,Enero,Argentina,32,0,1,,1,"(0.25129,-76.875963)"
2017,Enero,Argentina,32,30,56,,86,"(0.814836,-77.662532)"
2017,Enero,Argentina,32,1,0,,1,"(1.813928,-78.763924)"
2017,Enero,Argentina,32,21,29,,50,"(10.445761,-75.516429)"
2017,Enero,Argentina,32,22,14,,36,"(10.886611,-74.776708)"
2017,Enero,Argentina,32,1,1,,2,"(12.586067,-81.702563)"
2017,Enero,Argentina,32,146,139,,285,"(3.541112,-76.384584)"
2017,Enero,Argentina,32,4261,3872,,8133,"(4.697144,-74.140516)"
2017,Enero,Argentina,32,11,12,,23,"(4.815061,-75.736532)"
2017,Enero,Argentina,32,120,136,,256,"(6.171601,-75.427454)"
2017,Enero,Argentina,32,5,5,,10,"(7.128456,-73.183637)"
2017,Enero,República de Armenia,51,0,1,,1,"(4.697144,-74.140516)"
2017,Enero,Aruba,533,6,4,,10,"(10.408582,-75.538003)"
2017,Enero,Aruba,533,7,8,,15,"(10.445761,-75.516429)"
2017,Enero,Aruba,533,41,25,,66,"(10.886611,-74.776708)"
2017,Enero,Aruba,533,49,35,,84,"(3.541112,-76.384584)"
2017,Enero,Aruba,533,2248,1838,,4086,"(4.697144,-74.140516)"
2017,Enero,Aruba,533,14,5,,19,"(4.815061,-75.736532)"
2017,Enero,Aruba,533,210,154,,364,"(6.171601,-75.427454)"
2017,Enero,Aruba,533,10,48,,58,"(7.128456,-73.183637)"
2017,Enero,Australia,36,6,0,,6,"(10.445761,-75.516429)"
2017,Enero,Australia,36,8,6,,14,"(10.886611,-74.776708)"
2017,Enero,Australia,36,29,46,,75,"(3.541112,-76.384584)"
2017,Enero,Australia,36,642,509,,1151,"(4.697144,-74.140516)"
2017,Enero,Australia,36,5,4,,9,"(4.815061,-75.736532)"
2017,Enero,Australia,36,95,86,,181,"(6.171601,-75.427454)"
2017,Enero,Australia,36,4,1,,5,"(7.128456,-73.183637)"
2017,Enero,Austria,40,3,0,,3,"(10.445761,-75.516429)"
2017,Enero,Austria,40,1,0,,1,"(10.886611,-74.776708)"
2017,Enero,Austria,40,7,0,,7,"(3.541112,-76.384584)"
2017,Enero,Austria,40,43,31,,74,"(4.697144,-74.140516)"
2017,Enero,Austria,40,2,4,,6,"(6.171601,-75.427454)"
2017,Enero,Austria,40,0,1,,1,"(7.128456,-73.183637)"
2017,Enero,Azerbaiyán,31,8,7,,15,"(4.697144,-74.140516)"
2017,Enero,Bahamas,44,0,1,,1,"(10.445761,-75.516429)"
2017,Enero,Bahamas,44,2,2,,4,"(10.886611,-74.776708)"
2017,Enero,Bahamas,44,8,5,,13,"(3.541112,-76.384584)"
2017,Enero,Bahamas,44,6,12,,18,"(4.697144,-74.140516)"
2017,Enero,Bahamas,44,4,2,,6,"(4.815061,-75.736532)"
2017,Enero,Bahamas,44,7,24,,31,"(6.171601,-75.427454)"
2017,Enero,Bahamas,44,1,2,,3,"(7.128456,-73.183637)"
2017,Enero,Bahréin,48,0,1,,1,"(3.541112,-76.384584)"
2017,Enero,Bahréin,48,7,6,,13,"(4.697144,-74.140516)"
2017,Enero,Bahréin,48,2,0,,2,"(6.171601,-75.427454)"
2017,Enero,Bangladesh,50,2,3,,5,"(4.697144,-74.140516)"
2017,Enero,Barbados,52,111,94,,205,"(4.697144,-74.140516)"
2017,Enero,Barbados,52,0,1,,1,"(6.171601,-75.427454)"
2017,Enero,República de Belarús,112,0,2,,2,"(4.697144,-74.140516)"
2017,Enero,República de Belarús,112,0,1,,1,"(6.171601,-75.427454)"
2017,Enero,Bélgica,56,2,0,,2,"(10.445761,-75.516429)"
2017,Enero,Bélgica,56,4,1,,5,"(10.886611,-74.776708)"
2017,Enero,Bélgica,56,36,27,,63,"(3.541112,-76.384584)"
2017,Enero,Bélgica,56,155,93,,248,"(4.697144,-74.140516)"
2017,Enero,Bélgica,56,20,18,,38,"(6.171601,-75.427454)"
2017,Enero,Belice,84,1,0,,1,"(3.541112,-76.384584)"
2017,Enero,Belice,84,6,9,,15,"(4.697144,-74.140516)"
2017,Enero,Belice,84,5,0,,5,"(6.171601,-75.427454)"
2017,Enero,Bermudas/Territorio Británico de Ultramar,60,1,1,,2,"(4.697144,-74.140516)"
2017,Enero,Bermudas/Territorio Británico de Ultramar,60,1,2,,3,"(6.171601,-75.427454)"
2017,Enero,Bolivia,68,10,11,,21,"(0.814836,-77.662532)"
2017,Enero,Bolivia,68,4,3,,7,"(10.445761,-75.516429)"
2017,Enero,Bolivia,68,2,10,,12,"(10.886611,-74.776708)"
2017,Enero,Bolivia,68,37,48,,85,"(3.541112,-76.384584)"
2017,Enero,Bolivia,68,384,704,,1088,"(4.697144,-74.140516)"
2017,Enero,Bolivia,68,7,21,,28,"(4.815061,-75.736532)"
2017,Enero,Bolivia,68,30,59,,89,"(6.171601,-75.427454)"
2017,Enero,Botsuana,72,0,1,,1,"(4.697144,-74.140516)"
2017,Enero,Brasil,76,203,365,,568,"(-4.197703,-69.941278)"
2017,Enero,Brasil,76,5,28,,33,"(0.814836,-77.662532)"
2017,Enero,Brasil,76,20,23,,43,"(10.445761,-75.516429)"
2017,Enero,Brasil,76,22,10,,32,"(10.886611,-74.776708)"
2017,Enero,Brasil,76,1,3,,4,"(12.586067,-81.702563)"
2017,Enero,Brasil,76,114,162,,276,"(3.541112,-76.384584)"
2017,Enero,Brasil,76,2,0,,2,"(3.866713,-67.927521)"
2017,Enero,Brasil,76,2739,3573,,6312,"(4.697144,-74.140516)"
2017,Enero,Brasil,76,11,24,,35,"(4.815061,-75.736532)"
2017,Enero,Brasil,76,146,176,,322,"(6.171601,-75.427454)"
2017,Enero,Bulgaria,100,0,1,,1,"(10.886611,-74.776708)"
2017,Enero,Bulgaria,100,0,1,,1,"(3.541112,-76.384584)"
2017,Enero,Bulgaria,100,0,3,,3,"(4.697144,-74.140516)"
2017,Enero,Burkina Faso,854,0,1,,1,"(4.697144,-74.140516)"
2017,Enero,Cabo Verde,132,0,1,,1,"(4.697144,-74.140516)"
2017,Enero,Islas Caimán/Territorio Británico de Ultramar,136,17,12,,29,"(12.586067,-81.702563)"
2017,Enero,Islas Caimán/Territorio Británico de Ultramar,136,0,2,,2,"(3.541112,-76.384584)"
2017,Enero,Islas Caimán/Territorio Británico de Ultramar,136,5,5,,10,"(4.697144,-74.140516)"
2017,Enero,Islas Caimán/Territorio Británico de Ultramar,136,2,3,,5,"(6.171601,-75.427454)"
2017,Enero,Camboya,116,2,3,,5,"(4.697144,-74.140516)"
2017,Enero,Camerún,120,3,4,,7,"(4.697144,-74.140516)"
2017,Enero,Camerún,120,0,1,,1,"(6.171601,-75.427454)"
2017,Enero,Canadá,124,204,180,,384,"(10.445761,-75.516429)"
2017,Enero,Canadá,124,119,90,,209,"(10.886611,-74.776708)"
2017,Enero,Canadá,124,25,29,,54,"(12.586067,-81.702563)"
2017,Enero,Canadá,124,272,230,,502,"(3.541112,-76.384584)"
2017,Enero,Canadá,124,2,3,,5,"(4.452882,-75.766298)"
2017,Enero,Canadá,124,3376,3084,,6460,"(4.697144,-74.140516)"
2017,Enero,Canadá,124,40,29,,69,"(4.815061,-75.736532)"
2017,Enero,Canadá,124,510,456,,966,"(6.171601,-75.427454)"
2017,Enero,Canadá,124,34,42,,76,"(7.128456,-73.183637)"
2017,Enero,Chad,148,1,0,,1,"(4.697144,-74.140516)"
2017,Enero,España,724,2,1,,3,"(10.445761,-75.516429)"
2017,Enero,España,724,21,14,,35,"(10.886611,-74.776708)"
2017,Enero,España,724,3471,2459,,5930,"(3.541112,-76.384584)"
2017,Enero,España,724,11965,8666,,20631,"(4.697144,-74.140516)"
2017,Enero,España,724,16,10,,26,"(4.815061,-75.736532)"
2017,Enero,España,724,1389,939,,2328,"(6.171601,-75.427454)"
2017,Enero,España,724,1,0,,1,"(7.128456,-73.183637)"
2017,Enero,Colombia,170,3,11,,14,"(10.445761,-75.516429)"
2017,Enero,Colombia,170,100,296,,396,"(4.697144,-74.140516)"
2017,Enero,República Del Congo,178,1,1,,2,"(4.697144,-74.140516)"
2017,Enero,República Del Congo,178,1,0,,1,"(6.171601,-75.427454)"
2017,Enero,República de Corea,410,1,1,,2,"(3.541112,-76.384584)"
2017,Enero,República de Corea,410,13,17,,30,"(4.697144,-74.140516)"
2017,Enero,República de Corea,410,2,0,,2,"(6.171601,-75.427454)"
2017,Enero,Islas Malvinas,238,0,1,,1,"(6.171601,-75.427454)"
2017,Enero,Costa de Marfil,384,3,2,,5,"(3.541112,-76.384584)"
2017,Enero,Costa de Marfil,384,1,4,,5,"(4.697144,-74.140516)"
2017,Enero,Costa de Marfil,384,0,1,,1,"(6.171601,-75.427454)"
2017,Enero,Costa Rica,188,24,16,,40,"(10.445761,-75.516429)"
2017,Enero,Costa Rica,188,49,40,,89,"(10.886611,-74.776708)"
2017,Enero,Costa Rica,188,4,31,,35,"(12.5744111,-81.703935)"
2017,Enero,Costa Rica,188,71,58,,129,"(12.586067,-81.702563)"
2017,Enero,Costa Rica,188,89,86,,175,"(3.541112,-76.384584)"
2017,Enero,Costa Rica,188,1521,1469,,2990,"(4.697144,-74.140516)"
2017,Enero,Costa Rica,188,35,25,,60,"(4.815061,-75.736532)"
2017,Enero,Costa Rica,188,215,207,,422,"(6.171601,-75.427454)"
2017,Enero,Costa Rica,188,15,15,,30,"(7.128456,-73.183637)"
2017,Enero,Croacia,191,3,5,,8,"(4.697144,-74.140516)"
2017,Enero,Croacia,191,0,2,,2,"(6.171601,-75.427454)"
2017,Enero,Cuba,192,15,19,,34,"(10.445761,-75.516429)"
2017,Enero,Cuba,192,12,25,,37,"(10.886611,-74.776708)"
2017,Enero,Cuba,192,2,2,,4,"(12.586067,-81.702563)"
2017,Enero,Cuba,192,68,68,,136,"(3.541112,-76.384584)"
2017,Enero,Cuba,192,1566,1524,,3090,"(4.697144,-74.140516)"
2017,Enero,Cuba,192,21,20,,41,"(4.815061,-75.736532)"
2017,Enero,Cuba,192,149,132,,281,"(6.171601,-75.427454)"
2017,Enero,Cuba,192,7,8,,15,"(7.128456,-73.183637)"
2017,Enero,Curazao,99999,14,46,,60,"(4.697144,-74.140516)"
2017,Enero,República Checa,203,1,0,,1,"(10.886611,-74.776708)"
2017,Enero,República Checa,203,2,1,,3,"(3.541112,-76.384584)"
2017,Enero,República Checa,203,4,12,,16,"(4.697144,-74.140516)"
2017,Enero,República Checa,203,0,1,,1,"(6.171601,-75.427454)"
2017,Enero,Chile,152,424,403,,827,"(0.814836,-77.662532)"
2017,Enero,Chile,152,4,5,,9,"(1.813928,-78.763924)"
2017,Enero,Chile,152,40,28,,68,"(10.445761,-75.516429)"
2017,Enero,Chile,152,30,16,,46,"(10.886611,-74.776708)"
2017,Enero,Chile,152,1,2,,3,"(12.586067,-81.702563)"
2017,Enero,Chile,152,528,366,,894,"(3.541112,-76.384584)"
2017,Enero,Chile,152,6715,5821,,12536,"(4.697144,-74.140516)"
2017,Enero,Chile,152,92,81,,173,"(4.815061,-75.736532)"
2017,Enero,Chile,152,174,188,,362,"(6.171601,-75.427454)"
2017,Enero,Chile,152,19,14,,33,"(7.128456,-73.183637)"
2017,Enero,China,156,2,2,,4,"(10.445761,-75.516429)"
2017,Enero,China,156,3,5,,8,"(10.886611,-74.776708)"
2017,Enero,China,156,12,17,,29,"(3.541112,-76.384584)"
2017,Enero,China,156,77,120,,197,"(4.697144,-74.140516)"
2017,Enero,China,156,7,14,,21,"(6.171601,-75.427454)"
2017,Enero,China,156,0,1,,1,"(7.128456,-73.183637)"
2017,Enero,Chipre,196,0,1,,1,"(4.697144,-74.140516)"
2017,Enero,Dinamarca,208,4,4,,8,"(3.541112,-76.384584)"
2017,Enero,Dinamarca,208,41,33,,74,"(4.697144,-74.140516)"
2017,Enero,Dinamarca,208,1,0,,1,"(4.815061,-75.736532)"
2017,Enero,Dinamarca,208,2,2,,4,"(6.171601,-75.427454)"
2017,Enero,Dinamarca,208,1,0,,1,"(7.128456,-73.183637)"
2017,Enero,Dominica,212,0,4,,4,"(3.541112,-76.384584)"
2017,Enero,Dominica,212,0,3,,3,"(6.171601,-75.427454)"
2017,Enero,Ecuador,218,8,7,,15,"(-0.193180,-74.784874)"
2017,Enero,Ecuador,218,852,1162,,2014,"(0.25129,-76.875963)"
2017,Enero,Ecuador,218,21,24,,45,"(0.812436,-77.847006)"
2017,Enero,Ecuador,218,12105,13452,,25557,"(0.814836,-77.662532)"
2017,Enero,Ecuador,218,213,242,,455,"(1.813928,-78.763924)"
2017,Enero,Ecuador,218,0,3,,3,"(10.445761,-75.516429)"
2017,Enero,Ecuador,218,5,11,,16,"(10.886611,-74.776708)"
2017,Enero,Ecuador,218,2,1,,3,"(12.586067,-81.702563)"
2017,Enero,Ecuador,218,496,537,,1033,"(3.541112,-76.384584)"
2017,Enero,Ecuador,218,3701,5085,,8786,"(4.697144,-74.140516)"
2017,Enero,Ecuador,218,2,4,,6,"(4.815061,-75.736532)"
2017,Enero,Ecuador,218,24,37,,61,"(6.171601,-75.427454)"
2017,Enero,Ecuador,218,1,1,,2,"(7.128456,-73.183637)"
2017,Enero,Egipto,818,15,15,,30,"(4.697144,-74.140516)"
2017,Enero,Egipto,818,2,1,,3,"(6.171601,-75.427454)"
2017,Enero,El Salvador,222,4,5,,9,"(10.445761,-75.516429)"
2017,Enero,El Salvador,222,4,4,,8,"(10.886611,-74.776708)"
2017,Enero,El Salvador,222,3,2,,5,"(12.586067,-81.702563)"
2017,Enero,El Salvador,222,115,132,,247,"(3.541112,-76.384584)"
2017,Enero,El Salvador,222,995,1193,,2188,"(4.697144,-74.140516)"
2017,Enero,El Salvador,222,1,1,,2,"(4.815061,-75.736532)"
2017,Enero,El Salvador,222,76,120,,196,"(6.171601,-75.427454)"
2017,Enero,El Salvador,222,1,0,,1,"(7.128456,-73.183637)"
2017,Enero,Emiratos Árabes,784,8,3,,11,"(3.541112,-76.384584)"
2017,Enero,Emiratos Árabes,784,139,479,,618,"(4.697144,-74.140516)"
2017,Enero,Emiratos Árabes,784,16,20,,36,"(6.171601,-75.427454)"
2017,Enero,Emiratos Árabes,784,1,1,,2,"(7.128456,-73.183637)"
2017,Enero,Eritrea,232,2,1,,3,"(4.697144,-74.140516)"
2017,Enero,Eslovaquia,703,2,2,,4,"(4.697144,-74.140516)"
2017,Enero,Eslovenia,705,1,0,,1,"(3.541112,-76.384584)"
2017,Enero,Eslovenia,705,1,1,,2,"(4.697144,-74.140516)"
2017,Enero,Estados Unidos de América,840,3,3,,6,"(10.408582,-75.538003)"
2017,Enero,Estados Unidos de América,840,4434,3686,,8120,"(10.445761,-75.516429)"
2017,Enero,Estados Unidos de América,840,3030,2480,,5510,"(10.886611,-74.776708)"
2017,Enero,Estados Unidos de América,840,0,6,,6,"(11.117806,-74.232622)"
2017,Enero,Estados Unidos de América,840,111,106,,217,"(12.586067,-81.702563)"
2017,Enero,Estados Unidos de América,840,6320,4909,,11229,"(3.541112,-76.384584)"
2017,Enero,Estados Unidos de América,840,620,474,,1094,"(4.452882,-75.766298)"
2017,Enero,Estados Unidos de América,840,34699,30970,,65669,"(4.697144,-74.140516)"
2017,Enero,Estados Unidos de América,840,1117,855,,1972,"(4.815061,-75.736532)"
2017,Enero,Estados Unidos de América,840,10997,9506,,20503,"(6.171601,-75.427454)"
2017,Enero,Estados Unidos de América,840,259,210,,469,"(7.128456,-73.183637)"
2017,Enero,Estonia,233,0,1,,1,"(3.541112,-76.384584)"
2017,Enero,Estonia,233,0,1,,1,"(6.171601,-75.427454)"
2017,Enero,Etiopia,231,2,12,,14,"(4.697144,-74.140516)"
2017,Enero,Filipinas,608,1,0,,1,"(10.445761,-75.516429)"
2017,Enero,Filipinas,608,1,1,,2,"(10.886611,-74.776708)"
2017,Enero,Filipinas,608,2,0,,2,"(3.541112,-76.384584)"
2017,Enero,Filipinas,608,7,5,,12,"(4.697144,-74.140516)"
2017,Enero,Finlandia,246,0,1,,1,"(10.445761,-75.516429)"
2017,Enero,Finlandia,246,1,4,,5,"(10.886611,-74.776708)"
2017,Enero,Finlandia,246,2,1,,3,"(3.541112,-76.384584)"
2017,Enero,Finlandia,246,24,12,,36,"(4.697144,-74.140516)"
2017,Enero,Francia,250,5,0,,5,"(10.445761,-75.516429)"
2017,Enero,Francia,250,9,4,,13,"(10.886611,-74.776708)"
2017,Enero,Francia,250,171,134,,305,"(3.541112,-76.384584)"
2017,Enero,Francia,250,1571,1343,,2914,"(4.697144,-74.140516)"
2017,Enero,Francia,250,5,5,,10,"(4.815061,-75.736532)"
2017,Enero,Francia,250,92,55,,147,"(6.171601,-75.427454)"
2017,Enero,Francia,250,4,2,,6,"(7.128456,-73.183637)"
2017,Enero,Gabón,266,2,0,,2,"(4.697144,-74.140516)"
2017,Enero,Georgia,268,0,1,,1,"(4.697144,-74.140516)"
2017,Enero,Ghana,288,0,1,,1,"(0.814836,-77.662532)"
2017,Enero,Ghana,288,1,0,,1,"(4.697144,-74.140516)"
2017,Enero,Ghana,288,0,1,,1,"(6.171601,-75.427454)"
2017,Enero,Gibraltar/Territorio Británico de Ultramar,292,3,4,,7,"(0.814836,-77.662532)"
2017,Enero,Gibraltar/Territorio Británico de Ultramar,292,0,1,,1,"(4.697144,-74.140516)"
2017,Enero,Granada,308,0,1,,1,"(6.171601,-75.427454)"
2017,Enero,Grecia,300,2,0,,2,"(10.445761,-75.516429)"
2017,Enero,Grecia,300,8,4,,12,"(4.697144,-74.140516)"
2017,Enero,Grecia,300,3,2,,5,"(6.171601,-75.427454)"
2017,Enero,Guatemala,320,5,16,,21,"(10.445761,-75.516429)"
2017,Enero,Guatemala,320,12,16,,28,"(10.886611,-74.776708)"
2017,Enero,Guatemala,320,6,4,,10,"(12.586067,-81.702563)"
2017,Enero,Guatemala,320,77,113,,190,"(3.541112,-76.384584)"
2017,Enero,Guatemala,320,644,806,,1450,"(4.697144,-74.140516)"
2017,Enero,Guatemala,320,21,22,,43,"(4.815061,-75.736532)"
2017,Enero,Guatemala,320,134,162,,296,"(6.171601,-75.427454)"
2017,Enero,Guatemala,320,15,7,,22,"(7.128456,-73.183637)"
2017,Enero,Guyana,328,1,3,,4,"(10.886611,-74.776708)"
2017,Enero,Guyana,328,4,3,,7,"(4.697144,-74.140516)"
2017,Enero,Guyana,328,0,1,,1,"(4.815061,-75.736532)"
2017,Enero,Guyana,328,0,2,,2,"(6.171601,-75.427454)"
2017,Enero,Guinea,324,2,0,,2,"(0.814836,-77.662532)"
2017,Enero,Guinea Ecuatorial,226,1,0,,1,"(3.541112,-76.384584)"
2017,Enero,Guinea Ecuatorial,226,3,7,,10,"(4.697144,-74.140516)"
2017,Enero,Guinea Ecuatorial,226,1,3,,4,"(6.171601,-75.427454)"
2017,Enero,Guadalupe/Territorio Francés,312,1,0,,1,"(4.697144,-74.140516)"
2017,Enero,Guadalupe/Territorio Francés,312,0,1,,1,"(6.171601,-75.427454)"
2017,Enero,Guayana Francesa/Departamento de Ultramar Francés,254,0,1,,1,"(10.886611,-74.776708)"
2017,Enero,Guayana Francesa/Departamento de Ultramar Francés,254,1,1,,2,"(4.697144,-74.140516)"
2017,Enero,Haití,332,0,2,,2,"(10.445761,-75.516429)"
2017,Enero,Haití,332,1,7,,8,"(10.886611,-74.776708)"
2017,Enero,Haití,332,2,3,,5,"(3.541112,-76.384584)"
2017,Enero,Haití,332,8,8,,16,"(4.697144,-74.140516)"
2017,Enero,Haití,332,1,1,,2,"(4.815061,-75.736532)"
2017,Enero,Haití,332,0,4,,4,"(6.171601,-75.427454)"
2017,Enero,Haití,332,2,2,,4,"(7.128456,-73.183637)"
2017,Enero,Honduras,340,0,7,,7,"(10.408582,-75.538003)"
2017,Enero,Honduras,340,3,4,,7,"(10.445761,-75.516429)"
2017,Enero,Honduras,340,6,13,,19,"(10.886611,-74.776708)"
2017,Enero,Honduras,340,6,24,,30,"(3.541112,-76.384584)"
2017,Enero,Honduras,340,128,195,,323,"(4.697144,-74.140516)"
2017,Enero,Honduras,340,9,9,,18,"(4.815061,-75.736532)"
2017,Enero,Honduras,340,42,109,,151,"(6.171601,-75.427454)"
2017,Enero,Honduras,340,2,1,,3,"(7.128456,-73.183637)"
2017,Enero,Hong Kong,344,2,0,,2,"(3.541112,-76.384584)"
2017,Enero,Hong Kong,344,21,27,,48,"(4.697144,-74.140516)"
2017,Enero,Hong Kong,344,2,2,,4,"(6.171601,-75.427454)"
2017,Enero,Hungría,348,1,0,,1,"(10.886611,-74.776708)"
2017,Enero,Hungría,348,3,13,,16,"(4.697144,-74.140516)"
2017,Enero,India,356,1,0,,1,"(10.445761,-75.516429)"
2017,Enero,India,356,3,1,,4,"(3.541112,-76.384584)"
2017,Enero,India,356,51,27,,78,"(4.697144,-74.140516)"
2017,Enero,India,356,2,0,,2,"(4.815061,-75.736532)"
2017,Enero,India,356,6,4,,10,"(6.171601,-75.427454)"
2017,Enero,Indonesia,360,3,2,,5,"(3.541112,-76.384584)"
2017,Enero,Indonesia,360,5,11,,16,"(4.697144,-74.140516)"
2017,Enero,Indonesia,360,0,1,,1,"(6.171601,-75.427454)"
2017,Enero,Iraq,368,3,7,,10,"(4.697144,-74.140516)"
2017,Enero,Irán,364,3,7,,10,"(4.697144,-74.140516)"
2017,Enero,República de Irlanda,372,3,1,,4,"(3.541112,-76.384584)"
2017,Enero,República de Irlanda,372,22,19,,41,"(4.697144,-74.140516)"
2017,Enero,República de Irlanda,372,3,2,,5,"(6.171601,-75.427454)"
2017,Enero,Islandia,352,3,3,,6,"(4.697144,-74.140516)"
2017,Enero,Islas Pitcairn/Territorio Británico de Ultramar,612,0,1,,1,"(10.408582,-75.538003)"
2017,Enero,Israel,376,2,0,,2,"(10.886611,-74.776708)"
2017,Enero,Israel,376,20,12,,32,"(3.541112,-76.384584)"
2017,Enero,Israel,376,90,115,,205,"(4.697144,-74.140516)"
2017,Enero,Israel,376,13,8,,21,"(6.171601,-75.427454)"
2017,Enero,Italia,380,3,1,,4,"(10.445761,-75.516429)"
2017,Enero,Italia,380,6,4,,10,"(10.886611,-74.776708)"
2017,Enero,Italia,380,1,0,,1,"(12.586067,-81.702563)"
2017,Enero,Italia,380,246,108,,354,"(3.541112,-76.384584)"
2017,Enero,Italia,380,757,471,,1228,"(4.697144,-74.140516)"
2017,Enero,Italia,380,4,0,,4,"(4.815061,-75.736532)"
2017,Enero,Italia,380,85,45,,130,"(6.171601,-75.427454)"
2017,Enero,Jamaica,388,3044,2424,,5468,"(10.408582,-75.538003)"
2017,Enero,Jamaica,388,4,7,,11,"(10.445761,-75.516429)"
2017,Enero,Jamaica,388,3,3,,6,"(10.886611,-74.776708)"
2017,Enero,Jamaica,388,2,2,,4,"(12.586067,-81.702563)"
2017,Enero,Jamaica,388,10,3,,13,"(3.541112,-76.384584)"
2017,Enero,Jamaica,388,29,33,,62,"(4.697144,-74.140516)"
2017,Enero,Jamaica,388,3,8,,11,"(4.815061,-75.736532)"
2017,Enero,Jamaica,388,13,13,,26,"(6.171601,-75.427454)"
2017,Enero,Japón,392,1,0,,1,"(10.886611,-74.776708)"
2017,Enero,Japón,392,15,9,,24,"(3.541112,-76.384584)"
2017,Enero,Japón,392,59,64,,123,"(4.697144,-74.140516)"
2017,Enero,Japón,392,10,5,,15,"(6.171601,-75.427454)"
2017,Enero,Japón,392,0,1,,1,"(7.128456,-73.183637)"
2017,Enero,Jordania,400,1,1,,2,"(4.697144,-74.140516)"
2017,Enero,Jordania,400,1,0,,1,"(6.171601,-75.427454)"
2017,Enero,Kazajistán,398,2,2,,4,"(3.541112,-76.384584)"
2017,Enero,Kazajistán,398,6,10,,16,"(4.697144,-74.140516)"
2017,Enero,Kenia,404,0,1,,1,"(10.886611,-74.776708)"
2017,Enero,Kenia,404,1,0,,1,"(3.541112,-76.384584)"
2017,Enero,Kenia,404,5,3,,8,"(4.697144,-74.140516)"
2017,Enero,Kuwait,414,3,2,,5,"(10.886611,-74.776708)"
2017,Enero,Kuwait,414,2,6,,8,"(4.697144,-74.140516)"
2017,Enero,Kuwait,414,1,0,,1,"(6.171601,-75.427454)"
2017,Enero,Kuwait,414,1,0,,1,"(7.128456,-73.183637)"
2017,Enero,República Democrática Popular  Lao,418,0,1,,1,"(4.697144,-74.140516)"
2017,Enero,Letonia,428,0,1,,1,"(4.697144,-74.140516)"
2017,Enero,Lituania,440,0,7,,7,"(4.697144,-74.140516)"
2017,Enero,Líbano,422,1,1,,2,"(10.886611,-74.776708)"
2017,Enero,Líbano,422,2,0,,2,"(3.541112,-76.384584)"
2017,Enero,Líbano,422,10,15,,25,"(4.697144,-74.140516)"
2017,Enero,Liberia,430,1,0,,1,"(4.697144,-74.140516)"
2017,Enero,Liberia,430,2,1,,3,"(6.171601,-75.427454)"
2017,Enero,Liechtenstein,438,1,0,,1,"(4.697144,-74.140516)"
2017,Enero,Luxemburgo,442,12,8,,20,"(4.697144,-74.140516)"
2017,Enero,Luxemburgo,442,1,0,,1,"(6.171601,-75.427454)"
2017,Enero,Madagascar,450,1,0,,1,"(4.697144,-74.140516)"
2017,Enero,Malasia,458,1,1,,2,"(10.445761,-75.516429)"
2017,Enero,Malasia,458,2,0,,2,"(3.541112,-76.384584)"
2017,Enero,Malasia,458,4,11,,15,"(4.697144,-74.140516)"
2017,Enero,Malasia,458,5,3,,8,"(6.171601,-75.427454)"
2017,Enero,Malawi,454,1,1,,2,"(4.697144,-74.140516)"
2017,Enero,Malí,466,0,1,,1,"(4.697144,-74.140516)"
2017,Enero,Malta,470,2,0,,2,"(3.541112,-76.384584)"
2017,Enero,Malta,470,37,26,,63,"(4.697144,-74.140516)"
2017,Enero,Malta,470,2,0,,2,"(6.171601,-75.427454)"
2017,Enero,Marruecos,504,0,1,,1,"(3.541112,-76.384584)"
2017,Enero,Marruecos,504,6,3,,9,"(4.697144,-74.140516)"
2017,Enero,Mauritania,478,0,1,,1,"(4.697144,-74.140516)"
2017,Enero,Martinica/Departamento de Ultramar Francés,474,1,4,,5,"(10.886611,-74.776708)"
2017,Enero,México,484,67,66,,133,"(10.445761,-75.516429)"
2017,Enero,México,484,121,108,,229,"(10.886611,-74.776708)"
2017,Enero,México,484,11,7,,18,"(12.586067,-81.702563)"
2017,Enero,México,484,596,593,,1189,"(3.541112,-76.384584)"
2017,Enero,México,484,16805,15021,,31826,"(4.697144,-74.140516)"
2017,Enero,México,484,119,92,,211,"(4.815061,-75.736532)"
2017,Enero,México,484,2227,1890,,4117,"(6.171601,-75.427454)"
2017,Enero,México,484,58,43,,101,"(7.128456,-73.183637)"
2017,Enero,Mayotte/Colectividad Territorial Francesa,175,0,1,,1,"(4.697144,-74.140516)"
2017,Enero,Mongolia,496,0,1,,1,"(4.697144,-74.140516)"
2017,Enero,Mozambique,508,1,1,,2,"(4.697144,-74.140516)"
2017,Enero,Myanmar,104,0,3,,3,"(4.697144,-74.140516)"
2017,Enero,Namibia,516,0,1,,1,"(4.697144,-74.140516)"
2017,Enero,Nicaragua,558,2,3,,5,"(10.445761,-75.516429)"
2017,Enero,Nicaragua,558,4,4,,8,"(10.886611,-74.776708)"
2017,Enero,Nicaragua,558,3,5,,8,"(12.586067,-81.702563)"
2017,Enero,Nicaragua,558,31,66,,97,"(3.541112,-76.384584)"
2017,Enero,Nicaragua,558,67,99,,166,"(4.697144,-74.140516)"
2017,Enero,Nicaragua,558,4,10,,14,"(4.815061,-75.736532)"
2017,Enero,Nicaragua,558,16,59,,75,"(6.171601,-75.427454)"
2017,Enero,Nicaragua,558,0,2,,2,"(7.128456,-73.183637)"
2017,Enero,Nigeria,566,4,17,,21,"(4.697144,-74.140516)"
2017,Enero,Níger,562,0,1,,1,"(4.697144,-74.140516)"
2017,Enero,Noruega,578,1,1,,2,"(10.445761,-75.516429)"
2017,Enero,Noruega,578,3,1,,4,"(10.886611,-74.776708)"
2017,Enero,Noruega,578,7,6,,13,"(3.541112,-76.384584)"
2017,Enero,Noruega,578,33,27,,60,"(4.697144,-74.140516)"
2017,Enero,Noruega,578,8,5,,13,"(6.171601,-75.427454)"
2017,Enero,Nueva Caledonia/Territorio francés,540,1,0,,1,"(4.697144,-74.140516)"
2017,Enero,Nueva Zelanda,554,2,0,,2,"(10.886611,-74.776708)"
2017,Enero,Nueva Zelanda,554,3,4,,7,"(3.541112,-76.384584)"
2017,Enero,Nueva Zelanda,554,51,47,,98,"(4.697144,-74.140516)"
2017,Enero,Nueva Zelanda,554,12,9,,21,"(6.171601,-75.427454)"
2017,Enero,Omán,512,0,1,,1,"(10.886611,-74.776708)"
2017,Enero,Omán,512,7,8,,15,"(4.697144,-74.140516)"
2017,Enero,Omán,512,1,1,,2,"(6.171601,-75.427454)"
2017,Enero,Papúa Nueva Guinea,598,0,1,,1,"(4.697144,-74.140516)"
2017,Enero,Pakistán,586,0,2,,2,"(4.697144,-74.140516)"
2017,Enero,Panamá,591,15,75,,90,"(10.408582,-75.538003)"
2017,Enero,Panamá,591,999,821,,1820,"(10.445761,-75.516429)"
2017,Enero,Panamá,591,1099,891,,1990,"(10.886611,-74.776708)"
2017,Enero,Panamá,591,0,2,,2,"(10.971302,-74.765397)"
2017,Enero,Panamá,591,1,9,,10,"(11.117806,-74.232622)"
2017,Enero,Panamá,591,1,7,,8,"(12.5744111,-81.703935)"
2017,Enero,Panamá,591,97,92,,189,"(12.586067,-81.702563)"
2017,Enero,Panamá,591,2728,2160,,4888,"(3.541112,-76.384584)"
2017,Enero,Panamá,591,593,419,,1012,"(4.452882,-75.766298)"
2017,Enero,Panamá,591,10313,10763,,21076,"(4.697144,-74.140516)"
2017,Enero,Panamá,591,630,415,,1045,"(4.815061,-75.736532)"
2017,Enero,Panamá,591,4462,4259,,8721,"(6.171601,-75.427454)"
2017,Enero,Panamá,591,1,13,,14,"(6.228046,-77.404104)"
2017,Enero,Panamá,591,17,17,,34,"(7.102626,-77.762647)"
2017,Enero,Panamá,591,245,228,,473,"(7.128456,-73.183637)"
2017,Enero,Panamá,591,43,84,,127,"(8.635765,-77.346578)"
2017,Enero,Paraguay,600,0,3,,3,"(10.445761,-75.516429)"
2017,Enero,Paraguay,600,3,3,,6,"(10.886611,-74.776708)"
2017,Enero,Paraguay,600,21,34,,55,"(3.541112,-76.384584)"
2017,Enero,Paraguay,600,58,159,,217,"(4.697144,-74.140516)"
2017,Enero,Paraguay,600,5,12,,17,"(4.815061,-75.736532)"
2017,Enero,Paraguay,600,10,15,,25,"(6.171601,-75.427454)"
2017,Enero,Perú,604,0,1,,1,"(-0.193180,-74.784874)"
2017,Enero,Perú,604,112,154,,266,"(-4.197703,-69.941278)"
2017,Enero,Perú,604,101,161,,262,"(0.814836,-77.662532)"
2017,Enero,Perú,604,0,4,,4,"(1.813928,-78.763924)"
2017,Enero,Perú,604,46,48,,94,"(10.445761,-75.516429)"
2017,Enero,Perú,604,13,11,,24,"(10.886611,-74.776708)"
2017,Enero,Perú,604,0,2,,2,"(12.586067,-81.702563)"
2017,Enero,Perú,604,296,356,,652,"(3.541112,-76.384584)"
2017,Enero,Perú,604,6078,6808,,12886,"(4.697144,-74.140516)"
2017,Enero,Perú,604,9,6,,15,"(4.815061,-75.736532)"
2017,Enero,Perú,604,435,429,,864,"(6.171601,-75.427454)"
2017,Enero,Perú,604,8,5,,13,"(7.128456,-73.183637)"
2017,Enero,Palestina,99999,0,1,,1,"(4.697144,-74.140516)"
2017,Enero,Polonia,616,1,0,,1,"(3.541112,-76.384584)"
2017,Enero,Polonia,616,14,18,,32,"(4.697144,-74.140516)"
2017,Enero,Portugal,620,0,1,,1,"(10.445761,-75.516429)"
2017,Enero,Portugal,620,4,8,,12,"(3.541112,-76.384584)"
2017,Enero,Portugal,620,61,69,,130,"(4.697144,-74.140516)"
2017,Enero,Portugal,620,8,1,,9,"(6.171601,-75.427454)"
2017,Enero,Puerto Rico/Territorio de Estados Unidos,630,24,24,,48,"(10.445761,-75.516429)"
2017,Enero,Puerto Rico/Territorio de Estados Unidos,630,18,22,,40,"(10.886611,-74.776708)"
2017,Enero,Puerto Rico/Territorio de Estados Unidos,630,1,1,,2,"(12.586067,-81.702563)"
2017,Enero,Puerto Rico/Territorio de Estados Unidos,630,45,30,,75,"(3.541112,-76.384584)"
2017,Enero,Puerto Rico/Territorio de Estados Unidos,630,787,715,,1502,"(4.697144,-74.140516)"
2017,Enero,Puerto Rico/Territorio de Estados Unidos,630,20,9,,29,"(4.815061,-75.736532)"
2017,Enero,Puerto Rico/Territorio de Estados Unidos,630,50,58,,108,"(6.171601,-75.427454)"
2017,Enero,Puerto Rico/Territorio de Estados Unidos,630,13,11,,24,"(7.128456,-73.183637)"
2017,Enero,Qatar,634,5,4,,9,"(3.541112,-76.384584)"
2017,Enero,Qatar,634,15,9,,24,"(4.697144,-74.140516)"
2017,Enero,Qatar,634,4,4,,8,"(6.171601,-75.427454)"
2017,Enero,Reino Unido de Gran Bretaña e Irlanda del Norte,826,3,1,,4,"(10.445761,-75.516429)"
2017,Enero,Reino Unido de Gran Bretaña e Irlanda del Norte,826,2,0,,2,"(10.886611,-74.776708)"
2017,Enero,Reino Unido de Gran Bretaña e Irlanda del Norte,826,124,114,,238,"(3.541112,-76.384584)"
2017,Enero,Reino Unido de Gran Bretaña e Irlanda del Norte,826,2460,1980,,4440,"(4.697144,-74.140516)"
2017,Enero,Reino Unido de Gran Bretaña e Irlanda del Norte,826,40,32,,72,"(6.171601,-75.427454)"
2017,Enero,República CentroÁfricana,140,5,2,,7,"(4.697144,-74.140516)"
2017,Enero,Federación de Rusia,643,1,3,,4,"(3.541112,-76.384584)"
2017,Enero,Federación de Rusia,643,17,31,,48,"(4.697144,-74.140516)"
2017,Enero,Federación de Rusia,643,0,3,,3,"(6.171601,-75.427454)"
2017,Enero,República Dominicana,214,0,3,,3,"(10.408582,-75.538003)"
2017,Enero,República Dominicana,214,22,39,,61,"(10.445761,-75.516429)"
2017,Enero,República Dominicana,214,54,56,,110,"(10.886611,-74.776708)"
2017,Enero,República Dominicana,214,0,1,,1,"(12.586067,-81.702563)"
2017,Enero,República Dominicana,214,94,88,,182,"(3.541112,-76.384584)"
2017,Enero,República Dominicana,214,3641,3441,,7082,"(4.697144,-74.140516)"
2017,Enero,República Dominicana,214,53,46,,99,"(4.815061,-75.736532)"
2017,Enero,República Dominicana,214,384,301,,685,"(6.171601,-75.427454)"
2017,Enero,República Dominicana,214,40,31,,71,"(7.128456,-73.183637)"
2017,Enero,Reunión,638,0,2,,2,"(4.697144,-74.140516)"
2017,Enero,Rumania,642,0,1,,1,"(3.541112,-76.384584)"
2017,Enero,Rumania,642,2,4,,6,"(4.697144,-74.140516)"
2017,Enero,Rumania,642,1,1,,2,"(6.171601,-75.427454)"
2017,Enero,Rwanda,646,0,1,,1,"(4.697144,-74.140516)"
2017,Enero,San Marino,674,1,4,,5,"(4.697144,-74.140516)"
2017,Enero,San  Vicente y las Granadinas,670,1,0,,1,"(10.445761,-75.516429)"
2017,Enero,San  Vicente y las Granadinas,670,1,0,,1,"(4.697144,-74.140516)"
2017,Enero,Santa Lucia,662,1,0,,1,"(10.445761,-75.516429)"
2017,Enero,Santa Lucia,662,1,0,,1,"(10.886611,-74.776708)"
2017,Enero,Santa Lucia,662,0,3,,3,"(3.541112,-76.384584)"
2017,Enero,Santa Lucia,662,1,0,,1,"(4.697144,-74.140516)"
2017,Enero,Senegal,686,2,1,,3,"(3.541112,-76.384584)"
2017,Enero,Senegal,686,0,1,,1,"(4.697144,-74.140516)"
2017,Enero,Singapur,702,2,1,,3,"(10.886611,-74.776708)"
2017,Enero,Singapur,702,2,1,,3,"(3.541112,-76.384584)"
2017,Enero,Singapur,702,11,17,,28,"(4.697144,-74.140516)"
2017,Enero,Singapur,702,2,2,,4,"(6.171601,-75.427454)"
2017,Enero,Sri Lanka,144,1,1,,2,"(4.697144,-74.140516)"
2017,Enero,Sudáfrica,710,1,0,,1,"(10.445761,-75.516429)"
2017,Enero,Sudáfrica,710,3,2,,5,"(3.541112,-76.384584)"
2017,Enero,Sudáfrica,710,18,22,,40,"(4.697144,-74.140516)"
2017,Enero,Sudáfrica,710,0,3,,3,"(6.171601,-75.427454)"
2017,Enero,Sudán,736,0,1,,1,"(3.541112,-76.384584)"
2017,Enero,Sudán,736,1,2,,3,"(4.697144,-74.140516)"
2017,Enero,Suecia,752,5,1,,6,"(10.445761,-75.516429)"
2017,Enero,Suecia,752,7,5,,12,"(10.886611,-74.776708)"
2017,Enero,Suecia,752,46,35,,81,"(3.541112,-76.384584)"
2017,Enero,Suecia,752,148,117,,265,"(4.697144,-74.140516)"
2017,Enero,Suecia,752,1,1,,2,"(4.815061,-75.736532)"
2017,Enero,Suecia,752,22,18,,40,"(6.171601,-75.427454)"
2017,Enero,Suiza,756,1,1,,2,"(10.445761,-75.516429)"
2017,Enero,Suiza,756,4,4,,8,"(10.886611,-74.776708)"
2017,Enero,Suiza,756,138,88,,226,"(3.541112,-76.384584)"
2017,Enero,Suiza,756,404,241,,645,"(4.697144,-74.140516)"
2017,Enero,Suiza,756,38,22,,60,"(6.171601,-75.427454)"
2017,Enero,Surinam,740,0,1,,1,"(10.408582,-75.538003)"
2017,Enero,Surinam,740,4,2,,6,"(4.697144,-74.140516)"
2017,Enero,Surinam,740,2,2,,4,"(6.171601,-75.427454)"
2017,Enero,Taiwán,158,4,5,,9,"(4.697144,-74.140516)"
2017,Enero,Taiwán,158,0,2,,2,"(6.171601,-75.427454)"
2017,Enero,Tailandia,764,20,30,,50,"(4.697144,-74.140516)"
2017,Enero,Tailandia,764,2,3,,5,"(6.171601,-75.427454)"
2017,Enero,Tanzania,834,0,3,,3,"(4.697144,-74.140516)"
2017,Enero,Trinidad y Tobago,780,1,2,,3,"(10.445761,-75.516429)"
2017,Enero,Trinidad y Tobago,780,6,8,,14,"(10.886611,-74.776708)"
2017,Enero,Trinidad y Tobago,780,3,50,,53,"(3.541112,-76.384584)"
2017,Enero,Trinidad y Tobago,780,34,29,,63,"(4.697144,-74.140516)"
2017,Enero,Trinidad y Tobago,780,5,6,,11,"(4.815061,-75.736532)"
2017,Enero,Trinidad y Tobago,780,14,10,,24,"(6.171601,-75.427454)"
2017,Enero,Trinidad y Tobago,780,3,1,,4,"(7.128456,-73.183637)"
2017,Enero,Túnez,788,1,5,,6,"(4.697144,-74.140516)"
2017,Enero,Turquía,792,4,2,,6,"(3.541112,-76.384584)"
2017,Enero,Turquía,792,161,147,,308,"(4.697144,-74.140516)"
2017,Enero,Turquía,792,2,0,,2,"(6.171601,-75.427454)"
2017,Enero,Turkmenistán,795,4,2,,6,"(4.697144,-74.140516)"
2017,Enero,Turkmenistán,795,0,1,,1,"(6.171601,-75.427454)"
2017,Enero,Ucrania,804,2,3,,5,"(4.697144,-74.140516)"
2017,Enero,Ucrania,804,1,0,,1,"(6.171601,-75.427454)"
2017,Enero,Uganda,800,2,0,,2,"(4.697144,-74.140516)"
2017,Enero,Uruguay,858,1,3,,4,"(10.445761,-75.516429)"
2017,Enero,Uruguay,858,6,3,,9,"(10.886611,-74.776708)"
2017,Enero,Uruguay,858,11,25,,36,"(3.541112,-76.384584)"
2017,Enero,Uruguay,858,118,171,,289,"(4.697144,-74.140516)"
2017,Enero,Uruguay,858,5,15,,20,"(4.815061,-75.736532)"
2017,Enero,Uruguay,858,37,21,,58,"(6.171601,-75.427454)"
2017,Enero,Venezuela,862,16,14,,30,"(10.445761,-75.516429)"
2017,Enero,Venezuela,862,21,28,,49,"(10.886611,-74.776708)"
2017,Enero,Venezuela,862,3969,3339,,7308,"(11.360009,-72.129330)"
2017,Enero,Venezuela,862,1,1,,2,"(12.586067,-81.702563)"
2017,Enero,Venezuela,862,13,17,,30,"(3.541112,-76.384584)"
2017,Enero,Venezuela,862,12,19,,31,"(3.866713,-67.927521)"
2017,Enero,Venezuela,862,2305,1863,,4168,"(4.697144,-74.140516)"
2017,Enero,Venezuela,862,9,6,,15,"(4.815061,-75.736532)"
2017,Enero,Venezuela,862,780,672,,1452,"(6.171601,-75.427454)"
2017,Enero,Venezuela,862,190,145,,335,"(6.185799,-67.483929)"
2017,Enero,Venezuela,862,885,751,,1636,"(7.088729,-70.740253)"
2017,Enero,Venezuela,862,3,6,,9,"(7.128456,-73.183637)"
2017,Enero,Venezuela,862,4249,4143,,8392,"(7.818934,-72.453226)"
2017,Enero,Venezuela,862,164,183,,347,"(8.36068,-72.409396)"
2017,Enero,Vietnam,704,1,0,,1,"(3.541112,-76.384584)"
2017,Enero,Vietnam,704,3,5,,8,"(4.697144,-74.140516)"
2017,Enero,Islas Vírgenes Británicas/Territorio Británico de Ultramar,92,1,0,,1,"(3.541112,-76.384584)"
2017,Enero,Islas Vírgenes Británicas/Territorio Británico de Ultramar,92,1,1,,2,"(4.697144,-74.140516)"
2017,Febrero,Afganistán,4,0,4,,4,"(4.697144,-74.140516)"
2017,Febrero,Albania,8,0,5,,5,"(4.697144,-74.140516)"
2017,Febrero,Albania,8,1,0,,1,"(6.171601,-75.427454)"
2017,Febrero,Alemania,276,2,0,,2,"(0.814836,-77.662532)"
2017,Febrero,Alemania,276,1,2,,3,"(10.445761,-75.516429)"
2017,Febrero,Alemania,276,6,4,,10,"(10.886611,-74.776708)"
2017,Febrero,Alemania,276,78,59,,137,"(3.541112,-76.384584)"
2017,Febrero,Alemania,276,853,807,,1660,"(4.697144,-74.140516)"
2017,Febrero,Alemania,276,2,0,,2,"(4.815061,-75.736532)"
2017,Febrero,Alemania,276,60,54,,114,"(6.171601,-75.427454)"
2017,Febrero,Andorra,20,2,0,,2,"(10.408582,-75.538003)"
2017,Febrero,Angola,24,3,5,,8,"(4.697144,-74.140516)"
2017,Febrero,Antigua y Barbuda,28,1,0,,1,"(4.697144,-74.140516)"
2017,Febrero,Países Bajos,528,1,0,,1,"(10.445761,-75.516429)"
2017,Febrero,Países Bajos,528,28,17,,45,"(10.886611,-74.776708)"
2017,Febrero,Países Bajos,528,146,80,,226,"(3.541112,-76.384584)"
2017,Febrero,Países Bajos,528,653,574,,1227,"(4.697144,-74.140516)"
2017,Febrero,Países Bajos,528,4,3,,7,"(4.815061,-75.736532)"
2017,Febrero,Países Bajos,528,61,54,,115,"(6.171601,-75.427454)"
2017,Febrero,Países Bajos,528,2,3,,5,"(7.128456,-73.183637)"
2017,Febrero,Arabia Saudita,682,1,2,,3,"(3.541112,-76.384584)"
2017,Febrero,Arabia Saudita,682,2,18,,20,"(4.697144,-74.140516)"
2017,Febrero,Arabia Saudita,682,1,1,,2,"(6.171601,-75.427454)"
2017,Febrero,Arabia Saudita,682,0,2,,2,"(7.128456,-73.183637)"
2017,Febrero,Argelia,12,3,2,,5,"(4.697144,-74.140516)"
2017,Febrero,Argentina,32,0,1,,1,"(-4.197703,-69.941278)"
2017,Febrero,Argentina,32,36,37,,73,"(0.814836,-77.662532)"
2017,Febrero,Argentina,32,9,11,,20,"(10.445761,-75.516429)"
2017,Febrero,Argentina,32,11,6,,17,"(10.886611,-74.776708)"
2017,Febrero,Argentina,32,0,2,,2,"(12.586067,-81.702563)"
2017,Febrero,Argentina,32,121,101,,222,"(3.541112,-76.384584)"
2017,Febrero,Argentina,32,3036,2645,,5681,"(4.697144,-74.140516)"
2017,Febrero,Argentina,32,10,12,,22,"(4.815061,-75.736532)"
2017,Febrero,Argentina,32,93,88,,181,"(6.171601,-75.427454)"
2017,Febrero,Argentina,32,1,2,,3,"(7.128456,-73.183637)"
2017,Febrero,Aruba,533,43,28,,71,"(10.408582,-75.538003)"
2017,Febrero,Aruba,533,4,3,,7,"(10.445761,-75.516429)"
2017,Febrero,Aruba,533,22,21,,43,"(10.886611,-74.776708)"
2017,Febrero,Aruba,533,3,4,,7,"(11.117806,-74.232622)"
2017,Febrero,Aruba,533,0,2,,2,"(11.247723,-74.213989)"
2017,Febrero,Aruba,533,30,10,,40,"(3.541112,-76.384584)"
2017,Febrero,Aruba,533,1317,1036,,2353,"(4.697144,-74.140516)"
2017,Febrero,Aruba,533,19,9,,28,"(4.815061,-75.736532)"
2017,Febrero,Aruba,533,61,37,,98,"(6.171601,-75.427454)"
2017,Febrero,Aruba,533,14,44,,58,"(7.128456,-73.183637)"
2017,Febrero,Australia,36,4,4,,8,"(10.886611,-74.776708)"
2017,Febrero,Australia,36,30,23,,53,"(3.541112,-76.384584)"
2017,Febrero,Australia,36,421,306,,727,"(4.697144,-74.140516)"
2017,Febrero,Australia,36,2,2,,4,"(4.815061,-75.736532)"
2017,Febrero,Australia,36,88,56,,144,"(6.171601,-75.427454)"
2017,Febrero,Australia,36,4,3,,7,"(7.128456,-73.183637)"
2017,Febrero,Austria,40,1,5,,6,"(3.541112,-76.384584)"
2017,Febrero,Austria,40,39,28,,67,"(4.697144,-74.140516)"
2017,Febrero,Austria,40,1,2,,3,"(6.171601,-75.427454)"
2017,Febrero,Azerbaiyán,31,0,3,,3,"(4.697144,-74.140516)"
2017,Febrero,Bahamas,44,0,1,,1,"(10.445761,-75.516429)"
2017,Febrero,Bahamas,44,2,0,,2,"(10.886611,-74.776708)"
2017,Febrero,Bahamas,44,7,1,,8,"(3.541112,-76.384584)"
2017,Febrero,Bahamas,44,7,13,,20,"(4.697144,-74.140516)"
2017,Febrero,Bahamas,44,4,1,,5,"(4.815061,-75.736532)"
2017,Febrero,Bahamas,44,6,27,,33,"(6.171601,-75.427454)"
2017,Febrero,Bahréin,48,1,0,,1,"(3.541112,-76.384584)"
2017,Febrero,Bahréin,48,1,2,,3,"(6.171601,-75.427454)"
2017,Febrero,Bangladesh,50,1,0,,1,"(4.697144,-74.140516)"
2017,Febrero,Barbados,52,72,67,,139,"(4.697144,-74.140516)"
2017,Febrero,Barbados,52,0,1,,1,"(6.171601,-75.427454)"
2017,Febrero,Bélgica,56,15,16,,31,"(3.541112,-76.384584)"
2017,Febrero,Bélgica,56,61,42,,103,"(4.697144,-74.140516)"
2017,Febrero,Bélgica,56,22,6,,28,"(6.171601,-75.427454)"
2017,Febrero,Belice,84,3,1,,4,"(3.541112,-76.384584)"
2017,Febrero,Belice,84,1,5,,6,"(4.697144,-74.140516)"
2017,Febrero,Belice,84,1,2,,3,"(4.815061,-75.736532)"
2017,Febrero,Belice,84,1,1,,2,"(6.171601,-75.427454)"
2017,Febrero,Benín,204,1,0,,1,"(4.697144,-74.140516)"
2017,Febrero,Bermudas/Territorio Británico de Ultramar,60,3,0,,3,"(4.697144,-74.140516)"
2017,Febrero,Bolivia,68,4,13,,17,"(0.814836,-77.662532)"
2017,Febrero,Bolivia,68,1,1,,2,"(1.813928,-78.763924)"
2017,Febrero,Bolivia,68,4,1,,5,"(10.445761,-75.516429)"
2017,Febrero,Bolivia,68,3,6,,9,"(10.886611,-74.776708)"
2017,Febrero,Bolivia,68,25,48,,73,"(3.541112,-76.384584)"
2017,Febrero,Bolivia,68,292,504,,796,"(4.697144,-74.140516)"
2017,Febrero,Bolivia,68,16,27,,43,"(4.815061,-75.736532)"
2017,Febrero,Bolivia,68,33,43,,76,"(6.171601,-75.427454)"
2017,Febrero,Bolivia,68,1,4,,5,"(7.128456,-73.183637)"
2017,Febrero,Bosnia y Herzegovina,70,7,1,,8,"(4.697144,-74.140516)"
2017,Febrero,Brasil,76,167,296,,463,"(-4.197703,-69.941278)"
2017,Febrero,Brasil,76,3,3,,6,"(-4.223468,-69.945098)"
2017,Febrero,Brasil,76,1,3,,4,"(0.814836,-77.662532)"
2017,Febrero,Brasil,76,9,17,,26,"(10.445761,-75.516429)"
2017,Febrero,Brasil,76,7,17,,24,"(10.886611,-74.776708)"
2017,Febrero,Brasil,76,2,2,,4,"(12.586067,-81.702563)"
2017,Febrero,Brasil,76,126,159,,285,"(3.541112,-76.384584)"
2017,Febrero,Brasil,76,2346,3106,,5452,"(4.697144,-74.140516)"
2017,Febrero,Brasil,76,19,40,,59,"(4.815061,-75.736532)"
2017,Febrero,Brasil,76,165,185,,350,"(6.171601,-75.427454)"
2017,Febrero,Brasil,76,8,8,,16,"(7.128456,-73.183637)"
2017,Febrero,Bulgaria,100,3,5,,8,"(4.697144,-74.140516)"
2017,Febrero,Bulgaria,100,1,0,,1,"(6.171601,-75.427454)"
2017,Febrero,Burundi,108,0,1,,1,"(4.697144,-74.140516)"
2017,Febrero,Islas Caimán/Territorio Británico de Ultramar,136,1,0,,1,"(10.886611,-74.776708)"
2017,Febrero,Islas Caimán/Territorio Británico de Ultramar,136,4,1,,5,"(12.586067,-81.702563)"
2017,Febrero,Islas Caimán/Territorio Británico de Ultramar,136,1,0,,1,"(3.541112,-76.384584)"
2017,Febrero,Islas Caimán/Territorio Británico de Ultramar,136,2,2,,4,"(4.697144,-74.140516)"
2017,Febrero,Islas Caimán/Territorio Británico de Ultramar,136,2,0,,2,"(6.171601,-75.427454)"
2017,Febrero,Camboya,116,1,0,,1,"(4.697144,-74.140516)"
2017,Febrero,Camerún,120,2,3,,5,"(4.697144,-74.140516)"
2017,Febrero,Camerún,120,0,1,,1,"(6.171601,-75.427454)"
2017,Febrero,Canadá,124,74,50,,124,"(10.445761,-75.516429)"
2017,Febrero,Canadá,124,19,19,,38,"(10.886611,-74.776708)"
2017,Febrero,Canadá,124,5,2,,7,"(12.586067,-81.702563)"
2017,Febrero,Canadá,124,116,106,,222,"(3.541112,-76.384584)"
2017,Febrero,Canadá,124,1355,1193,,2548,"(4.697144,-74.140516)"
2017,Febrero,Canadá,124,13,10,,23,"(4.815061,-75.736532)"
2017,Febrero,Canadá,124,232,176,,408,"(6.171601,-75.427454)"
2017,Febrero,Canadá,124,11,9,,20,"(7.128456,-73.183637)"
2017,Febrero,Chad,148,1,0,,1,"(4.697144,-74.140516)"
2017,Febrero,España,724,2,1,,3,"(10.445761,-75.516429)"
2017,Febrero,España,724,7,4,,11,"(10.886611,-74.776708)"
2017,Febrero,España,724,1,0,,1,"(12.586067,-81.702563)"
2017,Febrero,España,724,3077,2033,,5110,"(3.541112,-76.384584)"
2017,Febrero,España,724,8359,6489,,14848,"(4.697144,-74.140516)"
2017,Febrero,España,724,19,21,,40,"(4.815061,-75.736532)"
2017,Febrero,España,724,1098,843,,1941,"(6.171601,-75.427454)"
2017,Febrero,Colombia,170,2,11,,13,"(10.445761,-75.516429)"
2017,Febrero,Colombia,170,97,296,,393,"(4.697144,-74.140516)"
2017,Febrero,República Del Congo,178,0,1,,1,"(4.697144,-74.140516)"
2017,Febrero,República de Corea,410,20,19,,39,"(4.697144,-74.140516)"
2017,Febrero,República de Corea,410,3,3,,6,"(6.171601,-75.427454)"
2017,Febrero,Islas Malvinas,238,1,0,,1,"(4.697144,-74.140516)"
2017,Febrero,Costa de Marfil,384,2,6,,8,"(4.697144,-74.140516)"
2017,Febrero,Costa de Marfil,384,2,0,,2,"(6.171601,-75.427454)"
2017,Febrero,Costa Rica,188,9,18,,27,"(10.445761,-75.516429)"
2017,Febrero,Costa Rica,188,24,33,,57,"(10.886611,-74.776708)"
2017,Febrero,Costa Rica,188,3,25,,28,"(12.5744111,-81.703935)"
2017,Febrero,Costa Rica,188,22,22,,44,"(12.586067,-81.702563)"
2017,Febrero,Costa Rica,188,47,40,,87,"(3.541112,-76.384584)"
2017,Febrero,Costa Rica,188,915,1135,,2050,"(4.697144,-74.140516)"
2017,Febrero,Costa Rica,188,7,5,,12,"(4.815061,-75.736532)"
2017,Febrero,Costa Rica,188,102,141,,243,"(6.171601,-75.427454)"
2017,Febrero,Costa Rica,188,5,3,,8,"(7.128456,-73.183637)"
2017,Febrero,Croacia,191,2,3,,5,"(4.697144,-74.140516)"
2017,Febrero,Cuba,192,9,8,,17,"(10.445761,-75.516429)"
2017,Febrero,Cuba,192,8,15,,23,"(10.886611,-74.776708)"
2017,Febrero,Cuba,192,2,0,,2,"(12.586067,-81.702563)"
2017,Febrero,Cuba,192,32,30,,62,"(3.541112,-76.384584)"
2017,Febrero,Cuba,192,928,884,,1812,"(4.697144,-74.140516)"
2017,Febrero,Cuba,192,9,9,,18,"(4.815061,-75.736532)"
2017,Febrero,Cuba,192,62,42,,104,"(6.171601,-75.427454)"
2017,Febrero,Cuba,192,4,5,,9,"(7.128456,-73.183637)"
2017,Febrero,Curazao,99999,0,1,,1,"(10.445761,-75.516429)"
2017,Febrero,Curazao,99999,17,38,,55,"(4.697144,-74.140516)"
2017,Febrero,República Checa,203,2,6,,8,"(4.697144,-74.140516)"
2017,Febrero,República Checa,203,1,0,,1,"(6.171601,-75.427454)"
2017,Febrero,Chile,152,495,454,,949,"(0.814836,-77.662532)"
2017,Febrero,Chile,152,0,4,,4,"(1.813928,-78.763924)"
2017,Febrero,Chile,152,17,10,,27,"(10.445761,-75.516429)"
2017,Febrero,Chile,152,27,20,,47,"(10.886611,-74.776708)"
2017,Febrero,Chile,152,2,1,,3,"(12.586067,-81.702563)"
2017,Febrero,Chile,152,342,221,,563,"(3.541112,-76.384584)"
2017,Febrero,Chile,152,3678,3059,,6737,"(4.697144,-74.140516)"
2017,Febrero,Chile,152,79,59,,138,"(4.815061,-75.736532)"
2017,Febrero,Chile,152,98,104,,202,"(6.171601,-75.427454)"
2017,Febrero,Chile,152,8,9,,17,"(7.128456,-73.183637)"
2017,Febrero,China,156,0,3,,3,"(10.886611,-74.776708)"
2017,Febrero,China,156,14,64,,78,"(3.541112,-76.384584)"
2017,Febrero,China,156,187,550,,737,"(4.697144,-74.140516)"
2017,Febrero,China,156,20,64,,84,"(6.171601,-75.427454)"
2017,Febrero,Chipre,196,0,3,,3,"(4.697144,-74.140516)"
2017,Febrero,Dinamarca,208,4,1,,5,"(3.541112,-76.384584)"
2017,Febrero,Dinamarca,208,18,17,,35,"(4.697144,-74.140516)"
2017,Febrero,Dinamarca,208,1,1,,2,"(6.171601,-75.427454)"
2017,Febrero,Ecuador,218,5,9,,14,"(-0.193180,-74.784874)"
2017,Febrero,Ecuador,218,495,744,,1239,"(0.25129,-76.875963)"
2017,Febrero,Ecuador,218,17,26,,43,"(0.812436,-77.847006)"
2017,Febrero,Ecuador,218,5920,7318,,13238,"(0.814836,-77.662532)"
2017,Febrero,Ecuador,218,144,223,,367,"(1.813928,-78.763924)"
2017,Febrero,Ecuador,218,0,10,,10,"(10.408582,-75.538003)"
2017,Febrero,Ecuador,218,8,6,,14,"(10.445761,-75.516429)"
2017,Febrero,Ecuador,218,3,11,,14,"(10.886611,-74.776708)"
2017,Febrero,Ecuador,218,224,279,,503,"(3.541112,-76.384584)"
2017,Febrero,Ecuador,218,2505,3916,,6421,"(4.697144,-74.140516)"
2017,Febrero,Ecuador,218,2,1,,3,"(4.815061,-75.736532)"
2017,Febrero,Ecuador,218,36,60,,96,"(6.171601,-75.427454)"
2017,Febrero,Ecuador,218,2,7,,9,"(7.128456,-73.183637)"
2017,Febrero,Egipto,818,11,12,,23,"(4.697144,-74.140516)"
2017,Febrero,El Salvador,222,0,1,,1,"(10.445761,-75.516429)"
2017,Febrero,El Salvador,222,5,4,,9,"(10.886611,-74.776708)"
2017,Febrero,El Salvador,222,1,1,,2,"(12.586067,-81.702563)"
2017,Febrero,El Salvador,222,86,81,,167,"(3.541112,-76.384584)"
2017,Febrero,El Salvador,222,603,910,,1513,"(4.697144,-74.140516)"
2017,Febrero,El Salvador,222,1,1,,2,"(4.815061,-75.736532)"
2017,Febrero,El Salvador,222,58,71,,129,"(6.171601,-75.427454)"
2017,Febrero,Emiratos Árabes,784,0,1,,1,"(10.445761,-75.516429)"
2017,Febrero,Emiratos Árabes,784,2,5,,7,"(3.541112,-76.384584)"
2017,Febrero,Emiratos Árabes,784,60,208,,268,"(4.697144,-74.140516)"
2017,Febrero,Emiratos Árabes,784,1,0,,1,"(4.815061,-75.736532)"
2017,Febrero,Emiratos Árabes,784,3,4,,7,"(6.171601,-75.427454)"
2017,Febrero,Eritrea,232,2,0,,2,"(4.697144,-74.140516)"
2017,Febrero,Eslovaquia,703,1,0,,1,"(4.697144,-74.140516)"
2017,Febrero,Eslovenia,705,1,0,,1,"(3.541112,-76.384584)"
2017,Febrero,Eslovenia,705,2,2,,4,"(4.697144,-74.140516)"
2017,Febrero,Estados Unidos de América,840,2752,2159,,4911,"(10.445761,-75.516429)"
2017,Febrero,Estados Unidos de América,840,1946,1578,,3524,"(10.886611,-74.776708)"
2017,Febrero,Estados Unidos de América,840,2,0,,2,"(11.360009,-72.129330)"
2017,Febrero,Estados Unidos de América,840,32,32,,64,"(12.586067,-81.702563)"
2017,Febrero,Estados Unidos de América,840,4313,3145,,7458,"(3.541112,-76.384584)"
2017,Febrero,Estados Unidos de América,840,420,342,,762,"(4.452882,-75.766298)"
2017,Febrero,Estados Unidos de América,840,22492,20654,,43146,"(4.697144,-74.140516)"
2017,Febrero,Estados Unidos de América,840,529,431,,960,"(4.815061,-75.736532)"
2017,Febrero,Estados Unidos de América,840,7142,5951,,13093,"(6.171601,-75.427454)"
2017,Febrero,Estados Unidos de América,840,103,70,,173,"(7.128456,-73.183637)"
2017,Febrero,Estonia,233,2,1,,3,"(4.697144,-74.140516)"
2017,Febrero,Etiopia,231,0,2,,2,"(4.697144,-74.140516)"
2017,Febrero,Filipinas,608,4,0,,4,"(3.541112,-76.384584)"
2017,Febrero,Filipinas,608,6,5,,11,"(4.697144,-74.140516)"
2017,Febrero,Finlandia,246,1,0,,1,"(3.541112,-76.384584)"
2017,Febrero,Finlandia,246,7,2,,9,"(4.697144,-74.140516)"
2017,Febrero,Francia,250,2,0,,2,"(10.445761,-75.516429)"
2017,Febrero,Francia,250,4,4,,8,"(10.886611,-74.776708)"
2017,Febrero,Francia,250,104,73,,177,"(3.541112,-76.384584)"
2017,Febrero,Francia,250,1013,812,,1825,"(4.697144,-74.140516)"
2017,Febrero,Francia,250,2,2,,4,"(4.815061,-75.736532)"
2017,Febrero,Francia,250,89,48,,137,"(6.171601,-75.427454)"
2017,Febrero,Ghana,288,0,3,,3,"(4.697144,-74.140516)"
2017,Febrero,Ghana,288,4,1,,5,"(6.171601,-75.427454)"
2017,Febrero,Gibraltar/Territorio Británico de Ultramar,292,2,2,,4,"(0.814836,-77.662532)"
2017,Febrero,Grecia,300,6,9,,15,"(4.697144,-74.140516)"
2017,Febrero,Grecia,300,1,1,,2,"(6.171601,-75.427454)"
2017,Febrero,Guatemala,320,4,3,,7,"(10.445761,-75.516429)"
2017,Febrero,Guatemala,320,7,13,,20,"(10.886611,-74.776708)"
2017,Febrero,Guatemala,320,0,1,,1,"(12.586067,-81.702563)"
2017,Febrero,Guatemala,320,62,99,,161,"(3.541112,-76.384584)"
2017,Febrero,Guatemala,320,427,561,,988,"(4.697144,-74.140516)"
2017,Febrero,Guatemala,320,9,15,,24,"(4.815061,-75.736532)"
2017,Febrero,Guatemala,320,89,108,,197,"(6.171601,-75.427454)"
2017,Febrero,Guatemala,320,7,11,,18,"(7.128456,-73.183637)"
2017,Febrero,Guyana,328,2,2,,4,"(10.886611,-74.776708)"
2017,Febrero,Guyana,328,0,3,,3,"(4.697144,-74.140516)"
2017,Febrero,Guinea,324,1,0,,1,"(3.541112,-76.384584)"
2017,Febrero,Guinea Ecuatorial,226,2,0,,2,"(3.541112,-76.384584)"
2017,Febrero,Guinea Ecuatorial,226,1,2,,3,"(4.697144,-74.140516)"
2017,Febrero,Guadalupe/Territorio Francés,312,1,2,,3,"(4.697144,-74.140516)"
2017,Febrero,Guayana Francesa/Departamento de Ultramar Francés,254,0,1,,1,"(4.697144,-74.140516)"
2017,Febrero,Guayana Francesa/Departamento de Ultramar Francés,254,0,1,,1,"(6.171601,-75.427454)"
2017,Febrero,Haití,332,1,2,,3,"(10.886611,-74.776708)"
2017,Febrero,Haití,332,5,6,,11,"(4.697144,-74.140516)"
2017,Febrero,Haití,332,3,8,,11,"(6.171601,-75.427454)"
2017,Febrero,Honduras,340,2,6,,8,"(10.445761,-75.516429)"
2017,Febrero,Honduras,340,2,5,,7,"(10.886611,-74.776708)"
2017,Febrero,Honduras,340,4,0,,4,"(12.586067,-81.702563)"
2017,Febrero,Honduras,340,9,33,,42,"(3.541112,-76.384584)"
2017,Febrero,Honduras,340,70,118,,188,"(4.697144,-74.140516)"
2017,Febrero,Honduras,340,4,5,,9,"(4.815061,-75.736532)"
2017,Febrero,Honduras,340,33,45,,78,"(6.171601,-75.427454)"
2017,Febrero,Honduras,340,4,10,,14,"(7.128456,-73.183637)"
2017,Febrero,Hong Kong,344,2,3,,5,"(3.541112,-76.384584)"
2017,Febrero,Hong Kong,344,21,55,,76,"(4.697144,-74.140516)"
2017,Febrero,Hong Kong,344,2,4,,6,"(6.171601,-75.427454)"
2017,Febrero,Hungría,348,1,0,,1,"(3.541112,-76.384584)"
2017,Febrero,Hungría,348,9,13,,22,"(4.697144,-74.140516)"
2017,Febrero,India,356,4,4,,8,"(3.541112,-76.384584)"
2017,Febrero,India,356,57,42,,99,"(4.697144,-74.140516)"
2017,Febrero,India,356,1,0,,1,"(4.815061,-75.736532)"
2017,Febrero,India,356,7,5,,12,"(6.171601,-75.427454)"
2017,Febrero,India,356,0,2,,2,"(7.128456,-73.183637)"
2017,Febrero,Indonesia,360,0,1,,1,"(3.541112,-76.384584)"
2017,Febrero,Indonesia,360,7,7,,14,"(4.697144,-74.140516)"
2017,Febrero,Indonesia,360,1,0,,1,"(6.171601,-75.427454)"
2017,Febrero,Iraq,368,0,6,,6,"(4.697144,-74.140516)"
2017,Febrero,Iraq,368,0,1,,1,"(4.815061,-75.736532)"
2017,Febrero,Irán,364,4,6,,10,"(4.697144,-74.140516)"
2017,Febrero,República de Irlanda,372,2,1,,3,"(3.541112,-76.384584)"
2017,Febrero,República de Irlanda,372,10,3,,13,"(4.697144,-74.140516)"
2017,Febrero,Islandia,352,1,0,,1,"(4.697144,-74.140516)"
2017,Febrero,Isla de Man,833,0,1,,1,"(4.697144,-74.140516)"
2017,Febrero,Israel,376,0,1,,1,"(10.445761,-75.516429)"
2017,Febrero,Israel,376,15,11,,26,"(3.541112,-76.384584)"
2017,Febrero,Israel,376,78,53,,131,"(4.697144,-74.140516)"
2017,Febrero,Israel,376,5,5,,10,"(6.171601,-75.427454)"
2017,Febrero,Italia,380,1,0,,1,"(10.445761,-75.516429)"
2017,Febrero,Italia,380,8,3,,11,"(10.886611,-74.776708)"
2017,Febrero,Italia,380,236,98,,334,"(3.541112,-76.384584)"
2017,Febrero,Italia,380,577,336,,913,"(4.697144,-74.140516)"
2017,Febrero,Italia,380,62,42,,104,"(6.171601,-75.427454)"
2017,Febrero,Italia,380,0,1,,1,"(7.128456,-73.183637)"
2017,Febrero,Jamaica,388,1453,1010,,2463,"(10.408582,-75.538003)"
2017,Febrero,Jamaica,388,3,5,,8,"(10.445761,-75.516429)"
2017,Febrero,Jamaica,388,3,7,,10,"(3.541112,-76.384584)"
2017,Febrero,Jamaica,388,15,17,,32,"(4.697144,-74.140516)"
2017,Febrero,Jamaica,388,3,3,,6,"(4.815061,-75.736532)"
2017,Febrero,Jamaica,388,5,3,,8,"(6.171601,-75.427454)"
2017,Febrero,Japón,392,0,2,,2,"(10.886611,-74.776708)"
2017,Febrero,Japón,392,4,3,,7,"(3.541112,-76.384584)"
2017,Febrero,Japón,392,43,31,,74,"(4.697144,-74.140516)"
2017,Febrero,Japón,392,0,5,,5,"(6.171601,-75.427454)"
2017,Febrero,Jordania,400,0,1,,1,"(4.697144,-74.140516)"
2017,Febrero,Kazajistán,398,1,2,,3,"(4.697144,-74.140516)"
2017,Febrero,Kenia,404,2,3,,5,"(4.697144,-74.140516)"
2017,Febrero,Kenia,404,1,0,,1,"(6.171601,-75.427454)"
2017,Febrero,Kuwait,414,1,0,,1,"(4.697144,-74.140516)"
2017,Febrero,Lituania,440,0,9,,9,"(4.697144,-74.140516)"
2017,Febrero,Líbano,422,1,0,,1,"(10.886611,-74.776708)"
2017,Febrero,Líbano,422,7,19,,26,"(4.697144,-74.140516)"
2017,Febrero,Luxemburgo,442,1,6,,7,"(3.541112,-76.384584)"
2017,Febrero,Luxemburgo,442,4,1,,5,"(4.697144,-74.140516)"
2017,Febrero,Luxemburgo,442,1,0,,1,"(4.815061,-75.736532)"
2017,Febrero,Luxemburgo,442,0,2,,2,"(6.171601,-75.427454)"
2017,Febrero,Malasia,458,4,8,,12,"(4.697144,-74.140516)"
2017,Febrero,Malasia,458,1,4,,5,"(6.171601,-75.427454)"
2017,Febrero,Malta,470,2,0,,2,"(3.541112,-76.384584)"
2017,Febrero,Malta,470,18,12,,30,"(4.697144,-74.140516)"
2017,Febrero,Malta,470,3,0,,3,"(6.171601,-75.427454)"
2017,Febrero,Marruecos,504,0,1,,1,"(3.541112,-76.384584)"
2017,Febrero,Marruecos,504,0,1,,1,"(4.697144,-74.140516)"
2017,Febrero,Marruecos,504,2,1,,3,"(6.171601,-75.427454)"
2017,Febrero,Martinica/Departamento de Ultramar Francés,474,2,0,,2,"(3.541112,-76.384584)"
2017,Febrero,Martinica/Departamento de Ultramar Francés,474,1,1,,2,"(4.697144,-74.140516)"
2017,Febrero,México,484,15,14,,29,"(10.445761,-75.516429)"
2017,Febrero,México,484,53,40,,93,"(10.886611,-74.776708)"
2017,Febrero,México,484,2,1,,3,"(12.586067,-81.702563)"
2017,Febrero,México,484,431,383,,814,"(3.541112,-76.384584)"
2017,Febrero,México,484,10107,9739,,19846,"(4.697144,-74.140516)"
2017,Febrero,México,484,69,58,,127,"(4.815061,-75.736532)"
2017,Febrero,México,484,1295,1120,,2415,"(6.171601,-75.427454)"
2017,Febrero,México,484,28,25,,53,"(7.128456,-73.183637)"
2017,Febrero,Mozambique,508,1,1,,2,"(4.697144,-74.140516)"
2017,Febrero,Nepal,524,0,2,,2,"(4.697144,-74.140516)"
2017,Febrero,Nepal,524,0,1,,1,"(6.171601,-75.427454)"
2017,Febrero,Nicaragua,558,0,2,,2,"(10.445761,-75.516429)"
2017,Febrero,Nicaragua,558,2,5,,7,"(10.886611,-74.776708)"
2017,Febrero,Nicaragua,558,3,3,,6,"(12.586067,-81.702563)"
2017,Febrero,Nicaragua,558,18,35,,53,"(3.541112,-76.384584)"
2017,Febrero,Nicaragua,558,43,76,,119,"(4.697144,-74.140516)"
2017,Febrero,Nicaragua,558,2,7,,9,"(4.815061,-75.736532)"
2017,Febrero,Nicaragua,558,15,54,,69,"(6.171601,-75.427454)"
2017,Febrero,Nicaragua,558,1,3,,4,"(7.128456,-73.183637)"
2017,Febrero,Nigeria,566,0,9,,9,"(4.697144,-74.140516)"
2017,Febrero,Noruega,578,1,0,,1,"(10.445761,-75.516429)"
2017,Febrero,Noruega,578,0,1,,1,"(10.886611,-74.776708)"
2017,Febrero,Noruega,578,12,4,,16,"(3.541112,-76.384584)"
2017,Febrero,Noruega,578,9,14,,23,"(4.697144,-74.140516)"
2017,Febrero,Noruega,578,4,2,,6,"(6.171601,-75.427454)"
2017,Febrero,Nueva Zelanda,554,2,4,,6,"(3.541112,-76.384584)"
2017,Febrero,Nueva Zelanda,554,44,39,,83,"(4.697144,-74.140516)"
2017,Febrero,Nueva Zelanda,554,6,2,,8,"(6.171601,-75.427454)"
2017,Febrero,Nueva Zelanda,554,1,0,,1,"(7.128456,-73.183637)"
2017,Febrero,Omán,512,1,5,,6,"(4.697144,-74.140516)"
2017,Febrero,Panamá,591,11,61,,72,"(10.408582,-75.538003)"
2017,Febrero,Panamá,591,541,432,,973,"(10.445761,-75.516429)"
2017,Febrero,Panamá,591,678,705,,1383,"(10.886611,-74.776708)"
2017,Febrero,Panamá,591,3,32,,35,"(12.5744111,-81.703935)"
2017,Febrero,Panamá,591,56,56,,112,"(12.586067,-81.702563)"
2017,Febrero,Panamá,591,1911,1641,,3552,"(3.541112,-76.384584)"
2017,Febrero,Panamá,591,0,1,,1,"(3.893038,-77.067921)"
2017,Febrero,Panamá,591,354,270,,624,"(4.452882,-75.766298)"
2017,Febrero,Panamá,591,6240,7081,,13321,"(4.697144,-74.140516)"
2017,Febrero,Panamá,591,458,344,,802,"(4.815061,-75.736532)"
2017,Febrero,Panamá,591,2549,2456,,5005,"(6.171601,-75.427454)"
2017,Febrero,Panamá,591,1,10,,11,"(6.228046,-77.404104)"
2017,Febrero,Panamá,591,4,13,,17,"(7.102626,-77.762647)"
2017,Febrero,Panamá,591,156,139,,295,"(7.128456,-73.183637)"
2017,Febrero,Panamá,591,0,19,,19,"(8.066966,-76.735404)"
2017,Febrero,Panamá,591,24,64,,88,"(8.635765,-77.346578)"
2017,Febrero,Panamá,591,0,1,,1,"(9.402978,-75.681599)"
2017,Febrero,Paraguay,600,2,1,,3,"(10.445761,-75.516429)"
2017,Febrero,Paraguay,600,1,3,,4,"(10.886611,-74.776708)"
2017,Febrero,Paraguay,600,20,36,,56,"(3.541112,-76.384584)"
2017,Febrero,Paraguay,600,84,218,,302,"(4.697144,-74.140516)"
2017,Febrero,Paraguay,600,11,19,,30,"(4.815061,-75.736532)"
2017,Febrero,Paraguay,600,13,20,,33,"(6.171601,-75.427454)"
2017,Febrero,Perú,604,2,8,,10,"(-0.193180,-74.784874)"
2017,Febrero,Perú,604,159,210,,369,"(-4.197703,-69.941278)"
2017,Febrero,Perú,604,0,2,,2,"(-4.223468,-69.945098)"
2017,Febrero,Perú,604,65,97,,162,"(0.814836,-77.662532)"
2017,Febrero,Perú,604,25,20,,45,"(10.445761,-75.516429)"
2017,Febrero,Perú,604,21,10,,31,"(10.886611,-74.776708)"
2017,Febrero,Perú,604,0,2,,2,"(12.586067,-81.702563)"
2017,Febrero,Perú,604,173,211,,384,"(3.541112,-76.384584)"
2017,Febrero,Perú,604,4154,4772,,8926,"(4.697144,-74.140516)"
2017,Febrero,Perú,604,9,12,,21,"(4.815061,-75.736532)"
2017,Febrero,Perú,604,265,282,,547,"(6.171601,-75.427454)"
2017,Febrero,Perú,604,11,6,,17,"(7.128456,-73.183637)"
2017,Febrero,Polonia,616,0,1,,1,"(3.541112,-76.384584)"
2017,Febrero,Polonia,616,8,12,,20,"(4.697144,-74.140516)"
2017,Febrero,Portugal,620,7,3,,10,"(3.541112,-76.384584)"
2017,Febrero,Portugal,620,41,46,,87,"(4.697144,-74.140516)"
2017,Febrero,Portugal,620,7,6,,13,"(6.171601,-75.427454)"
2017,Febrero,Polinesia Francesa/Colectividad de Ultramar Francesa,258,0,1,,1,"(3.541112,-76.384584)"
2017,Febrero,Polinesia Francesa/Colectividad de Ultramar Francesa,258,2,0,,2,"(4.697144,-74.140516)"
2017,Febrero,Puerto Rico/Territorio de Estados Unidos,630,3,3,,6,"(10.445761,-75.516429)"
2017,Febrero,Puerto Rico/Territorio de Estados Unidos,630,21,17,,38,"(10.886611,-74.776708)"
2017,Febrero,Puerto Rico/Territorio de Estados Unidos,630,24,14,,38,"(3.541112,-76.384584)"
2017,Febrero,Puerto Rico/Territorio de Estados Unidos,630,400,394,,794,"(4.697144,-74.140516)"
2017,Febrero,Puerto Rico/Territorio de Estados Unidos,630,1,1,,2,"(4.815061,-75.736532)"
2017,Febrero,Puerto Rico/Territorio de Estados Unidos,630,31,35,,66,"(6.171601,-75.427454)"
2017,Febrero,Puerto Rico/Territorio de Estados Unidos,630,1,2,,3,"(7.128456,-73.183637)"
2017,Febrero,Qatar,634,4,0,,4,"(3.541112,-76.384584)"
2017,Febrero,Qatar,634,4,3,,7,"(4.697144,-74.140516)"
2017,Febrero,Qatar,634,6,3,,9,"(6.171601,-75.427454)"
2017,Febrero,Reino Unido de Gran Bretaña e Irlanda del Norte,826,0,1,,1,"(10.886611,-74.776708)"
2017,Febrero,Reino Unido de Gran Bretaña e Irlanda del Norte,826,39,30,,69,"(3.541112,-76.384584)"
2017,Febrero,Reino Unido de Gran Bretaña e Irlanda del Norte,826,1174,958,,2132,"(4.697144,-74.140516)"
2017,Febrero,Reino Unido de Gran Bretaña e Irlanda del Norte,826,16,7,,23,"(6.171601,-75.427454)"
2017,Febrero,Reino Unido de Gran Bretaña e Irlanda del Norte,826,1,0,,1,"(7.128456,-73.183637)"
2017,Febrero,Federación de Rusia,643,0,2,,2,"(10.886611,-74.776708)"
2017,Febrero,Federación de Rusia,643,1,3,,4,"(3.541112,-76.384584)"
2017,Febrero,Federación de Rusia,643,30,39,,69,"(4.697144,-74.140516)"
2017,Febrero,República Dominicana,214,11,22,,33,"(10.445761,-75.516429)"
2017,Febrero,República Dominicana,214,35,26,,61,"(10.886611,-74.776708)"
2017,Febrero,República Dominicana,214,8,7,,15,"(11.117806,-74.232622)"
2017,Febrero,República Dominicana,214,1,0,,1,"(12.586067,-81.702563)"
2017,Febrero,República Dominicana,214,72,71,,143,"(3.541112,-76.384584)"
2017,Febrero,República Dominicana,214,1777,1849,,3626,"(4.697144,-74.140516)"
2017,Febrero,República Dominicana,214,32,25,,57,"(4.815061,-75.736532)"
2017,Febrero,República Dominicana,214,170,140,,310,"(6.171601,-75.427454)"
2017,Febrero,República Dominicana,214,16,18,,34,"(7.128456,-73.183637)"
2017,Febrero,Reunión,638,0,1,,1,"(4.697144,-74.140516)"
2017,Febrero,Rumania,642,1,0,,1,"(3.541112,-76.384584)"
2017,Febrero,Rumania,642,3,0,,3,"(4.697144,-74.140516)"
2017,Febrero,San  Vicente y las Granadinas,670,1,0,,1,"(4.697144,-74.140516)"
2017,Febrero,Singapur,702,12,29,,41,"(4.697144,-74.140516)"
2017,Febrero,Singapur,702,4,3,,7,"(6.171601,-75.427454)"
2017,Febrero,Sri Lanka,144,1,0,,1,"(4.697144,-74.140516)"
2017,Febrero,Sudáfrica,710,9,6,,15,"(4.697144,-74.140516)"
2017,Febrero,Sudáfrica,710,0,1,,1,"(6.171601,-75.427454)"
2017,Febrero,Suecia,752,18,18,,36,"(3.541112,-76.384584)"
2017,Febrero,Suecia,752,72,57,,129,"(4.697144,-74.140516)"
2017,Febrero,Suecia,752,2,1,,3,"(4.815061,-75.736532)"
2017,Febrero,Suecia,752,3,5,,8,"(6.171601,-75.427454)"
2017,Febrero,Suecia,752,2,1,,3,"(7.128456,-73.183637)"
2017,Febrero,Suiza,756,2,1,,3,"(10.886611,-74.776708)"
2017,Febrero,Suiza,756,82,34,,116,"(3.541112,-76.384584)"
2017,Febrero,Suiza,756,237,122,,359,"(4.697144,-74.140516)"
2017,Febrero,Suiza,756,1,0,,1,"(4.815061,-75.736532)"
2017,Febrero,Suiza,756,32,20,,52,"(6.171601,-75.427454)"
2017,Febrero,Surinam,740,2,5,,7,"(4.697144,-74.140516)"
2017,Febrero,Taiwán,158,1,1,,2,"(4.697144,-74.140516)"
2017,Febrero,Taiwán,158,1,0,,1,"(6.171601,-75.427454)"
2017,Febrero,Tailandia,764,4,3,,7,"(3.541112,-76.384584)"
2017,Febrero,Tailandia,764,14,7,,21,"(4.697144,-74.140516)"
2017,Febrero,Tailandia,764,2,3,,5,"(6.171601,-75.427454)"
2017,Febrero,Tanzania,834,1,0,,1,"(3.541112,-76.384584)"
2017,Febrero,Tanzania,834,1,3,,4,"(4.697144,-74.140516)"
2017,Febrero,Trinidad y Tobago,780,0,3,,3,"(10.445761,-75.516429)"
2017,Febrero,Trinidad y Tobago,780,0,2,,2,"(10.886611,-74.776708)"
2017,Febrero,Trinidad y Tobago,780,4,3,,7,"(3.541112,-76.384584)"
2017,Febrero,Trinidad y Tobago,780,11,18,,29,"(4.697144,-74.140516)"
2017,Febrero,Trinidad y Tobago,780,2,1,,3,"(4.815061,-75.736532)"
2017,Febrero,Trinidad y Tobago,780,9,6,,15,"(6.171601,-75.427454)"
2017,Febrero,Turquía,792,1,0,,1,"(10.886611,-74.776708)"
2017,Febrero,Turquía,792,3,2,,5,"(3.541112,-76.384584)"
2017,Febrero,Turquía,792,118,110,,228,"(4.697144,-74.140516)"
2017,Febrero,Turquía,792,2,0,,2,"(6.171601,-75.427454)"
2017,Febrero,Turkmenistán,795,0,2,,2,"(4.697144,-74.140516)"
2017,Febrero,Ucrania,804,2,6,,8,"(4.697144,-74.140516)"
2017,Febrero,Uganda,800,2,0,,2,"(4.697144,-74.140516)"
2017,Febrero,Uruguay,858,0,1,,1,"(0.814836,-77.662532)"
2017,Febrero,Uruguay,858,5,1,,6,"(10.445761,-75.516429)"
2017,Febrero,Uruguay,858,3,3,,6,"(10.886611,-74.776708)"
2017,Febrero,Uruguay,858,14,8,,22,"(3.541112,-76.384584)"
2017,Febrero,Uruguay,858,99,131,,230,"(4.697144,-74.140516)"
2017,Febrero,Uruguay,858,3,5,,8,"(4.815061,-75.736532)"
2017,Febrero,Uruguay,858,27,18,,45,"(6.171601,-75.427454)"
2017,Febrero,Venezuela,862,0,8,,8,"(10.408582,-75.538003)"
2017,Febrero,Venezuela,862,3,5,,8,"(10.445761,-75.516429)"
2017,Febrero,Venezuela,862,11,22,,33,"(10.886611,-74.776708)"
2017,Febrero,Venezuela,862,0,2,,2,"(11.247723,-74.213989)"
2017,Febrero,Venezuela,862,2243,2167,,4410,"(11.360009,-72.129330)"
2017,Febrero,Venezuela,862,9,11,,20,"(3.541112,-76.384584)"
2017,Febrero,Venezuela,862,9,11,,20,"(3.866713,-67.927521)"
2017,Febrero,Venezuela,862,1096,1157,,2253,"(4.697144,-74.140516)"
2017,Febrero,Venezuela,862,3,1,,4,"(4.815061,-75.736532)"
2017,Febrero,Venezuela,862,257,298,,555,"(6.171601,-75.427454)"
2017,Febrero,Venezuela,862,107,131,,238,"(6.185799,-67.483929)"
2017,Febrero,Venezuela,862,699,675,,1374,"(7.088729,-70.740253)"
2017,Febrero,Venezuela,862,2,2,,4,"(7.128456,-73.183637)"
2017,Febrero,Venezuela,862,2322,2424,,4746,"(7.818934,-72.453226)"
2017,Febrero,Venezuela,862,69,129,,198,"(8.36068,-72.409396)"
2017,Febrero,Vietnam,704,1,2,,3,"(4.697144,-74.140516)"
2017,Febrero,Islas Vírgenes Británicas/Territorio Británico de Ultramar,92,0,1,,1,"(4.697144,-74.140516)"
2017,Febrero,Islas Vírgenes Británicas/Territorio Británico de Ultramar,92,0,5,,5,"(6.171601,-75.427454)"
2017,Febrero,Islas Vírgenes Estadounidenses/Territorio de Estados Unidos,850,1,3,,4,"(4.697144,-74.140516)"
2017,Marzo,Afganistán,4,0,1,,1,"(3.541112,-76.384584)"
2017,Marzo,Afganistán,4,2,3,,5,"(4.697144,-74.140516)"
2017,Marzo,Albania,8,0,5,,5,"(4.697144,-74.140516)"
2017,Marzo,Alemania,276,1,0,,1,"(0.814836,-77.662532)"
2017,Marzo,Alemania,276,1,1,,2,"(10.445761,-75.516429)"
2017,Marzo,Alemania,276,10,13,,23,"(10.886611,-74.776708)"
2017,Marzo,Alemania,276,84,56,,140,"(3.541112,-76.384584)"
2017,Marzo,Alemania,276,1204,1136,,2340,"(4.697144,-74.140516)"
2017,Marzo,Alemania,276,67,54,,121,"(6.171601,-75.427454)"
2017,Marzo,Andorra,20,1,0,,1,"(4.697144,-74.140516)"
2017,Marzo,Andorra,20,1,0,,1,"(6.171601,-75.427454)"
2017,Marzo,Angola,24,0,1,,1,"(3.541112,-76.384584)"
2017,Marzo,Angola,24,2,5,,7,"(4.697144,-74.140516)"
2017,Marzo,Antigua y Barbuda,28,0,2,,2,"(10.886611,-74.776708)"
2017,Marzo,Antigua y Barbuda,28,1,0,,1,"(3.541112,-76.384584)"
2017,Marzo,Antigua y Barbuda,28,1,2,,3,"(4.697144,-74.140516)"
2017,Marzo,Países Bajos,528,15,14,,29,"(10.445761,-75.516429)"
2017,Marzo,Países Bajos,528,26,7,,33,"(10.886611,-74.776708)"
2017,Marzo,Países Bajos,528,0,3,,3,"(10.971302,-74.765397)"
2017,Marzo,Países Bajos,528,121,63,,184,"(3.541112,-76.384584)"
2017,Marzo,Países Bajos,528,852,733,,1585,"(4.697144,-74.140516)"
2017,Marzo,Países Bajos,528,5,3,,8,"(4.815061,-75.736532)"
2017,Marzo,Países Bajos,528,90,57,,147,"(6.171601,-75.427454)"
2017,Marzo,Países Bajos,528,2,0,,2,"(7.128456,-73.183637)"
2017,Marzo,Arabia Saudita,682,0,1,,1,"(3.541112,-76.384584)"
2017,Marzo,Arabia Saudita,682,5,37,,42,"(4.697144,-74.140516)"
2017,Marzo,Arabia Saudita,682,1,2,,3,"(6.171601,-75.427454)"
2017,Marzo,Arabia Saudita,682,0,1,,1,"(7.128456,-73.183637)"
2017,Marzo,Argelia,12,3,5,,8,"(4.697144,-74.140516)"
2017,Marzo,Argentina,32,19,45,,64,"(0.814836,-77.662532)"
2017,Marzo,Argentina,32,0,1,,1,"(1.813928,-78.763924)"
2017,Marzo,Argentina,32,10,14,,24,"(10.445761,-75.516429)"
2017,Marzo,Argentina,32,31,22,,53,"(10.886611,-74.776708)"
2017,Marzo,Argentina,32,2,5,,7,"(12.586067,-81.702563)"
2017,Marzo,Argentina,32,207,187,,394,"(3.541112,-76.384584)"
2017,Marzo,Argentina,32,3715,3544,,7259,"(4.697144,-74.140516)"
2017,Marzo,Argentina,32,9,17,,26,"(4.815061,-75.736532)"
2017,Marzo,Argentina,32,180,182,,362,"(6.171601,-75.427454)"
2017,Marzo,Argentina,32,4,3,,7,"(7.128456,-73.183637)"
2017,Marzo,República de Armenia,51,0,1,,1,"(4.697144,-74.140516)"
2017,Marzo,Aruba,533,0,7,,7,"(10.408582,-75.538003)"
2017,Marzo,Aruba,533,2,1,,3,"(10.445761,-75.516429)"
2017,Marzo,Aruba,533,17,9,,26,"(10.886611,-74.776708)"
2017,Marzo,Aruba,533,0,2,,2,"(11.247723,-74.213989)"
2017,Marzo,Aruba,533,58,33,,91,"(3.541112,-76.384584)"
2017,Marzo,Aruba,533,1620,1265,,2885,"(4.697144,-74.140516)"
2017,Marzo,Aruba,533,19,9,,28,"(4.815061,-75.736532)"
2017,Marzo,Aruba,533,55,50,,105,"(6.171601,-75.427454)"
2017,Marzo,Aruba,533,11,68,,79,"(7.128456,-73.183637)"
2017,Marzo,Australia,36,4,0,,4,"(10.886611,-74.776708)"
2017,Marzo,Australia,36,31,13,,44,"(3.541112,-76.384584)"
2017,Marzo,Australia,36,295,200,,495,"(4.697144,-74.140516)"
2017,Marzo,Australia,36,5,1,,6,"(4.815061,-75.736532)"
2017,Marzo,Australia,36,35,43,,78,"(6.171601,-75.427454)"
2017,Marzo,Australia,36,1,1,,2,"(7.128456,-73.183637)"
2017,Marzo,Austria,40,2,1,,3,"(10.445761,-75.516429)"
2017,Marzo,Austria,40,0,1,,1,"(10.886611,-74.776708)"
2017,Marzo,Austria,40,5,1,,6,"(3.541112,-76.384584)"
2017,Marzo,Austria,40,33,37,,70,"(4.697144,-74.140516)"
2017,Marzo,Austria,40,5,2,,7,"(6.171601,-75.427454)"
2017,Marzo,Azerbaiyán,31,0,1,,1,"(4.697144,-74.140516)"
2017,Marzo,Bahamas,44,1,0,,1,"(10.445761,-75.516429)"
2017,Marzo,Bahamas,44,0,1,,1,"(10.886611,-74.776708)"
2017,Marzo,Bahamas,44,15,3,,18,"(3.541112,-76.384584)"
2017,Marzo,Bahamas,44,7,18,,25,"(4.697144,-74.140516)"
2017,Marzo,Bahamas,44,4,2,,6,"(4.815061,-75.736532)"
2017,Marzo,Bahamas,44,15,19,,34,"(6.171601,-75.427454)"
2017,Marzo,Bahréin,48,1,0,,1,"(4.697144,-74.140516)"
2017,Marzo,Bahréin,48,2,0,,2,"(6.171601,-75.427454)"
2017,Marzo,Bangladesh,50,1,0,,1,"(3.541112,-76.384584)"
2017,Marzo,Bangladesh,50,0,1,,1,"(4.697144,-74.140516)"
2017,Marzo,Barbados,52,92,98,,190,"(4.697144,-74.140516)"
2017,Marzo,Barbados,52,1,1,,2,"(6.171601,-75.427454)"
2017,Marzo,República de Belarús,112,1,0,,1,"(10.445761,-75.516429)"
2017,Marzo,República de Belarús,112,3,0,,3,"(4.697144,-74.140516)"
2017,Marzo,Bélgica,56,3,3,,6,"(10.886611,-74.776708)"
2017,Marzo,Bélgica,56,20,11,,31,"(3.541112,-76.384584)"
2017,Marzo,Bélgica,56,87,65,,152,"(4.697144,-74.140516)"
2017,Marzo,Bélgica,56,26,12,,38,"(6.171601,-75.427454)"
2017,Marzo,Belice,84,0,3,,3,"(3.541112,-76.384584)"
2017,Marzo,Belice,84,8,3,,11,"(4.697144,-74.140516)"
2017,Marzo,Belice,84,2,5,,7,"(6.171601,-75.427454)"
2017,Marzo,Benín,204,1,0,,1,"(4.697144,-74.140516)"
2017,Marzo,Benín,204,1,0,,1,"(6.171601,-75.427454)"
2017,Marzo,Bermudas/Territorio Británico de Ultramar,60,1,1,,2,"(4.697144,-74.140516)"
2017,Marzo,Bermudas/Territorio Británico de Ultramar,60,1,0,,1,"(4.815061,-75.736532)"
2017,Marzo,Bermudas/Territorio Británico de Ultramar,60,0,1,,1,"(6.171601,-75.427454)"
2017,Marzo,Bolivia,68,3,10,,13,"(0.814836,-77.662532)"
2017,Marzo,Bolivia,68,1,0,,1,"(10.445761,-75.516429)"
2017,Marzo,Bolivia,68,7,7,,14,"(10.886611,-74.776708)"
2017,Marzo,Bolivia,68,1,0,,1,"(12.586067,-81.702563)"
2017,Marzo,Bolivia,68,28,44,,72,"(3.541112,-76.384584)"
2017,Marzo,Bolivia,68,249,534,,783,"(4.697144,-74.140516)"
2017,Marzo,Bolivia,68,13,24,,37,"(4.815061,-75.736532)"
2017,Marzo,Bolivia,68,29,61,,90,"(6.171601,-75.427454)"
2017,Marzo,Bolivia,68,2,3,,5,"(7.128456,-73.183637)"
2017,Marzo,Botsuana,72,0,1,,1,"(4.697144,-74.140516)"
2017,Marzo,Brasil,76,133,204,,337,"(-4.197703,-69.941278)"
2017,Marzo,Brasil,76,1,3,,4,"(-4.223468,-69.945098)"
2017,Marzo,Brasil,76,1,3,,4,"(0.814836,-77.662532)"
2017,Marzo,Brasil,76,6,8,,14,"(10.445761,-75.516429)"
2017,Marzo,Brasil,76,18,14,,32,"(10.886611,-74.776708)"
2017,Marzo,Brasil,76,0,1,,1,"(12.586067,-81.702563)"
2017,Marzo,Brasil,76,117,162,,279,"(3.541112,-76.384584)"
2017,Marzo,Brasil,76,2462,3355,,5817,"(4.697144,-74.140516)"
2017,Marzo,Brasil,76,44,64,,108,"(4.815061,-75.736532)"
2017,Marzo,Brasil,76,134,192,,326,"(6.171601,-75.427454)"
2017,Marzo,Brasil,76,9,12,,21,"(7.128456,-73.183637)"
2017,Marzo,Bulgaria,100,3,3,,6,"(4.697144,-74.140516)"
2017,Marzo,Burundi,108,1,0,,1,"(4.697144,-74.140516)"
2017,Marzo,Islas Caimán/Territorio Británico de Ultramar,136,2,0,,2,"(3.541112,-76.384584)"
2017,Marzo,Islas Caimán/Territorio Británico de Ultramar,136,0,1,,1,"(4.697144,-74.140516)"
2017,Marzo,Camboya,116,2,2,,4,"(3.541112,-76.384584)"
2017,Marzo,Camboya,116,0,2,,2,"(4.697144,-74.140516)"
2017,Marzo,Camerún,120,0,1,,1,"(6.171601,-75.427454)"
2017,Marzo,Canadá,124,136,85,,221,"(10.445761,-75.516429)"
2017,Marzo,Canadá,124,37,31,,68,"(10.886611,-74.776708)"
2017,Marzo,Canadá,124,4,2,,6,"(12.586067,-81.702563)"
2017,Marzo,Canadá,124,142,94,,236,"(3.541112,-76.384584)"
2017,Marzo,Canadá,124,1656,1466,,3122,"(4.697144,-74.140516)"
2017,Marzo,Canadá,124,12,8,,20,"(4.815061,-75.736532)"
2017,Marzo,Canadá,124,268,223,,491,"(6.171601,-75.427454)"
2017,Marzo,Canadá,124,7,6,,13,"(7.128456,-73.183637)"
2017,Marzo,España,724,1,0,,1,"(10.445761,-75.516429)"
2017,Marzo,España,724,10,6,,16,"(10.886611,-74.776708)"
2017,Marzo,España,724,3511,2284,,5795,"(3.541112,-76.384584)"
2017,Marzo,España,724,10512,8183,,18695,"(4.697144,-74.140516)"
2017,Marzo,España,724,13,3,,16,"(4.815061,-75.736532)"
2017,Marzo,España,724,1723,1207,,2930,"(6.171601,-75.427454)"
2017,Marzo,España,724,1,0,,1,"(7.128456,-73.183637)"
2017,Marzo,Colombia,170,2,5,,7,"(10.445761,-75.516429)"
2017,Marzo,Colombia,170,126,429,,555,"(4.697144,-74.140516)"
2017,Marzo,República Del Congo,178,0,1,,1,"(4.697144,-74.140516)"
2017,Marzo,República de Corea,410,15,26,,41,"(4.697144,-74.140516)"
2017,Marzo,República de Corea,410,1,1,,2,"(6.171601,-75.427454)"
2017,Marzo,Costa de Marfil,384,1,1,,2,"(3.541112,-76.384584)"
2017,Marzo,Costa de Marfil,384,2,4,,6,"(4.697144,-74.140516)"
2017,Marzo,Costa de Marfil,384,1,0,,1,"(6.171601,-75.427454)"
2017,Marzo,Costa Rica,188,0,7,,7,"(10.408582,-75.538003)"
2017,Marzo,Costa Rica,188,9,5,,14,"(10.445761,-75.516429)"
2017,Marzo,Costa Rica,188,13,31,,44,"(10.886611,-74.776708)"
2017,Marzo,Costa Rica,188,7,45,,52,"(12.5744111,-81.703935)"
2017,Marzo,Costa Rica,188,22,21,,43,"(12.586067,-81.702563)"
2017,Marzo,Costa Rica,188,0,1,,1,"(13.3387613,-81.372937)"
2017,Marzo,Costa Rica,188,47,56,,103,"(3.541112,-76.384584)"
2017,Marzo,Costa Rica,188,1049,1256,,2305,"(4.697144,-74.140516)"
2017,Marzo,Costa Rica,188,6,8,,14,"(4.815061,-75.736532)"
2017,Marzo,Costa Rica,188,131,160,,291,"(6.171601,-75.427454)"
2017,Marzo,Costa Rica,188,3,4,,7,"(7.128456,-73.183637)"
2017,Marzo,Croacia,191,1,3,,4,"(4.697144,-74.140516)"
2017,Marzo,Cuba,192,0,1,,1,"(10.408582,-75.538003)"
2017,Marzo,Cuba,192,12,19,,31,"(10.445761,-75.516429)"
2017,Marzo,Cuba,192,10,13,,23,"(10.886611,-74.776708)"
2017,Marzo,Cuba,192,5,3,,8,"(12.586067,-81.702563)"
2017,Marzo,Cuba,192,106,87,,193,"(3.541112,-76.384584)"
2017,Marzo,Cuba,192,1110,1011,,2121,"(4.697144,-74.140516)"
2017,Marzo,Cuba,192,24,21,,45,"(4.815061,-75.736532)"
2017,Marzo,Cuba,192,109,77,,186,"(6.171601,-75.427454)"
2017,Marzo,Cuba,192,9,14,,23,"(7.128456,-73.183637)"
2017,Marzo,Curazao,99999,10,59,,69,"(4.697144,-74.140516)"
2017,Marzo,República Checa,203,0,1,,1,"(3.541112,-76.384584)"
2017,Marzo,República Checa,203,5,16,,21,"(4.697144,-74.140516)"
2017,Marzo,República Checa,203,3,3,,6,"(6.171601,-75.427454)"
2017,Marzo,Chile,152,298,262,,560,"(0.814836,-77.662532)"
2017,Marzo,Chile,152,0,1,,1,"(1.813928,-78.763924)"
2017,Marzo,Chile,152,40,23,,63,"(10.445761,-75.516429)"
2017,Marzo,Chile,152,57,35,,92,"(10.886611,-74.776708)"
2017,Marzo,Chile,152,4,1,,5,"(12.586067,-81.702563)"
2017,Marzo,Chile,152,573,352,,925,"(3.541112,-76.384584)"
2017,Marzo,Chile,152,4351,3958,,8309,"(4.697144,-74.140516)"
2017,Marzo,Chile,152,187,109,,296,"(4.815061,-75.736532)"
2017,Marzo,Chile,152,151,135,,286,"(6.171601,-75.427454)"
2017,Marzo,Chile,152,13,13,,26,"(7.128456,-73.183637)"
2017,Marzo,China,156,0,2,,2,"(10.445761,-75.516429)"
2017,Marzo,China,156,1,6,,7,"(10.886611,-74.776708)"
2017,Marzo,China,156,22,98,,120,"(3.541112,-76.384584)"
2017,Marzo,China,156,264,783,,1047,"(4.697144,-74.140516)"
2017,Marzo,China,156,1,0,,1,"(4.815061,-75.736532)"
2017,Marzo,China,156,61,105,,166,"(6.171601,-75.427454)"
2017,Marzo,Chipre,196,1,0,,1,"(3.541112,-76.384584)"
2017,Marzo,Chipre,196,1,0,,1,"(4.697144,-74.140516)"
2017,Marzo,Dinamarca,208,4,3,,7,"(3.541112,-76.384584)"
2017,Marzo,Dinamarca,208,21,10,,31,"(4.697144,-74.140516)"
2017,Marzo,Dinamarca,208,2,3,,5,"(6.171601,-75.427454)"
2017,Marzo,Dominica,212,0,1,,1,"(4.697144,-74.140516)"
2017,Marzo,Ecuador,218,6,6,,12,"(-0.193180,-74.784874)"
2017,Marzo,Ecuador,218,504,968,,1472,"(0.25129,-76.875963)"
2017,Marzo,Ecuador,218,16,21,,37,"(0.812436,-77.847006)"
2017,Marzo,Ecuador,218,6121,10225,,16346,"(0.814836,-77.662532)"
2017,Marzo,Ecuador,218,164,203,,367,"(1.813928,-78.763924)"
2017,Marzo,Ecuador,218,0,15,,15,"(10.408582,-75.538003)"
2017,Marzo,Ecuador,218,3,2,,5,"(10.445761,-75.516429)"
2017,Marzo,Ecuador,218,5,8,,13,"(10.886611,-74.776708)"
2017,Marzo,Ecuador,218,292,416,,708,"(3.541112,-76.384584)"
2017,Marzo,Ecuador,218,3018,4979,,7997,"(4.697144,-74.140516)"
2017,Marzo,Ecuador,218,2,4,,6,"(4.815061,-75.736532)"
2017,Marzo,Ecuador,218,63,112,,175,"(6.171601,-75.427454)"
2017,Marzo,Ecuador,218,0,1,,1,"(7.128456,-73.183637)"
2017,Marzo,Egipto,818,0,1,,1,"(3.541112,-76.384584)"
2017,Marzo,Egipto,818,9,12,,21,"(4.697144,-74.140516)"
2017,Marzo,El Salvador,222,3,0,,3,"(10.445761,-75.516429)"
2017,Marzo,El Salvador,222,1,2,,3,"(10.886611,-74.776708)"
2017,Marzo,El Salvador,222,1,0,,1,"(12.586067,-81.702563)"
2017,Marzo,El Salvador,222,89,97,,186,"(3.541112,-76.384584)"
2017,Marzo,El Salvador,222,714,1025,,1739,"(4.697144,-74.140516)"
2017,Marzo,El Salvador,222,65,93,,158,"(6.171601,-75.427454)"
2017,Marzo,El Salvador,222,1,0,,1,"(7.128456,-73.183637)"
2017,Marzo,Emiratos Árabes,784,2,1,,3,"(3.541112,-76.384584)"
2017,Marzo,Emiratos Árabes,784,70,172,,242,"(4.697144,-74.140516)"
2017,Marzo,Emiratos Árabes,784,9,4,,13,"(6.171601,-75.427454)"
2017,Marzo,Emiratos Árabes,784,1,1,,2,"(7.128456,-73.183637)"
2017,Marzo,Eritrea,232,0,3,,3,"(4.697144,-74.140516)"
2017,Marzo,Eritrea,232,0,1,,1,"(6.171601,-75.427454)"
2017,Marzo,Eslovaquia,703,1,0,,1,"(3.541112,-76.384584)"
2017,Marzo,Eslovaquia,703,0,1,,1,"(4.697144,-74.140516)"
2017,Marzo,Eslovenia,705,1,0,,1,"(3.541112,-76.384584)"
2017,Marzo,Eslovenia,705,0,2,,2,"(4.697144,-74.140516)"
2017,Marzo,Estados Unidos de América,840,3246,2926,,6172,"(10.445761,-75.516429)"
2017,Marzo,Estados Unidos de América,840,2612,2281,,4893,"(10.886611,-74.776708)"
2017,Marzo,Estados Unidos de América,840,10,14,,24,"(11.117806,-74.232622)"
2017,Marzo,Estados Unidos de América,840,33,28,,61,"(12.586067,-81.702563)"
2017,Marzo,Estados Unidos de América,840,5202,3749,,8951,"(3.541112,-76.384584)"
2017,Marzo,Estados Unidos de América,840,523,368,,891,"(4.452882,-75.766298)"
2017,Marzo,Estados Unidos de América,840,28072,25950,,54022,"(4.697144,-74.140516)"
2017,Marzo,Estados Unidos de América,840,724,604,,1328,"(4.815061,-75.736532)"
2017,Marzo,Estados Unidos de América,840,8878,7541,,16419,"(6.171601,-75.427454)"
2017,Marzo,Estados Unidos de América,840,161,118,,279,"(7.128456,-73.183637)"
2017,Marzo,Etiopia,231,1,0,,1,"(3.541112,-76.384584)"
2017,Marzo,Etiopia,231,2,6,,8,"(4.697144,-74.140516)"
2017,Marzo,Filipinas,608,1,0,,1,"(10.445761,-75.516429)"
2017,Marzo,Filipinas,608,1,1,,2,"(3.541112,-76.384584)"
2017,Marzo,Filipinas,608,3,6,,9,"(4.697144,-74.140516)"
2017,Marzo,Finlandia,246,2,0,,2,"(3.541112,-76.384584)"
2017,Marzo,Finlandia,246,9,4,,13,"(4.697144,-74.140516)"
2017,Marzo,Finlandia,246,1,1,,2,"(6.171601,-75.427454)"
2017,Marzo,Francia,250,2,1,,3,"(10.445761,-75.516429)"
2017,Marzo,Francia,250,8,5,,13,"(10.886611,-74.776708)"
2017,Marzo,Francia,250,91,76,,167,"(3.541112,-76.384584)"
2017,Marzo,Francia,250,1202,1048,,2250,"(4.697144,-74.140516)"
2017,Marzo,Francia,250,5,1,,6,"(4.815061,-75.736532)"
2017,Marzo,Francia,250,83,75,,158,"(6.171601,-75.427454)"
2017,Marzo,Gabón,266,0,1,,1,"(4.697144,-74.140516)"
2017,Marzo,Georgia,268,0,2,,2,"(4.697144,-74.140516)"
2017,Marzo,Ghana,288,1,0,,1,"(10.445761,-75.516429)"
2017,Marzo,Ghana,288,1,0,,1,"(4.697144,-74.140516)"
2017,Marzo,Gibraltar/Territorio Británico de Ultramar,292,1,0,,1,"(0.814836,-77.662532)"
2017,Marzo,Grecia,300,17,10,,27,"(4.697144,-74.140516)"
2017,Marzo,Grecia,300,1,0,,1,"(6.171601,-75.427454)"
2017,Marzo,Groenlandia,304,1,0,,1,"(4.697144,-74.140516)"
2017,Marzo,Guatemala,320,14,122,,136,"(10.408582,-75.538003)"
2017,Marzo,Guatemala,320,2,8,,10,"(10.445761,-75.516429)"
2017,Marzo,Guatemala,320,10,14,,24,"(10.886611,-74.776708)"
2017,Marzo,Guatemala,320,2,1,,3,"(12.586067,-81.702563)"
2017,Marzo,Guatemala,320,63,94,,157,"(3.541112,-76.384584)"
2017,Marzo,Guatemala,320,519,695,,1214,"(4.697144,-74.140516)"
2017,Marzo,Guatemala,320,5,10,,15,"(4.815061,-75.736532)"
2017,Marzo,Guatemala,320,85,143,,228,"(6.171601,-75.427454)"
2017,Marzo,Guatemala,320,1,6,,7,"(7.128456,-73.183637)"
2017,Marzo,Guyana,328,1,5,,6,"(4.697144,-74.140516)"
2017,Marzo,Guyana,328,0,1,,1,"(4.815061,-75.736532)"
2017,Marzo,Guyana,328,0,1,,1,"(6.171601,-75.427454)"
2017,Marzo,Guyana,328,0,1,,1,"(7.128456,-73.183637)"
2017,Marzo,Guinea Ecuatorial,226,1,0,,1,"(3.541112,-76.384584)"
2017,Marzo,Guinea Ecuatorial,226,0,2,,2,"(4.697144,-74.140516)"
2017,Marzo,Guinea Bissau,624,1,1,,2,"(4.697144,-74.140516)"
2017,Marzo,Guadalupe/Territorio Francés,312,0,1,,1,"(4.697144,-74.140516)"
2017,Marzo,Haití,332,0,1,,1,"(10.445761,-75.516429)"
2017,Marzo,Haití,332,1,5,,6,"(10.886611,-74.776708)"
2017,Marzo,Haití,332,1,2,,3,"(3.541112,-76.384584)"
2017,Marzo,Haití,332,2,7,,9,"(4.697144,-74.140516)"
2017,Marzo,Haití,332,0,2,,2,"(4.815061,-75.736532)"
2017,Marzo,Haití,332,4,4,,8,"(6.171601,-75.427454)"
2017,Marzo,Haití,332,2,3,,5,"(7.128456,-73.183637)"
2017,Marzo,Honduras,340,2,2,,4,"(10.445761,-75.516429)"
2017,Marzo,Honduras,340,2,8,,10,"(10.886611,-74.776708)"
2017,Marzo,Honduras,340,9,22,,31,"(3.541112,-76.384584)"
2017,Marzo,Honduras,340,0,7,,7,"(3.893038,-77.067921)"
2017,Marzo,Honduras,340,75,145,,220,"(4.697144,-74.140516)"
2017,Marzo,Honduras,340,4,3,,7,"(4.815061,-75.736532)"
2017,Marzo,Honduras,340,24,75,,99,"(6.171601,-75.427454)"
2017,Marzo,Honduras,340,3,3,,6,"(7.128456,-73.183637)"
2017,Marzo,Hong Kong,344,5,5,,10,"(3.541112,-76.384584)"
2017,Marzo,Hong Kong,344,24,28,,52,"(4.697144,-74.140516)"
2017,Marzo,Hong Kong,344,3,8,,11,"(6.171601,-75.427454)"
2017,Marzo,Hungría,348,0,1,,1,"(3.541112,-76.384584)"
2017,Marzo,Hungría,348,2,3,,5,"(4.697144,-74.140516)"
2017,Marzo,India,356,2,2,,4,"(3.541112,-76.384584)"
2017,Marzo,India,356,50,36,,86,"(4.697144,-74.140516)"
2017,Marzo,India,356,2,1,,3,"(6.171601,-75.427454)"
2017,Marzo,Indonesia,360,3,4,,7,"(4.697144,-74.140516)"
2017,Marzo,Indonesia,360,0,2,,2,"(6.171601,-75.427454)"
2017,Marzo,Iraq,368,0,4,,4,"(4.697144,-74.140516)"
2017,Marzo,Irán,364,1,2,,3,"(4.697144,-74.140516)"
2017,Marzo,República de Irlanda,372,1,0,,1,"(3.541112,-76.384584)"
2017,Marzo,República de Irlanda,372,21,6,,27,"(4.697144,-74.140516)"
2017,Marzo,República de Irlanda,372,4,1,,5,"(6.171601,-75.427454)"
2017,Marzo,Islandia,352,1,0,,1,"(3.541112,-76.384584)"
2017,Marzo,Islandia,352,4,1,,5,"(4.697144,-74.140516)"
2017,Marzo,Israel,376,4,9,,13,"(3.541112,-76.384584)"
2017,Marzo,Israel,376,120,85,,205,"(4.697144,-74.140516)"
2017,Marzo,Israel,376,6,4,,10,"(6.171601,-75.427454)"
2017,Marzo,Italia,380,9,5,,14,"(10.886611,-74.776708)"
2017,Marzo,Italia,380,236,105,,341,"(3.541112,-76.384584)"
2017,Marzo,Italia,380,641,421,,1062,"(4.697144,-74.140516)"
2017,Marzo,Italia,380,1,0,,1,"(4.815061,-75.736532)"
2017,Marzo,Italia,380,108,66,,174,"(6.171601,-75.427454)"
2017,Marzo,Jamaica,388,1972,1288,,3260,"(10.408582,-75.538003)"
2017,Marzo,Jamaica,388,1,5,,6,"(10.445761,-75.516429)"
2017,Marzo,Jamaica,388,1,2,,3,"(10.886611,-74.776708)"
2017,Marzo,Jamaica,388,1,1,,2,"(12.586067,-81.702563)"
2017,Marzo,Jamaica,388,5,5,,10,"(3.541112,-76.384584)"
2017,Marzo,Jamaica,388,5,13,,18,"(4.697144,-74.140516)"
2017,Marzo,Jamaica,388,3,5,,8,"(4.815061,-75.736532)"
2017,Marzo,Jamaica,388,11,10,,21,"(6.171601,-75.427454)"
2017,Marzo,Japón,392,0,2,,2,"(10.886611,-74.776708)"
2017,Marzo,Japón,392,7,2,,9,"(3.541112,-76.384584)"
2017,Marzo,Japón,392,79,87,,166,"(4.697144,-74.140516)"
2017,Marzo,Japón,392,16,8,,24,"(6.171601,-75.427454)"
2017,Marzo,Jordania,400,5,2,,7,"(4.697144,-74.140516)"
2017,Marzo,Kazajistán,398,0,2,,2,"(4.697144,-74.140516)"
2017,Marzo,Kenia,404,1,0,,1,"(10.886611,-74.776708)"
2017,Marzo,Kenia,404,1,2,,3,"(4.697144,-74.140516)"
2017,Marzo,Kirguistán,417,1,0,,1,"(4.697144,-74.140516)"
2017,Marzo,Kuwait,414,0,1,,1,"(3.541112,-76.384584)"
2017,Marzo,Kuwait,414,0,3,,3,"(4.697144,-74.140516)"
2017,Marzo,República de Kosovo,901,2,1,,3,"(3.541112,-76.384584)"
2017,Marzo,República Democrática Popular  Lao,418,0,1,,1,"(4.697144,-74.140516)"
2017,Marzo,Lituania,440,0,8,,8,"(4.697144,-74.140516)"
2017,Marzo,Líbano,422,2,1,,3,"(10.886611,-74.776708)"
2017,Marzo,Líbano,422,6,17,,23,"(4.697144,-74.140516)"
2017,Marzo,Líbano,422,0,1,,1,"(6.171601,-75.427454)"
2017,Marzo,Liberia,430,1,0,,1,"(10.445761,-75.516429)"
2017,Marzo,Luxemburgo,442,10,8,,18,"(4.697144,-74.140516)"
2017,Marzo,Malasia,458,1,1,,2,"(3.541112,-76.384584)"
2017,Marzo,Malasia,458,1,2,,3,"(4.697144,-74.140516)"
2017,Marzo,Malí,466,0,1,,1,"(4.697144,-74.140516)"
2017,Marzo,Malta,470,1,0,,1,"(3.541112,-76.384584)"
2017,Marzo,Malta,470,32,13,,45,"(4.697144,-74.140516)"
2017,Marzo,Malta,470,2,1,,3,"(6.171601,-75.427454)"
2017,Marzo,Marruecos,504,7,3,,10,"(4.697144,-74.140516)"
2017,Marzo,Marruecos,504,3,0,,3,"(6.171601,-75.427454)"
2017,Marzo,Mauricio,480,0,1,,1,"(4.697144,-74.140516)"
2017,Marzo,Mauritania,478,0,2,,2,"(4.697144,-74.140516)"
2017,Marzo,México,484,34,30,,64,"(10.445761,-75.516429)"
2017,Marzo,México,484,74,109,,183,"(10.886611,-74.776708)"
2017,Marzo,México,484,3,1,,4,"(12.586067,-81.702563)"
2017,Marzo,México,484,1,0,,1,"(13.3387613,-81.372937)"
2017,Marzo,México,484,684,565,,1249,"(3.541112,-76.384584)"
2017,Marzo,México,484,11088,10580,,21668,"(4.697144,-74.140516)"
2017,Marzo,México,484,154,120,,274,"(4.815061,-75.736532)"
2017,Marzo,México,484,1778,1429,,3207,"(6.171601,-75.427454)"
2017,Marzo,México,484,80,65,,145,"(7.128456,-73.183637)"
2017,Marzo,Mónaco,492,1,3,,4,"(4.697144,-74.140516)"
2017,Marzo,Mongolia,496,1,1,,2,"(6.171601,-75.427454)"
2017,Marzo,Montenegro,499,1,0,,1,"(4.697144,-74.140516)"
2017,Marzo,Micronesia,583,1,0,,1,"(6.171601,-75.427454)"
2017,Marzo,Mozambique,508,0,1,,1,"(4.697144,-74.140516)"
2017,Marzo,Nauru,520,0,1,,1,"(4.697144,-74.140516)"
2017,Marzo,Nicaragua,558,2,10,,12,"(10.886611,-74.776708)"
2017,Marzo,Nicaragua,558,1,3,,4,"(12.586067,-81.702563)"
2017,Marzo,Nicaragua,558,9,38,,47,"(3.541112,-76.384584)"
2017,Marzo,Nicaragua,558,37,65,,102,"(4.697144,-74.140516)"
2017,Marzo,Nicaragua,558,2,6,,8,"(4.815061,-75.736532)"
2017,Marzo,Nicaragua,558,16,54,,70,"(6.171601,-75.427454)"
2017,Marzo,Nigeria,566,0,7,,7,"(4.697144,-74.140516)"
2017,Marzo,Noruega,578,0,1,,1,"(10.445761,-75.516429)"
2017,Marzo,Noruega,578,2,1,,3,"(10.886611,-74.776708)"
2017,Marzo,Noruega,578,2,5,,7,"(3.541112,-76.384584)"
2017,Marzo,Noruega,578,23,17,,40,"(4.697144,-74.140516)"
2017,Marzo,Noruega,578,2,1,,3,"(6.171601,-75.427454)"
2017,Marzo,Nueva Caledonia/Territorio francés,540,2,0,,2,"(4.697144,-74.140516)"
2017,Marzo,Nueva Zelanda,554,1,1,,2,"(3.541112,-76.384584)"
2017,Marzo,Nueva Zelanda,554,28,23,,51,"(4.697144,-74.140516)"
2017,Marzo,Nueva Zelanda,554,3,2,,5,"(6.171601,-75.427454)"
2017,Marzo,Omán,512,2,10,,12,"(4.697144,-74.140516)"
2017,Marzo,Pakistán,586,1,0,,1,"(3.541112,-76.384584)"
2017,Marzo,Pakistán,586,1,0,,1,"(4.697144,-74.140516)"
2017,Marzo,Panamá,591,18,87,,105,"(10.408582,-75.538003)"
2017,Marzo,Panamá,591,833,763,,1596,"(10.445761,-75.516429)"
2017,Marzo,Panamá,591,875,889,,1764,"(10.886611,-74.776708)"
2017,Marzo,Panamá,591,52,61,,113,"(12.586067,-81.702563)"
2017,Marzo,Panamá,591,1901,1724,,3625,"(3.541112,-76.384584)"
2017,Marzo,Panamá,591,384,277,,661,"(4.452882,-75.766298)"
2017,Marzo,Panamá,591,7273,8522,,15795,"(4.697144,-74.140516)"
2017,Marzo,Panamá,591,463,369,,832,"(4.815061,-75.736532)"
2017,Marzo,Panamá,591,2820,2783,,5603,"(6.171601,-75.427454)"
2017,Marzo,Panamá,591,0,2,,2,"(6.228046,-77.404104)"
2017,Marzo,Panamá,591,4,12,,16,"(7.102626,-77.762647)"
2017,Marzo,Panamá,591,190,199,,389,"(7.128456,-73.183637)"
2017,Marzo,Panamá,591,0,15,,15,"(8.066966,-76.735404)"
2017,Marzo,Panamá,591,27,49,,76,"(8.635765,-77.346578)"
2017,Marzo,Paraguay,600,1,0,,1,"(0.814836,-77.662532)"
2017,Marzo,Paraguay,600,1,0,,1,"(10.445761,-75.516429)"
2017,Marzo,Paraguay,600,1,9,,10,"(10.886611,-74.776708)"
2017,Marzo,Paraguay,600,25,44,,69,"(3.541112,-76.384584)"
2017,Marzo,Paraguay,600,67,151,,218,"(4.697144,-74.140516)"
2017,Marzo,Paraguay,600,10,18,,28,"(4.815061,-75.736532)"
2017,Marzo,Paraguay,600,14,20,,34,"(6.171601,-75.427454)"
2017,Marzo,Paraguay,600,4,0,,4,"(7.128456,-73.183637)"
2017,Marzo,Perú,604,8,3,,11,"(-0.193180,-74.784874)"
2017,Marzo,Perú,604,140,106,,246,"(-4.197703,-69.941278)"
2017,Marzo,Perú,604,103,28,,131,"(-4.223468,-69.945098)"
2017,Marzo,Perú,604,57,70,,127,"(0.814836,-77.662532)"
2017,Marzo,Perú,604,0,5,,5,"(1.813928,-78.763924)"
2017,Marzo,Perú,604,26,31,,57,"(10.445761,-75.516429)"
2017,Marzo,Perú,604,28,14,,42,"(10.886611,-74.776708)"
2017,Marzo,Perú,604,220,262,,482,"(3.541112,-76.384584)"
2017,Marzo,Perú,604,4848,5656,,10504,"(4.697144,-74.140516)"
2017,Marzo,Perú,604,7,9,,16,"(4.815061,-75.736532)"
2017,Marzo,Perú,604,332,322,,654,"(6.171601,-75.427454)"
2017,Marzo,Perú,604,13,9,,22,"(7.128456,-73.183637)"
2017,Marzo,Palestina,99999,2,1,,3,"(4.697144,-74.140516)"
2017,Marzo,Polonia,616,0,3,,3,"(3.541112,-76.384584)"
2017,Marzo,Polonia,616,12,17,,29,"(4.697144,-74.140516)"
2017,Marzo,Portugal,620,1,1,,2,"(10.886611,-74.776708)"
2017,Marzo,Portugal,620,3,4,,7,"(3.541112,-76.384584)"
2017,Marzo,Portugal,620,62,50,,112,"(4.697144,-74.140516)"
2017,Marzo,Portugal,620,12,10,,22,"(6.171601,-75.427454)"
2017,Marzo,Polinesia Francesa/Colectividad de Ultramar Francesa,258,0,1,,1,"(4.697144,-74.140516)"
2017,Marzo,Polinesia Francesa/Colectividad de Ultramar Francesa,258,1,1,,2,"(4.815061,-75.736532)"
2017,Marzo,Puerto Rico/Territorio de Estados Unidos,630,7,4,,11,"(10.445761,-75.516429)"
2017,Marzo,Puerto Rico/Territorio de Estados Unidos,630,13,16,,29,"(10.886611,-74.776708)"
2017,Marzo,Puerto Rico/Territorio de Estados Unidos,630,41,34,,75,"(3.541112,-76.384584)"
2017,Marzo,Puerto Rico/Territorio de Estados Unidos,630,544,523,,1067,"(4.697144,-74.140516)"
2017,Marzo,Puerto Rico/Territorio de Estados Unidos,630,6,6,,12,"(4.815061,-75.736532)"
2017,Marzo,Puerto Rico/Territorio de Estados Unidos,630,43,44,,87,"(6.171601,-75.427454)"
2017,Marzo,Puerto Rico/Territorio de Estados Unidos,630,5,5,,10,"(7.128456,-73.183637)"
2017,Marzo,Qatar,634,0,1,,1,"(3.541112,-76.384584)"
2017,Marzo,Qatar,634,7,3,,10,"(4.697144,-74.140516)"
2017,Marzo,Qatar,634,1,1,,2,"(6.171601,-75.427454)"
2017,Marzo,Reino Unido de Gran Bretaña e Irlanda del Norte,826,38,26,,64,"(3.541112,-76.384584)"
2017,Marzo,Reino Unido de Gran Bretaña e Irlanda del Norte,826,1426,1223,,2649,"(4.697144,-74.140516)"
2017,Marzo,Reino Unido de Gran Bretaña e Irlanda del Norte,826,18,17,,35,"(6.171601,-75.427454)"
2017,Marzo,República CentroÁfricana,140,0,2,,2,"(4.697144,-74.140516)"
2017,Marzo,Federación de Rusia,643,0,2,,2,"(3.541112,-76.384584)"
2017,Marzo,Federación de Rusia,643,20,20,,40,"(4.697144,-74.140516)"
2017,Marzo,Federación de Rusia,643,1,0,,1,"(4.815061,-75.736532)"
2017,Marzo,República Dominicana,214,6,17,,23,"(10.445761,-75.516429)"
2017,Marzo,República Dominicana,214,53,56,,109,"(10.886611,-74.776708)"
2017,Marzo,República Dominicana,214,84,92,,176,"(3.541112,-76.384584)"
2017,Marzo,República Dominicana,214,2402,2370,,4772,"(4.697144,-74.140516)"
2017,Marzo,República Dominicana,214,41,35,,76,"(4.815061,-75.736532)"
2017,Marzo,República Dominicana,214,173,182,,355,"(6.171601,-75.427454)"
2017,Marzo,República Dominicana,214,28,26,,54,"(7.128456,-73.183637)"
2017,Marzo,República Democrática Popular de Corea,408,1,1,,2,"(4.697144,-74.140516)"
2017,Marzo,Rumania,642,2,3,,5,"(4.697144,-74.140516)"
2017,Marzo,Serbia,688,3,1,,4,"(4.697144,-74.140516)"
2017,Marzo,Singapur,702,0,3,,3,"(10.886611,-74.776708)"
2017,Marzo,Singapur,702,17,21,,38,"(4.697144,-74.140516)"
2017,Marzo,Singapur,702,1,2,,3,"(6.171601,-75.427454)"
2017,Marzo,Sudáfrica,710,0,1,,1,"(10.886611,-74.776708)"
2017,Marzo,Sudáfrica,710,6,11,,17,"(4.697144,-74.140516)"
2017,Marzo,Sudáfrica,710,1,6,,7,"(6.171601,-75.427454)"
2017,Marzo,Sudán,736,0,2,,2,"(6.171601,-75.427454)"
2017,Marzo,Suecia,752,1,0,,1,"(10.886611,-74.776708)"
2017,Marzo,Suecia,752,14,10,,24,"(3.541112,-76.384584)"
2017,Marzo,Suecia,752,71,50,,121,"(4.697144,-74.140516)"
2017,Marzo,Suecia,752,6,3,,9,"(6.171601,-75.427454)"
2017,Marzo,Suiza,756,0,1,,1,"(10.445761,-75.516429)"
2017,Marzo,Suiza,756,2,0,,2,"(10.886611,-74.776708)"
2017,Marzo,Suiza,756,64,36,,100,"(3.541112,-76.384584)"
2017,Marzo,Suiza,756,194,137,,331,"(4.697144,-74.140516)"
2017,Marzo,Suiza,756,0,1,,1,"(4.815061,-75.736532)"
2017,Marzo,Suiza,756,43,17,,60,"(6.171601,-75.427454)"
2017,Marzo,Surinam,740,0,3,,3,"(10.408582,-75.538003)"
2017,Marzo,Surinam,740,0,1,,1,"(10.886611,-74.776708)"
2017,Marzo,Surinam,740,5,4,,9,"(4.697144,-74.140516)"
2017,Marzo,Surinam,740,0,3,,3,"(6.171601,-75.427454)"
2017,Marzo,Taiwán,158,1,0,,1,"(3.541112,-76.384584)"
2017,Marzo,Taiwán,158,2,8,,10,"(4.697144,-74.140516)"
2017,Marzo,Taiwán,158,0,3,,3,"(6.171601,-75.427454)"
2017,Marzo,Tailandia,764,1,0,,1,"(3.541112,-76.384584)"
2017,Marzo,Tailandia,764,32,35,,67,"(4.697144,-74.140516)"
2017,Marzo,Tailandia,764,3,3,,6,"(6.171601,-75.427454)"
2017,Marzo,Tanzania,834,1,0,,1,"(3.541112,-76.384584)"
2017,Marzo,Tanzania,834,2,1,,3,"(4.697144,-74.140516)"
2017,Marzo,Trinidad y Tobago,780,1,4,,5,"(10.445761,-75.516429)"
2017,Marzo,Trinidad y Tobago,780,0,3,,3,"(10.886611,-74.776708)"
2017,Marzo,Trinidad y Tobago,780,2,1,,3,"(3.541112,-76.384584)"
2017,Marzo,Trinidad y Tobago,780,11,29,,40,"(4.697144,-74.140516)"
2017,Marzo,Trinidad y Tobago,780,2,4,,6,"(4.815061,-75.736532)"
2017,Marzo,Trinidad y Tobago,780,8,8,,16,"(6.171601,-75.427454)"
2017,Marzo,Trinidad y Tobago,780,3,5,,8,"(7.128456,-73.183637)"
2017,Marzo,Turquía,792,1,0,,1,"(10.886611,-74.776708)"
2017,Marzo,Turquía,792,1,0,,1,"(3.541112,-76.384584)"
2017,Marzo,Turquía,792,212,190,,402,"(4.697144,-74.140516)"
2017,Marzo,Turquía,792,6,10,,16,"(6.171601,-75.427454)"
2017,Marzo,Turquía,792,0,1,,1,"(7.128456,-73.183637)"
2017,Marzo,Turkmenistán,795,4,4,,8,"(4.697144,-74.140516)"
2017,Marzo,Turkmenistán,795,1,2,,3,"(6.171601,-75.427454)"
2017,Marzo,Ucrania,804,0,1,,1,"(3.541112,-76.384584)"
2017,Marzo,Ucrania,804,1,2,,3,"(4.697144,-74.140516)"
2017,Marzo,Uganda,800,2,0,,2,"(4.697144,-74.140516)"
2017,Marzo,Uruguay,858,1,1,,2,"(10.445761,-75.516429)"
2017,Marzo,Uruguay,858,6,4,,10,"(10.886611,-74.776708)"
2017,Marzo,Uruguay,858,21,38,,59,"(3.541112,-76.384584)"
2017,Marzo,Uruguay,858,98,129,,227,"(4.697144,-74.140516)"
2017,Marzo,Uruguay,858,10,12,,22,"(4.815061,-75.736532)"
2017,Marzo,Uruguay,858,18,29,,47,"(6.171601,-75.427454)"
2017,Marzo,Uruguay,858,2,0,,2,"(7.128456,-73.183637)"
2017,Marzo,Venezuela,862,7,8,,15,"(10.445761,-75.516429)"
2017,Marzo,Venezuela,862,6,12,,18,"(10.886611,-74.776708)"
2017,Marzo,Venezuela,862,2736,2681,,5417,"(11.360009,-72.129330)"
2017,Marzo,Venezuela,862,11,21,,32,"(3.541112,-76.384584)"
2017,Marzo,Venezuela,862,17,19,,36,"(3.866713,-67.927521)"
2017,Marzo,Venezuela,862,1362,1379,,2741,"(4.697144,-74.140516)"
2017,Marzo,Venezuela,862,3,5,,8,"(4.815061,-75.736532)"
2017,Marzo,Venezuela,862,342,349,,691,"(6.171601,-75.427454)"
2017,Marzo,Venezuela,862,143,133,,276,"(6.185799,-67.483929)"
2017,Marzo,Venezuela,862,788,679,,1467,"(7.088729,-70.740253)"
2017,Marzo,Venezuela,862,1,10,,11,"(7.128456,-73.183637)"
2017,Marzo,Venezuela,862,2495,2457,,4952,"(7.818934,-72.453226)"
2017,Marzo,Venezuela,862,106,136,,242,"(8.36068,-72.409396)"
2017,Marzo,Vietnam,704,3,3,,6,"(4.697144,-74.140516)"
2017,Marzo,Islas Vírgenes Británicas/Territorio Británico de Ultramar,92,0,5,,5,"(4.697144,-74.140516)"
2017,Abril,Afganistán,4,1,2,,3,"(4.697144,-74.140516)"
2017,Abril,Afganistán,4,1,0,,1,"(6.171601,-75.427454)"
2017,Abril,Albania,8,0,4,,4,"(4.697144,-74.140516)"
2017,Abril,Alemania,276,0,5,,5,"(0.814836,-77.662532)"
2017,Abril,Alemania,276,7,3,,10,"(10.445761,-75.516429)"
2017,Abril,Alemania,276,18,14,,32,"(10.886611,-74.776708)"
2017,Abril,Alemania,276,46,27,,73,"(3.541112,-76.384584)"
2017,Abril,Alemania,276,1340,1159,,2499,"(4.697144,-74.140516)"
2017,Abril,Alemania,276,1,1,,2,"(4.815061,-75.736532)"
2017,Abril,Alemania,276,71,69,,140,"(6.171601,-75.427454)"
2017,Abril,Alemania,276,0,1,,1,"(7.128456,-73.183637)"
2017,Abril,Angola,24,2,6,,8,"(4.697144,-74.140516)"
2017,Abril,Antigua y Barbuda,28,0,1,,1,"(10.886611,-74.776708)"
2017,Abril,Antigua y Barbuda,28,1,0,,1,"(3.541112,-76.384584)"
2017,Abril,Antigua y Barbuda,28,5,5,,10,"(4.697144,-74.140516)"
2017,Abril,Países Bajos,528,0,1,,1,"(10.408582,-75.538003)"
2017,Abril,Países Bajos,528,110,60,,170,"(10.445761,-75.516429)"
2017,Abril,Países Bajos,528,23,20,,43,"(10.886611,-74.776708)"
2017,Abril,Países Bajos,528,2,1,,3,"(11.117806,-74.232622)"
2017,Abril,Países Bajos,528,68,31,,99,"(3.541112,-76.384584)"
2017,Abril,Países Bajos,528,1127,932,,2059,"(4.697144,-74.140516)"
2017,Abril,Países Bajos,528,3,3,,6,"(4.815061,-75.736532)"
2017,Abril,Países Bajos,528,133,83,,216,"(6.171601,-75.427454)"
2017,Abril,Países Bajos,528,5,10,,15,"(7.128456,-73.183637)"
2017,Abril,Arabia Saudita,682,0,1,,1,"(3.541112,-76.384584)"
2017,Abril,Arabia Saudita,682,10,58,,68,"(4.697144,-74.140516)"
2017,Abril,Arabia Saudita,682,0,3,,3,"(6.171601,-75.427454)"
2017,Abril,Arabia Saudita,682,0,1,,1,"(7.128456,-73.183637)"
2017,Abril,Argelia,12,1,3,,4,"(4.697144,-74.140516)"
2017,Abril,Argentina,32,15,28,,43,"(0.814836,-77.662532)"
2017,Abril,Argentina,32,18,12,,30,"(10.445761,-75.516429)"
2017,Abril,Argentina,32,21,24,,45,"(10.886611,-74.776708)"
2017,Abril,Argentina,32,1,1,,2,"(12.586067,-81.702563)"
2017,Abril,Argentina,32,118,101,,219,"(3.541112,-76.384584)"
2017,Abril,Argentina,32,2840,2714,,5554,"(4.697144,-74.140516)"
2017,Abril,Argentina,32,8,17,,25,"(4.815061,-75.736532)"
2017,Abril,Argentina,32,102,128,,230,"(6.171601,-75.427454)"
2017,Abril,Argentina,32,2,6,,8,"(7.128456,-73.183637)"
2017,Abril,República de Armenia,51,0,2,,2,"(4.697144,-74.140516)"
2017,Abril,Aruba,533,48,27,,75,"(10.886611,-74.776708)"
2017,Abril,Aruba,533,1,0,,1,"(11.360009,-72.129330)"
2017,Abril,Aruba,533,0,2,,2,"(11.528919,-72.919681)"
2017,Abril,Aruba,533,1,1,,2,"(12.586067,-81.702563)"
2017,Abril,Aruba,533,71,30,,101,"(3.541112,-76.384584)"
2017,Abril,Aruba,533,2112,1611,,3723,"(4.697144,-74.140516)"
2017,Abril,Aruba,533,30,21,,51,"(4.815061,-75.736532)"
2017,Abril,Aruba,533,143,68,,211,"(6.171601,-75.427454)"
2017,Abril,Aruba,533,11,30,,41,"(7.128456,-73.183637)"
2017,Abril,Australia,36,0,1,,1,"(10.445761,-75.516429)"
2017,Abril,Australia,36,2,0,,2,"(10.886611,-74.776708)"
2017,Abril,Australia,36,9,4,,13,"(3.541112,-76.384584)"
2017,Abril,Australia,36,291,246,,537,"(4.697144,-74.140516)"
2017,Abril,Australia,36,3,3,,6,"(4.815061,-75.736532)"
2017,Abril,Australia,36,39,29,,68,"(6.171601,-75.427454)"
2017,Abril,Australia,36,1,1,,2,"(7.128456,-73.183637)"
2017,Abril,Austria,40,3,2,,5,"(10.445761,-75.516429)"
2017,Abril,Austria,40,0,1,,1,"(10.886611,-74.776708)"
2017,Abril,Austria,40,4,4,,8,"(3.541112,-76.384584)"
2017,Abril,Austria,40,26,33,,59,"(4.697144,-74.140516)"
2017,Abril,Austria,40,10,4,,14,"(6.171601,-75.427454)"
2017,Abril,Azerbaiyán,31,1,3,,4,"(4.697144,-74.140516)"
2017,Abril,Bahamas,44,2,0,,2,"(10.886611,-74.776708)"
2017,Abril,Bahamas,44,21,16,,37,"(3.541112,-76.384584)"
2017,Abril,Bahamas,44,19,17,,36,"(4.697144,-74.140516)"
2017,Abril,Bahamas,44,1,0,,1,"(4.815061,-75.736532)"
2017,Abril,Bahamas,44,15,21,,36,"(6.171601,-75.427454)"
2017,Abril,Bahréin,48,1,0,,1,"(3.541112,-76.384584)"
2017,Abril,Bahréin,48,2,2,,4,"(4.697144,-74.140516)"
2017,Abril,Bahréin,48,1,0,,1,"(6.171601,-75.427454)"
2017,Abril,Barbados,52,137,146,,283,"(4.697144,-74.140516)"
2017,Abril,Barbados,52,0,1,,1,"(6.171601,-75.427454)"
2017,Abril,Bélgica,56,1,1,,2,"(10.886611,-74.776708)"
2017,Abril,Bélgica,56,8,4,,12,"(3.541112,-76.384584)"
2017,Abril,Bélgica,56,98,77,,175,"(4.697144,-74.140516)"
2017,Abril,Bélgica,56,18,16,,34,"(6.171601,-75.427454)"
2017,Abril,Belice,84,1,1,,2,"(10.886611,-74.776708)"
2017,Abril,Belice,84,1,2,,3,"(3.541112,-76.384584)"
2017,Abril,Belice,84,7,5,,12,"(4.697144,-74.140516)"
2017,Abril,Belice,84,1,0,,1,"(4.815061,-75.736532)"
2017,Abril,Belice,84,10,6,,16,"(6.171601,-75.427454)"
2017,Abril,Benín,204,0,1,,1,"(4.697144,-74.140516)"
2017,Abril,Benín,204,1,0,,1,"(6.171601,-75.427454)"
2017,Abril,Bermudas/Territorio Británico de Ultramar,60,2,0,,2,"(4.697144,-74.140516)"
2017,Abril,Bolivia,68,1,9,,10,"(0.814836,-77.662532)"
2017,Abril,Bolivia,68,3,3,,6,"(10.445761,-75.516429)"
2017,Abril,Bolivia,68,4,1,,5,"(10.886611,-74.776708)"
2017,Abril,Bolivia,68,27,43,,70,"(3.541112,-76.384584)"
2017,Abril,Bolivia,68,390,543,,933,"(4.697144,-74.140516)"
2017,Abril,Bolivia,68,9,12,,21,"(4.815061,-75.736532)"
2017,Abril,Bolivia,68,26,48,,74,"(6.171601,-75.427454)"
2017,Abril,Bolivia,68,2,2,,4,"(7.128456,-73.183637)"
2017,Abril,Bosnia y Herzegovina,70,1,1,,2,"(4.697144,-74.140516)"
2017,Abril,Brasil,76,113,176,,289,"(-4.197703,-69.941278)"
2017,Abril,Brasil,76,16,28,,44,"(-4.223468,-69.945098)"
2017,Abril,Brasil,76,0,10,,10,"(0.814836,-77.662532)"
2017,Abril,Brasil,76,11,11,,22,"(10.445761,-75.516429)"
2017,Abril,Brasil,76,29,18,,47,"(10.886611,-74.776708)"
2017,Abril,Brasil,76,1,2,,3,"(12.586067,-81.702563)"
2017,Abril,Brasil,76,112,105,,217,"(3.541112,-76.384584)"
2017,Abril,Brasil,76,1,0,,1,"(3.866713,-67.927521)"
2017,Abril,Brasil,76,3283,4091,,7374,"(4.697144,-74.140516)"
2017,Abril,Brasil,76,23,56,,79,"(4.815061,-75.736532)"
2017,Abril,Brasil,76,166,232,,398,"(6.171601,-75.427454)"
2017,Abril,Brasil,76,3,3,,6,"(7.128456,-73.183637)"
2017,Abril,Bulgaria,100,1,4,,5,"(4.697144,-74.140516)"
2017,Abril,Cabo Verde,132,0,1,,1,"(4.697144,-74.140516)"
2017,Abril,Islas Caimán/Territorio Británico de Ultramar,136,2,0,,2,"(10.886611,-74.776708)"
2017,Abril,Islas Caimán/Territorio Británico de Ultramar,136,33,17,,50,"(12.586067,-81.702563)"
2017,Abril,Islas Caimán/Territorio Británico de Ultramar,136,1,1,,2,"(3.541112,-76.384584)"
2017,Abril,Islas Caimán/Territorio Británico de Ultramar,136,3,1,,4,"(4.697144,-74.140516)"
2017,Abril,Islas Caimán/Territorio Británico de Ultramar,136,1,0,,1,"(6.171601,-75.427454)"
2017,Abril,Camboya,116,1,3,,4,"(4.697144,-74.140516)"
2017,Abril,Camerún,120,1,0,,1,"(4.697144,-74.140516)"
2017,Abril,Canadá,124,17,15,,32,"(10.445761,-75.516429)"
2017,Abril,Canadá,124,49,37,,86,"(10.886611,-74.776708)"
2017,Abril,Canadá,124,3,1,,4,"(12.586067,-81.702563)"
2017,Abril,Canadá,124,138,112,,250,"(3.541112,-76.384584)"
2017,Abril,Canadá,124,0,2,,2,"(4.452882,-75.766298)"
2017,Abril,Canadá,124,1695,1454,,3149,"(4.697144,-74.140516)"
2017,Abril,Canadá,124,11,11,,22,"(4.815061,-75.736532)"
2017,Abril,Canadá,124,325,226,,551,"(6.171601,-75.427454)"
2017,Abril,Canadá,124,15,13,,28,"(7.128456,-73.183637)"
2017,Abril,Chad,148,1,0,,1,"(4.697144,-74.140516)"
2017,Abril,España,724,7,4,,11,"(10.445761,-75.516429)"
2017,Abril,España,724,6,7,,13,"(10.886611,-74.776708)"
2017,Abril,España,724,0,3,,3,"(12.586067,-81.702563)"
2017,Abril,España,724,2348,1736,,4084,"(3.541112,-76.384584)"
2017,Abril,España,724,11282,9366,,20648,"(4.697144,-74.140516)"
2017,Abril,España,724,1,1,,2,"(4.815061,-75.736532)"
2017,Abril,España,724,2290,1715,,4005,"(6.171601,-75.427454)"
2017,Abril,España,724,1,2,,3,"(7.128456,-73.183637)"
2017,Abril,Colombia,170,1,12,,13,"(10.445761,-75.516429)"
2017,Abril,Colombia,170,176,488,,664,"(4.697144,-74.140516)"
2017,Abril,República Del Congo,178,0,2,,2,"(4.697144,-74.140516)"
2017,Abril,República Democrática del Congo,180,0,1,,1,"(4.697144,-74.140516)"
2017,Abril,República de Corea,410,21,22,,43,"(4.697144,-74.140516)"
2017,Abril,Costa de Marfil,384,0,22,,22,"(10.408582,-75.538003)"
2017,Abril,Costa de Marfil,384,3,7,,10,"(4.697144,-74.140516)"
2017,Abril,Costa de Marfil,384,0,1,,1,"(6.171601,-75.427454)"
2017,Abril,Costa Rica,188,1,0,,1,"(10.408582,-75.538003)"
2017,Abril,Costa Rica,188,12,9,,21,"(10.445761,-75.516429)"
2017,Abril,Costa Rica,188,15,15,,30,"(10.886611,-74.776708)"
2017,Abril,Costa Rica,188,3,25,,28,"(12.5744111,-81.703935)"
2017,Abril,Costa Rica,188,28,37,,65,"(12.586067,-81.702563)"
2017,Abril,Costa Rica,188,38,55,,93,"(3.541112,-76.384584)"
2017,Abril,Costa Rica,188,1383,1457,,2840,"(4.697144,-74.140516)"
2017,Abril,Costa Rica,188,10,11,,21,"(4.815061,-75.736532)"
2017,Abril,Costa Rica,188,112,149,,261,"(6.171601,-75.427454)"
2017,Abril,Costa Rica,188,7,7,,14,"(7.128456,-73.183637)"
2017,Abril,Croacia,191,6,10,,16,"(4.697144,-74.140516)"
2017,Abril,Croacia,191,0,1,,1,"(6.171601,-75.427454)"
2017,Abril,Cuba,192,27,15,,42,"(10.445761,-75.516429)"
2017,Abril,Cuba,192,18,13,,31,"(10.886611,-74.776708)"
2017,Abril,Cuba,192,79,84,,163,"(3.541112,-76.384584)"
2017,Abril,Cuba,192,1550,1266,,2816,"(4.697144,-74.140516)"
2017,Abril,Cuba,192,18,10,,28,"(4.815061,-75.736532)"
2017,Abril,Cuba,192,147,108,,255,"(6.171601,-75.427454)"
2017,Abril,Cuba,192,12,10,,22,"(7.128456,-73.183637)"
2017,Abril,Curazao,99999,0,1,,1,"(10.445761,-75.516429)"
2017,Abril,Curazao,99999,12,49,,61,"(4.697144,-74.140516)"
2017,Abril,República Checa,203,11,10,,21,"(4.697144,-74.140516)"
2017,Abril,República Checa,203,1,1,,2,"(6.171601,-75.427454)"
2017,Abril,Chile,152,257,259,,516,"(0.814836,-77.662532)"
2017,Abril,Chile,152,1,1,,2,"(1.813928,-78.763924)"
2017,Abril,Chile,152,25,22,,47,"(10.445761,-75.516429)"
2017,Abril,Chile,152,42,29,,71,"(10.886611,-74.776708)"
2017,Abril,Chile,152,4,3,,7,"(12.586067,-81.702563)"
2017,Abril,Chile,152,514,345,,859,"(3.541112,-76.384584)"
2017,Abril,Chile,152,4186,3745,,7931,"(4.697144,-74.140516)"
2017,Abril,Chile,152,171,145,,316,"(4.815061,-75.736532)"
2017,Abril,Chile,152,185,142,,327,"(6.171601,-75.427454)"
2017,Abril,Chile,152,8,8,,16,"(7.128456,-73.183637)"
2017,Abril,China,156,1,6,,7,"(10.886611,-74.776708)"
2017,Abril,China,156,18,36,,54,"(3.541112,-76.384584)"
2017,Abril,China,156,280,660,,940,"(4.697144,-74.140516)"
2017,Abril,China,156,1,4,,5,"(4.815061,-75.736532)"
2017,Abril,China,156,28,71,,99,"(6.171601,-75.427454)"
2017,Abril,Chipre,196,3,3,,6,"(4.697144,-74.140516)"
2017,Abril,Dinamarca,208,3,0,,3,"(10.445761,-75.516429)"
2017,Abril,Dinamarca,208,2,0,,2,"(3.541112,-76.384584)"
2017,Abril,Dinamarca,208,21,12,,33,"(4.697144,-74.140516)"
2017,Abril,Dinamarca,208,2,1,,3,"(6.171601,-75.427454)"
2017,Abril,Dominica,212,1,0,,1,"(4.697144,-74.140516)"
2017,Abril,Ecuador,218,5,12,,17,"(-0.193180,-74.784874)"
2017,Abril,Ecuador,218,503,803,,1306,"(0.25129,-76.875963)"
2017,Abril,Ecuador,218,25,23,,48,"(0.812436,-77.847006)"
2017,Abril,Ecuador,218,7594,8750,,16344,"(0.814836,-77.662532)"
2017,Abril,Ecuador,218,214,215,,429,"(1.813928,-78.763924)"
2017,Abril,Ecuador,218,1,20,,21,"(10.408582,-75.538003)"
2017,Abril,Ecuador,218,1,1,,2,"(10.445761,-75.516429)"
2017,Abril,Ecuador,218,0,4,,4,"(10.886611,-74.776708)"
2017,Abril,Ecuador,218,0,1,,1,"(12.586067,-81.702563)"
2017,Abril,Ecuador,218,354,359,,713,"(3.541112,-76.384584)"
2017,Abril,Ecuador,218,3139,4046,,7185,"(4.697144,-74.140516)"
2017,Abril,Ecuador,218,5,2,,7,"(4.815061,-75.736532)"
2017,Abril,Ecuador,218,56,73,,129,"(6.171601,-75.427454)"
2017,Abril,Ecuador,218,1,2,,3,"(7.128456,-73.183637)"
2017,Abril,Egipto,818,0,1,,1,"(3.541112,-76.384584)"
2017,Abril,Egipto,818,33,33,,66,"(4.697144,-74.140516)"
2017,Abril,Egipto,818,4,0,,4,"(6.171601,-75.427454)"
2017,Abril,El Salvador,222,2,1,,3,"(10.445761,-75.516429)"
2017,Abril,El Salvador,222,1,6,,7,"(10.886611,-74.776708)"
2017,Abril,El Salvador,222,1,0,,1,"(12.586067,-81.702563)"
2017,Abril,El Salvador,222,48,75,,123,"(3.541112,-76.384584)"
2017,Abril,El Salvador,222,772,913,,1685,"(4.697144,-74.140516)"
2017,Abril,El Salvador,222,1,2,,3,"(4.815061,-75.736532)"
2017,Abril,El Salvador,222,83,99,,182,"(6.171601,-75.427454)"
2017,Abril,Emiratos Árabes,784,1,0,,1,"(10.886611,-74.776708)"
2017,Abril,Emiratos Árabes,784,4,4,,8,"(3.541112,-76.384584)"
2017,Abril,Emiratos Árabes,784,82,362,,444,"(4.697144,-74.140516)"
2017,Abril,Emiratos Árabes,784,1,1,,2,"(4.815061,-75.736532)"
2017,Abril,Emiratos Árabes,784,10,4,,14,"(6.171601,-75.427454)"
2017,Abril,Eritrea,232,1,0,,1,"(4.697144,-74.140516)"
2017,Abril,Eslovenia,705,1,0,,1,"(3.541112,-76.384584)"
2017,Abril,Eslovenia,705,0,1,,1,"(4.697144,-74.140516)"
2017,Abril,Estados Unidos de América,840,1,0,,1,"(10.408582,-75.538003)"
2017,Abril,Estados Unidos de América,840,2,4,,6,"(10.433609,-73.247863)"
2017,Abril,Estados Unidos de América,840,3384,2656,,6040,"(10.445761,-75.516429)"
2017,Abril,Estados Unidos de América,840,3090,2443,,5533,"(10.886611,-74.776708)"
2017,Abril,Estados Unidos de América,840,4,4,,8,"(11.117806,-74.232622)"
2017,Abril,Estados Unidos de América,840,62,51,,113,"(12.586067,-81.702563)"
2017,Abril,Estados Unidos de América,840,5640,4053,,9693,"(3.541112,-76.384584)"
2017,Abril,Estados Unidos de América,840,492,394,,886,"(4.452882,-75.766298)"
2017,Abril,Estados Unidos de América,840,33272,28771,,62043,"(4.697144,-74.140516)"
2017,Abril,Estados Unidos de América,840,837,558,,1395,"(4.815061,-75.736532)"
2017,Abril,Estados Unidos de América,840,11068,8539,,19607,"(6.171601,-75.427454)"
2017,Abril,Estados Unidos de América,840,218,146,,364,"(7.128456,-73.183637)"
2017,Abril,Estonia,233,0,1,,1,"(4.697144,-74.140516)"
2017,Abril,Etiopia,231,0,1,,1,"(3.541112,-76.384584)"
2017,Abril,Etiopia,231,1,6,,7,"(4.697144,-74.140516)"
2017,Abril,Etiopia,231,0,1,,1,"(6.171601,-75.427454)"
2017,Abril,Filipinas,608,0,1,,1,"(10.886611,-74.776708)"
2017,Abril,Filipinas,608,1,1,,2,"(3.541112,-76.384584)"
2017,Abril,Filipinas,608,4,4,,8,"(4.697144,-74.140516)"
2017,Abril,Finlandia,246,0,1,,1,"(3.541112,-76.384584)"
2017,Abril,Finlandia,246,9,6,,15,"(4.697144,-74.140516)"
2017,Abril,Finlandia,246,1,0,,1,"(6.171601,-75.427454)"
2017,Abril,Francia,250,3,2,,5,"(10.445761,-75.516429)"
2017,Abril,Francia,250,19,8,,27,"(10.886611,-74.776708)"
2017,Abril,Francia,250,56,40,,96,"(3.541112,-76.384584)"
2017,Abril,Francia,250,1495,1203,,2698,"(4.697144,-74.140516)"
2017,Abril,Francia,250,1,0,,1,"(4.815061,-75.736532)"
2017,Abril,Francia,250,100,59,,159,"(6.171601,-75.427454)"
2017,Abril,Francia,250,1,0,,1,"(7.128456,-73.183637)"
2017,Abril,Georgia,268,0,1,,1,"(4.697144,-74.140516)"
2017,Abril,Ghana,288,1,3,,4,"(4.697144,-74.140516)"
2017,Abril,Gibraltar/Territorio Británico de Ultramar,292,0,3,,3,"(0.814836,-77.662532)"
2017,Abril,Granada,308,0,1,,1,"(3.541112,-76.384584)"
2017,Abril,Granada,308,0,1,,1,"(6.171601,-75.427454)"
2017,Abril,Grecia,300,4,2,,6,"(3.541112,-76.384584)"
2017,Abril,Grecia,300,27,12,,39,"(4.697144,-74.140516)"
2017,Abril,Grecia,300,1,1,,2,"(6.171601,-75.427454)"
2017,Abril,Guatemala,320,2,5,,7,"(10.445761,-75.516429)"
2017,Abril,Guatemala,320,9,17,,26,"(10.886611,-74.776708)"
2017,Abril,Guatemala,320,1,0,,1,"(12.586067,-81.702563)"
2017,Abril,Guatemala,320,59,100,,159,"(3.541112,-76.384584)"
2017,Abril,Guatemala,320,527,640,,1167,"(4.697144,-74.140516)"
2017,Abril,Guatemala,320,11,8,,19,"(4.815061,-75.736532)"
2017,Abril,Guatemala,320,110,155,,265,"(6.171601,-75.427454)"
2017,Abril,Guatemala,320,4,3,,7,"(7.128456,-73.183637)"
2017,Abril,Guyana,328,1,1,,2,"(10.445761,-75.516429)"
2017,Abril,Guyana,328,0,2,,2,"(12.586067,-81.702563)"
2017,Abril,Guyana,328,1,0,,1,"(4.697144,-74.140516)"
2017,Abril,Guyana,328,1,1,,2,"(4.815061,-75.736532)"
2017,Abril,Guyana,328,0,2,,2,"(6.171601,-75.427454)"
2017,Abril,Guyana,328,0,1,,1,"(7.128456,-73.183637)"
2017,Abril,Guinea Ecuatorial,226,1,0,,1,"(3.541112,-76.384584)"
2017,Abril,Guinea Ecuatorial,226,0,4,,4,"(4.697144,-74.140516)"
2017,Abril,Guadalupe/Territorio Francés,312,0,1,,1,"(10.886611,-74.776708)"
2017,Abril,Guadalupe/Territorio Francés,312,2,2,,4,"(4.697144,-74.140516)"
2017,Abril,Guayana Francesa/Departamento de Ultramar Francés,254,0,1,,1,"(10.886611,-74.776708)"
2017,Abril,Guayana Francesa/Departamento de Ultramar Francés,254,0,2,,2,"(6.171601,-75.427454)"
2017,Abril,Haití,332,1,1,,2,"(10.445761,-75.516429)"
2017,Abril,Haití,332,1,3,,4,"(10.886611,-74.776708)"
2017,Abril,Haití,332,2,1,,3,"(3.541112,-76.384584)"
2017,Abril,Haití,332,5,20,,25,"(4.697144,-74.140516)"
2017,Abril,Haití,332,1,2,,3,"(4.815061,-75.736532)"
2017,Abril,Haití,332,1,3,,4,"(6.171601,-75.427454)"
2017,Abril,Honduras,340,3,3,,6,"(10.445761,-75.516429)"
2017,Abril,Honduras,340,1,5,,6,"(10.886611,-74.776708)"
2017,Abril,Honduras,340,2,1,,3,"(12.586067,-81.702563)"
2017,Abril,Honduras,340,16,34,,50,"(3.541112,-76.384584)"
2017,Abril,Honduras,340,82,137,,219,"(4.697144,-74.140516)"
2017,Abril,Honduras,340,4,6,,10,"(4.815061,-75.736532)"
2017,Abril,Honduras,340,22,82,,104,"(6.171601,-75.427454)"
2017,Abril,Honduras,340,2,2,,4,"(7.128456,-73.183637)"
2017,Abril,Hong Kong,344,1,0,,1,"(10.445761,-75.516429)"
2017,Abril,Hong Kong,344,0,3,,3,"(10.886611,-74.776708)"
2017,Abril,Hong Kong,344,1,3,,4,"(3.541112,-76.384584)"
2017,Abril,Hong Kong,344,33,52,,85,"(4.697144,-74.140516)"
2017,Abril,Hong Kong,344,1,7,,8,"(6.171601,-75.427454)"
2017,Abril,Hungría,348,7,1,,8,"(4.697144,-74.140516)"
2017,Abril,Hungría,348,1,1,,2,"(6.171601,-75.427454)"
2017,Abril,India,356,0,1,,1,"(10.886611,-74.776708)"
2017,Abril,India,356,1,1,,2,"(3.541112,-76.384584)"
2017,Abril,India,356,32,27,,59,"(4.697144,-74.140516)"
2017,Abril,India,356,2,4,,6,"(6.171601,-75.427454)"
2017,Abril,India,356,0,1,,1,"(7.128456,-73.183637)"
2017,Abril,Indonesia,360,1,5,,6,"(4.697144,-74.140516)"
2017,Abril,Indonesia,360,1,1,,2,"(6.171601,-75.427454)"
2017,Abril,Iraq,368,0,1,,1,"(10.408582,-75.538003)"
2017,Abril,Iraq,368,0,4,,4,"(4.697144,-74.140516)"
2017,Abril,Irán,364,2,1,,3,"(4.697144,-74.140516)"
2017,Abril,República de Irlanda,372,1,1,,2,"(3.541112,-76.384584)"
2017,Abril,República de Irlanda,372,19,18,,37,"(4.697144,-74.140516)"
2017,Abril,República de Irlanda,372,6,0,,6,"(6.171601,-75.427454)"
2017,Abril,Islandia,352,5,4,,9,"(4.697144,-74.140516)"
2017,Abril,Israel,376,0,1,,1,"(10.886611,-74.776708)"
2017,Abril,Israel,376,6,6,,12,"(3.541112,-76.384584)"
2017,Abril,Israel,376,108,97,,205,"(4.697144,-74.140516)"
2017,Abril,Israel,376,6,3,,9,"(6.171601,-75.427454)"
2017,Abril,Italia,380,5,0,,5,"(10.445761,-75.516429)"
2017,Abril,Italia,380,7,4,,11,"(10.886611,-74.776708)"
2017,Abril,Italia,380,76,35,,111,"(3.541112,-76.384584)"
2017,Abril,Italia,380,714,487,,1201,"(4.697144,-74.140516)"
2017,Abril,Italia,380,1,0,,1,"(4.815061,-75.736532)"
2017,Abril,Italia,380,118,52,,170,"(6.171601,-75.427454)"
2017,Abril,Jamaica,388,3036,2271,,5307,"(10.408582,-75.538003)"
2017,Abril,Jamaica,388,2,2,,4,"(10.445761,-75.516429)"
2017,Abril,Jamaica,388,1,0,,1,"(10.886611,-74.776708)"
2017,Abril,Jamaica,388,1,4,,5,"(12.586067,-81.702563)"
2017,Abril,Jamaica,388,12,5,,17,"(3.541112,-76.384584)"
2017,Abril,Jamaica,388,26,22,,48,"(4.697144,-74.140516)"
2017,Abril,Jamaica,388,2,2,,4,"(4.815061,-75.736532)"
2017,Abril,Jamaica,388,14,12,,26,"(6.171601,-75.427454)"
2017,Abril,Jamaica,388,1,4,,5,"(7.128456,-73.183637)"
2017,Abril,Islas Salomón,90,0,1,,1,"(4.697144,-74.140516)"
2017,Abril,Japón,392,0,2,,2,"(10.445761,-75.516429)"
2017,Abril,Japón,392,4,0,,4,"(3.541112,-76.384584)"
2017,Abril,Japón,392,119,100,,219,"(4.697144,-74.140516)"
2017,Abril,Japón,392,10,9,,19,"(6.171601,-75.427454)"
2017,Abril,Jordania,400,4,2,,6,"(4.697144,-74.140516)"
2017,Abril,Kazajistán,398,0,2,,2,"(4.697144,-74.140516)"
2017,Abril,Kenia,404,2,5,,7,"(4.697144,-74.140516)"
2017,Abril,Kenia,404,1,0,,1,"(6.171601,-75.427454)"
2017,Abril,Kuwait,414,0,1,,1,"(3.541112,-76.384584)"
2017,Abril,República Democrática Popular  Lao,418,0,1,,1,"(4.697144,-74.140516)"
2017,Abril,Letonia,428,0,1,,1,"(6.171601,-75.427454)"
2017,Abril,Lituania,440,1,0,,1,"(6.171601,-75.427454)"
2017,Abril,Líbano,422,2,2,,4,"(10.886611,-74.776708)"
2017,Abril,Líbano,422,0,1,,1,"(12.586067,-81.702563)"
2017,Abril,Líbano,422,1,1,,2,"(3.541112,-76.384584)"
2017,Abril,Líbano,422,14,12,,26,"(4.697144,-74.140516)"
2017,Abril,Liechtenstein,438,1,0,,1,"(6.171601,-75.427454)"
2017,Abril,Luxemburgo,442,6,2,,8,"(4.697144,-74.140516)"
2017,Abril,Luxemburgo,442,1,0,,1,"(6.171601,-75.427454)"
2017,Abril,Malasia,458,0,2,,2,"(4.697144,-74.140516)"
2017,Abril,Malasia,458,1,0,,1,"(6.171601,-75.427454)"
2017,Abril,Malta,470,1,0,,1,"(10.886611,-74.776708)"
2017,Abril,Malta,470,19,15,,34,"(4.697144,-74.140516)"
2017,Abril,Marruecos,504,3,4,,7,"(3.541112,-76.384584)"
2017,Abril,Marruecos,504,16,11,,27,"(4.697144,-74.140516)"
2017,Abril,Marruecos,504,4,7,,11,"(6.171601,-75.427454)"
2017,Abril,Martinica/Departamento de Ultramar Francés,474,0,1,,1,"(4.697144,-74.140516)"
2017,Abril,México,484,1,1,,2,"(0.814836,-77.662532)"
2017,Abril,México,484,94,72,,166,"(10.445761,-75.516429)"
2017,Abril,México,484,182,151,,333,"(10.886611,-74.776708)"
2017,Abril,México,484,4,2,,6,"(12.586067,-81.702563)"
2017,Abril,México,484,880,719,,1599,"(3.541112,-76.384584)"
2017,Abril,México,484,13708,12385,,26093,"(4.697144,-74.140516)"
2017,Abril,México,484,149,139,,288,"(4.815061,-75.736532)"
2017,Abril,México,484,2163,1757,,3920,"(6.171601,-75.427454)"
2017,Abril,México,484,102,82,,184,"(7.128456,-73.183637)"
2017,Abril,Mónaco,492,2,1,,3,"(4.697144,-74.140516)"
2017,Abril,Mónaco,492,1,0,,1,"(6.171601,-75.427454)"
2017,Abril,Myanmar,104,0,3,,3,"(4.697144,-74.140516)"
2017,Abril,Namibia,516,0,1,,1,"(4.697144,-74.140516)"
2017,Abril,Nicaragua,558,3,1,,4,"(10.445761,-75.516429)"
2017,Abril,Nicaragua,558,0,7,,7,"(10.886611,-74.776708)"
2017,Abril,Nicaragua,558,0,6,,6,"(12.5744111,-81.703935)"
2017,Abril,Nicaragua,558,4,3,,7,"(12.586067,-81.702563)"
2017,Abril,Nicaragua,558,17,44,,61,"(3.541112,-76.384584)"
2017,Abril,Nicaragua,558,34,61,,95,"(4.697144,-74.140516)"
2017,Abril,Nicaragua,558,8,10,,18,"(4.815061,-75.736532)"
2017,Abril,Nicaragua,558,19,39,,58,"(6.171601,-75.427454)"
2017,Abril,Nicaragua,558,1,0,,1,"(7.128456,-73.183637)"
2017,Abril,Nigeria,566,0,6,,6,"(4.697144,-74.140516)"
2017,Abril,Noruega,578,1,0,,1,"(10.445761,-75.516429)"
2017,Abril,Noruega,578,3,2,,5,"(10.886611,-74.776708)"
2017,Abril,Noruega,578,1,1,,2,"(3.541112,-76.384584)"
2017,Abril,Noruega,578,18,21,,39,"(4.697144,-74.140516)"
2017,Abril,Noruega,578,2,1,,3,"(6.171601,-75.427454)"
2017,Abril,Nueva Caledonia/Territorio francés,540,0,1,,1,"(4.697144,-74.140516)"
2017,Abril,Nueva Zelanda,554,0,1,,1,"(3.541112,-76.384584)"
2017,Abril,Nueva Zelanda,554,38,31,,69,"(4.697144,-74.140516)"
2017,Abril,Nueva Zelanda,554,1,1,,2,"(4.815061,-75.736532)"
2017,Abril,Nueva Zelanda,554,1,1,,2,"(6.171601,-75.427454)"
2017,Abril,Omán,512,0,1,,1,"(10.445761,-75.516429)"
2017,Abril,Omán,512,0,2,,2,"(4.697144,-74.140516)"
2017,Abril,Papúa Nueva Guinea,598,1,0,,1,"(6.171601,-75.427454)"
2017,Abril,Pakistán,586,0,1,,1,"(3.541112,-76.384584)"
2017,Abril,Pakistán,586,0,1,,1,"(4.697144,-74.140516)"
2017,Abril,Panamá,591,26,93,,119,"(10.408582,-75.538003)"
2017,Abril,Panamá,591,829,747,,1576,"(10.445761,-75.516429)"
2017,Abril,Panamá,591,864,832,,1696,"(10.886611,-74.776708)"
2017,Abril,Panamá,591,3,26,,29,"(12.5744111,-81.703935)"
2017,Abril,Panamá,591,66,75,,141,"(12.586067,-81.702563)"
2017,Abril,Panamá,591,1919,1593,,3512,"(3.541112,-76.384584)"
2017,Abril,Panamá,591,1,1,,2,"(3.893038,-77.067921)"
2017,Abril,Panamá,591,291,212,,503,"(4.452882,-75.766298)"
2017,Abril,Panamá,591,7850,8196,,16046,"(4.697144,-74.140516)"
2017,Abril,Panamá,591,474,404,,878,"(4.815061,-75.736532)"
2017,Abril,Panamá,591,3141,2934,,6075,"(6.171601,-75.427454)"
2017,Abril,Panamá,591,1,5,,6,"(6.228046,-77.404104)"
2017,Abril,Panamá,591,6,15,,21,"(7.102626,-77.762647)"
2017,Abril,Panamá,591,203,187,,390,"(7.128456,-73.183637)"
2017,Abril,Panamá,591,0,30,,30,"(8.066966,-76.735404)"
2017,Abril,Panamá,591,25,73,,98,"(8.635765,-77.346578)"
2017,Abril,Panamá,591,0,1,,1,"(9.402978,-75.681599)"
2017,Abril,Paraguay,600,0,4,,4,"(0.814836,-77.662532)"
2017,Abril,Paraguay,600,4,5,,9,"(10.445761,-75.516429)"
2017,Abril,Paraguay,600,0,5,,5,"(10.886611,-74.776708)"
2017,Abril,Paraguay,600,2,2,,4,"(12.586067,-81.702563)"
2017,Abril,Paraguay,600,21,31,,52,"(3.541112,-76.384584)"
2017,Abril,Paraguay,600,75,210,,285,"(4.697144,-74.140516)"
2017,Abril,Paraguay,600,9,16,,25,"(4.815061,-75.736532)"
2017,Abril,Paraguay,600,12,25,,37,"(6.171601,-75.427454)"
2017,Abril,Perú,604,4,11,,15,"(-0.193180,-74.784874)"
2017,Abril,Perú,604,141,139,,280,"(-4.197703,-69.941278)"
2017,Abril,Perú,604,67,104,,171,"(-4.223468,-69.945098)"
2017,Abril,Perú,604,54,75,,129,"(0.814836,-77.662532)"
2017,Abril,Perú,604,1,1,,2,"(1.813928,-78.763924)"
2017,Abril,Perú,604,83,55,,138,"(10.445761,-75.516429)"
2017,Abril,Perú,604,22,26,,48,"(10.886611,-74.776708)"
2017,Abril,Perú,604,0,3,,3,"(11.117806,-74.232622)"
2017,Abril,Perú,604,1,5,,6,"(12.586067,-81.702563)"
2017,Abril,Perú,604,213,174,,387,"(3.541112,-76.384584)"
2017,Abril,Perú,604,5489,6096,,11585,"(4.697144,-74.140516)"
2017,Abril,Perú,604,7,13,,20,"(4.815061,-75.736532)"
2017,Abril,Perú,604,327,311,,638,"(6.171601,-75.427454)"
2017,Abril,Perú,604,2,1,,3,"(7.128456,-73.183637)"
2017,Abril,Palestina,99999,1,0,,1,"(4.697144,-74.140516)"
2017,Abril,Polonia,616,1,0,,1,"(3.541112,-76.384584)"
2017,Abril,Polonia,616,9,11,,20,"(4.697144,-74.140516)"
2017,Abril,Polonia,616,2,0,,2,"(6.171601,-75.427454)"
2017,Abril,Portugal,620,0,1,,1,"(10.445761,-75.516429)"
2017,Abril,Portugal,620,2,2,,4,"(10.886611,-74.776708)"
2017,Abril,Portugal,620,13,8,,21,"(3.541112,-76.384584)"
2017,Abril,Portugal,620,78,68,,146,"(4.697144,-74.140516)"
2017,Abril,Portugal,620,15,12,,27,"(6.171601,-75.427454)"
2017,Abril,Puerto Rico/Territorio de Estados Unidos,630,5,7,,12,"(10.445761,-75.516429)"
2017,Abril,Puerto Rico/Territorio de Estados Unidos,630,18,10,,28,"(10.886611,-74.776708)"
2017,Abril,Puerto Rico/Territorio de Estados Unidos,630,2,1,,3,"(12.586067,-81.702563)"
2017,Abril,Puerto Rico/Territorio de Estados Unidos,630,32,32,,64,"(3.541112,-76.384584)"
2017,Abril,Puerto Rico/Territorio de Estados Unidos,630,746,622,,1368,"(4.697144,-74.140516)"
2017,Abril,Puerto Rico/Territorio de Estados Unidos,630,5,5,,10,"(4.815061,-75.736532)"
2017,Abril,Puerto Rico/Territorio de Estados Unidos,630,62,57,,119,"(6.171601,-75.427454)"
2017,Abril,Puerto Rico/Territorio de Estados Unidos,630,6,1,,7,"(7.128456,-73.183637)"
2017,Abril,Qatar,634,1,0,,1,"(3.541112,-76.384584)"
2017,Abril,Qatar,634,11,5,,16,"(4.697144,-74.140516)"
2017,Abril,Qatar,634,0,2,,2,"(6.171601,-75.427454)"
2017,Abril,Reino Unido de Gran Bretaña e Irlanda del Norte,826,0,1,,1,"(10.445761,-75.516429)"
2017,Abril,Reino Unido de Gran Bretaña e Irlanda del Norte,826,2,1,,3,"(10.886611,-74.776708)"
2017,Abril,Reino Unido de Gran Bretaña e Irlanda del Norte,826,25,17,,42,"(3.541112,-76.384584)"
2017,Abril,Reino Unido de Gran Bretaña e Irlanda del Norte,826,1722,1374,,3096,"(4.697144,-74.140516)"
2017,Abril,Reino Unido de Gran Bretaña e Irlanda del Norte,826,31,41,,72,"(6.171601,-75.427454)"
2017,Abril,República CentroÁfricana,140,6,1,,7,"(4.697144,-74.140516)"
2017,Abril,Federación de Rusia,643,1,2,,3,"(10.886611,-74.776708)"
2017,Abril,Federación de Rusia,643,1,2,,3,"(3.541112,-76.384584)"
2017,Abril,Federación de Rusia,643,46,61,,107,"(4.697144,-74.140516)"
2017,Abril,Federación de Rusia,643,3,2,,5,"(6.171601,-75.427454)"
2017,Abril,República Dominicana,214,0,4,,4,"(10.408582,-75.538003)"
2017,Abril,República Dominicana,214,13,22,,35,"(10.445761,-75.516429)"
2017,Abril,República Dominicana,214,44,54,,98,"(10.886611,-74.776708)"
2017,Abril,República Dominicana,214,7,5,,12,"(11.117806,-74.232622)"
2017,Abril,República Dominicana,214,15,8,,23,"(12.586067,-81.702563)"
2017,Abril,República Dominicana,214,88,99,,187,"(3.541112,-76.384584)"
2017,Abril,República Dominicana,214,3152,3010,,6162,"(4.697144,-74.140516)"
2017,Abril,República Dominicana,214,65,47,,112,"(4.815061,-75.736532)"
2017,Abril,República Dominicana,214,339,252,,591,"(6.171601,-75.427454)"
2017,Abril,República Dominicana,214,47,48,,95,"(7.128456,-73.183637)"
2017,Abril,República Democrática Popular de Corea,408,1,0,,1,"(4.697144,-74.140516)"
2017,Abril,Rumania,642,0,1,,1,"(3.541112,-76.384584)"
2017,Abril,Rumania,642,1,5,,6,"(4.697144,-74.140516)"
2017,Abril,Rumania,642,1,0,,1,"(6.171601,-75.427454)"
2017,Abril,Rwanda,646,0,1,,1,"(4.697144,-74.140516)"
2017,Abril,San Marino,674,0,1,,1,"(4.697144,-74.140516)"
2017,Abril,San  Vicente y las Granadinas,670,0,1,,1,"(10.886611,-74.776708)"
2017,Abril,Santa Lucia,662,1,0,,1,"(4.697144,-74.140516)"
2017,Abril,Santo Tomé y Príncipe,678,1,0,,1,"(3.541112,-76.384584)"
2017,Abril,Singapur,702,0,2,,2,"(10.445761,-75.516429)"
2017,Abril,Singapur,702,18,10,,28,"(4.697144,-74.140516)"
2017,Abril,Singapur,702,0,1,,1,"(6.171601,-75.427454)"
2017,Abril,Sri Lanka,144,2,1,,3,"(4.697144,-74.140516)"
2017,Abril,Sri Lanka,144,1,1,,2,"(6.171601,-75.427454)"
2017,Abril,Sudáfrica,710,17,13,,30,"(4.697144,-74.140516)"
2017,Abril,Sudán,736,0,2,,2,"(4.697144,-74.140516)"
2017,Abril,Suecia,752,2,0,,2,"(10.445761,-75.516429)"
2017,Abril,Suecia,752,2,2,,4,"(10.886611,-74.776708)"
2017,Abril,Suecia,752,7,6,,13,"(3.541112,-76.384584)"
2017,Abril,Suecia,752,78,77,,155,"(4.697144,-74.140516)"
2017,Abril,Suecia,752,6,7,,13,"(6.171601,-75.427454)"
2017,Abril,Suiza,756,3,0,,3,"(10.445761,-75.516429)"
2017,Abril,Suiza,756,34,14,,48,"(3.541112,-76.384584)"
2017,Abril,Suiza,756,259,156,,415,"(4.697144,-74.140516)"
2017,Abril,Suiza,756,1,1,,2,"(4.815061,-75.736532)"
2017,Abril,Suiza,756,27,16,,43,"(6.171601,-75.427454)"
2017,Abril,Suiza,756,0,1,,1,"(7.128456,-73.183637)"
2017,Abril,Surinam,740,0,3,,3,"(4.697144,-74.140516)"
2017,Abril,Surinam,740,0,3,,3,"(6.171601,-75.427454)"
2017,Abril,Taiwán,158,0,1,,1,"(3.541112,-76.384584)"
2017,Abril,Taiwán,158,0,3,,3,"(4.697144,-74.140516)"
2017,Abril,Taiwán,158,0,1,,1,"(6.171601,-75.427454)"
2017,Abril,República de Tayikistán,762,2,0,,2,"(4.697144,-74.140516)"
2017,Abril,Tailandia,764,0,4,,4,"(3.541112,-76.384584)"
2017,Abril,Tailandia,764,27,37,,64,"(4.697144,-74.140516)"
2017,Abril,Tailandia,764,3,1,,4,"(6.171601,-75.427454)"
2017,Abril,Trinidad y Tobago,780,3,3,,6,"(10.445761,-75.516429)"
2017,Abril,Trinidad y Tobago,780,1,4,,5,"(10.886611,-74.776708)"
2017,Abril,Trinidad y Tobago,780,4,1,,5,"(3.541112,-76.384584)"
2017,Abril,Trinidad y Tobago,780,16,34,,50,"(4.697144,-74.140516)"
2017,Abril,Trinidad y Tobago,780,0,1,,1,"(4.815061,-75.736532)"
2017,Abril,Trinidad y Tobago,780,5,3,,8,"(6.171601,-75.427454)"
2017,Abril,Túnez,788,6,4,,10,"(4.697144,-74.140516)"
2017,Abril,Túnez,788,1,0,,1,"(7.818934,-72.453226)"
2017,Abril,Turquía,792,1,1,,2,"(10.886611,-74.776708)"
2017,Abril,Turquía,792,3,7,,10,"(3.541112,-76.384584)"
2017,Abril,Turquía,792,345,381,,726,"(4.697144,-74.140516)"
2017,Abril,Turquía,792,3,5,,8,"(6.171601,-75.427454)"
2017,Abril,Turkmenistán,795,0,1,,1,"(3.541112,-76.384584)"
2017,Abril,Turkmenistán,795,2,0,,2,"(4.697144,-74.140516)"
2017,Abril,Ucrania,804,0,2,,2,"(4.697144,-74.140516)"
2017,Abril,Uruguay,858,1,0,,1,"(10.445761,-75.516429)"
2017,Abril,Uruguay,858,1,1,,2,"(10.886611,-74.776708)"
2017,Abril,Uruguay,858,6,11,,17,"(3.541112,-76.384584)"
2017,Abril,Uruguay,858,119,119,,238,"(4.697144,-74.140516)"
2017,Abril,Uruguay,858,9,9,,18,"(4.815061,-75.736532)"
2017,Abril,Uruguay,858,24,22,,46,"(6.171601,-75.427454)"
2017,Abril,Uruguay,858,1,0,,1,"(7.128456,-73.183637)"
2017,Abril,Vanuatu,548,1,0,,1,"(4.697144,-74.140516)"
2017,Abril,Venezuela,862,0,5,,5,"(10.408582,-75.538003)"
2017,Abril,Venezuela,862,6,1,,7,"(10.445761,-75.516429)"
2017,Abril,Venezuela,862,5,10,,15,"(10.886611,-74.776708)"
2017,Abril,Venezuela,862,0,1,,1,"(11.117806,-74.232622)"
2017,Abril,Venezuela,862,2565,2499,,5064,"(11.360009,-72.129330)"
2017,Abril,Venezuela,862,13,9,,22,"(3.541112,-76.384584)"
2017,Abril,Venezuela,862,7,10,,17,"(3.866713,-67.927521)"
2017,Abril,Venezuela,862,1700,1576,,3276,"(4.697144,-74.140516)"
2017,Abril,Venezuela,862,2,1,,3,"(4.815061,-75.736532)"
2017,Abril,Venezuela,862,542,492,,1034,"(6.171601,-75.427454)"
2017,Abril,Venezuela,862,132,148,,280,"(6.185799,-67.483929)"
2017,Abril,Venezuela,862,753,688,,1441,"(7.088729,-70.740253)"
2017,Abril,Venezuela,862,5,2,,7,"(7.128456,-73.183637)"
2017,Abril,Venezuela,862,2533,2373,,4906,"(7.818934,-72.453226)"
2017,Abril,Venezuela,862,0,1,,1,"(7.927209,-72.507910)"
2017,Abril,Venezuela,862,242,260,,502,"(8.36068,-72.409396)"
2017,Abril,Vietnam,704,4,9,,13,"(4.697144,-74.140516)"
2017,Abril,Vietnam,704,2,0,,2,"(6.171601,-75.427454)"
2017,Abril,Islas Vírgenes Británicas/Territorio Británico de Ultramar,92,1,1,,2,"(3.541112,-76.384584)"
2017,Abril,Zambia,894,1,0,,1,"(4.697144,-74.140516)"
2017,Abril,Islas Turcas y Caicos/Territorio Británico de Ultramar,796,4,4,,8,"(10.445761,-75.516429)"
2017,Mayo,Afganistán,4,0,4,,4,"(4.697144,-74.140516)"
2017,Mayo,Albania,8,0,7,,7,"(4.697144,-74.140516)"
2017,Mayo,Alemania,276,24,15,,39,"(10.445761,-75.516429)"
2017,Mayo,Alemania,276,9,4,,13,"(10.886611,-74.776708)"
2017,Mayo,Alemania,276,41,40,,81,"(3.541112,-76.384584)"
2017,Mayo,Alemania,276,1478,1450,,2928,"(4.697144,-74.140516)"
2017,Mayo,Alemania,276,0,1,,1,"(4.815061,-75.736532)"
2017,Mayo,Alemania,276,89,87,,176,"(6.171601,-75.427454)"
2017,Mayo,Alemania,276,2,1,,3,"(7.128456,-73.183637)"
2017,Mayo,Andorra,20,1,1,,2,"(4.697144,-74.140516)"
2017,Mayo,Angola,24,1,8,,9,"(4.697144,-74.140516)"
2017,Mayo,Antigua y Barbuda,28,3,0,,3,"(4.697144,-74.140516)"
2017,Mayo,Países Bajos,528,216,177,,393,"(10.408582,-75.538003)"
2017,Mayo,Países Bajos,528,113,93,,206,"(10.445761,-75.516429)"
2017,Mayo,Países Bajos,528,53,24,,77,"(10.886611,-74.776708)"
2017,Mayo,Países Bajos,528,73,38,,111,"(3.541112,-76.384584)"
2017,Mayo,Países Bajos,528,1068,856,,1924,"(4.697144,-74.140516)"
2017,Mayo,Países Bajos,528,9,2,,11,"(4.815061,-75.736532)"
2017,Mayo,Países Bajos,528,133,101,,234,"(6.171601,-75.427454)"
2017,Mayo,Países Bajos,528,1,4,,5,"(7.128456,-73.183637)"
2017,Mayo,Arabia Saudita,682,0,1,,1,"(3.541112,-76.384584)"
2017,Mayo,Arabia Saudita,682,2,25,,27,"(4.697144,-74.140516)"
2017,Mayo,Arabia Saudita,682,0,3,,3,"(6.171601,-75.427454)"
2017,Mayo,Argelia,12,2,4,,6,"(4.697144,-74.140516)"
2017,Mayo,Argentina,32,15,30,,45,"(0.814836,-77.662532)"
2017,Mayo,Argentina,32,9,17,,26,"(10.445761,-75.516429)"
2017,Mayo,Argentina,32,7,7,,14,"(10.886611,-74.776708)"
2017,Mayo,Argentina,32,1,3,,4,"(12.586067,-81.702563)"
2017,Mayo,Argentina,32,58,66,,124,"(3.541112,-76.384584)"
2017,Mayo,Argentina,32,2404,2709,,5113,"(4.697144,-74.140516)"
2017,Mayo,Argentina,32,5,8,,13,"(4.815061,-75.736532)"
2017,Mayo,Argentina,32,69,105,,174,"(6.171601,-75.427454)"
2017,Mayo,Argentina,32,1,1,,2,"(7.128456,-73.183637)"
2017,Mayo,Aruba,533,1194,769,,1963,"(10.408582,-75.538003)"
2017,Mayo,Aruba,533,3,1,,4,"(10.445761,-75.516429)"
2017,Mayo,Aruba,533,6,5,,11,"(10.886611,-74.776708)"
2017,Mayo,Aruba,533,40,18,,58,"(3.541112,-76.384584)"
2017,Mayo,Aruba,533,1923,1440,,3363,"(4.697144,-74.140516)"
2017,Mayo,Aruba,533,13,2,,15,"(4.815061,-75.736532)"
2017,Mayo,Aruba,533,3,5,,8,"(6.17134,-75.427194)"
2017,Mayo,Aruba,533,55,32,,87,"(6.171601,-75.427454)"
2017,Mayo,Aruba,533,17,65,,82,"(7.128456,-73.183637)"
2017,Mayo,Australia,36,0,1,,1,"(10.445761,-75.516429)"
2017,Mayo,Australia,36,1,2,,3,"(10.886611,-74.776708)"
2017,Mayo,Australia,36,8,5,,13,"(3.541112,-76.384584)"
2017,Mayo,Australia,36,281,194,,475,"(4.697144,-74.140516)"
2017,Mayo,Australia,36,26,17,,43,"(6.171601,-75.427454)"
2017,Mayo,Australia,36,1,3,,4,"(7.128456,-73.183637)"
2017,Mayo,Austria,40,2,1,,3,"(10.445761,-75.516429)"
2017,Mayo,Austria,40,1,0,,1,"(10.886611,-74.776708)"
2017,Mayo,Austria,40,1,0,,1,"(3.541112,-76.384584)"
2017,Mayo,Austria,40,55,49,,104,"(4.697144,-74.140516)"
2017,Mayo,Austria,40,0,1,,1,"(4.815061,-75.736532)"
2017,Mayo,Austria,40,8,7,,15,"(6.171601,-75.427454)"
2017,Mayo,Bahamas,44,0,2,,2,"(10.445761,-75.516429)"
2017,Mayo,Bahamas,44,10,2,,12,"(3.541112,-76.384584)"
2017,Mayo,Bahamas,44,4,6,,10,"(4.697144,-74.140516)"
2017,Mayo,Bahamas,44,1,0,,1,"(4.815061,-75.736532)"
2017,Mayo,Bahamas,44,12,9,,21,"(6.171601,-75.427454)"
2017,Mayo,Bahamas,44,1,0,,1,"(7.128456,-73.183637)"
2017,Mayo,Bahréin,48,0,2,,2,"(3.541112,-76.384584)"
2017,Mayo,Bahréin,48,4,2,,6,"(4.697144,-74.140516)"
2017,Mayo,Bahréin,48,1,0,,1,"(6.171601,-75.427454)"
2017,Mayo,Bangladesh,50,1,1,,2,"(4.697144,-74.140516)"
2017,Mayo,Barbados,52,130,148,,278,"(4.697144,-74.140516)"
2017,Mayo,Bélgica,56,1,0,,1,"(10.445761,-75.516429)"
2017,Mayo,Bélgica,56,1,0,,1,"(10.886611,-74.776708)"
2017,Mayo,Bélgica,56,10,12,,22,"(3.541112,-76.384584)"
2017,Mayo,Bélgica,56,67,53,,120,"(4.697144,-74.140516)"
2017,Mayo,Bélgica,56,20,13,,33,"(6.171601,-75.427454)"
2017,Mayo,Belice,84,1,0,,1,"(10.886611,-74.776708)"
2017,Mayo,Belice,84,6,8,,14,"(3.541112,-76.384584)"
2017,Mayo,Belice,84,5,7,,12,"(4.697144,-74.140516)"
2017,Mayo,Belice,84,2,2,,4,"(6.171601,-75.427454)"
2017,Mayo,Benín,204,0,1,,1,"(3.541112,-76.384584)"
2017,Mayo,Benín,204,0,1,,1,"(4.697144,-74.140516)"
2017,Mayo,Bermudas/Territorio Británico de Ultramar,60,3,0,,3,"(3.541112,-76.384584)"
2017,Mayo,Bermudas/Territorio Británico de Ultramar,60,3,1,,4,"(4.697144,-74.140516)"
2017,Mayo,Bermudas/Territorio Británico de Ultramar,60,1,2,,3,"(6.171601,-75.427454)"
2017,Mayo,Bolivia,68,1,13,,14,"(0.814836,-77.662532)"
2017,Mayo,Bolivia,68,0,1,,1,"(1.813928,-78.763924)"
2017,Mayo,Bolivia,68,2,3,,5,"(10.445761,-75.516429)"
2017,Mayo,Bolivia,68,0,3,,3,"(10.886611,-74.776708)"
2017,Mayo,Bolivia,68,1,0,,1,"(12.586067,-81.702563)"
2017,Mayo,Bolivia,68,14,38,,52,"(3.541112,-76.384584)"
2017,Mayo,Bolivia,68,274,521,,795,"(4.697144,-74.140516)"
2017,Mayo,Bolivia,68,3,6,,9,"(4.815061,-75.736532)"
2017,Mayo,Bolivia,68,18,29,,47,"(6.171601,-75.427454)"
2017,Mayo,Bolivia,68,1,1,,2,"(7.128456,-73.183637)"
2017,Mayo,Bosnia y Herzegovina,70,10,3,,13,"(4.697144,-74.140516)"
2017,Mayo,Brasil,76,0,1,,1,"(-0.193180,-74.784874)"
2017,Mayo,Brasil,76,147,265,,412,"(-4.197703,-69.941278)"
2017,Mayo,Brasil,76,3,23,,26,"(-4.223468,-69.945098)"
2017,Mayo,Brasil,76,1,5,,6,"(0.814836,-77.662532)"
2017,Mayo,Brasil,76,4,6,,10,"(10.445761,-75.516429)"
2017,Mayo,Brasil,76,3,8,,11,"(10.886611,-74.776708)"
2017,Mayo,Brasil,76,0,2,,2,"(11.117806,-74.232622)"
2017,Mayo,Brasil,76,56,65,,121,"(3.541112,-76.384584)"
2017,Mayo,Brasil,76,2551,3633,,6184,"(4.697144,-74.140516)"
2017,Mayo,Brasil,76,18,32,,50,"(4.815061,-75.736532)"
2017,Mayo,Brasil,76,117,179,,296,"(6.171601,-75.427454)"
2017,Mayo,Brasil,76,5,3,,8,"(7.128456,-73.183637)"
2017,Mayo,Brunei Darussalam,96,0,1,,1,"(4.697144,-74.140516)"
2017,Mayo,Bulgaria,100,1,0,,1,"(4.697144,-74.140516)"
2017,Mayo,Bulgaria,100,0,1,,1,"(6.171601,-75.427454)"
2017,Mayo,Cabo Verde,132,1,0,,1,"(4.697144,-74.140516)"
2017,Mayo,Islas Caimán/Territorio Británico de Ultramar,136,1,0,,1,"(12.586067,-81.702563)"
2017,Mayo,Islas Caimán/Territorio Británico de Ultramar,136,0,1,,1,"(3.541112,-76.384584)"
2017,Mayo,Islas Caimán/Territorio Británico de Ultramar,136,2,3,,5,"(4.697144,-74.140516)"
2017,Mayo,Islas Caimán/Territorio Británico de Ultramar,136,0,2,,2,"(6.171601,-75.427454)"
2017,Mayo,Camboya,116,3,1,,4,"(4.697144,-74.140516)"
2017,Mayo,Camerún,120,1,0,,1,"(3.541112,-76.384584)"
2017,Mayo,Canadá,124,22,12,,34,"(10.445761,-75.516429)"
2017,Mayo,Canadá,124,57,57,,114,"(10.886611,-74.776708)"
2017,Mayo,Canadá,124,1,0,,1,"(12.586067,-81.702563)"
2017,Mayo,Canadá,124,159,113,,272,"(3.541112,-76.384584)"
2017,Mayo,Canadá,124,0,1,,1,"(4.452882,-75.766298)"
2017,Mayo,Canadá,124,2023,1471,,3494,"(4.697144,-74.140516)"
2017,Mayo,Canadá,124,11,9,,20,"(4.815061,-75.736532)"
2017,Mayo,Canadá,124,360,283,,643,"(6.171601,-75.427454)"
2017,Mayo,Canadá,124,12,6,,18,"(7.128456,-73.183637)"
2017,Mayo,Chad,148,1,0,,1,"(4.697144,-74.140516)"
2017,Mayo,España,724,7,8,,15,"(10.445761,-75.516429)"
2017,Mayo,España,724,13,11,,24,"(10.886611,-74.776708)"
2017,Mayo,España,724,3392,2307,,5699,"(3.541112,-76.384584)"
2017,Mayo,España,724,0,1,,1,"(4.452882,-75.766298)"
2017,Mayo,España,724,15077,11136,,26213,"(4.697144,-74.140516)"
2017,Mayo,España,724,11,7,,18,"(4.815061,-75.736532)"
2017,Mayo,España,724,2784,1962,,4746,"(6.171601,-75.427454)"
2017,Mayo,España,724,7,4,,11,"(7.128456,-73.183637)"
2017,Mayo,Colombia,170,3,11,,14,"(10.445761,-75.516429)"
2017,Mayo,Colombia,170,173,476,,649,"(4.697144,-74.140516)"
2017,Mayo,República Democrática del Congo,180,0,1,,1,"(3.541112,-76.384584)"
2017,Mayo,República de Corea,410,0,1,,1,"(3.541112,-76.384584)"
2017,Mayo,República de Corea,410,18,20,,38,"(4.697144,-74.140516)"
2017,Mayo,República de Corea,410,1,4,,5,"(6.171601,-75.427454)"
2017,Mayo,Costa de Marfil,384,1,0,,1,"(3.541112,-76.384584)"
2017,Mayo,Costa de Marfil,384,6,4,,10,"(4.697144,-74.140516)"
2017,Mayo,Costa de Marfil,384,1,2,,3,"(6.171601,-75.427454)"
2017,Mayo,Costa Rica,188,5,11,,16,"(10.445761,-75.516429)"
2017,Mayo,Costa Rica,188,20,32,,52,"(10.886611,-74.776708)"
2017,Mayo,Costa Rica,188,3,26,,29,"(12.5744111,-81.703935)"
2017,Mayo,Costa Rica,188,15,13,,28,"(12.586067,-81.702563)"
2017,Mayo,Costa Rica,188,41,46,,87,"(3.541112,-76.384584)"
2017,Mayo,Costa Rica,188,1068,1273,,2341,"(4.697144,-74.140516)"
2017,Mayo,Costa Rica,188,13,8,,21,"(4.815061,-75.736532)"
2017,Mayo,Costa Rica,188,0,2,,2,"(6.17134,-75.427194)"
2017,Mayo,Costa Rica,188,134,160,,294,"(6.171601,-75.427454)"
2017,Mayo,Costa Rica,188,4,8,,12,"(7.128456,-73.183637)"
2017,Mayo,Croacia,191,1,0,,1,"(10.445761,-75.516429)"
2017,Mayo,Croacia,191,9,7,,16,"(4.697144,-74.140516)"
2017,Mayo,Croacia,191,0,1,,1,"(6.171601,-75.427454)"
2017,Mayo,Cuba,192,11,12,,23,"(10.445761,-75.516429)"
2017,Mayo,Cuba,192,11,10,,21,"(10.886611,-74.776708)"
2017,Mayo,Cuba,192,11,5,,16,"(12.586067,-81.702563)"
2017,Mayo,Cuba,192,72,46,,118,"(3.541112,-76.384584)"
2017,Mayo,Cuba,192,1366,1228,,2594,"(4.697144,-74.140516)"
2017,Mayo,Cuba,192,12,13,,25,"(4.815061,-75.736532)"
2017,Mayo,Cuba,192,166,125,,291,"(6.171601,-75.427454)"
2017,Mayo,Cuba,192,23,8,,31,"(7.128456,-73.183637)"
2017,Mayo,Curazao,99999,16,34,,50,"(4.697144,-74.140516)"
2017,Mayo,República Checa,203,38,33,,71,"(4.697144,-74.140516)"
2017,Mayo,República Checa,203,1,2,,3,"(6.171601,-75.427454)"
2017,Mayo,Chile,152,228,226,,454,"(0.814836,-77.662532)"
2017,Mayo,Chile,152,0,1,,1,"(1.813928,-78.763924)"
2017,Mayo,Chile,152,20,17,,37,"(10.445761,-75.516429)"
2017,Mayo,Chile,152,26,22,,48,"(10.886611,-74.776708)"
2017,Mayo,Chile,152,0,1,,1,"(12.586067,-81.702563)"
2017,Mayo,Chile,152,314,194,,508,"(3.541112,-76.384584)"
2017,Mayo,Chile,152,3519,3520,,7039,"(4.697144,-74.140516)"
2017,Mayo,Chile,152,82,67,,149,"(4.815061,-75.736532)"
2017,Mayo,Chile,152,86,87,,173,"(6.171601,-75.427454)"
2017,Mayo,Chile,152,6,6,,12,"(7.128456,-73.183637)"
2017,Mayo,China,156,2,4,,6,"(10.445761,-75.516429)"
2017,Mayo,China,156,0,2,,2,"(10.886611,-74.776708)"
2017,Mayo,China,156,0,4,,4,"(3.541112,-76.384584)"
2017,Mayo,China,156,231,503,,734,"(4.697144,-74.140516)"
2017,Mayo,China,156,1,0,,1,"(4.815061,-75.736532)"
2017,Mayo,China,156,26,59,,85,"(6.171601,-75.427454)"
2017,Mayo,China,156,0,3,,3,"(7.128456,-73.183637)"
2017,Mayo,Dinamarca,208,1,0,,1,"(10.886611,-74.776708)"
2017,Mayo,Dinamarca,208,2,2,,4,"(3.541112,-76.384584)"
2017,Mayo,Dinamarca,208,37,31,,68,"(4.697144,-74.140516)"
2017,Mayo,Dinamarca,208,8,10,,18,"(6.171601,-75.427454)"
2017,Mayo,Ecuador,218,2,5,,7,"(-0.193180,-74.784874)"
2017,Mayo,Ecuador,218,441,761,,1202,"(0.25129,-76.875963)"
2017,Mayo,Ecuador,218,22,23,,45,"(0.812436,-77.847006)"
2017,Mayo,Ecuador,218,4717,5712,,10429,"(0.814836,-77.662532)"
2017,Mayo,Ecuador,218,174,217,,391,"(1.813928,-78.763924)"
2017,Mayo,Ecuador,218,6,6,,12,"(10.445761,-75.516429)"
2017,Mayo,Ecuador,218,8,12,,20,"(10.886611,-74.776708)"
2017,Mayo,Ecuador,218,263,380,,643,"(3.541112,-76.384584)"
2017,Mayo,Ecuador,218,2544,4126,,6670,"(4.697144,-74.140516)"
2017,Mayo,Ecuador,218,0,3,,3,"(4.815061,-75.736532)"
2017,Mayo,Ecuador,218,38,68,,106,"(6.171601,-75.427454)"
2017,Mayo,Ecuador,218,3,0,,3,"(7.128456,-73.183637)"
2017,Mayo,Egipto,818,0,1,,1,"(3.541112,-76.384584)"
2017,Mayo,Egipto,818,18,15,,33,"(4.697144,-74.140516)"
2017,Mayo,Egipto,818,6,1,,7,"(6.171601,-75.427454)"
2017,Mayo,El Salvador,222,4,0,,4,"(10.445761,-75.516429)"
2017,Mayo,El Salvador,222,4,9,,13,"(10.886611,-74.776708)"
2017,Mayo,El Salvador,222,0,1,,1,"(12.586067,-81.702563)"
2017,Mayo,El Salvador,222,111,103,,214,"(3.541112,-76.384584)"
2017,Mayo,El Salvador,222,709,953,,1662,"(4.697144,-74.140516)"
2017,Mayo,El Salvador,222,1,1,,2,"(4.815061,-75.736532)"
2017,Mayo,El Salvador,222,51,73,,124,"(6.171601,-75.427454)"
2017,Mayo,El Salvador,222,1,0,,1,"(7.128456,-73.183637)"
2017,Mayo,Emiratos Árabes,784,1,4,,5,"(3.541112,-76.384584)"
2017,Mayo,Emiratos Árabes,784,71,129,,200,"(4.697144,-74.140516)"
2017,Mayo,Emiratos Árabes,784,5,8,,13,"(6.171601,-75.427454)"
2017,Mayo,Eritrea,232,0,1,,1,"(4.697144,-74.140516)"
2017,Mayo,Eslovaquia,703,0,1,,1,"(4.697144,-74.140516)"
2017,Mayo,Eslovenia,705,2,1,,3,"(4.697144,-74.140516)"
2017,Mayo,Estados Unidos de América,840,0,1,,1,"(0.814836,-77.662532)"
2017,Mayo,Estados Unidos de América,840,1,19,,20,"(10.408582,-75.538003)"
2017,Mayo,Estados Unidos de América,840,1,2,,3,"(10.433609,-73.247863)"
2017,Mayo,Estados Unidos de América,840,2854,2222,,5076,"(10.445761,-75.516429)"
2017,Mayo,Estados Unidos de América,840,2700,2202,,4902,"(10.886611,-74.776708)"
2017,Mayo,Estados Unidos de América,840,0,6,,6,"(11.117806,-74.232622)"
2017,Mayo,Estados Unidos de América,840,62,48,,110,"(12.586067,-81.702563)"
2017,Mayo,Estados Unidos de América,840,5789,4019,,9808,"(3.541112,-76.384584)"
2017,Mayo,Estados Unidos de América,840,619,465,,1084,"(4.452882,-75.766298)"
2017,Mayo,Estados Unidos de América,840,32142,27938,,60080,"(4.697144,-74.140516)"
2017,Mayo,Estados Unidos de América,840,1016,628,,1644,"(4.815061,-75.736532)"
2017,Mayo,Estados Unidos de América,840,3,6,,9,"(6.17134,-75.427194)"
2017,Mayo,Estados Unidos de América,840,10595,7986,,18581,"(6.171601,-75.427454)"
2017,Mayo,Estados Unidos de América,840,245,190,,435,"(7.128456,-73.183637)"
2017,Mayo,Estonia,233,2,2,,4,"(4.697144,-74.140516)"
2017,Mayo,Etiopia,231,1,2,,3,"(4.697144,-74.140516)"
2017,Mayo,Filipinas,608,4,3,,7,"(4.697144,-74.140516)"
2017,Mayo,Finlandia,246,1,1,,2,"(3.541112,-76.384584)"
2017,Mayo,Finlandia,246,5,7,,12,"(4.697144,-74.140516)"
2017,Mayo,Finlandia,246,1,0,,1,"(6.171601,-75.427454)"
2017,Mayo,Francia,250,4,2,,6,"(10.445761,-75.516429)"
2017,Mayo,Francia,250,6,4,,10,"(10.886611,-74.776708)"
2017,Mayo,Francia,250,67,51,,118,"(3.541112,-76.384584)"
2017,Mayo,Francia,250,1660,1346,,3006,"(4.697144,-74.140516)"
2017,Mayo,Francia,250,4,0,,4,"(4.815061,-75.736532)"
2017,Mayo,Francia,250,104,66,,170,"(6.171601,-75.427454)"
2017,Mayo,Gabón,266,1,1,,2,"(4.697144,-74.140516)"
2017,Mayo,Georgia,268,1,0,,1,"(3.541112,-76.384584)"
2017,Mayo,Georgia,268,0,1,,1,"(4.697144,-74.140516)"
2017,Mayo,Ghana,288,1,5,,6,"(4.697144,-74.140516)"
2017,Mayo,Gibraltar/Territorio Británico de Ultramar,292,1,0,,1,"(0.814836,-77.662532)"
2017,Mayo,Gibraltar/Territorio Británico de Ultramar,292,1,0,,1,"(10.886611,-74.776708)"
2017,Mayo,Gibraltar/Territorio Británico de Ultramar,292,0,1,,1,"(4.697144,-74.140516)"
2017,Mayo,Granada,308,2,0,,2,"(12.586067,-81.702563)"
2017,Mayo,Grecia,300,1,1,,2,"(10.445761,-75.516429)"
2017,Mayo,Grecia,300,1,0,,1,"(3.541112,-76.384584)"
2017,Mayo,Grecia,300,30,18,,48,"(4.697144,-74.140516)"
2017,Mayo,Grecia,300,5,3,,8,"(6.171601,-75.427454)"
2017,Mayo,Guatemala,320,1,7,,8,"(10.445761,-75.516429)"
2017,Mayo,Guatemala,320,7,6,,13,"(10.886611,-74.776708)"
2017,Mayo,Guatemala,320,3,4,,7,"(12.586067,-81.702563)"
2017,Mayo,Guatemala,320,47,98,,145,"(3.541112,-76.384584)"
2017,Mayo,Guatemala,320,460,692,,1152,"(4.697144,-74.140516)"
2017,Mayo,Guatemala,320,5,10,,15,"(4.815061,-75.736532)"
2017,Mayo,Guatemala,320,99,160,,259,"(6.171601,-75.427454)"
2017,Mayo,Guatemala,320,3,4,,7,"(7.128456,-73.183637)"
2017,Mayo,Guyana,328,0,1,,1,"(10.408582,-75.538003)"
2017,Mayo,Guyana,328,0,1,,1,"(10.445761,-75.516429)"
2017,Mayo,Guyana,328,1,3,,4,"(10.886611,-74.776708)"
2017,Mayo,Guyana,328,1,0,,1,"(3.541112,-76.384584)"
2017,Mayo,Guyana,328,2,3,,5,"(4.697144,-74.140516)"
2017,Mayo,Guyana,328,0,2,,2,"(6.171601,-75.427454)"
2017,Mayo,Guyana,328,0,1,,1,"(7.128456,-73.183637)"
2017,Mayo,Guinea Ecuatorial,226,1,0,,1,"(3.541112,-76.384584)"
2017,Mayo,Guinea Ecuatorial,226,2,4,,6,"(4.697144,-74.140516)"
2017,Mayo,Guadalupe/Territorio Francés,312,5,3,,8,"(4.697144,-74.140516)"
2017,Mayo,Guayana Francesa/Departamento de Ultramar Francés,254,0,1,,1,"(4.697144,-74.140516)"
2017,Mayo,Guayana Francesa/Departamento de Ultramar Francés,254,1,0,,1,"(6.171601,-75.427454)"
2017,Mayo,Haití,332,0,1,,1,"(10.408582,-75.538003)"
2017,Mayo,Haití,332,1,3,,4,"(10.886611,-74.776708)"
2017,Mayo,Haití,332,0,1,,1,"(3.541112,-76.384584)"
2017,Mayo,Haití,332,1,8,,9,"(4.697144,-74.140516)"
2017,Mayo,Haití,332,3,7,,10,"(6.171601,-75.427454)"
2017,Mayo,Honduras,340,0,2,,2,"(10.445761,-75.516429)"
2017,Mayo,Honduras,340,4,8,,12,"(10.886611,-74.776708)"
2017,Mayo,Honduras,340,0,1,,1,"(12.5744111,-81.703935)"
2017,Mayo,Honduras,340,14,24,,38,"(3.541112,-76.384584)"
2017,Mayo,Honduras,340,62,144,,206,"(4.697144,-74.140516)"
2017,Mayo,Honduras,340,3,4,,7,"(4.815061,-75.736532)"
2017,Mayo,Honduras,340,18,74,,92,"(6.171601,-75.427454)"
2017,Mayo,Honduras,340,0,4,,4,"(7.128456,-73.183637)"
2017,Mayo,Hong Kong,344,1,0,,1,"(10.445761,-75.516429)"
2017,Mayo,Hong Kong,344,0,1,,1,"(3.541112,-76.384584)"
2017,Mayo,Hong Kong,344,14,25,,39,"(4.697144,-74.140516)"
2017,Mayo,Hong Kong,344,0,2,,2,"(4.815061,-75.736532)"
2017,Mayo,Hong Kong,344,1,4,,5,"(6.171601,-75.427454)"
2017,Mayo,Hungría,348,8,5,,13,"(4.697144,-74.140516)"
2017,Mayo,Hungría,348,4,1,,5,"(6.171601,-75.427454)"
2017,Mayo,India,356,1,1,,2,"(10.445761,-75.516429)"
2017,Mayo,India,356,29,19,,48,"(4.697144,-74.140516)"
2017,Mayo,India,356,1,3,,4,"(6.171601,-75.427454)"
2017,Mayo,India,356,1,0,,1,"(7.128456,-73.183637)"
2017,Mayo,Indonesia,360,2,1,,3,"(4.697144,-74.140516)"
2017,Mayo,Iraq,368,1,4,,5,"(4.697144,-74.140516)"
2017,Mayo,Iraq,368,0,1,,1,"(6.171601,-75.427454)"
2017,Mayo,Irán,364,1,0,,1,"(4.697144,-74.140516)"
2017,Mayo,República de Irlanda,372,1,0,,1,"(10.445761,-75.516429)"
2017,Mayo,República de Irlanda,372,1,0,,1,"(10.886611,-74.776708)"
2017,Mayo,República de Irlanda,372,1,0,,1,"(3.541112,-76.384584)"
2017,Mayo,República de Irlanda,372,11,5,,16,"(4.697144,-74.140516)"
2017,Mayo,República de Irlanda,372,1,1,,2,"(6.171601,-75.427454)"
2017,Mayo,Islandia,352,2,2,,4,"(4.697144,-74.140516)"
2017,Mayo,Israel,376,0,1,,1,"(10.886611,-74.776708)"
2017,Mayo,Israel,376,6,2,,8,"(3.541112,-76.384584)"
2017,Mayo,Israel,376,136,78,,214,"(4.697144,-74.140516)"
2017,Mayo,Israel,376,0,1,,1,"(4.815061,-75.736532)"
2017,Mayo,Israel,376,7,4,,11,"(6.171601,-75.427454)"
2017,Mayo,Israel,376,0,2,,2,"(7.128456,-73.183637)"
2017,Mayo,Italia,380,9,7,,16,"(10.445761,-75.516429)"
2017,Mayo,Italia,380,8,9,,17,"(10.886611,-74.776708)"
2017,Mayo,Italia,380,0,2,,2,"(12.586067,-81.702563)"
2017,Mayo,Italia,380,102,43,,145,"(3.541112,-76.384584)"
2017,Mayo,Italia,380,763,576,,1339,"(4.697144,-74.140516)"
2017,Mayo,Italia,380,144,111,,255,"(6.171601,-75.427454)"
2017,Mayo,Italia,380,1,1,,2,"(7.128456,-73.183637)"
2017,Mayo,Jamaica,388,523,349,,872,"(10.408582,-75.538003)"
2017,Mayo,Jamaica,388,2,7,,9,"(10.445761,-75.516429)"
2017,Mayo,Jamaica,388,2,3,,5,"(10.886611,-74.776708)"
2017,Mayo,Jamaica,388,0,1,,1,"(12.586067,-81.702563)"
2017,Mayo,Jamaica,388,6,5,,11,"(3.541112,-76.384584)"
2017,Mayo,Jamaica,388,22,22,,44,"(4.697144,-74.140516)"
2017,Mayo,Jamaica,388,5,7,,12,"(4.815061,-75.736532)"
2017,Mayo,Jamaica,388,7,3,,10,"(6.171601,-75.427454)"
2017,Mayo,Japón,392,2,0,,2,"(10.886611,-74.776708)"
2017,Mayo,Japón,392,2,1,,3,"(3.541112,-76.384584)"
2017,Mayo,Japón,392,90,116,,206,"(4.697144,-74.140516)"
2017,Mayo,Japón,392,1,0,,1,"(4.815061,-75.736532)"
2017,Mayo,Japón,392,5,7,,12,"(6.171601,-75.427454)"
2017,Mayo,Jordania,400,3,3,,6,"(4.697144,-74.140516)"
2017,Mayo,Kazajistán,398,0,2,,2,"(4.697144,-74.140516)"
2017,Mayo,Kenia,404,1,7,,8,"(4.697144,-74.140516)"
2017,Mayo,Kuwait,414,0,1,,1,"(4.697144,-74.140516)"
2017,Mayo,Letonia,428,0,1,,1,"(4.697144,-74.140516)"
2017,Mayo,Lituania,440,1,2,,3,"(4.697144,-74.140516)"
2017,Mayo,Líbano,422,0,2,,2,"(10.886611,-74.776708)"
2017,Mayo,Líbano,422,8,18,,26,"(4.697144,-74.140516)"
2017,Mayo,Luxemburgo,442,1,0,,1,"(3.541112,-76.384584)"
2017,Mayo,Luxemburgo,442,5,1,,6,"(4.697144,-74.140516)"
2017,Mayo,Luxemburgo,442,2,0,,2,"(6.171601,-75.427454)"
2017,Mayo,Malasia,458,0,1,,1,"(3.541112,-76.384584)"
2017,Mayo,Malasia,458,4,3,,7,"(4.697144,-74.140516)"
2017,Mayo,Malasia,458,1,0,,1,"(6.171601,-75.427454)"
2017,Mayo,Malasia,458,0,1,,1,"(7.128456,-73.183637)"
2017,Mayo,Malí,466,0,1,,1,"(4.697144,-74.140516)"
2017,Mayo,Malta,470,20,20,,40,"(4.697144,-74.140516)"
2017,Mayo,Malta,470,3,1,,4,"(6.171601,-75.427454)"
2017,Mayo,Marruecos,504,5,4,,9,"(4.697144,-74.140516)"
2017,Mayo,Marruecos,504,2,0,,2,"(6.171601,-75.427454)"
2017,Mayo,Mauricio,480,1,0,,1,"(4.697144,-74.140516)"
2017,Mayo,México,484,51,34,,85,"(10.445761,-75.516429)"
2017,Mayo,México,484,150,136,,286,"(10.886611,-74.776708)"
2017,Mayo,México,484,6,5,,11,"(12.586067,-81.702563)"
2017,Mayo,México,484,798,625,,1423,"(3.541112,-76.384584)"
2017,Mayo,México,484,12378,11381,,23759,"(4.697144,-74.140516)"
2017,Mayo,México,484,109,120,,229,"(4.815061,-75.736532)"
2017,Mayo,México,484,2214,1659,,3873,"(6.171601,-75.427454)"
2017,Mayo,México,484,156,115,,271,"(7.128456,-73.183637)"
2017,Mayo,Mónaco,492,1,1,,2,"(4.697144,-74.140516)"
2017,Mayo,Mónaco,492,1,0,,1,"(4.815061,-75.736532)"
2017,Mayo,Mongolia,496,1,1,,2,"(4.697144,-74.140516)"
2017,Mayo,Montenegro,499,0,1,,1,"(4.697144,-74.140516)"
2017,Mayo,Mozambique,508,0,1,,1,"(4.697144,-74.140516)"
2017,Mayo,Myanmar,104,0,1,,1,"(4.697144,-74.140516)"
2017,Mayo,Myanmar,104,1,0,,1,"(4.815061,-75.736532)"
2017,Mayo,Nicaragua,558,1,1,,2,"(10.445761,-75.516429)"
2017,Mayo,Nicaragua,558,6,9,,15,"(10.886611,-74.776708)"
2017,Mayo,Nicaragua,558,0,1,,1,"(12.5744111,-81.703935)"
2017,Mayo,Nicaragua,558,1,4,,5,"(12.586067,-81.702563)"
2017,Mayo,Nicaragua,558,16,39,,55,"(3.541112,-76.384584)"
2017,Mayo,Nicaragua,558,27,78,,105,"(4.697144,-74.140516)"
2017,Mayo,Nicaragua,558,4,4,,8,"(4.815061,-75.736532)"
2017,Mayo,Nicaragua,558,21,59,,80,"(6.171601,-75.427454)"
2017,Mayo,Nicaragua,558,1,1,,2,"(7.128456,-73.183637)"
2017,Mayo,Nigeria,566,1,12,,13,"(4.697144,-74.140516)"
2017,Mayo,Nigeria,566,0,1,,1,"(6.171601,-75.427454)"
2017,Mayo,Noruega,578,2,0,,2,"(10.886611,-74.776708)"
2017,Mayo,Noruega,578,1,1,,2,"(3.541112,-76.384584)"
2017,Mayo,Noruega,578,23,21,,44,"(4.697144,-74.140516)"
2017,Mayo,Noruega,578,3,2,,5,"(6.171601,-75.427454)"
2017,Mayo,Nueva Zelanda,554,1,0,,1,"(3.541112,-76.384584)"
2017,Mayo,Nueva Zelanda,554,12,18,,30,"(4.697144,-74.140516)"
2017,Mayo,Nueva Zelanda,554,2,0,,2,"(6.171601,-75.427454)"
2017,Mayo,Omán,512,2,4,,6,"(4.697144,-74.140516)"
2017,Mayo,Pakistán,586,0,1,,1,"(4.697144,-74.140516)"
2017,Mayo,Panamá,591,21,136,,157,"(10.408582,-75.538003)"
2017,Mayo,Panamá,591,744,635,,1379,"(10.445761,-75.516429)"
2017,Mayo,Panamá,591,830,762,,1592,"(10.886611,-74.776708)"
2017,Mayo,Panamá,591,0,10,,10,"(10.971302,-74.765397)"
2017,Mayo,Panamá,591,2,3,,5,"(11.247723,-74.213989)"
2017,Mayo,Panamá,591,0,7,,7,"(12.5744111,-81.703935)"
2017,Mayo,Panamá,591,92,80,,172,"(12.586067,-81.702563)"
2017,Mayo,Panamá,591,1726,1598,,3324,"(3.541112,-76.384584)"
2017,Mayo,Panamá,591,356,264,,620,"(4.452882,-75.766298)"
2017,Mayo,Panamá,591,7285,8422,,15707,"(4.697144,-74.140516)"
2017,Mayo,Panamá,591,386,313,,699,"(4.815061,-75.736532)"
2017,Mayo,Panamá,591,2,2,,4,"(6.17134,-75.427194)"
2017,Mayo,Panamá,591,2845,2754,,5599,"(6.171601,-75.427454)"
2017,Mayo,Panamá,591,0,2,,2,"(6.228046,-77.404104)"
2017,Mayo,Panamá,591,1,8,,9,"(7.102626,-77.762647)"
2017,Mayo,Panamá,591,191,180,,371,"(7.128456,-73.183637)"
2017,Mayo,Panamá,591,0,31,,31,"(8.066966,-76.735404)"
2017,Mayo,Panamá,591,23,48,,71,"(8.635765,-77.346578)"
2017,Mayo,Paraguay,600,0,1,,1,"(0.814836,-77.662532)"
2017,Mayo,Paraguay,600,2,2,,4,"(10.445761,-75.516429)"
2017,Mayo,Paraguay,600,2,8,,10,"(10.886611,-74.776708)"
2017,Mayo,Paraguay,600,0,4,,4,"(12.586067,-81.702563)"
2017,Mayo,Paraguay,600,9,47,,56,"(3.541112,-76.384584)"
2017,Mayo,Paraguay,600,70,203,,273,"(4.697144,-74.140516)"
2017,Mayo,Paraguay,600,5,7,,12,"(4.815061,-75.736532)"
2017,Mayo,Paraguay,600,17,44,,61,"(6.171601,-75.427454)"
2017,Mayo,Perú,604,4,18,,22,"(-0.193180,-74.784874)"
2017,Mayo,Perú,604,53,84,,137,"(-4.197703,-69.941278)"
2017,Mayo,Perú,604,34,50,,84,"(-4.223468,-69.945098)"
2017,Mayo,Perú,604,72,107,,179,"(0.814836,-77.662532)"
2017,Mayo,Perú,604,33,53,,86,"(10.445761,-75.516429)"
2017,Mayo,Perú,604,17,9,,26,"(10.886611,-74.776708)"
2017,Mayo,Perú,604,0,1,,1,"(12.586067,-81.702563)"
2017,Mayo,Perú,604,130,140,,270,"(3.541112,-76.384584)"
2017,Mayo,Perú,604,4640,6176,,10816,"(4.697144,-74.140516)"
2017,Mayo,Perú,604,19,14,,33,"(4.815061,-75.736532)"
2017,Mayo,Perú,604,216,282,,498,"(6.171601,-75.427454)"
2017,Mayo,Perú,604,1,1,,2,"(7.128456,-73.183637)"
2017,Mayo,Polonia,616,1,2,,3,"(3.541112,-76.384584)"
2017,Mayo,Polonia,616,18,20,,38,"(4.697144,-74.140516)"
2017,Mayo,Polonia,616,6,4,,10,"(6.171601,-75.427454)"
2017,Mayo,Portugal,620,0,1,,1,"(10.886611,-74.776708)"
2017,Mayo,Portugal,620,8,3,,11,"(3.541112,-76.384584)"
2017,Mayo,Portugal,620,204,115,,319,"(4.697144,-74.140516)"
2017,Mayo,Portugal,620,1,0,,1,"(4.815061,-75.736532)"
2017,Mayo,Portugal,620,20,17,,37,"(6.171601,-75.427454)"
2017,Mayo,Puerto Rico/Territorio de Estados Unidos,630,2,4,,6,"(10.445761,-75.516429)"
2017,Mayo,Puerto Rico/Territorio de Estados Unidos,630,9,17,,26,"(10.886611,-74.776708)"
2017,Mayo,Puerto Rico/Territorio de Estados Unidos,630,3,0,,3,"(12.586067,-81.702563)"
2017,Mayo,Puerto Rico/Territorio de Estados Unidos,630,33,17,,50,"(3.541112,-76.384584)"
2017,Mayo,Puerto Rico/Territorio de Estados Unidos,630,503,441,,944,"(4.697144,-74.140516)"
2017,Mayo,Puerto Rico/Territorio de Estados Unidos,630,7,6,,13,"(4.815061,-75.736532)"
2017,Mayo,Puerto Rico/Territorio de Estados Unidos,630,39,41,,80,"(6.171601,-75.427454)"
2017,Mayo,Puerto Rico/Territorio de Estados Unidos,630,2,7,,9,"(7.128456,-73.183637)"
2017,Mayo,Qatar,634,0,1,,1,"(3.541112,-76.384584)"
2017,Mayo,Qatar,634,0,3,,3,"(4.697144,-74.140516)"
2017,Mayo,Qatar,634,1,3,,4,"(6.171601,-75.427454)"
2017,Mayo,Reino Unido de Gran Bretaña e Irlanda del Norte,826,3,1,,4,"(10.445761,-75.516429)"
2017,Mayo,Reino Unido de Gran Bretaña e Irlanda del Norte,826,1,1,,2,"(10.886611,-74.776708)"
2017,Mayo,Reino Unido de Gran Bretaña e Irlanda del Norte,826,15,19,,34,"(3.541112,-76.384584)"
2017,Mayo,Reino Unido de Gran Bretaña e Irlanda del Norte,826,1615,1381,,2996,"(4.697144,-74.140516)"
2017,Mayo,Reino Unido de Gran Bretaña e Irlanda del Norte,826,28,20,,48,"(6.171601,-75.427454)"
2017,Mayo,Reino Unido de Gran Bretaña e Irlanda del Norte,826,0,1,,1,"(7.128456,-73.183637)"
2017,Mayo,República CentroÁfricana,140,3,0,,3,"(4.697144,-74.140516)"
2017,Mayo,Federación de Rusia,643,0,1,,1,"(3.541112,-76.384584)"
2017,Mayo,Federación de Rusia,643,42,44,,86,"(4.697144,-74.140516)"
2017,Mayo,Federación de Rusia,643,2,1,,3,"(6.171601,-75.427454)"
2017,Mayo,República Dominicana,214,9,20,,29,"(10.445761,-75.516429)"
2017,Mayo,República Dominicana,214,40,52,,92,"(10.886611,-74.776708)"
2017,Mayo,República Dominicana,214,130,102,,232,"(3.541112,-76.384584)"
2017,Mayo,República Dominicana,214,2480,2394,,4874,"(4.697144,-74.140516)"
2017,Mayo,República Dominicana,214,88,72,,160,"(4.815061,-75.736532)"
2017,Mayo,República Dominicana,214,302,265,,567,"(6.171601,-75.427454)"
2017,Mayo,República Dominicana,214,40,28,,68,"(7.128456,-73.183637)"
2017,Mayo,República Democrática Popular de Corea,408,0,1,,1,"(4.697144,-74.140516)"
2017,Mayo,Rumania,642,1,0,,1,"(10.445761,-75.516429)"
2017,Mayo,Rumania,642,1,0,,1,"(3.541112,-76.384584)"
2017,Mayo,Rumania,642,1,2,,3,"(4.697144,-74.140516)"
2017,Mayo,Rumania,642,1,1,,2,"(6.171601,-75.427454)"
2017,Mayo,Rwanda,646,0,1,,1,"(4.697144,-74.140516)"
2017,Mayo,San Cristóbal y Nevis,659,0,1,,1,"(4.697144,-74.140516)"
2017,Mayo,San  Vicente y las Granadinas,670,0,1,,1,"(4.697144,-74.140516)"
2017,Mayo,San  Vicente y las Granadinas,670,1,3,,4,"(7.128456,-73.183637)"
2017,Mayo,Santo Tomé y Príncipe,678,1,5,,6,"(4.697144,-74.140516)"
2017,Mayo,Serbia,688,0,1,,1,"(4.697144,-74.140516)"
2017,Mayo,Serbia,688,1,1,,2,"(6.171601,-75.427454)"
2017,Mayo,Sierra Leona,694,0,1,,1,"(6.171601,-75.427454)"
2017,Mayo,Singapur,702,12,14,,26,"(4.697144,-74.140516)"
2017,Mayo,Singapur,702,2,0,,2,"(6.171601,-75.427454)"
2017,Mayo,Sri Lanka,144,0,1,,1,"(4.697144,-74.140516)"
2017,Mayo,Sudáfrica,710,18,12,,30,"(4.697144,-74.140516)"
2017,Mayo,Sudáfrica,710,1,1,,2,"(6.171601,-75.427454)"
2017,Mayo,Sudán,736,0,1,,1,"(4.697144,-74.140516)"
2017,Mayo,Suecia,752,2,1,,3,"(10.445761,-75.516429)"
2017,Mayo,Suecia,752,1,0,,1,"(10.886611,-74.776708)"
2017,Mayo,Suecia,752,7,9,,16,"(3.541112,-76.384584)"
2017,Mayo,Suecia,752,95,80,,175,"(4.697144,-74.140516)"
2017,Mayo,Suecia,752,1,1,,2,"(4.815061,-75.736532)"
2017,Mayo,Suecia,752,20,8,,28,"(6.171601,-75.427454)"
2017,Mayo,Suiza,756,6,0,,6,"(10.445761,-75.516429)"
2017,Mayo,Suiza,756,7,4,,11,"(10.886611,-74.776708)"
2017,Mayo,Suiza,756,34,22,,56,"(3.541112,-76.384584)"
2017,Mayo,Suiza,756,232,164,,396,"(4.697144,-74.140516)"
2017,Mayo,Suiza,756,35,18,,53,"(6.171601,-75.427454)"
2017,Mayo,Suiza,756,1,0,,1,"(7.128456,-73.183637)"
2017,Mayo,Surinam,740,2,4,,6,"(4.697144,-74.140516)"
2017,Mayo,Surinam,740,1,1,,2,"(6.171601,-75.427454)"
2017,Mayo,Taiwán,158,1,0,,1,"(3.541112,-76.384584)"
2017,Mayo,Taiwán,158,3,3,,6,"(4.697144,-74.140516)"
2017,Mayo,Taiwán,158,1,0,,1,"(6.171601,-75.427454)"
2017,Mayo,Tailandia,764,17,16,,33,"(4.697144,-74.140516)"
2017,Mayo,Tailandia,764,1,0,,1,"(6.171601,-75.427454)"
2017,Mayo,Tanzania,834,0,1,,1,"(4.697144,-74.140516)"
2017,Mayo,Tanzania,834,1,0,,1,"(6.171601,-75.427454)"
2017,Mayo,Trinidad y Tobago,780,3,3,,6,"(10.445761,-75.516429)"
2017,Mayo,Trinidad y Tobago,780,2,1,,3,"(10.886611,-74.776708)"
2017,Mayo,Trinidad y Tobago,780,0,13,,13,"(10.971302,-74.765397)"
2017,Mayo,Trinidad y Tobago,780,5,2,,7,"(3.541112,-76.384584)"
2017,Mayo,Trinidad y Tobago,780,11,23,,34,"(4.697144,-74.140516)"
2017,Mayo,Trinidad y Tobago,780,1,1,,2,"(4.815061,-75.736532)"
2017,Mayo,Trinidad y Tobago,780,8,9,,17,"(6.171601,-75.427454)"
2017,Mayo,Trinidad y Tobago,780,1,1,,2,"(7.128456,-73.183637)"
2017,Mayo,Túnez,788,1,2,,3,"(4.697144,-74.140516)"
2017,Mayo,Túnez,788,0,1,,1,"(6.171601,-75.427454)"
2017,Mayo,Turquía,792,0,2,,2,"(10.886611,-74.776708)"
2017,Mayo,Turquía,792,5,4,,9,"(3.541112,-76.384584)"
2017,Mayo,Turquía,792,523,375,,898,"(4.697144,-74.140516)"
2017,Mayo,Turquía,792,6,0,,6,"(6.171601,-75.427454)"
2017,Mayo,Turquía,792,1,2,,3,"(7.128456,-73.183637)"
2017,Mayo,Turkmenistán,795,12,6,,18,"(4.697144,-74.140516)"
2017,Mayo,Turkmenistán,795,0,1,,1,"(6.171601,-75.427454)"
2017,Mayo,Ucrania,804,1,2,,3,"(4.697144,-74.140516)"
2017,Mayo,Uganda,800,0,1,,1,"(10.886611,-74.776708)"
2017,Mayo,Uruguay,858,1,0,,1,"(10.445761,-75.516429)"
2017,Mayo,Uruguay,858,1,1,,2,"(10.886611,-74.776708)"
2017,Mayo,Uruguay,858,13,14,,27,"(3.541112,-76.384584)"
2017,Mayo,Uruguay,858,207,271,,478,"(4.697144,-74.140516)"
2017,Mayo,Uruguay,858,4,10,,14,"(4.815061,-75.736532)"
2017,Mayo,Uruguay,858,23,27,,50,"(6.171601,-75.427454)"
2017,Mayo,Venezuela,862,1,0,,1,"(10.433609,-73.247863)"
2017,Mayo,Venezuela,862,4,2,,6,"(10.445761,-75.516429)"
2017,Mayo,Venezuela,862,3,25,,28,"(10.886611,-74.776708)"
2017,Mayo,Venezuela,862,2127,2181,,4308,"(11.360009,-72.129330)"
2017,Mayo,Venezuela,862,1,0,,1,"(12.586067,-81.702563)"
2017,Mayo,Venezuela,862,5,6,,11,"(3.541112,-76.384584)"
2017,Mayo,Venezuela,862,2,4,,6,"(3.866713,-67.927521)"
2017,Mayo,Venezuela,862,1144,1185,,2329,"(4.697144,-74.140516)"
2017,Mayo,Venezuela,862,3,1,,4,"(4.815061,-75.736532)"
2017,Mayo,Venezuela,862,303,266,,569,"(6.171601,-75.427454)"
2017,Mayo,Venezuela,862,68,83,,151,"(6.185799,-67.483929)"
2017,Mayo,Venezuela,862,469,437,,906,"(7.088729,-70.740253)"
2017,Mayo,Venezuela,862,1,1,,2,"(7.128456,-73.183637)"
2017,Mayo,Venezuela,862,1131,1216,,2347,"(7.818934,-72.453226)"
2017,Mayo,Venezuela,862,1,1,,2,"(7.927209,-72.507910)"
2017,Mayo,Venezuela,862,70,84,,154,"(8.36068,-72.409396)"
2017,Mayo,Vietnam,704,0,3,,3,"(4.697144,-74.140516)"
2017,Mayo,Vietnam,704,0,2,,2,"(6.171601,-75.427454)"
2017,Mayo,Islas Vírgenes Británicas/Territorio Británico de Ultramar,92,2,1,,3,"(3.541112,-76.384584)"
2017,Mayo,Islas Vírgenes Británicas/Territorio Británico de Ultramar,92,0,4,,4,"(4.697144,-74.140516)"
2017,Mayo,Islas Vírgenes Estadounidenses/Territorio de Estados Unidos,850,2,2,,4,"(3.541112,-76.384584)"
2017,Mayo,Islas Vírgenes Estadounidenses/Territorio de Estados Unidos,850,3,3,,6,"(4.697144,-74.140516)"
2017,Junio,Afganistán,4,1,0,,1,"(3.541112,-76.384584)"
2017,Junio,Afganistán,4,0,3,,3,"(4.697144,-74.140516)"
2017,Junio,Albania,8,0,7,,7,"(4.697144,-74.140516)"
2017,Junio,Alemania,276,3,0,,3,"(0.814836,-77.662532)"
2017,Junio,Alemania,276,13,12,,25,"(10.445761,-75.516429)"
2017,Junio,Alemania,276,34,25,,59,"(10.886611,-74.776708)"
2017,Junio,Alemania,276,77,56,,133,"(3.541112,-76.384584)"
2017,Junio,Alemania,276,1905,1721,,3626,"(4.697144,-74.140516)"
2017,Junio,Alemania,276,1,0,,1,"(4.815061,-75.736532)"
2017,Junio,Alemania,276,107,85,,192,"(6.171601,-75.427454)"
2017,Junio,Alemania,276,2,0,,2,"(7.128456,-73.183637)"
2017,Junio,Andorra,20,1,2,,3,"(4.697144,-74.140516)"
2017,Junio,Angola,24,0,4,,4,"(4.697144,-74.140516)"
2017,Junio,Antigua y Barbuda,28,3,1,,4,"(4.697144,-74.140516)"
2017,Junio,Países Bajos,528,0,1,,1,"(10.408582,-75.538003)"
2017,Junio,Países Bajos,528,150,110,,260,"(10.445761,-75.516429)"
2017,Junio,Países Bajos,528,38,30,,68,"(10.886611,-74.776708)"
2017,Junio,Países Bajos,528,64,33,,97,"(3.541112,-76.384584)"
2017,Junio,Países Bajos,528,1457,1147,,2604,"(4.697144,-74.140516)"
2017,Junio,Países Bajos,528,11,4,,15,"(4.815061,-75.736532)"
2017,Junio,Países Bajos,528,199,156,,355,"(6.171601,-75.427454)"
2017,Junio,Países Bajos,528,1,4,,5,"(7.128456,-73.183637)"
2017,Junio,Arabia Saudita,682,5,26,,31,"(4.697144,-74.140516)"
2017,Junio,Arabia Saudita,682,1,2,,3,"(6.171601,-75.427454)"
2017,Junio,Argelia,12,8,6,,14,"(4.697144,-74.140516)"
2017,Junio,Argentina,32,8,16,,24,"(0.814836,-77.662532)"
2017,Junio,Argentina,32,14,15,,29,"(10.445761,-75.516429)"
2017,Junio,Argentina,32,10,8,,18,"(10.886611,-74.776708)"
2017,Junio,Argentina,32,78,75,,153,"(3.541112,-76.384584)"
2017,Junio,Argentina,32,2877,2724,,5601,"(4.697144,-74.140516)"
2017,Junio,Argentina,32,5,15,,20,"(4.815061,-75.736532)"
2017,Junio,Argentina,32,66,50,,116,"(6.171601,-75.427454)"
2017,Junio,Argentina,32,1,0,,1,"(7.128456,-73.183637)"
2017,Junio,Aruba,533,1804,1312,,3116,"(10.408582,-75.538003)"
2017,Junio,Aruba,533,9,11,,20,"(10.445761,-75.516429)"
2017,Junio,Aruba,533,20,12,,32,"(10.886611,-74.776708)"
2017,Junio,Aruba,533,0,13,,13,"(10.971302,-74.765397)"
2017,Junio,Aruba,533,11,8,,19,"(3.541112,-76.384584)"
2017,Junio,Aruba,533,2804,2209,,5013,"(4.697144,-74.140516)"
2017,Junio,Aruba,533,7,3,,10,"(4.815061,-75.736532)"
2017,Junio,Aruba,533,2,2,,4,"(6.17134,-75.427194)"
2017,Junio,Aruba,533,157,119,,276,"(6.171601,-75.427454)"
2017,Junio,Aruba,533,8,24,,32,"(7.128456,-73.183637)"
2017,Junio,Australia,36,4,3,,7,"(10.886611,-74.776708)"
2017,Junio,Australia,36,19,16,,35,"(3.541112,-76.384584)"
2017,Junio,Australia,36,321,283,,604,"(4.697144,-74.140516)"
2017,Junio,Australia,36,0,1,,1,"(4.815061,-75.736532)"
2017,Junio,Australia,36,46,27,,73,"(6.171601,-75.427454)"
2017,Junio,Austria,40,1,0,,1,"(10.445761,-75.516429)"
2017,Junio,Austria,40,2,2,,4,"(10.886611,-74.776708)"
2017,Junio,Austria,40,5,7,,12,"(3.541112,-76.384584)"
2017,Junio,Austria,40,45,41,,86,"(4.697144,-74.140516)"
2017,Junio,Austria,40,11,9,,20,"(6.171601,-75.427454)"
2017,Junio,Austria,40,4,2,,6,"(7.128456,-73.183637)"
2017,Junio,Azerbaiyán,31,0,1,,1,"(3.541112,-76.384584)"
2017,Junio,Azerbaiyán,31,2,1,,3,"(4.697144,-74.140516)"
2017,Junio,Bahamas,44,0,1,,1,"(10.445761,-75.516429)"
2017,Junio,Bahamas,44,16,7,,23,"(10.886611,-74.776708)"
2017,Junio,Bahamas,44,14,4,,18,"(3.541112,-76.384584)"
2017,Junio,Bahamas,44,8,13,,21,"(4.697144,-74.140516)"
2017,Junio,Bahamas,44,5,1,,6,"(4.815061,-75.736532)"
2017,Junio,Bahamas,44,24,9,,33,"(6.171601,-75.427454)"
2017,Junio,Bahréin,48,2,0,,2,"(3.541112,-76.384584)"
2017,Junio,Bahréin,48,0,1,,1,"(4.452882,-75.766298)"
2017,Junio,Bahréin,48,1,2,,3,"(4.697144,-74.140516)"
2017,Junio,Bahréin,48,0,1,,1,"(6.171601,-75.427454)"
2017,Junio,Bangladesh,50,0,1,,1,"(4.697144,-74.140516)"
2017,Junio,Barbados,52,155,186,,341,"(4.697144,-74.140516)"
2017,Junio,República de Belarús,112,1,0,,1,"(4.697144,-74.140516)"
2017,Junio,Bélgica,56,2,1,,3,"(10.445761,-75.516429)"
2017,Junio,Bélgica,56,2,1,,3,"(10.886611,-74.776708)"
2017,Junio,Bélgica,56,14,14,,28,"(3.541112,-76.384584)"
2017,Junio,Bélgica,56,91,82,,173,"(4.697144,-74.140516)"
2017,Junio,Bélgica,56,0,1,,1,"(4.815061,-75.736532)"
2017,Junio,Bélgica,56,48,31,,79,"(6.171601,-75.427454)"
2017,Junio,Belice,84,4,4,,8,"(3.541112,-76.384584)"
2017,Junio,Belice,84,16,11,,27,"(4.697144,-74.140516)"
2017,Junio,Belice,84,2,0,,2,"(6.171601,-75.427454)"
2017,Junio,Bermudas/Territorio Británico de Ultramar,60,1,0,,1,"(10.886611,-74.776708)"
2017,Junio,Bermudas/Territorio Británico de Ultramar,60,1,0,,1,"(3.541112,-76.384584)"
2017,Junio,Bermudas/Territorio Británico de Ultramar,60,1,2,,3,"(4.697144,-74.140516)"
2017,Junio,Bermudas/Territorio Británico de Ultramar,60,1,2,,3,"(6.171601,-75.427454)"
2017,Junio,Bolivia,68,2,10,,12,"(0.814836,-77.662532)"
2017,Junio,Bolivia,68,2,0,,2,"(10.445761,-75.516429)"
2017,Junio,Bolivia,68,2,2,,4,"(10.886611,-74.776708)"
2017,Junio,Bolivia,68,0,1,,1,"(12.586067,-81.702563)"
2017,Junio,Bolivia,68,14,30,,44,"(3.541112,-76.384584)"
2017,Junio,Bolivia,68,295,492,,787,"(4.697144,-74.140516)"
2017,Junio,Bolivia,68,5,11,,16,"(4.815061,-75.736532)"
2017,Junio,Bolivia,68,9,21,,30,"(6.171601,-75.427454)"
2017,Junio,Bolivia,68,0,1,,1,"(7.128456,-73.183637)"
2017,Junio,Brasil,76,144,185,,329,"(-4.197703,-69.941278)"
2017,Junio,Brasil,76,15,36,,51,"(-4.223468,-69.945098)"
2017,Junio,Brasil,76,15,17,,32,"(10.445761,-75.516429)"
2017,Junio,Brasil,76,17,16,,33,"(10.886611,-74.776708)"
2017,Junio,Brasil,76,1,0,,1,"(12.586067,-81.702563)"
2017,Junio,Brasil,76,79,98,,177,"(3.541112,-76.384584)"
2017,Junio,Brasil,76,0,1,,1,"(4.452882,-75.766298)"
2017,Junio,Brasil,76,3239,3658,,6897,"(4.697144,-74.140516)"
2017,Junio,Brasil,76,30,37,,67,"(4.815061,-75.736532)"
2017,Junio,Brasil,76,153,191,,344,"(6.171601,-75.427454)"
2017,Junio,Brasil,76,1,2,,3,"(7.128456,-73.183637)"
2017,Junio,Bulgaria,100,1,2,,3,"(3.541112,-76.384584)"
2017,Junio,Bulgaria,100,2,3,,5,"(4.697144,-74.140516)"
2017,Junio,Bulgaria,100,0,1,,1,"(6.171601,-75.427454)"
2017,Junio,Cabo Verde,132,1,0,,1,"(4.697144,-74.140516)"
2017,Junio,Cabo Verde,132,0,1,,1,"(6.171601,-75.427454)"
2017,Junio,Islas Caimán/Territorio Británico de Ultramar,136,4,4,,8,"(12.586067,-81.702563)"
2017,Junio,Islas Caimán/Territorio Británico de Ultramar,136,6,1,,7,"(4.697144,-74.140516)"
2017,Junio,Camerún,120,0,2,,2,"(4.697144,-74.140516)"
2017,Junio,Canadá,124,38,29,,67,"(10.445761,-75.516429)"
2017,Junio,Canadá,124,77,52,,129,"(10.886611,-74.776708)"
2017,Junio,Canadá,124,3,1,,4,"(12.586067,-81.702563)"
2017,Junio,Canadá,124,191,123,,314,"(3.541112,-76.384584)"
2017,Junio,Canadá,124,3067,2255,,5322,"(4.697144,-74.140516)"
2017,Junio,Canadá,124,20,14,,34,"(4.815061,-75.736532)"
2017,Junio,Canadá,124,416,305,,721,"(6.171601,-75.427454)"
2017,Junio,Canadá,124,16,3,,19,"(7.128456,-73.183637)"
2017,Junio,España,724,5,1,,6,"(0.814836,-77.662532)"
2017,Junio,España,724,21,16,,37,"(10.445761,-75.516429)"
2017,Junio,España,724,43,21,,64,"(10.886611,-74.776708)"
2017,Junio,España,724,0,1,,1,"(12.586067,-81.702563)"
2017,Junio,España,724,3504,2438,,5942,"(3.541112,-76.384584)"
2017,Junio,España,724,18213,13696,,31909,"(4.697144,-74.140516)"
2017,Junio,España,724,5,2,,7,"(4.815061,-75.736532)"
2017,Junio,España,724,2925,2084,,5009,"(6.171601,-75.427454)"
2017,Junio,España,724,6,7,,13,"(7.128456,-73.183637)"
2017,Junio,Colombia,170,1,6,,7,"(10.445761,-75.516429)"
2017,Junio,Colombia,170,199,551,,750,"(4.697144,-74.140516)"
2017,Junio,República Del Congo,178,0,1,,1,"(3.541112,-76.384584)"
2017,Junio,República de Corea,410,1,0,,1,"(10.445761,-75.516429)"
2017,Junio,República de Corea,410,24,38,,62,"(4.697144,-74.140516)"
2017,Junio,República de Corea,410,0,2,,2,"(6.171601,-75.427454)"
2017,Junio,Costa de Marfil,384,0,1,,1,"(3.541112,-76.384584)"
2017,Junio,Costa de Marfil,384,6,6,,12,"(4.697144,-74.140516)"
2017,Junio,Costa de Marfil,384,1,0,,1,"(6.171601,-75.427454)"
2017,Junio,Costa Rica,188,12,4,,16,"(10.445761,-75.516429)"
2017,Junio,Costa Rica,188,14,25,,39,"(10.886611,-74.776708)"
2017,Junio,Costa Rica,188,1,0,,1,"(11.117806,-74.232622)"
2017,Junio,Costa Rica,188,4,33,,37,"(12.5744111,-81.703935)"
2017,Junio,Costa Rica,188,6,4,,10,"(12.586067,-81.702563)"
2017,Junio,Costa Rica,188,21,37,,58,"(3.541112,-76.384584)"
2017,Junio,Costa Rica,188,1386,1489,,2875,"(4.697144,-74.140516)"
2017,Junio,Costa Rica,188,8,3,,11,"(4.815061,-75.736532)"
2017,Junio,Costa Rica,188,88,85,,173,"(6.171601,-75.427454)"
2017,Junio,Costa Rica,188,2,0,,2,"(7.128456,-73.183637)"
2017,Junio,Croacia,191,13,12,,25,"(4.697144,-74.140516)"
2017,Junio,Cuba,192,35,29,,64,"(10.445761,-75.516429)"
2017,Junio,Cuba,192,36,28,,64,"(10.886611,-74.776708)"
2017,Junio,Cuba,192,2,1,,3,"(12.586067,-81.702563)"
2017,Junio,Cuba,192,124,86,,210,"(3.541112,-76.384584)"
2017,Junio,Cuba,192,2040,1661,,3701,"(4.697144,-74.140516)"
2017,Junio,Cuba,192,14,11,,25,"(4.815061,-75.736532)"
2017,Junio,Cuba,192,131,123,,254,"(6.171601,-75.427454)"
2017,Junio,Cuba,192,16,15,,31,"(7.128456,-73.183637)"
2017,Junio,Curazao,99999,12,59,,71,"(4.697144,-74.140516)"
2017,Junio,República Checa,203,2,0,,2,"(10.445761,-75.516429)"
2017,Junio,República Checa,203,0,1,,1,"(10.886611,-74.776708)"
2017,Junio,República Checa,203,1,1,,2,"(3.541112,-76.384584)"
2017,Junio,República Checa,203,18,22,,40,"(4.697144,-74.140516)"
2017,Junio,República Checa,203,0,2,,2,"(6.171601,-75.427454)"
2017,Junio,Chile,152,209,222,,431,"(0.814836,-77.662532)"
2017,Junio,Chile,152,0,1,,1,"(1.813928,-78.763924)"
2017,Junio,Chile,152,39,24,,63,"(10.445761,-75.516429)"
2017,Junio,Chile,152,59,32,,91,"(10.886611,-74.776708)"
2017,Junio,Chile,152,3,6,,9,"(12.586067,-81.702563)"
2017,Junio,Chile,152,265,196,,461,"(3.541112,-76.384584)"
2017,Junio,Chile,152,4488,4010,,8498,"(4.697144,-74.140516)"
2017,Junio,Chile,152,75,54,,129,"(4.815061,-75.736532)"
2017,Junio,Chile,152,107,70,,177,"(6.171601,-75.427454)"
2017,Junio,Chile,152,1,2,,3,"(7.128456,-73.183637)"
2017,Junio,China,156,1,0,,1,"(10.886611,-74.776708)"
2017,Junio,China,156,6,13,,19,"(3.541112,-76.384584)"
2017,Junio,China,156,229,370,,599,"(4.697144,-74.140516)"
2017,Junio,China,156,22,74,,96,"(6.171601,-75.427454)"
2017,Junio,Chipre,196,0,1,,1,"(4.697144,-74.140516)"
2017,Junio,Dinamarca,208,3,0,,3,"(10.445761,-75.516429)"
2017,Junio,Dinamarca,208,1,1,,2,"(12.586067,-81.702563)"
2017,Junio,Dinamarca,208,3,2,,5,"(3.541112,-76.384584)"
2017,Junio,Dinamarca,208,56,38,,94,"(4.697144,-74.140516)"
2017,Junio,Dinamarca,208,3,4,,7,"(6.171601,-75.427454)"
2017,Junio,Dominica,212,0,1,,1,"(3.541112,-76.384584)"
2017,Junio,Ecuador,218,6,10,,16,"(-0.193180,-74.784874)"
2017,Junio,Ecuador,218,644,835,,1479,"(0.25129,-76.875963)"
2017,Junio,Ecuador,218,14,29,,43,"(0.812436,-77.847006)"
2017,Junio,Ecuador,218,6900,7779,,14679,"(0.814836,-77.662532)"
2017,Junio,Ecuador,218,222,173,,395,"(1.813928,-78.763924)"
2017,Junio,Ecuador,218,0,1,,1,"(10.408582,-75.538003)"
2017,Junio,Ecuador,218,8,15,,23,"(10.886611,-74.776708)"
2017,Junio,Ecuador,218,1,2,,3,"(12.586067,-81.702563)"
2017,Junio,Ecuador,218,422,366,,788,"(3.541112,-76.384584)"
2017,Junio,Ecuador,218,1,6,,7,"(3.893038,-77.067921)"
2017,Junio,Ecuador,218,3137,4529,,7666,"(4.697144,-74.140516)"
2017,Junio,Ecuador,218,0,2,,2,"(4.815061,-75.736532)"
2017,Junio,Ecuador,218,12,42,,54,"(6.171601,-75.427454)"
2017,Junio,Egipto,818,0,1,,1,"(10.408582,-75.538003)"
2017,Junio,Egipto,818,0,1,,1,"(3.541112,-76.384584)"
2017,Junio,Egipto,818,24,77,,101,"(4.697144,-74.140516)"
2017,Junio,Egipto,818,4,2,,6,"(6.171601,-75.427454)"
2017,Junio,El Salvador,222,0,1,,1,"(10.886611,-74.776708)"
2017,Junio,El Salvador,222,0,4,,4,"(12.586067,-81.702563)"
2017,Junio,El Salvador,222,79,83,,162,"(3.541112,-76.384584)"
2017,Junio,El Salvador,222,828,1018,,1846,"(4.697144,-74.140516)"
2017,Junio,El Salvador,222,1,0,,1,"(4.815061,-75.736532)"
2017,Junio,El Salvador,222,62,75,,137,"(6.171601,-75.427454)"
2017,Junio,Emiratos Árabes,784,3,1,,4,"(3.541112,-76.384584)"
2017,Junio,Emiratos Árabes,784,92,282,,374,"(4.697144,-74.140516)"
2017,Junio,Emiratos Árabes,784,0,1,,1,"(4.815061,-75.736532)"
2017,Junio,Emiratos Árabes,784,13,7,,20,"(6.171601,-75.427454)"
2017,Junio,Eslovaquia,703,1,2,,3,"(4.697144,-74.140516)"
2017,Junio,Eslovenia,705,1,2,,3,"(4.697144,-74.140516)"
2017,Junio,Eslovenia,705,1,1,,2,"(6.171601,-75.427454)"
2017,Junio,Estados Unidos de América,840,0,3,,3,"(10.408582,-75.538003)"
2017,Junio,Estados Unidos de América,840,4401,3382,,7783,"(10.445761,-75.516429)"
2017,Junio,Estados Unidos de América,840,3912,3050,,6962,"(10.886611,-74.776708)"
2017,Junio,Estados Unidos de América,840,0,1,,1,"(10.971302,-74.765397)"
2017,Junio,Estados Unidos de América,840,75,50,,125,"(12.586067,-81.702563)"
2017,Junio,Estados Unidos de América,840,7156,5046,,12202,"(3.541112,-76.384584)"
2017,Junio,Estados Unidos de América,840,911,638,,1549,"(4.452882,-75.766298)"
2017,Junio,Estados Unidos de América,840,43291,35444,,78735,"(4.697144,-74.140516)"
2017,Junio,Estados Unidos de América,840,1357,920,,2277,"(4.815061,-75.736532)"
2017,Junio,Estados Unidos de América,840,14536,10879,,25415,"(6.171601,-75.427454)"
2017,Junio,Estados Unidos de América,840,357,240,,597,"(7.128456,-73.183637)"
2017,Junio,Estonia,233,6,1,,7,"(4.697144,-74.140516)"
2017,Junio,Etiopia,231,0,2,,2,"(4.697144,-74.140516)"
2017,Junio,Etiopia,231,0,1,,1,"(6.171601,-75.427454)"
2017,Junio,Filipinas,608,5,1,,6,"(4.697144,-74.140516)"
2017,Junio,Finlandia,246,1,0,,1,"(10.445761,-75.516429)"
2017,Junio,Finlandia,246,0,2,,2,"(10.886611,-74.776708)"
2017,Junio,Finlandia,246,0,3,,3,"(3.541112,-76.384584)"
2017,Junio,Finlandia,246,13,12,,25,"(4.697144,-74.140516)"
2017,Junio,Finlandia,246,1,1,,2,"(4.815061,-75.736532)"
2017,Junio,Finlandia,246,2,0,,2,"(6.171601,-75.427454)"
2017,Junio,Francia,250,21,8,,29,"(10.445761,-75.516429)"
2017,Junio,Francia,250,30,20,,50,"(10.886611,-74.776708)"
2017,Junio,Francia,250,141,84,,225,"(3.541112,-76.384584)"
2017,Junio,Francia,250,1,0,,1,"(4.452882,-75.766298)"
2017,Junio,Francia,250,2985,2450,,5435,"(4.697144,-74.140516)"
2017,Junio,Francia,250,0,6,,6,"(4.815061,-75.736532)"
2017,Junio,Francia,250,198,145,,343,"(6.171601,-75.427454)"
2017,Junio,Francia,250,7,2,,9,"(7.128456,-73.183637)"
2017,Junio,Ghana,288,1,0,,1,"(3.541112,-76.384584)"
2017,Junio,Ghana,288,0,2,,2,"(4.697144,-74.140516)"
2017,Junio,Gibraltar/Territorio Británico de Ultramar,292,0,1,,1,"(4.697144,-74.140516)"
2017,Junio,Granada,308,0,1,,1,"(4.697144,-74.140516)"
2017,Junio,Grecia,300,0,1,,1,"(10.445761,-75.516429)"
2017,Junio,Grecia,300,0,1,,1,"(10.886611,-74.776708)"
2017,Junio,Grecia,300,2,2,,4,"(3.541112,-76.384584)"
2017,Junio,Grecia,300,67,50,,117,"(4.697144,-74.140516)"
2017,Junio,Grecia,300,4,4,,8,"(6.171601,-75.427454)"
2017,Junio,Guatemala,320,2,2,,4,"(10.445761,-75.516429)"
2017,Junio,Guatemala,320,7,11,,18,"(10.886611,-74.776708)"
2017,Junio,Guatemala,320,55,92,,147,"(3.541112,-76.384584)"
2017,Junio,Guatemala,320,593,700,,1293,"(4.697144,-74.140516)"
2017,Junio,Guatemala,320,16,15,,31,"(4.815061,-75.736532)"
2017,Junio,Guatemala,320,78,89,,167,"(6.171601,-75.427454)"
2017,Junio,Guatemala,320,2,4,,6,"(7.128456,-73.183637)"
2017,Junio,Guyana,328,1,2,,3,"(10.886611,-74.776708)"
2017,Junio,Guyana,328,5,9,,14,"(4.697144,-74.140516)"
2017,Junio,Guyana,328,0,1,,1,"(4.815061,-75.736532)"
2017,Junio,Guyana,328,3,2,,5,"(6.171601,-75.427454)"
2017,Junio,Guinea,324,0,1,,1,"(4.697144,-74.140516)"
2017,Junio,Guinea Ecuatorial,226,0,6,,6,"(3.541112,-76.384584)"
2017,Junio,Guinea Ecuatorial,226,1,0,,1,"(4.697144,-74.140516)"
2017,Junio,Guinea Ecuatorial,226,0,1,,1,"(6.171601,-75.427454)"
2017,Junio,Guadalupe/Territorio Francés,312,1,0,,1,"(3.541112,-76.384584)"
2017,Junio,Guadalupe/Territorio Francés,312,0,4,,4,"(4.697144,-74.140516)"
2017,Junio,Guayana Francesa/Departamento de Ultramar Francés,254,0,1,,1,"(4.815061,-75.736532)"
2017,Junio,Guayana Francesa/Departamento de Ultramar Francés,254,1,0,,1,"(6.171601,-75.427454)"
2017,Junio,Haití,332,0,1,,1,"(10.445761,-75.516429)"
2017,Junio,Haití,332,2,3,,5,"(10.886611,-74.776708)"
2017,Junio,Haití,332,1,3,,4,"(3.541112,-76.384584)"
2017,Junio,Haití,332,4,6,,10,"(4.697144,-74.140516)"
2017,Junio,Haití,332,1,0,,1,"(4.815061,-75.736532)"
2017,Junio,Haití,332,2,2,,4,"(6.171601,-75.427454)"
2017,Junio,Haití,332,0,1,,1,"(7.128456,-73.183637)"
2017,Junio,Honduras,340,4,3,,7,"(10.445761,-75.516429)"
2017,Junio,Honduras,340,2,7,,9,"(10.886611,-74.776708)"
2017,Junio,Honduras,340,0,1,,1,"(12.586067,-81.702563)"
2017,Junio,Honduras,340,9,25,,34,"(3.541112,-76.384584)"
2017,Junio,Honduras,340,104,185,,289,"(4.697144,-74.140516)"
2017,Junio,Honduras,340,3,5,,8,"(4.815061,-75.736532)"
2017,Junio,Honduras,340,29,73,,102,"(6.171601,-75.427454)"
2017,Junio,Honduras,340,1,5,,6,"(7.128456,-73.183637)"
2017,Junio,Hong Kong,344,0,2,,2,"(10.445761,-75.516429)"
2017,Junio,Hong Kong,344,3,2,,5,"(3.541112,-76.384584)"
2017,Junio,Hong Kong,344,16,24,,40,"(4.697144,-74.140516)"
2017,Junio,Hong Kong,344,2,2,,4,"(6.171601,-75.427454)"
2017,Junio,Hungría,348,0,1,,1,"(3.541112,-76.384584)"
2017,Junio,Hungría,348,14,18,,32,"(4.697144,-74.140516)"
2017,Junio,India,356,0,1,,1,"(3.541112,-76.384584)"
2017,Junio,India,356,23,20,,43,"(4.697144,-74.140516)"
2017,Junio,India,356,1,2,,3,"(4.815061,-75.736532)"
2017,Junio,India,356,7,1,,8,"(6.171601,-75.427454)"
2017,Junio,Indonesia,360,1,0,,1,"(3.541112,-76.384584)"
2017,Junio,Indonesia,360,5,5,,10,"(4.697144,-74.140516)"
2017,Junio,Indonesia,360,0,1,,1,"(6.171601,-75.427454)"
2017,Junio,Iraq,368,0,6,,6,"(4.697144,-74.140516)"
2017,Junio,Irán,364,3,0,,3,"(4.697144,-74.140516)"
2017,Junio,Irán,364,2,0,,2,"(4.815061,-75.736532)"
2017,Junio,República de Irlanda,372,0,1,,1,"(3.541112,-76.384584)"
2017,Junio,República de Irlanda,372,23,9,,32,"(4.697144,-74.140516)"
2017,Junio,República de Irlanda,372,8,0,,8,"(6.171601,-75.427454)"
2017,Junio,Islandia,352,0,2,,2,"(4.697144,-74.140516)"
2017,Junio,Islandia,352,0,1,,1,"(7.128456,-73.183637)"
2017,Junio,Israel,376,1,0,,1,"(10.886611,-74.776708)"
2017,Junio,Israel,376,9,5,,14,"(3.541112,-76.384584)"
2017,Junio,Israel,376,172,107,,279,"(4.697144,-74.140516)"
2017,Junio,Israel,376,10,9,,19,"(6.171601,-75.427454)"
2017,Junio,Italia,380,23,16,,39,"(10.445761,-75.516429)"
2017,Junio,Italia,380,23,9,,32,"(10.886611,-74.776708)"
2017,Junio,Italia,380,152,65,,217,"(3.541112,-76.384584)"
2017,Junio,Italia,380,812,602,,1414,"(4.697144,-74.140516)"
2017,Junio,Italia,380,1,4,,5,"(4.815061,-75.736532)"
2017,Junio,Italia,380,149,104,,253,"(6.171601,-75.427454)"
2017,Junio,Jamaica,388,0,2,,2,"(10.408582,-75.538003)"
2017,Junio,Jamaica,388,2,12,,14,"(10.445761,-75.516429)"
2017,Junio,Jamaica,388,6,4,,10,"(10.886611,-74.776708)"
2017,Junio,Jamaica,388,1,2,,3,"(12.586067,-81.702563)"
2017,Junio,Jamaica,388,8,6,,14,"(3.541112,-76.384584)"
2017,Junio,Jamaica,388,29,25,,54,"(4.697144,-74.140516)"
2017,Junio,Jamaica,388,0,1,,1,"(4.815061,-75.736532)"
2017,Junio,Jamaica,388,11,13,,24,"(6.171601,-75.427454)"
2017,Junio,Japón,392,0,1,,1,"(10.886611,-74.776708)"
2017,Junio,Japón,392,2,4,,6,"(3.541112,-76.384584)"
2017,Junio,Japón,392,152,164,,316,"(4.697144,-74.140516)"
2017,Junio,Japón,392,2,0,,2,"(4.815061,-75.736532)"
2017,Junio,Japón,392,5,12,,17,"(6.171601,-75.427454)"
2017,Junio,Jordania,400,2,7,,9,"(4.697144,-74.140516)"
2017,Junio,Kazajistán,398,1,2,,3,"(4.697144,-74.140516)"
2017,Junio,Kenia,404,1,0,,1,"(3.541112,-76.384584)"
2017,Junio,Kenia,404,8,9,,17,"(4.697144,-74.140516)"
2017,Junio,Kuwait,414,0,1,,1,"(3.541112,-76.384584)"
2017,Junio,Kuwait,414,2,3,,5,"(4.697144,-74.140516)"
2017,Junio,República Democrática Popular  Lao,418,2,0,,2,"(4.697144,-74.140516)"
2017,Junio,Lesoto,426,1,0,,1,"(4.697144,-74.140516)"
2017,Junio,Lituania,440,0,3,,3,"(4.697144,-74.140516)"
2017,Junio,Líbano,422,2,0,,2,"(10.886611,-74.776708)"
2017,Junio,Líbano,422,0,1,,1,"(3.541112,-76.384584)"
2017,Junio,Líbano,422,66,67,,133,"(4.697144,-74.140516)"
2017,Junio,Líbano,422,0,1,,1,"(6.171601,-75.427454)"
2017,Junio,Luxemburgo,442,3,2,,5,"(10.886611,-74.776708)"
2017,Junio,Luxemburgo,442,3,6,,9,"(4.697144,-74.140516)"
2017,Junio,Macao,446,1,0,,1,"(4.697144,-74.140516)"
2017,Junio,Malasia,458,0,1,,1,"(3.541112,-76.384584)"
2017,Junio,Malawi,454,0,1,,1,"(4.697144,-74.140516)"
2017,Junio,Malta,470,0,1,,1,"(10.445761,-75.516429)"
2017,Junio,Malta,470,1,0,,1,"(3.541112,-76.384584)"
2017,Junio,Malta,470,25,21,,46,"(4.697144,-74.140516)"
2017,Junio,Malta,470,1,1,,2,"(6.171601,-75.427454)"
2017,Junio,Marruecos,504,1,0,,1,"(3.541112,-76.384584)"
2017,Junio,Marruecos,504,12,5,,17,"(4.697144,-74.140516)"
2017,Junio,Marruecos,504,1,2,,3,"(6.171601,-75.427454)"
2017,Junio,Mauritania,478,0,2,,2,"(4.697144,-74.140516)"
2017,Junio,Martinica/Departamento de Ultramar Francés,474,0,1,,1,"(4.697144,-74.140516)"
2017,Junio,México,484,168,131,,299,"(10.445761,-75.516429)"
2017,Junio,México,484,353,302,,655,"(10.886611,-74.776708)"
2017,Junio,México,484,10,6,,16,"(12.586067,-81.702563)"
2017,Junio,México,484,1155,924,,2079,"(3.541112,-76.384584)"
2017,Junio,México,484,17490,14968,,32458,"(4.697144,-74.140516)"
2017,Junio,México,484,308,198,,506,"(4.815061,-75.736532)"
2017,Junio,México,484,2876,2328,,5204,"(6.171601,-75.427454)"
2017,Junio,México,484,142,118,,260,"(7.128456,-73.183637)"
2017,Junio,Mónaco,492,0,1,,1,"(4.697144,-74.140516)"
2017,Junio,Mónaco,492,0,1,,1,"(6.171601,-75.427454)"
2017,Junio,Namibia,516,0,1,,1,"(4.697144,-74.140516)"
2017,Junio,Nicaragua,558,3,5,,8,"(10.445761,-75.516429)"
2017,Junio,Nicaragua,558,1,1,,2,"(10.886611,-74.776708)"
2017,Junio,Nicaragua,558,0,3,,3,"(12.5744111,-81.703935)"
2017,Junio,Nicaragua,558,1,0,,1,"(12.586067,-81.702563)"
2017,Junio,Nicaragua,558,14,34,,48,"(3.541112,-76.384584)"
2017,Junio,Nicaragua,558,46,83,,129,"(4.697144,-74.140516)"
2017,Junio,Nicaragua,558,4,6,,10,"(4.815061,-75.736532)"
2017,Junio,Nicaragua,558,13,56,,69,"(6.171601,-75.427454)"
2017,Junio,Nicaragua,558,0,2,,2,"(7.128456,-73.183637)"
2017,Junio,Nigeria,566,2,0,,2,"(3.541112,-76.384584)"
2017,Junio,Nigeria,566,1,2,,3,"(4.697144,-74.140516)"
2017,Junio,Noruega,578,1,3,,4,"(10.445761,-75.516429)"
2017,Junio,Noruega,578,0,1,,1,"(12.586067,-81.702563)"
2017,Junio,Noruega,578,4,4,,8,"(3.541112,-76.384584)"
2017,Junio,Noruega,578,43,32,,75,"(4.697144,-74.140516)"
2017,Junio,Noruega,578,2,0,,2,"(4.815061,-75.736532)"
2017,Junio,Noruega,578,4,6,,10,"(6.171601,-75.427454)"
2017,Junio,Nueva Zelanda,554,1,0,,1,"(10.886611,-74.776708)"
2017,Junio,Nueva Zelanda,554,32,32,,64,"(4.697144,-74.140516)"
2017,Junio,Nueva Zelanda,554,0,1,,1,"(6.171601,-75.427454)"
2017,Junio,Nueva Zelanda,554,1,0,,1,"(7.128456,-73.183637)"
2017,Junio,Omán,512,0,4,,4,"(4.697144,-74.140516)"
2017,Junio,Omán,512,1,0,,1,"(6.171601,-75.427454)"
2017,Junio,Papúa Nueva Guinea,598,1,1,,2,"(4.697144,-74.140516)"
2017,Junio,Pakistán,586,0,1,,1,"(3.541112,-76.384584)"
2017,Junio,Pakistán,586,0,1,,1,"(4.697144,-74.140516)"
2017,Junio,Panamá,591,13,115,,128,"(10.408582,-75.538003)"
2017,Junio,Panamá,591,1051,933,,1984,"(10.445761,-75.516429)"
2017,Junio,Panamá,591,840,791,,1631,"(10.886611,-74.776708)"
2017,Junio,Panamá,591,0,3,,3,"(10.971302,-74.765397)"
2017,Junio,Panamá,591,1,1,,2,"(11.247723,-74.213989)"
2017,Junio,Panamá,591,0,1,,1,"(11.360009,-72.129330)"
2017,Junio,Panamá,591,2,29,,31,"(12.5744111,-81.703935)"
2017,Junio,Panamá,591,73,73,,146,"(12.586067,-81.702563)"
2017,Junio,Panamá,591,0,1,,1,"(13.3387613,-81.372937)"
2017,Junio,Panamá,591,1858,1477,,3335,"(3.541112,-76.384584)"
2017,Junio,Panamá,591,1,6,,7,"(3.893038,-77.067921)"
2017,Junio,Panamá,591,527,385,,912,"(4.452882,-75.766298)"
2017,Junio,Panamá,591,9227,9552,,18779,"(4.697144,-74.140516)"
2017,Junio,Panamá,591,436,390,,826,"(4.815061,-75.736532)"
2017,Junio,Panamá,591,3757,3322,,7079,"(6.171601,-75.427454)"
2017,Junio,Panamá,591,6,4,,10,"(6.228046,-77.404104)"
2017,Junio,Panamá,591,5,26,,31,"(7.102626,-77.762647)"
2017,Junio,Panamá,591,206,172,,378,"(7.128456,-73.183637)"
2017,Junio,Panamá,591,0,7,,7,"(8.066966,-76.735404)"
2017,Junio,Panamá,591,28,58,,86,"(8.635765,-77.346578)"
2017,Junio,Paraguay,600,0,1,,1,"(0.814836,-77.662532)"
2017,Junio,Paraguay,600,1,3,,4,"(10.445761,-75.516429)"
2017,Junio,Paraguay,600,1,5,,6,"(10.886611,-74.776708)"
2017,Junio,Paraguay,600,14,9,,23,"(3.541112,-76.384584)"
2017,Junio,Paraguay,600,86,188,,274,"(4.697144,-74.140516)"
2017,Junio,Paraguay,600,14,17,,31,"(4.815061,-75.736532)"
2017,Junio,Paraguay,600,12,28,,40,"(6.171601,-75.427454)"
2017,Junio,Paraguay,600,0,3,,3,"(7.128456,-73.183637)"
2017,Junio,Perú,604,4,2,,6,"(-0.193180,-74.784874)"
2017,Junio,Perú,604,86,102,,188,"(-4.197703,-69.941278)"
2017,Junio,Perú,604,101,200,,301,"(-4.223468,-69.945098)"
2017,Junio,Perú,604,57,107,,164,"(0.814836,-77.662532)"
2017,Junio,Perú,604,0,2,,2,"(1.813928,-78.763924)"
2017,Junio,Perú,604,74,66,,140,"(10.445761,-75.516429)"
2017,Junio,Perú,604,13,8,,21,"(10.886611,-74.776708)"
2017,Junio,Perú,604,0,2,,2,"(12.586067,-81.702563)"
2017,Junio,Perú,604,234,169,,403,"(3.541112,-76.384584)"
2017,Junio,Perú,604,6545,6610,,13155,"(4.697144,-74.140516)"
2017,Junio,Perú,604,6,4,,10,"(4.815061,-75.736532)"
2017,Junio,Perú,604,229,219,,448,"(6.171601,-75.427454)"
2017,Junio,Perú,604,1,1,,2,"(7.128456,-73.183637)"
2017,Junio,Polonia,616,0,1,,1,"(10.445761,-75.516429)"
2017,Junio,Polonia,616,0,1,,1,"(3.541112,-76.384584)"
2017,Junio,Polonia,616,24,25,,49,"(4.697144,-74.140516)"
2017,Junio,Polonia,616,5,1,,6,"(6.171601,-75.427454)"
2017,Junio,Portugal,620,10,5,,15,"(3.541112,-76.384584)"
2017,Junio,Portugal,620,163,125,,288,"(4.697144,-74.140516)"
2017,Junio,Portugal,620,0,2,,2,"(4.815061,-75.736532)"
2017,Junio,Portugal,620,11,11,,22,"(6.171601,-75.427454)"
2017,Junio,Portugal,620,1,0,,1,"(7.128456,-73.183637)"
2017,Junio,Puerto Rico/Territorio de Estados Unidos,630,9,4,,13,"(10.445761,-75.516429)"
2017,Junio,Puerto Rico/Territorio de Estados Unidos,630,22,17,,39,"(10.886611,-74.776708)"
2017,Junio,Puerto Rico/Territorio de Estados Unidos,630,1,1,,2,"(12.586067,-81.702563)"
2017,Junio,Puerto Rico/Territorio de Estados Unidos,630,21,17,,38,"(3.541112,-76.384584)"
2017,Junio,Puerto Rico/Territorio de Estados Unidos,630,710,620,,1330,"(4.697144,-74.140516)"
2017,Junio,Puerto Rico/Territorio de Estados Unidos,630,15,4,,19,"(4.815061,-75.736532)"
2017,Junio,Puerto Rico/Territorio de Estados Unidos,630,78,55,,133,"(6.171601,-75.427454)"
2017,Junio,Puerto Rico/Territorio de Estados Unidos,630,7,4,,11,"(7.128456,-73.183637)"
2017,Junio,Qatar,634,1,0,,1,"(3.541112,-76.384584)"
2017,Junio,Qatar,634,6,2,,8,"(4.697144,-74.140516)"
2017,Junio,Qatar,634,1,2,,3,"(6.171601,-75.427454)"
2017,Junio,Reino Unido de Gran Bretaña e Irlanda del Norte,826,0,2,,2,"(10.445761,-75.516429)"
2017,Junio,Reino Unido de Gran Bretaña e Irlanda del Norte,826,4,7,,11,"(10.886611,-74.776708)"
2017,Junio,Reino Unido de Gran Bretaña e Irlanda del Norte,826,35,21,,56,"(3.541112,-76.384584)"
2017,Junio,Reino Unido de Gran Bretaña e Irlanda del Norte,826,2533,1731,,4264,"(4.697144,-74.140516)"
2017,Junio,Reino Unido de Gran Bretaña e Irlanda del Norte,826,39,30,,69,"(6.171601,-75.427454)"
2017,Junio,República CentroÁfricana,140,4,6,,10,"(4.697144,-74.140516)"
2017,Junio,Federación de Rusia,643,2,1,,3,"(10.445761,-75.516429)"
2017,Junio,Federación de Rusia,643,0,1,,1,"(10.886611,-74.776708)"
2017,Junio,Federación de Rusia,643,1,2,,3,"(3.541112,-76.384584)"
2017,Junio,Federación de Rusia,643,62,59,,121,"(4.697144,-74.140516)"
2017,Junio,Federación de Rusia,643,0,1,,1,"(4.815061,-75.736532)"
2017,Junio,Federación de Rusia,643,7,12,,19,"(6.171601,-75.427454)"
2017,Junio,República Dominicana,214,19,14,,33,"(10.445761,-75.516429)"
2017,Junio,República Dominicana,214,38,53,,91,"(10.886611,-74.776708)"
2017,Junio,República Dominicana,214,0,2,,2,"(11.117806,-74.232622)"
2017,Junio,República Dominicana,214,0,1,,1,"(12.586067,-81.702563)"
2017,Junio,República Dominicana,214,72,59,,131,"(3.541112,-76.384584)"
2017,Junio,República Dominicana,214,3705,3323,,7028,"(4.697144,-74.140516)"
2017,Junio,República Dominicana,214,23,24,,47,"(4.815061,-75.736532)"
2017,Junio,República Dominicana,214,259,204,,463,"(6.171601,-75.427454)"
2017,Junio,República Dominicana,214,70,54,,124,"(7.128456,-73.183637)"
2017,Junio,Reunión,638,1,0,,1,"(4.697144,-74.140516)"
2017,Junio,Rumania,642,4,0,,4,"(10.445761,-75.516429)"
2017,Junio,Rumania,642,2,4,,6,"(4.697144,-74.140516)"
2017,Junio,Rumania,642,1,4,,5,"(6.171601,-75.427454)"
2017,Junio,Rwanda,646,0,1,,1,"(4.697144,-74.140516)"
2017,Junio,San  Vicente y las Granadinas,670,1,4,,5,"(4.697144,-74.140516)"
2017,Junio,Santa Lucia,662,1,1,,2,"(10.445761,-75.516429)"
2017,Junio,Santo Tomé y Príncipe,678,1,0,,1,"(12.586067,-81.702563)"
2017,Junio,Senegal,686,1,0,,1,"(4.697144,-74.140516)"
2017,Junio,Seychelles,690,1,0,,1,"(4.697144,-74.140516)"
2017,Junio,Singapur,702,1,1,,2,"(3.541112,-76.384584)"
2017,Junio,Singapur,702,14,24,,38,"(4.697144,-74.140516)"
2017,Junio,Singapur,702,3,3,,6,"(6.171601,-75.427454)"
2017,Junio,Sudáfrica,710,0,1,,1,"(3.541112,-76.384584)"
2017,Junio,Sudáfrica,710,23,17,,40,"(4.697144,-74.140516)"
2017,Junio,Sudáfrica,710,1,0,,1,"(6.171601,-75.427454)"
2017,Junio,Sudán,736,0,1,,1,"(6.171601,-75.427454)"
2017,Junio,Suecia,752,2,3,,5,"(10.445761,-75.516429)"
2017,Junio,Suecia,752,6,6,,12,"(10.886611,-74.776708)"
2017,Junio,Suecia,752,10,14,,24,"(3.541112,-76.384584)"
2017,Junio,Suecia,752,100,97,,197,"(4.697144,-74.140516)"
2017,Junio,Suecia,752,12,8,,20,"(6.171601,-75.427454)"
2017,Junio,Suecia,752,1,0,,1,"(7.128456,-73.183637)"
2017,Junio,Suiza,756,8,3,,11,"(10.886611,-74.776708)"
2017,Junio,Suiza,756,60,23,,83,"(3.541112,-76.384584)"
2017,Junio,Suiza,756,304,249,,553,"(4.697144,-74.140516)"
2017,Junio,Suiza,756,33,23,,56,"(6.171601,-75.427454)"
2017,Junio,Surinam,740,5,3,,8,"(4.697144,-74.140516)"
2017,Junio,Surinam,740,0,3,,3,"(6.171601,-75.427454)"
2017,Junio,Taiwán,158,0,2,,2,"(4.697144,-74.140516)"
2017,Junio,Tailandia,764,0,1,,1,"(10.445761,-75.516429)"
2017,Junio,Tailandia,764,2,1,,3,"(10.886611,-74.776708)"
2017,Junio,Tailandia,764,1,0,,1,"(3.541112,-76.384584)"
2017,Junio,Tailandia,764,35,29,,64,"(4.697144,-74.140516)"
2017,Junio,Tailandia,764,3,2,,5,"(6.171601,-75.427454)"
2017,Junio,Tanzania,834,2,2,,4,"(4.697144,-74.140516)"
2017,Junio,Trinidad y Tobago,780,1,2,,3,"(10.445761,-75.516429)"
2017,Junio,Trinidad y Tobago,780,1,2,,3,"(10.886611,-74.776708)"
2017,Junio,Trinidad y Tobago,780,6,8,,14,"(3.541112,-76.384584)"
2017,Junio,Trinidad y Tobago,780,15,33,,48,"(4.697144,-74.140516)"
2017,Junio,Trinidad y Tobago,780,2,0,,2,"(4.815061,-75.736532)"
2017,Junio,Trinidad y Tobago,780,16,9,,25,"(6.171601,-75.427454)"
2017,Junio,Trinidad y Tobago,780,2,5,,7,"(7.128456,-73.183637)"
2017,Junio,Túnez,788,1,1,,2,"(4.697144,-74.140516)"
2017,Junio,Túnez,788,0,1,,1,"(6.171601,-75.427454)"
2017,Junio,Turquía,792,1,0,,1,"(10.886611,-74.776708)"
2017,Junio,Turquía,792,7,3,,10,"(3.541112,-76.384584)"
2017,Junio,Turquía,792,481,342,,823,"(4.697144,-74.140516)"
2017,Junio,Turquía,792,3,1,,4,"(4.815061,-75.736532)"
2017,Junio,Turquía,792,4,7,,11,"(6.171601,-75.427454)"
2017,Junio,Turkmenistán,795,1,4,,5,"(4.697144,-74.140516)"
2017,Junio,Ucrania,804,1,2,,3,"(4.697144,-74.140516)"
2017,Junio,Uganda,800,1,1,,2,"(4.697144,-74.140516)"
2017,Junio,Uruguay,858,1,0,,1,"(10.886611,-74.776708)"
2017,Junio,Uruguay,858,2,7,,9,"(3.541112,-76.384584)"
2017,Junio,Uruguay,858,274,343,,617,"(4.697144,-74.140516)"
2017,Junio,Uruguay,858,9,9,,18,"(4.815061,-75.736532)"
2017,Junio,Uruguay,858,8,6,,14,"(6.171601,-75.427454)"
2017,Junio,Uruguay,858,1,0,,1,"(7.128456,-73.183637)"
2017,Junio,Venezuela,862,4,12,,16,"(10.445761,-75.516429)"
2017,Junio,Venezuela,862,3,12,,15,"(10.886611,-74.776708)"
2017,Junio,Venezuela,862,2162,2129,,4291,"(11.360009,-72.129330)"
2017,Junio,Venezuela,862,0,1,,1,"(12.586067,-81.702563)"
2017,Junio,Venezuela,862,1,9,,10,"(3.541112,-76.384584)"
2017,Junio,Venezuela,862,7,6,,13,"(3.866713,-67.927521)"
2017,Junio,Venezuela,862,1505,1413,,2918,"(4.697144,-74.140516)"
2017,Junio,Venezuela,862,3,2,,5,"(4.815061,-75.736532)"
2017,Junio,Venezuela,862,738,630,,1368,"(6.171601,-75.427454)"
2017,Junio,Venezuela,862,76,80,,156,"(6.185799,-67.483929)"
2017,Junio,Venezuela,862,711,620,,1331,"(7.088729,-70.740253)"
2017,Junio,Venezuela,862,1,9,,10,"(7.128456,-73.183637)"
2017,Junio,Venezuela,862,1986,1949,,3935,"(7.818934,-72.453226)"
2017,Junio,Venezuela,862,110,150,,260,"(8.36068,-72.409396)"
2017,Junio,Vietnam,704,1,0,,1,"(10.886611,-74.776708)"
2017,Junio,Vietnam,704,1,1,,2,"(4.697144,-74.140516)"
2017,Junio,Vietnam,704,1,0,,1,"(4.815061,-75.736532)"
2017,Junio,Islas Vírgenes Británicas/Territorio Británico de Ultramar,92,1,1,,2,"(3.541112,-76.384584)"
2017,Junio,Zambia,894,1,0,,1,"(4.697144,-74.140516)"
2017,Junio,Zimbabue,716,1,1,,2,"(4.697144,-74.140516)"
2017,Junio,Islas Turcas y Caicos/Territorio Británico de Ultramar,796,0,4,,4,"(4.697144,-74.140516)"
2017,Junio,Islas Turcas y Caicos/Territorio Británico de Ultramar,796,0,2,,2,"(6.171601,-75.427454)"
2017,Julio,Afganistán,4,0,2,,2,"(4.697144,-74.140516)"
2017,Julio,Albania,8,0,1,,1,"(3.541112,-76.384584)"
2017,Julio,Albania,8,1,9,,10,"(4.697144,-74.140516)"
2017,Julio,Alemania,276,5,4,,9,"(0.814836,-77.662532)"
2017,Julio,Alemania,276,15,3,,18,"(10.445761,-75.516429)"
2017,Julio,Alemania,276,43,36,,79,"(10.886611,-74.776708)"
2017,Julio,Alemania,276,59,49,,108,"(3.541112,-76.384584)"
2017,Julio,Alemania,276,1401,1169,,2570,"(4.697144,-74.140516)"
2017,Julio,Alemania,276,8,4,,12,"(4.815061,-75.736532)"
2017,Julio,Alemania,276,88,92,,180,"(6.171601,-75.427454)"
2017,Julio,Alemania,276,3,1,,4,"(7.128456,-73.183637)"
2017,Julio,Andorra,20,1,0,,1,"(4.697144,-74.140516)"
2017,Julio,Angola,24,1,5,,6,"(4.697144,-74.140516)"
2017,Julio,Antigua y Barbuda,28,8,0,,8,"(12.586067,-81.702563)"
2017,Julio,Antigua y Barbuda,28,3,3,,6,"(4.697144,-74.140516)"
2017,Julio,Países Bajos,528,0,1,,1,"(10.408582,-75.538003)"
2017,Julio,Países Bajos,528,94,67,,161,"(10.445761,-75.516429)"
2017,Julio,Países Bajos,528,38,22,,60,"(10.886611,-74.776708)"
2017,Julio,Países Bajos,528,91,34,,125,"(3.541112,-76.384584)"
2017,Julio,Países Bajos,528,1280,1043,,2323,"(4.697144,-74.140516)"
2017,Julio,Países Bajos,528,10,1,,11,"(4.815061,-75.736532)"
2017,Julio,Países Bajos,528,136,106,,242,"(6.171601,-75.427454)"
2017,Julio,Arabia Saudita,682,2,2,,4,"(3.541112,-76.384584)"
2017,Julio,Arabia Saudita,682,11,37,,48,"(4.697144,-74.140516)"
2017,Julio,Arabia Saudita,682,1,0,,1,"(4.815061,-75.736532)"
2017,Julio,Arabia Saudita,682,1,4,,5,"(6.171601,-75.427454)"
2017,Julio,Arabia Saudita,682,0,1,,1,"(7.128456,-73.183637)"
2017,Julio,Argelia,12,4,7,,11,"(4.697144,-74.140516)"
2017,Julio,Argentina,32,11,24,,35,"(0.814836,-77.662532)"
2017,Julio,Argentina,32,0,1,,1,"(1.813928,-78.763924)"
2017,Julio,Argentina,32,10,7,,17,"(10.445761,-75.516429)"
2017,Julio,Argentina,32,20,11,,31,"(10.886611,-74.776708)"
2017,Julio,Argentina,32,0,1,,1,"(12.586067,-81.702563)"
2017,Julio,Argentina,32,69,71,,140,"(3.541112,-76.384584)"
2017,Julio,Argentina,32,2358,2408,,4766,"(4.697144,-74.140516)"
2017,Julio,Argentina,32,20,25,,45,"(4.815061,-75.736532)"
2017,Julio,Argentina,32,55,62,,117,"(6.171601,-75.427454)"
2017,Julio,Argentina,32,5,4,,9,"(7.128456,-73.183637)"
2017,Julio,República de Armenia,51,1,1,,2,"(4.697144,-74.140516)"
2017,Julio,Aruba,533,1946,1445,,3391,"(10.408582,-75.538003)"
2017,Julio,Aruba,533,3,0,,3,"(10.445761,-75.516429)"
2017,Julio,Aruba,533,14,13,,27,"(10.886611,-74.776708)"
2017,Julio,Aruba,533,0,2,,2,"(11.247723,-74.213989)"
2017,Julio,Aruba,533,52,31,,83,"(3.541112,-76.384584)"
2017,Julio,Aruba,533,2362,1956,,4318,"(4.697144,-74.140516)"
2017,Julio,Aruba,533,3,7,,10,"(4.815061,-75.736532)"
2017,Julio,Aruba,533,59,59,,118,"(6.171601,-75.427454)"
2017,Julio,Aruba,533,13,49,,62,"(7.128456,-73.183637)"
2017,Julio,Australia,36,0,2,,2,"(10.445761,-75.516429)"
2017,Julio,Australia,36,2,2,,4,"(10.886611,-74.776708)"
2017,Julio,Australia,36,17,7,,24,"(3.541112,-76.384584)"
2017,Julio,Australia,36,327,285,,612,"(4.697144,-74.140516)"
2017,Julio,Australia,36,3,1,,4,"(4.815061,-75.736532)"
2017,Julio,Australia,36,37,47,,84,"(6.171601,-75.427454)"
2017,Julio,Australia,36,3,1,,4,"(7.128456,-73.183637)"
2017,Julio,Austria,40,2,3,,5,"(10.445761,-75.516429)"
2017,Julio,Austria,40,2,1,,3,"(10.886611,-74.776708)"
2017,Julio,Austria,40,1,0,,1,"(3.541112,-76.384584)"
2017,Julio,Austria,40,44,42,,86,"(4.697144,-74.140516)"
2017,Julio,Austria,40,8,9,,17,"(6.171601,-75.427454)"
2017,Julio,Austria,40,3,3,,6,"(7.128456,-73.183637)"
2017,Julio,Azerbaiyán,31,3,1,,4,"(4.697144,-74.140516)"
2017,Julio,Bahamas,44,0,2,,2,"(10.445761,-75.516429)"
2017,Julio,Bahamas,44,12,13,,25,"(10.886611,-74.776708)"
2017,Julio,Bahamas,44,1,1,,2,"(12.586067,-81.702563)"
2017,Julio,Bahamas,44,12,5,,17,"(3.541112,-76.384584)"
2017,Julio,Bahamas,44,12,11,,23,"(4.697144,-74.140516)"
2017,Julio,Bahamas,44,5,6,,11,"(4.815061,-75.736532)"
2017,Julio,Bahamas,44,19,17,,36,"(6.171601,-75.427454)"
2017,Julio,Bahamas,44,1,2,,3,"(7.128456,-73.183637)"
2017,Julio,Bahréin,48,1,2,,3,"(10.445761,-75.516429)"
2017,Julio,Bahréin,48,4,6,,10,"(4.697144,-74.140516)"
2017,Julio,Bahréin,48,0,1,,1,"(6.171601,-75.427454)"
2017,Julio,Bangladesh,50,1,3,,4,"(4.697144,-74.140516)"
2017,Julio,Barbados,52,4,4,,8,"(10.886611,-74.776708)"
2017,Julio,Barbados,52,150,147,,297,"(4.697144,-74.140516)"
2017,Julio,República de Belarús,112,1,2,,3,"(4.697144,-74.140516)"
2017,Julio,Bélgica,56,1,0,,1,"(10.445761,-75.516429)"
2017,Julio,Bélgica,56,2,3,,5,"(10.886611,-74.776708)"
2017,Julio,Bélgica,56,19,14,,33,"(3.541112,-76.384584)"
2017,Julio,Bélgica,56,115,76,,191,"(4.697144,-74.140516)"
2017,Julio,Bélgica,56,1,0,,1,"(4.815061,-75.736532)"
2017,Julio,Bélgica,56,55,33,,88,"(6.171601,-75.427454)"
2017,Julio,Belice,84,1,3,,4,"(3.541112,-76.384584)"
2017,Julio,Belice,84,13,8,,21,"(4.697144,-74.140516)"
2017,Julio,Belice,84,0,2,,2,"(4.815061,-75.736532)"
2017,Julio,Belice,84,8,4,,12,"(6.171601,-75.427454)"
2017,Julio,Bermudas/Territorio Británico de Ultramar,60,14,127,,141,"(10.408582,-75.538003)"
2017,Julio,Bermudas/Territorio Británico de Ultramar,60,1,0,,1,"(4.697144,-74.140516)"
2017,Julio,Bermudas/Territorio Británico de Ultramar,60,0,1,,1,"(6.171601,-75.427454)"
2017,Julio,Bolivia,68,1,12,,13,"(0.814836,-77.662532)"
2017,Julio,Bolivia,68,0,1,,1,"(10.445761,-75.516429)"
2017,Julio,Bolivia,68,2,3,,5,"(10.886611,-74.776708)"
2017,Julio,Bolivia,68,16,17,,33,"(3.541112,-76.384584)"
2017,Julio,Bolivia,68,311,485,,796,"(4.697144,-74.140516)"
2017,Julio,Bolivia,68,4,2,,6,"(4.815061,-75.736532)"
2017,Julio,Bolivia,68,6,15,,21,"(6.171601,-75.427454)"
2017,Julio,Bolivia,68,1,0,,1,"(7.128456,-73.183637)"
2017,Julio,Bosnia y Herzegovina,70,1,2,,3,"(4.697144,-74.140516)"
2017,Julio,Brasil,76,149,285,,434,"(-4.197703,-69.941278)"
2017,Julio,Brasil,76,12,16,,28,"(-4.223468,-69.945098)"
2017,Julio,Brasil,76,8,8,,16,"(10.445761,-75.516429)"
2017,Julio,Brasil,76,5,13,,18,"(10.886611,-74.776708)"
2017,Julio,Brasil,76,2,1,,3,"(12.586067,-81.702563)"
2017,Julio,Brasil,76,75,92,,167,"(3.541112,-76.384584)"
2017,Julio,Brasil,76,2723,3423,,6146,"(4.697144,-74.140516)"
2017,Julio,Brasil,76,13,30,,43,"(4.815061,-75.736532)"
2017,Julio,Brasil,76,90,115,,205,"(6.171601,-75.427454)"
2017,Julio,Brasil,76,7,8,,15,"(7.128456,-73.183637)"
2017,Julio,Bulgaria,100,6,5,,11,"(4.697144,-74.140516)"
2017,Julio,Bulgaria,100,0,1,,1,"(6.171601,-75.427454)"
2017,Julio,Burkina Faso,854,0,1,,1,"(4.697144,-74.140516)"
2017,Julio,Islas Caimán/Territorio Británico de Ultramar,136,4,4,,8,"(12.586067,-81.702563)"
2017,Julio,Islas Caimán/Territorio Británico de Ultramar,136,2,1,,3,"(3.541112,-76.384584)"
2017,Julio,Islas Caimán/Territorio Británico de Ultramar,136,2,4,,6,"(4.697144,-74.140516)"
2017,Julio,Islas Caimán/Territorio Británico de Ultramar,136,3,1,,4,"(6.171601,-75.427454)"
2017,Julio,Camboya,116,0,1,,1,"(4.697144,-74.140516)"
2017,Julio,Camerún,120,1,3,,4,"(4.697144,-74.140516)"
2017,Julio,Canadá,124,44,34,,78,"(10.445761,-75.516429)"
2017,Julio,Canadá,124,63,48,,111,"(10.886611,-74.776708)"
2017,Julio,Canadá,124,0,1,,1,"(12.586067,-81.702563)"
2017,Julio,Canadá,124,182,144,,326,"(3.541112,-76.384584)"
2017,Julio,Canadá,124,2,1,,3,"(4.452882,-75.766298)"
2017,Julio,Canadá,124,2411,1914,,4325,"(4.697144,-74.140516)"
2017,Julio,Canadá,124,17,13,,30,"(4.815061,-75.736532)"
2017,Julio,Canadá,124,314,227,,541,"(6.171601,-75.427454)"
2017,Julio,Canadá,124,17,10,,27,"(7.128456,-73.183637)"
2017,Julio,España,724,1,0,,1,"(0.814836,-77.662532)"
2017,Julio,España,724,10,4,,14,"(10.445761,-75.516429)"
2017,Julio,España,724,22,23,,45,"(10.886611,-74.776708)"
2017,Julio,España,724,0,2,,2,"(12.586067,-81.702563)"
2017,Julio,España,724,2885,1854,,4739,"(3.541112,-76.384584)"
2017,Julio,España,724,12427,9390,,21817,"(4.697144,-74.140516)"
2017,Julio,España,724,16,13,,29,"(4.815061,-75.736532)"
2017,Julio,España,724,2101,1556,,3657,"(6.171601,-75.427454)"
2017,Julio,España,724,6,8,,14,"(7.128456,-73.183637)"
2017,Julio,Colombia,170,2,6,,8,"(10.445761,-75.516429)"
2017,Julio,Colombia,170,171,516,,687,"(4.697144,-74.140516)"
2017,Julio,República Del Congo,178,0,2,,2,"(4.697144,-74.140516)"
2017,Julio,República de Corea,410,0,1,,1,"(10.445761,-75.516429)"
2017,Julio,República de Corea,410,23,18,,41,"(4.697144,-74.140516)"
2017,Julio,República de Corea,410,5,12,,17,"(6.171601,-75.427454)"
2017,Julio,Costa de Marfil,384,5,8,,13,"(4.697144,-74.140516)"
2017,Julio,Costa de Marfil,384,0,1,,1,"(6.171601,-75.427454)"
2017,Julio,Costa Rica,188,9,9,,18,"(10.445761,-75.516429)"
2017,Julio,Costa Rica,188,23,17,,40,"(10.886611,-74.776708)"
2017,Julio,Costa Rica,188,1,9,,10,"(12.5744111,-81.703935)"
2017,Julio,Costa Rica,188,4,9,,13,"(12.586067,-81.702563)"
2017,Julio,Costa Rica,188,53,51,,104,"(3.541112,-76.384584)"
2017,Julio,Costa Rica,188,1195,1329,,2524,"(4.697144,-74.140516)"
2017,Julio,Costa Rica,188,4,3,,7,"(4.815061,-75.736532)"
2017,Julio,Costa Rica,188,130,170,,300,"(6.171601,-75.427454)"
2017,Julio,Costa Rica,188,4,2,,6,"(7.128456,-73.183637)"
2017,Julio,Croacia,191,1,0,,1,"(10.886611,-74.776708)"
2017,Julio,Croacia,191,2,8,,10,"(4.697144,-74.140516)"
2017,Julio,Croacia,191,0,1,,1,"(6.171601,-75.427454)"
2017,Julio,Cuba,192,21,26,,47,"(10.445761,-75.516429)"
2017,Julio,Cuba,192,14,23,,37,"(10.886611,-74.776708)"
2017,Julio,Cuba,192,80,52,,132,"(3.541112,-76.384584)"
2017,Julio,Cuba,192,1435,1254,,2689,"(4.697144,-74.140516)"
2017,Julio,Cuba,192,8,10,,18,"(4.815061,-75.736532)"
2017,Julio,Cuba,192,110,94,,204,"(6.171601,-75.427454)"
2017,Julio,Cuba,192,14,14,,28,"(7.128456,-73.183637)"
2017,Julio,Curazao,99999,18,45,,63,"(4.697144,-74.140516)"
2017,Julio,República Checa,203,0,1,,1,"(3.541112,-76.384584)"
2017,Julio,República Checa,203,14,9,,23,"(4.697144,-74.140516)"
2017,Julio,República Checa,203,4,1,,5,"(6.171601,-75.427454)"
2017,Julio,Chile,152,217,233,,450,"(0.814836,-77.662532)"
2017,Julio,Chile,152,9,8,,17,"(10.445761,-75.516429)"
2017,Julio,Chile,152,37,27,,64,"(10.886611,-74.776708)"
2017,Julio,Chile,152,1,2,,3,"(12.586067,-81.702563)"
2017,Julio,Chile,152,219,162,,381,"(3.541112,-76.384584)"
2017,Julio,Chile,152,4100,3767,,7867,"(4.697144,-74.140516)"
2017,Julio,Chile,152,59,45,,104,"(4.815061,-75.736532)"
2017,Julio,Chile,152,100,77,,177,"(6.171601,-75.427454)"
2017,Julio,Chile,152,6,7,,13,"(7.128456,-73.183637)"
2017,Julio,China,156,1,3,,4,"(10.445761,-75.516429)"
2017,Julio,China,156,2,2,,4,"(10.886611,-74.776708)"
2017,Julio,China,156,3,15,,18,"(3.541112,-76.384584)"
2017,Julio,China,156,136,345,,481,"(4.697144,-74.140516)"
2017,Julio,China,156,26,52,,78,"(6.171601,-75.427454)"
2017,Julio,Chipre,196,1,0,,1,"(6.171601,-75.427454)"
2017,Julio,Dinamarca,208,2,0,,2,"(10.445761,-75.516429)"
2017,Julio,Dinamarca,208,2,1,,3,"(10.886611,-74.776708)"
2017,Julio,Dinamarca,208,0,2,,2,"(12.586067,-81.702563)"
2017,Julio,Dinamarca,208,2,0,,2,"(3.541112,-76.384584)"
2017,Julio,Dinamarca,208,36,37,,73,"(4.697144,-74.140516)"
2017,Julio,Dinamarca,208,6,5,,11,"(6.171601,-75.427454)"
2017,Julio,Dominica,212,0,1,,1,"(4.697144,-74.140516)"
2017,Julio,Ecuador,218,0,2,,2,"(-0.193180,-74.784874)"
2017,Julio,Ecuador,218,561,884,,1445,"(0.25129,-76.875963)"
2017,Julio,Ecuador,218,54,45,,99,"(0.812436,-77.847006)"
2017,Julio,Ecuador,218,7875,8284,,16159,"(0.814836,-77.662532)"
2017,Julio,Ecuador,218,178,213,,391,"(1.813928,-78.763924)"
2017,Julio,Ecuador,218,0,2,,2,"(10.445761,-75.516429)"
2017,Julio,Ecuador,218,5,8,,13,"(10.886611,-74.776708)"
2017,Julio,Ecuador,218,372,490,,862,"(3.541112,-76.384584)"
2017,Julio,Ecuador,218,2760,4242,,7002,"(4.697144,-74.140516)"
2017,Julio,Ecuador,218,1,3,,4,"(4.815061,-75.736532)"
2017,Julio,Ecuador,218,8,21,,29,"(6.171601,-75.427454)"
2017,Julio,Ecuador,218,1,1,,2,"(7.128456,-73.183637)"
2017,Julio,Egipto,818,1,0,,1,"(10.886611,-74.776708)"
2017,Julio,Egipto,818,2,4,,6,"(3.541112,-76.384584)"
2017,Julio,Egipto,818,14,12,,26,"(4.697144,-74.140516)"
2017,Julio,Egipto,818,0,1,,1,"(6.171601,-75.427454)"
2017,Julio,El Salvador,222,2,2,,4,"(10.445761,-75.516429)"
2017,Julio,El Salvador,222,7,1,,8,"(10.886611,-74.776708)"
2017,Julio,El Salvador,222,100,82,,182,"(3.541112,-76.384584)"
2017,Julio,El Salvador,222,880,1169,,2049,"(4.697144,-74.140516)"
2017,Julio,El Salvador,222,52,132,,184,"(6.171601,-75.427454)"
2017,Julio,Emiratos Árabes,784,0,1,,1,"(10.445761,-75.516429)"
2017,Julio,Emiratos Árabes,784,0,1,,1,"(10.886611,-74.776708)"
2017,Julio,Emiratos Árabes,784,4,2,,6,"(3.541112,-76.384584)"
2017,Julio,Emiratos Árabes,784,80,147,,227,"(4.697144,-74.140516)"
2017,Julio,Emiratos Árabes,784,10,11,,21,"(6.171601,-75.427454)"
2017,Julio,Eritrea,232,0,1,,1,"(4.697144,-74.140516)"
2017,Julio,Eslovaquia,703,0,1,,1,"(4.697144,-74.140516)"
2017,Julio,Eslovenia,705,1,4,,5,"(4.697144,-74.140516)"
2017,Julio,Estados Unidos de América,840,1,1,,2,"(0.814836,-77.662532)"
2017,Julio,Estados Unidos de América,840,3828,3139,,6967,"(10.445761,-75.516429)"
2017,Julio,Estados Unidos de América,840,3761,3025,,6786,"(10.886611,-74.776708)"
2017,Julio,Estados Unidos de América,840,64,58,,122,"(12.586067,-81.702563)"
2017,Julio,Estados Unidos de América,840,7312,5006,,12318,"(3.541112,-76.384584)"
2017,Julio,Estados Unidos de América,840,881,643,,1524,"(4.452882,-75.766298)"
2017,Julio,Estados Unidos de América,840,35461,29408,,64869,"(4.697144,-74.140516)"
2017,Julio,Estados Unidos de América,840,1101,695,,1796,"(4.815061,-75.736532)"
2017,Julio,Estados Unidos de América,840,0,2,,2,"(6.17134,-75.427194)"
2017,Julio,Estados Unidos de América,840,11629,9261,,20890,"(6.171601,-75.427454)"
2017,Julio,Estados Unidos de América,840,321,219,,540,"(7.128456,-73.183637)"
2017,Julio,Estados Unidos de América,840,0,1,,1,"(9.402978,-75.681599)"
2017,Julio,Estonia,233,1,5,,6,"(4.697144,-74.140516)"
2017,Julio,Etiopia,231,1,1,,2,"(4.697144,-74.140516)"
2017,Julio,Etiopia,231,0,1,,1,"(6.171601,-75.427454)"
2017,Julio,Filipinas,608,6,3,,9,"(4.697144,-74.140516)"
2017,Julio,Finlandia,246,13,8,,21,"(4.697144,-74.140516)"
2017,Julio,Finlandia,246,2,1,,3,"(6.171601,-75.427454)"
2017,Julio,Francia,250,7,3,,10,"(10.445761,-75.516429)"
2017,Julio,Francia,250,27,18,,45,"(10.886611,-74.776708)"
2017,Julio,Francia,250,91,53,,144,"(3.541112,-76.384584)"
2017,Julio,Francia,250,1755,1384,,3139,"(4.697144,-74.140516)"
2017,Julio,Francia,250,6,8,,14,"(4.815061,-75.736532)"
2017,Julio,Francia,250,154,107,,261,"(6.171601,-75.427454)"
2017,Julio,Francia,250,4,3,,7,"(7.128456,-73.183637)"
2017,Julio,Gabón,266,0,1,,1,"(4.697144,-74.140516)"
2017,Julio,Georgia,268,0,2,,2,"(4.697144,-74.140516)"
2017,Julio,Ghana,288,0,1,,1,"(10.445761,-75.516429)"
2017,Julio,Ghana,288,0,3,,3,"(4.697144,-74.140516)"
2017,Julio,Ghana,288,0,1,,1,"(6.171601,-75.427454)"
2017,Julio,Gibraltar/Territorio Británico de Ultramar,292,2,3,,5,"(0.814836,-77.662532)"
2017,Julio,Grecia,300,0,1,,1,"(10.445761,-75.516429)"
2017,Julio,Grecia,300,0,1,,1,"(10.886611,-74.776708)"
2017,Julio,Grecia,300,1,1,,2,"(3.541112,-76.384584)"
2017,Julio,Grecia,300,40,16,,56,"(4.697144,-74.140516)"
2017,Julio,Grecia,300,8,2,,10,"(6.171601,-75.427454)"
2017,Julio,Grecia,300,2,0,,2,"(7.128456,-73.183637)"
2017,Julio,Guatemala,320,4,6,,10,"(10.445761,-75.516429)"
2017,Julio,Guatemala,320,18,37,,55,"(10.886611,-74.776708)"
2017,Julio,Guatemala,320,2,1,,3,"(12.586067,-81.702563)"
2017,Julio,Guatemala,320,69,96,,165,"(3.541112,-76.384584)"
2017,Julio,Guatemala,320,569,760,,1329,"(4.697144,-74.140516)"
2017,Julio,Guatemala,320,10,13,,23,"(4.815061,-75.736532)"
2017,Julio,Guatemala,320,92,159,,251,"(6.171601,-75.427454)"
2017,Julio,Guatemala,320,4,4,,8,"(7.128456,-73.183637)"
2017,Julio,Guyana,328,0,1,,1,"(10.408582,-75.538003)"
2017,Julio,Guyana,328,1,2,,3,"(10.886611,-74.776708)"
2017,Julio,Guyana,328,0,2,,2,"(3.541112,-76.384584)"
2017,Julio,Guyana,328,0,1,,1,"(4.697144,-74.140516)"
2017,Julio,Guyana,328,1,2,,3,"(6.171601,-75.427454)"
2017,Julio,Guinea,324,1,0,,1,"(4.697144,-74.140516)"
2017,Julio,Guinea Ecuatorial,226,0,3,,3,"(4.697144,-74.140516)"
2017,Julio,Guadalupe/Territorio Francés,312,0,1,,1,"(10.886611,-74.776708)"
2017,Julio,Guadalupe/Territorio Francés,312,1,0,,1,"(4.697144,-74.140516)"
2017,Julio,Guadalupe/Territorio Francés,312,1,0,,1,"(4.815061,-75.736532)"
2017,Julio,Guayana Francesa/Departamento de Ultramar Francés,254,0,1,,1,"(10.886611,-74.776708)"
2017,Julio,Guayana Francesa/Departamento de Ultramar Francés,254,1,0,,1,"(4.697144,-74.140516)"
2017,Julio,Haití,332,1,0,,1,"(10.445761,-75.516429)"
2017,Julio,Haití,332,2,2,,4,"(10.886611,-74.776708)"
2017,Julio,Haití,332,1,1,,2,"(3.541112,-76.384584)"
2017,Julio,Haití,332,4,6,,10,"(4.697144,-74.140516)"
2017,Julio,Haití,332,0,1,,1,"(4.815061,-75.736532)"
2017,Julio,Haití,332,0,7,,7,"(6.171601,-75.427454)"
2017,Julio,Honduras,340,1,5,,6,"(10.445761,-75.516429)"
2017,Julio,Honduras,340,3,9,,12,"(10.886611,-74.776708)"
2017,Julio,Honduras,340,1,1,,2,"(12.586067,-81.702563)"
2017,Julio,Honduras,340,11,21,,32,"(3.541112,-76.384584)"
2017,Julio,Honduras,340,84,221,,305,"(4.697144,-74.140516)"
2017,Julio,Honduras,340,3,2,,5,"(4.815061,-75.736532)"
2017,Julio,Honduras,340,30,72,,102,"(6.171601,-75.427454)"
2017,Julio,Honduras,340,1,4,,5,"(7.128456,-73.183637)"
2017,Julio,Hong Kong,344,0,3,,3,"(3.541112,-76.384584)"
2017,Julio,Hong Kong,344,10,16,,26,"(4.697144,-74.140516)"
2017,Julio,Hong Kong,344,3,2,,5,"(6.171601,-75.427454)"
2017,Julio,Hungría,348,0,2,,2,"(3.541112,-76.384584)"
2017,Julio,Hungría,348,6,6,,12,"(4.697144,-74.140516)"
2017,Julio,India,356,1,0,,1,"(10.886611,-74.776708)"
2017,Julio,India,356,4,1,,5,"(3.541112,-76.384584)"
2017,Julio,India,356,24,22,,46,"(4.697144,-74.140516)"
2017,Julio,India,356,0,1,,1,"(4.815061,-75.736532)"
2017,Julio,India,356,0,5,,5,"(6.171601,-75.427454)"
2017,Julio,India,356,0,2,,2,"(7.128456,-73.183637)"
2017,Julio,Indonesia,360,9,14,,23,"(4.697144,-74.140516)"
2017,Julio,Iraq,368,1,5,,6,"(4.697144,-74.140516)"
2017,Julio,Irán,364,2,2,,4,"(4.697144,-74.140516)"
2017,Julio,República de Irlanda,372,13,7,,20,"(4.697144,-74.140516)"
2017,Julio,República de Irlanda,372,0,2,,2,"(6.171601,-75.427454)"
2017,Julio,Islandia,352,2,3,,5,"(4.697144,-74.140516)"
2017,Julio,Islandia,352,2,1,,3,"(6.171601,-75.427454)"
2017,Julio,Israel,376,2,1,,3,"(10.886611,-74.776708)"
2017,Julio,Israel,376,10,11,,21,"(3.541112,-76.384584)"
2017,Julio,Israel,376,67,55,,122,"(4.697144,-74.140516)"
2017,Julio,Israel,376,12,9,,21,"(6.171601,-75.427454)"
2017,Julio,Italia,380,18,5,,23,"(10.445761,-75.516429)"
2017,Julio,Italia,380,17,6,,23,"(10.886611,-74.776708)"
2017,Julio,Italia,380,1,1,,2,"(12.586067,-81.702563)"
2017,Julio,Italia,380,138,87,,225,"(3.541112,-76.384584)"
2017,Julio,Italia,380,691,558,,1249,"(4.697144,-74.140516)"
2017,Julio,Italia,380,5,0,,5,"(4.815061,-75.736532)"
2017,Julio,Italia,380,137,72,,209,"(6.171601,-75.427454)"
2017,Julio,Italia,380,2,1,,3,"(7.128456,-73.183637)"
2017,Julio,Jamaica,388,6,13,,19,"(10.445761,-75.516429)"
2017,Julio,Jamaica,388,5,7,,12,"(10.886611,-74.776708)"
2017,Julio,Jamaica,388,3,2,,5,"(12.586067,-81.702563)"
2017,Julio,Jamaica,388,5,10,,15,"(3.541112,-76.384584)"
2017,Julio,Jamaica,388,27,55,,82,"(4.697144,-74.140516)"
2017,Julio,Jamaica,388,3,4,,7,"(4.815061,-75.736532)"
2017,Julio,Jamaica,388,11,10,,21,"(6.171601,-75.427454)"
2017,Julio,Jamaica,388,2,2,,4,"(7.128456,-73.183637)"
2017,Julio,Japón,392,4,1,,5,"(3.541112,-76.384584)"
2017,Julio,Japón,392,66,63,,129,"(4.697144,-74.140516)"
2017,Julio,Japón,392,7,11,,18,"(6.171601,-75.427454)"
2017,Julio,Jordania,400,2,0,,2,"(3.541112,-76.384584)"
2017,Julio,Jordania,400,0,1,,1,"(4.697144,-74.140516)"
2017,Julio,Kazajistán,398,6,6,,12,"(4.697144,-74.140516)"
2017,Julio,Kenia,404,0,1,,1,"(10.886611,-74.776708)"
2017,Julio,Kenia,404,0,1,,1,"(3.541112,-76.384584)"
2017,Julio,Kenia,404,3,7,,10,"(4.697144,-74.140516)"
2017,Julio,Kenia,404,0,1,,1,"(6.171601,-75.427454)"
2017,Julio,Kuwait,414,3,8,,11,"(4.697144,-74.140516)"
2017,Julio,Kuwait,414,0,1,,1,"(7.128456,-73.183637)"
2017,Julio,Letonia,428,0,1,,1,"(4.697144,-74.140516)"
2017,Julio,Lituania,440,2,3,,5,"(4.697144,-74.140516)"
2017,Julio,Líbano,422,3,4,,7,"(10.886611,-74.776708)"
2017,Julio,Líbano,422,14,20,,34,"(4.697144,-74.140516)"
2017,Julio,Liberia,430,1,0,,1,"(4.697144,-74.140516)"
2017,Julio,Liechtenstein,438,1,0,,1,"(4.697144,-74.140516)"
2017,Julio,Luxemburgo,442,7,4,,11,"(4.697144,-74.140516)"
2017,Julio,Luxemburgo,442,2,2,,4,"(6.171601,-75.427454)"
2017,Julio,Malasia,458,4,4,,8,"(4.697144,-74.140516)"
2017,Julio,Malasia,458,1,1,,2,"(6.171601,-75.427454)"
2017,Julio,Malí,466,0,1,,1,"(4.697144,-74.140516)"
2017,Julio,Malta,470,0,1,,1,"(3.541112,-76.384584)"
2017,Julio,Malta,470,23,13,,36,"(4.697144,-74.140516)"
2017,Julio,Malta,470,2,0,,2,"(6.171601,-75.427454)"
2017,Julio,Marruecos,504,10,7,,17,"(4.697144,-74.140516)"
2017,Julio,Mauritania,478,0,1,,1,"(4.697144,-74.140516)"
2017,Julio,Martinica/Departamento de Ultramar Francés,474,1,0,,1,"(10.886611,-74.776708)"
2017,Julio,México,484,3,1,,4,"(0.814836,-77.662532)"
2017,Julio,México,484,90,82,,172,"(10.445761,-75.516429)"
2017,Julio,México,484,232,186,,418,"(10.886611,-74.776708)"
2017,Julio,México,484,5,4,,9,"(11.117806,-74.232622)"
2017,Julio,México,484,3,3,,6,"(12.586067,-81.702563)"
2017,Julio,México,484,730,564,,1294,"(3.541112,-76.384584)"
2017,Julio,México,484,14750,13537,,28287,"(4.697144,-74.140516)"
2017,Julio,México,484,229,182,,411,"(4.815061,-75.736532)"
2017,Julio,México,484,1838,1588,,3426,"(6.171601,-75.427454)"
2017,Julio,México,484,73,61,,134,"(7.128456,-73.183637)"
2017,Julio,Mónaco,492,7,0,,7,"(4.697144,-74.140516)"
2017,Julio,Mozambique,508,1,0,,1,"(4.697144,-74.140516)"
2017,Julio,Nepal,524,0,2,,2,"(4.697144,-74.140516)"
2017,Julio,Nicaragua,558,3,3,,6,"(10.445761,-75.516429)"
2017,Julio,Nicaragua,558,2,2,,4,"(10.886611,-74.776708)"
2017,Julio,Nicaragua,558,0,2,,2,"(12.586067,-81.702563)"
2017,Julio,Nicaragua,558,21,51,,72,"(3.541112,-76.384584)"
2017,Julio,Nicaragua,558,40,77,,117,"(4.697144,-74.140516)"
2017,Julio,Nicaragua,558,6,7,,13,"(4.815061,-75.736532)"
2017,Julio,Nicaragua,558,21,65,,86,"(6.171601,-75.427454)"
2017,Julio,Nicaragua,558,0,1,,1,"(7.128456,-73.183637)"
2017,Julio,Nigeria,566,0,7,,7,"(4.697144,-74.140516)"
2017,Julio,Noruega,578,2,1,,3,"(10.445761,-75.516429)"
2017,Julio,Noruega,578,2,1,,3,"(10.886611,-74.776708)"
2017,Julio,Noruega,578,7,5,,12,"(3.541112,-76.384584)"
2017,Julio,Noruega,578,39,25,,64,"(4.697144,-74.140516)"
2017,Julio,Noruega,578,5,3,,8,"(6.171601,-75.427454)"
2017,Julio,Nueva Zelanda,554,30,45,,75,"(4.697144,-74.140516)"
2017,Julio,Omán,512,0,1,,1,"(10.445761,-75.516429)"
2017,Julio,Omán,512,1,1,,2,"(3.541112,-76.384584)"
2017,Julio,Omán,512,3,10,,13,"(4.697144,-74.140516)"
2017,Julio,Omán,512,1,1,,2,"(6.171601,-75.427454)"
2017,Julio,Pakistán,586,0,1,,1,"(4.697144,-74.140516)"
2017,Julio,Panamá,591,1,1,,2,"(0.814836,-77.662532)"
2017,Julio,Panamá,591,24,122,,146,"(10.408582,-75.538003)"
2017,Julio,Panamá,591,841,659,,1500,"(10.445761,-75.516429)"
2017,Julio,Panamá,591,803,838,,1641,"(10.886611,-74.776708)"
2017,Julio,Panamá,591,2,17,,19,"(12.5744111,-81.703935)"
2017,Julio,Panamá,591,69,68,,137,"(12.586067,-81.702563)"
2017,Julio,Panamá,591,2287,1835,,4122,"(3.541112,-76.384584)"
2017,Julio,Panamá,591,0,3,,3,"(3.893038,-77.067921)"
2017,Julio,Panamá,591,324,219,,543,"(4.452882,-75.766298)"
2017,Julio,Panamá,591,7830,8583,,16413,"(4.697144,-74.140516)"
2017,Julio,Panamá,591,427,275,,702,"(4.815061,-75.736532)"
2017,Julio,Panamá,591,2914,2741,,5655,"(6.171601,-75.427454)"
2017,Julio,Panamá,591,2,1,,3,"(6.228046,-77.404104)"
2017,Julio,Panamá,591,13,18,,31,"(7.102626,-77.762647)"
2017,Julio,Panamá,591,190,158,,348,"(7.128456,-73.183637)"
2017,Julio,Panamá,591,0,8,,8,"(8.066966,-76.735404)"
2017,Julio,Panamá,591,29,49,,78,"(8.635765,-77.346578)"
2017,Julio,Paraguay,600,3,13,,16,"(10.886611,-74.776708)"
2017,Julio,Paraguay,600,21,21,,42,"(3.541112,-76.384584)"
2017,Julio,Paraguay,600,90,202,,292,"(4.697144,-74.140516)"
2017,Julio,Paraguay,600,5,6,,11,"(4.815061,-75.736532)"
2017,Julio,Paraguay,600,15,16,,31,"(6.171601,-75.427454)"
2017,Julio,Paraguay,600,0,1,,1,"(7.128456,-73.183637)"
2017,Julio,Perú,604,7,7,,14,"(-0.193180,-74.784874)"
2017,Julio,Perú,604,89,131,,220,"(-4.197703,-69.941278)"
2017,Julio,Perú,604,90,85,,175,"(-4.223468,-69.945098)"
2017,Julio,Perú,604,59,75,,134,"(0.814836,-77.662532)"
2017,Julio,Perú,604,25,28,,53,"(10.445761,-75.516429)"
2017,Julio,Perú,604,10,13,,23,"(10.886611,-74.776708)"
2017,Julio,Perú,604,1,1,,2,"(12.586067,-81.702563)"
2017,Julio,Perú,604,96,63,,159,"(3.541112,-76.384584)"
2017,Julio,Perú,604,5357,6131,,11488,"(4.697144,-74.140516)"
2017,Julio,Perú,604,3,1,,4,"(4.815061,-75.736532)"
2017,Julio,Perú,604,127,183,,310,"(6.171601,-75.427454)"
2017,Julio,Perú,604,3,3,,6,"(7.128456,-73.183637)"
2017,Julio,Palestina,99999,1,4,,5,"(4.697144,-74.140516)"
2017,Julio,Polonia,616,0,1,,1,"(10.886611,-74.776708)"
2017,Julio,Polonia,616,2,1,,3,"(3.541112,-76.384584)"
2017,Julio,Polonia,616,28,36,,64,"(4.697144,-74.140516)"
2017,Julio,Polonia,616,2,1,,3,"(6.171601,-75.427454)"
2017,Julio,Portugal,620,5,6,,11,"(10.886611,-74.776708)"
2017,Julio,Portugal,620,3,13,,16,"(3.541112,-76.384584)"
2017,Julio,Portugal,620,69,70,,139,"(4.697144,-74.140516)"
2017,Julio,Portugal,620,0,1,,1,"(4.815061,-75.736532)"
2017,Julio,Portugal,620,22,16,,38,"(6.171601,-75.427454)"
2017,Julio,Puerto Rico/Territorio de Estados Unidos,630,10,25,,35,"(10.445761,-75.516429)"
2017,Julio,Puerto Rico/Territorio de Estados Unidos,630,19,43,,62,"(10.886611,-74.776708)"
2017,Julio,Puerto Rico/Territorio de Estados Unidos,630,117,91,,208,"(3.541112,-76.384584)"
2017,Julio,Puerto Rico/Territorio de Estados Unidos,630,530,463,,993,"(4.697144,-74.140516)"
2017,Julio,Puerto Rico/Territorio de Estados Unidos,630,8,7,,15,"(4.815061,-75.736532)"
2017,Julio,Puerto Rico/Territorio de Estados Unidos,630,53,47,,100,"(6.171601,-75.427454)"
2017,Julio,Puerto Rico/Territorio de Estados Unidos,630,2,3,,5,"(7.128456,-73.183637)"
2017,Julio,Qatar,634,0,1,,1,"(10.445761,-75.516429)"
2017,Julio,Qatar,634,0,1,,1,"(3.541112,-76.384584)"
2017,Julio,Qatar,634,6,10,,16,"(4.697144,-74.140516)"
2017,Julio,Qatar,634,3,2,,5,"(6.171601,-75.427454)"
2017,Julio,Reino Unido de Gran Bretaña e Irlanda del Norte,826,0,1,,1,"(10.445761,-75.516429)"
2017,Julio,Reino Unido de Gran Bretaña e Irlanda del Norte,826,4,3,,7,"(10.886611,-74.776708)"
2017,Julio,Reino Unido de Gran Bretaña e Irlanda del Norte,826,39,23,,62,"(3.541112,-76.384584)"
2017,Julio,Reino Unido de Gran Bretaña e Irlanda del Norte,826,1904,1470,,3374,"(4.697144,-74.140516)"
2017,Julio,Reino Unido de Gran Bretaña e Irlanda del Norte,826,50,31,,81,"(6.171601,-75.427454)"
2017,Julio,Reino Unido de Gran Bretaña e Irlanda del Norte,826,1,0,,1,"(7.128456,-73.183637)"
2017,Julio,República CentroÁfricana,140,6,2,,8,"(4.697144,-74.140516)"
2017,Julio,Federación de Rusia,643,0,1,,1,"(10.445761,-75.516429)"
2017,Julio,Federación de Rusia,643,2,0,,2,"(10.886611,-74.776708)"
2017,Julio,Federación de Rusia,643,0,2,,2,"(3.541112,-76.384584)"
2017,Julio,Federación de Rusia,643,61,52,,113,"(4.697144,-74.140516)"
2017,Julio,Federación de Rusia,643,5,5,,10,"(6.171601,-75.427454)"
2017,Julio,República Dominicana,214,14,17,,31,"(10.445761,-75.516429)"
2017,Julio,República Dominicana,214,50,93,,143,"(10.886611,-74.776708)"
2017,Julio,República Dominicana,214,1,7,,8,"(11.117806,-74.232622)"
2017,Julio,República Dominicana,214,82,68,,150,"(3.541112,-76.384584)"
2017,Julio,República Dominicana,214,2939,2787,,5726,"(4.697144,-74.140516)"
2017,Julio,República Dominicana,214,43,32,,75,"(4.815061,-75.736532)"
2017,Julio,República Dominicana,214,187,168,,355,"(6.171601,-75.427454)"
2017,Julio,República Dominicana,214,15,18,,33,"(7.128456,-73.183637)"
2017,Julio,Reunión,638,1,0,,1,"(4.697144,-74.140516)"
2017,Julio,Rumania,642,1,0,,1,"(3.541112,-76.384584)"
2017,Julio,Rumania,642,6,5,,11,"(4.697144,-74.140516)"
2017,Julio,Rumania,642,0,1,,1,"(6.171601,-75.427454)"
2017,Julio,San  Vicente y las Granadinas,670,0,3,,3,"(4.697144,-74.140516)"
2017,Julio,Senegal,686,2,1,,3,"(4.697144,-74.140516)"
2017,Julio,Senegal,686,0,1,,1,"(7.128456,-73.183637)"
2017,Julio,Serbia,688,1,0,,1,"(10.886611,-74.776708)"
2017,Julio,Serbia,688,0,1,,1,"(4.697144,-74.140516)"
2017,Julio,Singapur,702,1,2,,3,"(10.445761,-75.516429)"
2017,Julio,Singapur,702,13,15,,28,"(4.697144,-74.140516)"
2017,Julio,Singapur,702,2,1,,3,"(6.171601,-75.427454)"
2017,Julio,Sudáfrica,710,17,12,,29,"(4.697144,-74.140516)"
2017,Julio,Sudáfrica,710,1,0,,1,"(6.171601,-75.427454)"
2017,Julio,Suecia,752,4,0,,4,"(10.445761,-75.516429)"
2017,Julio,Suecia,752,5,3,,8,"(10.886611,-74.776708)"
2017,Julio,Suecia,752,17,12,,29,"(3.541112,-76.384584)"
2017,Julio,Suecia,752,104,88,,192,"(4.697144,-74.140516)"
2017,Julio,Suecia,752,2,1,,3,"(4.815061,-75.736532)"
2017,Julio,Suecia,752,24,13,,37,"(6.171601,-75.427454)"
2017,Julio,Suiza,756,2,1,,3,"(0.814836,-77.662532)"
2017,Julio,Suiza,756,7,3,,10,"(10.445761,-75.516429)"
2017,Julio,Suiza,756,10,4,,14,"(10.886611,-74.776708)"
2017,Julio,Suiza,756,61,36,,97,"(3.541112,-76.384584)"
2017,Julio,Suiza,756,272,173,,445,"(4.697144,-74.140516)"
2017,Julio,Suiza,756,65,32,,97,"(6.171601,-75.427454)"
2017,Julio,Surinam,740,1,6,,7,"(4.697144,-74.140516)"
2017,Julio,Surinam,740,1,1,,2,"(6.171601,-75.427454)"
2017,Julio,Surinam,740,0,1,,1,"(7.128456,-73.183637)"
2017,Julio,Taiwán,158,3,3,,6,"(4.697144,-74.140516)"
2017,Julio,Tailandia,764,4,1,,5,"(10.886611,-74.776708)"
2017,Julio,Tailandia,764,0,2,,2,"(3.541112,-76.384584)"
2017,Julio,Tailandia,764,12,12,,24,"(4.697144,-74.140516)"
2017,Julio,Tailandia,764,3,1,,4,"(6.171601,-75.427454)"
2017,Julio,Tanzania,834,2,4,,6,"(4.697144,-74.140516)"
2017,Julio,Trinidad y Tobago,780,0,1,,1,"(10.408582,-75.538003)"
2017,Julio,Trinidad y Tobago,780,2,1,,3,"(10.445761,-75.516429)"
2017,Julio,Trinidad y Tobago,780,2,2,,4,"(10.886611,-74.776708)"
2017,Julio,Trinidad y Tobago,780,5,14,,19,"(3.541112,-76.384584)"
2017,Julio,Trinidad y Tobago,780,18,26,,44,"(4.697144,-74.140516)"
2017,Julio,Trinidad y Tobago,780,1,3,,4,"(4.815061,-75.736532)"
2017,Julio,Trinidad y Tobago,780,4,7,,11,"(6.171601,-75.427454)"
2017,Julio,Trinidad y Tobago,780,4,2,,6,"(7.128456,-73.183637)"
2017,Julio,Túnez,788,3,1,,4,"(4.697144,-74.140516)"
2017,Julio,Turquía,792,1,0,,1,"(10.445761,-75.516429)"
2017,Julio,Turquía,792,2,1,,3,"(3.541112,-76.384584)"
2017,Julio,Turquía,792,271,224,,495,"(4.697144,-74.140516)"
2017,Julio,Turquía,792,4,1,,5,"(6.171601,-75.427454)"
2017,Julio,Turkmenistán,795,2,1,,3,"(4.697144,-74.140516)"
2017,Julio,Ucrania,804,1,2,,3,"(4.697144,-74.140516)"
2017,Julio,Ucrania,804,0,1,,1,"(6.171601,-75.427454)"
2017,Julio,Uganda,800,0,2,,2,"(10.886611,-74.776708)"
2017,Julio,Uganda,800,0,1,,1,"(4.697144,-74.140516)"
2017,Julio,Uruguay,858,0,1,,1,"(0.814836,-77.662532)"
2017,Julio,Uruguay,858,15,21,,36,"(10.886611,-74.776708)"
2017,Julio,Uruguay,858,15,17,,32,"(3.541112,-76.384584)"
2017,Julio,Uruguay,858,309,324,,633,"(4.697144,-74.140516)"
2017,Julio,Uruguay,858,3,3,,6,"(4.815061,-75.736532)"
2017,Julio,Uruguay,858,18,23,,41,"(6.171601,-75.427454)"
2017,Julio,Venezuela,862,0,8,,8,"(10.408582,-75.538003)"
2017,Julio,Venezuela,862,4,1,,5,"(10.445761,-75.516429)"
2017,Julio,Venezuela,862,10,23,,33,"(10.886611,-74.776708)"
2017,Julio,Venezuela,862,0,11,,11,"(10.971302,-74.765397)"
2017,Julio,Venezuela,862,0,21,,21,"(11.247723,-74.213989)"
2017,Julio,Venezuela,862,1892,1994,,3886,"(11.360009,-72.129330)"
2017,Julio,Venezuela,862,1,2,,3,"(12.586067,-81.702563)"
2017,Julio,Venezuela,862,3,8,,11,"(3.541112,-76.384584)"
2017,Julio,Venezuela,862,5,6,,11,"(3.866713,-67.927521)"
2017,Julio,Venezuela,862,1042,1006,,2048,"(4.697144,-74.140516)"
2017,Julio,Venezuela,862,1,0,,1,"(4.815061,-75.736532)"
2017,Julio,Venezuela,862,433,355,,788,"(6.171601,-75.427454)"
2017,Julio,Venezuela,862,64,80,,144,"(6.185799,-67.483929)"
2017,Julio,Venezuela,862,535,566,,1101,"(7.088729,-70.740253)"
2017,Julio,Venezuela,862,5,2,,7,"(7.128456,-73.183637)"
2017,Julio,Venezuela,862,1468,1419,,2887,"(7.818934,-72.453226)"
2017,Julio,Venezuela,862,89,130,,219,"(8.36068,-72.409396)"
2017,Julio,Vietnam,704,5,2,,7,"(4.697144,-74.140516)"
2017,Julio,Islas Vírgenes Británicas/Territorio Británico de Ultramar,92,3,8,,11,"(4.697144,-74.140516)"
2017,Julio,Islas Vírgenes Británicas/Territorio Británico de Ultramar,92,0,1,,1,"(6.171601,-75.427454)"
2017,Agosto,Afganistán,4,1,5,,6,"(4.697144,-74.140516)"
2017,Agosto,Albania,8,0,1,,1,"(3.541112,-76.384584)"
2017,Agosto,Albania,8,0,3,,3,"(4.697144,-74.140516)"
2017,Agosto,Alemania,276,3,2,,5,"(10.445761,-75.516429)"
2017,Agosto,Alemania,276,11,6,,17,"(10.886611,-74.776708)"
2017,Agosto,Alemania,276,1,0,,1,"(12.586067,-81.702563)"
2017,Agosto,Alemania,276,45,35,,80,"(3.541112,-76.384584)"
2017,Agosto,Alemania,276,1238,926,,2164,"(4.697144,-74.140516)"
2017,Agosto,Alemania,276,56,38,,94,"(6.171601,-75.427454)"
2017,Agosto,Andorra,20,1,1,,2,"(4.697144,-74.140516)"
2017,Agosto,Angola,24,1,11,,12,"(4.697144,-74.140516)"
2017,Agosto,Antigua y Barbuda,28,3,1,,4,"(4.697144,-74.140516)"
2017,Agosto,Países Bajos,528,116,75,,191,"(10.445761,-75.516429)"
2017,Agosto,Países Bajos,528,45,27,,72,"(10.886611,-74.776708)"
2017,Agosto,Países Bajos,528,70,47,,117,"(3.541112,-76.384584)"
2017,Agosto,Países Bajos,528,1132,959,,2091,"(4.697144,-74.140516)"
2017,Agosto,Países Bajos,528,6,4,,10,"(4.815061,-75.736532)"
2017,Agosto,Países Bajos,528,135,80,,215,"(6.171601,-75.427454)"
2017,Agosto,Países Bajos,528,2,3,,5,"(7.128456,-73.183637)"
2017,Agosto,Arabia Saudita,682,2,3,,5,"(3.541112,-76.384584)"
2017,Agosto,Arabia Saudita,682,36,51,,87,"(4.697144,-74.140516)"
2017,Agosto,Arabia Saudita,682,1,0,,1,"(4.815061,-75.736532)"
2017,Agosto,Arabia Saudita,682,2,2,,4,"(6.171601,-75.427454)"
2017,Agosto,Argelia,12,6,8,,14,"(4.697144,-74.140516)"
2017,Agosto,Argentina,32,7,16,,23,"(0.814836,-77.662532)"
2017,Agosto,Argentina,32,14,11,,25,"(10.445761,-75.516429)"
2017,Agosto,Argentina,32,21,9,,30,"(10.886611,-74.776708)"
2017,Agosto,Argentina,32,1,0,,1,"(12.586067,-81.702563)"
2017,Agosto,Argentina,32,100,105,,205,"(3.541112,-76.384584)"
2017,Agosto,Argentina,32,2928,3007,,5935,"(4.697144,-74.140516)"
2017,Agosto,Argentina,32,24,35,,59,"(4.815061,-75.736532)"
2017,Agosto,Argentina,32,67,76,,143,"(6.171601,-75.427454)"
2017,Agosto,Argentina,32,2,2,,4,"(7.128456,-73.183637)"
2017,Agosto,República de Armenia,51,0,1,,1,"(4.697144,-74.140516)"
2017,Agosto,Aruba,533,1380,1001,,2381,"(10.408582,-75.538003)"
2017,Agosto,Aruba,533,3,1,,4,"(10.445761,-75.516429)"
2017,Agosto,Aruba,533,14,15,,29,"(10.886611,-74.776708)"
2017,Agosto,Aruba,533,0,3,,3,"(10.971302,-74.765397)"
2017,Agosto,Aruba,533,45,29,,74,"(3.541112,-76.384584)"
2017,Agosto,Aruba,533,2474,1904,,4378,"(4.697144,-74.140516)"
2017,Agosto,Aruba,533,12,13,,25,"(4.815061,-75.736532)"
2017,Agosto,Aruba,533,84,53,,137,"(6.171601,-75.427454)"
2017,Agosto,Aruba,533,9,44,,53,"(7.128456,-73.183637)"
2017,Agosto,Australia,36,2,4,,6,"(10.886611,-74.776708)"
2017,Agosto,Australia,36,12,10,,22,"(3.541112,-76.384584)"
2017,Agosto,Australia,36,359,244,,603,"(4.697144,-74.140516)"
2017,Agosto,Australia,36,19,15,,34,"(6.171601,-75.427454)"
2017,Agosto,Australia,36,1,1,,2,"(7.128456,-73.183637)"
2017,Agosto,Austria,40,4,2,,6,"(10.886611,-74.776708)"
2017,Agosto,Austria,40,2,1,,3,"(3.541112,-76.384584)"
2017,Agosto,Austria,40,49,39,,88,"(4.697144,-74.140516)"
2017,Agosto,Austria,40,1,5,,6,"(6.171601,-75.427454)"
2017,Agosto,Azerbaiyán,31,6,13,,19,"(4.697144,-74.140516)"
2017,Agosto,Bahamas,44,3,0,,3,"(10.445761,-75.516429)"
2017,Agosto,Bahamas,44,1,0,,1,"(10.886611,-74.776708)"
2017,Agosto,Bahamas,44,14,7,,21,"(3.541112,-76.384584)"
2017,Agosto,Bahamas,44,9,10,,19,"(4.697144,-74.140516)"
2017,Agosto,Bahamas,44,5,7,,12,"(4.815061,-75.736532)"
2017,Agosto,Bahamas,44,21,12,,33,"(6.171601,-75.427454)"
2017,Agosto,Bahréin,48,2,1,,3,"(3.541112,-76.384584)"
2017,Agosto,Bangladesh,50,1,2,,3,"(4.697144,-74.140516)"
2017,Agosto,Bangladesh,50,0,2,,2,"(6.171601,-75.427454)"
2017,Agosto,Barbados,52,3,9,,12,"(3.541112,-76.384584)"
2017,Agosto,Barbados,52,2,6,,8,"(4.697144,-74.140516)"
2017,Agosto,Barbados,52,2,1,,3,"(6.171601,-75.427454)"
2017,Agosto,República de Belarús,112,0,2,,2,"(7.818934,-72.453226)"
2017,Agosto,Bélgica,56,4,1,,5,"(10.886611,-74.776708)"
2017,Agosto,Bélgica,56,39,17,,56,"(3.541112,-76.384584)"
2017,Agosto,Bélgica,56,143,88,,231,"(4.697144,-74.140516)"
2017,Agosto,Bélgica,56,0,1,,1,"(4.815061,-75.736532)"
2017,Agosto,Bélgica,56,32,25,,57,"(6.171601,-75.427454)"
2017,Agosto,Belice,84,1,0,,1,"(10.445761,-75.516429)"
2017,Agosto,Belice,84,1,0,,1,"(12.586067,-81.702563)"
2017,Agosto,Belice,84,1,0,,1,"(3.541112,-76.384584)"
2017,Agosto,Belice,84,10,6,,16,"(4.697144,-74.140516)"
2017,Agosto,Belice,84,3,6,,9,"(6.171601,-75.427454)"
2017,Agosto,Bermudas/Territorio Británico de Ultramar,60,1,0,,1,"(3.541112,-76.384584)"
2017,Agosto,Bermudas/Territorio Británico de Ultramar,60,1,3,,4,"(4.697144,-74.140516)"
2017,Agosto,Bermudas/Territorio Británico de Ultramar,60,0,2,,2,"(6.171601,-75.427454)"
2017,Agosto,Bolivia,68,1,8,,9,"(0.814836,-77.662532)"
2017,Agosto,Bolivia,68,1,1,,2,"(10.445761,-75.516429)"
2017,Agosto,Bolivia,68,1,2,,3,"(10.886611,-74.776708)"
2017,Agosto,Bolivia,68,20,41,,61,"(3.541112,-76.384584)"
2017,Agosto,Bolivia,68,319,474,,793,"(4.697144,-74.140516)"
2017,Agosto,Bolivia,68,3,1,,4,"(4.815061,-75.736532)"
2017,Agosto,Bolivia,68,9,28,,37,"(6.171601,-75.427454)"
2017,Agosto,Bolivia,68,1,0,,1,"(7.128456,-73.183637)"
2017,Agosto,Bosnia y Herzegovina,70,4,1,,5,"(4.697144,-74.140516)"
2017,Agosto,Brasil,76,147,249,,396,"(-4.197703,-69.941278)"
2017,Agosto,Brasil,76,2,1,,3,"(0.814836,-77.662532)"
2017,Agosto,Brasil,76,15,23,,38,"(10.445761,-75.516429)"
2017,Agosto,Brasil,76,12,7,,19,"(10.886611,-74.776708)"
2017,Agosto,Brasil,76,84,103,,187,"(3.541112,-76.384584)"
2017,Agosto,Brasil,76,0,1,,1,"(3.866713,-67.927521)"
2017,Agosto,Brasil,76,3429,4378,,7807,"(4.697144,-74.140516)"
2017,Agosto,Brasil,76,19,36,,55,"(4.815061,-75.736532)"
2017,Agosto,Brasil,76,128,172,,300,"(6.171601,-75.427454)"
2017,Agosto,Brasil,76,8,5,,13,"(7.128456,-73.183637)"
2017,Agosto,Bulgaria,100,6,6,,12,"(4.697144,-74.140516)"
2017,Agosto,Islas Caimán/Territorio Británico de Ultramar,136,4,0,,4,"(12.586067,-81.702563)"
2017,Agosto,Islas Caimán/Territorio Británico de Ultramar,136,2,2,,4,"(4.697144,-74.140516)"
2017,Agosto,Camboya,116,2,1,,3,"(4.697144,-74.140516)"
2017,Agosto,Camerún,120,1,5,,6,"(4.697144,-74.140516)"
2017,Agosto,Canadá,124,35,30,,65,"(10.445761,-75.516429)"
2017,Agosto,Canadá,124,116,71,,187,"(10.886611,-74.776708)"
2017,Agosto,Canadá,124,2,2,,4,"(12.586067,-81.702563)"
2017,Agosto,Canadá,124,180,123,,303,"(3.541112,-76.384584)"
2017,Agosto,Canadá,124,2506,2010,,4516,"(4.697144,-74.140516)"
2017,Agosto,Canadá,124,13,13,,26,"(4.815061,-75.736532)"
2017,Agosto,Canadá,124,321,203,,524,"(6.171601,-75.427454)"
2017,Agosto,Canadá,124,20,10,,30,"(7.128456,-73.183637)"
2017,Agosto,España,724,3,8,,11,"(10.445761,-75.516429)"
2017,Agosto,España,724,55,31,,86,"(10.886611,-74.776708)"
2017,Agosto,España,724,2683,1779,,4462,"(3.541112,-76.384584)"
2017,Agosto,España,724,11308,7871,,19179,"(4.697144,-74.140516)"
2017,Agosto,España,724,6,3,,9,"(4.815061,-75.736532)"
2017,Agosto,España,724,2194,1500,,3694,"(6.171601,-75.427454)"
2017,Agosto,España,724,3,4,,7,"(7.128456,-73.183637)"
2017,Agosto,Colombia,170,2,8,,10,"(10.445761,-75.516429)"
2017,Agosto,Colombia,170,165,526,,691,"(4.697144,-74.140516)"
2017,Agosto,Colombia,170,187,189,,376,"(6.171601,-75.427454)"
2017,Agosto,República de Corea,410,0,1,,1,"(3.541112,-76.384584)"
2017,Agosto,República de Corea,410,30,18,,48,"(4.697144,-74.140516)"
2017,Agosto,República de Corea,410,1,4,,5,"(6.171601,-75.427454)"
2017,Agosto,Costa de Marfil,384,0,1,,1,"(3.541112,-76.384584)"
2017,Agosto,Costa de Marfil,384,6,9,,15,"(4.697144,-74.140516)"
2017,Agosto,Costa Rica,188,8,10,,18,"(10.445761,-75.516429)"
2017,Agosto,Costa Rica,188,15,27,,42,"(10.886611,-74.776708)"
2017,Agosto,Costa Rica,188,0,1,,1,"(11.117806,-74.232622)"
2017,Agosto,Costa Rica,188,5,46,,51,"(12.5744111,-81.703935)"
2017,Agosto,Costa Rica,188,3,2,,5,"(12.586067,-81.702563)"
2017,Agosto,Costa Rica,188,36,28,,64,"(3.541112,-76.384584)"
2017,Agosto,Costa Rica,188,1112,1337,,2449,"(4.697144,-74.140516)"
2017,Agosto,Costa Rica,188,8,8,,16,"(4.815061,-75.736532)"
2017,Agosto,Costa Rica,188,99,99,,198,"(6.171601,-75.427454)"
2017,Agosto,Costa Rica,188,7,3,,10,"(7.128456,-73.183637)"
2017,Agosto,Croacia,191,1,1,,2,"(3.541112,-76.384584)"
2017,Agosto,Croacia,191,5,2,,7,"(4.697144,-74.140516)"
2017,Agosto,Cuba,192,7,9,,16,"(10.445761,-75.516429)"
2017,Agosto,Cuba,192,23,10,,33,"(10.886611,-74.776708)"
2017,Agosto,Cuba,192,1,0,,1,"(12.586067,-81.702563)"
2017,Agosto,Cuba,192,67,59,,126,"(3.541112,-76.384584)"
2017,Agosto,Cuba,192,1572,1254,,2826,"(4.697144,-74.140516)"
2017,Agosto,Cuba,192,27,22,,49,"(4.815061,-75.736532)"
2017,Agosto,Cuba,192,91,69,,160,"(6.171601,-75.427454)"
2017,Agosto,Cuba,192,29,15,,44,"(7.128456,-73.183637)"
2017,Agosto,Curazao,99999,9,38,,47,"(4.697144,-74.140516)"
2017,Agosto,República Checa,203,1,1,,2,"(3.541112,-76.384584)"
2017,Agosto,República Checa,203,10,13,,23,"(4.697144,-74.140516)"
2017,Agosto,República Checa,203,0,1,,1,"(6.171601,-75.427454)"
2017,Agosto,Chile,152,0,1,,1,"(0.25129,-76.875963)"
2017,Agosto,Chile,152,191,193,,384,"(0.814836,-77.662532)"
2017,Agosto,Chile,152,1,0,,1,"(1.813928,-78.763924)"
2017,Agosto,Chile,152,18,9,,27,"(10.445761,-75.516429)"
2017,Agosto,Chile,152,22,20,,42,"(10.886611,-74.776708)"
2017,Agosto,Chile,152,1,2,,3,"(12.586067,-81.702563)"
2017,Agosto,Chile,152,226,161,,387,"(3.541112,-76.384584)"
2017,Agosto,Chile,152,4710,4228,,8938,"(4.697144,-74.140516)"
2017,Agosto,Chile,152,86,54,,140,"(4.815061,-75.736532)"
2017,Agosto,Chile,152,64,51,,115,"(6.171601,-75.427454)"
2017,Agosto,Chile,152,4,6,,10,"(7.128456,-73.183637)"
2017,Agosto,China,156,2,1,,3,"(10.445761,-75.516429)"
2017,Agosto,China,156,4,4,,8,"(10.886611,-74.776708)"
2017,Agosto,China,156,10,19,,29,"(3.541112,-76.384584)"
2017,Agosto,China,156,201,520,,721,"(4.697144,-74.140516)"
2017,Agosto,China,156,1,0,,1,"(4.815061,-75.736532)"
2017,Agosto,China,156,25,44,,69,"(6.171601,-75.427454)"
2017,Agosto,China,156,1,1,,2,"(7.128456,-73.183637)"
2017,Agosto,Chipre,196,2,1,,3,"(4.697144,-74.140516)"
2017,Agosto,Dinamarca,208,1,2,,3,"(10.445761,-75.516429)"
2017,Agosto,Dinamarca,208,1,1,,2,"(10.886611,-74.776708)"
2017,Agosto,Dinamarca,208,1,0,,1,"(3.541112,-76.384584)"
2017,Agosto,Dinamarca,208,34,39,,73,"(4.697144,-74.140516)"
2017,Agosto,Dinamarca,208,3,1,,4,"(6.171601,-75.427454)"
2017,Agosto,Dinamarca,208,2,0,,2,"(7.128456,-73.183637)"
2017,Agosto,Dominica,212,1,0,,1,"(4.697144,-74.140516)"
2017,Agosto,Ecuador,218,3,5,,8,"(-0.193180,-74.784874)"
2017,Agosto,Ecuador,218,491,797,,1288,"(0.25129,-76.875963)"
2017,Agosto,Ecuador,218,14,28,,42,"(0.812436,-77.847006)"
2017,Agosto,Ecuador,218,6132,6926,,13058,"(0.814836,-77.662532)"
2017,Agosto,Ecuador,218,168,166,,334,"(1.813928,-78.763924)"
2017,Agosto,Ecuador,218,2,1,,3,"(10.445761,-75.516429)"
2017,Agosto,Ecuador,218,6,14,,20,"(10.886611,-74.776708)"
2017,Agosto,Ecuador,218,298,344,,642,"(3.541112,-76.384584)"
2017,Agosto,Ecuador,218,0,7,,7,"(3.893038,-77.067921)"
2017,Agosto,Ecuador,218,2372,3698,,6070,"(4.697144,-74.140516)"
2017,Agosto,Ecuador,218,1,2,,3,"(4.815061,-75.736532)"
2017,Agosto,Ecuador,218,13,37,,50,"(6.171601,-75.427454)"
2017,Agosto,Ecuador,218,1,3,,4,"(7.128456,-73.183637)"
2017,Agosto,Egipto,818,1,2,,3,"(10.886611,-74.776708)"
2017,Agosto,Egipto,818,1,0,,1,"(3.541112,-76.384584)"
2017,Agosto,Egipto,818,23,10,,33,"(4.697144,-74.140516)"
2017,Agosto,Egipto,818,1,0,,1,"(4.815061,-75.736532)"
2017,Agosto,El Salvador,222,1,0,,1,"(10.445761,-75.516429)"
2017,Agosto,El Salvador,222,0,4,,4,"(10.886611,-74.776708)"
2017,Agosto,El Salvador,222,1,0,,1,"(12.586067,-81.702563)"
2017,Agosto,El Salvador,222,111,107,,218,"(3.541112,-76.384584)"
2017,Agosto,El Salvador,222,724,930,,1654,"(4.697144,-74.140516)"
2017,Agosto,El Salvador,222,1,1,,2,"(4.815061,-75.736532)"
2017,Agosto,El Salvador,222,245,241,,486,"(6.171601,-75.427454)"
2017,Agosto,Emiratos Árabes,784,1,0,,1,"(10.445761,-75.516429)"
2017,Agosto,Emiratos Árabes,784,0,1,,1,"(10.886611,-74.776708)"
2017,Agosto,Emiratos Árabes,784,16,3,,19,"(3.541112,-76.384584)"
2017,Agosto,Emiratos Árabes,784,142,262,,404,"(4.697144,-74.140516)"
2017,Agosto,Emiratos Árabes,784,13,11,,24,"(6.171601,-75.427454)"
2017,Agosto,Eritrea,232,2,1,,3,"(4.697144,-74.140516)"
2017,Agosto,Eslovaquia,703,0,1,,1,"(10.445761,-75.516429)"
2017,Agosto,Eslovaquia,703,4,3,,7,"(4.697144,-74.140516)"
2017,Agosto,Eslovenia,705,3,2,,5,"(4.697144,-74.140516)"
2017,Agosto,Estados Unidos de América,840,3727,2929,,6656,"(10.445761,-75.516429)"
2017,Agosto,Estados Unidos de América,840,3735,2707,,6442,"(10.886611,-74.776708)"
2017,Agosto,Estados Unidos de América,840,111,51,,162,"(12.586067,-81.702563)"
2017,Agosto,Estados Unidos de América,840,6737,4516,,11253,"(3.541112,-76.384584)"
2017,Agosto,Estados Unidos de América,840,957,667,,1624,"(4.452882,-75.766298)"
2017,Agosto,Estados Unidos de América,840,33713,27385,,61098,"(4.697144,-74.140516)"
2017,Agosto,Estados Unidos de América,840,1145,756,,1901,"(4.815061,-75.736532)"
2017,Agosto,Estados Unidos de América,840,11651,8715,,20366,"(6.171601,-75.427454)"
2017,Agosto,Estados Unidos de América,840,281,186,,467,"(7.128456,-73.183637)"
2017,Agosto,Estonia,233,2,2,,4,"(4.697144,-74.140516)"
2017,Agosto,Etiopia,231,3,3,,6,"(4.697144,-74.140516)"
2017,Agosto,Etiopia,231,0,1,,1,"(6.171601,-75.427454)"
2017,Agosto,Filipinas,608,1,0,,1,"(10.886611,-74.776708)"
2017,Agosto,Filipinas,608,0,1,,1,"(3.541112,-76.384584)"
2017,Agosto,Filipinas,608,2,1,,3,"(4.697144,-74.140516)"
2017,Agosto,Finlandia,246,1,0,,1,"(10.886611,-74.776708)"
2017,Agosto,Finlandia,246,2,0,,2,"(3.541112,-76.384584)"
2017,Agosto,Finlandia,246,13,14,,27,"(4.697144,-74.140516)"
2017,Agosto,Finlandia,246,2,4,,6,"(6.171601,-75.427454)"
2017,Agosto,Finlandia,246,1,0,,1,"(7.128456,-73.183637)"
2017,Agosto,Francia,250,11,6,,17,"(10.445761,-75.516429)"
2017,Agosto,Francia,250,30,11,,41,"(10.886611,-74.776708)"
2017,Agosto,Francia,250,1,0,,1,"(12.586067,-81.702563)"
2017,Agosto,Francia,250,154,95,,249,"(3.541112,-76.384584)"
2017,Agosto,Francia,250,2067,1415,,3482,"(4.697144,-74.140516)"
2017,Agosto,Francia,250,18,14,,32,"(4.815061,-75.736532)"
2017,Agosto,Francia,250,136,95,,231,"(6.171601,-75.427454)"
2017,Agosto,Francia,250,3,2,,5,"(7.128456,-73.183637)"
2017,Agosto,Gabón,266,1,1,,2,"(4.697144,-74.140516)"
2017,Agosto,Gambia,270,1,0,,1,"(4.697144,-74.140516)"
2017,Agosto,Georgia,268,0,1,,1,"(4.697144,-74.140516)"
2017,Agosto,Ghana,288,0,1,,1,"(4.697144,-74.140516)"
2017,Agosto,Ghana,288,0,2,,2,"(6.171601,-75.427454)"
2017,Agosto,Gibraltar/Territorio Británico de Ultramar,292,0,1,,1,"(0.814836,-77.662532)"
2017,Agosto,Granada,308,0,1,,1,"(4.697144,-74.140516)"
2017,Agosto,Grecia,300,5,2,,7,"(3.541112,-76.384584)"
2017,Agosto,Grecia,300,39,34,,73,"(4.697144,-74.140516)"
2017,Agosto,Grecia,300,1,0,,1,"(4.815061,-75.736532)"
2017,Agosto,Grecia,300,7,4,,11,"(6.171601,-75.427454)"
2017,Agosto,Guatemala,320,4,0,,4,"(10.445761,-75.516429)"
2017,Agosto,Guatemala,320,2,9,,11,"(10.886611,-74.776708)"
2017,Agosto,Guatemala,320,1,0,,1,"(12.586067,-81.702563)"
2017,Agosto,Guatemala,320,52,78,,130,"(3.541112,-76.384584)"
2017,Agosto,Guatemala,320,541,675,,1216,"(4.697144,-74.140516)"
2017,Agosto,Guatemala,320,11,16,,27,"(4.815061,-75.736532)"
2017,Agosto,Guatemala,320,83,106,,189,"(6.171601,-75.427454)"
2017,Agosto,Guatemala,320,3,5,,8,"(7.128456,-73.183637)"
2017,Agosto,Guyana,328,2,3,,5,"(10.886611,-74.776708)"
2017,Agosto,Guyana,328,4,5,,9,"(4.697144,-74.140516)"
2017,Agosto,Guyana,328,1,0,,1,"(6.171601,-75.427454)"
2017,Agosto,Guinea,324,0,1,,1,"(4.697144,-74.140516)"
2017,Agosto,Guinea Ecuatorial,226,1,0,,1,"(3.541112,-76.384584)"
2017,Agosto,Guinea Ecuatorial,226,3,0,,3,"(4.697144,-74.140516)"
2017,Agosto,Guinea Bissau,624,1,0,,1,"(6.171601,-75.427454)"
2017,Agosto,Guadalupe/Territorio Francés,312,0,2,,2,"(4.697144,-74.140516)"
2017,Agosto,Guayana Francesa/Departamento de Ultramar Francés,254,2,2,,4,"(4.697144,-74.140516)"
2017,Agosto,Haití,332,0,1,,1,"(10.886611,-74.776708)"
2017,Agosto,Haití,332,1,1,,2,"(3.541112,-76.384584)"
2017,Agosto,Haití,332,2,9,,11,"(4.697144,-74.140516)"
2017,Agosto,Haití,332,1,0,,1,"(4.815061,-75.736532)"
2017,Agosto,Haití,332,1,2,,3,"(6.171601,-75.427454)"
2017,Agosto,Haití,332,0,1,,1,"(7.128456,-73.183637)"
2017,Agosto,Honduras,340,0,1,,1,"(10.408582,-75.538003)"
2017,Agosto,Honduras,340,0,4,,4,"(10.445761,-75.516429)"
2017,Agosto,Honduras,340,3,14,,17,"(10.886611,-74.776708)"
2017,Agosto,Honduras,340,16,36,,52,"(3.541112,-76.384584)"
2017,Agosto,Honduras,340,98,198,,296,"(4.697144,-74.140516)"
2017,Agosto,Honduras,340,1,3,,4,"(4.815061,-75.736532)"
2017,Agosto,Honduras,340,40,76,,116,"(6.171601,-75.427454)"
2017,Agosto,Honduras,340,2,5,,7,"(7.128456,-73.183637)"
2017,Agosto,Hong Kong,344,1,0,,1,"(3.541112,-76.384584)"
2017,Agosto,Hong Kong,344,18,17,,35,"(4.697144,-74.140516)"
2017,Agosto,Hong Kong,344,3,1,,4,"(6.171601,-75.427454)"
2017,Agosto,Hungría,348,1,0,,1,"(3.541112,-76.384584)"
2017,Agosto,Hungría,348,14,17,,31,"(4.697144,-74.140516)"
2017,Agosto,Hungría,348,10,9,,19,"(6.171601,-75.427454)"
2017,Agosto,India,356,0,1,,1,"(10.886611,-74.776708)"
2017,Agosto,India,356,1,5,,6,"(3.541112,-76.384584)"
2017,Agosto,India,356,35,31,,66,"(4.697144,-74.140516)"
2017,Agosto,India,356,0,1,,1,"(4.815061,-75.736532)"
2017,Agosto,India,356,2,4,,6,"(6.171601,-75.427454)"
2017,Agosto,Indonesia,360,5,6,,11,"(4.697144,-74.140516)"
2017,Agosto,Indonesia,360,0,1,,1,"(6.171601,-75.427454)"
2017,Agosto,Iraq,368,0,6,,6,"(4.697144,-74.140516)"
2017,Agosto,Iraq,368,0,1,,1,"(6.171601,-75.427454)"
2017,Agosto,Irán,364,1,0,,1,"(4.697144,-74.140516)"
2017,Agosto,Irán,364,2,0,,2,"(4.815061,-75.736532)"
2017,Agosto,República de Irlanda,372,1,1,,2,"(3.541112,-76.384584)"
2017,Agosto,República de Irlanda,372,9,8,,17,"(4.697144,-74.140516)"
2017,Agosto,República de Irlanda,372,4,2,,6,"(6.171601,-75.427454)"
2017,Agosto,Islandia,352,5,1,,6,"(4.697144,-74.140516)"
2017,Agosto,Israel,376,2,1,,3,"(10.886611,-74.776708)"
2017,Agosto,Israel,376,9,5,,14,"(3.541112,-76.384584)"
2017,Agosto,Israel,376,115,84,,199,"(4.697144,-74.140516)"
2017,Agosto,Israel,376,6,0,,6,"(6.171601,-75.427454)"
2017,Agosto,Israel,376,0,1,,1,"(7.128456,-73.183637)"
2017,Agosto,Italia,380,7,3,,10,"(10.445761,-75.516429)"
2017,Agosto,Italia,380,13,7,,20,"(10.886611,-74.776708)"
2017,Agosto,Italia,380,0,1,,1,"(12.586067,-81.702563)"
2017,Agosto,Italia,380,85,36,,121,"(3.541112,-76.384584)"
2017,Agosto,Italia,380,601,343,,944,"(4.697144,-74.140516)"
2017,Agosto,Italia,380,2,1,,3,"(4.815061,-75.736532)"
2017,Agosto,Italia,380,84,52,,136,"(6.171601,-75.427454)"
2017,Agosto,Jamaica,388,0,3,,3,"(10.445761,-75.516429)"
2017,Agosto,Jamaica,388,2,4,,6,"(10.886611,-74.776708)"
2017,Agosto,Jamaica,388,0,1,,1,"(12.586067,-81.702563)"
2017,Agosto,Jamaica,388,7,8,,15,"(3.541112,-76.384584)"
2017,Agosto,Jamaica,388,16,19,,35,"(4.697144,-74.140516)"
2017,Agosto,Jamaica,388,1,1,,2,"(4.815061,-75.736532)"
2017,Agosto,Jamaica,388,17,11,,28,"(6.171601,-75.427454)"
2017,Agosto,Jamaica,388,9,16,,25,"(7.128456,-73.183637)"
2017,Agosto,Japón,392,1,1,,2,"(10.886611,-74.776708)"
2017,Agosto,Japón,392,0,3,,3,"(3.541112,-76.384584)"
2017,Agosto,Japón,392,80,72,,152,"(4.697144,-74.140516)"
2017,Agosto,Japón,392,3,5,,8,"(6.171601,-75.427454)"
2017,Agosto,Jordania,400,1,1,,2,"(10.886611,-74.776708)"
2017,Agosto,Jordania,400,2,5,,7,"(4.697144,-74.140516)"
2017,Agosto,Kazajistán,398,0,1,,1,"(3.541112,-76.384584)"
2017,Agosto,Kazajistán,398,3,2,,5,"(4.697144,-74.140516)"
2017,Agosto,Kenia,404,8,4,,12,"(4.697144,-74.140516)"
2017,Agosto,Kuwait,414,0,1,,1,"(3.541112,-76.384584)"
2017,Agosto,Kuwait,414,2,3,,5,"(4.697144,-74.140516)"
2017,Agosto,Kuwait,414,2,1,,3,"(6.171601,-75.427454)"
2017,Agosto,República de Kosovo,901,0,1,,1,"(4.697144,-74.140516)"
2017,Agosto,Letonia,428,0,1,,1,"(4.697144,-74.140516)"
2017,Agosto,Lituania,440,0,2,,2,"(4.697144,-74.140516)"
2017,Agosto,Líbano,422,2,1,,3,"(10.886611,-74.776708)"
2017,Agosto,Líbano,422,17,19,,36,"(4.697144,-74.140516)"
2017,Agosto,Líbano,422,0,2,,2,"(7.128456,-73.183637)"
2017,Agosto,Liechtenstein,438,2,0,,2,"(10.886611,-74.776708)"
2017,Agosto,Luxemburgo,442,8,8,,16,"(4.697144,-74.140516)"
2017,Agosto,Luxemburgo,442,1,1,,2,"(4.815061,-75.736532)"
2017,Agosto,Luxemburgo,442,2,1,,3,"(6.171601,-75.427454)"
2017,Agosto,Madagascar,450,0,1,,1,"(4.697144,-74.140516)"
2017,Agosto,Malasia,458,1,2,,3,"(4.697144,-74.140516)"
2017,Agosto,Malawi,454,0,1,,1,"(4.697144,-74.140516)"
2017,Agosto,Malí,466,0,1,,1,"(3.541112,-76.384584)"
2017,Agosto,Malta,470,0,1,,1,"(3.541112,-76.384584)"
2017,Agosto,Malta,470,12,9,,21,"(4.697144,-74.140516)"
2017,Agosto,Malta,470,1,1,,2,"(6.171601,-75.427454)"
2017,Agosto,Marruecos,504,6,9,,15,"(4.697144,-74.140516)"
2017,Agosto,Mauritania,478,0,1,,1,"(4.697144,-74.140516)"
2017,Agosto,Martinica/Departamento de Ultramar Francés,474,1,0,,1,"(10.886611,-74.776708)"
2017,Agosto,Martinica/Departamento de Ultramar Francés,474,1,0,,1,"(3.541112,-76.384584)"
2017,Agosto,México,484,70,45,,115,"(10.445761,-75.516429)"
2017,Agosto,México,484,222,161,,383,"(10.886611,-74.776708)"
2017,Agosto,México,484,11,7,,18,"(12.586067,-81.702563)"
2017,Agosto,México,484,931,775,,1706,"(3.541112,-76.384584)"
2017,Agosto,México,484,15532,13631,,29163,"(4.697144,-74.140516)"
2017,Agosto,México,484,281,196,,477,"(4.815061,-75.736532)"
2017,Agosto,México,484,2341,1744,,4085,"(6.171601,-75.427454)"
2017,Agosto,México,484,166,110,,276,"(7.128456,-73.183637)"
2017,Agosto,Mónaco,492,1,1,,2,"(4.697144,-74.140516)"
2017,Agosto,Montenegro,499,0,1,,1,"(4.697144,-74.140516)"
2017,Agosto,Mozambique,508,4,0,,4,"(4.697144,-74.140516)"
2017,Agosto,Mozambique,508,1,0,,1,"(6.171601,-75.427454)"
2017,Agosto,Nepal,524,2,1,,3,"(4.697144,-74.140516)"
2017,Agosto,Nicaragua,558,1,1,,2,"(10.445761,-75.516429)"
2017,Agosto,Nicaragua,558,0,1,,1,"(10.886611,-74.776708)"
2017,Agosto,Nicaragua,558,0,3,,3,"(12.5744111,-81.703935)"
2017,Agosto,Nicaragua,558,14,43,,57,"(3.541112,-76.384584)"
2017,Agosto,Nicaragua,558,53,100,,153,"(4.697144,-74.140516)"
2017,Agosto,Nicaragua,558,3,4,,7,"(4.815061,-75.736532)"
2017,Agosto,Nicaragua,558,22,65,,87,"(6.171601,-75.427454)"
2017,Agosto,Nicaragua,558,1,0,,1,"(7.128456,-73.183637)"
2017,Agosto,Nigeria,566,1,5,,6,"(4.697144,-74.140516)"
2017,Agosto,Noruega,578,1,0,,1,"(10.445761,-75.516429)"
2017,Agosto,Noruega,578,3,0,,3,"(10.886611,-74.776708)"
2017,Agosto,Noruega,578,7,3,,10,"(3.541112,-76.384584)"
2017,Agosto,Noruega,578,49,34,,83,"(4.697144,-74.140516)"
2017,Agosto,Noruega,578,5,3,,8,"(6.171601,-75.427454)"
2017,Agosto,Nueva Zelanda,554,36,34,,70,"(4.697144,-74.140516)"
2017,Agosto,Omán,512,1,0,,1,"(3.541112,-76.384584)"
2017,Agosto,Omán,512,15,12,,27,"(4.697144,-74.140516)"
2017,Agosto,Omán,512,2,2,,4,"(6.171601,-75.427454)"
2017,Agosto,Papúa Nueva Guinea,598,0,1,,1,"(6.171601,-75.427454)"
2017,Agosto,Panamá,591,19,88,,107,"(10.408582,-75.538003)"
2017,Agosto,Panamá,591,851,710,,1561,"(10.445761,-75.516429)"
2017,Agosto,Panamá,591,872,807,,1679,"(10.886611,-74.776708)"
2017,Agosto,Panamá,591,0,1,,1,"(10.971302,-74.765397)"
2017,Agosto,Panamá,591,0,4,,4,"(11.247723,-74.213989)"
2017,Agosto,Panamá,591,0,6,,6,"(12.5744111,-81.703935)"
2017,Agosto,Panamá,591,72,81,,153,"(12.586067,-81.702563)"
2017,Agosto,Panamá,591,0,14,,14,"(13.3387613,-81.372937)"
2017,Agosto,Panamá,591,1944,1653,,3597,"(3.541112,-76.384584)"
2017,Agosto,Panamá,591,341,238,,579,"(4.452882,-75.766298)"
2017,Agosto,Panamá,591,7537,8636,,16173,"(4.697144,-74.140516)"
2017,Agosto,Panamá,591,388,325,,713,"(4.815061,-75.736532)"
2017,Agosto,Panamá,591,3733,3345,,7078,"(6.171601,-75.427454)"
2017,Agosto,Panamá,591,1,10,,11,"(6.228046,-77.404104)"
2017,Agosto,Panamá,591,5,25,,30,"(7.102626,-77.762647)"
2017,Agosto,Panamá,591,146,138,,284,"(7.128456,-73.183637)"
2017,Agosto,Panamá,591,0,30,,30,"(8.066966,-76.735404)"
2017,Agosto,Panamá,591,23,46,,69,"(8.635765,-77.346578)"
2017,Agosto,Paraguay,600,0,1,,1,"(0.814836,-77.662532)"
2017,Agosto,Paraguay,600,4,3,,7,"(10.445761,-75.516429)"
2017,Agosto,Paraguay,600,6,5,,11,"(10.886611,-74.776708)"
2017,Agosto,Paraguay,600,1,0,,1,"(12.586067,-81.702563)"
2017,Agosto,Paraguay,600,22,32,,54,"(3.541112,-76.384584)"
2017,Agosto,Paraguay,600,102,243,,345,"(4.697144,-74.140516)"
2017,Agosto,Paraguay,600,20,34,,54,"(4.815061,-75.736532)"
2017,Agosto,Paraguay,600,27,25,,52,"(6.171601,-75.427454)"
2017,Agosto,Paraguay,600,0,1,,1,"(7.128456,-73.183637)"
2017,Agosto,Perú,604,9,23,,32,"(-0.193180,-74.784874)"
2017,Agosto,Perú,604,78,123,,201,"(-4.197703,-69.941278)"
2017,Agosto,Perú,604,3,6,,9,"(-4.223468,-69.945098)"
2017,Agosto,Perú,604,1,0,,1,"(0.25129,-76.875963)"
2017,Agosto,Perú,604,47,52,,99,"(0.814836,-77.662532)"
2017,Agosto,Perú,604,0,1,,1,"(1.813928,-78.763924)"
2017,Agosto,Perú,604,82,80,,162,"(10.445761,-75.516429)"
2017,Agosto,Perú,604,5,10,,15,"(10.886611,-74.776708)"
2017,Agosto,Perú,604,1,1,,2,"(12.586067,-81.702563)"
2017,Agosto,Perú,604,154,177,,331,"(3.541112,-76.384584)"
2017,Agosto,Perú,604,5745,6380,,12125,"(4.697144,-74.140516)"
2017,Agosto,Perú,604,1,2,,3,"(4.815061,-75.736532)"
2017,Agosto,Perú,604,177,207,,384,"(6.171601,-75.427454)"
2017,Agosto,Perú,604,3,3,,6,"(7.128456,-73.183637)"
2017,Agosto,Polonia,616,2,1,,3,"(10.886611,-74.776708)"
2017,Agosto,Polonia,616,0,3,,3,"(3.541112,-76.384584)"
2017,Agosto,Polonia,616,15,19,,34,"(4.697144,-74.140516)"
2017,Agosto,Portugal,620,1,1,,2,"(10.886611,-74.776708)"
2017,Agosto,Portugal,620,9,7,,16,"(3.541112,-76.384584)"
2017,Agosto,Portugal,620,68,59,,127,"(4.697144,-74.140516)"
2017,Agosto,Portugal,620,8,6,,14,"(6.171601,-75.427454)"
2017,Agosto,Polinesia Francesa/Colectividad de Ultramar Francesa,258,0,2,,2,"(4.697144,-74.140516)"
2017,Agosto,Puerto Rico/Territorio de Estados Unidos,630,11,7,,18,"(10.445761,-75.516429)"
2017,Agosto,Puerto Rico/Territorio de Estados Unidos,630,31,23,,54,"(10.886611,-74.776708)"
2017,Agosto,Puerto Rico/Territorio de Estados Unidos,630,43,35,,78,"(3.541112,-76.384584)"
2017,Agosto,Puerto Rico/Territorio de Estados Unidos,630,628,523,,1151,"(4.697144,-74.140516)"
2017,Agosto,Puerto Rico/Territorio de Estados Unidos,630,18,15,,33,"(4.815061,-75.736532)"
2017,Agosto,Puerto Rico/Territorio de Estados Unidos,630,52,49,,101,"(6.171601,-75.427454)"
2017,Agosto,Puerto Rico/Territorio de Estados Unidos,630,3,5,,8,"(7.128456,-73.183637)"
2017,Agosto,Qatar,634,1,5,,6,"(3.541112,-76.384584)"
2017,Agosto,Qatar,634,18,7,,25,"(4.697144,-74.140516)"
2017,Agosto,Qatar,634,2,4,,6,"(6.171601,-75.427454)"
2017,Agosto,Reino Unido de Gran Bretaña e Irlanda del Norte,826,0,2,,2,"(10.445761,-75.516429)"
2017,Agosto,Reino Unido de Gran Bretaña e Irlanda del Norte,826,5,2,,7,"(10.886611,-74.776708)"
2017,Agosto,Reino Unido de Gran Bretaña e Irlanda del Norte,826,82,52,,134,"(3.541112,-76.384584)"
2017,Agosto,Reino Unido de Gran Bretaña e Irlanda del Norte,826,1671,1144,,2815,"(4.697144,-74.140516)"
2017,Agosto,Reino Unido de Gran Bretaña e Irlanda del Norte,826,47,19,,66,"(6.171601,-75.427454)"
2017,Agosto,Reino Unido de Gran Bretaña e Irlanda del Norte,826,0,1,,1,"(7.128456,-73.183637)"
2017,Agosto,República CentroÁfricana,140,5,0,,5,"(4.697144,-74.140516)"
2017,Agosto,Federación de Rusia,643,3,1,,4,"(10.886611,-74.776708)"
2017,Agosto,Federación de Rusia,643,1,2,,3,"(3.541112,-76.384584)"
2017,Agosto,Federación de Rusia,643,62,58,,120,"(4.697144,-74.140516)"
2017,Agosto,Federación de Rusia,643,4,5,,9,"(6.171601,-75.427454)"
2017,Agosto,República Dominicana,214,12,12,,24,"(10.445761,-75.516429)"
2017,Agosto,República Dominicana,214,51,60,,111,"(10.886611,-74.776708)"
2017,Agosto,República Dominicana,214,5,0,,5,"(12.586067,-81.702563)"
2017,Agosto,República Dominicana,214,120,134,,254,"(3.541112,-76.384584)"
2017,Agosto,República Dominicana,214,3251,2972,,6223,"(4.697144,-74.140516)"
2017,Agosto,República Dominicana,214,53,48,,101,"(4.815061,-75.736532)"
2017,Agosto,República Dominicana,214,228,172,,400,"(6.171601,-75.427454)"
2017,Agosto,República Dominicana,214,42,57,,99,"(7.128456,-73.183637)"
2017,Agosto,Reunión,638,1,0,,1,"(3.541112,-76.384584)"
2017,Agosto,Rumania,642,7,11,,18,"(4.697144,-74.140516)"
2017,Agosto,Rwanda,646,1,0,,1,"(3.541112,-76.384584)"
2017,Agosto,Samoa Occidental,882,1,0,,1,"(4.697144,-74.140516)"
2017,Agosto,San  Vicente y las Granadinas,670,2,3,,5,"(4.697144,-74.140516)"
2017,Agosto,Senegal,686,1,2,,3,"(4.697144,-74.140516)"
2017,Agosto,Serbia,688,2,0,,2,"(4.697144,-74.140516)"
2017,Agosto,Singapur,702,2,0,,2,"(3.541112,-76.384584)"
2017,Agosto,Singapur,702,15,7,,22,"(4.697144,-74.140516)"
2017,Agosto,Singapur,702,2,2,,4,"(6.171601,-75.427454)"
2017,Agosto,Sri Lanka,144,0,1,,1,"(4.697144,-74.140516)"
2017,Agosto,Sudáfrica,710,17,24,,41,"(4.697144,-74.140516)"
2017,Agosto,Suecia,752,2,1,,3,"(10.445761,-75.516429)"
2017,Agosto,Suecia,752,4,5,,9,"(10.886611,-74.776708)"
2017,Agosto,Suecia,752,22,12,,34,"(3.541112,-76.384584)"
2017,Agosto,Suecia,752,93,79,,172,"(4.697144,-74.140516)"
2017,Agosto,Suecia,752,3,2,,5,"(4.815061,-75.736532)"
2017,Agosto,Suecia,752,21,20,,41,"(6.171601,-75.427454)"
2017,Agosto,Suiza,756,4,2,,6,"(10.886611,-74.776708)"
2017,Agosto,Suiza,756,83,35,,118,"(3.541112,-76.384584)"
2017,Agosto,Suiza,756,409,259,,668,"(4.697144,-74.140516)"
2017,Agosto,Suiza,756,1,3,,4,"(4.815061,-75.736532)"
2017,Agosto,Suiza,756,34,19,,53,"(6.171601,-75.427454)"
2017,Agosto,Surinam,740,0,2,,2,"(10.408582,-75.538003)"
2017,Agosto,Surinam,740,1,1,,2,"(4.697144,-74.140516)"
2017,Agosto,Surinam,740,0,3,,3,"(6.171601,-75.427454)"
2017,Agosto,Taiwán,158,0,3,,3,"(3.541112,-76.384584)"
2017,Agosto,Taiwán,158,11,15,,26,"(4.697144,-74.140516)"
2017,Agosto,Taiwán,158,1,1,,2,"(6.171601,-75.427454)"
2017,Agosto,Tailandia,764,2,0,,2,"(3.541112,-76.384584)"
2017,Agosto,Tailandia,764,30,37,,67,"(4.697144,-74.140516)"
2017,Agosto,Tailandia,764,2,1,,3,"(6.171601,-75.427454)"
2017,Agosto,Territorio Británico del Océano Índico/Territorios Británicos de Ultramar,86,0,1,,1,"(4.697144,-74.140516)"
2017,Agosto,Tanzania,834,3,1,,4,"(4.697144,-74.140516)"
2017,Agosto,Trinidad y Tobago,780,1,2,,3,"(10.445761,-75.516429)"
2017,Agosto,Trinidad y Tobago,780,4,1,,5,"(10.886611,-74.776708)"
2017,Agosto,Trinidad y Tobago,780,4,9,,13,"(3.541112,-76.384584)"
2017,Agosto,Trinidad y Tobago,780,22,29,,51,"(4.697144,-74.140516)"
2017,Agosto,Trinidad y Tobago,780,1,5,,6,"(4.815061,-75.736532)"
2017,Agosto,Trinidad y Tobago,780,6,6,,12,"(6.171601,-75.427454)"
2017,Agosto,Trinidad y Tobago,780,4,1,,5,"(7.128456,-73.183637)"
2017,Agosto,Túnez,788,1,1,,2,"(4.697144,-74.140516)"
2017,Agosto,Turquía,792,0,1,,1,"(10.886611,-74.776708)"
2017,Agosto,Turquía,792,11,8,,19,"(3.541112,-76.384584)"
2017,Agosto,Turquía,792,266,185,,451,"(4.697144,-74.140516)"
2017,Agosto,Turquía,792,6,2,,8,"(6.171601,-75.427454)"
2017,Agosto,Turkmenistán,795,0,1,,1,"(4.697144,-74.140516)"
2017,Agosto,Ucrania,804,1,3,,4,"(4.697144,-74.140516)"
2017,Agosto,Ucrania,804,0,1,,1,"(6.171601,-75.427454)"
2017,Agosto,Uruguay,858,1,2,,3,"(10.445761,-75.516429)"
2017,Agosto,Uruguay,858,2,2,,4,"(10.886611,-74.776708)"
2017,Agosto,Uruguay,858,1,0,,1,"(12.586067,-81.702563)"
2017,Agosto,Uruguay,858,11,8,,19,"(3.541112,-76.384584)"
2017,Agosto,Uruguay,858,280,349,,629,"(4.697144,-74.140516)"
2017,Agosto,Uruguay,858,1,4,,5,"(4.815061,-75.736532)"
2017,Agosto,Uruguay,858,15,14,,29,"(6.171601,-75.427454)"
2017,Agosto,Uruguay,858,0,2,,2,"(7.128456,-73.183637)"
2017,Agosto,Uzbekistán,860,3,0,,3,"(4.697144,-74.140516)"
2017,Agosto,Venezuela,862,2,4,,6,"(10.445761,-75.516429)"
2017,Agosto,Venezuela,862,6,30,,36,"(10.886611,-74.776708)"
2017,Agosto,Venezuela,862,2043,2127,,4170,"(11.360009,-72.129330)"
2017,Agosto,Venezuela,862,9,16,,25,"(3.541112,-76.384584)"
2017,Agosto,Venezuela,862,3,7,,10,"(3.866713,-67.927521)"
2017,Agosto,Venezuela,862,619,564,,1183,"(4.697144,-74.140516)"
2017,Agosto,Venezuela,862,3,0,,3,"(4.815061,-75.736532)"
2017,Agosto,Venezuela,862,290,286,,576,"(6.171601,-75.427454)"
2017,Agosto,Venezuela,862,46,66,,112,"(6.185799,-67.483929)"
2017,Agosto,Venezuela,862,700,682,,1382,"(7.088729,-70.740253)"
2017,Agosto,Venezuela,862,4,3,,7,"(7.128456,-73.183637)"
2017,Agosto,Venezuela,862,1655,2165,,3820,"(7.818934,-72.453226)"
2017,Agosto,Venezuela,862,2,2,,4,"(7.927209,-72.507910)"
2017,Agosto,Venezuela,862,121,183,,304,"(8.36068,-72.409396)"
2017,Agosto,Vietnam,704,1,0,,1,"(3.541112,-76.384584)"
2017,Agosto,Vietnam,704,1,4,,5,"(4.697144,-74.140516)"
2017,Agosto,Vietnam,704,1,1,,2,"(6.171601,-75.427454)"
2017,Agosto,Islas Vírgenes Británicas/Territorio Británico de Ultramar,92,0,5,,5,"(10.408582,-75.538003)"
2017,Agosto,Islas Vírgenes Británicas/Territorio Británico de Ultramar,92,0,1,,1,"(6.171601,-75.427454)"
2017,Agosto,Zambia,894,0,1,,1,"(4.697144,-74.140516)"
2017,Agosto,Islas Turcas y Caicos/Territorio Británico de Ultramar,796,1,0,,1,"(3.541112,-76.384584)"
2017,Agosto,Islas Turcas y Caicos/Territorio Británico de Ultramar,796,3,3,,6,"(4.697144,-74.140516)"
2017,Agosto,Desconocido,99999,585,440,,1025,"(6.171601,-75.427454)"
2017,Septiembre,Afganistán,4,0,2,,2,"(4.697144,-74.140516)"
2017,Septiembre,Albania,8,0,1,,1,"(3.541112,-76.384584)"
2017,Septiembre,Albania,8,1,2,,3,"(4.697144,-74.140516)"
2017,Septiembre,Alemania,276,5,9,,14,"(10.445761,-75.516429)"
2017,Septiembre,Alemania,276,7,2,,9,"(10.886611,-74.776708)"
2017,Septiembre,Alemania,276,73,61,,134,"(3.541112,-76.384584)"
2017,Septiembre,Alemania,276,1588,1484,,3072,"(4.697144,-74.140516)"
2017,Septiembre,Alemania,276,3,1,,4,"(4.815061,-75.736532)"
2017,Septiembre,Alemania,276,3,2,,5,"(7.128456,-73.183637)"
2017,Septiembre,Angola,24,1,2,,3,"(4.697144,-74.140516)"
2017,Septiembre,Antigua y Barbuda,28,1,0,,1,"(4.697144,-74.140516)"
2017,Septiembre,Países Bajos,528,126,110,,236,"(10.445761,-75.516429)"
2017,Septiembre,Países Bajos,528,10,7,,17,"(10.886611,-74.776708)"
2017,Septiembre,Países Bajos,528,40,18,,58,"(3.541112,-76.384584)"
2017,Septiembre,Países Bajos,528,739,791,,1530,"(4.697144,-74.140516)"
2017,Septiembre,Países Bajos,528,6,0,,6,"(4.815061,-75.736532)"
2017,Septiembre,Países Bajos,528,4,12,,16,"(6.171601,-75.427454)"
2017,Septiembre,Países Bajos,528,1,6,,7,"(7.128456,-73.183637)"
2017,Septiembre,Arabia Saudita,682,2,2,,4,"(10.445761,-75.516429)"
2017,Septiembre,Arabia Saudita,682,0,3,,3,"(3.541112,-76.384584)"
2017,Septiembre,Arabia Saudita,682,5,28,,33,"(4.697144,-74.140516)"
2017,Septiembre,Argelia,12,1,0,,1,"(3.541112,-76.384584)"
2017,Septiembre,Argelia,12,5,6,,11,"(4.697144,-74.140516)"
2017,Septiembre,Argentina,32,12,31,,43,"(0.814836,-77.662532)"
2017,Septiembre,Argentina,32,22,13,,35,"(10.445761,-75.516429)"
2017,Septiembre,Argentina,32,9,10,,19,"(10.886611,-74.776708)"
2017,Septiembre,Argentina,32,145,170,,315,"(3.541112,-76.384584)"
2017,Septiembre,Argentina,32,2377,2537,,4914,"(4.697144,-74.140516)"
2017,Septiembre,Argentina,32,16,29,,45,"(4.815061,-75.736532)"
2017,Septiembre,Argentina,32,1,1,,2,"(7.128456,-73.183637)"
2017,Septiembre,República de Armenia,51,1,0,,1,"(3.541112,-76.384584)"
2017,Septiembre,Aruba,533,1673,1092,,2765,"(10.408582,-75.538003)"
2017,Septiembre,Aruba,533,1,4,,5,"(10.445761,-75.516429)"
2017,Septiembre,Aruba,533,2,3,,5,"(10.886611,-74.776708)"
2017,Septiembre,Aruba,533,4,6,,10,"(11.117806,-74.232622)"
2017,Septiembre,Aruba,533,6,2,,8,"(11.247723,-74.213989)"
2017,Septiembre,Aruba,533,2,4,,6,"(11.528919,-72.919681)"
2017,Septiembre,Aruba,533,1,0,,1,"(12.586067,-81.702563)"
2017,Septiembre,Aruba,533,30,17,,47,"(3.541112,-76.384584)"
2017,Septiembre,Aruba,533,1706,1358,,3064,"(4.697144,-74.140516)"
2017,Septiembre,Aruba,533,11,6,,17,"(4.815061,-75.736532)"
2017,Septiembre,Aruba,533,0,7,,7,"(6.171601,-75.427454)"
2017,Septiembre,Aruba,533,25,67,,92,"(7.128456,-73.183637)"
2017,Septiembre,Australia,36,1,2,,3,"(10.886611,-74.776708)"
2017,Septiembre,Australia,36,13,13,,26,"(3.541112,-76.384584)"
2017,Septiembre,Australia,36,198,133,,331,"(4.697144,-74.140516)"
2017,Septiembre,Australia,36,3,3,,6,"(4.815061,-75.736532)"
2017,Septiembre,Australia,36,3,0,,3,"(7.128456,-73.183637)"
2017,Septiembre,Austria,40,1,0,,1,"(10.445761,-75.516429)"
2017,Septiembre,Austria,40,0,3,,3,"(10.886611,-74.776708)"
2017,Septiembre,Austria,40,1,4,,5,"(3.541112,-76.384584)"
2017,Septiembre,Austria,40,30,30,,60,"(4.697144,-74.140516)"
2017,Septiembre,Austria,40,1,2,,3,"(4.815061,-75.736532)"
2017,Septiembre,Austria,40,1,1,,2,"(7.128456,-73.183637)"
2017,Septiembre,Azerbaiyán,31,0,1,,1,"(4.697144,-74.140516)"
2017,Septiembre,Bahamas,44,0,1,,1,"(10.445761,-75.516429)"
2017,Septiembre,Bahamas,44,5,1,,6,"(3.541112,-76.384584)"
2017,Septiembre,Bahamas,44,4,5,,9,"(4.697144,-74.140516)"
2017,Septiembre,Bahamas,44,1,0,,1,"(4.815061,-75.736532)"
2017,Septiembre,Bahréin,48,3,1,,4,"(4.697144,-74.140516)"
2017,Septiembre,Bangladesh,50,1,0,,1,"(4.697144,-74.140516)"
2017,Septiembre,Barbados,52,3,2,,5,"(3.541112,-76.384584)"
2017,Septiembre,Barbados,52,11,9,,20,"(4.697144,-74.140516)"
2017,Septiembre,República de Belarús,112,1,0,,1,"(11.360009,-72.129330)"
2017,Septiembre,Bélgica,56,1,1,,2,"(10.445761,-75.516429)"
2017,Septiembre,Bélgica,56,1,0,,1,"(10.886611,-74.776708)"
2017,Septiembre,Bélgica,56,11,8,,19,"(3.541112,-76.384584)"
2017,Septiembre,Bélgica,56,78,47,,125,"(4.697144,-74.140516)"
2017,Septiembre,Bélgica,56,1,0,,1,"(4.815061,-75.736532)"
2017,Septiembre,Bélgica,56,1,2,,3,"(7.128456,-73.183637)"
2017,Septiembre,Belice,84,9,7,,16,"(4.697144,-74.140516)"
2017,Septiembre,Bermudas/Territorio Británico de Ultramar,60,4,0,,4,"(4.697144,-74.140516)"
2017,Septiembre,Bermudas/Territorio Británico de Ultramar,60,1,0,,1,"(4.815061,-75.736532)"
2017,Septiembre,Bolivia,68,3,8,,11,"(0.814836,-77.662532)"
2017,Septiembre,Bolivia,68,2,2,,4,"(10.445761,-75.516429)"
2017,Septiembre,Bolivia,68,2,1,,3,"(10.886611,-74.776708)"
2017,Septiembre,Bolivia,68,39,57,,96,"(3.541112,-76.384584)"
2017,Septiembre,Bolivia,68,236,384,,620,"(4.697144,-74.140516)"
2017,Septiembre,Bolivia,68,3,3,,6,"(4.815061,-75.736532)"
2017,Septiembre,Bosnia y Herzegovina,70,2,1,,3,"(4.697144,-74.140516)"
2017,Septiembre,Brasil,76,123,254,,377,"(-4.197703,-69.941278)"
2017,Septiembre,Brasil,76,6,7,,13,"(-4.223468,-69.945098)"
2017,Septiembre,Brasil,76,18,15,,33,"(10.445761,-75.516429)"
2017,Septiembre,Brasil,76,3,1,,4,"(10.886611,-74.776708)"
2017,Septiembre,Brasil,76,104,193,,297,"(3.541112,-76.384584)"
2017,Septiembre,Brasil,76,2508,3309,,5817,"(4.697144,-74.140516)"
2017,Septiembre,Brasil,76,16,32,,48,"(4.815061,-75.736532)"
2017,Septiembre,Brasil,76,2,4,,6,"(7.128456,-73.183637)"
2017,Septiembre,Brunei Darussalam,96,0,1,,1,"(4.697144,-74.140516)"
2017,Septiembre,Bulgaria,100,2,2,,4,"(4.697144,-74.140516)"
2017,Septiembre,Islas Caimán/Territorio Británico de Ultramar,136,1,0,,1,"(12.586067,-81.702563)"
2017,Septiembre,Islas Caimán/Territorio Británico de Ultramar,136,1,1,,2,"(4.697144,-74.140516)"
2017,Septiembre,Camboya,116,1,0,,1,"(4.697144,-74.140516)"
2017,Septiembre,Camerún,120,0,2,,2,"(4.697144,-74.140516)"
2017,Septiembre,Canadá,124,28,19,,47,"(10.445761,-75.516429)"
2017,Septiembre,Canadá,124,30,12,,42,"(10.886611,-74.776708)"
2017,Septiembre,Canadá,124,172,142,,314,"(3.541112,-76.384584)"
2017,Septiembre,Canadá,124,1999,1653,,3652,"(4.697144,-74.140516)"
2017,Septiembre,Canadá,124,16,13,,29,"(4.815061,-75.736532)"
2017,Septiembre,Canadá,124,0,22,,22,"(6.171601,-75.427454)"
2017,Septiembre,Canadá,124,12,13,,25,"(7.128456,-73.183637)"
2017,Septiembre,España,724,0,2,,2,"(10.408582,-75.538003)"
2017,Septiembre,España,724,16,24,,40,"(10.445761,-75.516429)"
2017,Septiembre,España,724,24,19,,43,"(10.886611,-74.776708)"
2017,Septiembre,España,724,2329,1534,,3863,"(3.541112,-76.384584)"
2017,Septiembre,España,724,13707,9901,,23608,"(4.697144,-74.140516)"
2017,Septiembre,España,724,24,9,,33,"(4.815061,-75.736532)"
2017,Septiembre,España,724,2274,1534,,3808,"(6.171601,-75.427454)"
2017,Septiembre,España,724,20,11,,31,"(7.128456,-73.183637)"
2017,Septiembre,Colombia,170,3,9,,12,"(10.445761,-75.516429)"
2017,Septiembre,Colombia,170,683,586,,1269,"(10.886611,-74.776708)"
2017,Septiembre,Colombia,170,1710,1695,,3405,"(4.697144,-74.140516)"
2017,Septiembre,Colombia,170,1777,1698,,3475,"(6.171601,-75.427454)"
2017,Septiembre,República de Corea,410,0,1,,1,"(3.541112,-76.384584)"
2017,Septiembre,República de Corea,410,15,17,,32,"(4.697144,-74.140516)"
2017,Septiembre,Costa de Marfil,384,1,0,,1,"(3.541112,-76.384584)"
2017,Septiembre,Costa de Marfil,384,5,3,,8,"(4.697144,-74.140516)"
2017,Septiembre,Costa Rica,188,0,1,,1,"(10.408582,-75.538003)"
2017,Septiembre,Costa Rica,188,16,13,,29,"(10.445761,-75.516429)"
2017,Septiembre,Costa Rica,188,8,9,,17,"(10.886611,-74.776708)"
2017,Septiembre,Costa Rica,188,2,19,,21,"(12.5744111,-81.703935)"
2017,Septiembre,Costa Rica,188,1,1,,2,"(12.586067,-81.702563)"
2017,Septiembre,Costa Rica,188,57,59,,116,"(3.541112,-76.384584)"
2017,Septiembre,Costa Rica,188,1055,1214,,2269,"(4.697144,-74.140516)"
2017,Septiembre,Costa Rica,188,13,14,,27,"(4.815061,-75.736532)"
2017,Septiembre,Costa Rica,188,3,10,,13,"(6.171601,-75.427454)"
2017,Septiembre,Costa Rica,188,1,4,,5,"(7.128456,-73.183637)"
2017,Septiembre,Croacia,191,1,1,,2,"(3.541112,-76.384584)"
2017,Septiembre,Croacia,191,6,3,,9,"(4.697144,-74.140516)"
2017,Septiembre,Croacia,191,1,2,,3,"(4.815061,-75.736532)"
2017,Septiembre,Cuba,192,9,6,,15,"(10.445761,-75.516429)"
2017,Septiembre,Cuba,192,1,2,,3,"(10.886611,-74.776708)"
2017,Septiembre,Cuba,192,121,62,,183,"(3.541112,-76.384584)"
2017,Septiembre,Cuba,192,724,711,,1435,"(4.697144,-74.140516)"
2017,Septiembre,Cuba,192,5,8,,13,"(4.815061,-75.736532)"
2017,Septiembre,Cuba,192,18,8,,26,"(7.128456,-73.183637)"
2017,Septiembre,Curazao,99999,12,47,,59,"(4.697144,-74.140516)"
2017,Septiembre,República Checa,203,0,2,,2,"(3.541112,-76.384584)"
2017,Septiembre,República Checa,203,8,10,,18,"(4.697144,-74.140516)"
2017,Septiembre,República Checa,203,0,1,,1,"(7.128456,-73.183637)"
2017,Septiembre,Chile,152,0,1,,1,"(0.25129,-76.875963)"
2017,Septiembre,Chile,152,143,167,,310,"(0.814836,-77.662532)"
2017,Septiembre,Chile,152,21,16,,37,"(10.445761,-75.516429)"
2017,Septiembre,Chile,152,7,4,,11,"(10.886611,-74.776708)"
2017,Septiembre,Chile,152,247,189,,436,"(3.541112,-76.384584)"
2017,Septiembre,Chile,152,4056,3608,,7664,"(4.697144,-74.140516)"
2017,Septiembre,Chile,152,39,16,,55,"(4.815061,-75.736532)"
2017,Septiembre,Chile,152,0,7,,7,"(6.171601,-75.427454)"
2017,Septiembre,Chile,152,8,4,,12,"(7.128456,-73.183637)"
2017,Septiembre,China,156,0,3,,3,"(10.445761,-75.516429)"
2017,Septiembre,China,156,3,8,,11,"(10.886611,-74.776708)"
2017,Septiembre,China,156,9,21,,30,"(3.541112,-76.384584)"
2017,Septiembre,China,156,153,378,,531,"(4.697144,-74.140516)"
2017,Septiembre,China,156,0,2,,2,"(4.815061,-75.736532)"
2017,Septiembre,China,156,1,1,,2,"(7.128456,-73.183637)"
2017,Septiembre,Chipre,196,0,2,,2,"(4.697144,-74.140516)"
2017,Septiembre,Dinamarca,208,3,0,,3,"(10.445761,-75.516429)"
2017,Septiembre,Dinamarca,208,1,0,,1,"(3.541112,-76.384584)"
2017,Septiembre,Dinamarca,208,14,16,,30,"(4.697144,-74.140516)"
2017,Septiembre,Dinamarca,208,1,0,,1,"(7.128456,-73.183637)"
2017,Septiembre,Ecuador,218,1,2,,3,"(-0.193180,-74.784874)"
2017,Septiembre,Ecuador,218,505,797,,1302,"(0.25129,-76.875963)"
2017,Septiembre,Ecuador,218,20,33,,53,"(0.812436,-77.847006)"
2017,Septiembre,Ecuador,218,5396,6474,,11870,"(0.814836,-77.662532)"
2017,Septiembre,Ecuador,218,163,160,,323,"(1.813928,-78.763924)"
2017,Septiembre,Ecuador,218,4,9,,13,"(10.445761,-75.516429)"
2017,Septiembre,Ecuador,218,696,507,,1203,"(10.886611,-74.776708)"
2017,Septiembre,Ecuador,218,138,224,,362,"(3.541112,-76.384584)"
2017,Septiembre,Ecuador,218,2213,3654,,5867,"(4.697144,-74.140516)"
2017,Septiembre,Ecuador,218,5,5,,10,"(4.815061,-75.736532)"
2017,Septiembre,Ecuador,218,1,5,,6,"(6.171601,-75.427454)"
2017,Septiembre,Ecuador,218,2,9,,11,"(7.128456,-73.183637)"
2017,Septiembre,Egipto,818,2,0,,2,"(3.541112,-76.384584)"
2017,Septiembre,Egipto,818,15,14,,29,"(4.697144,-74.140516)"
2017,Septiembre,El Salvador,222,1,0,,1,"(10.445761,-75.516429)"
2017,Septiembre,El Salvador,222,1,3,,4,"(10.886611,-74.776708)"
2017,Septiembre,El Salvador,222,150,138,,288,"(3.541112,-76.384584)"
2017,Septiembre,El Salvador,222,1322,1408,,2730,"(4.697144,-74.140516)"
2017,Septiembre,El Salvador,222,1427,1189,,2616,"(6.171601,-75.427454)"
2017,Septiembre,El Salvador,222,1,1,,2,"(7.128456,-73.183637)"
2017,Septiembre,Emiratos Árabes,784,1,2,,3,"(10.445761,-75.516429)"
2017,Septiembre,Emiratos Árabes,784,3,5,,8,"(3.541112,-76.384584)"
2017,Septiembre,Emiratos Árabes,784,60,83,,143,"(4.697144,-74.140516)"
2017,Septiembre,Eslovaquia,703,1,0,,1,"(4.697144,-74.140516)"
2017,Septiembre,Eslovenia,705,2,1,,3,"(4.697144,-74.140516)"
2017,Septiembre,Estados Unidos de América,840,2802,2409,,5211,"(10.445761,-75.516429)"
2017,Septiembre,Estados Unidos de América,840,842,874,,1716,"(10.886611,-74.776708)"
2017,Septiembre,Estados Unidos de América,840,0,1,,1,"(11.247723,-74.213989)"
2017,Septiembre,Estados Unidos de América,840,7,12,,19,"(12.586067,-81.702563)"
2017,Septiembre,Estados Unidos de América,840,4784,3380,,8164,"(3.541112,-76.384584)"
2017,Septiembre,Estados Unidos de América,840,716,554,,1270,"(4.452882,-75.766298)"
2017,Septiembre,Estados Unidos de América,840,26833,23901,,50734,"(4.697144,-74.140516)"
2017,Septiembre,Estados Unidos de América,840,817,538,,1355,"(4.815061,-75.736532)"
2017,Septiembre,Estados Unidos de América,840,7288,6038,,13326,"(6.171601,-75.427454)"
2017,Septiembre,Estados Unidos de América,840,197,145,,342,"(7.128456,-73.183637)"
2017,Septiembre,Etiopia,231,0,1,,1,"(4.697144,-74.140516)"
2017,Septiembre,Filipinas,608,1,0,,1,"(10.445761,-75.516429)"
2017,Septiembre,Filipinas,608,1,2,,3,"(4.697144,-74.140516)"
2017,Septiembre,Finlandia,246,6,4,,10,"(4.697144,-74.140516)"
2017,Septiembre,Francia,250,18,9,,27,"(10.445761,-75.516429)"
2017,Septiembre,Francia,250,8,10,,18,"(10.886611,-74.776708)"
2017,Septiembre,Francia,250,121,64,,185,"(3.541112,-76.384584)"
2017,Septiembre,Francia,250,0,1,,1,"(4.452882,-75.766298)"
2017,Septiembre,Francia,250,2197,1742,,3939,"(4.697144,-74.140516)"
2017,Septiembre,Francia,250,10,13,,23,"(4.815061,-75.736532)"
2017,Septiembre,Francia,250,1,1,,2,"(7.128456,-73.183637)"
2017,Septiembre,Georgia,268,0,3,,3,"(4.697144,-74.140516)"
2017,Septiembre,Gibraltar/Territorio Británico de Ultramar,292,2,0,,2,"(0.814836,-77.662532)"
2017,Septiembre,Grecia,300,1,0,,1,"(3.541112,-76.384584)"
2017,Septiembre,Grecia,300,17,11,,28,"(4.697144,-74.140516)"
2017,Septiembre,Grecia,300,0,1,,1,"(7.128456,-73.183637)"
2017,Septiembre,Guatemala,320,8,10,,18,"(10.445761,-75.516429)"
2017,Septiembre,Guatemala,320,4,13,,17,"(10.886611,-74.776708)"
2017,Septiembre,Guatemala,320,57,83,,140,"(3.541112,-76.384584)"
2017,Septiembre,Guatemala,320,306,446,,752,"(4.697144,-74.140516)"
2017,Septiembre,Guatemala,320,14,14,,28,"(4.815061,-75.736532)"
2017,Septiembre,Guatemala,320,9,15,,24,"(7.128456,-73.183637)"
2017,Septiembre,Guyana,328,3,5,,8,"(10.886611,-74.776708)"
2017,Septiembre,Guyana,328,0,1,,1,"(3.541112,-76.384584)"
2017,Septiembre,Guyana,328,1,1,,2,"(4.697144,-74.140516)"
2017,Septiembre,Guinea,324,1,0,,1,"(0.814836,-77.662532)"
2017,Septiembre,Guinea Ecuatorial,226,2,2,,4,"(3.541112,-76.384584)"
2017,Septiembre,Guadalupe/Territorio Francés,312,0,1,,1,"(3.541112,-76.384584)"
2017,Septiembre,Guadalupe/Territorio Francés,312,0,1,,1,"(4.697144,-74.140516)"
2017,Septiembre,Guayana Francesa/Departamento de Ultramar Francés,254,2,0,,2,"(4.697144,-74.140516)"
2017,Septiembre,Haití,332,0,1,,1,"(10.445761,-75.516429)"
2017,Septiembre,Haití,332,2,5,,7,"(10.886611,-74.776708)"
2017,Septiembre,Haití,332,0,2,,2,"(3.541112,-76.384584)"
2017,Septiembre,Haití,332,1,3,,4,"(4.697144,-74.140516)"
2017,Septiembre,Honduras,340,0,2,,2,"(10.408582,-75.538003)"
2017,Septiembre,Honduras,340,2,0,,2,"(10.445761,-75.516429)"
2017,Septiembre,Honduras,340,0,6,,6,"(10.886611,-74.776708)"
2017,Septiembre,Honduras,340,13,32,,45,"(3.541112,-76.384584)"
2017,Septiembre,Honduras,340,60,100,,160,"(4.697144,-74.140516)"
2017,Septiembre,Honduras,340,1,2,,3,"(4.815061,-75.736532)"
2017,Septiembre,Honduras,340,2,1,,3,"(7.128456,-73.183637)"
2017,Septiembre,Hong Kong,344,0,1,,1,"(10.445761,-75.516429)"
2017,Septiembre,Hong Kong,344,0,2,,2,"(3.541112,-76.384584)"
2017,Septiembre,Hong Kong,344,23,47,,70,"(4.697144,-74.140516)"
2017,Septiembre,Hungría,348,0,2,,2,"(3.541112,-76.384584)"
2017,Septiembre,Hungría,348,14,5,,19,"(4.697144,-74.140516)"
2017,Septiembre,India,356,3,0,,3,"(10.445761,-75.516429)"
2017,Septiembre,India,356,1,1,,2,"(3.541112,-76.384584)"
2017,Septiembre,India,356,27,44,,71,"(4.697144,-74.140516)"
2017,Septiembre,Indonesia,360,0,1,,1,"(3.541112,-76.384584)"
2017,Septiembre,Indonesia,360,7,5,,12,"(4.697144,-74.140516)"
2017,Septiembre,Iraq,368,2,1,,3,"(4.697144,-74.140516)"
2017,Septiembre,Irán,364,4,5,,9,"(4.697144,-74.140516)"
2017,Septiembre,República de Irlanda,372,0,1,,1,"(3.541112,-76.384584)"
2017,Septiembre,República de Irlanda,372,6,9,,15,"(4.697144,-74.140516)"
2017,Septiembre,Islandia,352,1,1,,2,"(10.445761,-75.516429)"
2017,Septiembre,Islandia,352,3,3,,6,"(4.697144,-74.140516)"
2017,Septiembre,Isla de Man,833,1,0,,1,"(4.697144,-74.140516)"
2017,Septiembre,Israel,376,4,4,,8,"(3.541112,-76.384584)"
2017,Septiembre,Israel,376,135,80,,215,"(4.697144,-74.140516)"
2017,Septiembre,Italia,380,19,13,,32,"(10.445761,-75.516429)"
2017,Septiembre,Italia,380,16,6,,22,"(10.886611,-74.776708)"
2017,Septiembre,Italia,380,111,65,,176,"(3.541112,-76.384584)"
2017,Septiembre,Italia,380,584,445,,1029,"(4.697144,-74.140516)"
2017,Septiembre,Italia,380,3,1,,4,"(4.815061,-75.736532)"
2017,Septiembre,Italia,380,2,1,,3,"(7.128456,-73.183637)"
2017,Septiembre,Jamaica,388,0,11,,11,"(10.408582,-75.538003)"
2017,Septiembre,Jamaica,388,2,8,,10,"(10.445761,-75.516429)"
2017,Septiembre,Jamaica,388,0,1,,1,"(10.886611,-74.776708)"
2017,Septiembre,Jamaica,388,10,8,,18,"(3.541112,-76.384584)"
2017,Septiembre,Jamaica,388,23,26,,49,"(4.697144,-74.140516)"
2017,Septiembre,Jamaica,388,14,2,,16,"(4.815061,-75.736532)"
2017,Septiembre,Japón,392,0,1,,1,"(10.445761,-75.516429)"
2017,Septiembre,Japón,392,2,1,,3,"(3.541112,-76.384584)"
2017,Septiembre,Japón,392,62,73,,135,"(4.697144,-74.140516)"
2017,Septiembre,Japón,392,1,1,,2,"(4.815061,-75.736532)"
2017,Septiembre,Kazajistán,398,0,1,,1,"(3.541112,-76.384584)"
2017,Septiembre,Kazajistán,398,0,5,,5,"(4.697144,-74.140516)"
2017,Septiembre,Kenia,404,2,3,,5,"(4.697144,-74.140516)"
2017,Septiembre,Kuwait,414,1,2,,3,"(4.697144,-74.140516)"
2017,Septiembre,Letonia,428,1,0,,1,"(3.541112,-76.384584)"
2017,Septiembre,Lituania,440,0,4,,4,"(4.697144,-74.140516)"
2017,Septiembre,Líbano,422,11,15,,26,"(4.697144,-74.140516)"
2017,Septiembre,Luxemburgo,442,5,5,,10,"(4.697144,-74.140516)"
2017,Septiembre,Malasia,458,2,1,,3,"(4.697144,-74.140516)"
2017,Septiembre,Maldivas,462,1,0,,1,"(4.697144,-74.140516)"
2017,Septiembre,Malta,470,1,2,,3,"(3.541112,-76.384584)"
2017,Septiembre,Malta,470,22,13,,35,"(4.697144,-74.140516)"
2017,Septiembre,Marruecos,504,6,3,,9,"(4.697144,-74.140516)"
2017,Septiembre,Islas Marshall,584,1,0,,1,"(12.5744111,-81.703935)"
2017,Septiembre,Mauricio,480,0,1,,1,"(4.697144,-74.140516)"
2017,Septiembre,México,484,60,50,,110,"(10.445761,-75.516429)"
2017,Septiembre,México,484,89,67,,156,"(10.886611,-74.776708)"
2017,Septiembre,México,484,0,2,,2,"(12.586067,-81.702563)"
2017,Septiembre,México,484,968,731,,1699,"(3.541112,-76.384584)"
2017,Septiembre,México,484,13650,12132,,25782,"(4.697144,-74.140516)"
2017,Septiembre,México,484,252,184,,436,"(4.815061,-75.736532)"
2017,Septiembre,México,484,0,6,,6,"(6.171601,-75.427454)"
2017,Septiembre,México,484,217,129,,346,"(7.128456,-73.183637)"
2017,Septiembre,Mónaco,492,1,2,,3,"(4.697144,-74.140516)"
2017,Septiembre,Montenegro,499,0,1,,1,"(4.697144,-74.140516)"
2017,Septiembre,Nauru,520,0,1,,1,"(4.697144,-74.140516)"
2017,Septiembre,Nicaragua,558,1,3,,4,"(10.445761,-75.516429)"
2017,Septiembre,Nicaragua,558,0,1,,1,"(10.886611,-74.776708)"
2017,Septiembre,Nicaragua,558,16,32,,48,"(3.541112,-76.384584)"
2017,Septiembre,Nicaragua,558,23,48,,71,"(4.697144,-74.140516)"
2017,Septiembre,Nicaragua,558,1,7,,8,"(4.815061,-75.736532)"
2017,Septiembre,Nicaragua,558,0,3,,3,"(7.128456,-73.183637)"
2017,Septiembre,Nigeria,566,1,4,,5,"(10.445761,-75.516429)"
2017,Septiembre,Nigeria,566,0,3,,3,"(4.697144,-74.140516)"
2017,Septiembre,Noruega,578,1,0,,1,"(10.445761,-75.516429)"
2017,Septiembre,Noruega,578,0,2,,2,"(3.541112,-76.384584)"
2017,Septiembre,Noruega,578,17,22,,39,"(4.697144,-74.140516)"
2017,Septiembre,Nueva Zelanda,554,2,1,,3,"(3.541112,-76.384584)"
2017,Septiembre,Nueva Zelanda,554,21,17,,38,"(4.697144,-74.140516)"
2017,Septiembre,Omán,512,0,1,,1,"(10.445761,-75.516429)"
2017,Septiembre,Omán,512,1,0,,1,"(3.541112,-76.384584)"
2017,Septiembre,Omán,512,2,2,,4,"(4.697144,-74.140516)"
2017,Septiembre,Panamá,591,19,182,,201,"(10.408582,-75.538003)"
2017,Septiembre,Panamá,591,846,826,,1672,"(10.445761,-75.516429)"
2017,Septiembre,Panamá,591,1052,1102,,2154,"(10.886611,-74.776708)"
2017,Septiembre,Panamá,591,0,2,,2,"(10.971302,-74.765397)"
2017,Septiembre,Panamá,591,0,5,,5,"(12.5744111,-81.703935)"
2017,Septiembre,Panamá,591,108,74,,182,"(12.586067,-81.702563)"
2017,Septiembre,Panamá,591,2141,1825,,3966,"(3.541112,-76.384584)"
2017,Septiembre,Panamá,591,302,212,,514,"(4.452882,-75.766298)"
2017,Septiembre,Panamá,591,8423,9248,,17671,"(4.697144,-74.140516)"
2017,Septiembre,Panamá,591,492,404,,896,"(4.815061,-75.736532)"
2017,Septiembre,Panamá,591,3,2,,5,"(6.17134,-75.427194)"
2017,Septiembre,Panamá,591,6887,6047,,12934,"(6.171601,-75.427454)"
2017,Septiembre,Panamá,591,0,2,,2,"(6.228046,-77.404104)"
2017,Septiembre,Panamá,591,4,13,,17,"(7.102626,-77.762647)"
2017,Septiembre,Panamá,591,199,165,,364,"(7.128456,-73.183637)"
2017,Septiembre,Panamá,591,0,14,,14,"(8.066966,-76.735404)"
2017,Septiembre,Panamá,591,18,33,,51,"(8.635765,-77.346578)"
2017,Septiembre,Paraguay,600,3,5,,8,"(10.445761,-75.516429)"
2017,Septiembre,Paraguay,600,1,11,,12,"(10.886611,-74.776708)"
2017,Septiembre,Paraguay,600,23,47,,70,"(3.541112,-76.384584)"
2017,Septiembre,Paraguay,600,44,156,,200,"(4.697144,-74.140516)"
2017,Septiembre,Paraguay,600,24,28,,52,"(4.815061,-75.736532)"
2017,Septiembre,Paraguay,600,2,1,,3,"(7.128456,-73.183637)"
2017,Septiembre,Perú,604,3,5,,8,"(-0.193180,-74.784874)"
2017,Septiembre,Perú,604,52,93,,145,"(-4.197703,-69.941278)"
2017,Septiembre,Perú,604,29,24,,53,"(-4.223468,-69.945098)"
2017,Septiembre,Perú,604,0,2,,2,"(0.25129,-76.875963)"
2017,Septiembre,Perú,604,77,78,,155,"(0.814836,-77.662532)"
2017,Septiembre,Perú,604,1,0,,1,"(1.813928,-78.763924)"
2017,Septiembre,Perú,604,56,45,,101,"(10.445761,-75.516429)"
2017,Septiembre,Perú,604,21,22,,43,"(10.886611,-74.776708)"
2017,Septiembre,Perú,604,0,6,,6,"(12.586067,-81.702563)"
2017,Septiembre,Perú,604,244,331,,575,"(3.541112,-76.384584)"
2017,Septiembre,Perú,604,5042,5726,,10768,"(4.697144,-74.140516)"
2017,Septiembre,Perú,604,12,14,,26,"(4.815061,-75.736532)"
2017,Septiembre,Perú,604,1,12,,13,"(6.171601,-75.427454)"
2017,Septiembre,Perú,604,3,6,,9,"(7.128456,-73.183637)"
2017,Septiembre,Palestina,99999,2,1,,3,"(4.697144,-74.140516)"
2017,Septiembre,Polonia,616,0,1,,1,"(10.445761,-75.516429)"
2017,Septiembre,Polonia,616,1,0,,1,"(3.541112,-76.384584)"
2017,Septiembre,Polonia,616,12,22,,34,"(4.697144,-74.140516)"
2017,Septiembre,Portugal,620,1,0,,1,"(10.445761,-75.516429)"
2017,Septiembre,Portugal,620,1,1,,2,"(10.886611,-74.776708)"
2017,Septiembre,Portugal,620,6,12,,18,"(3.541112,-76.384584)"
2017,Septiembre,Portugal,620,110,76,,186,"(4.697144,-74.140516)"
2017,Septiembre,Portugal,620,1,0,,1,"(4.815061,-75.736532)"
2017,Septiembre,Polinesia Francesa/Colectividad de Ultramar Francesa,258,2,0,,2,"(4.697144,-74.140516)"
2017,Septiembre,Puerto Rico/Territorio de Estados Unidos,630,5,6,,11,"(10.445761,-75.516429)"
2017,Septiembre,Puerto Rico/Territorio de Estados Unidos,630,4,13,,17,"(10.886611,-74.776708)"
2017,Septiembre,Puerto Rico/Territorio de Estados Unidos,630,15,12,,27,"(3.541112,-76.384584)"
2017,Septiembre,Puerto Rico/Territorio de Estados Unidos,630,281,256,,537,"(4.697144,-74.140516)"
2017,Septiembre,Puerto Rico/Territorio de Estados Unidos,630,6,2,,8,"(4.815061,-75.736532)"
2017,Septiembre,Puerto Rico/Territorio de Estados Unidos,630,4,3,,7,"(7.128456,-73.183637)"
2017,Septiembre,Qatar,634,1,0,,1,"(3.541112,-76.384584)"
2017,Septiembre,Qatar,634,4,10,,14,"(4.697144,-74.140516)"
2017,Septiembre,Reino Unido de Gran Bretaña e Irlanda del Norte,826,4,0,,4,"(10.445761,-75.516429)"
2017,Septiembre,Reino Unido de Gran Bretaña e Irlanda del Norte,826,4,1,,5,"(10.886611,-74.776708)"
2017,Septiembre,Reino Unido de Gran Bretaña e Irlanda del Norte,826,0,10,,10,"(11.247723,-74.213989)"
2017,Septiembre,Reino Unido de Gran Bretaña e Irlanda del Norte,826,69,44,,113,"(3.541112,-76.384584)"
2017,Septiembre,Reino Unido de Gran Bretaña e Irlanda del Norte,826,2002,1505,,3507,"(4.697144,-74.140516)"
2017,Septiembre,Reino Unido de Gran Bretaña e Irlanda del Norte,826,3,1,,4,"(4.815061,-75.736532)"
2017,Septiembre,República CentroÁfricana,140,1,0,,1,"(4.697144,-74.140516)"
2017,Septiembre,Federación de Rusia,643,1,0,,1,"(3.541112,-76.384584)"
2017,Septiembre,Federación de Rusia,643,69,85,,154,"(4.697144,-74.140516)"
2017,Septiembre,República Dominicana,214,5,19,,24,"(10.445761,-75.516429)"
2017,Septiembre,República Dominicana,214,4,11,,15,"(10.886611,-74.776708)"
2017,Septiembre,República Dominicana,214,64,67,,131,"(3.541112,-76.384584)"
2017,Septiembre,República Dominicana,214,1870,1700,,3570,"(4.697144,-74.140516)"
2017,Septiembre,República Dominicana,214,32,33,,65,"(4.815061,-75.736532)"
2017,Septiembre,República Dominicana,214,2,5,,7,"(6.171601,-75.427454)"
2017,Septiembre,República Dominicana,214,50,25,,75,"(7.128456,-73.183637)"
2017,Septiembre,República Democrática Popular de Corea,408,1,1,,2,"(4.697144,-74.140516)"
2017,Septiembre,Rumania,642,3,1,,4,"(4.697144,-74.140516)"
2017,Septiembre,Rwanda,646,0,1,,1,"(4.697144,-74.140516)"
2017,Septiembre,San  Vicente y las Granadinas,670,0,3,,3,"(4.697144,-74.140516)"
2017,Septiembre,Santa Lucia,662,0,1,,1,"(4.697144,-74.140516)"
2017,Septiembre,Serbia,688,3,1,,4,"(4.697144,-74.140516)"
2017,Septiembre,Sierra Leona,694,0,2,,2,"(4.697144,-74.140516)"
2017,Septiembre,Singapur,702,0,1,,1,"(10.886611,-74.776708)"
2017,Septiembre,Singapur,702,2,0,,2,"(3.541112,-76.384584)"
2017,Septiembre,Singapur,702,5,10,,15,"(4.697144,-74.140516)"
2017,Septiembre,Singapur,702,0,1,,1,"(4.815061,-75.736532)"
2017,Septiembre,Sudáfrica,710,11,10,,21,"(4.697144,-74.140516)"
2017,Septiembre,Sudán,736,1,0,,1,"(4.697144,-74.140516)"
2017,Septiembre,Suecia,752,4,0,,4,"(10.445761,-75.516429)"
2017,Septiembre,Suecia,752,11,5,,16,"(3.541112,-76.384584)"
2017,Septiembre,Suecia,752,36,34,,70,"(4.697144,-74.140516)"
2017,Septiembre,Suiza,756,1,2,,3,"(10.445761,-75.516429)"
2017,Septiembre,Suiza,756,4,4,,8,"(10.886611,-74.776708)"
2017,Septiembre,Suiza,756,33,13,,46,"(3.541112,-76.384584)"
2017,Septiembre,Suiza,756,182,129,,311,"(4.697144,-74.140516)"
2017,Septiembre,Suiza,756,4,1,,5,"(4.815061,-75.736532)"
2017,Septiembre,Suiza,756,0,2,,2,"(7.128456,-73.183637)"
2017,Septiembre,Surinam,740,0,2,,2,"(10.886611,-74.776708)"
2017,Septiembre,Surinam,740,1,3,,4,"(4.697144,-74.140516)"
2017,Septiembre,Taiwán,158,0,5,,5,"(4.697144,-74.140516)"
2017,Septiembre,República de Tayikistán,762,1,0,,1,"(4.697144,-74.140516)"
2017,Septiembre,Tailandia,764,3,2,,5,"(3.541112,-76.384584)"
2017,Septiembre,Tailandia,764,19,12,,31,"(4.697144,-74.140516)"
2017,Septiembre,Tailandia,764,1,0,,1,"(4.815061,-75.736532)"
2017,Septiembre,Trinidad y Tobago,780,1,2,,3,"(10.445761,-75.516429)"
2017,Septiembre,Trinidad y Tobago,780,0,1,,1,"(10.886611,-74.776708)"
2017,Septiembre,Trinidad y Tobago,780,6,10,,16,"(3.541112,-76.384584)"
2017,Septiembre,Trinidad y Tobago,780,18,27,,45,"(4.697144,-74.140516)"
2017,Septiembre,Trinidad y Tobago,780,5,5,,10,"(4.815061,-75.736532)"
2017,Septiembre,Trinidad y Tobago,780,4,3,,7,"(7.128456,-73.183637)"
2017,Septiembre,Turquía,792,2,3,,5,"(10.445761,-75.516429)"
2017,Septiembre,Turquía,792,2,2,,4,"(3.541112,-76.384584)"
2017,Septiembre,Turquía,792,1038,516,,1554,"(4.697144,-74.140516)"
2017,Septiembre,Turkmenistán,795,9,6,,15,"(4.697144,-74.140516)"
2017,Septiembre,Ucrania,804,2,12,,14,"(4.697144,-74.140516)"
2017,Septiembre,Uganda,800,0,1,,1,"(4.697144,-74.140516)"
2017,Septiembre,Uruguay,858,2,1,,3,"(10.445761,-75.516429)"
2017,Septiembre,Uruguay,858,4,3,,7,"(10.886611,-74.776708)"
2017,Septiembre,Uruguay,858,6,14,,20,"(3.541112,-76.384584)"
2017,Septiembre,Uruguay,858,243,319,,562,"(4.697144,-74.140516)"
2017,Septiembre,Uruguay,858,5,3,,8,"(4.815061,-75.736532)"
2017,Septiembre,Uzbekistán,860,2,0,,2,"(4.697144,-74.140516)"
2017,Septiembre,Venezuela,862,4,11,,15,"(10.445761,-75.516429)"
2017,Septiembre,Venezuela,862,9,18,,27,"(10.886611,-74.776708)"
2017,Septiembre,Venezuela,862,0,2,,2,"(11.117806,-74.232622)"
2017,Septiembre,Venezuela,862,2534,2192,,4726,"(11.360009,-72.129330)"
2017,Septiembre,Venezuela,862,6,11,,17,"(3.541112,-76.384584)"
2017,Septiembre,Venezuela,862,6,5,,11,"(3.866713,-67.927521)"
2017,Septiembre,Venezuela,862,369,358,,727,"(4.697144,-74.140516)"
2017,Septiembre,Venezuela,862,2,1,,3,"(4.815061,-75.736532)"
2017,Septiembre,Venezuela,862,2,2,,4,"(6.171601,-75.427454)"
2017,Septiembre,Venezuela,862,59,48,,107,"(6.185799,-67.483929)"
2017,Septiembre,Venezuela,862,576,559,,1135,"(7.088729,-70.740253)"
2017,Septiembre,Venezuela,862,0,3,,3,"(7.128456,-73.183637)"
2017,Septiembre,Venezuela,862,1720,1660,,3380,"(7.818934,-72.453226)"
2017,Septiembre,Venezuela,862,117,123,,240,"(8.36068,-72.409396)"
2017,Septiembre,Vietnam,704,0,3,,3,"(3.541112,-76.384584)"
2017,Septiembre,Vietnam,704,6,3,,9,"(4.697144,-74.140516)"
2017,Septiembre,Islas Vírgenes Estadounidenses/Territorio de Estados Unidos,850,2,0,,2,"(3.541112,-76.384584)"
2017,Octubre,Alemania,276,1,1,,2,"(0.814836,-77.662532)"
2017,Octubre,Alemania,276,4,4,,8,"(10.445761,-75.516429)"
2017,Octubre,Alemania,276,55,43,,98,"(3.541112,-76.384584)"
2017,Octubre,Alemania,276,1,0,,1,"(4.452882,-75.766298)"
2017,Octubre,Alemania,276,1305,1327,,2632,"(4.697144,-74.140516)"
2017,Octubre,Alemania,276,3,5,,8,"(4.815061,-75.736532)"
2017,Octubre,Alemania,276,2,0,,2,"(7.128456,-73.183637)"
2017,Octubre,Andorra,20,0,1,,1,"(3.541112,-76.384584)"
2017,Octubre,Antigua y Barbuda,28,0,4,,4,"(4.697144,-74.140516)"
2017,Octubre,Países Bajos,528,137,96,,233,"(10.445761,-75.516429)"
2017,Octubre,Países Bajos,528,2,14,,16,"(10.886611,-74.776708)"
2017,Octubre,Países Bajos,528,53,27,,80,"(3.541112,-76.384584)"
2017,Octubre,Países Bajos,528,526,715,,1241,"(4.697144,-74.140516)"
2017,Octubre,Países Bajos,528,4,5,,9,"(4.815061,-75.736532)"
2017,Octubre,Países Bajos,528,0,2,,2,"(6.171601,-75.427454)"
2017,Octubre,Países Bajos,528,0,1,,1,"(9.402978,-75.681599)"
2017,Octubre,Arabia Saudita,682,1,0,,1,"(3.541112,-76.384584)"
2017,Octubre,Argentina,32,5,4,,9,"(-4.197703,-69.941278)"
2017,Octubre,Argentina,32,0,2,,2,"(0.25129,-76.875963)"
2017,Octubre,Argentina,32,15,27,,42,"(0.814836,-77.662532)"
2017,Octubre,Argentina,32,23,14,,37,"(10.445761,-75.516429)"
2017,Octubre,Argentina,32,7,64,,71,"(10.886611,-74.776708)"
2017,Octubre,Argentina,32,152,151,,303,"(3.541112,-76.384584)"
2017,Octubre,Argentina,32,2849,2745,,5594,"(4.697144,-74.140516)"
2017,Octubre,Argentina,32,11,16,,27,"(4.815061,-75.736532)"
2017,Octubre,Argentina,32,0,2,,2,"(6.171601,-75.427454)"
2017,Octubre,Argentina,32,2,5,,7,"(7.128456,-73.183637)"
2017,Octubre,Aruba,533,1672,1197,,2869,"(10.408582,-75.538003)"
2017,Octubre,Aruba,533,6,4,,10,"(10.445761,-75.516429)"
2017,Octubre,Aruba,533,1,1,,2,"(10.886611,-74.776708)"
2017,Octubre,Aruba,533,0,2,,2,"(11.247723,-74.213989)"
2017,Octubre,Aruba,533,6,5,,11,"(11.528919,-72.919681)"
2017,Octubre,Aruba,533,0,17,,17,"(12.165168,-71.983761)"
2017,Octubre,Aruba,533,41,26,,67,"(3.541112,-76.384584)"
2017,Octubre,Aruba,533,2080,1615,,3695,"(4.697144,-74.140516)"
2017,Octubre,Aruba,533,11,6,,17,"(4.815061,-75.736532)"
2017,Octubre,Aruba,533,19,41,,60,"(7.128456,-73.183637)"
2017,Octubre,Australia,36,13,12,,25,"(3.541112,-76.384584)"
2017,Octubre,Australia,36,1,0,,1,"(4.452882,-75.766298)"
2017,Octubre,Australia,36,3,1,,4,"(4.815061,-75.736532)"
2017,Octubre,Australia,36,1,3,,4,"(7.128456,-73.183637)"
2017,Octubre,Austria,40,1,0,,1,"(10.445761,-75.516429)"
2017,Octubre,Austria,40,4,4,,8,"(3.541112,-76.384584)"
2017,Octubre,Bahamas,44,11,15,,26,"(10.408582,-75.538003)"
2017,Octubre,Bahamas,44,1,1,,2,"(10.445761,-75.516429)"
2017,Octubre,Bahamas,44,11,2,,13,"(3.541112,-76.384584)"
2017,Octubre,Bahamas,44,7,1,,8,"(4.815061,-75.736532)"
2017,Octubre,Bahréin,48,0,1,,1,"(10.445761,-75.516429)"
2017,Octubre,Bangladesh,50,0,1,,1,"(3.541112,-76.384584)"
2017,Octubre,Barbados,52,0,1,,1,"(3.541112,-76.384584)"
2017,Octubre,República de Belarús,112,1,0,,1,"(11.360009,-72.129330)"
2017,Octubre,República de Belarús,112,0,1,,1,"(7.818934,-72.453226)"
2017,Octubre,Bélgica,56,1,1,,2,"(10.445761,-75.516429)"
2017,Octubre,Bélgica,56,15,10,,25,"(3.541112,-76.384584)"
2017,Octubre,Bélgica,56,2,0,,2,"(7.128456,-73.183637)"
2017,Octubre,Bolivia,68,9,9,,18,"(0.814836,-77.662532)"
2017,Octubre,Bolivia,68,3,3,,6,"(10.445761,-75.516429)"
2017,Octubre,Bolivia,68,27,60,,87,"(3.541112,-76.384584)"
2017,Octubre,Bolivia,68,132,231,,363,"(4.697144,-74.140516)"
2017,Octubre,Bolivia,68,5,5,,10,"(4.815061,-75.736532)"
2017,Octubre,Bolivia,68,0,4,,4,"(7.128456,-73.183637)"
2017,Octubre,Brasil,76,126,221,,347,"(-4.197703,-69.941278)"
2017,Octubre,Brasil,76,2,10,,12,"(-4.223468,-69.945098)"
2017,Octubre,Brasil,76,1,2,,3,"(0.814836,-77.662532)"
2017,Octubre,Brasil,76,8,6,,14,"(10.445761,-75.516429)"
2017,Octubre,Brasil,76,149,191,,340,"(3.541112,-76.384584)"
2017,Octubre,Brasil,76,0,2,,2,"(3.866713,-67.927521)"
2017,Octubre,Brasil,76,2494,3184,,5678,"(4.697144,-74.140516)"
2017,Octubre,Brasil,76,15,30,,45,"(4.815061,-75.736532)"
2017,Octubre,Brasil,76,4,6,,10,"(7.128456,-73.183637)"
2017,Octubre,Islas Caimán/Territorio Británico de Ultramar,136,3,0,,3,"(3.541112,-76.384584)"
2017,Octubre,Islas Caimán/Territorio Británico de Ultramar,136,0,1,,1,"(4.697144,-74.140516)"
2017,Octubre,Camerún,120,0,1,,1,"(3.541112,-76.384584)"
2017,Octubre,Canadá,124,14,8,,22,"(10.445761,-75.516429)"
2017,Octubre,Canadá,124,1,5,,6,"(10.886611,-74.776708)"
2017,Octubre,Canadá,124,148,109,,257,"(3.541112,-76.384584)"
2017,Octubre,Canadá,124,1098,962,,2060,"(4.697144,-74.140516)"
2017,Octubre,Canadá,124,12,12,,24,"(4.815061,-75.736532)"
2017,Octubre,Canadá,124,1,7,,8,"(6.171601,-75.427454)"
2017,Octubre,Canadá,124,5,5,,10,"(7.128456,-73.183637)"
2017,Octubre,España,724,14,7,,21,"(10.445761,-75.516429)"
2017,Octubre,España,724,2895,2102,,4997,"(3.541112,-76.384584)"
2017,Octubre,España,724,12065,9161,,21226,"(4.697144,-74.140516)"
2017,Octubre,España,724,24,19,,43,"(4.815061,-75.736532)"
2017,Octubre,España,724,1303,855,,2158,"(6.171601,-75.427454)"
2017,Octubre,España,724,3,3,,6,"(7.128456,-73.183637)"
2017,Octubre,Colombia,170,2,8,,10,"(10.445761,-75.516429)"
2017,Octubre,Colombia,170,1300,1152,,2452,"(10.886611,-74.776708)"
2017,Octubre,Colombia,170,1,0,,1,"(3.541112,-76.384584)"
2017,Octubre,Colombia,170,4092,3878,,7970,"(4.697144,-74.140516)"
2017,Octubre,Colombia,170,2078,1890,,3968,"(6.171601,-75.427454)"
2017,Octubre,República de Corea,410,2,0,,2,"(3.541112,-76.384584)"
2017,Octubre,Costa de Marfil,384,0,1,,1,"(10.408582,-75.538003)"
2017,Octubre,Costa Rica,188,417,326,,743,"(10.408582,-75.538003)"
2017,Octubre,Costa Rica,188,12,16,,28,"(10.445761,-75.516429)"
2017,Octubre,Costa Rica,188,0,3,,3,"(10.886611,-74.776708)"
2017,Octubre,Costa Rica,188,0,11,,11,"(11.247723,-74.213989)"
2017,Octubre,Costa Rica,188,2,18,,20,"(12.5744111,-81.703935)"
2017,Octubre,Costa Rica,188,63,79,,142,"(3.541112,-76.384584)"
2017,Octubre,Costa Rica,188,917,1103,,2020,"(4.697144,-74.140516)"
2017,Octubre,Costa Rica,188,22,20,,42,"(4.815061,-75.736532)"
2017,Octubre,Costa Rica,188,1,18,,19,"(6.171601,-75.427454)"
2017,Octubre,Costa Rica,188,0,5,,5,"(7.128456,-73.183637)"
2017,Octubre,Croacia,191,0,1,,1,"(3.541112,-76.384584)"
2017,Octubre,Cuba,192,15,15,,30,"(10.445761,-75.516429)"
2017,Octubre,Cuba,192,112,79,,191,"(3.541112,-76.384584)"
2017,Octubre,Cuba,192,849,714,,1563,"(4.697144,-74.140516)"
2017,Octubre,Cuba,192,12,20,,32,"(4.815061,-75.736532)"
2017,Octubre,Cuba,192,33,17,,50,"(7.128456,-73.183637)"
2017,Octubre,Curazao,99999,5,38,,43,"(4.697144,-74.140516)"
2017,Octubre,Chile,152,158,173,,331,"(0.814836,-77.662532)"
2017,Octubre,Chile,152,19,18,,37,"(10.445761,-75.516429)"
2017,Octubre,Chile,152,288,191,,479,"(3.541112,-76.384584)"
2017,Octubre,Chile,152,4072,3517,,7589,"(4.697144,-74.140516)"
2017,Octubre,Chile,152,45,27,,72,"(4.815061,-75.736532)"
2017,Octubre,Chile,152,4,8,,12,"(7.128456,-73.183637)"
2017,Octubre,China,156,0,2,,2,"(10.445761,-75.516429)"
2017,Octubre,China,156,20,39,,59,"(3.541112,-76.384584)"
2017,Octubre,China,156,0,1,,1,"(4.815061,-75.736532)"
2017,Octubre,China,156,2,1,,3,"(7.128456,-73.183637)"
2017,Octubre,Dinamarca,208,3,0,,3,"(10.445761,-75.516429)"
2017,Octubre,Dinamarca,208,3,0,,3,"(3.541112,-76.384584)"
2017,Octubre,Dominica,212,0,1,,1,"(3.541112,-76.384584)"
2017,Octubre,Ecuador,218,0,2,,2,"(-0.193180,-74.784874)"
2017,Octubre,Ecuador,218,529,899,,1428,"(0.25129,-76.875963)"
2017,Octubre,Ecuador,218,13,32,,45,"(0.812436,-77.847006)"
2017,Octubre,Ecuador,218,5574,6859,,12433,"(0.814836,-77.662532)"
2017,Octubre,Ecuador,218,142,170,,312,"(1.813928,-78.763924)"
2017,Octubre,Ecuador,218,0,4,,4,"(10.408582,-75.538003)"
2017,Octubre,Ecuador,218,1,9,,10,"(10.445761,-75.516429)"
2017,Octubre,Ecuador,218,919,812,,1731,"(10.886611,-74.776708)"
2017,Octubre,Ecuador,218,322,435,,757,"(3.541112,-76.384584)"
2017,Octubre,Ecuador,218,0,1,,1,"(3.893038,-77.067921)"
2017,Octubre,Ecuador,218,2574,3800,,6374,"(4.697144,-74.140516)"
2017,Octubre,Ecuador,218,7,12,,19,"(4.815061,-75.736532)"
2017,Octubre,Ecuador,218,4,26,,30,"(6.171601,-75.427454)"
2017,Octubre,Ecuador,218,2,2,,4,"(7.128456,-73.183637)"
2017,Octubre,Egipto,818,0,2,,2,"(3.541112,-76.384584)"
2017,Octubre,El Salvador,222,0,3,,3,"(10.445761,-75.516429)"
2017,Octubre,El Salvador,222,72,115,,187,"(3.541112,-76.384584)"
2017,Octubre,El Salvador,222,3171,3289,,6460,"(4.697144,-74.140516)"
2017,Octubre,El Salvador,222,4,2,,6,"(4.815061,-75.736532)"
2017,Octubre,El Salvador,222,1512,1411,,2923,"(6.171601,-75.427454)"
2017,Octubre,El Salvador,222,2,1,,3,"(7.128456,-73.183637)"
2017,Octubre,Emiratos Árabes,784,3,2,,5,"(10.445761,-75.516429)"
2017,Octubre,Emiratos Árabes,784,1,7,,8,"(3.541112,-76.384584)"
2017,Octubre,Emiratos Árabes,784,1,1,,2,"(7.128456,-73.183637)"
2017,Octubre,Estados Unidos de América,840,1,5,,6,"(10.408582,-75.538003)"
2017,Octubre,Estados Unidos de América,840,2792,2190,,4982,"(10.445761,-75.516429)"
2017,Octubre,Estados Unidos de América,840,19,23,,42,"(10.886611,-74.776708)"
2017,Octubre,Estados Unidos de América,840,4857,3588,,8445,"(3.541112,-76.384584)"
2017,Octubre,Estados Unidos de América,840,896,743,,1639,"(4.452882,-75.766298)"
2017,Octubre,Estados Unidos de América,840,27580,24971,,52551,"(4.697144,-74.140516)"
2017,Octubre,Estados Unidos de América,840,770,514,,1284,"(4.815061,-75.736532)"
2017,Octubre,Estados Unidos de América,840,2,2,,4,"(6.17134,-75.427194)"
2017,Octubre,Estados Unidos de América,840,7934,6649,,14583,"(6.171601,-75.427454)"
2017,Octubre,Estados Unidos de América,840,239,170,,409,"(7.128456,-73.183637)"
2017,Octubre,Filipinas,608,1,0,,1,"(3.541112,-76.384584)"
2017,Octubre,Finlandia,246,1,0,,1,"(0.814836,-77.662532)"
2017,Octubre,Francia,250,8,4,,12,"(10.445761,-75.516429)"
2017,Octubre,Francia,250,78,44,,122,"(3.541112,-76.384584)"
2017,Octubre,Francia,250,2,1,,3,"(4.452882,-75.766298)"
2017,Octubre,Francia,250,1581,1489,,3070,"(4.697144,-74.140516)"
2017,Octubre,Francia,250,5,5,,10,"(4.815061,-75.736532)"
2017,Octubre,Francia,250,1,0,,1,"(7.128456,-73.183637)"
2017,Octubre,Gibraltar/Territorio Británico de Ultramar,292,1,7,,8,"(0.814836,-77.662532)"
2017,Octubre,Granada,308,0,1,,1,"(4.697144,-74.140516)"
2017,Octubre,Guatemala,320,5,10,,15,"(10.445761,-75.516429)"
2017,Octubre,Guatemala,320,79,138,,217,"(3.541112,-76.384584)"
2017,Octubre,Guatemala,320,12,19,,31,"(4.815061,-75.736532)"
2017,Octubre,Guatemala,320,1,1,,2,"(6.171601,-75.427454)"
2017,Octubre,Guatemala,320,8,7,,15,"(7.128456,-73.183637)"
2017,Octubre,Guyana,328,0,1,,1,"(3.541112,-76.384584)"
2017,Octubre,Guyana,328,0,1,,1,"(4.815061,-75.736532)"
2017,Octubre,Haití,332,0,1,,1,"(10.445761,-75.516429)"
2017,Octubre,Haití,332,0,4,,4,"(3.541112,-76.384584)"
2017,Octubre,Haití,332,1,0,,1,"(4.815061,-75.736532)"
2017,Octubre,Honduras,340,3,148,,151,"(10.408582,-75.538003)"
2017,Octubre,Honduras,340,6,3,,9,"(10.445761,-75.516429)"
2017,Octubre,Honduras,340,0,3,,3,"(13.3387613,-81.372937)"
2017,Octubre,Honduras,340,22,27,,49,"(3.541112,-76.384584)"
2017,Octubre,Honduras,340,0,2,,2,"(4.697144,-74.140516)"
2017,Octubre,Honduras,340,1,5,,6,"(4.815061,-75.736532)"
2017,Octubre,Honduras,340,3,8,,11,"(7.128456,-73.183637)"
2017,Octubre,Hong Kong,344,2,3,,5,"(3.541112,-76.384584)"
2017,Octubre,India,356,1,0,,1,"(10.445761,-75.516429)"
2017,Octubre,India,356,11,8,,19,"(3.541112,-76.384584)"
2017,Octubre,Iraq,368,0,1,,1,"(7.128456,-73.183637)"
2017,Octubre,República de Irlanda,372,2,1,,3,"(3.541112,-76.384584)"
2017,Octubre,Islandia,352,1,0,,1,"(3.541112,-76.384584)"
2017,Octubre,Israel,376,5,9,,14,"(3.541112,-76.384584)"
2017,Octubre,Israel,376,1,0,,1,"(4.815061,-75.736532)"
2017,Octubre,Italia,380,13,10,,23,"(10.445761,-75.516429)"
2017,Octubre,Italia,380,85,48,,133,"(3.541112,-76.384584)"
2017,Octubre,Italia,380,1,5,,6,"(4.815061,-75.736532)"
2017,Octubre,Italia,380,1,2,,3,"(7.128456,-73.183637)"
2017,Octubre,Jamaica,388,625,445,,1070,"(10.408582,-75.538003)"
2017,Octubre,Jamaica,388,1,3,,4,"(10.445761,-75.516429)"
2017,Octubre,Jamaica,388,3,6,,9,"(3.541112,-76.384584)"
2017,Octubre,Jamaica,388,0,2,,2,"(4.697144,-74.140516)"
2017,Octubre,Jamaica,388,2,2,,4,"(4.815061,-75.736532)"
2017,Octubre,Jamaica,388,0,2,,2,"(6.17134,-75.427194)"
2017,Octubre,Jamaica,388,3,2,,5,"(7.128456,-73.183637)"
2017,Octubre,Japón,392,3,4,,7,"(3.541112,-76.384584)"
2017,Octubre,Kenia,404,0,2,,2,"(3.541112,-76.384584)"
2017,Octubre,Kuwait,414,0,1,,1,"(3.541112,-76.384584)"
2017,Octubre,Líbano,422,2,2,,4,"(3.541112,-76.384584)"
2017,Octubre,Luxemburgo,442,0,1,,1,"(3.541112,-76.384584)"
2017,Octubre,Luxemburgo,442,1,1,,2,"(4.697144,-74.140516)"
2017,Octubre,Luxemburgo,442,1,3,,4,"(4.815061,-75.736532)"
2017,Octubre,Malta,470,0,1,,1,"(3.541112,-76.384584)"
2017,Octubre,Marruecos,504,2,1,,3,"(3.541112,-76.384584)"
2017,Octubre,México,484,71,82,,153,"(10.445761,-75.516429)"
2017,Octubre,México,484,916,766,,1682,"(3.541112,-76.384584)"
2017,Octubre,México,484,14486,13215,,27701,"(4.697144,-74.140516)"
2017,Octubre,México,484,280,218,,498,"(4.815061,-75.736532)"
2017,Octubre,México,484,1,1,,2,"(6.171601,-75.427454)"
2017,Octubre,México,484,214,158,,372,"(7.128456,-73.183637)"
2017,Octubre,Mozambique,508,1,0,,1,"(3.541112,-76.384584)"
2017,Octubre,Nicaragua,558,0,3,,3,"(12.5744111,-81.703935)"
2017,Octubre,Nicaragua,558,17,45,,62,"(3.541112,-76.384584)"
2017,Octubre,Nicaragua,558,10,6,,16,"(4.815061,-75.736532)"
2017,Octubre,Noruega,578,2,1,,3,"(10.445761,-75.516429)"
2017,Octubre,Noruega,578,2,2,,4,"(3.541112,-76.384584)"
2017,Octubre,Nueva Zelanda,554,0,1,,1,"(3.541112,-76.384584)"
2017,Octubre,Panamá,591,171,235,,406,"(10.408582,-75.538003)"
2017,Octubre,Panamá,591,1010,1010,,2020,"(10.445761,-75.516429)"
2017,Octubre,Panamá,591,1996,1882,,3878,"(10.886611,-74.776708)"
2017,Octubre,Panamá,591,0,2,,2,"(10.971302,-74.765397)"
2017,Octubre,Panamá,591,1,14,,15,"(12.165168,-71.983761)"
2017,Octubre,Panamá,591,2,15,,17,"(12.5744111,-81.703935)"
2017,Octubre,Panamá,591,156,123,,279,"(12.586067,-81.702563)"
2017,Octubre,Panamá,591,0,1,,1,"(13.3387613,-81.372937)"
2017,Octubre,Panamá,591,2257,1902,,4159,"(3.541112,-76.384584)"
2017,Octubre,Panamá,591,283,192,,475,"(4.452882,-75.766298)"
2017,Octubre,Panamá,591,12286,13009,,25295,"(4.697144,-74.140516)"
2017,Octubre,Panamá,591,426,348,,774,"(4.815061,-75.736532)"
2017,Octubre,Panamá,591,7862,7095,,14957,"(6.171601,-75.427454)"
2017,Octubre,Panamá,591,1,8,,9,"(6.228046,-77.404104)"
2017,Octubre,Panamá,591,7,16,,23,"(7.102626,-77.762647)"
2017,Octubre,Panamá,591,182,177,,359,"(7.128456,-73.183637)"
2017,Octubre,Panamá,591,0,48,,48,"(8.066966,-76.735404)"
2017,Octubre,Panamá,591,18,44,,62,"(8.635765,-77.346578)"
2017,Octubre,Paraguay,600,1,1,,2,"(10.445761,-75.516429)"
2017,Octubre,Paraguay,600,3,4,,7,"(10.886611,-74.776708)"
2017,Octubre,Paraguay,600,24,49,,73,"(3.541112,-76.384584)"
2017,Octubre,Paraguay,600,0,34,,34,"(4.697144,-74.140516)"
2017,Octubre,Paraguay,600,9,31,,40,"(4.815061,-75.736532)"
2017,Octubre,Paraguay,600,4,5,,9,"(7.128456,-73.183637)"
2017,Octubre,Perú,604,4,11,,15,"(-0.193180,-74.784874)"
2017,Octubre,Perú,604,101,131,,232,"(-4.197703,-69.941278)"
2017,Octubre,Perú,604,18,41,,59,"(-4.223468,-69.945098)"
2017,Octubre,Perú,604,0,1,,1,"(0.25129,-76.875963)"
2017,Octubre,Perú,604,68,101,,169,"(0.814836,-77.662532)"
2017,Octubre,Perú,604,1,0,,1,"(1.813928,-78.763924)"
2017,Octubre,Perú,604,82,93,,175,"(10.445761,-75.516429)"
2017,Octubre,Perú,604,0,2,,2,"(10.886611,-74.776708)"
2017,Octubre,Perú,604,306,425,,731,"(3.541112,-76.384584)"
2017,Octubre,Perú,604,6388,7455,,13843,"(4.697144,-74.140516)"
2017,Octubre,Perú,604,7,9,,16,"(4.815061,-75.736532)"
2017,Octubre,Perú,604,0,10,,10,"(6.171601,-75.427454)"
2017,Octubre,Perú,604,6,5,,11,"(7.128456,-73.183637)"
2017,Octubre,Polonia,616,0,1,,1,"(3.541112,-76.384584)"
2017,Octubre,Portugal,620,0,2,,2,"(10.445761,-75.516429)"
2017,Octubre,Portugal,620,5,0,,5,"(3.541112,-76.384584)"
2017,Octubre,Portugal,620,41,62,,103,"(4.697144,-74.140516)"
2017,Octubre,Puerto Rico/Territorio de Estados Unidos,630,5,2,,7,"(10.445761,-75.516429)"
2017,Octubre,Puerto Rico/Territorio de Estados Unidos,630,0,6,,6,"(10.971302,-74.765397)"
2017,Octubre,Puerto Rico/Territorio de Estados Unidos,630,26,22,,48,"(3.541112,-76.384584)"
2017,Octubre,Puerto Rico/Territorio de Estados Unidos,630,15,11,,26,"(4.697144,-74.140516)"
2017,Octubre,Puerto Rico/Territorio de Estados Unidos,630,5,2,,7,"(4.815061,-75.736532)"
2017,Octubre,Puerto Rico/Territorio de Estados Unidos,630,5,3,,8,"(7.128456,-73.183637)"
2017,Octubre,Reino Unido de Gran Bretaña e Irlanda del Norte,826,0,3,,3,"(10.445761,-75.516429)"
2017,Octubre,Reino Unido de Gran Bretaña e Irlanda del Norte,826,19,19,,38,"(3.541112,-76.384584)"
2017,Octubre,Reino Unido de Gran Bretaña e Irlanda del Norte,826,1327,1163,,2490,"(4.697144,-74.140516)"
2017,Octubre,Reino Unido de Gran Bretaña e Irlanda del Norte,826,1,0,,1,"(7.128456,-73.183637)"
2017,Octubre,Federación de Rusia,643,0,2,,2,"(3.541112,-76.384584)"
2017,Octubre,República Dominicana,214,4,3,,7,"(10.408582,-75.538003)"
2017,Octubre,República Dominicana,214,22,41,,63,"(10.445761,-75.516429)"
2017,Octubre,República Dominicana,214,2,2,,4,"(10.886611,-74.776708)"
2017,Octubre,República Dominicana,214,13,10,,23,"(11.117806,-74.232622)"
2017,Octubre,República Dominicana,214,111,110,,221,"(3.541112,-76.384584)"
2017,Octubre,República Dominicana,214,2587,2259,,4846,"(4.697144,-74.140516)"
2017,Octubre,República Dominicana,214,57,56,,113,"(4.815061,-75.736532)"
2017,Octubre,República Dominicana,214,36,31,,67,"(7.128456,-73.183637)"
2017,Octubre,San Cristóbal y Nevis,659,0,1,,1,"(3.541112,-76.384584)"
2017,Octubre,San  Vicente y las Granadinas,670,0,1,,1,"(4.697144,-74.140516)"
2017,Octubre,Singapur,702,1,1,,2,"(10.445761,-75.516429)"
2017,Octubre,Singapur,702,0,2,,2,"(3.541112,-76.384584)"
2017,Octubre,Suecia,752,11,5,,16,"(3.541112,-76.384584)"
2017,Octubre,Suecia,752,1,0,,1,"(7.128456,-73.183637)"
2017,Octubre,Suiza,756,8,3,,11,"(10.445761,-75.516429)"
2017,Octubre,Suiza,756,30,19,,49,"(3.541112,-76.384584)"
2017,Octubre,Suiza,756,1,0,,1,"(4.697144,-74.140516)"
2017,Octubre,Suiza,756,2,1,,3,"(4.815061,-75.736532)"
2017,Octubre,Surinam,740,0,11,,11,"(10.408582,-75.538003)"
2017,Octubre,Surinam,740,0,1,,1,"(7.128456,-73.183637)"
2017,Octubre,Tailandia,764,4,0,,4,"(3.541112,-76.384584)"
2017,Octubre,Tanzania,834,0,1,,1,"(3.541112,-76.384584)"
2017,Octubre,Trinidad y Tobago,780,2,5,,7,"(10.445761,-75.516429)"
2017,Octubre,Trinidad y Tobago,780,1,15,,16,"(3.541112,-76.384584)"
2017,Octubre,Trinidad y Tobago,780,0,1,,1,"(4.815061,-75.736532)"
2017,Octubre,Trinidad y Tobago,780,0,2,,2,"(7.128456,-73.183637)"
2017,Octubre,Turquía,792,0,2,,2,"(3.541112,-76.384584)"
2017,Octubre,Turquía,792,934,580,,1514,"(4.697144,-74.140516)"
2017,Octubre,Uruguay,858,32,31,,63,"(3.541112,-76.384584)"
2017,Octubre,Uruguay,858,238,309,,547,"(4.697144,-74.140516)"
2017,Octubre,Uruguay,858,5,5,,10,"(4.815061,-75.736532)"
2017,Octubre,Venezuela,862,5,5,,10,"(10.445761,-75.516429)"
2017,Octubre,Venezuela,862,2,8,,10,"(10.886611,-74.776708)"
2017,Octubre,Venezuela,862,1,0,,1,"(11.117806,-74.232622)"
2017,Octubre,Venezuela,862,2462,2484,,4946,"(11.360009,-72.129330)"
2017,Octubre,Venezuela,862,0,2,,2,"(12.165168,-71.983761)"
2017,Octubre,Venezuela,862,8,22,,30,"(3.541112,-76.384584)"
2017,Octubre,Venezuela,862,6,7,,13,"(3.866713,-67.927521)"
2017,Octubre,Venezuela,862,256,260,,516,"(4.697144,-74.140516)"
2017,Octubre,Venezuela,862,2,1,,3,"(4.815061,-75.736532)"
2017,Octubre,Venezuela,862,2,1,,3,"(6.171601,-75.427454)"
2017,Octubre,Venezuela,862,55,58,,113,"(6.185799,-67.483929)"
2017,Octubre,Venezuela,862,810,650,,1460,"(7.088729,-70.740253)"
2017,Octubre,Venezuela,862,2,4,,6,"(7.128456,-73.183637)"
2017,Octubre,Venezuela,862,2193,2023,,4216,"(7.818934,-72.453226)"
2017,Octubre,Venezuela,862,0,5,,5,"(7.927209,-72.507910)"
2017,Octubre,Venezuela,862,92,132,,224,"(8.36068,-72.409396)"
2017,Noviembre,Afganistán,4,0,3,,3,"(4.697144,-74.140516)"
2017,Noviembre,Albania,8,1,4,,5,"(4.697144,-74.140516)"
2017,Noviembre,Alemania,276,8,7,,15,"(10.445761,-75.516429)"
2017,Noviembre,Alemania,276,5,3,,8,"(10.886611,-74.776708)"
2017,Noviembre,Alemania,276,36,25,,61,"(3.541112,-76.384584)"
2017,Noviembre,Alemania,276,871,953,,1824,"(4.697144,-74.140516)"
2017,Noviembre,Alemania,276,39,43,,82,"(6.171601,-75.427454)"
2017,Noviembre,Angola,24,2,9,,11,"(4.697144,-74.140516)"
2017,Noviembre,Países Bajos,528,84,59,,143,"(10.445761,-75.516429)"
2017,Noviembre,Países Bajos,528,23,19,,42,"(10.886611,-74.776708)"
2017,Noviembre,Países Bajos,528,40,14,,54,"(3.541112,-76.384584)"
2017,Noviembre,Países Bajos,528,769,694,,1463,"(4.697144,-74.140516)"
2017,Noviembre,Países Bajos,528,5,3,,8,"(4.815061,-75.736532)"
2017,Noviembre,Países Bajos,528,109,70,,179,"(6.171601,-75.427454)"
2017,Noviembre,Países Bajos,528,1,0,,1,"(7.128456,-73.183637)"
2017,Noviembre,Arabia Saudita,682,5,24,,29,"(4.697144,-74.140516)"
2017,Noviembre,Arabia Saudita,682,1,0,,1,"(6.171601,-75.427454)"
2017,Noviembre,Arabia Saudita,682,0,1,,1,"(7.128456,-73.183637)"
2017,Noviembre,Argelia,12,0,1,,1,"(3.541112,-76.384584)"
2017,Noviembre,Argelia,12,0,4,,4,"(4.697144,-74.140516)"
2017,Noviembre,Argentina,32,1,1,,2,"(0.25129,-76.875963)"
2017,Noviembre,Argentina,32,12,21,,33,"(0.814836,-77.662532)"
2017,Noviembre,Argentina,32,25,26,,51,"(10.445761,-75.516429)"
2017,Noviembre,Argentina,32,35,24,,59,"(10.886611,-74.776708)"
2017,Noviembre,Argentina,32,162,195,,357,"(3.541112,-76.384584)"
2017,Noviembre,Argentina,32,3127,3080,,6207,"(4.697144,-74.140516)"
2017,Noviembre,Argentina,32,31,37,,68,"(4.815061,-75.736532)"
2017,Noviembre,Argentina,32,143,165,,308,"(6.171601,-75.427454)"
2017,Noviembre,Argentina,32,1,3,,4,"(7.128456,-73.183637)"
2017,Noviembre,Aruba,533,70,45,,115,"(10.408582,-75.538003)"
2017,Noviembre,Aruba,533,2,1,,3,"(10.445761,-75.516429)"
2017,Noviembre,Aruba,533,24,18,,42,"(10.886611,-74.776708)"
2017,Noviembre,Aruba,533,0,4,,4,"(10.971302,-74.765397)"
2017,Noviembre,Aruba,533,3,5,,8,"(11.117806,-74.232622)"
2017,Noviembre,Aruba,533,0,7,,7,"(12.165168,-71.983761)"
2017,Noviembre,Aruba,533,44,40,,84,"(3.541112,-76.384584)"
2017,Noviembre,Aruba,533,1903,1481,,3384,"(4.697144,-74.140516)"
2017,Noviembre,Aruba,533,7,5,,12,"(4.815061,-75.736532)"
2017,Noviembre,Aruba,533,109,69,,178,"(6.171601,-75.427454)"
2017,Noviembre,Aruba,533,8,27,,35,"(7.128456,-73.183637)"
2017,Noviembre,Australia,36,3,1,,4,"(10.445761,-75.516429)"
2017,Noviembre,Australia,36,0,2,,2,"(10.886611,-74.776708)"
2017,Noviembre,Australia,36,18,18,,36,"(3.541112,-76.384584)"
2017,Noviembre,Australia,36,1,1,,2,"(4.452882,-75.766298)"
2017,Noviembre,Australia,36,293,207,,500,"(4.697144,-74.140516)"
2017,Noviembre,Australia,36,1,2,,3,"(4.815061,-75.736532)"
2017,Noviembre,Australia,36,38,24,,62,"(6.171601,-75.427454)"
2017,Noviembre,Australia,36,3,1,,4,"(7.128456,-73.183637)"
2017,Noviembre,Austria,40,1,0,,1,"(10.886611,-74.776708)"
2017,Noviembre,Austria,40,2,2,,4,"(3.541112,-76.384584)"
2017,Noviembre,Austria,40,22,15,,37,"(4.697144,-74.140516)"
2017,Noviembre,Austria,40,3,2,,5,"(6.171601,-75.427454)"
2017,Noviembre,Azerbaiyán,31,1,2,,3,"(4.697144,-74.140516)"
2017,Noviembre,Bahamas,44,1,0,,1,"(10.886611,-74.776708)"
2017,Noviembre,Bahamas,44,0,1,,1,"(12.586067,-81.702563)"
2017,Noviembre,Bahamas,44,11,3,,14,"(3.541112,-76.384584)"
2017,Noviembre,Bahamas,44,9,8,,17,"(4.697144,-74.140516)"
2017,Noviembre,Bahamas,44,2,1,,3,"(4.815061,-75.736532)"
2017,Noviembre,Bahamas,44,15,15,,30,"(6.171601,-75.427454)"
2017,Noviembre,Bahréin,48,1,1,,2,"(3.541112,-76.384584)"
2017,Noviembre,Bahréin,48,2,6,,8,"(4.697144,-74.140516)"
2017,Noviembre,Bahréin,48,0,1,,1,"(6.171601,-75.427454)"
2017,Noviembre,Bahréin,48,1,0,,1,"(7.818934,-72.453226)"
2017,Noviembre,Bangladesh,50,0,2,,2,"(4.697144,-74.140516)"
2017,Noviembre,Barbados,52,1,0,,1,"(10.886611,-74.776708)"
2017,Noviembre,Barbados,52,3,1,,4,"(4.697144,-74.140516)"
2017,Noviembre,Barbados,52,1,2,,3,"(6.171601,-75.427454)"
2017,Noviembre,República de Belarús,112,0,1,,1,"(11.360009,-72.129330)"
2017,Noviembre,República de Belarús,112,1,0,,1,"(7.818934,-72.453226)"
2017,Noviembre,Bélgica,56,1,2,,3,"(10.886611,-74.776708)"
2017,Noviembre,Bélgica,56,6,3,,9,"(3.541112,-76.384584)"
2017,Noviembre,Bélgica,56,58,38,,96,"(4.697144,-74.140516)"
2017,Noviembre,Bélgica,56,3,0,,3,"(4.815061,-75.736532)"
2017,Noviembre,Bélgica,56,9,8,,17,"(6.171601,-75.427454)"
2017,Noviembre,Belice,84,1,2,,3,"(3.541112,-76.384584)"
2017,Noviembre,Belice,84,7,3,,10,"(4.697144,-74.140516)"
2017,Noviembre,Belice,84,5,1,,6,"(6.171601,-75.427454)"
2017,Noviembre,Benín,204,0,2,,2,"(3.541112,-76.384584)"
2017,Noviembre,Benín,204,0,1,,1,"(4.697144,-74.140516)"
2017,Noviembre,Bolivia,68,5,12,,17,"(0.814836,-77.662532)"
2017,Noviembre,Bolivia,68,1,2,,3,"(10.445761,-75.516429)"
2017,Noviembre,Bolivia,68,1,1,,2,"(10.886611,-74.776708)"
2017,Noviembre,Bolivia,68,23,36,,59,"(3.541112,-76.384584)"
2017,Noviembre,Bolivia,68,293,440,,733,"(4.697144,-74.140516)"
2017,Noviembre,Bolivia,68,4,7,,11,"(4.815061,-75.736532)"
2017,Noviembre,Bolivia,68,23,33,,56,"(6.171601,-75.427454)"
2017,Noviembre,Bolivia,68,1,1,,2,"(7.128456,-73.183637)"
2017,Noviembre,Brasil,76,85,190,,275,"(-4.197703,-69.941278)"
2017,Noviembre,Brasil,76,7,22,,29,"(-4.223468,-69.945098)"
2017,Noviembre,Brasil,76,0,4,,4,"(0.814836,-77.662532)"
2017,Noviembre,Brasil,76,6,12,,18,"(10.445761,-75.516429)"
2017,Noviembre,Brasil,76,18,22,,40,"(10.886611,-74.776708)"
2017,Noviembre,Brasil,76,1,1,,2,"(12.586067,-81.702563)"
2017,Noviembre,Brasil,76,164,206,,370,"(3.541112,-76.384584)"
2017,Noviembre,Brasil,76,2534,3406,,5940,"(4.697144,-74.140516)"
2017,Noviembre,Brasil,76,33,38,,71,"(4.815061,-75.736532)"
2017,Noviembre,Brasil,76,234,282,,516,"(6.171601,-75.427454)"
2017,Noviembre,Brasil,76,1,7,,8,"(7.128456,-73.183637)"
2017,Noviembre,Bulgaria,100,1,1,,2,"(4.697144,-74.140516)"
2017,Noviembre,Islas Caimán/Territorio Británico de Ultramar,136,2,2,,4,"(12.586067,-81.702563)"
2017,Noviembre,Islas Caimán/Territorio Británico de Ultramar,136,1,0,,1,"(3.541112,-76.384584)"
2017,Noviembre,Islas Caimán/Territorio Británico de Ultramar,136,2,4,,6,"(4.697144,-74.140516)"
2017,Noviembre,Islas Caimán/Territorio Británico de Ultramar,136,1,0,,1,"(4.815061,-75.736532)"
2017,Noviembre,Islas Caimán/Territorio Británico de Ultramar,136,3,1,,4,"(6.171601,-75.427454)"
2017,Noviembre,Camboya,116,1,0,,1,"(4.697144,-74.140516)"
2017,Noviembre,Camboya,116,1,0,,1,"(4.815061,-75.736532)"
2017,Noviembre,Canadá,124,11,4,,15,"(10.445761,-75.516429)"
2017,Noviembre,Canadá,124,43,21,,64,"(10.886611,-74.776708)"
2017,Noviembre,Canadá,124,92,74,,166,"(3.541112,-76.384584)"
2017,Noviembre,Canadá,124,1183,942,,2125,"(4.697144,-74.140516)"
2017,Noviembre,Canadá,124,5,3,,8,"(4.815061,-75.736532)"
2017,Noviembre,Canadá,124,172,136,,308,"(6.171601,-75.427454)"
2017,Noviembre,Canadá,124,5,4,,9,"(7.128456,-73.183637)"
2017,Noviembre,Chad,148,0,1,,1,"(10.445761,-75.516429)"
2017,Noviembre,España,724,11,5,,16,"(10.445761,-75.516429)"
2017,Noviembre,España,724,7,6,,13,"(10.886611,-74.776708)"
2017,Noviembre,España,724,2510,1799,,4309,"(3.541112,-76.384584)"
2017,Noviembre,España,724,10293,8170,,18463,"(4.697144,-74.140516)"
2017,Noviembre,España,724,7,8,,15,"(4.815061,-75.736532)"
2017,Noviembre,España,724,917,655,,1572,"(6.171601,-75.427454)"
2017,Noviembre,España,724,5,0,,5,"(7.128456,-73.183637)"
2017,Noviembre,Colombia,170,2,6,,8,"(10.445761,-75.516429)"
2017,Noviembre,Colombia,170,1249,1441,,2690,"(4.697144,-74.140516)"
2017,Noviembre,Colombia,170,20,12,,32,"(6.171601,-75.427454)"
2017,Noviembre,República Del Congo,178,0,1,,1,"(4.697144,-74.140516)"
2017,Noviembre,República Democrática del Congo,180,0,1,,1,"(4.697144,-74.140516)"
2017,Noviembre,República de Corea,410,1,1,,2,"(3.541112,-76.384584)"
2017,Noviembre,República de Corea,410,14,28,,42,"(4.697144,-74.140516)"
2017,Noviembre,República de Corea,410,1,6,,7,"(6.171601,-75.427454)"
2017,Noviembre,Costa de Marfil,384,1,1,,2,"(4.697144,-74.140516)"
2017,Noviembre,Costa Rica,188,9,8,,17,"(10.445761,-75.516429)"
2017,Noviembre,Costa Rica,188,30,31,,61,"(10.886611,-74.776708)"
2017,Noviembre,Costa Rica,188,2,18,,20,"(12.5744111,-81.703935)"
2017,Noviembre,Costa Rica,188,1,1,,2,"(12.586067,-81.702563)"
2017,Noviembre,Costa Rica,188,59,67,,126,"(3.541112,-76.384584)"
2017,Noviembre,Costa Rica,188,1016,1280,,2296,"(4.697144,-74.140516)"
2017,Noviembre,Costa Rica,188,8,20,,28,"(4.815061,-75.736532)"
2017,Noviembre,Costa Rica,188,160,154,,314,"(6.171601,-75.427454)"
2017,Noviembre,Costa Rica,188,5,4,,9,"(7.128456,-73.183637)"
2017,Noviembre,Costa Rica,188,1,0,,1,"(8.066966,-76.735404)"
2017,Noviembre,Cuba,192,8,5,,13,"(10.445761,-75.516429)"
2017,Noviembre,Cuba,192,22,17,,39,"(10.886611,-74.776708)"
2017,Noviembre,Cuba,192,89,85,,174,"(3.541112,-76.384584)"
2017,Noviembre,Cuba,192,979,828,,1807,"(4.697144,-74.140516)"
2017,Noviembre,Cuba,192,29,16,,45,"(4.815061,-75.736532)"
2017,Noviembre,Cuba,192,129,92,,221,"(6.171601,-75.427454)"
2017,Noviembre,Cuba,192,6,5,,11,"(7.128456,-73.183637)"
2017,Noviembre,Curazao,99999,20,59,,79,"(4.697144,-74.140516)"
2017,Noviembre,República Checa,203,4,10,,14,"(4.697144,-74.140516)"
2017,Noviembre,República Checa,203,0,1,,1,"(6.171601,-75.427454)"
2017,Noviembre,Chile,152,0,3,,3,"(0.25129,-76.875963)"
2017,Noviembre,Chile,152,207,182,,389,"(0.814836,-77.662532)"
2017,Noviembre,Chile,152,0,1,,1,"(1.813928,-78.763924)"
2017,Noviembre,Chile,152,25,20,,45,"(10.445761,-75.516429)"
2017,Noviembre,Chile,152,28,20,,48,"(10.886611,-74.776708)"
2017,Noviembre,Chile,152,271,205,,476,"(3.541112,-76.384584)"
2017,Noviembre,Chile,152,4217,3767,,7984,"(4.697144,-74.140516)"
2017,Noviembre,Chile,152,71,70,,141,"(4.815061,-75.736532)"
2017,Noviembre,Chile,152,177,164,,341,"(6.171601,-75.427454)"
2017,Noviembre,Chile,152,7,10,,17,"(7.128456,-73.183637)"
2017,Noviembre,China,156,0,1,,1,"(10.445761,-75.516429)"
2017,Noviembre,China,156,0,2,,2,"(10.886611,-74.776708)"
2017,Noviembre,China,156,2,7,,9,"(3.541112,-76.384584)"
2017,Noviembre,China,156,65,230,,295,"(4.697144,-74.140516)"
2017,Noviembre,China,156,0,1,,1,"(4.815061,-75.736532)"
2017,Noviembre,China,156,10,34,,44,"(6.171601,-75.427454)"
2017,Noviembre,China,156,1,1,,2,"(7.128456,-73.183637)"
2017,Noviembre,Chipre,196,1,0,,1,"(4.697144,-74.140516)"
2017,Noviembre,Chipre,196,0,1,,1,"(6.171601,-75.427454)"
2017,Noviembre,Dinamarca,208,2,0,,2,"(10.445761,-75.516429)"
2017,Noviembre,Dinamarca,208,18,11,,29,"(4.697144,-74.140516)"
2017,Noviembre,Dinamarca,208,6,0,,6,"(6.171601,-75.427454)"
2017,Noviembre,Ecuador,218,1,3,,4,"(-0.193180,-74.784874)"
2017,Noviembre,Ecuador,218,503,820,,1323,"(0.25129,-76.875963)"
2017,Noviembre,Ecuador,218,15,22,,37,"(0.812436,-77.847006)"
2017,Noviembre,Ecuador,218,5174,5818,,10992,"(0.814836,-77.662532)"
2017,Noviembre,Ecuador,218,164,197,,361,"(1.813928,-78.763924)"
2017,Noviembre,Ecuador,218,1,2,,3,"(10.445761,-75.516429)"
2017,Noviembre,Ecuador,218,89,77,,166,"(10.886611,-74.776708)"
2017,Noviembre,Ecuador,218,1,0,,1,"(11.360009,-72.129330)"
2017,Noviembre,Ecuador,218,344,551,,895,"(3.541112,-76.384584)"
2017,Noviembre,Ecuador,218,2578,4068,,6646,"(4.697144,-74.140516)"
2017,Noviembre,Ecuador,218,9,7,,16,"(4.815061,-75.736532)"
2017,Noviembre,Ecuador,218,57,77,,134,"(6.171601,-75.427454)"
2017,Noviembre,Ecuador,218,0,3,,3,"(7.128456,-73.183637)"
2017,Noviembre,Egipto,818,0,2,,2,"(3.541112,-76.384584)"
2017,Noviembre,Egipto,818,17,12,,29,"(4.697144,-74.140516)"
2017,Noviembre,Egipto,818,2,1,,3,"(6.171601,-75.427454)"
2017,Noviembre,El Salvador,222,1,0,,1,"(10.445761,-75.516429)"
2017,Noviembre,El Salvador,222,14,9,,23,"(10.886611,-74.776708)"
2017,Noviembre,El Salvador,222,80,96,,176,"(3.541112,-76.384584)"
2017,Noviembre,El Salvador,222,1412,1714,,3126,"(4.697144,-74.140516)"
2017,Noviembre,El Salvador,222,3,1,,4,"(4.815061,-75.736532)"
2017,Noviembre,El Salvador,222,128,160,,288,"(6.171601,-75.427454)"
2017,Noviembre,Emiratos Árabes,784,1,2,,3,"(10.445761,-75.516429)"
2017,Noviembre,Emiratos Árabes,784,1,2,,3,"(10.886611,-74.776708)"
2017,Noviembre,Emiratos Árabes,784,6,3,,9,"(3.541112,-76.384584)"
2017,Noviembre,Emiratos Árabes,784,85,211,,296,"(4.697144,-74.140516)"
2017,Noviembre,Emiratos Árabes,784,10,4,,14,"(6.171601,-75.427454)"
2017,Noviembre,Eritrea,232,1,1,,2,"(4.697144,-74.140516)"
2017,Noviembre,Eslovaquia,703,1,2,,3,"(4.697144,-74.140516)"
2017,Noviembre,Eslovenia,705,1,2,,3,"(3.541112,-76.384584)"
2017,Noviembre,Eslovenia,705,2,1,,3,"(4.697144,-74.140516)"
2017,Noviembre,Estados Unidos de América,840,1,2,,3,"(10.408582,-75.538003)"
2017,Noviembre,Estados Unidos de América,840,2804,2154,,4958,"(10.445761,-75.516429)"
2017,Noviembre,Estados Unidos de América,840,2809,2117,,4926,"(10.886611,-74.776708)"
2017,Noviembre,Estados Unidos de América,840,6,2,,8,"(11.117806,-74.232622)"
2017,Noviembre,Estados Unidos de América,840,59,32,,91,"(12.586067,-81.702563)"
2017,Noviembre,Estados Unidos de América,840,4815,3243,,8058,"(3.541112,-76.384584)"
2017,Noviembre,Estados Unidos de América,840,692,478,,1170,"(4.452882,-75.766298)"
2017,Noviembre,Estados Unidos de América,840,31889,27025,,58914,"(4.697144,-74.140516)"
2017,Noviembre,Estados Unidos de América,840,651,413,,1064,"(4.815061,-75.736532)"
2017,Noviembre,Estados Unidos de América,840,10036,7758,,17794,"(6.171601,-75.427454)"
2017,Noviembre,Estados Unidos de América,840,235,157,,392,"(7.128456,-73.183637)"
2017,Noviembre,Estonia,233,2,1,,3,"(4.697144,-74.140516)"
2017,Noviembre,Etiopia,231,1,1,,2,"(3.541112,-76.384584)"
2017,Noviembre,Etiopia,231,1,1,,2,"(4.697144,-74.140516)"
2017,Noviembre,Filipinas,608,0,1,,1,"(10.408582,-75.538003)"
2017,Noviembre,Filipinas,608,1,0,,1,"(10.445761,-75.516429)"
2017,Noviembre,Filipinas,608,0,1,,1,"(3.541112,-76.384584)"
2017,Noviembre,Filipinas,608,0,2,,2,"(4.697144,-74.140516)"
2017,Noviembre,Filipinas,608,1,3,,4,"(6.171601,-75.427454)"
2017,Noviembre,Finlandia,246,1,3,,4,"(3.541112,-76.384584)"
2017,Noviembre,Finlandia,246,4,6,,10,"(4.697144,-74.140516)"
2017,Noviembre,Finlandia,246,2,1,,3,"(6.171601,-75.427454)"
2017,Noviembre,Francia,250,4,3,,7,"(10.445761,-75.516429)"
2017,Noviembre,Francia,250,7,2,,9,"(10.886611,-74.776708)"
2017,Noviembre,Francia,250,56,39,,95,"(3.541112,-76.384584)"
2017,Noviembre,Francia,250,1078,935,,2013,"(4.697144,-74.140516)"
2017,Noviembre,Francia,250,4,6,,10,"(4.815061,-75.736532)"
2017,Noviembre,Francia,250,69,47,,116,"(6.171601,-75.427454)"
2017,Noviembre,Francia,250,2,0,,2,"(7.128456,-73.183637)"
2017,Noviembre,Ghana,288,0,1,,1,"(4.697144,-74.140516)"
2017,Noviembre,Gibraltar/Territorio Británico de Ultramar,292,1,0,,1,"(0.814836,-77.662532)"
2017,Noviembre,Grecia,300,10,5,,15,"(4.697144,-74.140516)"
2017,Noviembre,Grecia,300,1,0,,1,"(6.171601,-75.427454)"
2017,Noviembre,Guatemala,320,5,7,,12,"(10.445761,-75.516429)"
2017,Noviembre,Guatemala,320,9,10,,19,"(10.886611,-74.776708)"
2017,Noviembre,Guatemala,320,0,3,,3,"(11.117806,-74.232622)"
2017,Noviembre,Guatemala,320,0,1,,1,"(12.586067,-81.702563)"
2017,Noviembre,Guatemala,320,88,117,,205,"(3.541112,-76.384584)"
2017,Noviembre,Guatemala,320,216,286,,502,"(4.697144,-74.140516)"
2017,Noviembre,Guatemala,320,19,22,,41,"(4.815061,-75.736532)"
2017,Noviembre,Guatemala,320,139,189,,328,"(6.171601,-75.427454)"
2017,Noviembre,Guatemala,320,7,11,,18,"(7.128456,-73.183637)"
2017,Noviembre,Guyana,328,3,0,,3,"(10.886611,-74.776708)"
2017,Noviembre,Guyana,328,0,2,,2,"(3.541112,-76.384584)"
2017,Noviembre,Guyana,328,0,1,,1,"(4.697144,-74.140516)"
2017,Noviembre,Guyana,328,0,1,,1,"(6.171601,-75.427454)"
2017,Noviembre,Guinea Ecuatorial,226,1,1,,2,"(4.697144,-74.140516)"
2017,Noviembre,Guadalupe/Territorio Francés,312,1,0,,1,"(4.697144,-74.140516)"
2017,Noviembre,Haití,332,0,2,,2,"(10.886611,-74.776708)"
2017,Noviembre,Haití,332,1,1,,2,"(3.541112,-76.384584)"
2017,Noviembre,Haití,332,0,2,,2,"(4.697144,-74.140516)"
2017,Noviembre,Haití,332,0,1,,1,"(4.815061,-75.736532)"
2017,Noviembre,Haití,332,1,5,,6,"(6.171601,-75.427454)"
2017,Noviembre,Honduras,340,0,8,,8,"(10.408582,-75.538003)"
2017,Noviembre,Honduras,340,4,4,,8,"(10.445761,-75.516429)"
2017,Noviembre,Honduras,340,4,9,,13,"(10.886611,-74.776708)"
2017,Noviembre,Honduras,340,0,3,,3,"(12.5744111,-81.703935)"
2017,Noviembre,Honduras,340,0,3,,3,"(12.586067,-81.702563)"
2017,Noviembre,Honduras,340,10,24,,34,"(3.541112,-76.384584)"
2017,Noviembre,Honduras,340,55,126,,181,"(4.697144,-74.140516)"
2017,Noviembre,Honduras,340,1,5,,6,"(4.815061,-75.736532)"
2017,Noviembre,Honduras,340,36,64,,100,"(6.171601,-75.427454)"
2017,Noviembre,Honduras,340,1,1,,2,"(7.128456,-73.183637)"
2017,Noviembre,Hong Kong,344,0,1,,1,"(3.541112,-76.384584)"
2017,Noviembre,Hong Kong,344,20,29,,49,"(4.697144,-74.140516)"
2017,Noviembre,Hong Kong,344,0,4,,4,"(6.171601,-75.427454)"
2017,Noviembre,Hungría,348,1,0,,1,"(3.541112,-76.384584)"
2017,Noviembre,Hungría,348,4,2,,6,"(4.697144,-74.140516)"
2017,Noviembre,Hungría,348,1,0,,1,"(6.171601,-75.427454)"
2017,Noviembre,India,356,0,3,,3,"(10.886611,-74.776708)"
2017,Noviembre,India,356,1,5,,6,"(3.541112,-76.384584)"
2017,Noviembre,India,356,36,32,,68,"(4.697144,-74.140516)"
2017,Noviembre,India,356,7,12,,19,"(6.171601,-75.427454)"
2017,Noviembre,India,356,2,0,,2,"(7.128456,-73.183637)"
2017,Noviembre,Indonesia,360,4,12,,16,"(4.697144,-74.140516)"
2017,Noviembre,Indonesia,360,0,1,,1,"(6.171601,-75.427454)"
2017,Noviembre,Iraq,368,1,0,,1,"(3.541112,-76.384584)"
2017,Noviembre,Iraq,368,0,1,,1,"(4.697144,-74.140516)"
2017,Noviembre,Iraq,368,0,1,,1,"(6.171601,-75.427454)"
2017,Noviembre,Irán,364,3,2,,5,"(4.697144,-74.140516)"
2017,Noviembre,República de Irlanda,372,1,0,,1,"(3.541112,-76.384584)"
2017,Noviembre,República de Irlanda,372,16,3,,19,"(4.697144,-74.140516)"
2017,Noviembre,República de Irlanda,372,3,0,,3,"(6.171601,-75.427454)"
2017,Noviembre,Islandia,352,3,1,,4,"(4.697144,-74.140516)"
2017,Noviembre,Israel,376,6,2,,8,"(3.541112,-76.384584)"
2017,Noviembre,Israel,376,71,65,,136,"(4.697144,-74.140516)"
2017,Noviembre,Israel,376,6,1,,7,"(6.171601,-75.427454)"
2017,Noviembre,Israel,376,2,2,,4,"(7.128456,-73.183637)"
2017,Noviembre,Italia,380,4,0,,4,"(10.445761,-75.516429)"
2017,Noviembre,Italia,380,2,1,,3,"(10.886611,-74.776708)"
2017,Noviembre,Italia,380,74,29,,103,"(3.541112,-76.384584)"
2017,Noviembre,Italia,380,364,282,,646,"(4.697144,-74.140516)"
2017,Noviembre,Italia,380,1,1,,2,"(4.815061,-75.736532)"
2017,Noviembre,Italia,380,71,43,,114,"(6.171601,-75.427454)"
2017,Noviembre,Italia,380,0,2,,2,"(7.128456,-73.183637)"
2017,Noviembre,Jamaica,388,2326,1617,,3943,"(10.408582,-75.538003)"
2017,Noviembre,Jamaica,388,1,8,,9,"(10.445761,-75.516429)"
2017,Noviembre,Jamaica,388,1,1,,2,"(10.886611,-74.776708)"
2017,Noviembre,Jamaica,388,5,4,,9,"(3.541112,-76.384584)"
2017,Noviembre,Jamaica,388,13,19,,32,"(4.697144,-74.140516)"
2017,Noviembre,Jamaica,388,4,2,,6,"(4.815061,-75.736532)"
2017,Noviembre,Jamaica,388,1,3,,4,"(6.17134,-75.427194)"
2017,Noviembre,Jamaica,388,8,8,,16,"(6.171601,-75.427454)"
2017,Noviembre,Jamaica,388,1,0,,1,"(7.128456,-73.183637)"
2017,Noviembre,Japón,392,0,1,,1,"(10.886611,-74.776708)"
2017,Noviembre,Japón,392,4,2,,6,"(3.541112,-76.384584)"
2017,Noviembre,Japón,392,33,46,,79,"(4.697144,-74.140516)"
2017,Noviembre,Japón,392,1,0,,1,"(4.815061,-75.736532)"
2017,Noviembre,Japón,392,4,0,,4,"(6.171601,-75.427454)"
2017,Noviembre,Jordania,400,0,2,,2,"(4.697144,-74.140516)"
2017,Noviembre,Kenia,404,0,1,,1,"(10.445761,-75.516429)"
2017,Noviembre,Kenia,404,1,0,,1,"(10.886611,-74.776708)"
2017,Noviembre,Kenia,404,3,0,,3,"(3.541112,-76.384584)"
2017,Noviembre,Kenia,404,1,1,,2,"(4.697144,-74.140516)"
2017,Noviembre,Kuwait,414,0,1,,1,"(3.541112,-76.384584)"
2017,Noviembre,Lituania,440,0,1,,1,"(4.697144,-74.140516)"
2017,Noviembre,Líbano,422,5,2,,7,"(4.697144,-74.140516)"
2017,Noviembre,Luxemburgo,442,1,1,,2,"(4.697144,-74.140516)"
2017,Noviembre,Malasia,458,0,2,,2,"(3.541112,-76.384584)"
2017,Noviembre,Malasia,458,6,14,,20,"(4.697144,-74.140516)"
2017,Noviembre,Malasia,458,0,1,,1,"(6.171601,-75.427454)"
2017,Noviembre,Malasia,458,0,2,,2,"(7.128456,-73.183637)"
2017,Noviembre,Malta,470,10,5,,15,"(4.697144,-74.140516)"
2017,Noviembre,Malta,470,2,2,,4,"(6.171601,-75.427454)"
2017,Noviembre,Marruecos,504,8,3,,11,"(4.697144,-74.140516)"
2017,Noviembre,Marruecos,504,1,0,,1,"(6.171601,-75.427454)"
2017,Noviembre,Mauritania,478,0,1,,1,"(4.697144,-74.140516)"
2017,Noviembre,México,484,70,54,,124,"(10.445761,-75.516429)"
2017,Noviembre,México,484,139,135,,274,"(10.886611,-74.776708)"
2017,Noviembre,México,484,1,2,,3,"(12.586067,-81.702563)"
2017,Noviembre,México,484,911,746,,1657,"(3.541112,-76.384584)"
2017,Noviembre,México,484,13617,12444,,26061,"(4.697144,-74.140516)"
2017,Noviembre,México,484,202,161,,363,"(4.815061,-75.736532)"
2017,Noviembre,México,484,2424,2019,,4443,"(6.171601,-75.427454)"
2017,Noviembre,México,484,151,122,,273,"(7.128456,-73.183637)"
2017,Noviembre,Mónaco,492,0,1,,1,"(4.697144,-74.140516)"
2017,Noviembre,Mozambique,508,1,2,,3,"(4.697144,-74.140516)"
2017,Noviembre,Nicaragua,558,2,1,,3,"(10.445761,-75.516429)"
2017,Noviembre,Nicaragua,558,5,7,,12,"(10.886611,-74.776708)"
2017,Noviembre,Nicaragua,558,0,2,,2,"(12.586067,-81.702563)"
2017,Noviembre,Nicaragua,558,13,38,,51,"(3.541112,-76.384584)"
2017,Noviembre,Nicaragua,558,40,73,,113,"(4.697144,-74.140516)"
2017,Noviembre,Nicaragua,558,7,6,,13,"(4.815061,-75.736532)"
2017,Noviembre,Nicaragua,558,15,41,,56,"(6.171601,-75.427454)"
2017,Noviembre,Nigeria,566,0,4,,4,"(4.697144,-74.140516)"
2017,Noviembre,Noruega,578,1,2,,3,"(3.541112,-76.384584)"
2017,Noviembre,Noruega,578,8,6,,14,"(4.697144,-74.140516)"
2017,Noviembre,Noruega,578,1,1,,2,"(6.171601,-75.427454)"
2017,Noviembre,Nueva Caledonia/Territorio francés,540,1,0,,1,"(4.697144,-74.140516)"
2017,Noviembre,Nueva Zelanda,554,1,0,,1,"(3.541112,-76.384584)"
2017,Noviembre,Nueva Zelanda,554,20,20,,40,"(4.697144,-74.140516)"
2017,Noviembre,Nueva Zelanda,554,2,0,,2,"(6.171601,-75.427454)"
2017,Noviembre,Omán,512,3,4,,7,"(4.697144,-74.140516)"
2017,Noviembre,Omán,512,2,3,,5,"(6.171601,-75.427454)"
2017,Noviembre,Pakistán,586,0,1,,1,"(4.697144,-74.140516)"
2017,Noviembre,Panamá,591,18,84,,102,"(10.408582,-75.538003)"
2017,Noviembre,Panamá,591,1007,893,,1900,"(10.445761,-75.516429)"
2017,Noviembre,Panamá,591,957,935,,1892,"(10.886611,-74.776708)"
2017,Noviembre,Panamá,591,1,0,,1,"(10.971302,-74.765397)"
2017,Noviembre,Panamá,591,0,7,,7,"(12.165168,-71.983761)"
2017,Noviembre,Panamá,591,2,10,,12,"(12.5744111,-81.703935)"
2017,Noviembre,Panamá,591,101,97,,198,"(12.586067,-81.702563)"
2017,Noviembre,Panamá,591,2,2,,4,"(13.3387613,-81.372937)"
2017,Noviembre,Panamá,591,1993,1719,,3712,"(3.541112,-76.384584)"
2017,Noviembre,Panamá,591,321,205,,526,"(4.452882,-75.766298)"
2017,Noviembre,Panamá,591,8641,9629,,18270,"(4.697144,-74.140516)"
2017,Noviembre,Panamá,591,432,323,,755,"(4.815061,-75.736532)"
2017,Noviembre,Panamá,591,0,3,,3,"(6.17134,-75.427194)"
2017,Noviembre,Panamá,591,3623,3258,,6881,"(6.171601,-75.427454)"
2017,Noviembre,Panamá,591,8,10,,18,"(6.228046,-77.404104)"
2017,Noviembre,Panamá,591,9,14,,23,"(7.102626,-77.762647)"
2017,Noviembre,Panamá,591,222,204,,426,"(7.128456,-73.183637)"
2017,Noviembre,Panamá,591,0,28,,28,"(8.066966,-76.735404)"
2017,Noviembre,Panamá,591,18,40,,58,"(8.635765,-77.346578)"
2017,Noviembre,Paraguay,600,4,3,,7,"(10.445761,-75.516429)"
2017,Noviembre,Paraguay,600,1,11,,12,"(10.886611,-74.776708)"
2017,Noviembre,Paraguay,600,0,1,,1,"(12.586067,-81.702563)"
2017,Noviembre,Paraguay,600,27,42,,69,"(3.541112,-76.384584)"
2017,Noviembre,Paraguay,600,51,145,,196,"(4.697144,-74.140516)"
2017,Noviembre,Paraguay,600,18,23,,41,"(4.815061,-75.736532)"
2017,Noviembre,Paraguay,600,18,38,,56,"(6.171601,-75.427454)"
2017,Noviembre,Paraguay,600,0,1,,1,"(7.128456,-73.183637)"
2017,Noviembre,Perú,604,4,6,,10,"(-0.193180,-74.784874)"
2017,Noviembre,Perú,604,66,71,,137,"(-4.197703,-69.941278)"
2017,Noviembre,Perú,604,34,132,,166,"(-4.223468,-69.945098)"
2017,Noviembre,Perú,604,1,2,,3,"(0.25129,-76.875963)"
2017,Noviembre,Perú,604,104,106,,210,"(0.814836,-77.662532)"
2017,Noviembre,Perú,604,1,3,,4,"(1.813928,-78.763924)"
2017,Noviembre,Perú,604,62,61,,123,"(10.445761,-75.516429)"
2017,Noviembre,Perú,604,11,16,,27,"(10.886611,-74.776708)"
2017,Noviembre,Perú,604,0,1,,1,"(12.586067,-81.702563)"
2017,Noviembre,Perú,604,268,339,,607,"(3.541112,-76.384584)"
2017,Noviembre,Perú,604,5812,6447,,12259,"(4.697144,-74.140516)"
2017,Noviembre,Perú,604,8,12,,20,"(4.815061,-75.736532)"
2017,Noviembre,Perú,604,350,409,,759,"(6.171601,-75.427454)"
2017,Noviembre,Perú,604,1,5,,6,"(7.128456,-73.183637)"
2017,Noviembre,Polonia,616,0,1,,1,"(10.886611,-74.776708)"
2017,Noviembre,Polonia,616,0,2,,2,"(3.541112,-76.384584)"
2017,Noviembre,Polonia,616,3,8,,11,"(4.697144,-74.140516)"
2017,Noviembre,Portugal,620,1,0,,1,"(10.445761,-75.516429)"
2017,Noviembre,Portugal,620,0,1,,1,"(10.886611,-74.776708)"
2017,Noviembre,Portugal,620,4,3,,7,"(3.541112,-76.384584)"
2017,Noviembre,Portugal,620,70,115,,185,"(4.697144,-74.140516)"
2017,Noviembre,Portugal,620,8,9,,17,"(6.171601,-75.427454)"
2017,Noviembre,Puerto Rico/Territorio de Estados Unidos,630,5,4,,9,"(10.445761,-75.516429)"
2017,Noviembre,Puerto Rico/Territorio de Estados Unidos,630,4,12,,16,"(10.886611,-74.776708)"
2017,Noviembre,Puerto Rico/Territorio de Estados Unidos,630,21,15,,36,"(3.541112,-76.384584)"
2017,Noviembre,Puerto Rico/Territorio de Estados Unidos,630,200,186,,386,"(4.697144,-74.140516)"
2017,Noviembre,Puerto Rico/Territorio de Estados Unidos,630,2,3,,5,"(4.815061,-75.736532)"
2017,Noviembre,Puerto Rico/Territorio de Estados Unidos,630,24,21,,45,"(6.171601,-75.427454)"
2017,Noviembre,Puerto Rico/Territorio de Estados Unidos,630,0,2,,2,"(7.128456,-73.183637)"
2017,Noviembre,Qatar,634,1,0,,1,"(3.541112,-76.384584)"
2017,Noviembre,Qatar,634,4,6,,10,"(4.697144,-74.140516)"
2017,Noviembre,Qatar,634,3,0,,3,"(6.171601,-75.427454)"
2017,Noviembre,Reino Unido de Gran Bretaña e Irlanda del Norte,826,1,0,,1,"(10.445761,-75.516429)"
2017,Noviembre,Reino Unido de Gran Bretaña e Irlanda del Norte,826,1,1,,2,"(10.886611,-74.776708)"
2017,Noviembre,Reino Unido de Gran Bretaña e Irlanda del Norte,826,25,9,,34,"(3.541112,-76.384584)"
2017,Noviembre,Reino Unido de Gran Bretaña e Irlanda del Norte,826,1153,1028,,2181,"(4.697144,-74.140516)"
2017,Noviembre,Reino Unido de Gran Bretaña e Irlanda del Norte,826,28,8,,36,"(6.171601,-75.427454)"
2017,Noviembre,República CentroÁfricana,140,0,1,,1,"(4.697144,-74.140516)"
2017,Noviembre,Federación de Rusia,643,0,2,,2,"(10.445761,-75.516429)"
2017,Noviembre,Federación de Rusia,643,1,0,,1,"(3.541112,-76.384584)"
2017,Noviembre,Federación de Rusia,643,6,33,,39,"(4.697144,-74.140516)"
2017,Noviembre,Federación de Rusia,643,1,0,,1,"(6.171601,-75.427454)"
2017,Noviembre,República Dominicana,214,7,11,,18,"(10.445761,-75.516429)"
2017,Noviembre,República Dominicana,214,65,52,,117,"(10.886611,-74.776708)"
2017,Noviembre,República Dominicana,214,18,25,,43,"(11.117806,-74.232622)"
2017,Noviembre,República Dominicana,214,1,0,,1,"(12.586067,-81.702563)"
2017,Noviembre,República Dominicana,214,101,111,,212,"(3.541112,-76.384584)"
2017,Noviembre,República Dominicana,214,2884,2448,,5332,"(4.697144,-74.140516)"
2017,Noviembre,República Dominicana,214,28,25,,53,"(4.815061,-75.736532)"
2017,Noviembre,República Dominicana,214,380,277,,657,"(6.171601,-75.427454)"
2017,Noviembre,República Dominicana,214,15,15,,30,"(7.128456,-73.183637)"
2017,Noviembre,República Democrática Popular de Corea,408,1,1,,2,"(4.697144,-74.140516)"
2017,Noviembre,Rumania,642,1,3,,4,"(4.697144,-74.140516)"
2017,Noviembre,Rwanda,646,0,1,,1,"(4.697144,-74.140516)"
2017,Noviembre,San Marino,674,2,3,,5,"(4.697144,-74.140516)"
2017,Noviembre,San  Vicente y las Granadinas,670,0,1,,1,"(4.697144,-74.140516)"
2017,Noviembre,Senegal,686,0,1,,1,"(4.697144,-74.140516)"
2017,Noviembre,Serbia,688,4,1,,5,"(4.697144,-74.140516)"
2017,Noviembre,Serbia,688,1,0,,1,"(6.171601,-75.427454)"
2017,Noviembre,Singapur,702,35,27,,62,"(4.697144,-74.140516)"
2017,Noviembre,Singapur,702,1,2,,3,"(6.171601,-75.427454)"
2017,Noviembre,Sri Lanka,144,1,0,,1,"(4.697144,-74.140516)"
2017,Noviembre,Sri Lanka,144,1,0,,1,"(6.171601,-75.427454)"
2017,Noviembre,Sudáfrica,710,0,1,,1,"(10.886611,-74.776708)"
2017,Noviembre,Sudáfrica,710,1,2,,3,"(3.541112,-76.384584)"
2017,Noviembre,Sudáfrica,710,7,8,,15,"(4.697144,-74.140516)"
2017,Noviembre,Sudáfrica,710,0,1,,1,"(4.815061,-75.736532)"
2017,Noviembre,Sudáfrica,710,2,0,,2,"(6.171601,-75.427454)"
2017,Noviembre,Suecia,752,2,0,,2,"(10.445761,-75.516429)"
2017,Noviembre,Suecia,752,13,2,,15,"(3.541112,-76.384584)"
2017,Noviembre,Suecia,752,42,33,,75,"(4.697144,-74.140516)"
2017,Noviembre,Suecia,752,1,1,,2,"(4.815061,-75.736532)"
2017,Noviembre,Suecia,752,4,3,,7,"(6.171601,-75.427454)"
2017,Noviembre,Suiza,756,29,15,,44,"(3.541112,-76.384584)"
2017,Noviembre,Suiza,756,130,88,,218,"(4.697144,-74.140516)"
2017,Noviembre,Suiza,756,2,0,,2,"(4.815061,-75.736532)"
2017,Noviembre,Suiza,756,28,16,,44,"(6.171601,-75.427454)"
2017,Noviembre,Suiza,756,1,0,,1,"(7.128456,-73.183637)"
2017,Noviembre,Surinam,740,0,1,,1,"(10.886611,-74.776708)"
2017,Noviembre,Surinam,740,0,4,,4,"(4.697144,-74.140516)"
2017,Noviembre,Surinam,740,0,3,,3,"(6.171601,-75.427454)"
2017,Noviembre,Surinam,740,1,0,,1,"(7.128456,-73.183637)"
2017,Noviembre,Taiwán,158,3,3,,6,"(4.697144,-74.140516)"
2017,Noviembre,Taiwán,158,1,0,,1,"(6.171601,-75.427454)"
2017,Noviembre,Tailandia,764,1,3,,4,"(3.541112,-76.384584)"
2017,Noviembre,Tailandia,764,17,17,,34,"(4.697144,-74.140516)"
2017,Noviembre,Tailandia,764,5,6,,11,"(6.171601,-75.427454)"
2017,Noviembre,Trinidad y Tobago,780,2,1,,3,"(10.445761,-75.516429)"
2017,Noviembre,Trinidad y Tobago,780,3,8,,11,"(10.886611,-74.776708)"
2017,Noviembre,Trinidad y Tobago,780,3,13,,16,"(3.541112,-76.384584)"
2017,Noviembre,Trinidad y Tobago,780,11,23,,34,"(4.697144,-74.140516)"
2017,Noviembre,Trinidad y Tobago,780,1,2,,3,"(4.815061,-75.736532)"
2017,Noviembre,Trinidad y Tobago,780,7,7,,14,"(6.171601,-75.427454)"
2017,Noviembre,Trinidad y Tobago,780,4,1,,5,"(7.128456,-73.183637)"
2017,Noviembre,Túnez,788,1,0,,1,"(4.697144,-74.140516)"
2017,Noviembre,Turquía,792,0,1,,1,"(10.445761,-75.516429)"
2017,Noviembre,Turquía,792,841,468,,1309,"(4.697144,-74.140516)"
2017,Noviembre,Turquía,792,4,3,,7,"(6.171601,-75.427454)"
2017,Noviembre,Turkmenistán,795,2,4,,6,"(4.697144,-74.140516)"
2017,Noviembre,Uruguay,858,2,0,,2,"(0.814836,-77.662532)"
2017,Noviembre,Uruguay,858,2,2,,4,"(10.445761,-75.516429)"
2017,Noviembre,Uruguay,858,0,1,,1,"(10.886611,-74.776708)"
2017,Noviembre,Uruguay,858,22,28,,50,"(3.541112,-76.384584)"
2017,Noviembre,Uruguay,858,408,439,,847,"(4.697144,-74.140516)"
2017,Noviembre,Uruguay,858,9,9,,18,"(4.815061,-75.736532)"
2017,Noviembre,Uruguay,858,37,22,,59,"(6.171601,-75.427454)"
2017,Noviembre,Uruguay,858,0,2,,2,"(7.128456,-73.183637)"
2017,Noviembre,Venezuela,862,0,17,,17,"(10.408582,-75.538003)"
2017,Noviembre,Venezuela,862,7,8,,15,"(10.445761,-75.516429)"
2017,Noviembre,Venezuela,862,7,21,,28,"(10.886611,-74.776708)"
2017,Noviembre,Venezuela,862,0,2,,2,"(11.117806,-74.232622)"
2017,Noviembre,Venezuela,862,2567,2655,,5222,"(11.360009,-72.129330)"
2017,Noviembre,Venezuela,862,0,3,,3,"(11.528919,-72.919681)"
2017,Noviembre,Venezuela,862,0,1,,1,"(12.586067,-81.702563)"
2017,Noviembre,Venezuela,862,5,18,,23,"(3.541112,-76.384584)"
2017,Noviembre,Venezuela,862,6,8,,14,"(3.866713,-67.927521)"
2017,Noviembre,Venezuela,862,601,714,,1315,"(4.697144,-74.140516)"
2017,Noviembre,Venezuela,862,0,2,,2,"(4.815061,-75.736532)"
2017,Noviembre,Venezuela,862,447,445,,892,"(6.171601,-75.427454)"
2017,Noviembre,Venezuela,862,76,62,,138,"(6.185799,-67.483929)"
2017,Noviembre,Venezuela,862,932,841,,1773,"(7.088729,-70.740253)"
2017,Noviembre,Venezuela,862,4,6,,10,"(7.128456,-73.183637)"
2017,Noviembre,Venezuela,862,2440,2253,,4693,"(7.818934,-72.453226)"
2017,Noviembre,Venezuela,862,1,1,,2,"(7.927209,-72.507910)"
2017,Noviembre,Venezuela,862,123,182,,305,"(8.36068,-72.409396)"
2017,Noviembre,Vietnam,704,3,6,,9,"(4.697144,-74.140516)"
2017,Noviembre,República Árabe de Yemen,887,1,0,,1,"(3.541112,-76.384584)"
2017,Diciembre,Afganistán,4,1,3,,4,"(4.697144,-74.140516)"
2017,Diciembre,Albania,8,0,5,,5,"(4.697144,-74.140516)"
2017,Diciembre,Alemania,276,1,1,,2,"(0.814836,-77.662532)"
2017,Diciembre,Alemania,276,12,9,,21,"(10.445761,-75.516429)"
2017,Diciembre,Alemania,276,21,15,,36,"(10.886611,-74.776708)"
2017,Diciembre,Alemania,276,2,0,,2,"(12.586067,-81.702563)"
2017,Diciembre,Alemania,276,67,43,,110,"(3.541112,-76.384584)"
2017,Diciembre,Alemania,276,1130,863,,1993,"(4.697144,-74.140516)"
2017,Diciembre,Alemania,276,1,0,,1,"(4.815061,-75.736532)"
2017,Diciembre,Alemania,276,83,60,,143,"(6.171601,-75.427454)"
2017,Diciembre,Alemania,276,5,3,,8,"(7.128456,-73.183637)"
2017,Diciembre,Angola,24,1,1,,2,"(4.697144,-74.140516)"
2017,Diciembre,Antigua y Barbuda,28,2,1,,3,"(3.541112,-76.384584)"
2017,Diciembre,Antigua y Barbuda,28,5,3,,8,"(4.697144,-74.140516)"
2017,Diciembre,Antigua y Barbuda,28,1,0,,1,"(6.171601,-75.427454)"
2017,Diciembre,Países Bajos,528,0,1,,1,"(10.408582,-75.538003)"
2017,Diciembre,Países Bajos,528,94,61,,155,"(10.445761,-75.516429)"
2017,Diciembre,Países Bajos,528,25,18,,43,"(10.886611,-74.776708)"
2017,Diciembre,Países Bajos,528,122,92,,214,"(3.541112,-76.384584)"
2017,Diciembre,Países Bajos,528,1305,992,,2297,"(4.697144,-74.140516)"
2017,Diciembre,Países Bajos,528,6,3,,9,"(4.815061,-75.736532)"
2017,Diciembre,Países Bajos,528,2,1,,3,"(6.17134,-75.427194)"
2017,Diciembre,Países Bajos,528,241,161,,402,"(6.171601,-75.427454)"
2017,Diciembre,Países Bajos,528,3,10,,13,"(7.128456,-73.183637)"
2017,Diciembre,Arabia Saudita,682,5,19,,24,"(4.697144,-74.140516)"
2017,Diciembre,Arabia Saudita,682,0,1,,1,"(6.171601,-75.427454)"
2017,Diciembre,Arabia Saudita,682,1,2,,3,"(7.128456,-73.183637)"
2017,Diciembre,Argelia,12,3,6,,9,"(4.697144,-74.140516)"
2017,Diciembre,Argentina,32,14,25,,39,"(0.814836,-77.662532)"
2017,Diciembre,Argentina,32,34,29,,63,"(10.445761,-75.516429)"
2017,Diciembre,Argentina,32,33,31,,64,"(10.886611,-74.776708)"
2017,Diciembre,Argentina,32,0,1,,1,"(12.586067,-81.702563)"
2017,Diciembre,Argentina,32,160,136,,296,"(3.541112,-76.384584)"
2017,Diciembre,Argentina,32,4517,3527,,8044,"(4.697144,-74.140516)"
2017,Diciembre,Argentina,32,27,27,,54,"(4.815061,-75.736532)"
2017,Diciembre,Argentina,32,132,104,,236,"(6.171601,-75.427454)"
2017,Diciembre,Argentina,32,1,3,,4,"(7.128456,-73.183637)"
2017,Diciembre,República de Armenia,51,0,1,,1,"(4.697144,-74.140516)"
2017,Diciembre,Aruba,533,1773,1334,,3107,"(10.408582,-75.538003)"
2017,Diciembre,Aruba,533,5,1,,6,"(10.445761,-75.516429)"
2017,Diciembre,Aruba,533,23,19,,42,"(10.886611,-74.776708)"
2017,Diciembre,Aruba,533,0,18,,18,"(12.165168,-71.983761)"
2017,Diciembre,Aruba,533,87,62,,149,"(3.541112,-76.384584)"
2017,Diciembre,Aruba,533,3422,2687,,6109,"(4.697144,-74.140516)"
2017,Diciembre,Aruba,533,6,0,,6,"(4.815061,-75.736532)"
2017,Diciembre,Aruba,533,145,101,,246,"(6.171601,-75.427454)"
2017,Diciembre,Aruba,533,8,28,,36,"(7.128456,-73.183637)"
2017,Diciembre,Australia,36,1,0,,1,"(10.445761,-75.516429)"
2017,Diciembre,Australia,36,10,6,,16,"(3.541112,-76.384584)"
2017,Diciembre,Australia,36,411,278,,689,"(4.697144,-74.140516)"
2017,Diciembre,Australia,36,2,1,,3,"(4.815061,-75.736532)"
2017,Diciembre,Australia,36,72,42,,114,"(6.171601,-75.427454)"
2017,Diciembre,Australia,36,6,2,,8,"(7.128456,-73.183637)"
2017,Diciembre,Austria,40,1,1,,2,"(10.886611,-74.776708)"
2017,Diciembre,Austria,40,6,4,,10,"(3.541112,-76.384584)"
2017,Diciembre,Austria,40,36,28,,64,"(4.697144,-74.140516)"
2017,Diciembre,Austria,40,5,5,,10,"(6.171601,-75.427454)"
2017,Diciembre,Azerbaiyán,31,3,0,,3,"(4.697144,-74.140516)"
2017,Diciembre,Bahamas,44,1,2,,3,"(10.445761,-75.516429)"
2017,Diciembre,Bahamas,44,2,2,,4,"(10.886611,-74.776708)"
2017,Diciembre,Bahamas,44,7,3,,10,"(3.541112,-76.384584)"
2017,Diciembre,Bahamas,44,8,14,,22,"(4.697144,-74.140516)"
2017,Diciembre,Bahamas,44,4,1,,5,"(4.815061,-75.736532)"
2017,Diciembre,Bahamas,44,22,15,,37,"(6.171601,-75.427454)"
2017,Diciembre,Bahamas,44,2,0,,2,"(7.128456,-73.183637)"
2017,Diciembre,Bahréin,48,0,3,,3,"(3.541112,-76.384584)"
2017,Diciembre,Bahréin,48,5,1,,6,"(4.697144,-74.140516)"
2017,Diciembre,Bahréin,48,1,0,,1,"(6.171601,-75.427454)"
2017,Diciembre,Bangladesh,50,1,0,,1,"(3.541112,-76.384584)"
2017,Diciembre,Bangladesh,50,0,1,,1,"(4.697144,-74.140516)"
2017,Diciembre,Barbados,52,1,0,,1,"(10.886611,-74.776708)"
2017,Diciembre,Barbados,52,1,1,,2,"(3.541112,-76.384584)"
2017,Diciembre,Barbados,52,4,3,,7,"(4.697144,-74.140516)"
2017,Diciembre,Barbados,52,2,1,,3,"(6.171601,-75.427454)"
2017,Diciembre,República de Belarús,112,0,1,,1,"(6.171601,-75.427454)"
2017,Diciembre,Bélgica,56,4,0,,4,"(10.445761,-75.516429)"
2017,Diciembre,Bélgica,56,5,0,,5,"(10.886611,-74.776708)"
2017,Diciembre,Bélgica,56,12,5,,17,"(3.541112,-76.384584)"
2017,Diciembre,Bélgica,56,86,54,,140,"(4.697144,-74.140516)"
2017,Diciembre,Bélgica,56,1,0,,1,"(4.815061,-75.736532)"
2017,Diciembre,Bélgica,56,16,14,,30,"(6.171601,-75.427454)"
2017,Diciembre,Belice,84,1,1,,2,"(3.541112,-76.384584)"
2017,Diciembre,Belice,84,5,7,,12,"(4.697144,-74.140516)"
2017,Diciembre,Belice,84,1,0,,1,"(4.815061,-75.736532)"
2017,Diciembre,Belice,84,2,3,,5,"(6.171601,-75.427454)"
2017,Diciembre,Benín,204,3,0,,3,"(4.697144,-74.140516)"
2017,Diciembre,Bermudas/Territorio Británico de Ultramar,60,2,2,,4,"(4.697144,-74.140516)"
2017,Diciembre,Bolivia,68,4,11,,15,"(0.814836,-77.662532)"
2017,Diciembre,Bolivia,68,0,1,,1,"(1.813928,-78.763924)"
2017,Diciembre,Bolivia,68,4,5,,9,"(10.445761,-75.516429)"
2017,Diciembre,Bolivia,68,1,1,,2,"(10.886611,-74.776708)"
2017,Diciembre,Bolivia,68,19,17,,36,"(3.541112,-76.384584)"
2017,Diciembre,Bolivia,68,444,528,,972,"(4.697144,-74.140516)"
2017,Diciembre,Bolivia,68,4,0,,4,"(4.815061,-75.736532)"
2017,Diciembre,Bolivia,68,33,30,,63,"(6.171601,-75.427454)"
2017,Diciembre,Brasil,76,112,144,,256,"(-4.197703,-69.941278)"
2017,Diciembre,Brasil,76,27,25,,52,"(-4.223468,-69.945098)"
2017,Diciembre,Brasil,76,0,1,,1,"(0.814836,-77.662532)"
2017,Diciembre,Brasil,76,2,4,,6,"(1.813928,-78.763924)"
2017,Diciembre,Brasil,76,14,14,,28,"(10.445761,-75.516429)"
2017,Diciembre,Brasil,76,11,19,,30,"(10.886611,-74.776708)"
2017,Diciembre,Brasil,76,0,1,,1,"(12.586067,-81.702563)"
2017,Diciembre,Brasil,76,160,121,,281,"(3.541112,-76.384584)"
2017,Diciembre,Brasil,76,0,1,,1,"(3.866713,-67.927521)"
2017,Diciembre,Brasil,76,4694,4703,,9397,"(4.697144,-74.140516)"
2017,Diciembre,Brasil,76,20,22,,42,"(4.815061,-75.736532)"
2017,Diciembre,Brasil,76,153,156,,309,"(6.171601,-75.427454)"
2017,Diciembre,Brasil,76,1,4,,5,"(7.128456,-73.183637)"
2017,Diciembre,Bulgaria,100,0,4,,4,"(4.697144,-74.140516)"
2017,Diciembre,Bulgaria,100,2,3,,5,"(6.171601,-75.427454)"
2017,Diciembre,Cabo Verde,132,1,0,,1,"(4.697144,-74.140516)"
2017,Diciembre,Islas Caimán/Territorio Británico de Ultramar,136,1,1,,2,"(10.445761,-75.516429)"
2017,Diciembre,Islas Caimán/Territorio Británico de Ultramar,136,1,0,,1,"(10.886611,-74.776708)"
2017,Diciembre,Islas Caimán/Territorio Británico de Ultramar,136,75,40,,115,"(12.586067,-81.702563)"
2017,Diciembre,Islas Caimán/Territorio Británico de Ultramar,136,1,2,,3,"(3.541112,-76.384584)"
2017,Diciembre,Islas Caimán/Territorio Británico de Ultramar,136,5,6,,11,"(4.697144,-74.140516)"
2017,Diciembre,Camboya,116,1,1,,2,"(4.697144,-74.140516)"
2017,Diciembre,Camerún,120,0,1,,1,"(4.697144,-74.140516)"
2017,Diciembre,Camerún,120,0,1,,1,"(6.171601,-75.427454)"
2017,Diciembre,Canadá,124,62,40,,102,"(10.445761,-75.516429)"
2017,Diciembre,Canadá,124,34,25,,59,"(10.886611,-74.776708)"
2017,Diciembre,Canadá,124,1,1,,2,"(12.586067,-81.702563)"
2017,Diciembre,Canadá,124,153,114,,267,"(3.541112,-76.384584)"
2017,Diciembre,Canadá,124,1,1,,2,"(4.452882,-75.766298)"
2017,Diciembre,Canadá,124,2105,1638,,3743,"(4.697144,-74.140516)"
2017,Diciembre,Canadá,124,20,12,,32,"(4.815061,-75.736532)"
2017,Diciembre,Canadá,124,253,194,,447,"(6.171601,-75.427454)"
2017,Diciembre,Canadá,124,16,9,,25,"(7.128456,-73.183637)"
2017,Diciembre,España,724,5,4,,9,"(10.445761,-75.516429)"
2017,Diciembre,España,724,16,8,,24,"(10.886611,-74.776708)"
2017,Diciembre,España,724,3657,2530,,6187,"(3.541112,-76.384584)"
2017,Diciembre,España,724,12879,9668,,22547,"(4.697144,-74.140516)"
2017,Diciembre,España,724,13,7,,20,"(4.815061,-75.736532)"
2017,Diciembre,España,724,2279,1685,,3964,"(6.171601,-75.427454)"
2017,Diciembre,España,724,3,0,,3,"(7.128456,-73.183637)"
2017,Diciembre,Colombia,170,1,11,,12,"(10.445761,-75.516429)"
2017,Diciembre,Colombia,170,0,1,,1,"(10.886611,-74.776708)"
2017,Diciembre,Colombia,170,242,493,,735,"(4.697144,-74.140516)"
2017,Diciembre,República de Corea,410,10,8,,18,"(4.697144,-74.140516)"
2017,Diciembre,República de Corea,410,1,0,,1,"(6.171601,-75.427454)"
2017,Diciembre,Costa de Marfil,384,4,1,,5,"(4.697144,-74.140516)"
2017,Diciembre,Costa Rica,188,1,0,,1,"(10.408582,-75.538003)"
2017,Diciembre,Costa Rica,188,11,5,,16,"(10.445761,-75.516429)"
2017,Diciembre,Costa Rica,188,32,28,,60,"(10.886611,-74.776708)"
2017,Diciembre,Costa Rica,188,4,34,,38,"(12.5744111,-81.703935)"
2017,Diciembre,Costa Rica,188,10,6,,16,"(12.586067,-81.702563)"
2017,Diciembre,Costa Rica,188,48,33,,81,"(3.541112,-76.384584)"
2017,Diciembre,Costa Rica,188,1367,1339,,2706,"(4.697144,-74.140516)"
2017,Diciembre,Costa Rica,188,19,12,,31,"(4.815061,-75.736532)"
2017,Diciembre,Costa Rica,188,142,122,,264,"(6.171601,-75.427454)"
2017,Diciembre,Costa Rica,188,4,5,,9,"(7.128456,-73.183637)"
2017,Diciembre,Croacia,191,6,1,,7,"(4.697144,-74.140516)"
2017,Diciembre,Cuba,192,13,15,,28,"(10.445761,-75.516429)"
2017,Diciembre,Cuba,192,9,14,,23,"(10.886611,-74.776708)"
2017,Diciembre,Cuba,192,0,2,,2,"(12.586067,-81.702563)"
2017,Diciembre,Cuba,192,59,45,,104,"(3.541112,-76.384584)"
2017,Diciembre,Cuba,192,1563,1311,,2874,"(4.697144,-74.140516)"
2017,Diciembre,Cuba,192,26,16,,42,"(4.815061,-75.736532)"
2017,Diciembre,Cuba,192,129,97,,226,"(6.171601,-75.427454)"
2017,Diciembre,Cuba,192,7,5,,12,"(7.128456,-73.183637)"
2017,Diciembre,Curazao,99999,11,31,,42,"(4.697144,-74.140516)"
2017,Diciembre,República Checa,203,1,0,,1,"(10.445761,-75.516429)"
2017,Diciembre,República Checa,203,1,0,,1,"(3.541112,-76.384584)"
2017,Diciembre,República Checa,203,16,10,,26,"(4.697144,-74.140516)"
2017,Diciembre,República Checa,203,1,0,,1,"(6.171601,-75.427454)"
2017,Diciembre,Chile,152,3,2,,5,"(0.25129,-76.875963)"
2017,Diciembre,Chile,152,136,106,,242,"(0.814836,-77.662532)"
2017,Diciembre,Chile,152,8,67,,75,"(10.408582,-75.538003)"
2017,Diciembre,Chile,152,38,16,,54,"(10.445761,-75.516429)"
2017,Diciembre,Chile,152,27,16,,43,"(10.886611,-74.776708)"
2017,Diciembre,Chile,152,0,1,,1,"(12.586067,-81.702563)"
2017,Diciembre,Chile,152,330,219,,549,"(3.541112,-76.384584)"
2017,Diciembre,Chile,152,6928,4983,,11911,"(4.697144,-74.140516)"
2017,Diciembre,Chile,152,64,30,,94,"(4.815061,-75.736532)"
2017,Diciembre,Chile,152,114,91,,205,"(6.171601,-75.427454)"
2017,Diciembre,Chile,152,6,7,,13,"(7.128456,-73.183637)"
2017,Diciembre,China,156,0,2,,2,"(10.886611,-74.776708)"
2017,Diciembre,China,156,5,9,,14,"(3.541112,-76.384584)"
2017,Diciembre,China,156,75,121,,196,"(4.697144,-74.140516)"
2017,Diciembre,China,156,0,1,,1,"(4.815061,-75.736532)"
2017,Diciembre,China,156,9,15,,24,"(6.171601,-75.427454)"
2017,Diciembre,Chipre,196,1,2,,3,"(4.697144,-74.140516)"
2017,Diciembre,Chipre,196,0,1,,1,"(6.171601,-75.427454)"
2017,Diciembre,Dinamarca,208,1,2,,3,"(10.445761,-75.516429)"
2017,Diciembre,Dinamarca,208,22,15,,37,"(4.697144,-74.140516)"
2017,Diciembre,Dinamarca,208,11,7,,18,"(6.171601,-75.427454)"
2017,Diciembre,Ecuador,218,3,2,,5,"(-0.193180,-74.784874)"
2017,Diciembre,Ecuador,218,797,1153,,1950,"(0.25129,-76.875963)"
2017,Diciembre,Ecuador,218,47,70,,117,"(0.812436,-77.847006)"
2017,Diciembre,Ecuador,218,9744,9643,,19387,"(0.814836,-77.662532)"
2017,Diciembre,Ecuador,218,252,235,,487,"(1.813928,-78.763924)"
2017,Diciembre,Ecuador,218,0,1,,1,"(10.408582,-75.538003)"
2017,Diciembre,Ecuador,218,7,4,,11,"(10.445761,-75.516429)"
2017,Diciembre,Ecuador,218,3,2,,5,"(10.886611,-74.776708)"
2017,Diciembre,Ecuador,218,461,417,,878,"(3.541112,-76.384584)"
2017,Diciembre,Ecuador,218,0,7,,7,"(3.893038,-77.067921)"
2017,Diciembre,Ecuador,218,3482,3862,,7344,"(4.697144,-74.140516)"
2017,Diciembre,Ecuador,218,20,16,,36,"(6.171601,-75.427454)"
2017,Diciembre,Ecuador,218,1,1,,2,"(7.128456,-73.183637)"
2017,Diciembre,Egipto,818,1,1,,2,"(3.541112,-76.384584)"
2017,Diciembre,Egipto,818,8,14,,22,"(4.697144,-74.140516)"
2017,Diciembre,Egipto,818,2,1,,3,"(6.171601,-75.427454)"
2017,Diciembre,El Salvador,222,2,0,,2,"(10.445761,-75.516429)"
2017,Diciembre,El Salvador,222,5,4,,9,"(10.886611,-74.776708)"
2017,Diciembre,El Salvador,222,78,68,,146,"(3.541112,-76.384584)"
2017,Diciembre,El Salvador,222,952,1000,,1952,"(4.697144,-74.140516)"
2017,Diciembre,El Salvador,222,3,2,,5,"(4.815061,-75.736532)"
2017,Diciembre,El Salvador,222,83,102,,185,"(6.171601,-75.427454)"
2017,Diciembre,Emiratos Árabes,784,4,4,,8,"(3.541112,-76.384584)"
2017,Diciembre,Emiratos Árabes,784,115,183,,298,"(4.697144,-74.140516)"
2017,Diciembre,Emiratos Árabes,784,0,2,,2,"(4.815061,-75.736532)"
2017,Diciembre,Emiratos Árabes,784,12,8,,20,"(6.171601,-75.427454)"
2017,Diciembre,Eritrea,232,0,1,,1,"(4.697144,-74.140516)"
2017,Diciembre,Eslovaquia,703,0,3,,3,"(4.697144,-74.140516)"
2017,Diciembre,Eslovenia,705,1,1,,2,"(4.697144,-74.140516)"
2017,Diciembre,Eslovenia,705,1,3,,4,"(6.171601,-75.427454)"
2017,Diciembre,Estados Unidos de América,840,1,0,,1,"(0.814836,-77.662532)"
2017,Diciembre,Estados Unidos de América,840,0,1,,1,"(10.408582,-75.538003)"
2017,Diciembre,Estados Unidos de América,840,5217,4079,,9296,"(10.445761,-75.516429)"
2017,Diciembre,Estados Unidos de América,840,3602,2907,,6509,"(10.886611,-74.776708)"
2017,Diciembre,Estados Unidos de América,840,0,2,,2,"(10.971302,-74.765397)"
2017,Diciembre,Estados Unidos de América,840,0,10,,10,"(11.247723,-74.213989)"
2017,Diciembre,Estados Unidos de América,840,70,48,,118,"(12.586067,-81.702563)"
2017,Diciembre,Estados Unidos de América,840,6542,4646,,11188,"(3.541112,-76.384584)"
2017,Diciembre,Estados Unidos de América,840,699,449,,1148,"(4.452882,-75.766298)"
2017,Diciembre,Estados Unidos de América,840,40806,32771,,73577,"(4.697144,-74.140516)"
2017,Diciembre,Estados Unidos de América,840,1016,683,,1699,"(4.815061,-75.736532)"
2017,Diciembre,Estados Unidos de América,840,13381,10255,,23636,"(6.171601,-75.427454)"
2017,Diciembre,Estados Unidos de América,840,289,210,,499,"(7.128456,-73.183637)"
2017,Diciembre,Estonia,233,0,1,,1,"(4.697144,-74.140516)"
2017,Diciembre,Etiopia,231,0,2,,2,"(4.697144,-74.140516)"
2017,Diciembre,Etiopia,231,0,3,,3,"(6.171601,-75.427454)"
2017,Diciembre,Filipinas,608,1,0,,1,"(10.886611,-74.776708)"
2017,Diciembre,Filipinas,608,3,4,,7,"(4.697144,-74.140516)"
2017,Diciembre,Finlandia,246,1,0,,1,"(10.445761,-75.516429)"
2017,Diciembre,Finlandia,246,1,0,,1,"(10.886611,-74.776708)"
2017,Diciembre,Finlandia,246,11,3,,14,"(4.697144,-74.140516)"
2017,Diciembre,Finlandia,246,0,1,,1,"(6.171601,-75.427454)"
2017,Diciembre,Francia,250,5,6,,11,"(10.445761,-75.516429)"
2017,Diciembre,Francia,250,12,7,,19,"(10.886611,-74.776708)"
2017,Diciembre,Francia,250,72,49,,121,"(3.541112,-76.384584)"
2017,Diciembre,Francia,250,1772,1358,,3130,"(4.697144,-74.140516)"
2017,Diciembre,Francia,250,25,8,,33,"(4.815061,-75.736532)"
2017,Diciembre,Francia,250,118,69,,187,"(6.171601,-75.427454)"
2017,Diciembre,Francia,250,2,3,,5,"(7.128456,-73.183637)"
2017,Diciembre,Georgia,268,0,1,,1,"(4.697144,-74.140516)"
2017,Diciembre,Ghana,288,0,1,,1,"(4.697144,-74.140516)"
2017,Diciembre,Gibraltar/Territorio Británico de Ultramar,292,3,0,,3,"(0.814836,-77.662532)"
2017,Diciembre,Grecia,300,1,1,,2,"(3.541112,-76.384584)"
2017,Diciembre,Grecia,300,6,9,,15,"(4.697144,-74.140516)"
2017,Diciembre,Grecia,300,4,1,,5,"(6.171601,-75.427454)"
2017,Diciembre,Guatemala,320,1,3,,4,"(10.445761,-75.516429)"
2017,Diciembre,Guatemala,320,5,8,,13,"(10.886611,-74.776708)"
2017,Diciembre,Guatemala,320,81,72,,153,"(3.541112,-76.384584)"
2017,Diciembre,Guatemala,320,614,626,,1240,"(4.697144,-74.140516)"
2017,Diciembre,Guatemala,320,11,13,,24,"(4.815061,-75.736532)"
2017,Diciembre,Guatemala,320,124,108,,232,"(6.171601,-75.427454)"
2017,Diciembre,Guatemala,320,5,8,,13,"(7.128456,-73.183637)"
2017,Diciembre,Guyana,328,0,1,,1,"(10.445761,-75.516429)"
2017,Diciembre,Guyana,328,1,2,,3,"(10.886611,-74.776708)"
2017,Diciembre,Guyana,328,1,0,,1,"(3.541112,-76.384584)"
2017,Diciembre,Guyana,328,1,1,,2,"(4.697144,-74.140516)"
2017,Diciembre,Guyana,328,0,1,,1,"(6.171601,-75.427454)"
2017,Diciembre,Guinea,324,0,1,,1,"(4.697144,-74.140516)"
2017,Diciembre,Guinea Ecuatorial,226,1,1,,2,"(4.697144,-74.140516)"
2017,Diciembre,Guadalupe/Territorio Francés,312,1,0,,1,"(4.697144,-74.140516)"
2017,Diciembre,Guayana Francesa/Departamento de Ultramar Francés,254,1,0,,1,"(3.541112,-76.384584)"
2017,Diciembre,Guayana Francesa/Departamento de Ultramar Francés,254,1,0,,1,"(4.697144,-74.140516)"
2017,Diciembre,Guayana Francesa/Departamento de Ultramar Francés,254,0,1,,1,"(4.815061,-75.736532)"
2017,Diciembre,Guayana Francesa/Departamento de Ultramar Francés,254,0,1,,1,"(6.171601,-75.427454)"
2017,Diciembre,Haití,332,1,0,,1,"(10.445761,-75.516429)"
2017,Diciembre,Haití,332,1,2,,3,"(3.541112,-76.384584)"
2017,Diciembre,Haití,332,5,8,,13,"(4.697144,-74.140516)"
2017,Diciembre,Haití,332,1,6,,7,"(6.171601,-75.427454)"
2017,Diciembre,Honduras,340,0,7,,7,"(10.408582,-75.538003)"
2017,Diciembre,Honduras,340,0,7,,7,"(10.445761,-75.516429)"
2017,Diciembre,Honduras,340,2,4,,6,"(10.886611,-74.776708)"
2017,Diciembre,Honduras,340,21,16,,37,"(3.541112,-76.384584)"
2017,Diciembre,Honduras,340,55,75,,130,"(4.697144,-74.140516)"
2017,Diciembre,Honduras,340,3,6,,9,"(4.815061,-75.736532)"
2017,Diciembre,Honduras,340,25,30,,55,"(6.171601,-75.427454)"
2017,Diciembre,Honduras,340,1,0,,1,"(7.128456,-73.183637)"
2017,Diciembre,Hong Kong,344,3,1,,4,"(3.541112,-76.384584)"
2017,Diciembre,Hong Kong,344,15,26,,41,"(4.697144,-74.140516)"
2017,Diciembre,Hong Kong,344,0,1,,1,"(6.171601,-75.427454)"
2017,Diciembre,Hungría,348,1,1,,2,"(3.541112,-76.384584)"
2017,Diciembre,Hungría,348,5,3,,8,"(4.697144,-74.140516)"
2017,Diciembre,India,356,0,1,,1,"(10.886611,-74.776708)"
2017,Diciembre,India,356,4,3,,7,"(3.541112,-76.384584)"
2017,Diciembre,India,356,41,42,,83,"(4.697144,-74.140516)"
2017,Diciembre,India,356,13,5,,18,"(6.171601,-75.427454)"
2017,Diciembre,India,356,0,1,,1,"(7.128456,-73.183637)"
2017,Diciembre,Indonesia,360,1,1,,2,"(3.541112,-76.384584)"
2017,Diciembre,Indonesia,360,1,1,,2,"(4.697144,-74.140516)"
2017,Diciembre,Iraq,368,0,1,,1,"(3.541112,-76.384584)"
2017,Diciembre,Iraq,368,0,4,,4,"(4.697144,-74.140516)"
2017,Diciembre,Irán,364,1,1,,2,"(4.697144,-74.140516)"
2017,Diciembre,Irán,364,0,2,,2,"(6.171601,-75.427454)"
2017,Diciembre,República de Irlanda,372,4,2,,6,"(3.541112,-76.384584)"
2017,Diciembre,República de Irlanda,372,10,7,,17,"(4.697144,-74.140516)"
2017,Diciembre,República de Irlanda,372,0,3,,3,"(6.171601,-75.427454)"
2017,Diciembre,Islandia,352,3,1,,4,"(4.697144,-74.140516)"
2017,Diciembre,Israel,376,1,0,,1,"(10.445761,-75.516429)"
2017,Diciembre,Israel,376,1,0,,1,"(10.886611,-74.776708)"
2017,Diciembre,Israel,376,5,2,,7,"(3.541112,-76.384584)"
2017,Diciembre,Israel,376,123,67,,190,"(4.697144,-74.140516)"
2017,Diciembre,Israel,376,13,6,,19,"(6.171601,-75.427454)"
2017,Diciembre,Italia,380,9,3,,12,"(10.445761,-75.516429)"
2017,Diciembre,Italia,380,10,9,,19,"(10.886611,-74.776708)"
2017,Diciembre,Italia,380,75,22,,97,"(3.541112,-76.384584)"
2017,Diciembre,Italia,380,520,338,,858,"(4.697144,-74.140516)"
2017,Diciembre,Italia,380,1,0,,1,"(4.815061,-75.736532)"
2017,Diciembre,Italia,380,90,36,,126,"(6.171601,-75.427454)"
2017,Diciembre,Jamaica,388,1346,973,,2319,"(10.408582,-75.538003)"
2017,Diciembre,Jamaica,388,5,14,,19,"(10.445761,-75.516429)"
2017,Diciembre,Jamaica,388,2,6,,8,"(10.886611,-74.776708)"
2017,Diciembre,Jamaica,388,20,21,,41,"(3.541112,-76.384584)"
2017,Diciembre,Jamaica,388,41,34,,75,"(4.697144,-74.140516)"
2017,Diciembre,Jamaica,388,3,2,,5,"(4.815061,-75.736532)"
2017,Diciembre,Jamaica,388,40,24,,64,"(6.171601,-75.427454)"
2017,Diciembre,Japón,392,1,2,,3,"(10.445761,-75.516429)"
2017,Diciembre,Japón,392,2,2,,4,"(10.886611,-74.776708)"
2017,Diciembre,Japón,392,3,0,,3,"(3.541112,-76.384584)"
2017,Diciembre,Japón,392,73,73,,146,"(4.697144,-74.140516)"
2017,Diciembre,Japón,392,14,9,,23,"(6.171601,-75.427454)"
2017,Diciembre,Jordania,400,4,3,,7,"(4.697144,-74.140516)"
2017,Diciembre,Kazajistán,398,0,1,,1,"(4.697144,-74.140516)"
2017,Diciembre,Kenia,404,5,7,,12,"(4.697144,-74.140516)"
2017,Diciembre,Kuwait,414,0,1,,1,"(10.445761,-75.516429)"
2017,Diciembre,Kuwait,414,1,9,,10,"(4.697144,-74.140516)"
2017,Diciembre,Lituania,440,0,1,,1,"(4.697144,-74.140516)"
2017,Diciembre,Líbano,422,2,6,,8,"(10.886611,-74.776708)"
2017,Diciembre,Líbano,422,2,2,,4,"(3.541112,-76.384584)"
2017,Diciembre,Líbano,422,4,9,,13,"(4.697144,-74.140516)"
2017,Diciembre,Liechtenstein,438,0,1,,1,"(4.697144,-74.140516)"
2017,Diciembre,Luxemburgo,442,5,1,,6,"(4.697144,-74.140516)"
2017,Diciembre,Luxemburgo,442,2,0,,2,"(6.171601,-75.427454)"
2017,Diciembre,Macao,446,0,1,,1,"(4.697144,-74.140516)"
2017,Diciembre,Macedonia,807,1,0,,1,"(4.697144,-74.140516)"
2017,Diciembre,Madagascar,450,0,3,,3,"(4.697144,-74.140516)"
2017,Diciembre,Malasia,458,0,1,,1,"(3.541112,-76.384584)"
2017,Diciembre,Malasia,458,2,1,,3,"(4.697144,-74.140516)"
2017,Diciembre,Malasia,458,2,0,,2,"(6.171601,-75.427454)"
2017,Diciembre,Maldivas,462,1,0,,1,"(4.697144,-74.140516)"
2017,Diciembre,Maldivas,462,2,3,,5,"(6.171601,-75.427454)"
2017,Diciembre,Malta,470,1,2,,3,"(3.541112,-76.384584)"
2017,Diciembre,Malta,470,12,10,,22,"(4.697144,-74.140516)"
2017,Diciembre,Malta,470,0,1,,1,"(6.171601,-75.427454)"
2017,Diciembre,Marruecos,504,2,1,,3,"(3.541112,-76.384584)"
2017,Diciembre,Marruecos,504,14,12,,26,"(4.697144,-74.140516)"
2017,Diciembre,Marruecos,504,2,2,,4,"(6.171601,-75.427454)"
2017,Diciembre,Mauritania,478,0,1,,1,"(4.697144,-74.140516)"
2017,Diciembre,Martinica/Departamento de Ultramar Francés,474,1,0,,1,"(10.445761,-75.516429)"
2017,Diciembre,Martinica/Departamento de Ultramar Francés,474,2,0,,2,"(4.697144,-74.140516)"
2017,Diciembre,Martinica/Departamento de Ultramar Francés,474,1,0,,1,"(4.815061,-75.736532)"
2017,Diciembre,México,484,0,2,,2,"(0.814836,-77.662532)"
2017,Diciembre,México,484,105,84,,189,"(10.445761,-75.516429)"
2017,Diciembre,México,484,164,145,,309,"(10.886611,-74.776708)"
2017,Diciembre,México,484,5,5,,10,"(12.586067,-81.702563)"
2017,Diciembre,México,484,938,701,,1639,"(3.541112,-76.384584)"
2017,Diciembre,México,484,18811,15306,,34117,"(4.697144,-74.140516)"
2017,Diciembre,México,484,222,187,,409,"(4.815061,-75.736532)"
2017,Diciembre,México,484,2671,1937,,4608,"(6.171601,-75.427454)"
2017,Diciembre,México,484,150,119,,269,"(7.128456,-73.183637)"
2017,Diciembre,Mongolia,496,0,1,,1,"(4.697144,-74.140516)"
2017,Diciembre,Nicaragua,558,3,3,,6,"(10.445761,-75.516429)"
2017,Diciembre,Nicaragua,558,3,4,,7,"(10.886611,-74.776708)"
2017,Diciembre,Nicaragua,558,4,2,,6,"(12.586067,-81.702563)"
2017,Diciembre,Nicaragua,558,23,36,,59,"(3.541112,-76.384584)"
2017,Diciembre,Nicaragua,558,58,70,,128,"(4.697144,-74.140516)"
2017,Diciembre,Nicaragua,558,5,5,,10,"(4.815061,-75.736532)"
2017,Diciembre,Nicaragua,558,23,51,,74,"(6.171601,-75.427454)"
2017,Diciembre,Nicaragua,558,2,1,,3,"(7.128456,-73.183637)"
2017,Diciembre,Nigeria,566,1,2,,3,"(4.697144,-74.140516)"
2017,Diciembre,Noruega,578,1,2,,3,"(3.541112,-76.384584)"
2017,Diciembre,Noruega,578,37,18,,55,"(4.697144,-74.140516)"
2017,Diciembre,Noruega,578,4,2,,6,"(6.171601,-75.427454)"
2017,Diciembre,Nueva Zelanda,554,2,0,,2,"(3.541112,-76.384584)"
2017,Diciembre,Nueva Zelanda,554,39,18,,57,"(4.697144,-74.140516)"
2017,Diciembre,Nueva Zelanda,554,1,2,,3,"(6.171601,-75.427454)"
2017,Diciembre,Omán,512,0,2,,2,"(10.445761,-75.516429)"
2017,Diciembre,Omán,512,4,0,,4,"(4.697144,-74.140516)"
2017,Diciembre,Papúa Nueva Guinea,598,1,0,,1,"(4.697144,-74.140516)"
2017,Diciembre,Pakistán,586,0,1,,1,"(4.697144,-74.140516)"
2017,Diciembre,Panamá,591,14,91,,105,"(10.408582,-75.538003)"
2017,Diciembre,Panamá,591,1352,959,,2311,"(10.445761,-75.516429)"
2017,Diciembre,Panamá,591,1054,913,,1967,"(10.886611,-74.776708)"
2017,Diciembre,Panamá,591,0,2,,2,"(10.971302,-74.765397)"
2017,Diciembre,Panamá,591,0,3,,3,"(12.165168,-71.983761)"
2017,Diciembre,Panamá,591,1,11,,12,"(12.5744111,-81.703935)"
2017,Diciembre,Panamá,591,162,130,,292,"(12.586067,-81.702563)"
2017,Diciembre,Panamá,591,2342,1947,,4289,"(3.541112,-76.384584)"
2017,Diciembre,Panamá,591,284,197,,481,"(4.452882,-75.766298)"
2017,Diciembre,Panamá,591,9854,9554,,19408,"(4.697144,-74.140516)"
2017,Diciembre,Panamá,591,444,326,,770,"(4.815061,-75.736532)"
2017,Diciembre,Panamá,591,1,2,,3,"(6.17134,-75.427194)"
2017,Diciembre,Panamá,591,4083,3435,,7518,"(6.171601,-75.427454)"
2017,Diciembre,Panamá,591,3,7,,10,"(6.228046,-77.404104)"
2017,Diciembre,Panamá,591,5,18,,23,"(7.102626,-77.762647)"
2017,Diciembre,Panamá,591,237,194,,431,"(7.128456,-73.183637)"
2017,Diciembre,Panamá,591,0,22,,22,"(8.066966,-76.735404)"
2017,Diciembre,Panamá,591,18,42,,60,"(8.635765,-77.346578)"
2017,Diciembre,Paraguay,600,0,1,,1,"(0.814836,-77.662532)"
2017,Diciembre,Paraguay,600,4,5,,9,"(10.445761,-75.516429)"
2017,Diciembre,Paraguay,600,4,5,,9,"(10.886611,-74.776708)"
2017,Diciembre,Paraguay,600,31,31,,62,"(3.541112,-76.384584)"
2017,Diciembre,Paraguay,600,76,164,,240,"(4.697144,-74.140516)"
2017,Diciembre,Paraguay,600,12,9,,21,"(4.815061,-75.736532)"
2017,Diciembre,Paraguay,600,14,15,,29,"(6.171601,-75.427454)"
2017,Diciembre,Paraguay,600,0,1,,1,"(7.128456,-73.183637)"
2017,Diciembre,Perú,604,9,3,,12,"(-0.193180,-74.784874)"
2017,Diciembre,Perú,604,72,72,,144,"(-4.197703,-69.941278)"
2017,Diciembre,Perú,604,187,166,,353,"(-4.223468,-69.945098)"
2017,Diciembre,Perú,604,0,2,,2,"(0.25129,-76.875963)"
2017,Diciembre,Perú,604,99,104,,203,"(0.814836,-77.662532)"
2017,Diciembre,Perú,604,4,1,,5,"(1.813928,-78.763924)"
2017,Diciembre,Perú,604,118,86,,204,"(10.445761,-75.516429)"
2017,Diciembre,Perú,604,12,8,,20,"(10.886611,-74.776708)"
2017,Diciembre,Perú,604,300,272,,572,"(3.541112,-76.384584)"
2017,Diciembre,Perú,604,6676,6173,,12849,"(4.697144,-74.140516)"
2017,Diciembre,Perú,604,9,0,,9,"(4.815061,-75.736532)"
2017,Diciembre,Perú,604,475,375,,850,"(6.171601,-75.427454)"
2017,Diciembre,Perú,604,3,3,,6,"(7.128456,-73.183637)"
2017,Diciembre,Polonia,616,0,1,,1,"(3.541112,-76.384584)"
2017,Diciembre,Polonia,616,11,13,,24,"(4.697144,-74.140516)"
2017,Diciembre,Polonia,616,0,1,,1,"(6.171601,-75.427454)"
2017,Diciembre,Portugal,620,1,1,,2,"(10.445761,-75.516429)"
2017,Diciembre,Portugal,620,6,9,,15,"(3.541112,-76.384584)"
2017,Diciembre,Portugal,620,89,131,,220,"(4.697144,-74.140516)"
2017,Diciembre,Portugal,620,2,2,,4,"(4.815061,-75.736532)"
2017,Diciembre,Portugal,620,14,11,,25,"(6.171601,-75.427454)"
2017,Diciembre,Puerto Rico/Territorio de Estados Unidos,630,11,7,,18,"(10.445761,-75.516429)"
2017,Diciembre,Puerto Rico/Territorio de Estados Unidos,630,10,5,,15,"(10.886611,-74.776708)"
2017,Diciembre,Puerto Rico/Territorio de Estados Unidos,630,31,22,,53,"(3.541112,-76.384584)"
2017,Diciembre,Puerto Rico/Territorio de Estados Unidos,630,583,495,,1078,"(4.697144,-74.140516)"
2017,Diciembre,Puerto Rico/Territorio de Estados Unidos,630,3,4,,7,"(4.815061,-75.736532)"
2017,Diciembre,Puerto Rico/Territorio de Estados Unidos,630,57,39,,96,"(6.171601,-75.427454)"
2017,Diciembre,Puerto Rico/Territorio de Estados Unidos,630,5,8,,13,"(7.128456,-73.183637)"
2017,Diciembre,Qatar,634,8,2,,10,"(4.697144,-74.140516)"
2017,Diciembre,Qatar,634,2,2,,4,"(6.171601,-75.427454)"
2017,Diciembre,Reino Unido de Gran Bretaña e Irlanda del Norte,826,1,1,,2,"(10.445761,-75.516429)"
2017,Diciembre,Reino Unido de Gran Bretaña e Irlanda del Norte,826,3,3,,6,"(10.886611,-74.776708)"
2017,Diciembre,Reino Unido de Gran Bretaña e Irlanda del Norte,826,17,17,,34,"(3.541112,-76.384584)"
2017,Diciembre,Reino Unido de Gran Bretaña e Irlanda del Norte,826,1547,1146,,2693,"(4.697144,-74.140516)"
2017,Diciembre,Reino Unido de Gran Bretaña e Irlanda del Norte,826,49,23,,72,"(6.171601,-75.427454)"
2017,Diciembre,República CentroÁfricana,140,0,1,,1,"(4.697144,-74.140516)"
2017,Diciembre,Federación de Rusia,643,0,1,,1,"(3.541112,-76.384584)"
2017,Diciembre,Federación de Rusia,643,22,22,,44,"(4.697144,-74.140516)"
2017,Diciembre,Federación de Rusia,643,0,2,,2,"(6.171601,-75.427454)"
2017,Diciembre,República Dominicana,214,13,10,,23,"(10.445761,-75.516429)"
2017,Diciembre,República Dominicana,214,59,54,,113,"(10.886611,-74.776708)"
2017,Diciembre,República Dominicana,214,112,98,,210,"(3.541112,-76.384584)"
2017,Diciembre,República Dominicana,214,4473,3448,,7921,"(4.697144,-74.140516)"
2017,Diciembre,República Dominicana,214,57,41,,98,"(4.815061,-75.736532)"
2017,Diciembre,República Dominicana,214,314,250,,564,"(6.171601,-75.427454)"
2017,Diciembre,República Dominicana,214,23,20,,43,"(7.128456,-73.183637)"
2017,Diciembre,Reunión,638,0,1,,1,"(4.697144,-74.140516)"
2017,Diciembre,República Democrática Popular de Corea,408,0,1,,1,"(4.697144,-74.140516)"
2017,Diciembre,Rumania,642,1,3,,4,"(4.697144,-74.140516)"
2017,Diciembre,San Cristóbal y Nevis,659,1,2,,3,"(10.445761,-75.516429)"
2017,Diciembre,San Cristóbal y Nevis,659,1,6,,7,"(4.697144,-74.140516)"
2017,Diciembre,San  Vicente y las Granadinas,670,3,2,,5,"(4.697144,-74.140516)"
2017,Diciembre,Serbia,688,0,1,,1,"(4.697144,-74.140516)"
2017,Diciembre,Serbia,688,1,1,,2,"(6.171601,-75.427454)"
2017,Diciembre,Seychelles,690,0,4,,4,"(4.697144,-74.140516)"
2017,Diciembre,Singapur,702,1,0,,1,"(10.886611,-74.776708)"
2017,Diciembre,Singapur,702,1,3,,4,"(3.541112,-76.384584)"
2017,Diciembre,Singapur,702,21,12,,33,"(4.697144,-74.140516)"
2017,Diciembre,Singapur,702,1,2,,3,"(4.815061,-75.736532)"
2017,Diciembre,Singapur,702,1,0,,1,"(6.171601,-75.427454)"
2017,Diciembre,Sudáfrica,710,23,14,,37,"(4.697144,-74.140516)"
2017,Diciembre,Sudán,736,0,1,,1,"(6.171601,-75.427454)"
2017,Diciembre,Suecia,752,4,1,,5,"(10.886611,-74.776708)"
2017,Diciembre,Suecia,752,12,4,,16,"(3.541112,-76.384584)"
2017,Diciembre,Suecia,752,46,41,,87,"(4.697144,-74.140516)"
2017,Diciembre,Suecia,752,4,0,,4,"(4.815061,-75.736532)"
2017,Diciembre,Suecia,752,12,5,,17,"(6.171601,-75.427454)"
2017,Diciembre,Suiza,756,5,4,,9,"(10.445761,-75.516429)"
2017,Diciembre,Suiza,756,7,0,,7,"(10.886611,-74.776708)"
2017,Diciembre,Suiza,756,50,25,,75,"(3.541112,-76.384584)"
2017,Diciembre,Suiza,756,258,162,,420,"(4.697144,-74.140516)"
2017,Diciembre,Suiza,756,3,1,,4,"(4.815061,-75.736532)"
2017,Diciembre,Suiza,756,41,21,,62,"(6.171601,-75.427454)"
2017,Diciembre,Surinam,740,0,1,,1,"(10.408582,-75.538003)"
2017,Diciembre,Surinam,740,1,2,,3,"(4.697144,-74.140516)"
2017,Diciembre,Surinam,740,2,0,,2,"(6.171601,-75.427454)"
2017,Diciembre,Taiwán,158,3,4,,7,"(4.697144,-74.140516)"
2017,Diciembre,Tailandia,764,3,3,,6,"(3.541112,-76.384584)"
2017,Diciembre,Tailandia,764,35,30,,65,"(4.697144,-74.140516)"
2017,Diciembre,Tailandia,764,12,6,,18,"(6.171601,-75.427454)"
2017,Diciembre,Tanzania,834,2,6,,8,"(4.697144,-74.140516)"
2017,Diciembre,Togo,768,3,1,,4,"(4.697144,-74.140516)"
2017,Diciembre,Trinidad y Tobago,780,3,1,,4,"(10.445761,-75.516429)"
2017,Diciembre,Trinidad y Tobago,780,1,1,,2,"(10.886611,-74.776708)"
2017,Diciembre,Trinidad y Tobago,780,3,2,,5,"(3.541112,-76.384584)"
2017,Diciembre,Trinidad y Tobago,780,22,18,,40,"(4.697144,-74.140516)"
2017,Diciembre,Trinidad y Tobago,780,4,6,,10,"(4.815061,-75.736532)"
2017,Diciembre,Trinidad y Tobago,780,12,13,,25,"(6.171601,-75.427454)"
2017,Diciembre,Trinidad y Tobago,780,5,1,,6,"(7.128456,-73.183637)"
2017,Diciembre,Túnez,788,4,0,,4,"(4.697144,-74.140516)"
2017,Diciembre,Turquía,792,6,7,,13,"(3.541112,-76.384584)"
2017,Diciembre,Turquía,792,784,542,,1326,"(4.697144,-74.140516)"
2017,Diciembre,Turquía,792,2,5,,7,"(6.171601,-75.427454)"
2017,Diciembre,Turkmenistán,795,5,5,,10,"(4.697144,-74.140516)"
2017,Diciembre,Ucrania,804,0,1,,1,"(4.697144,-74.140516)"
2017,Diciembre,Uganda,800,1,0,,1,"(4.697144,-74.140516)"
2017,Diciembre,Uruguay,858,1,2,,3,"(0.814836,-77.662532)"
2017,Diciembre,Uruguay,858,3,3,,6,"(10.445761,-75.516429)"
2017,Diciembre,Uruguay,858,27,19,,46,"(3.541112,-76.384584)"
2017,Diciembre,Uruguay,858,523,483,,1006,"(4.697144,-74.140516)"
2017,Diciembre,Uruguay,858,4,9,,13,"(4.815061,-75.736532)"
2017,Diciembre,Uruguay,858,34,28,,62,"(6.171601,-75.427454)"
2017,Diciembre,Venezuela,862,6,2,,8,"(10.445761,-75.516429)"
2017,Diciembre,Venezuela,862,15,14,,29,"(10.886611,-74.776708)"
2017,Diciembre,Venezuela,862,0,2,,2,"(11.117806,-74.232622)"
2017,Diciembre,Venezuela,862,2656,2851,,5507,"(11.360009,-72.129330)"
2017,Diciembre,Venezuela,862,2,1,,3,"(11.528919,-72.919681)"
2017,Diciembre,Venezuela,862,0,1,,1,"(12.165168,-71.983761)"
2017,Diciembre,Venezuela,862,2,0,,2,"(12.586067,-81.702563)"
2017,Diciembre,Venezuela,862,219,164,,383,"(3.541112,-76.384584)"
2017,Diciembre,Venezuela,862,5,2,,7,"(3.866713,-67.927521)"
2017,Diciembre,Venezuela,862,1352,1201,,2553,"(4.697144,-74.140516)"
2017,Diciembre,Venezuela,862,3,1,,4,"(4.815061,-75.736532)"
2017,Diciembre,Venezuela,862,1072,845,,1917,"(6.171601,-75.427454)"
2017,Diciembre,Venezuela,862,88,79,,167,"(6.185799,-67.483929)"
2017,Diciembre,Venezuela,862,1253,1077,,2330,"(7.088729,-70.740253)"
2017,Diciembre,Venezuela,862,6,3,,9,"(7.128456,-73.183637)"
2017,Diciembre,Venezuela,862,3089,3141,,6230,"(7.818934,-72.453226)"
2017,Diciembre,Venezuela,862,287,343,,630,"(8.36068,-72.409396)"
2017,Diciembre,Vietnam,704,2,4,,6,"(4.697144,-74.140516)"
2017,Diciembre,Vietnam,704,1,0,,1,"(6.171601,-75.427454)"
2017,Diciembre,Islas Vírgenes Británicas/Territorio Británico de Ultramar,92,0,5,,5,"(4.697144,-74.140516)"
2017,Diciembre,Islas Vírgenes Británicas/Territorio Británico de Ultramar,92,2,0,,2,"(6.171601,-75.427454)"
2017,Diciembre,Zambia,894,0,1,,1,"(6.171601,-75.427454)"
2018,Enero,Afganistán,4,0,1,,1,"(0.25129,-76.875963)"
2018,Enero,Afganistán,4,0,6,,6,"(4.697144,-74.140516)"
2018,Enero,Albania,8,1,18,,19,"(4.697144,-74.140516)"
2018,Enero,Alemania,276,0,2,,2,"(0.814836,-77.662532)"
2018,Enero,Alemania,276,14,6,,20,"(10.445761,-75.516429)"
2018,Enero,Alemania,276,16,9,,25,"(10.886611,-74.776708)"
2018,Enero,Alemania,276,74,59,,133,"(3.541112,-76.384584)"
2018,Enero,Alemania,276,1240,1125,,2365,"(4.697144,-74.140516)"
2018,Enero,Alemania,276,6,2,,8,"(4.815061,-75.736532)"
2018,Enero,Alemania,276,112,100,,212,"(6.171601,-75.427454)"
2018,Enero,Alemania,276,2,0,,2,"(7.128456,-73.183637)"
2018,Enero,Andorra,20,4,1,,5,"(4.697144,-74.140516)"
2018,Enero,Angola,24,2,14,,16,"(4.697144,-74.140516)"
2018,Enero,Angola,24,1,1,,2,"(6.171601,-75.427454)"
2018,Enero,Antigua y Barbuda,28,0,2,,2,"(3.541112,-76.384584)"
2018,Enero,Antigua y Barbuda,28,2,3,,5,"(4.697144,-74.140516)"
2018,Enero,Antigua y Barbuda,28,1,0,,1,"(6.171601,-75.427454)"
2018,Enero,Países Bajos,528,135,82,,217,"(10.445761,-75.516429)"
2018,Enero,Países Bajos,528,27,19,,46,"(10.886611,-74.776708)"
2018,Enero,Países Bajos,528,274,153,,427,"(3.541112,-76.384584)"
2018,Enero,Países Bajos,528,1177,1066,,2243,"(4.697144,-74.140516)"
2018,Enero,Países Bajos,528,6,3,,9,"(4.815061,-75.736532)"
2018,Enero,Países Bajos,528,300,234,,534,"(6.171601,-75.427454)"
2018,Enero,Países Bajos,528,0,1,,1,"(7.128456,-73.183637)"
2018,Enero,Arabia Saudita,682,2,3,,5,"(3.541112,-76.384584)"
2018,Enero,Arabia Saudita,682,21,62,,83,"(4.697144,-74.140516)"
2018,Enero,Arabia Saudita,682,0,1,,1,"(4.815061,-75.736532)"
2018,Enero,Arabia Saudita,682,2,7,,9,"(6.171601,-75.427454)"
2018,Enero,Argelia,12,4,11,,15,"(4.697144,-74.140516)"
2018,Enero,Argentina,32,27,59,,86,"(0.814836,-77.662532)"
2018,Enero,Argentina,32,1,0,,1,"(1.813928,-78.763924)"
2018,Enero,Argentina,32,50,43,,93,"(10.445761,-75.516429)"
2018,Enero,Argentina,32,41,51,,92,"(10.886611,-74.776708)"
2018,Enero,Argentina,32,2,3,,5,"(12.586067,-81.702563)"
2018,Enero,Argentina,32,189,162,,351,"(3.541112,-76.384584)"
2018,Enero,Argentina,32,4467,4184,,8651,"(4.697144,-74.140516)"
2018,Enero,Argentina,32,21,41,,62,"(4.815061,-75.736532)"
2018,Enero,Argentina,32,94,171,,265,"(6.171601,-75.427454)"
2018,Enero,Argentina,32,7,4,,11,"(7.128456,-73.183637)"
2018,Enero,Aruba,533,499,407,,906,"(10.408582,-75.538003)"
2018,Enero,Aruba,533,5,4,,9,"(10.445761,-75.516429)"
2018,Enero,Aruba,533,18,25,,43,"(10.886611,-74.776708)"
2018,Enero,Aruba,533,0,8,,8,"(12.165168,-71.983761)"
2018,Enero,Aruba,533,38,28,,66,"(3.541112,-76.384584)"
2018,Enero,Aruba,533,2634,2150,,4784,"(4.697144,-74.140516)"
2018,Enero,Aruba,533,2,6,,8,"(4.815061,-75.736532)"
2018,Enero,Aruba,533,106,82,,188,"(6.171601,-75.427454)"
2018,Enero,Aruba,533,4,26,,30,"(7.128456,-73.183637)"
2018,Enero,Australia,36,4,5,,9,"(10.445761,-75.516429)"
2018,Enero,Australia,36,9,13,,22,"(10.886611,-74.776708)"
2018,Enero,Australia,36,2,0,,2,"(12.586067,-81.702563)"
2018,Enero,Australia,36,31,37,,68,"(3.541112,-76.384584)"
2018,Enero,Australia,36,867,664,,1531,"(4.697144,-74.140516)"
2018,Enero,Australia,36,6,5,,11,"(4.815061,-75.736532)"
2018,Enero,Australia,36,108,86,,194,"(6.171601,-75.427454)"
2018,Enero,Australia,36,0,2,,2,"(7.128456,-73.183637)"
2018,Enero,Austria,40,1,1,,2,"(10.445761,-75.516429)"
2018,Enero,Austria,40,0,1,,1,"(10.886611,-74.776708)"
2018,Enero,Austria,40,3,2,,5,"(3.541112,-76.384584)"
2018,Enero,Austria,40,60,48,,108,"(4.697144,-74.140516)"
2018,Enero,Austria,40,1,1,,2,"(4.815061,-75.736532)"
2018,Enero,Austria,40,10,5,,15,"(6.171601,-75.427454)"
2018,Enero,Azerbaiyán,31,1,4,,5,"(4.697144,-74.140516)"
2018,Enero,Bahamas,44,0,3,,3,"(10.445761,-75.516429)"
2018,Enero,Bahamas,44,5,4,,9,"(10.886611,-74.776708)"
2018,Enero,Bahamas,44,12,12,,24,"(3.541112,-76.384584)"
2018,Enero,Bahamas,44,6,8,,14,"(4.697144,-74.140516)"
2018,Enero,Bahamas,44,1,1,,2,"(4.815061,-75.736532)"
2018,Enero,Bahamas,44,11,47,,58,"(6.171601,-75.427454)"
2018,Enero,Bahamas,44,2,1,,3,"(7.128456,-73.183637)"
2018,Enero,Bahréin,48,1,0,,1,"(3.541112,-76.384584)"
2018,Enero,Bahréin,48,3,1,,4,"(4.452882,-75.766298)"
2018,Enero,Bahréin,48,0,5,,5,"(4.697144,-74.140516)"
2018,Enero,Bahréin,48,1,1,,2,"(6.171601,-75.427454)"
2018,Enero,Bangladesh,50,1,2,,3,"(4.697144,-74.140516)"
2018,Enero,Barbados,52,1,1,,2,"(3.541112,-76.384584)"
2018,Enero,Barbados,52,5,13,,18,"(4.697144,-74.140516)"
2018,Enero,Barbados,52,1,2,,3,"(4.815061,-75.736532)"
2018,Enero,Barbados,52,0,3,,3,"(6.171601,-75.427454)"
2018,Enero,República de Belarús,112,0,1,,1,"(4.697144,-74.140516)"
2018,Enero,Bélgica,56,3,1,,4,"(10.445761,-75.516429)"
2018,Enero,Bélgica,56,3,1,,4,"(10.886611,-74.776708)"
2018,Enero,Bélgica,56,36,29,,65,"(3.541112,-76.384584)"
2018,Enero,Bélgica,56,140,98,,238,"(4.697144,-74.140516)"
2018,Enero,Bélgica,56,1,0,,1,"(4.815061,-75.736532)"
2018,Enero,Bélgica,56,41,25,,66,"(6.171601,-75.427454)"
2018,Enero,Belice,84,1,0,,1,"(3.541112,-76.384584)"
2018,Enero,Belice,84,8,5,,13,"(4.697144,-74.140516)"
2018,Enero,Belice,84,4,3,,7,"(6.171601,-75.427454)"
2018,Enero,Benín,204,0,1,,1,"(4.697144,-74.140516)"
2018,Enero,Bermudas/Territorio Británico de Ultramar,60,5,2,,7,"(4.697144,-74.140516)"
2018,Enero,Bolivia,68,5,18,,23,"(0.814836,-77.662532)"
2018,Enero,Bolivia,68,3,3,,6,"(10.445761,-75.516429)"
2018,Enero,Bolivia,68,5,11,,16,"(10.886611,-74.776708)"
2018,Enero,Bolivia,68,28,36,,64,"(3.541112,-76.384584)"
2018,Enero,Bolivia,68,451,684,,1135,"(4.697144,-74.140516)"
2018,Enero,Bolivia,68,12,12,,24,"(4.815061,-75.736532)"
2018,Enero,Bolivia,68,27,47,,74,"(6.171601,-75.427454)"
2018,Enero,Bolivia,68,1,0,,1,"(7.128456,-73.183637)"
2018,Enero,Botsuana,72,1,0,,1,"(4.697144,-74.140516)"
2018,Enero,Brasil,76,125,241,,366,"(-4.197703,-69.941278)"
2018,Enero,Brasil,76,26,35,,61,"(-4.223468,-69.945098)"
2018,Enero,Brasil,76,3,6,,9,"(0.814836,-77.662532)"
2018,Enero,Brasil,76,12,17,,29,"(10.445761,-75.516429)"
2018,Enero,Brasil,76,10,12,,22,"(10.886611,-74.776708)"
2018,Enero,Brasil,76,1,2,,3,"(12.586067,-81.702563)"
2018,Enero,Brasil,76,94,113,,207,"(3.541112,-76.384584)"
2018,Enero,Brasil,76,3385,4254,,7639,"(4.697144,-74.140516)"
2018,Enero,Brasil,76,13,26,,39,"(4.815061,-75.736532)"
2018,Enero,Brasil,76,135,166,,301,"(6.171601,-75.427454)"
2018,Enero,Brasil,76,2,5,,7,"(7.128456,-73.183637)"
2018,Enero,Brunei Darussalam,96,0,1,,1,"(4.697144,-74.140516)"
2018,Enero,Brunei Darussalam,96,1,0,,1,"(6.171601,-75.427454)"
2018,Enero,Bulgaria,100,0,5,,5,"(3.541112,-76.384584)"
2018,Enero,Bulgaria,100,0,1,,1,"(4.697144,-74.140516)"
2018,Enero,Bulgaria,100,2,1,,3,"(6.171601,-75.427454)"
2018,Enero,Cabo Verde,132,0,1,,1,"(3.541112,-76.384584)"
2018,Enero,Cabo Verde,132,4,2,,6,"(4.697144,-74.140516)"
2018,Enero,Islas Caimán/Territorio Británico de Ultramar,136,1,0,,1,"(10.445761,-75.516429)"
2018,Enero,Islas Caimán/Territorio Británico de Ultramar,136,24,25,,49,"(12.586067,-81.702563)"
2018,Enero,Islas Caimán/Territorio Británico de Ultramar,136,1,0,,1,"(3.541112,-76.384584)"
2018,Enero,Islas Caimán/Territorio Británico de Ultramar,136,6,10,,16,"(4.697144,-74.140516)"
2018,Enero,Islas Caimán/Territorio Británico de Ultramar,136,2,2,,4,"(6.171601,-75.427454)"
2018,Enero,Camboya,116,4,0,,4,"(4.697144,-74.140516)"
2018,Enero,Camboya,116,0,1,,1,"(7.128456,-73.183637)"
2018,Enero,Antártida,10,0,1,,1,"(4.697144,-74.140516)"
2018,Enero,Camerún,120,3,8,,11,"(4.697144,-74.140516)"
2018,Enero,Canadá,124,0,1,,1,"(0.814836,-77.662532)"
2018,Enero,Canadá,124,304,274,,578,"(10.445761,-75.516429)"
2018,Enero,Canadá,124,115,87,,202,"(10.886611,-74.776708)"
2018,Enero,Canadá,124,23,29,,52,"(12.586067,-81.702563)"
2018,Enero,Canadá,124,304,257,,561,"(3.541112,-76.384584)"
2018,Enero,Canadá,124,3,1,,4,"(4.452882,-75.766298)"
2018,Enero,Canadá,124,3590,3344,,6934,"(4.697144,-74.140516)"
2018,Enero,Canadá,124,32,22,,54,"(4.815061,-75.736532)"
2018,Enero,Canadá,124,569,518,,1087,"(6.171601,-75.427454)"
2018,Enero,Canadá,124,40,32,,72,"(7.128456,-73.183637)"
2018,Enero,España,724,8,10,,18,"(10.445761,-75.516429)"
2018,Enero,España,724,24,14,,38,"(10.886611,-74.776708)"
2018,Enero,España,724,3,0,,3,"(12.586067,-81.702563)"
2018,Enero,España,724,3057,2061,,5118,"(3.541112,-76.384584)"
2018,Enero,España,724,13133,9562,,22695,"(4.697144,-74.140516)"
2018,Enero,España,724,16,11,,27,"(4.815061,-75.736532)"
2018,Enero,España,724,1968,1461,,3429,"(6.171601,-75.427454)"
2018,Enero,Colombia,170,0,9,,9,"(10.445761,-75.516429)"
2018,Enero,Colombia,170,208,593,,801,"(4.697144,-74.140516)"
2018,Enero,República Del Congo,178,0,1,,1,"(4.697144,-74.140516)"
2018,Enero,República de Corea,410,4,2,,6,"(10.445761,-75.516429)"
2018,Enero,República de Corea,410,0,2,,2,"(3.541112,-76.384584)"
2018,Enero,República de Corea,410,10,7,,17,"(4.697144,-74.140516)"
2018,Enero,República de Corea,410,2,0,,2,"(6.171601,-75.427454)"
2018,Enero,Costa de Marfil,384,1,0,,1,"(3.541112,-76.384584)"
2018,Enero,Costa de Marfil,384,5,9,,14,"(4.697144,-74.140516)"
2018,Enero,Costa de Marfil,384,0,1,,1,"(6.171601,-75.427454)"
2018,Enero,Costa Rica,188,1,0,,1,"(10.408582,-75.538003)"
2018,Enero,Costa Rica,188,35,21,,56,"(10.445761,-75.516429)"
2018,Enero,Costa Rica,188,42,44,,86,"(10.886611,-74.776708)"
2018,Enero,Costa Rica,188,2,14,,16,"(12.5744111,-81.703935)"
2018,Enero,Costa Rica,188,10,5,,15,"(12.586067,-81.702563)"
2018,Enero,Costa Rica,188,112,108,,220,"(3.541112,-76.384584)"
2018,Enero,Costa Rica,188,1537,1588,,3125,"(4.697144,-74.140516)"
2018,Enero,Costa Rica,188,61,42,,103,"(4.815061,-75.736532)"
2018,Enero,Costa Rica,188,369,278,,647,"(6.171601,-75.427454)"
2018,Enero,Costa Rica,188,12,9,,21,"(7.128456,-73.183637)"
2018,Enero,Croacia,191,1,1,,2,"(3.541112,-76.384584)"
2018,Enero,Croacia,191,0,2,,2,"(4.697144,-74.140516)"
2018,Enero,Croacia,191,0,1,,1,"(6.171601,-75.427454)"
2018,Enero,Cuba,192,21,18,,39,"(10.445761,-75.516429)"
2018,Enero,Cuba,192,13,12,,25,"(10.886611,-74.776708)"
2018,Enero,Cuba,192,3,4,,7,"(12.586067,-81.702563)"
2018,Enero,Cuba,192,49,41,,90,"(3.541112,-76.384584)"
2018,Enero,Cuba,192,1456,1250,,2706,"(4.697144,-74.140516)"
2018,Enero,Cuba,192,18,16,,34,"(4.815061,-75.736532)"
2018,Enero,Cuba,192,118,110,,228,"(6.171601,-75.427454)"
2018,Enero,Cuba,192,4,4,,8,"(7.128456,-73.183637)"
2018,Enero,Curazao,99999,19,39,,58,"(4.697144,-74.140516)"
2018,Enero,República Checa,203,1,0,,1,"(3.541112,-76.384584)"
2018,Enero,República Checa,203,10,17,,27,"(4.697144,-74.140516)"
2018,Enero,República Checa,203,2,1,,3,"(6.171601,-75.427454)"
2018,Enero,Chile,152,0,3,,3,"(0.25129,-76.875963)"
2018,Enero,Chile,152,350,346,,696,"(0.814836,-77.662532)"
2018,Enero,Chile,152,1,4,,5,"(1.813928,-78.763924)"
2018,Enero,Chile,152,38,30,,68,"(10.445761,-75.516429)"
2018,Enero,Chile,152,21,25,,46,"(10.886611,-74.776708)"
2018,Enero,Chile,152,1,0,,1,"(12.586067,-81.702563)"
2018,Enero,Chile,152,345,244,,589,"(3.541112,-76.384584)"
2018,Enero,Chile,152,7811,6628,,14439,"(4.697144,-74.140516)"
2018,Enero,Chile,152,46,35,,81,"(4.815061,-75.736532)"
2018,Enero,Chile,152,123,153,,276,"(6.171601,-75.427454)"
2018,Enero,Chile,152,6,4,,10,"(7.128456,-73.183637)"
2018,Enero,China,156,3,5,,8,"(10.886611,-74.776708)"
2018,Enero,China,156,5,16,,21,"(3.541112,-76.384584)"
2018,Enero,China,156,99,247,,346,"(4.697144,-74.140516)"
2018,Enero,China,156,11,43,,54,"(6.171601,-75.427454)"
2018,Enero,Chipre,196,1,1,,2,"(4.697144,-74.140516)"
2018,Enero,Chipre,196,0,1,,1,"(6.171601,-75.427454)"
2018,Enero,Dinamarca,208,0,1,,1,"(10.886611,-74.776708)"
2018,Enero,Dinamarca,208,2,1,,3,"(3.541112,-76.384584)"
2018,Enero,Dinamarca,208,33,35,,68,"(4.697144,-74.140516)"
2018,Enero,Dinamarca,208,1,1,,2,"(4.815061,-75.736532)"
2018,Enero,Dinamarca,208,5,3,,8,"(6.171601,-75.427454)"
2018,Enero,Dinamarca,208,1,0,,1,"(7.128456,-73.183637)"
2018,Enero,Dominica,212,0,1,,1,"(4.697144,-74.140516)"
2018,Enero,Ecuador,218,2,3,,5,"(-0.193180,-74.784874)"
2018,Enero,Ecuador,218,1260,1620,,2880,"(0.25129,-76.875963)"
2018,Enero,Ecuador,218,108,147,,255,"(0.812436,-77.847006)"
2018,Enero,Ecuador,218,13286,14258,,27544,"(0.814836,-77.662532)"
2018,Enero,Ecuador,218,236,239,,475,"(1.813928,-78.763924)"
2018,Enero,Ecuador,218,0,16,,16,"(10.408582,-75.538003)"
2018,Enero,Ecuador,218,5,2,,7,"(10.445761,-75.516429)"
2018,Enero,Ecuador,218,10,14,,24,"(10.886611,-74.776708)"
2018,Enero,Ecuador,218,3,3,,6,"(12.586067,-81.702563)"
2018,Enero,Ecuador,218,554,575,,1129,"(3.541112,-76.384584)"
2018,Enero,Ecuador,218,3626,4820,,8447,"(4.697144,-74.140516)"
2018,Enero,Ecuador,218,1,3,,4,"(4.815061,-75.736532)"
2018,Enero,Ecuador,218,13,39,,52,"(6.171601,-75.427454)"
2018,Enero,Ecuador,218,1,3,,4,"(7.128456,-73.183637)"
2018,Enero,Egipto,818,0,1,,1,"(3.541112,-76.384584)"
2018,Enero,Egipto,818,13,22,,35,"(4.697144,-74.140516)"
2018,Enero,Egipto,818,1,1,,2,"(6.171601,-75.427454)"
2018,Enero,El Salvador,222,1,6,,7,"(10.445761,-75.516429)"
2018,Enero,El Salvador,222,4,12,,16,"(10.886611,-74.776708)"
2018,Enero,El Salvador,222,0,1,,1,"(12.586067,-81.702563)"
2018,Enero,El Salvador,222,57,71,,128,"(3.541112,-76.384584)"
2018,Enero,El Salvador,222,885,1097,,1982,"(4.697144,-74.140516)"
2018,Enero,El Salvador,222,2,2,,4,"(4.815061,-75.736532)"
2018,Enero,El Salvador,222,68,110,,178,"(6.171601,-75.427454)"
2018,Enero,El Salvador,222,0,1,,1,"(7.128456,-73.183637)"
2018,Enero,Emiratos Árabes,784,0,2,,2,"(10.886611,-74.776708)"
2018,Enero,Emiratos Árabes,784,3,2,,5,"(3.541112,-76.384584)"
2018,Enero,Emiratos Árabes,784,133,397,,530,"(4.697144,-74.140516)"
2018,Enero,Emiratos Árabes,784,21,12,,33,"(6.171601,-75.427454)"
2018,Enero,Eritrea,232,1,0,,1,"(4.697144,-74.140516)"
2018,Enero,Eslovaquia,703,2,2,,4,"(4.697144,-74.140516)"
2018,Enero,Eslovaquia,703,0,1,,1,"(6.171601,-75.427454)"
2018,Enero,Eslovenia,705,1,0,,1,"(10.445761,-75.516429)"
2018,Enero,Eslovenia,705,1,3,,4,"(4.697144,-74.140516)"
2018,Enero,Estados Unidos de América,840,1,8,,9,"(10.408582,-75.538003)"
2018,Enero,Estados Unidos de América,840,4436,3704,,8140,"(10.445761,-75.516429)"
2018,Enero,Estados Unidos de América,840,3175,2497,,5672,"(10.886611,-74.776708)"
2018,Enero,Estados Unidos de América,840,123,94,,217,"(12.586067,-81.702563)"
2018,Enero,Estados Unidos de América,840,6217,5000,,11217,"(3.541112,-76.384584)"
2018,Enero,Estados Unidos de América,840,643,531,,1174,"(4.452882,-75.766298)"
2018,Enero,Estados Unidos de América,840,33240,29533,,62773,"(4.697144,-74.140516)"
2018,Enero,Estados Unidos de América,840,1134,871,,2005,"(4.815061,-75.736532)"
2018,Enero,Estados Unidos de América,840,11956,10217,,22173,"(6.171601,-75.427454)"
2018,Enero,Estados Unidos de América,840,259,168,,427,"(7.128456,-73.183637)"
2018,Enero,Estonia,233,0,1,,1,"(10.445761,-75.516429)"
2018,Enero,Estonia,233,0,1,,1,"(4.697144,-74.140516)"
2018,Enero,Estonia,233,0,1,,1,"(6.171601,-75.427454)"
2018,Enero,Etiopia,231,1,1,,2,"(3.541112,-76.384584)"
2018,Enero,Etiopia,231,0,6,,6,"(4.697144,-74.140516)"
2018,Enero,Etiopia,231,0,1,,1,"(6.171601,-75.427454)"
2018,Enero,Filipinas,608,6,5,,11,"(4.697144,-74.140516)"
2018,Enero,Filipinas,608,1,3,,4,"(6.171601,-75.427454)"
2018,Enero,Finlandia,246,1,0,,1,"(10.886611,-74.776708)"
2018,Enero,Finlandia,246,2,1,,3,"(3.541112,-76.384584)"
2018,Enero,Finlandia,246,17,12,,29,"(4.697144,-74.140516)"
2018,Enero,Finlandia,246,1,0,,1,"(4.815061,-75.736532)"
2018,Enero,Finlandia,246,1,1,,2,"(6.171601,-75.427454)"
2018,Enero,Francia,250,15,3,,18,"(10.445761,-75.516429)"
2018,Enero,Francia,250,16,5,,21,"(10.886611,-74.776708)"
2018,Enero,Francia,250,134,90,,224,"(3.541112,-76.384584)"
2018,Enero,Francia,250,1736,1335,,3071,"(4.697144,-74.140516)"
2018,Enero,Francia,250,12,11,,23,"(4.815061,-75.736532)"
2018,Enero,Francia,250,129,102,,231,"(6.171601,-75.427454)"
2018,Enero,Francia,250,3,0,,3,"(7.128456,-73.183637)"
2018,Enero,Gambia,270,0,1,,1,"(4.697144,-74.140516)"
2018,Enero,Ghana,288,2,0,,2,"(4.697144,-74.140516)"
2018,Enero,Ghana,288,0,1,,1,"(6.171601,-75.427454)"
2018,Enero,Gibraltar/Territorio Británico de Ultramar,292,1,0,,1,"(0.814836,-77.662532)"
2018,Enero,Gibraltar/Territorio Británico de Ultramar,292,0,1,,1,"(4.697144,-74.140516)"
2018,Enero,Granada,308,0,1,,1,"(4.697144,-74.140516)"
2018,Enero,Granada,308,0,1,,1,"(6.171601,-75.427454)"
2018,Enero,Grecia,300,2,0,,2,"(3.541112,-76.384584)"
2018,Enero,Grecia,300,10,9,,19,"(4.697144,-74.140516)"
2018,Enero,Grecia,300,1,0,,1,"(6.171601,-75.427454)"
2018,Enero,Guatemala,320,5,11,,16,"(10.445761,-75.516429)"
2018,Enero,Guatemala,320,18,19,,37,"(10.886611,-74.776708)"
2018,Enero,Guatemala,320,0,4,,4,"(12.586067,-81.702563)"
2018,Enero,Guatemala,320,83,148,,231,"(3.541112,-76.384584)"
2018,Enero,Guatemala,320,619,758,,1377,"(4.697144,-74.140516)"
2018,Enero,Guatemala,320,19,18,,37,"(4.815061,-75.736532)"
2018,Enero,Guatemala,320,136,200,,336,"(6.171601,-75.427454)"
2018,Enero,Guatemala,320,14,14,,28,"(7.128456,-73.183637)"
2018,Enero,Guyana,328,1,7,,8,"(10.886611,-74.776708)"
2018,Enero,Guyana,328,0,2,,2,"(3.541112,-76.384584)"
2018,Enero,Guyana,328,3,8,,11,"(4.697144,-74.140516)"
2018,Enero,Guyana,328,1,0,,1,"(4.815061,-75.736532)"
2018,Enero,Guinea,324,0,1,,1,"(4.697144,-74.140516)"
2018,Enero,Guinea Ecuatorial,226,2,7,,9,"(4.697144,-74.140516)"
2018,Enero,Guadalupe/Territorio Francés,312,0,1,,1,"(3.541112,-76.384584)"
2018,Enero,Guadalupe/Territorio Francés,312,4,1,,5,"(4.697144,-74.140516)"
2018,Enero,Guadalupe/Territorio Francés,312,2,0,,2,"(4.815061,-75.736532)"
2018,Enero,Guayana Francesa/Departamento de Ultramar Francés,254,1,0,,1,"(3.541112,-76.384584)"
2018,Enero,Guayana Francesa/Departamento de Ultramar Francés,254,3,3,,6,"(4.697144,-74.140516)"
2018,Enero,Haití,332,0,1,,1,"(10.445761,-75.516429)"
2018,Enero,Haití,332,0,3,,3,"(10.886611,-74.776708)"
2018,Enero,Haití,332,0,1,,1,"(3.541112,-76.384584)"
2018,Enero,Haití,332,1,10,,11,"(4.697144,-74.140516)"
2018,Enero,Haití,332,1,0,,1,"(4.815061,-75.736532)"
2018,Enero,Haití,332,1,4,,5,"(6.171601,-75.427454)"
2018,Enero,Honduras,340,4,7,,11,"(10.445761,-75.516429)"
2018,Enero,Honduras,340,5,13,,18,"(10.886611,-74.776708)"
2018,Enero,Honduras,340,7,22,,29,"(3.541112,-76.384584)"
2018,Enero,Honduras,340,85,177,,262,"(4.697144,-74.140516)"
2018,Enero,Honduras,340,8,8,,16,"(4.815061,-75.736532)"
2018,Enero,Honduras,340,42,70,,112,"(6.171601,-75.427454)"
2018,Enero,Honduras,340,4,4,,8,"(7.128456,-73.183637)"
2018,Enero,Hong Kong,344,0,2,,2,"(10.445761,-75.516429)"
2018,Enero,Hong Kong,344,1,1,,2,"(10.886611,-74.776708)"
2018,Enero,Hong Kong,344,3,0,,3,"(3.541112,-76.384584)"
2018,Enero,Hong Kong,344,21,32,,53,"(4.697144,-74.140516)"
2018,Enero,Hong Kong,344,5,3,,8,"(6.171601,-75.427454)"
2018,Enero,Hungría,348,9,18,,27,"(4.697144,-74.140516)"
2018,Enero,Hungría,348,0,1,,1,"(6.171601,-75.427454)"
2018,Enero,India,356,2,1,,3,"(10.445761,-75.516429)"
2018,Enero,India,356,2,2,,4,"(3.541112,-76.384584)"
2018,Enero,India,356,33,24,,57,"(4.697144,-74.140516)"
2018,Enero,India,356,12,6,,18,"(6.171601,-75.427454)"
2018,Enero,Indonesia,360,5,7,,12,"(4.697144,-74.140516)"
2018,Enero,Indonesia,360,2,0,,2,"(6.171601,-75.427454)"
2018,Enero,Iraq,368,0,1,,1,"(3.541112,-76.384584)"
2018,Enero,Iraq,368,3,10,,13,"(4.697144,-74.140516)"
2018,Enero,Irán,364,2,1,,3,"(4.697144,-74.140516)"
2018,Enero,República de Irlanda,372,1,2,,3,"(3.541112,-76.384584)"
2018,Enero,República de Irlanda,372,28,21,,49,"(4.697144,-74.140516)"
2018,Enero,República de Irlanda,372,2,0,,2,"(6.171601,-75.427454)"
2018,Enero,Islandia,352,4,7,,11,"(4.697144,-74.140516)"
2018,Enero,Israel,376,4,0,,4,"(10.445761,-75.516429)"
2018,Enero,Israel,376,0,2,,2,"(10.886611,-74.776708)"
2018,Enero,Israel,376,13,6,,19,"(3.541112,-76.384584)"
2018,Enero,Israel,376,139,90,,229,"(4.697144,-74.140516)"
2018,Enero,Israel,376,4,1,,5,"(4.815061,-75.736532)"
2018,Enero,Israel,376,11,7,,18,"(6.171601,-75.427454)"
2018,Enero,Italia,380,15,16,,31,"(10.445761,-75.516429)"
2018,Enero,Italia,380,9,5,,14,"(10.886611,-74.776708)"
2018,Enero,Italia,380,0,1,,1,"(12.586067,-81.702563)"
2018,Enero,Italia,380,154,77,,231,"(3.541112,-76.384584)"
2018,Enero,Italia,380,756,480,,1236,"(4.697144,-74.140516)"
2018,Enero,Italia,380,6,5,,11,"(4.815061,-75.736532)"
2018,Enero,Italia,380,103,55,,158,"(6.171601,-75.427454)"
2018,Enero,Islas Feroe/Región Autónoma de Dinamarca,234,1,0,,1,"(4.697144,-74.140516)"
2018,Enero,Jamaica,388,1425,1159,,2584,"(10.408582,-75.538003)"
2018,Enero,Jamaica,388,1,5,,6,"(10.445761,-75.516429)"
2018,Enero,Jamaica,388,1,0,,1,"(10.886611,-74.776708)"
2018,Enero,Jamaica,388,0,12,,12,"(12.5744111,-81.703935)"
2018,Enero,Jamaica,388,3,2,,5,"(12.586067,-81.702563)"
2018,Enero,Jamaica,388,19,11,,30,"(3.541112,-76.384584)"
2018,Enero,Jamaica,388,46,51,,97,"(4.697144,-74.140516)"
2018,Enero,Jamaica,388,7,7,,14,"(4.815061,-75.736532)"
2018,Enero,Jamaica,388,16,8,,24,"(6.171601,-75.427454)"
2018,Enero,Jamaica,388,2,2,,4,"(7.128456,-73.183637)"
2018,Enero,Japón,392,6,5,,11,"(3.541112,-76.384584)"
2018,Enero,Japón,392,62,59,,121,"(4.697144,-74.140516)"
2018,Enero,Japón,392,1,1,,2,"(4.815061,-75.736532)"
2018,Enero,Japón,392,13,7,,20,"(6.171601,-75.427454)"
2018,Enero,Jordania,400,2,0,,2,"(4.697144,-74.140516)"
2018,Enero,Kazajistán,398,0,4,,4,"(4.697144,-74.140516)"
2018,Enero,Kenia,404,2,1,,3,"(10.445761,-75.516429)"
2018,Enero,Kenia,404,5,5,,10,"(4.697144,-74.140516)"
2018,Enero,Kuwait,414,0,1,,1,"(3.541112,-76.384584)"
2018,Enero,Kuwait,414,5,8,,13,"(4.697144,-74.140516)"
2018,Enero,Lituania,440,0,1,,1,"(3.541112,-76.384584)"
2018,Enero,Lituania,440,2,0,,2,"(4.697144,-74.140516)"
2018,Enero,Líbano,422,1,1,,2,"(3.541112,-76.384584)"
2018,Enero,Líbano,422,9,9,,18,"(4.697144,-74.140516)"
2018,Enero,Liberia,430,1,0,,1,"(6.171601,-75.427454)"
2018,Enero,Libia,434,0,1,,1,"(4.697144,-74.140516)"
2018,Enero,Luxemburgo,442,1,0,,1,"(10.445761,-75.516429)"
2018,Enero,Luxemburgo,442,1,0,,1,"(10.886611,-74.776708)"
2018,Enero,Luxemburgo,442,1,1,,2,"(3.541112,-76.384584)"
2018,Enero,Luxemburgo,442,6,5,,11,"(4.697144,-74.140516)"
2018,Enero,Luxemburgo,442,1,0,,1,"(4.815061,-75.736532)"
2018,Enero,Luxemburgo,442,5,1,,6,"(6.171601,-75.427454)"
2018,Enero,Macao,446,1,0,,1,"(4.697144,-74.140516)"
2018,Enero,Malasia,458,1,3,,4,"(4.697144,-74.140516)"
2018,Enero,Malasia,458,2,0,,2,"(6.171601,-75.427454)"
2018,Enero,Maldivas,462,1,1,,2,"(4.697144,-74.140516)"
2018,Enero,Malí,466,1,0,,1,"(4.697144,-74.140516)"
2018,Enero,Malta,470,1,0,,1,"(10.445761,-75.516429)"
2018,Enero,Malta,470,2,0,,2,"(3.541112,-76.384584)"
2018,Enero,Malta,470,27,18,,45,"(4.697144,-74.140516)"
2018,Enero,Malta,470,2,2,,4,"(6.171601,-75.427454)"
2018,Enero,Marruecos,504,6,7,,13,"(4.697144,-74.140516)"
2018,Enero,Marruecos,504,4,2,,6,"(6.171601,-75.427454)"
2018,Enero,Mauritania,478,0,2,,2,"(4.697144,-74.140516)"
2018,Enero,México,484,3,1,,4,"(0.814836,-77.662532)"
2018,Enero,México,484,85,48,,133,"(10.445761,-75.516429)"
2018,Enero,México,484,136,105,,241,"(10.886611,-74.776708)"
2018,Enero,México,484,0,1,,1,"(10.971302,-74.765397)"
2018,Enero,México,484,4,6,,10,"(12.586067,-81.702563)"
2018,Enero,México,484,566,556,,1122,"(3.541112,-76.384584)"
2018,Enero,México,484,17775,15820,,33595,"(4.697144,-74.140516)"
2018,Enero,México,484,187,137,,324,"(4.815061,-75.736532)"
2018,Enero,México,484,2292,1849,,4141,"(6.171601,-75.427454)"
2018,Enero,México,484,84,80,,164,"(7.128456,-73.183637)"
2018,Enero,Mozambique,508,7,3,,10,"(4.697144,-74.140516)"
2018,Enero,Nepal,524,1,0,,1,"(4.697144,-74.140516)"
2018,Enero,Nicaragua,558,8,14,,22,"(10.445761,-75.516429)"
2018,Enero,Nicaragua,558,5,5,,10,"(10.886611,-74.776708)"
2018,Enero,Nicaragua,558,3,0,,3,"(12.586067,-81.702563)"
2018,Enero,Nicaragua,558,15,63,,78,"(3.541112,-76.384584)"
2018,Enero,Nicaragua,558,49,91,,140,"(4.697144,-74.140516)"
2018,Enero,Nicaragua,558,4,7,,11,"(4.815061,-75.736532)"
2018,Enero,Nicaragua,558,23,69,,92,"(6.171601,-75.427454)"
2018,Enero,Nicaragua,558,3,0,,3,"(7.128456,-73.183637)"
2018,Enero,Nigeria,566,0,2,,2,"(10.445761,-75.516429)"
2018,Enero,Nigeria,566,1,11,,12,"(4.697144,-74.140516)"
2018,Enero,Noruega,578,1,1,,2,"(10.445761,-75.516429)"
2018,Enero,Noruega,578,1,0,,1,"(10.886611,-74.776708)"
2018,Enero,Noruega,578,5,4,,9,"(3.541112,-76.384584)"
2018,Enero,Noruega,578,36,33,,69,"(4.697144,-74.140516)"
2018,Enero,Noruega,578,7,7,,14,"(6.171601,-75.427454)"
2018,Enero,Nueva Zelanda,554,1,2,,3,"(10.886611,-74.776708)"
2018,Enero,Nueva Zelanda,554,3,2,,5,"(3.541112,-76.384584)"
2018,Enero,Nueva Zelanda,554,77,52,,129,"(4.697144,-74.140516)"
2018,Enero,Nueva Zelanda,554,9,8,,17,"(6.171601,-75.427454)"
2018,Enero,Omán,512,3,12,,15,"(4.697144,-74.140516)"
2018,Enero,Pakistán,586,1,0,,1,"(4.697144,-74.140516)"
2018,Enero,Panamá,591,36,131,,167,"(10.408582,-75.538003)"
2018,Enero,Panamá,591,1886,1415,,3301,"(10.445761,-75.516429)"
2018,Enero,Panamá,591,1180,1011,,2191,"(10.886611,-74.776708)"
2018,Enero,Panamá,591,1,17,,18,"(10.971302,-74.765397)"
2018,Enero,Panamá,591,1,0,,1,"(11.247723,-74.213989)"
2018,Enero,Panamá,591,0,1,,1,"(11.360009,-72.129330)"
2018,Enero,Panamá,591,0,3,,3,"(12.165168,-71.983761)"
2018,Enero,Panamá,591,1,9,,10,"(12.5744111,-81.703935)"
2018,Enero,Panamá,591,147,119,,266,"(12.586067,-81.702563)"
2018,Enero,Panamá,591,2342,1974,,4316,"(3.541112,-76.384584)"
2018,Enero,Panamá,591,518,370,,888,"(4.452882,-75.766298)"
2018,Enero,Panamá,591,8771,9678,,18450,"(4.697144,-74.140516)"
2018,Enero,Panamá,591,606,434,,1040,"(4.815061,-75.736532)"
2018,Enero,Panamá,591,4260,3832,,8092,"(6.171601,-75.427454)"
2018,Enero,Panamá,591,3,6,,9,"(6.228046,-77.404104)"
2018,Enero,Panamá,591,19,33,,52,"(7.102626,-77.762647)"
2018,Enero,Panamá,591,241,185,,426,"(7.128456,-73.183637)"
2018,Enero,Panamá,591,0,11,,11,"(8.066966,-76.735404)"
2018,Enero,Panamá,591,40,79,,119,"(8.635765,-77.346578)"
2018,Enero,Paraguay,600,3,6,,9,"(10.445761,-75.516429)"
2018,Enero,Paraguay,600,4,8,,12,"(10.886611,-74.776708)"
2018,Enero,Paraguay,600,0,1,,1,"(12.586067,-81.702563)"
2018,Enero,Paraguay,600,21,28,,49,"(3.541112,-76.384584)"
2018,Enero,Paraguay,600,74,192,,266,"(4.697144,-74.140516)"
2018,Enero,Paraguay,600,4,10,,14,"(4.815061,-75.736532)"
2018,Enero,Paraguay,600,18,69,,87,"(6.171601,-75.427454)"
2018,Enero,Perú,604,9,15,,24,"(-0.193180,-74.784874)"
2018,Enero,Perú,604,82,74,,156,"(-4.197703,-69.941278)"
2018,Enero,Perú,604,123,132,,255,"(-4.223468,-69.945098)"
2018,Enero,Perú,604,8,14,,22,"(0.25129,-76.875963)"
2018,Enero,Perú,604,131,148,,279,"(0.814836,-77.662532)"
2018,Enero,Perú,604,0,1,,1,"(1.813928,-78.763924)"
2018,Enero,Perú,604,75,71,,146,"(10.445761,-75.516429)"
2018,Enero,Perú,604,20,18,,38,"(10.886611,-74.776708)"
2018,Enero,Perú,604,0,3,,3,"(11.117806,-74.232622)"
2018,Enero,Perú,604,0,3,,3,"(12.586067,-81.702563)"
2018,Enero,Perú,604,242,274,,516,"(3.541112,-76.384584)"
2018,Enero,Perú,604,5491,6053,,11544,"(4.697144,-74.140516)"
2018,Enero,Perú,604,17,12,,29,"(4.815061,-75.736532)"
2018,Enero,Perú,604,359,358,,717,"(6.171601,-75.427454)"
2018,Enero,Perú,604,8,3,,11,"(7.128456,-73.183637)"
2018,Enero,Polonia,616,0,3,,3,"(3.541112,-76.384584)"
2018,Enero,Polonia,616,6,14,,20,"(4.697144,-74.140516)"
2018,Enero,Polonia,616,3,3,,6,"(6.171601,-75.427454)"
2018,Enero,Portugal,620,1,0,,1,"(10.886611,-74.776708)"
2018,Enero,Portugal,620,6,2,,8,"(3.541112,-76.384584)"
2018,Enero,Portugal,620,97,114,,211,"(4.697144,-74.140516)"
2018,Enero,Portugal,620,2,0,,2,"(4.815061,-75.736532)"
2018,Enero,Portugal,620,9,5,,14,"(6.171601,-75.427454)"
2018,Enero,Polinesia Francesa/Colectividad de Ultramar Francesa,258,1,0,,1,"(3.541112,-76.384584)"
2018,Enero,Puerto Rico/Territorio de Estados Unidos,630,17,9,,26,"(10.445761,-75.516429)"
2018,Enero,Puerto Rico/Territorio de Estados Unidos,630,25,11,,36,"(10.886611,-74.776708)"
2018,Enero,Puerto Rico/Territorio de Estados Unidos,630,57,26,,83,"(3.541112,-76.384584)"
2018,Enero,Puerto Rico/Territorio de Estados Unidos,630,588,462,,1050,"(4.697144,-74.140516)"
2018,Enero,Puerto Rico/Territorio de Estados Unidos,630,2,6,,8,"(4.815061,-75.736532)"
2018,Enero,Puerto Rico/Territorio de Estados Unidos,630,45,33,,78,"(6.171601,-75.427454)"
2018,Enero,Puerto Rico/Territorio de Estados Unidos,630,3,3,,6,"(7.128456,-73.183637)"
2018,Enero,Qatar,634,2,3,,5,"(3.541112,-76.384584)"
2018,Enero,Qatar,634,10,9,,19,"(4.697144,-74.140516)"
2018,Enero,Qatar,634,3,6,,9,"(6.171601,-75.427454)"
2018,Enero,Reino Unido de Gran Bretaña e Irlanda del Norte,826,2,3,,5,"(10.445761,-75.516429)"
2018,Enero,Reino Unido de Gran Bretaña e Irlanda del Norte,826,3,1,,4,"(10.886611,-74.776708)"
2018,Enero,Reino Unido de Gran Bretaña e Irlanda del Norte,826,75,82,,157,"(3.541112,-76.384584)"
2018,Enero,Reino Unido de Gran Bretaña e Irlanda del Norte,826,2262,1863,,4125,"(4.697144,-74.140516)"
2018,Enero,Reino Unido de Gran Bretaña e Irlanda del Norte,826,2,2,,4,"(4.815061,-75.736532)"
2018,Enero,Reino Unido de Gran Bretaña e Irlanda del Norte,826,73,76,,149,"(6.171601,-75.427454)"
2018,Enero,República CentroÁfricana,140,4,4,,8,"(4.697144,-74.140516)"
2018,Enero,Federación de Rusia,643,0,1,,1,"(10.445761,-75.516429)"
2018,Enero,Federación de Rusia,643,0,1,,1,"(12.586067,-81.702563)"
2018,Enero,Federación de Rusia,643,1,0,,1,"(3.541112,-76.384584)"
2018,Enero,Federación de Rusia,643,17,26,,43,"(4.697144,-74.140516)"
2018,Enero,Federación de Rusia,643,0,1,,1,"(6.171601,-75.427454)"
2018,Enero,República Dominicana,214,20,22,,42,"(10.445761,-75.516429)"
2018,Enero,República Dominicana,214,50,56,,106,"(10.886611,-74.776708)"
2018,Enero,República Dominicana,214,5,5,,10,"(11.117806,-74.232622)"
2018,Enero,República Dominicana,214,1,3,,4,"(12.586067,-81.702563)"
2018,Enero,República Dominicana,214,83,86,,169,"(3.541112,-76.384584)"
2018,Enero,República Dominicana,214,3429,3199,,6628,"(4.697144,-74.140516)"
2018,Enero,República Dominicana,214,31,28,,59,"(4.815061,-75.736532)"
2018,Enero,República Dominicana,214,280,222,,502,"(6.171601,-75.427454)"
2018,Enero,República Dominicana,214,11,14,,25,"(7.128456,-73.183637)"
2018,Enero,Reunión,638,0,1,,1,"(4.697144,-74.140516)"
2018,Enero,Rumania,642,2,2,,4,"(4.697144,-74.140516)"
2018,Enero,Sahara Occidental/Desierto Sahara,732,1,0,,1,"(4.697144,-74.140516)"
2018,Enero,San  Vicente y las Granadinas,670,2,3,,5,"(4.697144,-74.140516)"
2018,Enero,Santa Lucia,662,1,1,,2,"(10.445761,-75.516429)"
2018,Enero,Senegal,686,1,4,,5,"(4.697144,-74.140516)"
2018,Enero,Sierra Leona,694,0,1,,1,"(4.697144,-74.140516)"
2018,Enero,Singapur,702,0,2,,2,"(3.541112,-76.384584)"
2018,Enero,Singapur,702,15,17,,32,"(4.697144,-74.140516)"
2018,Enero,Singapur,702,0,1,,1,"(6.171601,-75.427454)"
2018,Enero,Sudáfrica,710,0,1,,1,"(10.445761,-75.516429)"
2018,Enero,Sudáfrica,710,11,13,,24,"(4.697144,-74.140516)"
2018,Enero,Sudán,736,0,1,,1,"(4.697144,-74.140516)"
2018,Enero,Sudán,736,0,1,,1,"(6.171601,-75.427454)"
2018,Enero,Suecia,752,0,1,,1,"(0.814836,-77.662532)"
2018,Enero,Suecia,752,1,1,,2,"(10.445761,-75.516429)"
2018,Enero,Suecia,752,14,14,,28,"(10.886611,-74.776708)"
2018,Enero,Suecia,752,44,50,,94,"(3.541112,-76.384584)"
2018,Enero,Suecia,752,138,124,,262,"(4.697144,-74.140516)"
2018,Enero,Suecia,752,5,1,,6,"(4.815061,-75.736532)"
2018,Enero,Suecia,752,46,19,,65,"(6.171601,-75.427454)"
2018,Enero,Suecia,752,2,3,,5,"(7.128456,-73.183637)"
2018,Enero,Suiza,756,6,2,,8,"(10.445761,-75.516429)"
2018,Enero,Suiza,756,1,0,,1,"(10.886611,-74.776708)"
2018,Enero,Suiza,756,91,42,,133,"(3.541112,-76.384584)"
2018,Enero,Suiza,756,437,265,,702,"(4.697144,-74.140516)"
2018,Enero,Suiza,756,2,0,,2,"(4.815061,-75.736532)"
2018,Enero,Suiza,756,49,30,,79,"(6.171601,-75.427454)"
2018,Enero,Surinam,740,0,1,,1,"(10.408582,-75.538003)"
2018,Enero,Surinam,740,1,2,,3,"(4.697144,-74.140516)"
2018,Enero,Taiwán,158,2,4,,6,"(4.697144,-74.140516)"
2018,Enero,República de Tayikistán,762,0,1,,1,"(4.697144,-74.140516)"
2018,Enero,Tailandia,764,24,21,,45,"(4.697144,-74.140516)"
2018,Enero,Tailandia,764,1,0,,1,"(4.815061,-75.736532)"
2018,Enero,Tailandia,764,3,3,,6,"(6.171601,-75.427454)"
2018,Enero,Tanzania,834,1,1,,2,"(4.697144,-74.140516)"
2018,Enero,Trinidad y Tobago,780,4,4,,8,"(10.445761,-75.516429)"
2018,Enero,Trinidad y Tobago,780,1,4,,5,"(10.886611,-74.776708)"
2018,Enero,Trinidad y Tobago,780,6,5,,11,"(3.541112,-76.384584)"
2018,Enero,Trinidad y Tobago,780,10,39,,49,"(4.697144,-74.140516)"
2018,Enero,Trinidad y Tobago,780,2,2,,4,"(4.815061,-75.736532)"
2018,Enero,Trinidad y Tobago,780,13,9,,22,"(6.171601,-75.427454)"
2018,Enero,Trinidad y Tobago,780,5,2,,7,"(7.128456,-73.183637)"
2018,Enero,Túnez,788,1,5,,6,"(4.697144,-74.140516)"
2018,Enero,Turquía,792,3,4,,7,"(3.541112,-76.384584)"
2018,Enero,Turquía,792,237,188,,425,"(4.697144,-74.140516)"
2018,Enero,Turquía,792,9,7,,16,"(6.171601,-75.427454)"
2018,Enero,Turkmenistán,795,2,0,,2,"(4.697144,-74.140516)"
2018,Enero,Ucrania,804,0,1,,1,"(4.697144,-74.140516)"
2018,Enero,Uganda,800,1,0,,1,"(4.697144,-74.140516)"
2018,Enero,Uruguay,858,4,5,,9,"(10.445761,-75.516429)"
2018,Enero,Uruguay,858,2,0,,2,"(10.886611,-74.776708)"
2018,Enero,Uruguay,858,15,13,,28,"(3.541112,-76.384584)"
2018,Enero,Uruguay,858,377,384,,761,"(4.697144,-74.140516)"
2018,Enero,Uruguay,858,2,10,,12,"(4.815061,-75.736532)"
2018,Enero,Uruguay,858,17,15,,32,"(6.171601,-75.427454)"
2018,Enero,Uruguay,858,0,1,,1,"(7.128456,-73.183637)"
2018,Enero,Venezuela,862,1,25,,26,"(10.408582,-75.538003)"
2018,Enero,Venezuela,862,14,17,,31,"(10.445761,-75.516429)"
2018,Enero,Venezuela,862,17,22,,39,"(10.886611,-74.776708)"
2018,Enero,Venezuela,862,2,1,,3,"(11.117806,-74.232622)"
2018,Enero,Venezuela,862,3217,2983,,6200,"(11.360009,-72.129330)"
2018,Enero,Venezuela,862,2,2,,4,"(11.528919,-72.919681)"
2018,Enero,Venezuela,862,331,267,,598,"(3.541112,-76.384584)"
2018,Enero,Venezuela,862,3,7,,10,"(3.866713,-67.927521)"
2018,Enero,Venezuela,862,1650,1431,,3081,"(4.697144,-74.140516)"
2018,Enero,Venezuela,862,0,1,,1,"(4.815061,-75.736532)"
2018,Enero,Venezuela,862,1319,1127,,2446,"(6.171601,-75.427454)"
2018,Enero,Venezuela,862,81,74,,155,"(6.185799,-67.483929)"
2018,Enero,Venezuela,862,872,772,,1644,"(7.088729,-70.740253)"
2018,Enero,Venezuela,862,7,8,,15,"(7.128456,-73.183637)"
2018,Enero,Venezuela,862,2855,3062,,5917,"(7.818934,-72.453226)"
2018,Enero,Venezuela,862,1,1,,2,"(7.927209,-72.507910)"
2018,Enero,Venezuela,862,209,294,,503,"(8.36068,-72.409396)"
2018,Enero,Vietnam,704,4,3,,7,"(4.697144,-74.140516)"
2018,Enero,Vietnam,704,0,2,,2,"(6.171601,-75.427454)"
2018,Enero,Islas Turcas y Caicos/Territorio Británico de Ultramar,796,1,0,,1,"(4.697144,-74.140516)"
2018,Febrero,Afganistán,4,0,1,,1,"(10.886611,-74.776708)"
2018,Febrero,Afganistán,4,0,1,,1,"(4.697144,-74.140516)"
2018,Febrero,Albania,8,0,2,,2,"(4.697144,-74.140516)"
2018,Febrero,Alemania,276,8,6,,14,"(10.445761,-75.516429)"
2018,Febrero,Alemania,276,7,10,,17,"(10.886611,-74.776708)"
2018,Febrero,Alemania,276,0,1,,1,"(12.586067,-81.702563)"
2018,Febrero,Alemania,276,46,20,,66,"(3.541112,-76.384584)"
2018,Febrero,Alemania,276,838,740,,1578,"(4.697144,-74.140516)"
2018,Febrero,Alemania,276,56,67,,123,"(6.171601,-75.427454)"
2018,Febrero,Alemania,276,0,1,,1,"(7.128456,-73.183637)"
2018,Febrero,Andorra,20,0,1,,1,"(3.541112,-76.384584)"
2018,Febrero,Andorra,20,1,1,,2,"(4.697144,-74.140516)"
2018,Febrero,Angola,24,0,1,,1,"(10.445761,-75.516429)"
2018,Febrero,Angola,24,0,1,,1,"(3.541112,-76.384584)"
2018,Febrero,Angola,24,0,1,,1,"(4.697144,-74.140516)"
2018,Febrero,Antigua y Barbuda,28,1,0,,1,"(3.541112,-76.384584)"
2018,Febrero,Antigua y Barbuda,28,2,4,,6,"(4.697144,-74.140516)"
2018,Febrero,Países Bajos,528,60,35,,95,"(10.445761,-75.516429)"
2018,Febrero,Países Bajos,528,15,15,,30,"(10.886611,-74.776708)"
2018,Febrero,Países Bajos,528,135,81,,216,"(3.541112,-76.384584)"
2018,Febrero,Países Bajos,528,816,744,,1560,"(4.697144,-74.140516)"
2018,Febrero,Países Bajos,528,0,3,,3,"(4.815061,-75.736532)"
2018,Febrero,Países Bajos,528,3,5,,8,"(6.17134,-75.427194)"
2018,Febrero,Países Bajos,528,96,79,,175,"(6.171601,-75.427454)"
2018,Febrero,Países Bajos,528,2,3,,5,"(7.128456,-73.183637)"
2018,Febrero,Arabia Saudita,682,0,1,,1,"(3.541112,-76.384584)"
2018,Febrero,Arabia Saudita,682,4,20,,24,"(4.697144,-74.140516)"
2018,Febrero,Arabia Saudita,682,0,2,,2,"(6.171601,-75.427454)"
2018,Febrero,Argelia,12,1,3,,4,"(4.697144,-74.140516)"
2018,Febrero,Argentina,32,2,3,,5,"(0.25129,-76.875963)"
2018,Febrero,Argentina,32,36,123,,159,"(0.814836,-77.662532)"
2018,Febrero,Argentina,32,32,14,,46,"(10.445761,-75.516429)"
2018,Febrero,Argentina,32,19,20,,39,"(10.886611,-74.776708)"
2018,Febrero,Argentina,32,0,2,,2,"(12.586067,-81.702563)"
2018,Febrero,Argentina,32,93,103,,196,"(3.541112,-76.384584)"
2018,Febrero,Argentina,32,3113,3015,,6128,"(4.697144,-74.140516)"
2018,Febrero,Argentina,32,18,20,,38,"(4.815061,-75.736532)"
2018,Febrero,Argentina,32,78,74,,152,"(6.171601,-75.427454)"
2018,Febrero,Argentina,32,1,3,,4,"(7.128456,-73.183637)"
2018,Febrero,Aruba,533,587,435,,1022,"(10.408582,-75.538003)"
2018,Febrero,Aruba,533,0,1,,1,"(10.445761,-75.516429)"
2018,Febrero,Aruba,533,19,12,,31,"(10.886611,-74.776708)"
2018,Febrero,Aruba,533,1,0,,1,"(11.117806,-74.232622)"
2018,Febrero,Aruba,533,0,14,,14,"(12.165168,-71.983761)"
2018,Febrero,Aruba,533,71,43,,114,"(3.541112,-76.384584)"
2018,Febrero,Aruba,533,1467,1169,,2636,"(4.697144,-74.140516)"
2018,Febrero,Aruba,533,8,5,,13,"(4.815061,-75.736532)"
2018,Febrero,Aruba,533,47,36,,83,"(6.171601,-75.427454)"
2018,Febrero,Aruba,533,17,32,,49,"(7.128456,-73.183637)"
2018,Febrero,Australia,36,2,1,,3,"(10.445761,-75.516429)"
2018,Febrero,Australia,36,2,0,,2,"(10.886611,-74.776708)"
2018,Febrero,Australia,36,24,16,,40,"(3.541112,-76.384584)"
2018,Febrero,Australia,36,389,302,,691,"(4.697144,-74.140516)"
2018,Febrero,Australia,36,2,0,,2,"(4.815061,-75.736532)"
2018,Febrero,Australia,36,54,51,,105,"(6.171601,-75.427454)"
2018,Febrero,Australia,36,5,4,,9,"(7.128456,-73.183637)"
2018,Febrero,Austria,40,2,1,,3,"(10.445761,-75.516429)"
2018,Febrero,Austria,40,2,4,,6,"(3.541112,-76.384584)"
2018,Febrero,Austria,40,35,45,,80,"(4.697144,-74.140516)"
2018,Febrero,Austria,40,6,4,,10,"(6.171601,-75.427454)"
2018,Febrero,Austria,40,0,1,,1,"(7.128456,-73.183637)"
2018,Febrero,Azerbaiyán,31,0,1,,1,"(4.697144,-74.140516)"
2018,Febrero,Bahamas,44,0,1,,1,"(10.445761,-75.516429)"
2018,Febrero,Bahamas,44,1,1,,2,"(10.886611,-74.776708)"
2018,Febrero,Bahamas,44,22,8,,30,"(3.541112,-76.384584)"
2018,Febrero,Bahamas,44,18,15,,33,"(4.697144,-74.140516)"
2018,Febrero,Bahamas,44,1,0,,1,"(4.815061,-75.736532)"
2018,Febrero,Bahamas,44,11,14,,25,"(6.171601,-75.427454)"
2018,Febrero,Bahamas,44,1,0,,1,"(7.128456,-73.183637)"
2018,Febrero,Bahréin,48,1,1,,2,"(3.541112,-76.384584)"
2018,Febrero,Bahréin,48,5,3,,8,"(4.697144,-74.140516)"
2018,Febrero,Bahréin,48,2,0,,2,"(6.171601,-75.427454)"
2018,Febrero,Bahréin,48,1,0,,1,"(7.128456,-73.183637)"
2018,Febrero,Bangladesh,50,1,2,,3,"(4.697144,-74.140516)"
2018,Febrero,Barbados,52,4,4,,8,"(4.697144,-74.140516)"
2018,Febrero,República de Belarús,112,1,0,,1,"(4.697144,-74.140516)"
2018,Febrero,República de Belarús,112,0,1,,1,"(7.818934,-72.453226)"
2018,Febrero,Bélgica,56,1,0,,1,"(10.445761,-75.516429)"
2018,Febrero,Bélgica,56,1,0,,1,"(10.886611,-74.776708)"
2018,Febrero,Bélgica,56,6,7,,13,"(3.541112,-76.384584)"
2018,Febrero,Bélgica,56,72,42,,114,"(4.697144,-74.140516)"
2018,Febrero,Bélgica,56,24,14,,38,"(6.171601,-75.427454)"
2018,Febrero,Belice,84,8,7,,15,"(4.697144,-74.140516)"
2018,Febrero,Belice,84,4,0,,4,"(6.171601,-75.427454)"
2018,Febrero,Bermudas/Territorio Británico de Ultramar,60,2,4,,6,"(4.697144,-74.140516)"
2018,Febrero,Bolivia,68,5,17,,22,"(0.814836,-77.662532)"
2018,Febrero,Bolivia,68,0,1,,1,"(1.813928,-78.763924)"
2018,Febrero,Bolivia,68,5,4,,9,"(10.445761,-75.516429)"
2018,Febrero,Bolivia,68,1,2,,3,"(10.886611,-74.776708)"
2018,Febrero,Bolivia,68,24,41,,65,"(3.541112,-76.384584)"
2018,Febrero,Bolivia,68,318,505,,823,"(4.697144,-74.140516)"
2018,Febrero,Bolivia,68,5,11,,16,"(4.815061,-75.736532)"
2018,Febrero,Bolivia,68,24,67,,91,"(6.171601,-75.427454)"
2018,Febrero,Bolivia,68,1,0,,1,"(7.128456,-73.183637)"
2018,Febrero,Bosnia y Herzegovina,70,1,0,,1,"(4.697144,-74.140516)"
2018,Febrero,Brasil,76,125,244,,369,"(-4.197703,-69.941278)"
2018,Febrero,Brasil,76,21,37,,58,"(-4.223468,-69.945098)"
2018,Febrero,Brasil,76,2,5,,7,"(0.814836,-77.662532)"
2018,Febrero,Brasil,76,2,150,,152,"(10.408582,-75.538003)"
2018,Febrero,Brasil,76,13,13,,26,"(10.445761,-75.516429)"
2018,Febrero,Brasil,76,8,14,,22,"(10.886611,-74.776708)"
2018,Febrero,Brasil,76,1,1,,2,"(12.586067,-81.702563)"
2018,Febrero,Brasil,76,113,173,,286,"(3.541112,-76.384584)"
2018,Febrero,Brasil,76,4,0,,4,"(3.866713,-67.927521)"
2018,Febrero,Brasil,76,3026,3878,,6904,"(4.697144,-74.140516)"
2018,Febrero,Brasil,76,25,41,,66,"(4.815061,-75.736532)"
2018,Febrero,Brasil,76,145,195,,340,"(6.171601,-75.427454)"
2018,Febrero,Brasil,76,12,8,,20,"(7.128456,-73.183637)"
2018,Febrero,Bulgaria,100,2,3,,5,"(4.697144,-74.140516)"
2018,Febrero,Burkina Faso,854,1,0,,1,"(4.697144,-74.140516)"
2018,Febrero,Cabo Verde,132,1,0,,1,"(10.445761,-75.516429)"
2018,Febrero,Cabo Verde,132,0,1,,1,"(4.697144,-74.140516)"
2018,Febrero,Islas Caimán/Territorio Británico de Ultramar,136,0,2,,2,"(10.408582,-75.538003)"
2018,Febrero,Islas Caimán/Territorio Británico de Ultramar,136,1,1,,2,"(10.445761,-75.516429)"
2018,Febrero,Islas Caimán/Territorio Británico de Ultramar,136,6,3,,9,"(4.697144,-74.140516)"
2018,Febrero,Camboya,116,1,4,,5,"(4.697144,-74.140516)"
2018,Febrero,Camboya,116,1,0,,1,"(6.171601,-75.427454)"
2018,Febrero,Camerún,120,1,0,,1,"(4.697144,-74.140516)"
2018,Febrero,Canadá,124,137,94,,231,"(10.445761,-75.516429)"
2018,Febrero,Canadá,124,54,44,,98,"(10.886611,-74.776708)"
2018,Febrero,Canadá,124,12,7,,19,"(12.586067,-81.702563)"
2018,Febrero,Canadá,124,157,126,,283,"(3.541112,-76.384584)"
2018,Febrero,Canadá,124,2,2,,4,"(4.452882,-75.766298)"
2018,Febrero,Canadá,124,1548,1344,,2892,"(4.697144,-74.140516)"
2018,Febrero,Canadá,124,11,17,,28,"(4.815061,-75.736532)"
2018,Febrero,Canadá,124,269,198,,467,"(6.171601,-75.427454)"
2018,Febrero,Canadá,124,8,6,,14,"(7.128456,-73.183637)"
2018,Febrero,Chad,148,1,0,,1,"(4.697144,-74.140516)"
2018,Febrero,España,724,2,4,,6,"(10.445761,-75.516429)"
2018,Febrero,España,724,14,16,,30,"(10.886611,-74.776708)"
2018,Febrero,España,724,3211,2069,,5280,"(3.541112,-76.384584)"
2018,Febrero,España,724,10121,7924,,18045,"(4.697144,-74.140516)"
2018,Febrero,España,724,5,2,,7,"(4.815061,-75.736532)"
2018,Febrero,España,724,1728,1262,,2990,"(6.171601,-75.427454)"
2018,Febrero,España,724,1,0,,1,"(7.128456,-73.183637)"
2018,Febrero,Colombia,170,4,8,,12,"(10.445761,-75.516429)"
2018,Febrero,Colombia,170,226,586,,812,"(4.697144,-74.140516)"
2018,Febrero,República Del Congo,178,0,1,,1,"(4.697144,-74.140516)"
2018,Febrero,República Democrática del Congo,180,0,1,,1,"(3.541112,-76.384584)"
2018,Febrero,República de Corea,410,1,0,,1,"(10.886611,-74.776708)"
2018,Febrero,República de Corea,410,1,0,,1,"(3.541112,-76.384584)"
2018,Febrero,República de Corea,410,21,17,,38,"(4.697144,-74.140516)"
2018,Febrero,República de Corea,410,1,3,,4,"(6.171601,-75.427454)"
2018,Febrero,Costa de Marfil,384,2,4,,6,"(4.697144,-74.140516)"
2018,Febrero,Costa Rica,188,16,13,,29,"(10.445761,-75.516429)"
2018,Febrero,Costa Rica,188,21,25,,46,"(10.886611,-74.776708)"
2018,Febrero,Costa Rica,188,1,8,,9,"(12.5744111,-81.703935)"
2018,Febrero,Costa Rica,188,3,3,,6,"(12.586067,-81.702563)"
2018,Febrero,Costa Rica,188,66,60,,126,"(3.541112,-76.384584)"
2018,Febrero,Costa Rica,188,928,1176,,2104,"(4.697144,-74.140516)"
2018,Febrero,Costa Rica,188,16,16,,32,"(4.815061,-75.736532)"
2018,Febrero,Costa Rica,188,166,159,,325,"(6.171601,-75.427454)"
2018,Febrero,Costa Rica,188,4,5,,9,"(7.128456,-73.183637)"
2018,Febrero,Croacia,191,3,0,,3,"(4.697144,-74.140516)"
2018,Febrero,Cuba,192,7,18,,25,"(10.445761,-75.516429)"
2018,Febrero,Cuba,192,13,13,,26,"(10.886611,-74.776708)"
2018,Febrero,Cuba,192,1,0,,1,"(12.586067,-81.702563)"
2018,Febrero,Cuba,192,34,29,,63,"(3.541112,-76.384584)"
2018,Febrero,Cuba,192,738,672,,1410,"(4.697144,-74.140516)"
2018,Febrero,Cuba,192,8,8,,16,"(4.815061,-75.736532)"
2018,Febrero,Cuba,192,75,73,,148,"(6.171601,-75.427454)"
2018,Febrero,Cuba,192,2,3,,5,"(7.128456,-73.183637)"
2018,Febrero,Curazao,99999,18,53,,71,"(4.697144,-74.140516)"
2018,Febrero,República Checa,203,0,1,,1,"(10.886611,-74.776708)"
2018,Febrero,República Checa,203,14,9,,23,"(4.697144,-74.140516)"
2018,Febrero,República Checa,203,1,0,,1,"(6.171601,-75.427454)"
2018,Febrero,Chile,152,4,1,,5,"(0.25129,-76.875963)"
2018,Febrero,Chile,152,532,501,,1033,"(0.814836,-77.662532)"
2018,Febrero,Chile,152,0,6,,6,"(1.813928,-78.763924)"
2018,Febrero,Chile,152,18,13,,31,"(10.445761,-75.516429)"
2018,Febrero,Chile,152,22,11,,33,"(10.886611,-74.776708)"
2018,Febrero,Chile,152,1,4,,5,"(12.586067,-81.702563)"
2018,Febrero,Chile,152,180,129,,309,"(3.541112,-76.384584)"
2018,Febrero,Chile,152,3805,2978,,6783,"(4.697144,-74.140516)"
2018,Febrero,Chile,152,17,18,,35,"(4.815061,-75.736532)"
2018,Febrero,Chile,152,98,132,,230,"(6.171601,-75.427454)"
2018,Febrero,Chile,152,5,13,,18,"(7.128456,-73.183637)"
2018,Febrero,China,156,0,2,,2,"(10.445761,-75.516429)"
2018,Febrero,China,156,1,0,,1,"(10.886611,-74.776708)"
2018,Febrero,China,156,4,14,,18,"(3.541112,-76.384584)"
2018,Febrero,China,156,80,164,,244,"(4.697144,-74.140516)"
2018,Febrero,China,156,10,19,,29,"(6.171601,-75.427454)"
2018,Febrero,Dinamarca,208,2,1,,3,"(10.445761,-75.516429)"
2018,Febrero,Dinamarca,208,2,0,,2,"(10.886611,-74.776708)"
2018,Febrero,Dinamarca,208,2,0,,2,"(3.541112,-76.384584)"
2018,Febrero,Dinamarca,208,15,16,,31,"(4.697144,-74.140516)"
2018,Febrero,Dinamarca,208,1,1,,2,"(6.171601,-75.427454)"
2018,Febrero,Dominica,212,0,1,,1,"(3.541112,-76.384584)"
2018,Febrero,Ecuador,218,0,7,,7,"(-0.193180,-74.784874)"
2018,Febrero,Ecuador,218,534,1001,,1535,"(0.25129,-76.875963)"
2018,Febrero,Ecuador,218,41,51,,92,"(0.812436,-77.847006)"
2018,Febrero,Ecuador,218,5756,7398,,13154,"(0.814836,-77.662532)"
2018,Febrero,Ecuador,218,168,210,,378,"(1.813928,-78.763924)"
2018,Febrero,Ecuador,218,0,3,,3,"(10.408582,-75.538003)"
2018,Febrero,Ecuador,218,1,8,,9,"(10.445761,-75.516429)"
2018,Febrero,Ecuador,218,6,20,,26,"(10.886611,-74.776708)"
2018,Febrero,Ecuador,218,285,391,,676,"(3.541112,-76.384584)"
2018,Febrero,Ecuador,218,0,1,,1,"(4.452882,-75.766298)"
2018,Febrero,Ecuador,218,2396,3851,,6247,"(4.697144,-74.140516)"
2018,Febrero,Ecuador,218,1,4,,5,"(4.815061,-75.736532)"
2018,Febrero,Ecuador,218,23,79,,102,"(6.171601,-75.427454)"
2018,Febrero,Ecuador,218,3,11,,14,"(7.128456,-73.183637)"
2018,Febrero,Egipto,818,0,1,,1,"(3.541112,-76.384584)"
2018,Febrero,Egipto,818,10,7,,17,"(4.697144,-74.140516)"
2018,Febrero,Egipto,818,2,0,,2,"(6.171601,-75.427454)"
2018,Febrero,Egipto,818,0,1,,1,"(7.128456,-73.183637)"
2018,Febrero,El Salvador,222,2,1,,3,"(10.445761,-75.516429)"
2018,Febrero,El Salvador,222,1,7,,8,"(10.886611,-74.776708)"
2018,Febrero,El Salvador,222,50,74,,124,"(3.541112,-76.384584)"
2018,Febrero,El Salvador,222,597,990,,1587,"(4.697144,-74.140516)"
2018,Febrero,El Salvador,222,1,0,,1,"(4.815061,-75.736532)"
2018,Febrero,El Salvador,222,68,117,,185,"(6.171601,-75.427454)"
2018,Febrero,Emiratos Árabes,784,4,2,,6,"(3.541112,-76.384584)"
2018,Febrero,Emiratos Árabes,784,75,211,,286,"(4.697144,-74.140516)"
2018,Febrero,Emiratos Árabes,784,4,1,,5,"(6.171601,-75.427454)"
2018,Febrero,Emiratos Árabes,784,1,0,,1,"(7.128456,-73.183637)"
2018,Febrero,Eritrea,232,1,1,,2,"(4.697144,-74.140516)"
2018,Febrero,Eslovaquia,703,0,2,,2,"(4.697144,-74.140516)"
2018,Febrero,Eslovenia,705,0,1,,1,"(4.697144,-74.140516)"
2018,Febrero,Estados Unidos de América,840,1,1,,2,"(10.408582,-75.538003)"
2018,Febrero,Estados Unidos de América,840,3016,2439,,5455,"(10.445761,-75.516429)"
2018,Febrero,Estados Unidos de América,840,2672,2076,,4748,"(10.886611,-74.776708)"
2018,Febrero,Estados Unidos de América,840,5,5,,10,"(11.117806,-74.232622)"
2018,Febrero,Estados Unidos de América,840,40,41,,81,"(12.586067,-81.702563)"
2018,Febrero,Estados Unidos de América,840,4807,3325,,8132,"(3.541112,-76.384584)"
2018,Febrero,Estados Unidos de América,840,480,389,,869,"(4.452882,-75.766298)"
2018,Febrero,Estados Unidos de América,840,22914,21248,,44162,"(4.697144,-74.140516)"
2018,Febrero,Estados Unidos de América,840,555,401,,956,"(4.815061,-75.736532)"
2018,Febrero,Estados Unidos de América,840,2,6,,8,"(6.17134,-75.427194)"
2018,Febrero,Estados Unidos de América,840,7385,6272,,13657,"(6.171601,-75.427454)"
2018,Febrero,Estados Unidos de América,840,169,130,,299,"(7.128456,-73.183637)"
2018,Febrero,Estados Unidos de América,840,0,1,,1,"(8.635765,-77.346578)"
2018,Febrero,Estonia,233,0,1,,1,"(4.697144,-74.140516)"
2018,Febrero,Etiopia,231,0,2,,2,"(4.697144,-74.140516)"
2018,Febrero,Etiopia,231,0,1,,1,"(6.171601,-75.427454)"
2018,Febrero,Filipinas,608,0,1,,1,"(10.886611,-74.776708)"
2018,Febrero,Filipinas,608,5,3,,8,"(4.697144,-74.140516)"
2018,Febrero,Filipinas,608,1,3,,4,"(6.171601,-75.427454)"
2018,Febrero,Finlandia,246,0,1,,1,"(10.445761,-75.516429)"
2018,Febrero,Finlandia,246,1,0,,1,"(3.541112,-76.384584)"
2018,Febrero,Finlandia,246,6,1,,7,"(4.697144,-74.140516)"
2018,Febrero,Finlandia,246,2,3,,5,"(6.171601,-75.427454)"
2018,Febrero,Francia,250,3,1,,4,"(10.445761,-75.516429)"
2018,Febrero,Francia,250,5,5,,10,"(10.886611,-74.776708)"
2018,Febrero,Francia,250,62,40,,102,"(3.541112,-76.384584)"
2018,Febrero,Francia,250,913,719,,1632,"(4.697144,-74.140516)"
2018,Febrero,Francia,250,4,6,,10,"(4.815061,-75.736532)"
2018,Febrero,Francia,250,63,46,,109,"(6.171601,-75.427454)"
2018,Febrero,Francia,250,2,0,,2,"(7.128456,-73.183637)"
2018,Febrero,Ghana,288,1,0,,1,"(4.697144,-74.140516)"
2018,Febrero,Grecia,300,5,3,,8,"(4.697144,-74.140516)"
2018,Febrero,Guatemala,320,2,1,,3,"(10.408582,-75.538003)"
2018,Febrero,Guatemala,320,6,9,,15,"(10.445761,-75.516429)"
2018,Febrero,Guatemala,320,13,17,,30,"(10.886611,-74.776708)"
2018,Febrero,Guatemala,320,58,102,,160,"(3.541112,-76.384584)"
2018,Febrero,Guatemala,320,373,505,,878,"(4.697144,-74.140516)"
2018,Febrero,Guatemala,320,9,15,,24,"(4.815061,-75.736532)"
2018,Febrero,Guatemala,320,89,149,,238,"(6.171601,-75.427454)"
2018,Febrero,Guatemala,320,12,20,,32,"(7.128456,-73.183637)"
2018,Febrero,Guyana,328,1,1,,2,"(10.445761,-75.516429)"
2018,Febrero,Guyana,328,1,0,,1,"(10.886611,-74.776708)"
2018,Febrero,Guyana,328,0,3,,3,"(4.697144,-74.140516)"
2018,Febrero,Guinea,324,0,1,,1,"(0.814836,-77.662532)"
2018,Febrero,Guinea,324,0,2,,2,"(4.697144,-74.140516)"
2018,Febrero,Guinea Ecuatorial,226,1,0,,1,"(3.541112,-76.384584)"
2018,Febrero,Guinea Ecuatorial,226,1,0,,1,"(4.697144,-74.140516)"
2018,Febrero,Guinea Ecuatorial,226,0,1,,1,"(6.171601,-75.427454)"
2018,Febrero,Guadalupe/Territorio Francés,312,0,3,,3,"(4.697144,-74.140516)"
2018,Febrero,Guayana Francesa/Departamento de Ultramar Francés,254,1,0,,1,"(10.886611,-74.776708)"
2018,Febrero,Guayana Francesa/Departamento de Ultramar Francés,254,1,0,,1,"(4.697144,-74.140516)"
2018,Febrero,Haití,332,1,0,,1,"(10.445761,-75.516429)"
2018,Febrero,Haití,332,0,1,,1,"(10.886611,-74.776708)"
2018,Febrero,Haití,332,7,7,,14,"(4.697144,-74.140516)"
2018,Febrero,Haití,332,1,0,,1,"(4.815061,-75.736532)"
2018,Febrero,Haití,332,3,2,,5,"(6.171601,-75.427454)"
2018,Febrero,Honduras,340,4,3,,7,"(10.445761,-75.516429)"
2018,Febrero,Honduras,340,1,5,,6,"(10.886611,-74.776708)"
2018,Febrero,Honduras,340,15,26,,41,"(3.541112,-76.384584)"
2018,Febrero,Honduras,340,57,124,,181,"(4.697144,-74.140516)"
2018,Febrero,Honduras,340,1,1,,2,"(4.815061,-75.736532)"
2018,Febrero,Honduras,340,43,81,,124,"(6.171601,-75.427454)"
2018,Febrero,Honduras,340,0,1,,1,"(7.128456,-73.183637)"
2018,Febrero,Hong Kong,344,3,2,,5,"(3.541112,-76.384584)"
2018,Febrero,Hong Kong,344,17,37,,54,"(4.697144,-74.140516)"
2018,Febrero,Hong Kong,344,1,0,,1,"(6.171601,-75.427454)"
2018,Febrero,Hungría,348,6,5,,11,"(4.697144,-74.140516)"
2018,Febrero,India,356,2,5,,7,"(3.541112,-76.384584)"
2018,Febrero,India,356,30,29,,59,"(4.697144,-74.140516)"
2018,Febrero,India,356,5,10,,15,"(6.171601,-75.427454)"
2018,Febrero,India,356,1,0,,1,"(7.128456,-73.183637)"
2018,Febrero,Indonesia,360,2,2,,4,"(4.697144,-74.140516)"
2018,Febrero,Indonesia,360,0,1,,1,"(6.171601,-75.427454)"
2018,Febrero,Iraq,368,0,3,,3,"(4.697144,-74.140516)"
2018,Febrero,Irán,364,2,2,,4,"(4.697144,-74.140516)"
2018,Febrero,República de Irlanda,372,1,0,,1,"(10.445761,-75.516429)"
2018,Febrero,República de Irlanda,372,8,10,,18,"(4.697144,-74.140516)"
2018,Febrero,Islandia,352,1,1,,2,"(3.541112,-76.384584)"
2018,Febrero,Islandia,352,2,6,,8,"(4.697144,-74.140516)"
2018,Febrero,Israel,376,0,2,,2,"(10.886611,-74.776708)"
2018,Febrero,Israel,376,2,3,,5,"(3.541112,-76.384584)"
2018,Febrero,Israel,376,107,71,,178,"(4.697144,-74.140516)"
2018,Febrero,Israel,376,4,5,,9,"(6.171601,-75.427454)"
2018,Febrero,Israel,376,0,1,,1,"(7.128456,-73.183637)"
2018,Febrero,Italia,380,10,2,,12,"(10.445761,-75.516429)"
2018,Febrero,Italia,380,4,5,,9,"(10.886611,-74.776708)"
2018,Febrero,Italia,380,161,55,,216,"(3.541112,-76.384584)"
2018,Febrero,Italia,380,552,349,,901,"(4.697144,-74.140516)"
2018,Febrero,Italia,380,94,66,,160,"(6.171601,-75.427454)"
2018,Febrero,Italia,380,0,1,,1,"(7.128456,-73.183637)"
2018,Febrero,Jamaica,388,691,510,,1201,"(10.408582,-75.538003)"
2018,Febrero,Jamaica,388,4,6,,10,"(10.445761,-75.516429)"
2018,Febrero,Jamaica,388,4,6,,10,"(10.886611,-74.776708)"
2018,Febrero,Jamaica,388,3,0,,3,"(3.541112,-76.384584)"
2018,Febrero,Jamaica,388,14,22,,36,"(4.697144,-74.140516)"
2018,Febrero,Jamaica,388,1,0,,1,"(4.815061,-75.736532)"
2018,Febrero,Jamaica,388,7,12,,19,"(6.171601,-75.427454)"
2018,Febrero,Jamaica,388,1,0,,1,"(8.635765,-77.346578)"
2018,Febrero,Japón,392,2,1,,3,"(10.886611,-74.776708)"
2018,Febrero,Japón,392,4,3,,7,"(3.541112,-76.384584)"
2018,Febrero,Japón,392,40,41,,81,"(4.697144,-74.140516)"
2018,Febrero,Japón,392,8,7,,15,"(6.171601,-75.427454)"
2018,Febrero,Jordania,400,0,2,,2,"(3.541112,-76.384584)"
2018,Febrero,Jordania,400,1,1,,2,"(4.697144,-74.140516)"
2018,Febrero,Kenia,404,2,0,,2,"(4.697144,-74.140516)"
2018,Febrero,Kuwait,414,1,2,,3,"(4.697144,-74.140516)"
2018,Febrero,Kuwait,414,0,1,,1,"(7.128456,-73.183637)"
2018,Febrero,República de Kosovo,901,0,1,,1,"(4.697144,-74.140516)"
2018,Febrero,Letonia,428,0,1,,1,"(4.697144,-74.140516)"
2018,Febrero,Líbano,422,0,2,,2,"(10.886611,-74.776708)"
2018,Febrero,Líbano,422,3,11,,14,"(4.697144,-74.140516)"
2018,Febrero,Líbano,422,4,0,,4,"(7.128456,-73.183637)"
2018,Febrero,Liechtenstein,438,0,1,,1,"(4.697144,-74.140516)"
2018,Febrero,Luxemburgo,442,6,5,,11,"(4.697144,-74.140516)"
2018,Febrero,Luxemburgo,442,0,1,,1,"(6.171601,-75.427454)"
2018,Febrero,Macao,446,0,1,,1,"(4.697144,-74.140516)"
2018,Febrero,Malasia,458,0,1,,1,"(3.541112,-76.384584)"
2018,Febrero,Malasia,458,11,9,,20,"(4.697144,-74.140516)"
2018,Febrero,Malasia,458,2,0,,2,"(6.171601,-75.427454)"
2018,Febrero,Malawi,454,1,0,,1,"(4.697144,-74.140516)"
2018,Febrero,Malí,466,1,0,,1,"(4.697144,-74.140516)"
2018,Febrero,Malta,470,1,0,,1,"(10.445761,-75.516429)"
2018,Febrero,Malta,470,31,15,,46,"(4.697144,-74.140516)"
2018,Febrero,Malta,470,2,3,,5,"(6.171601,-75.427454)"
2018,Febrero,Marruecos,504,3,14,,17,"(4.697144,-74.140516)"
2018,Febrero,Marruecos,504,1,0,,1,"(6.171601,-75.427454)"
2018,Febrero,Martinica/Departamento de Ultramar Francés,474,0,1,,1,"(4.697144,-74.140516)"
2018,Febrero,México,484,41,25,,66,"(10.445761,-75.516429)"
2018,Febrero,México,484,93,59,,152,"(10.886611,-74.776708)"
2018,Febrero,México,484,0,1,,1,"(12.586067,-81.702563)"
2018,Febrero,México,484,527,440,,967,"(3.541112,-76.384584)"
2018,Febrero,México,484,10303,10060,,20363,"(4.697144,-74.140516)"
2018,Febrero,México,484,70,64,,134,"(4.815061,-75.736532)"
2018,Febrero,México,484,1444,1217,,2661,"(6.171601,-75.427454)"
2018,Febrero,México,484,86,66,,152,"(7.128456,-73.183637)"
2018,Febrero,Mónaco,492,0,1,,1,"(4.697144,-74.140516)"
2018,Febrero,Mongolia,496,0,1,,1,"(4.697144,-74.140516)"
2018,Febrero,Namibia,516,1,0,,1,"(4.697144,-74.140516)"
2018,Febrero,Nepal,524,1,0,,1,"(4.697144,-74.140516)"
2018,Febrero,Nicaragua,558,0,2,,2,"(10.445761,-75.516429)"
2018,Febrero,Nicaragua,558,1,6,,7,"(10.886611,-74.776708)"
2018,Febrero,Nicaragua,558,0,1,,1,"(12.5744111,-81.703935)"
2018,Febrero,Nicaragua,558,15,46,,61,"(3.541112,-76.384584)"
2018,Febrero,Nicaragua,558,34,72,,106,"(4.697144,-74.140516)"
2018,Febrero,Nicaragua,558,4,4,,8,"(4.815061,-75.736532)"
2018,Febrero,Nicaragua,558,22,60,,82,"(6.171601,-75.427454)"
2018,Febrero,Nicaragua,558,2,3,,5,"(7.128456,-73.183637)"
2018,Febrero,Nigeria,566,0,1,,1,"(10.445761,-75.516429)"
2018,Febrero,Nigeria,566,1,0,,1,"(3.541112,-76.384584)"
2018,Febrero,Nigeria,566,0,3,,3,"(4.697144,-74.140516)"
2018,Febrero,Noruega,578,0,1,,1,"(10.445761,-75.516429)"
2018,Febrero,Noruega,578,2,0,,2,"(10.886611,-74.776708)"
2018,Febrero,Noruega,578,2,1,,3,"(3.541112,-76.384584)"
2018,Febrero,Noruega,578,13,8,,21,"(4.697144,-74.140516)"
2018,Febrero,Noruega,578,4,4,,8,"(6.171601,-75.427454)"
2018,Febrero,Nueva Zelanda,554,1,0,,1,"(3.541112,-76.384584)"
2018,Febrero,Nueva Zelanda,554,47,26,,73,"(4.697144,-74.140516)"
2018,Febrero,Nueva Zelanda,554,5,6,,11,"(6.171601,-75.427454)"
2018,Febrero,Nueva Zelanda,554,1,0,,1,"(7.128456,-73.183637)"
2018,Febrero,Omán,512,0,3,,3,"(4.697144,-74.140516)"
2018,Febrero,Panamá,591,11,87,,98,"(10.408582,-75.538003)"
2018,Febrero,Panamá,591,1172,982,,2154,"(10.445761,-75.516429)"
2018,Febrero,Panamá,591,894,757,,1651,"(10.886611,-74.776708)"
2018,Febrero,Panamá,591,0,1,,1,"(10.971302,-74.765397)"
2018,Febrero,Panamá,591,0,10,,10,"(12.165168,-71.983761)"
2018,Febrero,Panamá,591,3,25,,28,"(12.5744111,-81.703935)"
2018,Febrero,Panamá,591,58,60,,118,"(12.586067,-81.702563)"
2018,Febrero,Panamá,591,0,10,,10,"(13.3387613,-81.372937)"
2018,Febrero,Panamá,591,2407,1961,,4368,"(3.541112,-76.384584)"
2018,Febrero,Panamá,591,1,6,,7,"(3.893038,-77.067921)"
2018,Febrero,Panamá,591,269,173,,442,"(4.452882,-75.766298)"
2018,Febrero,Panamá,591,5964,6936,,12900,"(4.697144,-74.140516)"
2018,Febrero,Panamá,591,305,263,,568,"(4.815061,-75.736532)"
2018,Febrero,Panamá,591,2,6,,8,"(6.17134,-75.427194)"
2018,Febrero,Panamá,591,2630,2432,,5062,"(6.171601,-75.427454)"
2018,Febrero,Panamá,591,1,5,,6,"(6.228046,-77.404104)"
2018,Febrero,Panamá,591,9,24,,33,"(7.102626,-77.762647)"
2018,Febrero,Panamá,591,168,200,,368,"(7.128456,-73.183637)"
2018,Febrero,Panamá,591,0,8,,8,"(8.066966,-76.735404)"
2018,Febrero,Panamá,591,17,46,,63,"(8.635765,-77.346578)"
2018,Febrero,Paraguay,600,0,11,,11,"(10.445761,-75.516429)"
2018,Febrero,Paraguay,600,2,8,,10,"(10.886611,-74.776708)"
2018,Febrero,Paraguay,600,21,46,,67,"(3.541112,-76.384584)"
2018,Febrero,Paraguay,600,50,133,,183,"(4.697144,-74.140516)"
2018,Febrero,Paraguay,600,9,10,,19,"(4.815061,-75.736532)"
2018,Febrero,Paraguay,600,9,26,,35,"(6.171601,-75.427454)"
2018,Febrero,Paraguay,600,0,2,,2,"(7.128456,-73.183637)"
2018,Febrero,Perú,604,5,5,,10,"(-0.193180,-74.784874)"
2018,Febrero,Perú,604,37,62,,99,"(-4.197703,-69.941278)"
2018,Febrero,Perú,604,173,163,,336,"(-4.223468,-69.945098)"
2018,Febrero,Perú,604,1,10,,11,"(0.25129,-76.875963)"
2018,Febrero,Perú,604,138,166,,304,"(0.814836,-77.662532)"
2018,Febrero,Perú,604,2,3,,5,"(1.813928,-78.763924)"
2018,Febrero,Perú,604,26,31,,57,"(10.445761,-75.516429)"
2018,Febrero,Perú,604,16,13,,29,"(10.886611,-74.776708)"
2018,Febrero,Perú,604,1,1,,2,"(12.586067,-81.702563)"
2018,Febrero,Perú,604,182,148,,330,"(3.541112,-76.384584)"
2018,Febrero,Perú,604,3644,4463,,8107,"(4.697144,-74.140516)"
2018,Febrero,Perú,604,17,15,,32,"(4.815061,-75.736532)"
2018,Febrero,Perú,604,340,402,,742,"(6.171601,-75.427454)"
2018,Febrero,Perú,604,12,4,,16,"(7.128456,-73.183637)"
2018,Febrero,Palestina,99999,0,2,,2,"(4.697144,-74.140516)"
2018,Febrero,Polonia,616,0,1,,1,"(10.886611,-74.776708)"
2018,Febrero,Polonia,616,5,12,,17,"(4.697144,-74.140516)"
2018,Febrero,Polonia,616,0,2,,2,"(6.171601,-75.427454)"
2018,Febrero,Portugal,620,0,2,,2,"(10.886611,-74.776708)"
2018,Febrero,Portugal,620,2,2,,4,"(3.541112,-76.384584)"
2018,Febrero,Portugal,620,86,108,,194,"(4.697144,-74.140516)"
2018,Febrero,Portugal,620,1,1,,2,"(4.815061,-75.736532)"
2018,Febrero,Portugal,620,4,8,,12,"(6.171601,-75.427454)"
2018,Febrero,Puerto Rico/Territorio de Estados Unidos,630,3,2,,5,"(10.445761,-75.516429)"
2018,Febrero,Puerto Rico/Territorio de Estados Unidos,630,5,8,,13,"(10.886611,-74.776708)"
2018,Febrero,Puerto Rico/Territorio de Estados Unidos,630,1,1,,2,"(12.586067,-81.702563)"
2018,Febrero,Puerto Rico/Territorio de Estados Unidos,630,25,6,,31,"(3.541112,-76.384584)"
2018,Febrero,Puerto Rico/Territorio de Estados Unidos,630,364,360,,724,"(4.697144,-74.140516)"
2018,Febrero,Puerto Rico/Territorio de Estados Unidos,630,3,1,,4,"(4.815061,-75.736532)"
2018,Febrero,Puerto Rico/Territorio de Estados Unidos,630,26,15,,41,"(6.171601,-75.427454)"
2018,Febrero,Puerto Rico/Territorio de Estados Unidos,630,2,3,,5,"(7.128456,-73.183637)"
2018,Febrero,Qatar,634,1,0,,1,"(10.886611,-74.776708)"
2018,Febrero,Qatar,634,9,6,,15,"(4.697144,-74.140516)"
2018,Febrero,Qatar,634,4,1,,5,"(6.171601,-75.427454)"
2018,Febrero,Reino Unido de Gran Bretaña e Irlanda del Norte,826,1,0,,1,"(10.445761,-75.516429)"
2018,Febrero,Reino Unido de Gran Bretaña e Irlanda del Norte,826,1,0,,1,"(10.886611,-74.776708)"
2018,Febrero,Reino Unido de Gran Bretaña e Irlanda del Norte,826,30,18,,48,"(3.541112,-76.384584)"
2018,Febrero,Reino Unido de Gran Bretaña e Irlanda del Norte,826,1204,986,,2190,"(4.697144,-74.140516)"
2018,Febrero,Reino Unido de Gran Bretaña e Irlanda del Norte,826,21,15,,36,"(6.171601,-75.427454)"
2018,Febrero,República CentroÁfricana,140,1,2,,3,"(4.697144,-74.140516)"
2018,Febrero,Federación de Rusia,643,30,64,,94,"(4.697144,-74.140516)"
2018,Febrero,Federación de Rusia,643,0,3,,3,"(6.171601,-75.427454)"
2018,Febrero,República Dominicana,214,7,8,,15,"(10.445761,-75.516429)"
2018,Febrero,República Dominicana,214,58,58,,116,"(10.886611,-74.776708)"
2018,Febrero,República Dominicana,214,7,4,,11,"(11.117806,-74.232622)"
2018,Febrero,República Dominicana,214,60,73,,133,"(3.541112,-76.384584)"
2018,Febrero,República Dominicana,214,1793,1712,,3505,"(4.697144,-74.140516)"
2018,Febrero,República Dominicana,214,15,10,,25,"(4.815061,-75.736532)"
2018,Febrero,República Dominicana,214,144,131,,275,"(6.171601,-75.427454)"
2018,Febrero,República Dominicana,214,17,12,,29,"(7.128456,-73.183637)"
2018,Febrero,Reunión,638,0,1,,1,"(4.697144,-74.140516)"
2018,Febrero,República Democrática Popular de Corea,408,0,1,,1,"(4.697144,-74.140516)"
2018,Febrero,Rumania,642,2,1,,3,"(4.697144,-74.140516)"
2018,Febrero,San  Vicente y las Granadinas,670,0,2,,2,"(4.697144,-74.140516)"
2018,Febrero,Senegal,686,2,0,,2,"(4.697144,-74.140516)"
2018,Febrero,Serbia,688,2,0,,2,"(4.697144,-74.140516)"
2018,Febrero,Singapur,702,7,10,,17,"(4.697144,-74.140516)"
2018,Febrero,Somalia,706,0,1,,1,"(4.697144,-74.140516)"
2018,Febrero,Sudáfrica,710,2,0,,2,"(3.541112,-76.384584)"
2018,Febrero,Sudáfrica,710,8,3,,11,"(4.697144,-74.140516)"
2018,Febrero,Sudáfrica,710,2,0,,2,"(6.171601,-75.427454)"
2018,Febrero,Suecia,752,1,0,,1,"(10.445761,-75.516429)"
2018,Febrero,Suecia,752,8,6,,14,"(10.886611,-74.776708)"
2018,Febrero,Suecia,752,22,29,,51,"(3.541112,-76.384584)"
2018,Febrero,Suecia,752,64,47,,111,"(4.697144,-74.140516)"
2018,Febrero,Suecia,752,2,1,,3,"(4.815061,-75.736532)"
2018,Febrero,Suecia,752,16,14,,30,"(6.171601,-75.427454)"
2018,Febrero,Suiza,756,5,1,,6,"(10.445761,-75.516429)"
2018,Febrero,Suiza,756,1,0,,1,"(10.886611,-74.776708)"
2018,Febrero,Suiza,756,47,20,,67,"(3.541112,-76.384584)"
2018,Febrero,Suiza,756,242,166,,408,"(4.697144,-74.140516)"
2018,Febrero,Suiza,756,29,22,,51,"(6.171601,-75.427454)"
2018,Febrero,Suiza,756,1,0,,1,"(7.128456,-73.183637)"
2018,Febrero,Surinam,740,0,1,,1,"(10.408582,-75.538003)"
2018,Febrero,Surinam,740,1,1,,2,"(3.541112,-76.384584)"
2018,Febrero,Surinam,740,3,9,,12,"(4.697144,-74.140516)"
2018,Febrero,Taiwán,158,2,3,,5,"(4.697144,-74.140516)"
2018,Febrero,Tailandia,764,0,1,,1,"(3.541112,-76.384584)"
2018,Febrero,Tailandia,764,19,5,,24,"(4.697144,-74.140516)"
2018,Febrero,Tailandia,764,5,5,,10,"(6.171601,-75.427454)"
2018,Febrero,Trinidad y Tobago,780,0,2,,2,"(10.886611,-74.776708)"
2018,Febrero,Trinidad y Tobago,780,2,7,,9,"(3.541112,-76.384584)"
2018,Febrero,Trinidad y Tobago,780,7,10,,17,"(4.697144,-74.140516)"
2018,Febrero,Trinidad y Tobago,780,5,7,,12,"(6.171601,-75.427454)"
2018,Febrero,Trinidad y Tobago,780,0,1,,1,"(7.128456,-73.183637)"
2018,Febrero,Turquía,792,1,1,,2,"(10.445761,-75.516429)"
2018,Febrero,Turquía,792,1,3,,4,"(3.541112,-76.384584)"
2018,Febrero,Turquía,792,394,265,,659,"(4.697144,-74.140516)"
2018,Febrero,Turquía,792,2,2,,4,"(6.171601,-75.427454)"
2018,Febrero,Turkmenistán,795,2,2,,4,"(4.697144,-74.140516)"
2018,Febrero,Ucrania,804,1,1,,2,"(4.697144,-74.140516)"
2018,Febrero,Uganda,800,0,1,,1,"(4.697144,-74.140516)"
2018,Febrero,Uruguay,858,0,2,,2,"(0.814836,-77.662532)"
2018,Febrero,Uruguay,858,1,5,,6,"(10.445761,-75.516429)"
2018,Febrero,Uruguay,858,0,1,,1,"(10.886611,-74.776708)"
2018,Febrero,Uruguay,858,13,27,,40,"(3.541112,-76.384584)"
2018,Febrero,Uruguay,858,246,279,,525,"(4.697144,-74.140516)"
2018,Febrero,Uruguay,858,1,9,,10,"(4.815061,-75.736532)"
2018,Febrero,Uruguay,858,12,14,,26,"(6.171601,-75.427454)"
2018,Febrero,Uruguay,858,1,1,,2,"(7.128456,-73.183637)"
2018,Febrero,Uzbekistán,860,0,4,,4,"(4.697144,-74.140516)"
2018,Febrero,Vanuatu,548,1,0,,1,"(4.697144,-74.140516)"
2018,Febrero,Venezuela,862,11,9,,20,"(10.445761,-75.516429)"
2018,Febrero,Venezuela,862,14,19,,33,"(10.886611,-74.776708)"
2018,Febrero,Venezuela,862,1,0,,1,"(11.117806,-74.232622)"
2018,Febrero,Venezuela,862,1759,1929,,3688,"(11.360009,-72.129330)"
2018,Febrero,Venezuela,862,1,0,,1,"(12.586067,-81.702563)"
2018,Febrero,Venezuela,862,357,284,,641,"(3.541112,-76.384584)"
2018,Febrero,Venezuela,862,5,6,,11,"(3.866713,-67.927521)"
2018,Febrero,Venezuela,862,926,821,,1747,"(4.697144,-74.140516)"
2018,Febrero,Venezuela,862,3,0,,3,"(4.815061,-75.736532)"
2018,Febrero,Venezuela,862,701,626,,1327,"(6.171601,-75.427454)"
2018,Febrero,Venezuela,862,41,47,,88,"(6.185799,-67.483929)"
2018,Febrero,Venezuela,862,444,504,,948,"(7.088729,-70.740253)"
2018,Febrero,Venezuela,862,6,3,,9,"(7.128456,-73.183637)"
2018,Febrero,Venezuela,862,1465,1615,,3080,"(7.818934,-72.453226)"
2018,Febrero,Venezuela,862,98,138,,236,"(8.36068,-72.409396)"
2018,Febrero,Vietnam,704,3,4,,7,"(4.697144,-74.140516)"
2018,Febrero,Vietnam,704,6,0,,6,"(6.171601,-75.427454)"
2018,Marzo,Afganistán,4,0,4,,4,"(4.697144,-74.140516)"
2018,Marzo,Afganistán,4,0,1,,1,"(6.171601,-75.427454)"
2018,Marzo,Albania,8,1,0,,1,"(3.541112,-76.384584)"
2018,Marzo,Albania,8,0,5,,5,"(4.697144,-74.140516)"
2018,Marzo,Alemania,276,1,1,,2,"(0.814836,-77.662532)"
2018,Marzo,Alemania,276,4,3,,7,"(10.445761,-75.516429)"
2018,Marzo,Alemania,276,19,12,,31,"(10.886611,-74.776708)"
2018,Marzo,Alemania,276,55,46,,101,"(3.541112,-76.384584)"
2018,Marzo,Alemania,276,1071,976,,2047,"(4.697144,-74.140516)"
2018,Marzo,Alemania,276,2,2,,4,"(4.815061,-75.736532)"
2018,Marzo,Alemania,276,54,54,,108,"(6.171601,-75.427454)"
2018,Marzo,Alemania,276,1,1,,2,"(7.128456,-73.183637)"
2018,Marzo,Angola,24,2,3,,5,"(4.697144,-74.140516)"
2018,Marzo,Antigua y Barbuda,28,1,1,,2,"(4.697144,-74.140516)"
2018,Marzo,Antigua y Barbuda,28,0,1,,1,"(4.815061,-75.736532)"
2018,Marzo,Países Bajos,528,0,1,,1,"(10.408582,-75.538003)"
2018,Marzo,Países Bajos,528,109,67,,176,"(10.445761,-75.516429)"
2018,Marzo,Países Bajos,528,17,8,,25,"(10.886611,-74.776708)"
2018,Marzo,Países Bajos,528,53,33,,86,"(3.541112,-76.384584)"
2018,Marzo,Países Bajos,528,842,756,,1598,"(4.697144,-74.140516)"
2018,Marzo,Países Bajos,528,1,0,,1,"(4.815061,-75.736532)"
2018,Marzo,Países Bajos,528,102,96,,198,"(6.171601,-75.427454)"
2018,Marzo,Países Bajos,528,2,0,,2,"(7.128456,-73.183637)"
2018,Marzo,Arabia Saudita,682,0,2,,2,"(3.541112,-76.384584)"
2018,Marzo,Arabia Saudita,682,4,28,,32,"(4.697144,-74.140516)"
2018,Marzo,Arabia Saudita,682,0,2,,2,"(6.171601,-75.427454)"
2018,Marzo,Argelia,12,3,0,,3,"(4.697144,-74.140516)"
2018,Marzo,Argelia,12,1,0,,1,"(6.171601,-75.427454)"
2018,Marzo,Argentina,32,1,3,,4,"(0.25129,-76.875963)"
2018,Marzo,Argentina,32,42,77,,119,"(0.814836,-77.662532)"
2018,Marzo,Argentina,32,52,43,,95,"(10.445761,-75.516429)"
2018,Marzo,Argentina,32,74,48,,122,"(10.886611,-74.776708)"
2018,Marzo,Argentina,32,1,2,,3,"(12.586067,-81.702563)"
2018,Marzo,Argentina,32,173,151,,324,"(3.541112,-76.384584)"
2018,Marzo,Argentina,32,3981,4053,,8035,"(4.697144,-74.140516)"
2018,Marzo,Argentina,32,25,43,,68,"(4.815061,-75.736532)"
2018,Marzo,Argentina,32,176,168,,344,"(6.171601,-75.427454)"
2018,Marzo,Argentina,32,13,6,,19,"(7.128456,-73.183637)"
2018,Marzo,Aruba,533,2041,1538,,3579,"(10.408582,-75.538003)"
2018,Marzo,Aruba,533,6,5,,11,"(10.445761,-75.516429)"
2018,Marzo,Aruba,533,8,3,,11,"(10.886611,-74.776708)"
2018,Marzo,Aruba,533,7,2,,9,"(11.247723,-74.213989)"
2018,Marzo,Aruba,533,20,23,,43,"(3.541112,-76.384584)"
2018,Marzo,Aruba,533,2160,1716,,3876,"(4.697144,-74.140516)"
2018,Marzo,Aruba,533,5,4,,9,"(4.815061,-75.736532)"
2018,Marzo,Aruba,533,72,54,,126,"(6.171601,-75.427454)"
2018,Marzo,Aruba,533,12,74,,86,"(7.128456,-73.183637)"
2018,Marzo,Australia,36,0,1,,1,"(10.445761,-75.516429)"
2018,Marzo,Australia,36,7,0,,7,"(10.886611,-74.776708)"
2018,Marzo,Australia,36,11,14,,25,"(3.541112,-76.384584)"
2018,Marzo,Australia,36,313,238,,551,"(4.697144,-74.140516)"
2018,Marzo,Australia,36,6,0,,6,"(4.815061,-75.736532)"
2018,Marzo,Australia,36,52,32,,84,"(6.171601,-75.427454)"
2018,Marzo,Austria,40,1,1,,2,"(10.886611,-74.776708)"
2018,Marzo,Austria,40,1,1,,2,"(3.541112,-76.384584)"
2018,Marzo,Austria,40,42,32,,74,"(4.697144,-74.140516)"
2018,Marzo,Austria,40,7,8,,15,"(6.171601,-75.427454)"
2018,Marzo,Azerbaiyán,31,2,1,,3,"(4.697144,-74.140516)"
2018,Marzo,Bahamas,44,0,3,,3,"(10.445761,-75.516429)"
2018,Marzo,Bahamas,44,0,5,,5,"(10.886611,-74.776708)"
2018,Marzo,Bahamas,44,16,13,,29,"(3.541112,-76.384584)"
2018,Marzo,Bahamas,44,12,18,,30,"(4.697144,-74.140516)"
2018,Marzo,Bahamas,44,3,1,,4,"(4.815061,-75.736532)"
2018,Marzo,Bahamas,44,17,14,,31,"(6.171601,-75.427454)"
2018,Marzo,Bahréin,48,0,1,,1,"(10.886611,-74.776708)"
2018,Marzo,Bahréin,48,2,0,,2,"(4.452882,-75.766298)"
2018,Marzo,Bahréin,48,0,4,,4,"(4.697144,-74.140516)"
2018,Marzo,Bahréin,48,1,1,,2,"(6.171601,-75.427454)"
2018,Marzo,Bahréin,48,0,1,,1,"(7.128456,-73.183637)"
2018,Marzo,Bangladesh,50,1,0,,1,"(6.171601,-75.427454)"
2018,Marzo,Barbados,52,1,0,,1,"(10.445761,-75.516429)"
2018,Marzo,Barbados,52,1,0,,1,"(12.586067,-81.702563)"
2018,Marzo,Barbados,52,1,2,,3,"(3.541112,-76.384584)"
2018,Marzo,Barbados,52,6,5,,11,"(4.697144,-74.140516)"
2018,Marzo,República de Belarús,112,1,1,,2,"(4.697144,-74.140516)"
2018,Marzo,Bélgica,56,1,2,,3,"(10.445761,-75.516429)"
2018,Marzo,Bélgica,56,0,1,,1,"(10.886611,-74.776708)"
2018,Marzo,Bélgica,56,9,8,,17,"(3.541112,-76.384584)"
2018,Marzo,Bélgica,56,77,54,,131,"(4.697144,-74.140516)"
2018,Marzo,Bélgica,56,20,13,,33,"(6.171601,-75.427454)"
2018,Marzo,Belice,84,2,2,,4,"(3.541112,-76.384584)"
2018,Marzo,Belice,84,17,10,,27,"(4.697144,-74.140516)"
2018,Marzo,Belice,84,1,0,,1,"(4.815061,-75.736532)"
2018,Marzo,Belice,84,6,4,,10,"(6.171601,-75.427454)"
2018,Marzo,Benín,204,0,1,,1,"(4.697144,-74.140516)"
2018,Marzo,Bermudas/Territorio Británico de Ultramar,60,2,1,,3,"(4.697144,-74.140516)"
2018,Marzo,Bermudas/Territorio Británico de Ultramar,60,1,0,,1,"(4.815061,-75.736532)"
2018,Marzo,Bermudas/Territorio Británico de Ultramar,60,1,1,,2,"(6.171601,-75.427454)"
2018,Marzo,Bolivia,68,8,31,,39,"(0.814836,-77.662532)"
2018,Marzo,Bolivia,68,2,2,,4,"(10.886611,-74.776708)"
2018,Marzo,Bolivia,68,25,32,,57,"(3.541112,-76.384584)"
2018,Marzo,Bolivia,68,366,541,,907,"(4.697144,-74.140516)"
2018,Marzo,Bolivia,68,9,24,,33,"(4.815061,-75.736532)"
2018,Marzo,Bolivia,68,35,68,,103,"(6.171601,-75.427454)"
2018,Marzo,Bosnia y Herzegovina,70,2,0,,2,"(4.697144,-74.140516)"
2018,Marzo,Brasil,76,104,215,,319,"(-4.197703,-69.941278)"
2018,Marzo,Brasil,76,22,29,,51,"(-4.223468,-69.945098)"
2018,Marzo,Brasil,76,3,5,,8,"(0.814836,-77.662532)"
2018,Marzo,Brasil,76,16,13,,29,"(10.445761,-75.516429)"
2018,Marzo,Brasil,76,27,27,,54,"(10.886611,-74.776708)"
2018,Marzo,Brasil,76,2,3,,5,"(12.586067,-81.702563)"
2018,Marzo,Brasil,76,144,161,,305,"(3.541112,-76.384584)"
2018,Marzo,Brasil,76,4479,5418,,9897,"(4.697144,-74.140516)"
2018,Marzo,Brasil,76,41,62,,103,"(4.815061,-75.736532)"
2018,Marzo,Brasil,76,288,285,,573,"(6.171601,-75.427454)"
2018,Marzo,Brasil,76,10,11,,21,"(7.128456,-73.183637)"
2018,Marzo,Brunei Darussalam,96,0,1,,1,"(4.697144,-74.140516)"
2018,Marzo,Bulgaria,100,3,1,,4,"(4.697144,-74.140516)"
2018,Marzo,Bulgaria,100,2,1,,3,"(6.171601,-75.427454)"
2018,Marzo,Islas Caimán/Territorio Británico de Ultramar,136,1,0,,1,"(10.445761,-75.516429)"
2018,Marzo,Islas Caimán/Territorio Británico de Ultramar,136,1,1,,2,"(12.586067,-81.702563)"
2018,Marzo,Islas Caimán/Territorio Británico de Ultramar,136,2,1,,3,"(4.697144,-74.140516)"
2018,Marzo,Camboya,116,4,1,,5,"(3.541112,-76.384584)"
2018,Marzo,Camboya,116,0,1,,1,"(4.697144,-74.140516)"
2018,Marzo,Canadá,124,156,122,,278,"(10.445761,-75.516429)"
2018,Marzo,Canadá,124,55,30,,85,"(10.886611,-74.776708)"
2018,Marzo,Canadá,124,23,12,,35,"(12.586067,-81.702563)"
2018,Marzo,Canadá,124,179,140,,319,"(3.541112,-76.384584)"
2018,Marzo,Canadá,124,0,1,,1,"(4.452882,-75.766298)"
2018,Marzo,Canadá,124,2073,1674,,3747,"(4.697144,-74.140516)"
2018,Marzo,Canadá,124,20,14,,34,"(4.815061,-75.736532)"
2018,Marzo,Canadá,124,304,217,,521,"(6.171601,-75.427454)"
2018,Marzo,Canadá,124,19,9,,28,"(7.128456,-73.183637)"
2018,Marzo,España,724,5,4,,9,"(10.445761,-75.516429)"
2018,Marzo,España,724,15,11,,26,"(10.886611,-74.776708)"
2018,Marzo,España,724,3219,2141,,5360,"(3.541112,-76.384584)"
2018,Marzo,España,724,14033,10902,,24936,"(4.697144,-74.140516)"
2018,Marzo,España,724,5,3,,8,"(4.815061,-75.736532)"
2018,Marzo,España,724,2589,1875,,4464,"(6.171601,-75.427454)"
2018,Marzo,España,724,1,3,,4,"(7.128456,-73.183637)"
2018,Marzo,Colombia,170,2,12,,14,"(10.445761,-75.516429)"
2018,Marzo,Colombia,170,278,693,,971,"(4.697144,-74.140516)"
2018,Marzo,República Del Congo,178,0,2,,2,"(4.697144,-74.140516)"
2018,Marzo,República Democrática del Congo,180,0,1,,1,"(4.697144,-74.140516)"
2018,Marzo,República de Corea,410,12,23,,35,"(4.697144,-74.140516)"
2018,Marzo,República de Corea,410,3,4,,7,"(6.171601,-75.427454)"
2018,Marzo,Costa de Marfil,384,5,3,,8,"(4.697144,-74.140516)"
2018,Marzo,Costa Rica,188,1,2,,3,"(10.408582,-75.538003)"
2018,Marzo,Costa Rica,188,6,8,,14,"(10.445761,-75.516429)"
2018,Marzo,Costa Rica,188,36,25,,61,"(10.886611,-74.776708)"
2018,Marzo,Costa Rica,188,1,0,,1,"(10.971302,-74.765397)"
2018,Marzo,Costa Rica,188,3,25,,28,"(12.5744111,-81.703935)"
2018,Marzo,Costa Rica,188,12,8,,20,"(12.586067,-81.702563)"
2018,Marzo,Costa Rica,188,41,27,,68,"(3.541112,-76.384584)"
2018,Marzo,Costa Rica,188,1222,1318,,2540,"(4.697144,-74.140516)"
2018,Marzo,Costa Rica,188,17,9,,26,"(4.815061,-75.736532)"
2018,Marzo,Costa Rica,188,2,6,,8,"(6.17134,-75.427194)"
2018,Marzo,Costa Rica,188,152,126,,278,"(6.171601,-75.427454)"
2018,Marzo,Costa Rica,188,5,6,,11,"(7.128456,-73.183637)"
2018,Marzo,Croacia,191,7,5,,12,"(4.697144,-74.140516)"
2018,Marzo,Cuba,192,20,22,,42,"(10.445761,-75.516429)"
2018,Marzo,Cuba,192,36,26,,62,"(10.886611,-74.776708)"
2018,Marzo,Cuba,192,72,66,,138,"(3.541112,-76.384584)"
2018,Marzo,Cuba,192,1275,1051,,2326,"(4.697144,-74.140516)"
2018,Marzo,Cuba,192,34,40,,74,"(4.815061,-75.736532)"
2018,Marzo,Cuba,192,124,95,,219,"(6.171601,-75.427454)"
2018,Marzo,Cuba,192,15,8,,23,"(7.128456,-73.183637)"
2018,Marzo,Curazao,99999,1,1,,2,"(10.445761,-75.516429)"
2018,Marzo,Curazao,99999,4,2,,6,"(10.886611,-74.776708)"
2018,Marzo,Curazao,99999,0,2,,2,"(3.541112,-76.384584)"
2018,Marzo,Curazao,99999,249,229,,478,"(4.697144,-74.140516)"
2018,Marzo,Curazao,99999,1,1,,2,"(4.815061,-75.736532)"
2018,Marzo,Curazao,99999,2,2,,4,"(6.171601,-75.427454)"
2018,Marzo,República Checa,203,0,2,,2,"(3.541112,-76.384584)"
2018,Marzo,República Checa,203,17,28,,45,"(4.697144,-74.140516)"
2018,Marzo,Chile,152,2,2,,4,"(0.25129,-76.875963)"
2018,Marzo,Chile,152,520,474,,994,"(0.814836,-77.662532)"
2018,Marzo,Chile,152,3,3,,6,"(1.813928,-78.763924)"
2018,Marzo,Chile,152,25,26,,51,"(10.445761,-75.516429)"
2018,Marzo,Chile,152,41,28,,69,"(10.886611,-74.776708)"
2018,Marzo,Chile,152,0,1,,1,"(12.586067,-81.702563)"
2018,Marzo,Chile,152,306,214,,520,"(3.541112,-76.384584)"
2018,Marzo,Chile,152,5441,4420,,9862,"(4.697144,-74.140516)"
2018,Marzo,Chile,152,83,54,,137,"(4.815061,-75.736532)"
2018,Marzo,Chile,152,238,197,,435,"(6.171601,-75.427454)"
2018,Marzo,Chile,152,4,4,,8,"(7.128456,-73.183637)"
2018,Marzo,China,156,2,6,,8,"(10.445761,-75.516429)"
2018,Marzo,China,156,3,13,,16,"(10.886611,-74.776708)"
2018,Marzo,China,156,14,37,,51,"(3.541112,-76.384584)"
2018,Marzo,China,156,257,686,,943,"(4.697144,-74.140516)"
2018,Marzo,China,156,2,4,,6,"(4.815061,-75.736532)"
2018,Marzo,China,156,60,132,,192,"(6.171601,-75.427454)"
2018,Marzo,China,156,1,0,,1,"(7.128456,-73.183637)"
2018,Marzo,Dinamarca,208,0,1,,1,"(10.445761,-75.516429)"
2018,Marzo,Dinamarca,208,0,1,,1,"(10.886611,-74.776708)"
2018,Marzo,Dinamarca,208,0,6,,6,"(3.541112,-76.384584)"
2018,Marzo,Dinamarca,208,28,19,,47,"(4.697144,-74.140516)"
2018,Marzo,Dinamarca,208,3,2,,5,"(6.171601,-75.427454)"
2018,Marzo,Ecuador,218,0,1,,1,"(-0.193180,-74.784874)"
2018,Marzo,Ecuador,218,899,1245,,2144,"(0.25129,-76.875963)"
2018,Marzo,Ecuador,218,117,118,,235,"(0.812436,-77.847006)"
2018,Marzo,Ecuador,218,7991,8999,,16990,"(0.814836,-77.662532)"
2018,Marzo,Ecuador,218,248,227,,475,"(1.813928,-78.763924)"
2018,Marzo,Ecuador,218,0,12,,12,"(10.408582,-75.538003)"
2018,Marzo,Ecuador,218,2,1,,3,"(10.445761,-75.516429)"
2018,Marzo,Ecuador,218,6,1,,7,"(10.886611,-74.776708)"
2018,Marzo,Ecuador,218,423,435,,858,"(3.541112,-76.384584)"
2018,Marzo,Ecuador,218,2948,4087,,7035,"(4.697144,-74.140516)"
2018,Marzo,Ecuador,218,1,0,,1,"(4.815061,-75.736532)"
2018,Marzo,Ecuador,218,0,1,,1,"(6.17134,-75.427194)"
2018,Marzo,Ecuador,218,31,32,,63,"(6.171601,-75.427454)"
2018,Marzo,Ecuador,218,3,2,,5,"(7.128456,-73.183637)"
2018,Marzo,Egipto,818,1,0,,1,"(10.886611,-74.776708)"
2018,Marzo,Egipto,818,3,6,,9,"(3.541112,-76.384584)"
2018,Marzo,Egipto,818,22,11,,33,"(4.697144,-74.140516)"
2018,Marzo,Egipto,818,7,2,,9,"(6.171601,-75.427454)"
2018,Marzo,El Salvador,222,1,2,,3,"(10.445761,-75.516429)"
2018,Marzo,El Salvador,222,6,12,,18,"(10.886611,-74.776708)"
2018,Marzo,El Salvador,222,71,75,,146,"(3.541112,-76.384584)"
2018,Marzo,El Salvador,222,775,963,,1738,"(4.697144,-74.140516)"
2018,Marzo,El Salvador,222,2,1,,3,"(4.815061,-75.736532)"
2018,Marzo,El Salvador,222,80,100,,180,"(6.171601,-75.427454)"
2018,Marzo,Emiratos Árabes,784,1,0,,1,"(10.445761,-75.516429)"
2018,Marzo,Emiratos Árabes,784,1,0,,1,"(10.886611,-74.776708)"
2018,Marzo,Emiratos Árabes,784,2,2,,4,"(3.541112,-76.384584)"
2018,Marzo,Emiratos Árabes,784,125,230,,355,"(4.697144,-74.140516)"
2018,Marzo,Emiratos Árabes,784,13,13,,26,"(6.171601,-75.427454)"
2018,Marzo,Eritrea,232,1,1,,2,"(4.697144,-74.140516)"
2018,Marzo,Eslovaquia,703,1,3,,4,"(4.697144,-74.140516)"
2018,Marzo,Eslovaquia,703,1,0,,1,"(6.171601,-75.427454)"
2018,Marzo,Eslovenia,705,1,1,,2,"(4.697144,-74.140516)"
2018,Marzo,Estados Unidos de América,840,0,1,,1,"(10.408582,-75.538003)"
2018,Marzo,Estados Unidos de América,840,3555,2827,,6382,"(10.445761,-75.516429)"
2018,Marzo,Estados Unidos de América,840,3206,2677,,5883,"(10.886611,-74.776708)"
2018,Marzo,Estados Unidos de América,840,0,1,,1,"(11.117806,-74.232622)"
2018,Marzo,Estados Unidos de América,840,44,40,,84,"(12.586067,-81.702563)"
2018,Marzo,Estados Unidos de América,840,6513,4607,,11120,"(3.541112,-76.384584)"
2018,Marzo,Estados Unidos de América,840,685,493,,1178,"(4.452882,-75.766298)"
2018,Marzo,Estados Unidos de América,840,34244,30225,,64469,"(4.697144,-74.140516)"
2018,Marzo,Estados Unidos de América,840,868,624,,1492,"(4.815061,-75.736532)"
2018,Marzo,Estados Unidos de América,840,11104,9059,,20163,"(6.171601,-75.427454)"
2018,Marzo,Estados Unidos de América,840,229,198,,427,"(7.128456,-73.183637)"
2018,Marzo,Estados Unidos de América,840,0,1,,1,"(8.635765,-77.346578)"
2018,Marzo,Estonia,233,3,1,,4,"(4.697144,-74.140516)"
2018,Marzo,Etiopia,231,1,2,,3,"(4.697144,-74.140516)"
2018,Marzo,Etiopia,231,0,1,,1,"(4.815061,-75.736532)"
2018,Marzo,Filipinas,608,0,1,,1,"(3.541112,-76.384584)"
2018,Marzo,Filipinas,608,1,0,,1,"(4.697144,-74.140516)"
2018,Marzo,Filipinas,608,0,2,,2,"(6.171601,-75.427454)"
2018,Marzo,Finlandia,246,1,0,,1,"(10.886611,-74.776708)"
2018,Marzo,Finlandia,246,1,1,,2,"(3.541112,-76.384584)"
2018,Marzo,Finlandia,246,12,8,,20,"(4.697144,-74.140516)"
2018,Marzo,Finlandia,246,1,0,,1,"(6.171601,-75.427454)"
2018,Marzo,Francia,250,4,4,,8,"(10.445761,-75.516429)"
2018,Marzo,Francia,250,7,3,,10,"(10.886611,-74.776708)"
2018,Marzo,Francia,250,69,53,,122,"(3.541112,-76.384584)"
2018,Marzo,Francia,250,1345,1154,,2499,"(4.697144,-74.140516)"
2018,Marzo,Francia,250,6,6,,12,"(4.815061,-75.736532)"
2018,Marzo,Francia,250,86,71,,157,"(6.171601,-75.427454)"
2018,Marzo,Gambia,270,1,0,,1,"(4.697144,-74.140516)"
2018,Marzo,Georgia,268,0,1,,1,"(4.697144,-74.140516)"
2018,Marzo,Georgia,268,0,1,,1,"(4.815061,-75.736532)"
2018,Marzo,Ghana,288,0,1,,1,"(4.697144,-74.140516)"
2018,Marzo,Gibraltar/Territorio Británico de Ultramar,292,1,2,,3,"(4.697144,-74.140516)"
2018,Marzo,Grecia,300,14,12,,26,"(4.697144,-74.140516)"
2018,Marzo,Grecia,300,3,2,,5,"(6.171601,-75.427454)"
2018,Marzo,Groenlandia,304,0,1,,1,"(4.697144,-74.140516)"
2018,Marzo,Guatemala,320,1,0,,1,"(0.814836,-77.662532)"
2018,Marzo,Guatemala,320,3,6,,9,"(10.445761,-75.516429)"
2018,Marzo,Guatemala,320,16,17,,33,"(10.886611,-74.776708)"
2018,Marzo,Guatemala,320,55,76,,131,"(3.541112,-76.384584)"
2018,Marzo,Guatemala,320,574,678,,1252,"(4.697144,-74.140516)"
2018,Marzo,Guatemala,320,9,16,,25,"(4.815061,-75.736532)"
2018,Marzo,Guatemala,320,124,160,,284,"(6.171601,-75.427454)"
2018,Marzo,Guatemala,320,7,9,,16,"(7.128456,-73.183637)"
2018,Marzo,Guyana,328,1,5,,6,"(10.886611,-74.776708)"
2018,Marzo,Guyana,328,1,0,,1,"(3.541112,-76.384584)"
2018,Marzo,Guyana,328,1,5,,6,"(4.697144,-74.140516)"
2018,Marzo,Guyana,328,0,1,,1,"(4.815061,-75.736532)"
2018,Marzo,Guyana,328,1,1,,2,"(6.171601,-75.427454)"
2018,Marzo,Guinea,324,1,0,,1,"(6.171601,-75.427454)"
2018,Marzo,Guinea Ecuatorial,226,0,3,,3,"(4.697144,-74.140516)"
2018,Marzo,Guadalupe/Territorio Francés,312,1,0,,1,"(3.541112,-76.384584)"
2018,Marzo,Guadalupe/Territorio Francés,312,1,4,,5,"(4.697144,-74.140516)"
2018,Marzo,Guayana Francesa/Departamento de Ultramar Francés,254,0,1,,1,"(4.697144,-74.140516)"
2018,Marzo,Guayana Francesa/Departamento de Ultramar Francés,254,1,0,,1,"(6.171601,-75.427454)"
2018,Marzo,Haití,332,0,1,,1,"(10.886611,-74.776708)"
2018,Marzo,Haití,332,1,1,,2,"(3.541112,-76.384584)"
2018,Marzo,Haití,332,3,5,,8,"(4.697144,-74.140516)"
2018,Marzo,Haití,332,3,3,,6,"(6.171601,-75.427454)"
2018,Marzo,Honduras,340,3,2,,5,"(10.445761,-75.516429)"
2018,Marzo,Honduras,340,10,2,,12,"(10.886611,-74.776708)"
2018,Marzo,Honduras,340,0,1,,1,"(10.971302,-74.765397)"
2018,Marzo,Honduras,340,1,0,,1,"(12.586067,-81.702563)"
2018,Marzo,Honduras,340,13,14,,27,"(3.541112,-76.384584)"
2018,Marzo,Honduras,340,77,139,,216,"(4.697144,-74.140516)"
2018,Marzo,Honduras,340,1,0,,1,"(4.815061,-75.736532)"
2018,Marzo,Honduras,340,49,87,,136,"(6.171601,-75.427454)"
2018,Marzo,Honduras,340,0,4,,4,"(7.128456,-73.183637)"
2018,Marzo,Hong Kong,344,0,3,,3,"(10.445761,-75.516429)"
2018,Marzo,Hong Kong,344,3,2,,5,"(10.886611,-74.776708)"
2018,Marzo,Hong Kong,344,1,5,,6,"(3.541112,-76.384584)"
2018,Marzo,Hong Kong,344,26,35,,61,"(4.697144,-74.140516)"
2018,Marzo,Hong Kong,344,1,0,,1,"(4.815061,-75.736532)"
2018,Marzo,Hong Kong,344,7,7,,14,"(6.171601,-75.427454)"
2018,Marzo,Hungría,348,4,7,,11,"(4.697144,-74.140516)"
2018,Marzo,Hungría,348,2,0,,2,"(6.171601,-75.427454)"
2018,Marzo,India,356,1,0,,1,"(10.886611,-74.776708)"
2018,Marzo,India,356,8,4,,12,"(3.541112,-76.384584)"
2018,Marzo,India,356,48,37,,85,"(4.697144,-74.140516)"
2018,Marzo,India,356,7,1,,8,"(6.171601,-75.427454)"
2018,Marzo,Indonesia,360,4,3,,7,"(4.697144,-74.140516)"
2018,Marzo,Indonesia,360,1,3,,4,"(6.171601,-75.427454)"
2018,Marzo,Iraq,368,0,5,,5,"(4.697144,-74.140516)"
2018,Marzo,Irán,364,4,3,,7,"(4.697144,-74.140516)"
2018,Marzo,República de Irlanda,372,10,7,,17,"(4.697144,-74.140516)"
2018,Marzo,República de Irlanda,372,2,2,,4,"(6.171601,-75.427454)"
2018,Marzo,Islandia,352,1,0,,1,"(10.886611,-74.776708)"
2018,Marzo,Islandia,352,0,1,,1,"(3.541112,-76.384584)"
2018,Marzo,Islandia,352,0,2,,2,"(4.697144,-74.140516)"
2018,Marzo,Israel,376,1,0,,1,"(10.886611,-74.776708)"
2018,Marzo,Israel,376,1,1,,2,"(3.541112,-76.384584)"
2018,Marzo,Israel,376,125,59,,184,"(4.697144,-74.140516)"
2018,Marzo,Israel,376,16,4,,20,"(6.171601,-75.427454)"
2018,Marzo,Italia,380,8,4,,12,"(10.445761,-75.516429)"
2018,Marzo,Italia,380,8,4,,12,"(10.886611,-74.776708)"
2018,Marzo,Italia,380,0,1,,1,"(12.586067,-81.702563)"
2018,Marzo,Italia,380,120,58,,178,"(3.541112,-76.384584)"
2018,Marzo,Italia,380,619,430,,1049,"(4.697144,-74.140516)"
2018,Marzo,Italia,380,111,62,,173,"(6.171601,-75.427454)"
2018,Marzo,Italia,380,3,2,,5,"(7.128456,-73.183637)"
2018,Marzo,Jamaica,388,535,373,,908,"(10.408582,-75.538003)"
2018,Marzo,Jamaica,388,2,9,,11,"(10.445761,-75.516429)"
2018,Marzo,Jamaica,388,3,5,,8,"(10.886611,-74.776708)"
2018,Marzo,Jamaica,388,0,1,,1,"(12.586067,-81.702563)"
2018,Marzo,Jamaica,388,6,8,,14,"(3.541112,-76.384584)"
2018,Marzo,Jamaica,388,16,23,,39,"(4.697144,-74.140516)"
2018,Marzo,Jamaica,388,2,4,,6,"(4.815061,-75.736532)"
2018,Marzo,Jamaica,388,10,10,,20,"(6.171601,-75.427454)"
2018,Marzo,Jamaica,388,4,1,,5,"(7.128456,-73.183637)"
2018,Marzo,Japón,392,4,2,,6,"(10.886611,-74.776708)"
2018,Marzo,Japón,392,8,3,,11,"(3.541112,-76.384584)"
2018,Marzo,Japón,392,119,123,,242,"(4.697144,-74.140516)"
2018,Marzo,Japón,392,5,3,,8,"(4.815061,-75.736532)"
2018,Marzo,Japón,392,9,6,,15,"(6.171601,-75.427454)"
2018,Marzo,Japón,392,1,4,,5,"(7.128456,-73.183637)"
2018,Marzo,Jordania,400,3,2,,5,"(4.697144,-74.140516)"
2018,Marzo,Jordania,400,0,1,,1,"(6.171601,-75.427454)"
2018,Marzo,Kazajistán,398,0,4,,4,"(4.697144,-74.140516)"
2018,Marzo,Kenia,404,4,3,,7,"(4.697144,-74.140516)"
2018,Marzo,Kenia,404,1,1,,2,"(6.171601,-75.427454)"
2018,Marzo,Kuwait,414,0,1,,1,"(3.541112,-76.384584)"
2018,Marzo,Kuwait,414,0,1,,1,"(6.171601,-75.427454)"
2018,Marzo,Letonia,428,0,1,,1,"(4.697144,-74.140516)"
2018,Marzo,Lituania,440,0,1,,1,"(4.697144,-74.140516)"
2018,Marzo,Líbano,422,1,2,,3,"(10.886611,-74.776708)"
2018,Marzo,Líbano,422,10,11,,21,"(4.697144,-74.140516)"
2018,Marzo,Líbano,422,2,1,,3,"(6.171601,-75.427454)"
2018,Marzo,Liechtenstein,438,1,0,,1,"(4.697144,-74.140516)"
2018,Marzo,Luxemburgo,442,1,0,,1,"(10.886611,-74.776708)"
2018,Marzo,Luxemburgo,442,2,2,,4,"(3.541112,-76.384584)"
2018,Marzo,Luxemburgo,442,3,3,,6,"(4.697144,-74.140516)"
2018,Marzo,Luxemburgo,442,1,2,,3,"(6.171601,-75.427454)"
2018,Marzo,Macao,446,1,2,,3,"(4.697144,-74.140516)"
2018,Marzo,Macedonia,807,1,0,,1,"(4.697144,-74.140516)"
2018,Marzo,Malasia,458,1,4,,5,"(4.697144,-74.140516)"
2018,Marzo,Malta,470,3,2,,5,"(3.541112,-76.384584)"
2018,Marzo,Malta,470,20,7,,27,"(4.697144,-74.140516)"
2018,Marzo,Malta,470,2,0,,2,"(6.171601,-75.427454)"
2018,Marzo,Marruecos,504,6,5,,11,"(4.697144,-74.140516)"
2018,Marzo,Marruecos,504,1,1,,2,"(6.171601,-75.427454)"
2018,Marzo,Mauritania,478,0,1,,1,"(4.697144,-74.140516)"
2018,Marzo,Martinica/Departamento de Ultramar Francés,474,1,0,,1,"(4.697144,-74.140516)"
2018,Marzo,México,484,94,79,,173,"(10.445761,-75.516429)"
2018,Marzo,México,484,157,142,,299,"(10.886611,-74.776708)"
2018,Marzo,México,484,2,5,,7,"(12.586067,-81.702563)"
2018,Marzo,México,484,794,643,,1437,"(3.541112,-76.384584)"
2018,Marzo,México,484,14847,13319,,28166,"(4.697144,-74.140516)"
2018,Marzo,México,484,201,134,,335,"(4.815061,-75.736532)"
2018,Marzo,México,484,2246,1756,,4002,"(6.171601,-75.427454)"
2018,Marzo,México,484,130,104,,234,"(7.128456,-73.183637)"
2018,Marzo,República de Moldavia,498,0,1,,1,"(4.697144,-74.140516)"
2018,Marzo,Mongolia,496,0,1,,1,"(10.886611,-74.776708)"
2018,Marzo,Micronesia,583,1,0,,1,"(6.171601,-75.427454)"
2018,Marzo,Mozambique,508,2,1,,3,"(4.697144,-74.140516)"
2018,Marzo,Nauru,520,0,1,,1,"(10.445761,-75.516429)"
2018,Marzo,Nepal,524,1,3,,4,"(4.697144,-74.140516)"
2018,Marzo,Nicaragua,558,1,2,,3,"(10.445761,-75.516429)"
2018,Marzo,Nicaragua,558,6,7,,13,"(10.886611,-74.776708)"
2018,Marzo,Nicaragua,558,1,1,,2,"(12.586067,-81.702563)"
2018,Marzo,Nicaragua,558,4,16,,20,"(3.541112,-76.384584)"
2018,Marzo,Nicaragua,558,35,78,,113,"(4.697144,-74.140516)"
2018,Marzo,Nicaragua,558,8,9,,17,"(4.815061,-75.736532)"
2018,Marzo,Nicaragua,558,20,47,,67,"(6.171601,-75.427454)"
2018,Marzo,Nicaragua,558,2,1,,3,"(7.128456,-73.183637)"
2018,Marzo,Nigeria,566,2,3,,5,"(4.697144,-74.140516)"
2018,Marzo,Noruega,578,1,0,,1,"(10.886611,-74.776708)"
2018,Marzo,Noruega,578,0,3,,3,"(3.541112,-76.384584)"
2018,Marzo,Noruega,578,26,12,,38,"(4.697144,-74.140516)"
2018,Marzo,Noruega,578,3,0,,3,"(6.171601,-75.427454)"
2018,Marzo,Nueva Zelanda,554,0,1,,1,"(3.541112,-76.384584)"
2018,Marzo,Nueva Zelanda,554,34,21,,55,"(4.697144,-74.140516)"
2018,Marzo,Nueva Zelanda,554,3,11,,14,"(6.171601,-75.427454)"
2018,Marzo,Omán,512,1,3,,4,"(4.697144,-74.140516)"
2018,Marzo,Papúa Nueva Guinea,598,0,2,,2,"(4.697144,-74.140516)"
2018,Marzo,Panamá,591,35,156,,191,"(10.408582,-75.538003)"
2018,Marzo,Panamá,591,1504,1277,,2781,"(10.445761,-75.516429)"
2018,Marzo,Panamá,591,1048,939,,1987,"(10.886611,-74.776708)"
2018,Marzo,Panamá,591,0,1,,1,"(10.971302,-74.765397)"
2018,Marzo,Panamá,591,1,9,,10,"(12.5744111,-81.703935)"
2018,Marzo,Panamá,591,61,74,,135,"(12.586067,-81.702563)"
2018,Marzo,Panamá,591,1,0,,1,"(13.3387613,-81.372937)"
2018,Marzo,Panamá,591,2026,1736,,3762,"(3.541112,-76.384584)"
2018,Marzo,Panamá,591,304,198,,502,"(4.452882,-75.766298)"
2018,Marzo,Panamá,591,7617,8331,,15949,"(4.697144,-74.140516)"
2018,Marzo,Panamá,591,434,372,,806,"(4.815061,-75.736532)"
2018,Marzo,Panamá,591,0,1,,1,"(6.17134,-75.427194)"
2018,Marzo,Panamá,591,3457,3056,,6513,"(6.171601,-75.427454)"
2018,Marzo,Panamá,591,1,11,,12,"(6.228046,-77.404104)"
2018,Marzo,Panamá,591,3,22,,25,"(7.102626,-77.762647)"
2018,Marzo,Panamá,591,184,171,,355,"(7.128456,-73.183637)"
2018,Marzo,Panamá,591,0,8,,8,"(8.066966,-76.735404)"
2018,Marzo,Panamá,591,26,50,,76,"(8.635765,-77.346578)"
2018,Marzo,Paraguay,600,1,4,,5,"(0.814836,-77.662532)"
2018,Marzo,Paraguay,600,1,1,,2,"(10.445761,-75.516429)"
2018,Marzo,Paraguay,600,3,8,,11,"(10.886611,-74.776708)"
2018,Marzo,Paraguay,600,0,1,,1,"(12.586067,-81.702563)"
2018,Marzo,Paraguay,600,40,44,,84,"(3.541112,-76.384584)"
2018,Marzo,Paraguay,600,128,193,,321,"(4.697144,-74.140516)"
2018,Marzo,Paraguay,600,14,22,,36,"(4.815061,-75.736532)"
2018,Marzo,Paraguay,600,36,74,,110,"(6.171601,-75.427454)"
2018,Marzo,Paraguay,600,4,4,,8,"(7.128456,-73.183637)"
2018,Marzo,Perú,604,6,4,,10,"(-0.193180,-74.784874)"
2018,Marzo,Perú,604,79,112,,191,"(-4.197703,-69.941278)"
2018,Marzo,Perú,604,144,131,,275,"(-4.223468,-69.945098)"
2018,Marzo,Perú,604,4,6,,10,"(0.25129,-76.875963)"
2018,Marzo,Perú,604,172,198,,370,"(0.814836,-77.662532)"
2018,Marzo,Perú,604,2,3,,5,"(1.813928,-78.763924)"
2018,Marzo,Perú,604,75,73,,148,"(10.445761,-75.516429)"
2018,Marzo,Perú,604,17,16,,33,"(10.886611,-74.776708)"
2018,Marzo,Perú,604,1,0,,1,"(12.586067,-81.702563)"
2018,Marzo,Perú,604,200,158,,358,"(3.541112,-76.384584)"
2018,Marzo,Perú,604,0,1,,1,"(4.452882,-75.766298)"
2018,Marzo,Perú,604,5454,5640,,11094,"(4.697144,-74.140516)"
2018,Marzo,Perú,604,16,18,,34,"(4.815061,-75.736532)"
2018,Marzo,Perú,604,570,535,,1105,"(6.171601,-75.427454)"
2018,Marzo,Perú,604,6,8,,14,"(7.128456,-73.183637)"
2018,Marzo,Palestina,99999,0,1,,1,"(4.697144,-74.140516)"
2018,Marzo,Polonia,616,1,2,,3,"(3.541112,-76.384584)"
2018,Marzo,Polonia,616,3,14,,17,"(4.697144,-74.140516)"
2018,Marzo,Polonia,616,3,3,,6,"(6.171601,-75.427454)"
2018,Marzo,Portugal,620,1,0,,1,"(10.886611,-74.776708)"
2018,Marzo,Portugal,620,1,3,,4,"(3.541112,-76.384584)"
2018,Marzo,Portugal,620,110,155,,265,"(4.697144,-74.140516)"
2018,Marzo,Portugal,620,2,1,,3,"(4.815061,-75.736532)"
2018,Marzo,Portugal,620,8,4,,12,"(6.171601,-75.427454)"
2018,Marzo,Polinesia Francesa/Colectividad de Ultramar Francesa,258,1,0,,1,"(4.697144,-74.140516)"
2018,Marzo,Puerto Rico/Territorio de Estados Unidos,630,3,3,,6,"(10.445761,-75.516429)"
2018,Marzo,Puerto Rico/Territorio de Estados Unidos,630,15,14,,29,"(10.886611,-74.776708)"
2018,Marzo,Puerto Rico/Territorio de Estados Unidos,630,25,16,,41,"(3.541112,-76.384584)"
2018,Marzo,Puerto Rico/Territorio de Estados Unidos,630,579,502,,1081,"(4.697144,-74.140516)"
2018,Marzo,Puerto Rico/Territorio de Estados Unidos,630,3,2,,5,"(4.815061,-75.736532)"
2018,Marzo,Puerto Rico/Territorio de Estados Unidos,630,40,39,,79,"(6.171601,-75.427454)"
2018,Marzo,Puerto Rico/Territorio de Estados Unidos,630,1,2,,3,"(7.128456,-73.183637)"
2018,Marzo,Qatar,634,0,1,,1,"(3.541112,-76.384584)"
2018,Marzo,Qatar,634,5,5,,10,"(4.697144,-74.140516)"
2018,Marzo,Qatar,634,3,1,,4,"(6.171601,-75.427454)"
2018,Marzo,Reino Unido de Gran Bretaña e Irlanda del Norte,826,4,2,,6,"(10.445761,-75.516429)"
2018,Marzo,Reino Unido de Gran Bretaña e Irlanda del Norte,826,4,0,,4,"(10.886611,-74.776708)"
2018,Marzo,Reino Unido de Gran Bretaña e Irlanda del Norte,826,24,16,,40,"(3.541112,-76.384584)"
2018,Marzo,Reino Unido de Gran Bretaña e Irlanda del Norte,826,1482,1224,,2706,"(4.697144,-74.140516)"
2018,Marzo,Reino Unido de Gran Bretaña e Irlanda del Norte,826,38,29,,67,"(6.171601,-75.427454)"
2018,Marzo,República CentroÁfricana,140,4,1,,5,"(4.697144,-74.140516)"
2018,Marzo,Federación de Rusia,643,1,1,,2,"(10.445761,-75.516429)"
2018,Marzo,Federación de Rusia,643,0,1,,1,"(10.886611,-74.776708)"
2018,Marzo,Federación de Rusia,643,1,0,,1,"(3.541112,-76.384584)"
2018,Marzo,Federación de Rusia,643,19,27,,46,"(4.697144,-74.140516)"
2018,Marzo,Federación de Rusia,643,0,1,,1,"(6.171601,-75.427454)"
2018,Marzo,República Dominicana,214,11,14,,25,"(10.445761,-75.516429)"
2018,Marzo,República Dominicana,214,39,46,,85,"(10.886611,-74.776708)"
2018,Marzo,República Dominicana,214,1,6,,7,"(11.117806,-74.232622)"
2018,Marzo,República Dominicana,214,58,55,,113,"(3.541112,-76.384584)"
2018,Marzo,República Dominicana,214,3159,2920,,6079,"(4.697144,-74.140516)"
2018,Marzo,República Dominicana,214,45,36,,81,"(4.815061,-75.736532)"
2018,Marzo,República Dominicana,214,275,182,,457,"(6.171601,-75.427454)"
2018,Marzo,República Dominicana,214,20,13,,33,"(7.128456,-73.183637)"
2018,Marzo,Reunión,638,0,1,,1,"(4.697144,-74.140516)"
2018,Marzo,Rumania,642,3,0,,3,"(4.697144,-74.140516)"
2018,Marzo,San  Vicente y las Granadinas,670,0,1,,1,"(4.697144,-74.140516)"
2018,Marzo,Santa Sede/Ciudad del Vaticano,336,1,0,,1,"(4.697144,-74.140516)"
2018,Marzo,Serbia,688,0,2,,2,"(4.697144,-74.140516)"
2018,Marzo,Serbia,688,2,0,,2,"(6.171601,-75.427454)"
2018,Marzo,Singapur,702,1,1,,2,"(10.886611,-74.776708)"
2018,Marzo,Singapur,702,13,19,,32,"(4.697144,-74.140516)"
2018,Marzo,Singapur,702,1,1,,2,"(6.171601,-75.427454)"
2018,Marzo,Sri Lanka,144,1,0,,1,"(3.541112,-76.384584)"
2018,Marzo,Sudáfrica,710,16,16,,32,"(4.697144,-74.140516)"
2018,Marzo,Sudáfrica,710,2,0,,2,"(6.171601,-75.427454)"
2018,Marzo,Suecia,752,1,1,,2,"(10.445761,-75.516429)"
2018,Marzo,Suecia,752,5,1,,6,"(10.886611,-74.776708)"
2018,Marzo,Suecia,752,15,17,,32,"(3.541112,-76.384584)"
2018,Marzo,Suecia,752,66,46,,112,"(4.697144,-74.140516)"
2018,Marzo,Suecia,752,13,10,,23,"(6.171601,-75.427454)"
2018,Marzo,Suiza,756,2,0,,2,"(10.445761,-75.516429)"
2018,Marzo,Suiza,756,2,0,,2,"(10.886611,-74.776708)"
2018,Marzo,Suiza,756,39,18,,57,"(3.541112,-76.384584)"
2018,Marzo,Suiza,756,267,181,,448,"(4.697144,-74.140516)"
2018,Marzo,Suiza,756,31,12,,43,"(6.171601,-75.427454)"
2018,Marzo,Suiza,756,1,0,,1,"(7.128456,-73.183637)"
2018,Marzo,Surinam,740,9,6,,15,"(4.697144,-74.140516)"
2018,Marzo,Surinam,740,0,1,,1,"(6.171601,-75.427454)"
2018,Marzo,Taiwán,158,2,5,,7,"(4.697144,-74.140516)"
2018,Marzo,Taiwán,158,0,2,,2,"(6.171601,-75.427454)"
2018,Marzo,Tailandia,764,1,3,,4,"(3.541112,-76.384584)"
2018,Marzo,Tailandia,764,44,39,,83,"(4.697144,-74.140516)"
2018,Marzo,Tailandia,764,2,1,,3,"(6.171601,-75.427454)"
2018,Marzo,Tanzania,834,3,1,,4,"(4.697144,-74.140516)"
2018,Marzo,Tanzania,834,1,1,,2,"(6.171601,-75.427454)"
2018,Marzo,Togo,768,0,1,,1,"(4.697144,-74.140516)"
2018,Marzo,Trinidad y Tobago,780,5,3,,8,"(10.886611,-74.776708)"
2018,Marzo,Trinidad y Tobago,780,6,8,,14,"(3.541112,-76.384584)"
2018,Marzo,Trinidad y Tobago,780,13,25,,38,"(4.697144,-74.140516)"
2018,Marzo,Trinidad y Tobago,780,0,3,,3,"(4.815061,-75.736532)"
2018,Marzo,Trinidad y Tobago,780,15,15,,30,"(6.171601,-75.427454)"
2018,Marzo,Trinidad y Tobago,780,2,2,,4,"(7.128456,-73.183637)"
2018,Marzo,Túnez,788,1,2,,3,"(4.697144,-74.140516)"
2018,Marzo,Turquía,792,6,6,,12,"(3.541112,-76.384584)"
2018,Marzo,Turquía,792,672,482,,1154,"(4.697144,-74.140516)"
2018,Marzo,Turquía,792,18,19,,37,"(6.171601,-75.427454)"
2018,Marzo,Turkmenistán,795,6,3,,9,"(4.697144,-74.140516)"
2018,Marzo,Ucrania,804,0,1,,1,"(4.697144,-74.140516)"
2018,Marzo,Uganda,800,3,1,,4,"(4.697144,-74.140516)"
2018,Marzo,Uruguay,858,0,1,,1,"(0.814836,-77.662532)"
2018,Marzo,Uruguay,858,4,3,,7,"(10.886611,-74.776708)"
2018,Marzo,Uruguay,858,22,28,,50,"(3.541112,-76.384584)"
2018,Marzo,Uruguay,858,402,381,,783,"(4.697144,-74.140516)"
2018,Marzo,Uruguay,858,9,13,,22,"(4.815061,-75.736532)"
2018,Marzo,Uruguay,858,21,17,,38,"(6.171601,-75.427454)"
2018,Marzo,Uruguay,858,2,4,,6,"(7.128456,-73.183637)"
2018,Marzo,Venezuela,862,11,8,,19,"(10.445761,-75.516429)"
2018,Marzo,Venezuela,862,16,12,,28,"(10.886611,-74.776708)"
2018,Marzo,Venezuela,862,0,1,,1,"(11.117806,-74.232622)"
2018,Marzo,Venezuela,862,1890,2075,,3965,"(11.360009,-72.129330)"
2018,Marzo,Venezuela,862,1,3,,4,"(11.528919,-72.919681)"
2018,Marzo,Venezuela,862,363,301,,664,"(3.541112,-76.384584)"
2018,Marzo,Venezuela,862,5,6,,11,"(3.866713,-67.927521)"
2018,Marzo,Venezuela,862,1089,1033,,2122,"(4.697144,-74.140516)"
2018,Marzo,Venezuela,862,41,33,,74,"(4.815061,-75.736532)"
2018,Marzo,Venezuela,862,900,728,,1628,"(6.171601,-75.427454)"
2018,Marzo,Venezuela,862,57,67,,124,"(6.185799,-67.483929)"
2018,Marzo,Venezuela,862,769,668,,1437,"(7.088729,-70.740253)"
2018,Marzo,Venezuela,862,1,3,,4,"(7.128456,-73.183637)"
2018,Marzo,Venezuela,862,1884,1787,,3671,"(7.818934,-72.453226)"
2018,Marzo,Venezuela,862,221,262,,483,"(8.36068,-72.409396)"
2018,Marzo,Vietnam,704,0,2,,2,"(3.541112,-76.384584)"
2018,Marzo,Vietnam,704,8,8,,16,"(4.697144,-74.140516)"
2018,Marzo,Vietnam,704,0,1,,1,"(6.171601,-75.427454)"
2018,Marzo,Islas Vírgenes Británicas/Territorio Británico de Ultramar,92,1,1,,2,"(3.541112,-76.384584)"
2018,Marzo,Islas Vírgenes Británicas/Territorio Británico de Ultramar,92,1,0,,1,"(4.697144,-74.140516)"
2018,Marzo,Islas Turcas y Caicos/Territorio Británico de Ultramar,796,0,1,,1,"(4.697144,-74.140516)"
2018,Abril,Afganistán,4,0,1,,1,"(10.886611,-74.776708)"
2018,Abril,Afganistán,4,1,10,,11,"(4.697144,-74.140516)"
2018,Abril,Albania,8,1,1,,2,"(4.697144,-74.140516)"
2018,Abril,Alemania,276,1,0,,1,"(0.814836,-77.662532)"
2018,Abril,Alemania,276,6,8,,14,"(10.445761,-75.516429)"
2018,Abril,Alemania,276,6,10,,16,"(10.886611,-74.776708)"
2018,Abril,Alemania,276,53,37,,90,"(3.541112,-76.384584)"
2018,Abril,Alemania,276,1234,1156,,2390,"(4.697144,-74.140516)"
2018,Abril,Alemania,276,0,1,,1,"(4.815061,-75.736532)"
2018,Abril,Alemania,276,56,45,,101,"(6.171601,-75.427454)"
2018,Abril,Alemania,276,1,1,,2,"(7.128456,-73.183637)"
2018,Abril,Andorra,20,1,0,,1,"(4.697144,-74.140516)"
2018,Abril,Angola,24,2,3,,5,"(4.697144,-74.140516)"
2018,Abril,Países Bajos,528,0,3,,3,"(10.408582,-75.538003)"
2018,Abril,Países Bajos,528,181,116,,297,"(10.445761,-75.516429)"
2018,Abril,Países Bajos,528,11,7,,18,"(10.886611,-74.776708)"
2018,Abril,Países Bajos,528,0,1,,1,"(12.586067,-81.702563)"
2018,Abril,Países Bajos,528,38,20,,58,"(3.541112,-76.384584)"
2018,Abril,Países Bajos,528,846,777,,1623,"(4.697144,-74.140516)"
2018,Abril,Países Bajos,528,68,65,,133,"(6.171601,-75.427454)"
2018,Abril,Arabia Saudita,682,0,2,,2,"(3.541112,-76.384584)"
2018,Abril,Arabia Saudita,682,4,33,,37,"(4.697144,-74.140516)"
2018,Abril,Arabia Saudita,682,0,1,,1,"(6.171601,-75.427454)"
2018,Abril,Argelia,12,1,0,,1,"(3.541112,-76.384584)"
2018,Abril,Argelia,12,4,4,,8,"(4.697144,-74.140516)"
2018,Abril,Argentina,32,18,49,,67,"(0.814836,-77.662532)"
2018,Abril,Argentina,32,17,15,,32,"(10.445761,-75.516429)"
2018,Abril,Argentina,32,37,34,,71,"(10.886611,-74.776708)"
2018,Abril,Argentina,32,0,1,,1,"(12.586067,-81.702563)"
2018,Abril,Argentina,32,96,121,,217,"(3.541112,-76.384584)"
2018,Abril,Argentina,32,2559,2769,,5328,"(4.697144,-74.140516)"
2018,Abril,Argentina,32,48,47,,95,"(4.815061,-75.736532)"
2018,Abril,Argentina,32,173,159,,332,"(6.171601,-75.427454)"
2018,Abril,Argentina,32,4,9,,13,"(7.128456,-73.183637)"
2018,Abril,República de Armenia,51,1,0,,1,"(6.171601,-75.427454)"
2018,Abril,Aruba,533,1807,1166,,2973,"(10.408582,-75.538003)"
2018,Abril,Aruba,533,3,3,,6,"(10.445761,-75.516429)"
2018,Abril,Aruba,533,16,11,,27,"(10.886611,-74.776708)"
2018,Abril,Aruba,533,0,2,,2,"(11.117806,-74.232622)"
2018,Abril,Aruba,533,25,17,,42,"(3.541112,-76.384584)"
2018,Abril,Aruba,533,1547,1283,,2830,"(4.697144,-74.140516)"
2018,Abril,Aruba,533,2,0,,2,"(4.815061,-75.736532)"
2018,Abril,Aruba,533,49,52,,101,"(6.171601,-75.427454)"
2018,Abril,Aruba,533,5,25,,30,"(7.128456,-73.183637)"
2018,Abril,Australia,36,1,0,,1,"(10.445761,-75.516429)"
2018,Abril,Australia,36,2,1,,3,"(10.886611,-74.776708)"
2018,Abril,Australia,36,5,6,,11,"(3.541112,-76.384584)"
2018,Abril,Australia,36,332,277,,609,"(4.697144,-74.140516)"
2018,Abril,Australia,36,2,3,,5,"(4.815061,-75.736532)"
2018,Abril,Australia,36,29,35,,64,"(6.171601,-75.427454)"
2018,Abril,Australia,36,1,5,,6,"(7.128456,-73.183637)"
2018,Abril,Austria,40,1,0,,1,"(10.886611,-74.776708)"
2018,Abril,Austria,40,3,2,,5,"(3.541112,-76.384584)"
2018,Abril,Austria,40,36,35,,71,"(4.697144,-74.140516)"
2018,Abril,Austria,40,6,6,,12,"(6.171601,-75.427454)"
2018,Abril,Azerbaiyán,31,0,1,,1,"(4.697144,-74.140516)"
2018,Abril,Bahamas,44,1,1,,2,"(10.886611,-74.776708)"
2018,Abril,Bahamas,44,1,1,,2,"(10.971302,-74.765397)"
2018,Abril,Bahamas,44,5,2,,7,"(3.541112,-76.384584)"
2018,Abril,Bahamas,44,16,19,,35,"(4.697144,-74.140516)"
2018,Abril,Bahamas,44,2,0,,2,"(4.815061,-75.736532)"
2018,Abril,Bahamas,44,13,30,,43,"(6.171601,-75.427454)"
2018,Abril,Bahamas,44,2,0,,2,"(7.128456,-73.183637)"
2018,Abril,Bahréin,48,0,1,,1,"(3.541112,-76.384584)"
2018,Abril,Bahréin,48,2,4,,6,"(4.697144,-74.140516)"
2018,Abril,Bahréin,48,2,0,,2,"(6.171601,-75.427454)"
2018,Abril,Bangladesh,50,1,0,,1,"(4.697144,-74.140516)"
2018,Abril,Barbados,52,4,6,,10,"(10.886611,-74.776708)"
2018,Abril,Barbados,52,1,2,,3,"(3.541112,-76.384584)"
2018,Abril,Barbados,52,3,10,,13,"(4.697144,-74.140516)"
2018,Abril,Barbados,52,2,4,,6,"(6.171601,-75.427454)"
2018,Abril,Bélgica,56,2,2,,4,"(10.445761,-75.516429)"
2018,Abril,Bélgica,56,12,12,,24,"(3.541112,-76.384584)"
2018,Abril,Bélgica,56,97,73,,170,"(4.697144,-74.140516)"
2018,Abril,Bélgica,56,12,9,,21,"(6.171601,-75.427454)"
2018,Abril,Belice,84,0,1,,1,"(10.886611,-74.776708)"
2018,Abril,Belice,84,0,2,,2,"(13.3387613,-81.372937)"
2018,Abril,Belice,84,10,15,,25,"(4.697144,-74.140516)"
2018,Abril,Belice,84,11,9,,20,"(6.171601,-75.427454)"
2018,Abril,Bermudas/Territorio Británico de Ultramar,60,4,6,,10,"(4.697144,-74.140516)"
2018,Abril,Bermudas/Territorio Británico de Ultramar,60,0,1,,1,"(6.171601,-75.427454)"
2018,Abril,Bolivia,68,1,7,,8,"(0.814836,-77.662532)"
2018,Abril,Bolivia,68,0,3,,3,"(10.445761,-75.516429)"
2018,Abril,Bolivia,68,0,1,,1,"(10.886611,-74.776708)"
2018,Abril,Bolivia,68,23,33,,56,"(3.541112,-76.384584)"
2018,Abril,Bolivia,68,291,527,,818,"(4.697144,-74.140516)"
2018,Abril,Bolivia,68,4,6,,10,"(4.815061,-75.736532)"
2018,Abril,Bolivia,68,37,90,,127,"(6.171601,-75.427454)"
2018,Abril,Bolivia,68,1,0,,1,"(7.128456,-73.183637)"
2018,Abril,Bosnia y Herzegovina,70,3,1,,4,"(4.697144,-74.140516)"
2018,Abril,Brasil,76,98,160,,258,"(-4.197703,-69.941278)"
2018,Abril,Brasil,76,11,42,,53,"(-4.223468,-69.945098)"
2018,Abril,Brasil,76,0,1,,1,"(0.814836,-77.662532)"
2018,Abril,Brasil,76,7,13,,20,"(10.445761,-75.516429)"
2018,Abril,Brasil,76,8,9,,17,"(10.886611,-74.776708)"
2018,Abril,Brasil,76,0,6,,6,"(11.117806,-74.232622)"
2018,Abril,Brasil,76,0,1,,1,"(12.586067,-81.702563)"
2018,Abril,Brasil,76,76,97,,173,"(3.541112,-76.384584)"
2018,Abril,Brasil,76,3290,4374,,7664,"(4.697144,-74.140516)"
2018,Abril,Brasil,76,19,13,,32,"(4.815061,-75.736532)"
2018,Abril,Brasil,76,99,155,,254,"(6.171601,-75.427454)"
2018,Abril,Brasil,76,4,2,,6,"(7.128456,-73.183637)"
2018,Abril,Brunei Darussalam,96,0,1,,1,"(4.697144,-74.140516)"
2018,Abril,Bulgaria,100,0,3,,3,"(4.697144,-74.140516)"
2018,Abril,Bulgaria,100,1,0,,1,"(6.171601,-75.427454)"
2018,Abril,Islas Caimán/Territorio Británico de Ultramar,136,3,0,,3,"(10.408582,-75.538003)"
2018,Abril,Islas Caimán/Territorio Británico de Ultramar,136,2,2,,4,"(10.445761,-75.516429)"
2018,Abril,Islas Caimán/Territorio Británico de Ultramar,136,1,0,,1,"(10.886611,-74.776708)"
2018,Abril,Islas Caimán/Territorio Británico de Ultramar,136,3,1,,4,"(12.586067,-81.702563)"
2018,Abril,Islas Caimán/Territorio Británico de Ultramar,136,1,1,,2,"(3.541112,-76.384584)"
2018,Abril,Islas Caimán/Territorio Británico de Ultramar,136,4,4,,8,"(4.697144,-74.140516)"
2018,Abril,Islas Caimán/Territorio Británico de Ultramar,136,0,1,,1,"(6.171601,-75.427454)"
2018,Abril,Camboya,116,1,1,,2,"(3.541112,-76.384584)"
2018,Abril,Camboya,116,0,3,,3,"(4.697144,-74.140516)"
2018,Abril,Camerún,120,1,1,,2,"(4.697144,-74.140516)"
2018,Abril,Canadá,124,46,32,,78,"(10.445761,-75.516429)"
2018,Abril,Canadá,124,42,43,,85,"(10.886611,-74.776708)"
2018,Abril,Canadá,124,3,1,,4,"(12.586067,-81.702563)"
2018,Abril,Canadá,124,123,88,,211,"(3.541112,-76.384584)"
2018,Abril,Canadá,124,0,1,,1,"(4.452882,-75.766298)"
2018,Abril,Canadá,124,1757,1526,,3283,"(4.697144,-74.140516)"
2018,Abril,Canadá,124,19,14,,33,"(4.815061,-75.736532)"
2018,Abril,Canadá,124,320,246,,566,"(6.171601,-75.427454)"
2018,Abril,Canadá,124,17,18,,35,"(7.128456,-73.183637)"
2018,Abril,España,724,3,3,,6,"(10.445761,-75.516429)"
2018,Abril,España,724,15,9,,24,"(10.886611,-74.776708)"
2018,Abril,España,724,3578,2405,,5983,"(3.541112,-76.384584)"
2018,Abril,España,724,13002,10029,,23031,"(4.697144,-74.140516)"
2018,Abril,España,724,1,2,,3,"(4.815061,-75.736532)"
2018,Abril,España,724,2397,1749,,4146,"(6.171601,-75.427454)"
2018,Abril,España,724,1,0,,1,"(7.128456,-73.183637)"
2018,Abril,Colombia,170,0,8,,8,"(10.445761,-75.516429)"
2018,Abril,Colombia,170,276,732,,1008,"(4.697144,-74.140516)"
2018,Abril,República Democrática del Congo,180,0,1,,1,"(4.697144,-74.140516)"
2018,Abril,República de Corea,410,0,2,,2,"(3.541112,-76.384584)"
2018,Abril,República de Corea,410,20,12,,32,"(4.697144,-74.140516)"
2018,Abril,República de Corea,410,1,5,,6,"(6.171601,-75.427454)"
2018,Abril,Costa de Marfil,384,3,4,,7,"(4.697144,-74.140516)"
2018,Abril,Costa de Marfil,384,1,4,,5,"(6.171601,-75.427454)"
2018,Abril,Costa Rica,188,0,1,,1,"(10.408582,-75.538003)"
2018,Abril,Costa Rica,188,9,10,,19,"(10.445761,-75.516429)"
2018,Abril,Costa Rica,188,25,33,,58,"(10.886611,-74.776708)"
2018,Abril,Costa Rica,188,1,9,,10,"(12.5744111,-81.703935)"
2018,Abril,Costa Rica,188,1,3,,4,"(12.586067,-81.702563)"
2018,Abril,Costa Rica,188,46,50,,96,"(3.541112,-76.384584)"
2018,Abril,Costa Rica,188,1161,1447,,2608,"(4.697144,-74.140516)"
2018,Abril,Costa Rica,188,16,13,,29,"(4.815061,-75.736532)"
2018,Abril,Costa Rica,188,154,142,,296,"(6.171601,-75.427454)"
2018,Abril,Costa Rica,188,3,2,,5,"(7.128456,-73.183637)"
2018,Abril,Croacia,191,1,1,,2,"(3.541112,-76.384584)"
2018,Abril,Croacia,191,2,4,,6,"(4.697144,-74.140516)"
2018,Abril,Croacia,191,1,0,,1,"(6.171601,-75.427454)"
2018,Abril,Cuba,192,1,0,,1,"(10.408582,-75.538003)"
2018,Abril,Cuba,192,5,3,,8,"(10.445761,-75.516429)"
2018,Abril,Cuba,192,10,13,,23,"(10.886611,-74.776708)"
2018,Abril,Cuba,192,0,1,,1,"(11.247723,-74.213989)"
2018,Abril,Cuba,192,40,45,,85,"(3.541112,-76.384584)"
2018,Abril,Cuba,192,1112,1050,,2162,"(4.697144,-74.140516)"
2018,Abril,Cuba,192,16,13,,29,"(4.815061,-75.736532)"
2018,Abril,Cuba,192,97,91,,188,"(6.171601,-75.427454)"
2018,Abril,Cuba,192,9,8,,17,"(7.128456,-73.183637)"
2018,Abril,Curazao,99999,1,1,,2,"(10.408582,-75.538003)"
2018,Abril,Curazao,99999,5,7,,12,"(10.886611,-74.776708)"
2018,Abril,Curazao,99999,1,0,,1,"(12.586067,-81.702563)"
2018,Abril,Curazao,99999,3,1,,4,"(3.541112,-76.384584)"
2018,Abril,Curazao,99999,275,268,,543,"(4.697144,-74.140516)"
2018,Abril,Curazao,99999,2,0,,2,"(4.815061,-75.736532)"
2018,Abril,Curazao,99999,9,6,,15,"(6.171601,-75.427454)"
2018,Abril,Curazao,99999,4,11,,15,"(7.128456,-73.183637)"
2018,Abril,República Checa,203,3,1,,4,"(10.886611,-74.776708)"
2018,Abril,República Checa,203,12,6,,18,"(4.697144,-74.140516)"
2018,Abril,Chile,152,0,1,,1,"(0.25129,-76.875963)"
2018,Abril,Chile,152,294,272,,566,"(0.814836,-77.662532)"
2018,Abril,Chile,152,3,1,,4,"(1.813928,-78.763924)"
2018,Abril,Chile,152,22,14,,36,"(10.445761,-75.516429)"
2018,Abril,Chile,152,57,41,,98,"(10.886611,-74.776708)"
2018,Abril,Chile,152,1,0,,1,"(12.586067,-81.702563)"
2018,Abril,Chile,152,415,261,,676,"(3.541112,-76.384584)"
2018,Abril,Chile,152,4493,4026,,8519,"(4.697144,-74.140516)"
2018,Abril,Chile,152,121,95,,216,"(4.815061,-75.736532)"
2018,Abril,Chile,152,279,210,,489,"(6.171601,-75.427454)"
2018,Abril,Chile,152,6,10,,16,"(7.128456,-73.183637)"
2018,Abril,China,156,4,11,,15,"(10.445761,-75.516429)"
2018,Abril,China,156,2,14,,16,"(10.886611,-74.776708)"
2018,Abril,China,156,10,53,,63,"(3.541112,-76.384584)"
2018,Abril,China,156,294,881,,1175,"(4.697144,-74.140516)"
2018,Abril,China,156,1,9,,10,"(4.815061,-75.736532)"
2018,Abril,China,156,41,105,,146,"(6.171601,-75.427454)"
2018,Abril,China,156,0,3,,3,"(7.128456,-73.183637)"
2018,Abril,Chipre,196,0,1,,1,"(4.697144,-74.140516)"
2018,Abril,Dinamarca,208,3,0,,3,"(3.541112,-76.384584)"
2018,Abril,Dinamarca,208,31,22,,53,"(4.697144,-74.140516)"
2018,Abril,Dinamarca,208,5,1,,6,"(6.171601,-75.427454)"
2018,Abril,Ecuador,218,2,0,,2,"(-0.193180,-74.784874)"
2018,Abril,Ecuador,218,505,955,,1460,"(0.25129,-76.875963)"
2018,Abril,Ecuador,218,56,86,,142,"(0.812436,-77.847006)"
2018,Abril,Ecuador,218,4954,6028,,10982,"(0.814836,-77.662532)"
2018,Abril,Ecuador,218,189,181,,370,"(1.813928,-78.763924)"
2018,Abril,Ecuador,218,0,3,,3,"(10.408582,-75.538003)"
2018,Abril,Ecuador,218,0,2,,2,"(10.445761,-75.516429)"
2018,Abril,Ecuador,218,4,8,,12,"(10.886611,-74.776708)"
2018,Abril,Ecuador,218,312,377,,689,"(3.541112,-76.384584)"
2018,Abril,Ecuador,218,2565,4189,,6754,"(4.697144,-74.140516)"
2018,Abril,Ecuador,218,1,2,,3,"(4.815061,-75.736532)"
2018,Abril,Ecuador,218,36,55,,91,"(6.171601,-75.427454)"
2018,Abril,Ecuador,218,0,4,,4,"(7.128456,-73.183637)"
2018,Abril,Egipto,818,1,2,,3,"(3.541112,-76.384584)"
2018,Abril,Egipto,818,17,59,,76,"(4.697144,-74.140516)"
2018,Abril,El Salvador,222,1,0,,1,"(10.445761,-75.516429)"
2018,Abril,El Salvador,222,15,16,,31,"(10.886611,-74.776708)"
2018,Abril,El Salvador,222,0,1,,1,"(12.586067,-81.702563)"
2018,Abril,El Salvador,222,32,50,,82,"(3.541112,-76.384584)"
2018,Abril,El Salvador,222,776,1135,,1911,"(4.697144,-74.140516)"
2018,Abril,El Salvador,222,7,8,,15,"(4.815061,-75.736532)"
2018,Abril,El Salvador,222,100,147,,247,"(6.171601,-75.427454)"
2018,Abril,El Salvador,222,2,0,,2,"(7.128456,-73.183637)"
2018,Abril,Emiratos Árabes,784,1,1,,2,"(3.541112,-76.384584)"
2018,Abril,Emiratos Árabes,784,86,226,,312,"(4.697144,-74.140516)"
2018,Abril,Emiratos Árabes,784,13,5,,18,"(6.171601,-75.427454)"
2018,Abril,Eritrea,232,1,1,,2,"(4.697144,-74.140516)"
2018,Abril,Eslovaquia,703,3,4,,7,"(4.697144,-74.140516)"
2018,Abril,Eslovenia,705,2,2,,4,"(4.697144,-74.140516)"
2018,Abril,Estados Unidos de América,840,0,4,,4,"(10.408582,-75.538003)"
2018,Abril,Estados Unidos de América,840,2,0,,2,"(10.433609,-73.247863)"
2018,Abril,Estados Unidos de América,840,2946,2337,,5283,"(10.445761,-75.516429)"
2018,Abril,Estados Unidos de América,840,2667,2095,,4762,"(10.886611,-74.776708)"
2018,Abril,Estados Unidos de América,840,0,1,,1,"(11.117806,-74.232622)"
2018,Abril,Estados Unidos de América,840,64,63,,127,"(12.586067,-81.702563)"
2018,Abril,Estados Unidos de América,840,5615,4094,,9709,"(3.541112,-76.384584)"
2018,Abril,Estados Unidos de América,840,622,499,,1121,"(4.452882,-75.766298)"
2018,Abril,Estados Unidos de América,840,31054,27769,,58823,"(4.697144,-74.140516)"
2018,Abril,Estados Unidos de América,840,717,494,,1211,"(4.815061,-75.736532)"
2018,Abril,Estados Unidos de América,840,9562,7839,,17401,"(6.171601,-75.427454)"
2018,Abril,Estados Unidos de América,840,238,185,,423,"(7.128456,-73.183637)"
2018,Abril,Estonia,233,2,2,,4,"(4.697144,-74.140516)"
2018,Abril,Etiopia,231,1,0,,1,"(4.697144,-74.140516)"
2018,Abril,Etiopia,231,0,1,,1,"(6.171601,-75.427454)"
2018,Abril,Filipinas,608,4,8,,12,"(4.697144,-74.140516)"
2018,Abril,Finlandia,246,1,2,,3,"(10.445761,-75.516429)"
2018,Abril,Finlandia,246,0,1,,1,"(3.541112,-76.384584)"
2018,Abril,Finlandia,246,8,6,,14,"(4.697144,-74.140516)"
2018,Abril,Francia,250,2,2,,4,"(10.445761,-75.516429)"
2018,Abril,Francia,250,5,4,,9,"(10.886611,-74.776708)"
2018,Abril,Francia,250,0,1,,1,"(12.586067,-81.702563)"
2018,Abril,Francia,250,64,40,,104,"(3.541112,-76.384584)"
2018,Abril,Francia,250,1224,1050,,2274,"(4.697144,-74.140516)"
2018,Abril,Francia,250,1,1,,2,"(4.815061,-75.736532)"
2018,Abril,Francia,250,81,42,,123,"(6.171601,-75.427454)"
2018,Abril,Francia,250,1,1,,2,"(7.128456,-73.183637)"
2018,Abril,Gabón,266,1,0,,1,"(6.171601,-75.427454)"
2018,Abril,Georgia,268,0,1,,1,"(4.697144,-74.140516)"
2018,Abril,Ghana,288,1,2,,3,"(4.697144,-74.140516)"
2018,Abril,Gibraltar/Territorio Británico de Ultramar,292,0,1,,1,"(4.697144,-74.140516)"
2018,Abril,Grecia,300,2,0,,2,"(10.886611,-74.776708)"
2018,Abril,Grecia,300,16,18,,34,"(4.697144,-74.140516)"
2018,Abril,Grecia,300,1,0,,1,"(6.171601,-75.427454)"
2018,Abril,Groenlandia,304,1,0,,1,"(4.697144,-74.140516)"
2018,Abril,Guatemala,320,10,10,,20,"(10.445761,-75.516429)"
2018,Abril,Guatemala,320,12,15,,27,"(10.886611,-74.776708)"
2018,Abril,Guatemala,320,0,1,,1,"(12.5744111,-81.703935)"
2018,Abril,Guatemala,320,1,6,,7,"(12.586067,-81.702563)"
2018,Abril,Guatemala,320,24,44,,68,"(3.541112,-76.384584)"
2018,Abril,Guatemala,320,1,0,,1,"(3.893038,-77.067921)"
2018,Abril,Guatemala,320,551,759,,1310,"(4.697144,-74.140516)"
2018,Abril,Guatemala,320,9,7,,16,"(4.815061,-75.736532)"
2018,Abril,Guatemala,320,143,169,,312,"(6.171601,-75.427454)"
2018,Abril,Guatemala,320,15,9,,24,"(7.128456,-73.183637)"
2018,Abril,Guyana,328,0,1,,1,"(10.445761,-75.516429)"
2018,Abril,Guyana,328,0,3,,3,"(10.886611,-74.776708)"
2018,Abril,Guyana,328,0,2,,2,"(4.697144,-74.140516)"
2018,Abril,Guyana,328,0,1,,1,"(6.171601,-75.427454)"
2018,Abril,Guinea Ecuatorial,226,0,2,,2,"(4.697144,-74.140516)"
2018,Abril,Guadalupe/Territorio Francés,312,0,1,,1,"(10.886611,-74.776708)"
2018,Abril,Guadalupe/Territorio Francés,312,2,3,,5,"(4.697144,-74.140516)"
2018,Abril,Haití,332,1,4,,5,"(10.445761,-75.516429)"
2018,Abril,Haití,332,0,4,,4,"(10.886611,-74.776708)"
2018,Abril,Haití,332,1,1,,2,"(3.541112,-76.384584)"
2018,Abril,Haití,332,6,3,,9,"(4.697144,-74.140516)"
2018,Abril,Haití,332,3,3,,6,"(6.171601,-75.427454)"
2018,Abril,Honduras,340,0,2,,2,"(10.445761,-75.516429)"
2018,Abril,Honduras,340,4,13,,17,"(10.886611,-74.776708)"
2018,Abril,Honduras,340,1,3,,4,"(12.586067,-81.702563)"
2018,Abril,Honduras,340,5,23,,28,"(3.541112,-76.384584)"
2018,Abril,Honduras,340,84,172,,256,"(4.697144,-74.140516)"
2018,Abril,Honduras,340,3,7,,10,"(4.815061,-75.736532)"
2018,Abril,Honduras,340,22,54,,76,"(6.171601,-75.427454)"
2018,Abril,Honduras,340,4,6,,10,"(7.128456,-73.183637)"
2018,Abril,Hong Kong,344,2,3,,5,"(3.541112,-76.384584)"
2018,Abril,Hong Kong,344,23,42,,65,"(4.697144,-74.140516)"
2018,Abril,Hong Kong,344,1,1,,2,"(4.815061,-75.736532)"
2018,Abril,Hong Kong,344,3,8,,11,"(6.171601,-75.427454)"
2018,Abril,Hungría,348,5,5,,10,"(4.697144,-74.140516)"
2018,Abril,Hungría,348,0,1,,1,"(6.171601,-75.427454)"
2018,Abril,India,356,0,2,,2,"(3.541112,-76.384584)"
2018,Abril,India,356,22,31,,53,"(4.697144,-74.140516)"
2018,Abril,India,356,1,3,,4,"(6.171601,-75.427454)"
2018,Abril,India,356,0,1,,1,"(7.128456,-73.183637)"
2018,Abril,Indonesia,360,8,6,,14,"(4.697144,-74.140516)"
2018,Abril,Indonesia,360,0,1,,1,"(6.171601,-75.427454)"
2018,Abril,Iraq,368,3,9,,12,"(4.697144,-74.140516)"
2018,Abril,Irán,364,2,2,,4,"(4.697144,-74.140516)"
2018,Abril,República de Irlanda,372,1,0,,1,"(3.541112,-76.384584)"
2018,Abril,República de Irlanda,372,27,21,,48,"(4.697144,-74.140516)"
2018,Abril,República de Irlanda,372,1,0,,1,"(6.171601,-75.427454)"
2018,Abril,Islandia,352,1,3,,4,"(4.697144,-74.140516)"
2018,Abril,Islandia,352,0,1,,1,"(6.171601,-75.427454)"
2018,Abril,Israel,376,1,0,,1,"(10.445761,-75.516429)"
2018,Abril,Israel,376,1,1,,2,"(10.886611,-74.776708)"
2018,Abril,Israel,376,3,6,,9,"(3.541112,-76.384584)"
2018,Abril,Israel,376,117,116,,233,"(4.697144,-74.140516)"
2018,Abril,Israel,376,9,4,,13,"(6.171601,-75.427454)"
2018,Abril,Italia,380,21,10,,31,"(10.445761,-75.516429)"
2018,Abril,Italia,380,7,2,,9,"(10.886611,-74.776708)"
2018,Abril,Italia,380,137,62,,199,"(3.541112,-76.384584)"
2018,Abril,Italia,380,800,535,,1335,"(4.697144,-74.140516)"
2018,Abril,Italia,380,2,1,,3,"(4.815061,-75.736532)"
2018,Abril,Italia,380,101,62,,163,"(6.171601,-75.427454)"
2018,Abril,Jamaica,388,2,5,,7,"(10.445761,-75.516429)"
2018,Abril,Jamaica,388,1,0,,1,"(10.886611,-74.776708)"
2018,Abril,Jamaica,388,1,0,,1,"(11.247723,-74.213989)"
2018,Abril,Jamaica,388,2,4,,6,"(12.586067,-81.702563)"
2018,Abril,Jamaica,388,10,2,,12,"(3.541112,-76.384584)"
2018,Abril,Jamaica,388,25,19,,44,"(4.697144,-74.140516)"
2018,Abril,Jamaica,388,2,1,,3,"(4.815061,-75.736532)"
2018,Abril,Jamaica,388,15,10,,25,"(6.171601,-75.427454)"
2018,Abril,Japón,392,0,1,,1,"(10.886611,-74.776708)"
2018,Abril,Japón,392,5,2,,7,"(3.541112,-76.384584)"
2018,Abril,Japón,392,91,84,,175,"(4.697144,-74.140516)"
2018,Abril,Japón,392,14,27,,41,"(6.171601,-75.427454)"
2018,Abril,Jordania,400,2,5,,7,"(4.697144,-74.140516)"
2018,Abril,Kazajistán,398,0,3,,3,"(4.697144,-74.140516)"
2018,Abril,Kenia,404,3,1,,4,"(3.541112,-76.384584)"
2018,Abril,Kenia,404,6,6,,12,"(4.697144,-74.140516)"
2018,Abril,Kenia,404,1,1,,2,"(6.171601,-75.427454)"
2018,Abril,Kuwait,414,1,9,,10,"(4.697144,-74.140516)"
2018,Abril,República Democrática Popular  Lao,418,0,1,,1,"(4.697144,-74.140516)"
2018,Abril,Lituania,440,0,2,,2,"(4.697144,-74.140516)"
2018,Abril,Lituania,440,0,1,,1,"(6.171601,-75.427454)"
2018,Abril,Líbano,422,2,5,,7,"(10.886611,-74.776708)"
2018,Abril,Líbano,422,10,13,,23,"(4.697144,-74.140516)"
2018,Abril,Libia,434,0,3,,3,"(4.697144,-74.140516)"
2018,Abril,Luxemburgo,442,4,1,,5,"(3.541112,-76.384584)"
2018,Abril,Luxemburgo,442,9,5,,14,"(4.697144,-74.140516)"
2018,Abril,Luxemburgo,442,2,0,,2,"(6.171601,-75.427454)"
2018,Abril,Malasia,458,4,2,,6,"(4.697144,-74.140516)"
2018,Abril,Malí,466,0,1,,1,"(10.445761,-75.516429)"
2018,Abril,Malta,470,2,0,,2,"(10.886611,-74.776708)"
2018,Abril,Malta,470,1,0,,1,"(3.541112,-76.384584)"
2018,Abril,Malta,470,17,10,,27,"(4.697144,-74.140516)"
2018,Abril,Malta,470,3,1,,4,"(6.171601,-75.427454)"
2018,Abril,Marruecos,504,0,2,,2,"(3.541112,-76.384584)"
2018,Abril,Marruecos,504,15,17,,32,"(4.697144,-74.140516)"
2018,Abril,Marruecos,504,3,2,,5,"(6.171601,-75.427454)"
2018,Abril,México,484,0,3,,3,"(10.408582,-75.538003)"
2018,Abril,México,484,1,0,,1,"(10.433609,-73.247863)"
2018,Abril,México,484,45,40,,85,"(10.445761,-75.516429)"
2018,Abril,México,484,127,94,,221,"(10.886611,-74.776708)"
2018,Abril,México,484,4,2,,6,"(12.586067,-81.702563)"
2018,Abril,México,484,462,404,,866,"(3.541112,-76.384584)"
2018,Abril,México,484,14492,13580,,28072,"(4.697144,-74.140516)"
2018,Abril,México,484,221,154,,375,"(4.815061,-75.736532)"
2018,Abril,México,484,2137,1809,,3946,"(6.171601,-75.427454)"
2018,Abril,México,484,103,66,,169,"(7.128456,-73.183637)"
2018,Abril,Mónaco,492,0,1,,1,"(3.541112,-76.384584)"
2018,Abril,Mónaco,492,2,2,,4,"(4.697144,-74.140516)"
2018,Abril,Mónaco,492,1,0,,1,"(6.171601,-75.427454)"
2018,Abril,Mongolia,496,0,1,,1,"(4.697144,-74.140516)"
2018,Abril,Myanmar,104,0,1,,1,"(4.697144,-74.140516)"
2018,Abril,Nepal,524,5,0,,5,"(4.697144,-74.140516)"
2018,Abril,Nicaragua,558,1,2,,3,"(10.445761,-75.516429)"
2018,Abril,Nicaragua,558,4,0,,4,"(10.886611,-74.776708)"
2018,Abril,Nicaragua,558,1,0,,1,"(12.5744111,-81.703935)"
2018,Abril,Nicaragua,558,0,1,,1,"(12.586067,-81.702563)"
2018,Abril,Nicaragua,558,12,25,,37,"(3.541112,-76.384584)"
2018,Abril,Nicaragua,558,36,75,,111,"(4.697144,-74.140516)"
2018,Abril,Nicaragua,558,12,6,,18,"(4.815061,-75.736532)"
2018,Abril,Nicaragua,558,16,49,,65,"(6.171601,-75.427454)"
2018,Abril,Nicaragua,558,1,0,,1,"(7.128456,-73.183637)"
2018,Abril,Nigeria,566,0,2,,2,"(10.445761,-75.516429)"
2018,Abril,Nigeria,566,0,1,,1,"(10.886611,-74.776708)"
2018,Abril,Nigeria,566,0,6,,6,"(4.697144,-74.140516)"
2018,Abril,Noruega,578,2,0,,2,"(10.445761,-75.516429)"
2018,Abril,Noruega,578,2,0,,2,"(10.886611,-74.776708)"
2018,Abril,Noruega,578,5,2,,7,"(3.541112,-76.384584)"
2018,Abril,Noruega,578,21,16,,37,"(4.697144,-74.140516)"
2018,Abril,Noruega,578,0,1,,1,"(6.171601,-75.427454)"
2018,Abril,Nueva Caledonia/Territorio francés,540,0,1,,1,"(4.697144,-74.140516)"
2018,Abril,Nueva Zelanda,554,28,36,,64,"(4.697144,-74.140516)"
2018,Abril,Nueva Zelanda,554,1,1,,2,"(6.171601,-75.427454)"
2018,Abril,Omán,512,0,2,,2,"(10.445761,-75.516429)"
2018,Abril,Omán,512,0,4,,4,"(4.697144,-74.140516)"
2018,Abril,Pakistán,586,0,1,,1,"(4.697144,-74.140516)"
2018,Abril,Panamá,591,17,106,,123,"(10.408582,-75.538003)"
2018,Abril,Panamá,591,1031,947,,1978,"(10.445761,-75.516429)"
2018,Abril,Panamá,591,811,838,,1649,"(10.886611,-74.776708)"
2018,Abril,Panamá,591,1,5,,6,"(10.971302,-74.765397)"
2018,Abril,Panamá,591,3,17,,20,"(12.5744111,-81.703935)"
2018,Abril,Panamá,591,53,64,,117,"(12.586067,-81.702563)"
2018,Abril,Panamá,591,1905,1602,,3507,"(3.541112,-76.384584)"
2018,Abril,Panamá,591,254,145,,399,"(4.452882,-75.766298)"
2018,Abril,Panamá,591,6521,7868,,14390,"(4.697144,-74.140516)"
2018,Abril,Panamá,591,386,331,,717,"(4.815061,-75.736532)"
2018,Abril,Panamá,591,0,1,,1,"(6.17134,-75.427194)"
2018,Abril,Panamá,591,2889,2808,,5697,"(6.171601,-75.427454)"
2018,Abril,Panamá,591,0,2,,2,"(6.228046,-77.404104)"
2018,Abril,Panamá,591,8,12,,20,"(7.102626,-77.762647)"
2018,Abril,Panamá,591,224,204,,428,"(7.128456,-73.183637)"
2018,Abril,Panamá,591,0,25,,25,"(8.066966,-76.735404)"
2018,Abril,Panamá,591,19,62,,81,"(8.635765,-77.346578)"
2018,Abril,Panamá,591,0,2,,2,"(9.402978,-75.681599)"
2018,Abril,Paraguay,600,3,3,,6,"(10.445761,-75.516429)"
2018,Abril,Paraguay,600,6,10,,16,"(10.886611,-74.776708)"
2018,Abril,Paraguay,600,37,56,,93,"(3.541112,-76.384584)"
2018,Abril,Paraguay,600,67,225,,292,"(4.697144,-74.140516)"
2018,Abril,Paraguay,600,15,35,,50,"(4.815061,-75.736532)"
2018,Abril,Paraguay,600,30,157,,187,"(6.171601,-75.427454)"
2018,Abril,Paraguay,600,3,3,,6,"(7.128456,-73.183637)"
2018,Abril,Perú,604,3,6,,9,"(-0.193180,-74.784874)"
2018,Abril,Perú,604,55,86,,141,"(-4.197703,-69.941278)"
2018,Abril,Perú,604,209,141,,350,"(-4.223468,-69.945098)"
2018,Abril,Perú,604,109,125,,234,"(0.814836,-77.662532)"
2018,Abril,Perú,604,1,0,,1,"(1.813928,-78.763924)"
2018,Abril,Perú,604,44,45,,89,"(10.445761,-75.516429)"
2018,Abril,Perú,604,13,14,,27,"(10.886611,-74.776708)"
2018,Abril,Perú,604,1,1,,2,"(12.586067,-81.702563)"
2018,Abril,Perú,604,188,184,,372,"(3.541112,-76.384584)"
2018,Abril,Perú,604,4831,5919,,10750,"(4.697144,-74.140516)"
2018,Abril,Perú,604,11,10,,21,"(4.815061,-75.736532)"
2018,Abril,Perú,604,533,519,,1052,"(6.171601,-75.427454)"
2018,Abril,Perú,604,3,5,,8,"(7.128456,-73.183637)"
2018,Abril,Polonia,616,2,1,,3,"(10.886611,-74.776708)"
2018,Abril,Polonia,616,0,1,,1,"(3.541112,-76.384584)"
2018,Abril,Polonia,616,9,23,,32,"(4.697144,-74.140516)"
2018,Abril,Polonia,616,0,2,,2,"(6.171601,-75.427454)"
2018,Abril,Portugal,620,7,10,,17,"(3.541112,-76.384584)"
2018,Abril,Portugal,620,146,167,,313,"(4.697144,-74.140516)"
2018,Abril,Portugal,620,6,6,,12,"(6.171601,-75.427454)"
2018,Abril,Puerto Rico/Territorio de Estados Unidos,630,7,2,,9,"(10.445761,-75.516429)"
2018,Abril,Puerto Rico/Territorio de Estados Unidos,630,9,15,,24,"(10.886611,-74.776708)"
2018,Abril,Puerto Rico/Territorio de Estados Unidos,630,3,2,,5,"(12.586067,-81.702563)"
2018,Abril,Puerto Rico/Territorio de Estados Unidos,630,39,18,,57,"(3.541112,-76.384584)"
2018,Abril,Puerto Rico/Territorio de Estados Unidos,630,483,486,,969,"(4.697144,-74.140516)"
2018,Abril,Puerto Rico/Territorio de Estados Unidos,630,3,3,,6,"(4.815061,-75.736532)"
2018,Abril,Puerto Rico/Territorio de Estados Unidos,630,54,35,,89,"(6.171601,-75.427454)"
2018,Abril,Puerto Rico/Territorio de Estados Unidos,630,3,3,,6,"(7.128456,-73.183637)"
2018,Abril,Qatar,634,0,1,,1,"(3.541112,-76.384584)"
2018,Abril,Qatar,634,3,10,,13,"(4.697144,-74.140516)"
2018,Abril,Qatar,634,2,4,,6,"(6.171601,-75.427454)"
2018,Abril,Reino Unido de Gran Bretaña e Irlanda del Norte,826,5,0,,5,"(10.886611,-74.776708)"
2018,Abril,Reino Unido de Gran Bretaña e Irlanda del Norte,826,40,24,,64,"(3.541112,-76.384584)"
2018,Abril,Reino Unido de Gran Bretaña e Irlanda del Norte,826,1,1,,2,"(4.452882,-75.766298)"
2018,Abril,Reino Unido de Gran Bretaña e Irlanda del Norte,826,1702,1273,,2975,"(4.697144,-74.140516)"
2018,Abril,Reino Unido de Gran Bretaña e Irlanda del Norte,826,39,24,,63,"(6.171601,-75.427454)"
2018,Abril,Reino Unido de Gran Bretaña e Irlanda del Norte,826,1,1,,2,"(7.128456,-73.183637)"
2018,Abril,República CentroÁfricana,140,5,1,,6,"(4.697144,-74.140516)"
2018,Abril,Federación de Rusia,643,0,1,,1,"(10.445761,-75.516429)"
2018,Abril,Federación de Rusia,643,0,1,,1,"(3.541112,-76.384584)"
2018,Abril,Federación de Rusia,643,21,41,,62,"(4.697144,-74.140516)"
2018,Abril,Federación de Rusia,643,2,0,,2,"(6.171601,-75.427454)"
2018,Abril,República Dominicana,214,8,16,,24,"(10.445761,-75.516429)"
2018,Abril,República Dominicana,214,26,29,,55,"(10.886611,-74.776708)"
2018,Abril,República Dominicana,214,66,63,,129,"(3.541112,-76.384584)"
2018,Abril,República Dominicana,214,2648,2689,,5337,"(4.697144,-74.140516)"
2018,Abril,República Dominicana,214,45,25,,70,"(4.815061,-75.736532)"
2018,Abril,República Dominicana,214,239,199,,438,"(6.171601,-75.427454)"
2018,Abril,República Dominicana,214,20,11,,31,"(7.128456,-73.183637)"
2018,Abril,Reunión,638,1,2,,3,"(4.697144,-74.140516)"
2018,Abril,Rumania,642,0,1,,1,"(3.541112,-76.384584)"
2018,Abril,Rumania,642,4,7,,11,"(4.697144,-74.140516)"
2018,Abril,Rumania,642,1,0,,1,"(6.171601,-75.427454)"
2018,Abril,Rwanda,646,1,0,,1,"(4.697144,-74.140516)"
2018,Abril,San Marino,674,0,1,,1,"(4.697144,-74.140516)"
2018,Abril,San  Vicente y las Granadinas,670,1,0,,1,"(4.697144,-74.140516)"
2018,Abril,Santa Sede/Ciudad del Vaticano,336,0,1,,1,"(4.697144,-74.140516)"
2018,Abril,Serbia,688,2,1,,3,"(3.541112,-76.384584)"
2018,Abril,Serbia,688,1,1,,2,"(6.171601,-75.427454)"
2018,Abril,Singapur,702,0,1,,1,"(10.886611,-74.776708)"
2018,Abril,Singapur,702,14,16,,30,"(4.697144,-74.140516)"
2018,Abril,Singapur,702,1,2,,3,"(6.171601,-75.427454)"
2018,Abril,República Árabe Siria,760,0,1,,1,"(4.697144,-74.140516)"
2018,Abril,Sudáfrica,710,10,18,,28,"(4.697144,-74.140516)"
2018,Abril,Suecia,752,0,2,,2,"(10.445761,-75.516429)"
2018,Abril,Suecia,752,1,1,,2,"(10.886611,-74.776708)"
2018,Abril,Suecia,752,13,18,,31,"(3.541112,-76.384584)"
2018,Abril,Suecia,752,56,47,,103,"(4.697144,-74.140516)"
2018,Abril,Suecia,752,14,8,,22,"(6.171601,-75.427454)"
2018,Abril,Suiza,756,3,1,,4,"(10.445761,-75.516429)"
2018,Abril,Suiza,756,1,1,,2,"(10.886611,-74.776708)"
2018,Abril,Suiza,756,30,18,,48,"(3.541112,-76.384584)"
2018,Abril,Suiza,756,233,147,,380,"(4.697144,-74.140516)"
2018,Abril,Suiza,756,1,0,,1,"(4.815061,-75.736532)"
2018,Abril,Suiza,756,36,20,,56,"(6.171601,-75.427454)"
2018,Abril,Suiza,756,0,1,,1,"(7.128456,-73.183637)"
2018,Abril,Surinam,740,0,1,,1,"(10.886611,-74.776708)"
2018,Abril,Surinam,740,6,10,,16,"(4.697144,-74.140516)"
2018,Abril,Surinam,740,1,0,,1,"(6.171601,-75.427454)"
2018,Abril,Taiwán,158,3,5,,8,"(4.697144,-74.140516)"
2018,Abril,Tailandia,764,17,14,,31,"(4.697144,-74.140516)"
2018,Abril,Tailandia,764,0,2,,2,"(6.171601,-75.427454)"
2018,Abril,Tanzania,834,1,1,,2,"(4.697144,-74.140516)"
2018,Abril,Trinidad y Tobago,780,0,2,,2,"(10.445761,-75.516429)"
2018,Abril,Trinidad y Tobago,780,0,9,,9,"(10.886611,-74.776708)"
2018,Abril,Trinidad y Tobago,780,2,6,,8,"(3.541112,-76.384584)"
2018,Abril,Trinidad y Tobago,780,12,19,,31,"(4.697144,-74.140516)"
2018,Abril,Trinidad y Tobago,780,0,5,,5,"(4.815061,-75.736532)"
2018,Abril,Trinidad y Tobago,780,7,12,,19,"(6.171601,-75.427454)"
2018,Abril,Trinidad y Tobago,780,3,0,,3,"(7.128456,-73.183637)"
2018,Abril,Túnez,788,11,9,,20,"(4.697144,-74.140516)"
2018,Abril,Turquía,792,0,1,,1,"(10.445761,-75.516429)"
2018,Abril,Turquía,792,2,1,,3,"(10.886611,-74.776708)"
2018,Abril,Turquía,792,42,41,,83,"(3.541112,-76.384584)"
2018,Abril,Turquía,792,953,491,,1444,"(4.697144,-74.140516)"
2018,Abril,Turquía,792,2,1,,3,"(4.815061,-75.736532)"
2018,Abril,Turquía,792,8,16,,24,"(6.171601,-75.427454)"
2018,Abril,Turkmenistán,795,6,3,,9,"(4.697144,-74.140516)"
2018,Abril,Ucrania,804,2,0,,2,"(10.445761,-75.516429)"
2018,Abril,Ucrania,804,0,2,,2,"(4.697144,-74.140516)"
2018,Abril,Uganda,800,0,1,,1,"(3.541112,-76.384584)"
2018,Abril,Uruguay,858,1,3,,4,"(0.814836,-77.662532)"
2018,Abril,Uruguay,858,0,1,,1,"(10.445761,-75.516429)"
2018,Abril,Uruguay,858,1,0,,1,"(10.886611,-74.776708)"
2018,Abril,Uruguay,858,15,32,,47,"(3.541112,-76.384584)"
2018,Abril,Uruguay,858,285,342,,627,"(4.697144,-74.140516)"
2018,Abril,Uruguay,858,3,4,,7,"(4.815061,-75.736532)"
2018,Abril,Uruguay,858,30,28,,58,"(6.171601,-75.427454)"
2018,Abril,Uruguay,858,3,7,,10,"(7.128456,-73.183637)"
2018,Abril,Venezuela,862,0,28,,28,"(10.408582,-75.538003)"
2018,Abril,Venezuela,862,0,2,,2,"(10.433609,-73.247863)"
2018,Abril,Venezuela,862,2,4,,6,"(10.445761,-75.516429)"
2018,Abril,Venezuela,862,6,17,,23,"(10.886611,-74.776708)"
2018,Abril,Venezuela,862,0,1,,1,"(11.117806,-74.232622)"
2018,Abril,Venezuela,862,1966,2143,,4109,"(11.360009,-72.129330)"
2018,Abril,Venezuela,862,2,3,,5,"(11.528919,-72.919681)"
2018,Abril,Venezuela,862,316,223,,539,"(3.541112,-76.384584)"
2018,Abril,Venezuela,862,4,5,,9,"(3.866713,-67.927521)"
2018,Abril,Venezuela,862,856,862,,1718,"(4.697144,-74.140516)"
2018,Abril,Venezuela,862,2,1,,3,"(4.815061,-75.736532)"
2018,Abril,Venezuela,862,665,638,,1303,"(6.171601,-75.427454)"
2018,Abril,Venezuela,862,54,51,,105,"(6.185799,-67.483929)"
2018,Abril,Venezuela,862,565,574,,1139,"(7.088729,-70.740253)"
2018,Abril,Venezuela,862,3,1,,4,"(7.128456,-73.183637)"
2018,Abril,Venezuela,862,1409,1665,,3074,"(7.818934,-72.453226)"
2018,Abril,Venezuela,862,4,17,,21,"(7.927209,-72.507910)"
2018,Abril,Venezuela,862,123,176,,299,"(8.36068,-72.409396)"
2018,Abril,Vietnam,704,1,0,,1,"(10.886611,-74.776708)"
2018,Abril,Vietnam,704,5,7,,12,"(4.697144,-74.140516)"
2018,Abril,Islas Vírgenes Estadounidenses/Territorio de Estados Unidos,850,0,5,,5,"(4.697144,-74.140516)"
2018,Mayo,Afganistán,4,0,4,,4,"(4.697144,-74.140516)"
2018,Mayo,Albania,8,1,24,,25,"(4.697144,-74.140516)"
2018,Mayo,Alemania,276,12,7,,19,"(10.445761,-75.516429)"
2018,Mayo,Alemania,276,13,5,,18,"(10.886611,-74.776708)"
2018,Mayo,Alemania,276,63,44,,107,"(3.541112,-76.384584)"
2018,Mayo,Alemania,276,1517,1485,,3002,"(4.697144,-74.140516)"
2018,Mayo,Alemania,276,2,2,,4,"(4.815061,-75.736532)"
2018,Mayo,Alemania,276,75,43,,118,"(6.171601,-75.427454)"
2018,Mayo,Alemania,276,2,1,,3,"(7.128456,-73.183637)"
2018,Mayo,Andorra,20,0,1,,1,"(4.697144,-74.140516)"
2018,Mayo,Angola,24,2,9,,11,"(4.697144,-74.140516)"
2018,Mayo,Antigua y Barbuda,28,0,1,,1,"(10.886611,-74.776708)"
2018,Mayo,Antigua y Barbuda,28,1,0,,1,"(3.541112,-76.384584)"
2018,Mayo,Antigua y Barbuda,28,2,0,,2,"(4.697144,-74.140516)"
2018,Mayo,Países Bajos,528,206,116,,322,"(10.445761,-75.516429)"
2018,Mayo,Países Bajos,528,16,3,,19,"(10.886611,-74.776708)"
2018,Mayo,Países Bajos,528,58,29,,87,"(3.541112,-76.384584)"
2018,Mayo,Países Bajos,528,1119,922,,2041,"(4.697144,-74.140516)"
2018,Mayo,Países Bajos,528,3,2,,5,"(4.815061,-75.736532)"
2018,Mayo,Países Bajos,528,87,80,,167,"(6.171601,-75.427454)"
2018,Mayo,Países Bajos,528,1,1,,2,"(7.128456,-73.183637)"
2018,Mayo,Arabia Saudita,682,0,1,,1,"(10.445761,-75.516429)"
2018,Mayo,Arabia Saudita,682,0,1,,1,"(3.541112,-76.384584)"
2018,Mayo,Arabia Saudita,682,6,33,,39,"(4.697144,-74.140516)"
2018,Mayo,Arabia Saudita,682,0,1,,1,"(6.171601,-75.427454)"
2018,Mayo,Argelia,12,1,3,,4,"(4.697144,-74.140516)"
2018,Mayo,Argentina,32,0,1,,1,"(0.25129,-76.875963)"
2018,Mayo,Argentina,32,11,28,,39,"(0.814836,-77.662532)"
2018,Mayo,Argentina,32,29,28,,57,"(10.445761,-75.516429)"
2018,Mayo,Argentina,32,28,26,,54,"(10.886611,-74.776708)"
2018,Mayo,Argentina,32,0,1,,1,"(12.586067,-81.702563)"
2018,Mayo,Argentina,32,104,82,,186,"(3.541112,-76.384584)"
2018,Mayo,Argentina,32,2425,2268,,4693,"(4.697144,-74.140516)"
2018,Mayo,Argentina,32,20,34,,54,"(4.815061,-75.736532)"
2018,Mayo,Argentina,32,131,184,,315,"(6.171601,-75.427454)"
2018,Mayo,Argentina,32,1,4,,5,"(7.128456,-73.183637)"
2018,Mayo,Aruba,533,369,216,,585,"(10.408582,-75.538003)"
2018,Mayo,Aruba,533,13,13,,26,"(10.886611,-74.776708)"
2018,Mayo,Aruba,533,1,13,,14,"(12.165168,-71.983761)"
2018,Mayo,Aruba,533,26,10,,36,"(3.541112,-76.384584)"
2018,Mayo,Aruba,533,1693,1251,,2944,"(4.697144,-74.140516)"
2018,Mayo,Aruba,533,8,6,,14,"(4.815061,-75.736532)"
2018,Mayo,Aruba,533,48,28,,76,"(6.171601,-75.427454)"
2018,Mayo,Aruba,533,10,29,,39,"(7.128456,-73.183637)"
2018,Mayo,Australia,36,1,0,,1,"(10.886611,-74.776708)"
2018,Mayo,Australia,36,9,10,,19,"(3.541112,-76.384584)"
2018,Mayo,Australia,36,287,201,,488,"(4.697144,-74.140516)"
2018,Mayo,Australia,36,3,1,,4,"(4.815061,-75.736532)"
2018,Mayo,Australia,36,31,16,,47,"(6.171601,-75.427454)"
2018,Mayo,Australia,36,1,0,,1,"(7.128456,-73.183637)"
2018,Mayo,Austria,40,3,0,,3,"(10.445761,-75.516429)"
2018,Mayo,Austria,40,0,1,,1,"(10.886611,-74.776708)"
2018,Mayo,Austria,40,1,2,,3,"(3.541112,-76.384584)"
2018,Mayo,Austria,40,40,29,,69,"(4.697144,-74.140516)"
2018,Mayo,Austria,40,9,5,,14,"(6.171601,-75.427454)"
2018,Mayo,Azerbaiyán,31,0,2,,2,"(10.445761,-75.516429)"
2018,Mayo,Azerbaiyán,31,4,4,,8,"(3.541112,-76.384584)"
2018,Mayo,Azerbaiyán,31,16,22,,38,"(4.697144,-74.140516)"
2018,Mayo,Azerbaiyán,31,1,2,,3,"(6.171601,-75.427454)"
2018,Mayo,Bahamas,44,1,0,,1,"(10.445761,-75.516429)"
2018,Mayo,Bahamas,44,0,6,,6,"(10.886611,-74.776708)"
2018,Mayo,Bahamas,44,2,3,,5,"(12.586067,-81.702563)"
2018,Mayo,Bahamas,44,2,0,,2,"(3.541112,-76.384584)"
2018,Mayo,Bahamas,44,14,17,,31,"(4.697144,-74.140516)"
2018,Mayo,Bahamas,44,4,0,,4,"(4.815061,-75.736532)"
2018,Mayo,Bahamas,44,21,25,,46,"(6.171601,-75.427454)"
2018,Mayo,Bahréin,48,1,0,,1,"(4.452882,-75.766298)"
2018,Mayo,Bahréin,48,2,3,,5,"(4.697144,-74.140516)"
2018,Mayo,Bahréin,48,1,1,,2,"(6.171601,-75.427454)"
2018,Mayo,Barbados,52,0,2,,2,"(10.886611,-74.776708)"
2018,Mayo,Barbados,52,2,5,,7,"(3.541112,-76.384584)"
2018,Mayo,Barbados,52,4,5,,9,"(4.697144,-74.140516)"
2018,Mayo,Barbados,52,0,1,,1,"(6.171601,-75.427454)"
2018,Mayo,Bélgica,56,1,2,,3,"(10.445761,-75.516429)"
2018,Mayo,Bélgica,56,4,4,,8,"(10.886611,-74.776708)"
2018,Mayo,Bélgica,56,18,9,,27,"(3.541112,-76.384584)"
2018,Mayo,Bélgica,56,109,67,,176,"(4.697144,-74.140516)"
2018,Mayo,Bélgica,56,31,19,,50,"(6.171601,-75.427454)"
2018,Mayo,Belice,84,3,9,,12,"(4.697144,-74.140516)"
2018,Mayo,Belice,84,4,1,,5,"(6.171601,-75.427454)"
2018,Mayo,Bermudas/Territorio Británico de Ultramar,60,1,0,,1,"(3.541112,-76.384584)"
2018,Mayo,Bermudas/Territorio Británico de Ultramar,60,0,1,,1,"(4.697144,-74.140516)"
2018,Mayo,Bolivia,68,0,5,,5,"(0.814836,-77.662532)"
2018,Mayo,Bolivia,68,0,1,,1,"(1.813928,-78.763924)"
2018,Mayo,Bolivia,68,3,6,,9,"(10.445761,-75.516429)"
2018,Mayo,Bolivia,68,1,1,,2,"(10.886611,-74.776708)"
2018,Mayo,Bolivia,68,0,1,,1,"(12.586067,-81.702563)"
2018,Mayo,Bolivia,68,18,32,,50,"(3.541112,-76.384584)"
2018,Mayo,Bolivia,68,453,745,,1198,"(4.697144,-74.140516)"
2018,Mayo,Bolivia,68,6,9,,15,"(4.815061,-75.736532)"
2018,Mayo,Bolivia,68,43,60,,103,"(6.171601,-75.427454)"
2018,Mayo,Brasil,76,138,217,,355,"(-4.197703,-69.941278)"
2018,Mayo,Brasil,76,15,39,,54,"(-4.223468,-69.945098)"
2018,Mayo,Brasil,76,1,0,,1,"(0.814836,-77.662532)"
2018,Mayo,Brasil,76,6,12,,18,"(10.445761,-75.516429)"
2018,Mayo,Brasil,76,4,12,,16,"(10.886611,-74.776708)"
2018,Mayo,Brasil,76,1,1,,2,"(12.586067,-81.702563)"
2018,Mayo,Brasil,76,128,118,,246,"(3.541112,-76.384584)"
2018,Mayo,Brasil,76,3487,4636,,8123,"(4.697144,-74.140516)"
2018,Mayo,Brasil,76,6,12,,18,"(4.815061,-75.736532)"
2018,Mayo,Brasil,76,165,207,,372,"(6.171601,-75.427454)"
2018,Mayo,Brasil,76,3,3,,6,"(7.128456,-73.183637)"
2018,Mayo,Bulgaria,100,1,0,,1,"(3.541112,-76.384584)"
2018,Mayo,Bulgaria,100,1,2,,3,"(4.697144,-74.140516)"
2018,Mayo,Cabo Verde,132,0,1,,1,"(4.697144,-74.140516)"
2018,Mayo,Islas Caimán/Territorio Británico de Ultramar,136,2,3,,5,"(12.586067,-81.702563)"
2018,Mayo,Islas Caimán/Territorio Británico de Ultramar,136,5,4,,9,"(4.697144,-74.140516)"
2018,Mayo,Islas Caimán/Territorio Británico de Ultramar,136,1,0,,1,"(6.171601,-75.427454)"
2018,Mayo,Camboya,116,2,1,,3,"(4.697144,-74.140516)"
2018,Mayo,Camerún,120,0,1,,1,"(4.697144,-74.140516)"
2018,Mayo,Canadá,124,37,25,,62,"(10.445761,-75.516429)"
2018,Mayo,Canadá,124,48,33,,81,"(10.886611,-74.776708)"
2018,Mayo,Canadá,124,1,0,,1,"(12.586067,-81.702563)"
2018,Mayo,Canadá,124,120,85,,205,"(3.541112,-76.384584)"
2018,Mayo,Canadá,124,2338,1819,,4157,"(4.697144,-74.140516)"
2018,Mayo,Canadá,124,25,11,,36,"(4.815061,-75.736532)"
2018,Mayo,Canadá,124,406,351,,757,"(6.171601,-75.427454)"
2018,Mayo,Canadá,124,15,13,,28,"(7.128456,-73.183637)"
2018,Mayo,España,724,7,9,,16,"(10.445761,-75.516429)"
2018,Mayo,España,724,25,19,,44,"(10.886611,-74.776708)"
2018,Mayo,España,724,4314,2934,,7248,"(3.541112,-76.384584)"
2018,Mayo,España,724,17013,12771,,29784,"(4.697144,-74.140516)"
2018,Mayo,España,724,11,3,,14,"(4.815061,-75.736532)"
2018,Mayo,España,724,3154,2189,,5343,"(6.171601,-75.427454)"
2018,Mayo,España,724,1,0,,1,"(7.128456,-73.183637)"
2018,Mayo,Colombia,170,2,6,,8,"(10.445761,-75.516429)"
2018,Mayo,Colombia,170,328,773,,1101,"(4.697144,-74.140516)"
2018,Mayo,República Del Congo,178,0,3,,3,"(4.697144,-74.140516)"
2018,Mayo,República de Corea,410,16,24,,40,"(4.697144,-74.140516)"
2018,Mayo,República de Corea,410,1,2,,3,"(6.171601,-75.427454)"
2018,Mayo,Costa de Marfil,384,4,6,,10,"(4.697144,-74.140516)"
2018,Mayo,Costa de Marfil,384,0,3,,3,"(6.171601,-75.427454)"
2018,Mayo,Costa Rica,188,6,0,,6,"(10.408582,-75.538003)"
2018,Mayo,Costa Rica,188,8,9,,17,"(10.445761,-75.516429)"
2018,Mayo,Costa Rica,188,26,38,,64,"(10.886611,-74.776708)"
2018,Mayo,Costa Rica,188,2,18,,20,"(12.5744111,-81.703935)"
2018,Mayo,Costa Rica,188,2,2,,4,"(12.586067,-81.702563)"
2018,Mayo,Costa Rica,188,40,40,,80,"(3.541112,-76.384584)"
2018,Mayo,Costa Rica,188,1157,1444,,2601,"(4.697144,-74.140516)"
2018,Mayo,Costa Rica,188,19,10,,29,"(4.815061,-75.736532)"
2018,Mayo,Costa Rica,188,150,126,,276,"(6.171601,-75.427454)"
2018,Mayo,Costa Rica,188,4,5,,9,"(7.128456,-73.183637)"
2018,Mayo,Croacia,191,1,1,,2,"(3.541112,-76.384584)"
2018,Mayo,Croacia,191,11,9,,20,"(4.697144,-74.140516)"
2018,Mayo,Croacia,191,1,0,,1,"(4.815061,-75.736532)"
2018,Mayo,Croacia,191,0,5,,5,"(6.171601,-75.427454)"
2018,Mayo,Cuba,192,7,13,,20,"(10.445761,-75.516429)"
2018,Mayo,Cuba,192,20,14,,34,"(10.886611,-74.776708)"
2018,Mayo,Cuba,192,60,56,,116,"(3.541112,-76.384584)"
2018,Mayo,Cuba,192,1241,1016,,2257,"(4.697144,-74.140516)"
2018,Mayo,Cuba,192,21,10,,31,"(4.815061,-75.736532)"
2018,Mayo,Cuba,192,203,118,,321,"(6.171601,-75.427454)"
2018,Mayo,Cuba,192,35,11,,46,"(7.128456,-73.183637)"
2018,Mayo,Curazao,99999,1,0,,1,"(10.886611,-74.776708)"
2018,Mayo,Curazao,99999,5,7,,12,"(3.541112,-76.384584)"
2018,Mayo,Curazao,99999,444,367,,811,"(4.697144,-74.140516)"
2018,Mayo,Curazao,99999,9,12,,21,"(6.171601,-75.427454)"
2018,Mayo,República Checa,203,2,0,,2,"(3.541112,-76.384584)"
2018,Mayo,República Checa,203,13,9,,22,"(4.697144,-74.140516)"
2018,Mayo,República Checa,203,1,0,,1,"(6.171601,-75.427454)"
2018,Mayo,Chile,152,0,1,,1,"(-4.197703,-69.941278)"
2018,Mayo,Chile,152,1,1,,2,"(0.812436,-77.847006)"
2018,Mayo,Chile,152,117,99,,216,"(0.814836,-77.662532)"
2018,Mayo,Chile,152,29,23,,52,"(10.445761,-75.516429)"
2018,Mayo,Chile,152,22,23,,45,"(10.886611,-74.776708)"
2018,Mayo,Chile,152,1,4,,5,"(12.586067,-81.702563)"
2018,Mayo,Chile,152,276,185,,461,"(3.541112,-76.384584)"
2018,Mayo,Chile,152,3721,3203,,6924,"(4.697144,-74.140516)"
2018,Mayo,Chile,152,104,71,,175,"(4.815061,-75.736532)"
2018,Mayo,Chile,152,184,148,,332,"(6.171601,-75.427454)"
2018,Mayo,Chile,152,2,6,,8,"(7.128456,-73.183637)"
2018,Mayo,China,156,1,3,,4,"(10.445761,-75.516429)"
2018,Mayo,China,156,4,9,,13,"(10.886611,-74.776708)"
2018,Mayo,China,156,6,18,,24,"(3.541112,-76.384584)"
2018,Mayo,China,156,224,445,,669,"(4.697144,-74.140516)"
2018,Mayo,China,156,0,1,,1,"(4.815061,-75.736532)"
2018,Mayo,China,156,17,52,,69,"(6.171601,-75.427454)"
2018,Mayo,Chipre,196,1,0,,1,"(3.541112,-76.384584)"
2018,Mayo,Chipre,196,1,2,,3,"(4.697144,-74.140516)"
2018,Mayo,Dinamarca,208,1,0,,1,"(10.445761,-75.516429)"
2018,Mayo,Dinamarca,208,1,0,,1,"(10.886611,-74.776708)"
2018,Mayo,Dinamarca,208,18,26,,44,"(4.697144,-74.140516)"
2018,Mayo,Dinamarca,208,2,3,,5,"(6.171601,-75.427454)"
2018,Mayo,Dominica,212,2,0,,2,"(4.697144,-74.140516)"
2018,Mayo,Ecuador,218,3,3,,6,"(-0.193180,-74.784874)"
2018,Mayo,Ecuador,218,523,890,,1413,"(0.25129,-76.875963)"
2018,Mayo,Ecuador,218,117,121,,238,"(0.812436,-77.847006)"
2018,Mayo,Ecuador,218,4384,6225,,10609,"(0.814836,-77.662532)"
2018,Mayo,Ecuador,218,171,156,,327,"(1.813928,-78.763924)"
2018,Mayo,Ecuador,218,5,6,,11,"(10.445761,-75.516429)"
2018,Mayo,Ecuador,218,6,9,,15,"(10.886611,-74.776708)"
2018,Mayo,Ecuador,218,2,2,,4,"(12.586067,-81.702563)"
2018,Mayo,Ecuador,218,269,371,,640,"(3.541112,-76.384584)"
2018,Mayo,Ecuador,218,2604,4156,,6761,"(4.697144,-74.140516)"
2018,Mayo,Ecuador,218,1,3,,4,"(4.815061,-75.736532)"
2018,Mayo,Ecuador,218,48,108,,156,"(6.171601,-75.427454)"
2018,Mayo,Ecuador,218,3,3,,6,"(7.128456,-73.183637)"
2018,Mayo,Egipto,818,3,3,,6,"(3.541112,-76.384584)"
2018,Mayo,Egipto,818,11,13,,24,"(4.697144,-74.140516)"
2018,Mayo,Egipto,818,3,1,,4,"(6.171601,-75.427454)"
2018,Mayo,El Salvador,222,1,2,,3,"(10.445761,-75.516429)"
2018,Mayo,El Salvador,222,1,7,,8,"(10.886611,-74.776708)"
2018,Mayo,El Salvador,222,8,13,,21,"(3.541112,-76.384584)"
2018,Mayo,El Salvador,222,839,1143,,1982,"(4.697144,-74.140516)"
2018,Mayo,El Salvador,222,3,1,,4,"(4.815061,-75.736532)"
2018,Mayo,El Salvador,222,71,105,,176,"(6.171601,-75.427454)"
2018,Mayo,Emiratos Árabes,784,0,2,,2,"(10.445761,-75.516429)"
2018,Mayo,Emiratos Árabes,784,2,3,,5,"(3.541112,-76.384584)"
2018,Mayo,Emiratos Árabes,784,71,304,,375,"(4.697144,-74.140516)"
2018,Mayo,Emiratos Árabes,784,9,6,,15,"(6.171601,-75.427454)"
2018,Mayo,Eritrea,232,0,3,,3,"(4.697144,-74.140516)"
2018,Mayo,Eslovaquia,703,2,0,,2,"(4.697144,-74.140516)"
2018,Mayo,Eslovenia,705,0,1,,1,"(3.541112,-76.384584)"
2018,Mayo,Eslovenia,705,1,3,,4,"(4.697144,-74.140516)"
2018,Mayo,Estados Unidos de América,840,1,4,,5,"(10.408582,-75.538003)"
2018,Mayo,Estados Unidos de América,840,0,2,,2,"(10.433609,-73.247863)"
2018,Mayo,Estados Unidos de América,840,3244,2563,,5809,"(10.445761,-75.516429)"
2018,Mayo,Estados Unidos de América,840,2775,2199,,4974,"(10.886611,-74.776708)"
2018,Mayo,Estados Unidos de América,840,67,35,,102,"(12.586067,-81.702563)"
2018,Mayo,Estados Unidos de América,840,6563,4373,,10936,"(3.541112,-76.384584)"
2018,Mayo,Estados Unidos de América,840,838,666,,1504,"(4.452882,-75.766298)"
2018,Mayo,Estados Unidos de América,840,36214,30532,,66748,"(4.697144,-74.140516)"
2018,Mayo,Estados Unidos de América,840,887,604,,1491,"(4.815061,-75.736532)"
2018,Mayo,Estados Unidos de América,840,11018,8351,,19369,"(6.171601,-75.427454)"
2018,Mayo,Estados Unidos de América,840,285,207,,492,"(7.128456,-73.183637)"
2018,Mayo,Estonia,233,0,1,,1,"(10.886611,-74.776708)"
2018,Mayo,Estonia,233,1,1,,2,"(4.697144,-74.140516)"
2018,Mayo,Etiopia,231,0,3,,3,"(4.697144,-74.140516)"
2018,Mayo,Filipinas,608,2,1,,3,"(3.541112,-76.384584)"
2018,Mayo,Filipinas,608,7,9,,16,"(4.697144,-74.140516)"
2018,Mayo,Finlandia,246,1,1,,2,"(10.445761,-75.516429)"
2018,Mayo,Finlandia,246,0,1,,1,"(3.541112,-76.384584)"
2018,Mayo,Finlandia,246,9,4,,13,"(4.697144,-74.140516)"
2018,Mayo,Finlandia,246,1,1,,2,"(6.171601,-75.427454)"
2018,Mayo,Francia,250,18,15,,33,"(10.445761,-75.516429)"
2018,Mayo,Francia,250,17,12,,29,"(10.886611,-74.776708)"
2018,Mayo,Francia,250,0,1,,1,"(12.586067,-81.702563)"
2018,Mayo,Francia,250,96,65,,161,"(3.541112,-76.384584)"
2018,Mayo,Francia,250,2012,1644,,3656,"(4.697144,-74.140516)"
2018,Mayo,Francia,250,4,2,,6,"(4.815061,-75.736532)"
2018,Mayo,Francia,250,120,79,,199,"(6.171601,-75.427454)"
2018,Mayo,Gabón,266,0,5,,5,"(4.697144,-74.140516)"
2018,Mayo,Gambia,270,2,1,,3,"(4.697144,-74.140516)"
2018,Mayo,Ghana,288,1,3,,4,"(4.697144,-74.140516)"
2018,Mayo,Gibraltar/Territorio Británico de Ultramar,292,1,1,,2,"(4.697144,-74.140516)"
2018,Mayo,Grecia,300,0,1,,1,"(10.445761,-75.516429)"
2018,Mayo,Grecia,300,1,0,,1,"(3.541112,-76.384584)"
2018,Mayo,Grecia,300,32,23,,55,"(4.697144,-74.140516)"
2018,Mayo,Grecia,300,3,1,,4,"(6.171601,-75.427454)"
2018,Mayo,Groenlandia,304,0,1,,1,"(4.697144,-74.140516)"
2018,Mayo,Guatemala,320,0,8,,8,"(10.445761,-75.516429)"
2018,Mayo,Guatemala,320,3,14,,17,"(10.886611,-74.776708)"
2018,Mayo,Guatemala,320,0,15,,15,"(12.586067,-81.702563)"
2018,Mayo,Guatemala,320,26,55,,81,"(3.541112,-76.384584)"
2018,Mayo,Guatemala,320,526,687,,1213,"(4.697144,-74.140516)"
2018,Mayo,Guatemala,320,10,13,,23,"(4.815061,-75.736532)"
2018,Mayo,Guatemala,320,81,126,,207,"(6.171601,-75.427454)"
2018,Mayo,Guatemala,320,3,6,,9,"(7.128456,-73.183637)"
2018,Mayo,Guyana,328,0,3,,3,"(10.886611,-74.776708)"
2018,Mayo,Guyana,328,1,0,,1,"(3.541112,-76.384584)"
2018,Mayo,Guyana,328,1,2,,3,"(4.697144,-74.140516)"
2018,Mayo,Guinea Ecuatorial,226,1,2,,3,"(4.697144,-74.140516)"
2018,Mayo,Guinea Ecuatorial,226,0,1,,1,"(6.171601,-75.427454)"
2018,Mayo,Guinea Bissau,624,0,1,,1,"(4.697144,-74.140516)"
2018,Mayo,Guadalupe/Territorio Francés,312,1,1,,2,"(3.541112,-76.384584)"
2018,Mayo,Guadalupe/Territorio Francés,312,0,1,,1,"(4.697144,-74.140516)"
2018,Mayo,Guayana Francesa/Departamento de Ultramar Francés,254,1,1,,2,"(4.697144,-74.140516)"
2018,Mayo,Haití,332,0,1,,1,"(10.886611,-74.776708)"
2018,Mayo,Haití,332,0,1,,1,"(3.541112,-76.384584)"
2018,Mayo,Haití,332,3,2,,5,"(4.697144,-74.140516)"
2018,Mayo,Haití,332,1,3,,4,"(6.171601,-75.427454)"
2018,Mayo,Honduras,340,3,6,,9,"(10.445761,-75.516429)"
2018,Mayo,Honduras,340,6,11,,17,"(10.886611,-74.776708)"
2018,Mayo,Honduras,340,15,13,,28,"(3.541112,-76.384584)"
2018,Mayo,Honduras,340,86,138,,224,"(4.697144,-74.140516)"
2018,Mayo,Honduras,340,5,19,,24,"(4.815061,-75.736532)"
2018,Mayo,Honduras,340,42,60,,102,"(6.171601,-75.427454)"
2018,Mayo,Honduras,340,0,3,,3,"(7.128456,-73.183637)"
2018,Mayo,Hong Kong,344,14,26,,40,"(4.697144,-74.140516)"
2018,Mayo,Hong Kong,344,7,4,,11,"(6.171601,-75.427454)"
2018,Mayo,Hungría,348,0,1,,1,"(10.445761,-75.516429)"
2018,Mayo,Hungría,348,0,1,,1,"(10.886611,-74.776708)"
2018,Mayo,Hungría,348,4,1,,5,"(3.541112,-76.384584)"
2018,Mayo,Hungría,348,6,8,,14,"(4.697144,-74.140516)"
2018,Mayo,Hungría,348,1,0,,1,"(6.171601,-75.427454)"
2018,Mayo,India,356,2,1,,3,"(3.541112,-76.384584)"
2018,Mayo,India,356,17,44,,61,"(4.697144,-74.140516)"
2018,Mayo,India,356,2,1,,3,"(6.171601,-75.427454)"
2018,Mayo,Indonesia,360,0,1,,1,"(3.541112,-76.384584)"
2018,Mayo,Indonesia,360,4,3,,7,"(4.697144,-74.140516)"
2018,Mayo,Iraq,368,1,7,,8,"(4.697144,-74.140516)"
2018,Mayo,Iraq,368,0,1,,1,"(6.171601,-75.427454)"
2018,Mayo,Irán,364,0,1,,1,"(4.697144,-74.140516)"
2018,Mayo,República de Irlanda,372,1,0,,1,"(3.541112,-76.384584)"
2018,Mayo,República de Irlanda,372,15,7,,22,"(4.697144,-74.140516)"
2018,Mayo,República de Irlanda,372,1,4,,5,"(6.171601,-75.427454)"
2018,Mayo,Islandia,352,3,2,,5,"(4.697144,-74.140516)"
2018,Mayo,Islandia,352,1,1,,2,"(6.171601,-75.427454)"
2018,Mayo,Israel,376,0,2,,2,"(10.445761,-75.516429)"
2018,Mayo,Israel,376,0,1,,1,"(10.886611,-74.776708)"
2018,Mayo,Israel,376,5,5,,10,"(3.541112,-76.384584)"
2018,Mayo,Israel,376,145,100,,245,"(4.697144,-74.140516)"
2018,Mayo,Israel,376,11,5,,16,"(6.171601,-75.427454)"
2018,Mayo,Italia,380,14,7,,21,"(10.445761,-75.516429)"
2018,Mayo,Italia,380,5,4,,9,"(10.886611,-74.776708)"
2018,Mayo,Italia,380,137,62,,199,"(3.541112,-76.384584)"
2018,Mayo,Italia,380,922,665,,1587,"(4.697144,-74.140516)"
2018,Mayo,Italia,380,1,3,,4,"(4.815061,-75.736532)"
2018,Mayo,Italia,380,127,70,,197,"(6.171601,-75.427454)"
2018,Mayo,Italia,380,2,2,,4,"(7.128456,-73.183637)"
2018,Mayo,Jamaica,388,1,2,,3,"(10.445761,-75.516429)"
2018,Mayo,Jamaica,388,3,3,,6,"(10.886611,-74.776708)"
2018,Mayo,Jamaica,388,3,0,,3,"(12.586067,-81.702563)"
2018,Mayo,Jamaica,388,5,3,,8,"(3.541112,-76.384584)"
2018,Mayo,Jamaica,388,17,22,,39,"(4.697144,-74.140516)"
2018,Mayo,Jamaica,388,1,4,,5,"(4.815061,-75.736532)"
2018,Mayo,Jamaica,388,7,22,,29,"(6.171601,-75.427454)"
2018,Mayo,Jamaica,388,2,4,,6,"(7.128456,-73.183637)"
2018,Mayo,Japón,392,1,1,,2,"(10.445761,-75.516429)"
2018,Mayo,Japón,392,1,0,,1,"(10.886611,-74.776708)"
2018,Mayo,Japón,392,4,2,,6,"(3.541112,-76.384584)"
2018,Mayo,Japón,392,108,102,,210,"(4.697144,-74.140516)"
2018,Mayo,Japón,392,0,1,,1,"(4.815061,-75.736532)"
2018,Mayo,Japón,392,10,7,,17,"(6.171601,-75.427454)"
2018,Mayo,Jordania,400,2,3,,5,"(4.697144,-74.140516)"
2018,Mayo,Kazajistán,398,0,1,,1,"(3.541112,-76.384584)"
2018,Mayo,Kenia,404,0,1,,1,"(10.445761,-75.516429)"
2018,Mayo,Kenia,404,3,2,,5,"(4.697144,-74.140516)"
2018,Mayo,Kuwait,414,0,1,,1,"(3.541112,-76.384584)"
2018,Mayo,Kuwait,414,0,1,,1,"(4.697144,-74.140516)"
2018,Mayo,Kuwait,414,0,1,,1,"(6.171601,-75.427454)"
2018,Mayo,República de Kosovo,901,0,1,,1,"(4.697144,-74.140516)"
2018,Mayo,Lituania,440,1,1,,2,"(3.541112,-76.384584)"
2018,Mayo,Lituania,440,8,2,,10,"(4.697144,-74.140516)"
2018,Mayo,Líbano,422,2,0,,2,"(10.886611,-74.776708)"
2018,Mayo,Líbano,422,15,17,,32,"(4.697144,-74.140516)"
2018,Mayo,Líbano,422,0,1,,1,"(6.171601,-75.427454)"
2018,Mayo,Liberia,430,2,1,,3,"(4.697144,-74.140516)"
2018,Mayo,Luxemburgo,442,1,1,,2,"(10.886611,-74.776708)"
2018,Mayo,Luxemburgo,442,0,2,,2,"(3.541112,-76.384584)"
2018,Mayo,Luxemburgo,442,11,3,,14,"(4.697144,-74.140516)"
2018,Mayo,Luxemburgo,442,0,1,,1,"(6.171601,-75.427454)"
2018,Mayo,Malasia,458,1,1,,2,"(3.541112,-76.384584)"
2018,Mayo,Malasia,458,2,2,,4,"(4.697144,-74.140516)"
2018,Mayo,Malasia,458,2,0,,2,"(6.171601,-75.427454)"
2018,Mayo,Malí,466,1,0,,1,"(4.697144,-74.140516)"
2018,Mayo,Malta,470,19,15,,34,"(4.697144,-74.140516)"
2018,Mayo,Malta,470,3,3,,6,"(6.171601,-75.427454)"
2018,Mayo,Malta,470,1,0,,1,"(7.128456,-73.183637)"
2018,Mayo,Marruecos,504,25,9,,34,"(4.697144,-74.140516)"
2018,Mayo,Marruecos,504,1,2,,3,"(6.171601,-75.427454)"
2018,Mayo,Mauricio,480,2,1,,3,"(4.697144,-74.140516)"
2018,Mayo,Mauritania,478,0,1,,1,"(4.697144,-74.140516)"
2018,Mayo,Martinica/Departamento de Ultramar Francés,474,1,3,,4,"(4.697144,-74.140516)"
2018,Mayo,México,484,2,2,,4,"(10.433609,-73.247863)"
2018,Mayo,México,484,61,51,,112,"(10.445761,-75.516429)"
2018,Mayo,México,484,127,133,,260,"(10.886611,-74.776708)"
2018,Mayo,México,484,4,6,,10,"(12.586067,-81.702563)"
2018,Mayo,México,484,429,383,,812,"(3.541112,-76.384584)"
2018,Mayo,México,484,15667,13972,,29640,"(4.697144,-74.140516)"
2018,Mayo,México,484,168,134,,302,"(4.815061,-75.736532)"
2018,Mayo,México,484,2341,1925,,4266,"(6.171601,-75.427454)"
2018,Mayo,México,484,85,58,,143,"(7.128456,-73.183637)"
2018,Mayo,República de Moldavia,498,1,0,,1,"(4.697144,-74.140516)"
2018,Mayo,Mónaco,492,2,1,,3,"(4.697144,-74.140516)"
2018,Mayo,Mongolia,496,0,1,,1,"(6.171601,-75.427454)"
2018,Mayo,Mozambique,508,1,0,,1,"(3.541112,-76.384584)"
2018,Mayo,Mozambique,508,2,0,,2,"(4.697144,-74.140516)"
2018,Mayo,Myanmar,104,1,0,,1,"(4.697144,-74.140516)"
2018,Mayo,Nepal,524,1,0,,1,"(4.697144,-74.140516)"
2018,Mayo,Nicaragua,558,3,3,,6,"(10.445761,-75.516429)"
2018,Mayo,Nicaragua,558,2,4,,6,"(10.886611,-74.776708)"
2018,Mayo,Nicaragua,558,1,3,,4,"(12.5744111,-81.703935)"
2018,Mayo,Nicaragua,558,3,22,,25,"(3.541112,-76.384584)"
2018,Mayo,Nicaragua,558,25,57,,82,"(4.697144,-74.140516)"
2018,Mayo,Nicaragua,558,2,6,,8,"(4.815061,-75.736532)"
2018,Mayo,Nicaragua,558,16,44,,60,"(6.171601,-75.427454)"
2018,Mayo,Nigeria,566,0,2,,2,"(10.445761,-75.516429)"
2018,Mayo,Nigeria,566,0,4,,4,"(4.697144,-74.140516)"
2018,Mayo,Noruega,578,3,1,,4,"(10.445761,-75.516429)"
2018,Mayo,Noruega,578,3,0,,3,"(10.886611,-74.776708)"
2018,Mayo,Noruega,578,5,0,,5,"(3.541112,-76.384584)"
2018,Mayo,Noruega,578,15,9,,24,"(4.697144,-74.140516)"
2018,Mayo,Noruega,578,0,1,,1,"(4.815061,-75.736532)"
2018,Mayo,Noruega,578,3,1,,4,"(6.171601,-75.427454)"
2018,Mayo,Nueva Caledonia/Territorio francés,540,1,0,,1,"(4.697144,-74.140516)"
2018,Mayo,Nueva Zelanda,554,0,2,,2,"(3.541112,-76.384584)"
2018,Mayo,Nueva Zelanda,554,39,24,,63,"(4.697144,-74.140516)"
2018,Mayo,Nueva Zelanda,554,0,1,,1,"(6.171601,-75.427454)"
2018,Mayo,Omán,512,3,7,,10,"(4.697144,-74.140516)"
2018,Mayo,Pakistán,586,0,1,,1,"(4.697144,-74.140516)"
2018,Mayo,Panamá,591,13,148,,161,"(10.408582,-75.538003)"
2018,Mayo,Panamá,591,1180,935,,2115,"(10.445761,-75.516429)"
2018,Mayo,Panamá,591,853,784,,1637,"(10.886611,-74.776708)"
2018,Mayo,Panamá,591,1,0,,1,"(10.971302,-74.765397)"
2018,Mayo,Panamá,591,1,1,,2,"(11.117806,-74.232622)"
2018,Mayo,Panamá,591,0,2,,2,"(11.247723,-74.213989)"
2018,Mayo,Panamá,591,0,26,,26,"(12.165168,-71.983761)"
2018,Mayo,Panamá,591,53,53,,106,"(12.586067,-81.702563)"
2018,Mayo,Panamá,591,2,2,,4,"(13.3387613,-81.372937)"
2018,Mayo,Panamá,591,2136,1808,,3944,"(3.541112,-76.384584)"
2018,Mayo,Panamá,591,232,155,,387,"(4.452882,-75.766298)"
2018,Mayo,Panamá,591,7316,8451,,15768,"(4.697144,-74.140516)"
2018,Mayo,Panamá,591,388,284,,672,"(4.815061,-75.736532)"
2018,Mayo,Panamá,591,0,2,,2,"(6.17134,-75.427194)"
2018,Mayo,Panamá,591,3180,2801,,5981,"(6.171601,-75.427454)"
2018,Mayo,Panamá,591,0,3,,3,"(6.228046,-77.404104)"
2018,Mayo,Panamá,591,6,18,,24,"(7.102626,-77.762647)"
2018,Mayo,Panamá,591,217,175,,392,"(7.128456,-73.183637)"
2018,Mayo,Panamá,591,0,8,,8,"(8.066966,-76.735404)"
2018,Mayo,Panamá,591,23,53,,76,"(8.635765,-77.346578)"
2018,Mayo,Paraguay,600,2,4,,6,"(10.445761,-75.516429)"
2018,Mayo,Paraguay,600,6,5,,11,"(10.886611,-74.776708)"
2018,Mayo,Paraguay,600,0,1,,1,"(12.586067,-81.702563)"
2018,Mayo,Paraguay,600,28,29,,57,"(3.541112,-76.384584)"
2018,Mayo,Paraguay,600,75,180,,255,"(4.697144,-74.140516)"
2018,Mayo,Paraguay,600,16,31,,47,"(4.815061,-75.736532)"
2018,Mayo,Paraguay,600,26,69,,95,"(6.171601,-75.427454)"
2018,Mayo,Perú,604,3,10,,13,"(-0.193180,-74.784874)"
2018,Mayo,Perú,604,28,38,,66,"(-4.197703,-69.941278)"
2018,Mayo,Perú,604,88,124,,212,"(-4.223468,-69.945098)"
2018,Mayo,Perú,604,77,101,,178,"(0.814836,-77.662532)"
2018,Mayo,Perú,604,2,1,,3,"(1.813928,-78.763924)"
2018,Mayo,Perú,604,66,62,,128,"(10.445761,-75.516429)"
2018,Mayo,Perú,604,10,16,,26,"(10.886611,-74.776708)"
2018,Mayo,Perú,604,0,1,,1,"(12.586067,-81.702563)"
2018,Mayo,Perú,604,196,208,,404,"(3.541112,-76.384584)"
2018,Mayo,Perú,604,5171,6015,,11186,"(4.697144,-74.140516)"
2018,Mayo,Perú,604,7,8,,15,"(4.815061,-75.736532)"
2018,Mayo,Perú,604,530,520,,1050,"(6.171601,-75.427454)"
2018,Mayo,Perú,604,5,2,,7,"(7.128456,-73.183637)"
2018,Mayo,Palestina,99999,1,1,,2,"(6.171601,-75.427454)"
2018,Mayo,Polonia,616,0,1,,1,"(10.445761,-75.516429)"
2018,Mayo,Polonia,616,1,1,,2,"(3.541112,-76.384584)"
2018,Mayo,Polonia,616,16,16,,32,"(4.697144,-74.140516)"
2018,Mayo,Polonia,616,1,3,,4,"(6.171601,-75.427454)"
2018,Mayo,Portugal,620,1,0,,1,"(10.886611,-74.776708)"
2018,Mayo,Portugal,620,1,0,,1,"(13.3387613,-81.372937)"
2018,Mayo,Portugal,620,7,1,,8,"(3.541112,-76.384584)"
2018,Mayo,Portugal,620,212,237,,449,"(4.697144,-74.140516)"
2018,Mayo,Portugal,620,1,0,,1,"(4.815061,-75.736532)"
2018,Mayo,Portugal,620,16,9,,25,"(6.171601,-75.427454)"
2018,Mayo,Puerto Rico/Territorio de Estados Unidos,630,6,2,,8,"(10.445761,-75.516429)"
2018,Mayo,Puerto Rico/Territorio de Estados Unidos,630,18,10,,28,"(10.886611,-74.776708)"
2018,Mayo,Puerto Rico/Territorio de Estados Unidos,630,0,1,,1,"(12.586067,-81.702563)"
2018,Mayo,Puerto Rico/Territorio de Estados Unidos,630,26,15,,41,"(3.541112,-76.384584)"
2018,Mayo,Puerto Rico/Territorio de Estados Unidos,630,420,399,,819,"(4.697144,-74.140516)"
2018,Mayo,Puerto Rico/Territorio de Estados Unidos,630,8,3,,11,"(4.815061,-75.736532)"
2018,Mayo,Puerto Rico/Territorio de Estados Unidos,630,37,43,,80,"(6.171601,-75.427454)"
2018,Mayo,Puerto Rico/Territorio de Estados Unidos,630,5,5,,10,"(7.128456,-73.183637)"
2018,Mayo,Qatar,634,0,1,,1,"(10.886611,-74.776708)"
2018,Mayo,Qatar,634,7,6,,13,"(4.697144,-74.140516)"
2018,Mayo,Qatar,634,2,1,,3,"(6.171601,-75.427454)"
2018,Mayo,Reino Unido de Gran Bretaña e Irlanda del Norte,826,1,5,,6,"(10.445761,-75.516429)"
2018,Mayo,Reino Unido de Gran Bretaña e Irlanda del Norte,826,5,1,,6,"(10.886611,-74.776708)"
2018,Mayo,Reino Unido de Gran Bretaña e Irlanda del Norte,826,22,15,,37,"(3.541112,-76.384584)"
2018,Mayo,Reino Unido de Gran Bretaña e Irlanda del Norte,826,1559,1321,,2880,"(4.697144,-74.140516)"
2018,Mayo,Reino Unido de Gran Bretaña e Irlanda del Norte,826,24,17,,41,"(6.171601,-75.427454)"
2018,Mayo,República CentroÁfricana,140,6,8,,14,"(4.697144,-74.140516)"
2018,Mayo,Federación de Rusia,643,5,4,,9,"(3.541112,-76.384584)"
2018,Mayo,Federación de Rusia,643,40,92,,132,"(4.697144,-74.140516)"
2018,Mayo,Federación de Rusia,643,4,11,,15,"(6.171601,-75.427454)"
2018,Mayo,República Dominicana,214,5,12,,17,"(10.445761,-75.516429)"
2018,Mayo,República Dominicana,214,26,23,,49,"(10.886611,-74.776708)"
2018,Mayo,República Dominicana,214,0,1,,1,"(12.586067,-81.702563)"
2018,Mayo,República Dominicana,214,77,58,,135,"(3.541112,-76.384584)"
2018,Mayo,República Dominicana,214,3763,3161,,6924,"(4.697144,-74.140516)"
2018,Mayo,República Dominicana,214,47,27,,74,"(4.815061,-75.736532)"
2018,Mayo,República Dominicana,214,218,239,,457,"(6.171601,-75.427454)"
2018,Mayo,República Dominicana,214,7,6,,13,"(7.128456,-73.183637)"
2018,Mayo,Reunión,638,1,1,,2,"(4.697144,-74.140516)"
2018,Mayo,República Democrática Popular de Corea,408,1,0,,1,"(4.697144,-74.140516)"
2018,Mayo,Rumania,642,2,2,,4,"(10.886611,-74.776708)"
2018,Mayo,Rumania,642,4,1,,5,"(3.541112,-76.384584)"
2018,Mayo,Rumania,642,6,4,,10,"(4.697144,-74.140516)"
2018,Mayo,Rumania,642,0,1,,1,"(6.171601,-75.427454)"
2018,Mayo,Rwanda,646,0,1,,1,"(4.697144,-74.140516)"
2018,Mayo,San  Vicente y las Granadinas,670,0,1,,1,"(10.886611,-74.776708)"
2018,Mayo,San  Vicente y las Granadinas,670,0,1,,1,"(4.697144,-74.140516)"
2018,Mayo,Santa Lucia,662,1,1,,2,"(4.697144,-74.140516)"
2018,Mayo,Senegal,686,0,2,,2,"(4.697144,-74.140516)"
2018,Mayo,Serbia,688,1,2,,3,"(4.697144,-74.140516)"
2018,Mayo,Sierra Leona,694,1,2,,3,"(4.697144,-74.140516)"
2018,Mayo,Singapur,702,0,1,,1,"(10.886611,-74.776708)"
2018,Mayo,Singapur,702,16,21,,37,"(4.697144,-74.140516)"
2018,Mayo,Singapur,702,1,1,,2,"(6.171601,-75.427454)"
2018,Mayo,Sri Lanka,144,0,2,,2,"(4.697144,-74.140516)"
2018,Mayo,Sudáfrica,710,9,12,,21,"(4.697144,-74.140516)"
2018,Mayo,Suecia,752,2,1,,3,"(10.445761,-75.516429)"
2018,Mayo,Suecia,752,6,2,,8,"(10.886611,-74.776708)"
2018,Mayo,Suecia,752,18,14,,32,"(3.541112,-76.384584)"
2018,Mayo,Suecia,752,68,48,,116,"(4.697144,-74.140516)"
2018,Mayo,Suecia,752,0,2,,2,"(4.815061,-75.736532)"
2018,Mayo,Suecia,752,18,9,,27,"(6.171601,-75.427454)"
2018,Mayo,Suiza,756,6,5,,11,"(10.445761,-75.516429)"
2018,Mayo,Suiza,756,3,4,,7,"(10.886611,-74.776708)"
2018,Mayo,Suiza,756,45,21,,66,"(3.541112,-76.384584)"
2018,Mayo,Suiza,756,313,211,,524,"(4.697144,-74.140516)"
2018,Mayo,Suiza,756,38,18,,56,"(6.171601,-75.427454)"
2018,Mayo,Surinam,740,4,17,,21,"(4.697144,-74.140516)"
2018,Mayo,Taiwán,158,0,3,,3,"(4.697144,-74.140516)"
2018,Mayo,Taiwán,158,1,3,,4,"(6.171601,-75.427454)"
2018,Mayo,Tailandia,764,1,0,,1,"(10.445761,-75.516429)"
2018,Mayo,Tailandia,764,0,1,,1,"(3.541112,-76.384584)"
2018,Mayo,Tailandia,764,23,17,,40,"(4.697144,-74.140516)"
2018,Mayo,Tailandia,764,8,5,,13,"(6.171601,-75.427454)"
2018,Mayo,Trinidad y Tobago,780,2,1,,3,"(10.445761,-75.516429)"
2018,Mayo,Trinidad y Tobago,780,1,2,,3,"(10.886611,-74.776708)"
2018,Mayo,Trinidad y Tobago,780,6,8,,14,"(3.541112,-76.384584)"
2018,Mayo,Trinidad y Tobago,780,6,19,,25,"(4.697144,-74.140516)"
2018,Mayo,Trinidad y Tobago,780,4,5,,9,"(4.815061,-75.736532)"
2018,Mayo,Trinidad y Tobago,780,1,2,,3,"(6.171601,-75.427454)"
2018,Mayo,Trinidad y Tobago,780,3,0,,3,"(7.128456,-73.183637)"
2018,Mayo,Túnez,788,1,1,,2,"(4.697144,-74.140516)"
2018,Mayo,Turquía,792,0,1,,1,"(10.886611,-74.776708)"
2018,Mayo,Turquía,792,66,63,,129,"(3.541112,-76.384584)"
2018,Mayo,Turquía,792,1157,617,,1774,"(4.697144,-74.140516)"
2018,Mayo,Turquía,792,0,1,,1,"(4.815061,-75.736532)"
2018,Mayo,Turquía,792,17,13,,30,"(6.171601,-75.427454)"
2018,Mayo,Turkmenistán,795,0,1,,1,"(3.541112,-76.384584)"
2018,Mayo,Turkmenistán,795,5,2,,7,"(4.697144,-74.140516)"
2018,Mayo,Ucrania,804,1,1,,2,"(10.886611,-74.776708)"
2018,Mayo,Ucrania,804,3,6,,9,"(4.697144,-74.140516)"
2018,Mayo,Uruguay,858,1,8,,9,"(-4.197703,-69.941278)"
2018,Mayo,Uruguay,858,0,1,,1,"(0.814836,-77.662532)"
2018,Mayo,Uruguay,858,1,2,,3,"(10.886611,-74.776708)"
2018,Mayo,Uruguay,858,24,71,,95,"(3.541112,-76.384584)"
2018,Mayo,Uruguay,858,218,334,,552,"(4.697144,-74.140516)"
2018,Mayo,Uruguay,858,4,8,,12,"(4.815061,-75.736532)"
2018,Mayo,Uruguay,858,15,17,,32,"(6.171601,-75.427454)"
2018,Mayo,Venezuela,862,0,11,,11,"(10.408582,-75.538003)"
2018,Mayo,Venezuela,862,1,2,,3,"(10.433609,-73.247863)"
2018,Mayo,Venezuela,862,0,7,,7,"(10.445761,-75.516429)"
2018,Mayo,Venezuela,862,17,16,,33,"(10.886611,-74.776708)"
2018,Mayo,Venezuela,862,1615,1853,,3468,"(11.360009,-72.129330)"
2018,Mayo,Venezuela,862,0,6,,6,"(12.165168,-71.983761)"
2018,Mayo,Venezuela,862,386,288,,674,"(3.541112,-76.384584)"
2018,Mayo,Venezuela,862,2,2,,4,"(3.866713,-67.927521)"
2018,Mayo,Venezuela,862,1050,960,,2010,"(4.697144,-74.140516)"
2018,Mayo,Venezuela,862,1,14,,15,"(4.815061,-75.736532)"
2018,Mayo,Venezuela,862,695,514,,1209,"(6.171601,-75.427454)"
2018,Mayo,Venezuela,862,42,54,,96,"(6.185799,-67.483929)"
2018,Mayo,Venezuela,862,475,400,,875,"(7.088729,-70.740253)"
2018,Mayo,Venezuela,862,3,5,,8,"(7.128456,-73.183637)"
2018,Mayo,Venezuela,862,1046,1027,,2073,"(7.818934,-72.453226)"
2018,Mayo,Venezuela,862,87,127,,214,"(8.36068,-72.409396)"
2018,Mayo,Vietnam,704,7,6,,13,"(4.697144,-74.140516)"
2018,Mayo,Vietnam,704,2,1,,3,"(6.171601,-75.427454)"
2018,Mayo,Islas Vírgenes Británicas/Territorio Británico de Ultramar,92,1,9,,10,"(10.886611,-74.776708)"
2018,Mayo,Islas Vírgenes Británicas/Territorio Británico de Ultramar,92,1,5,,6,"(6.171601,-75.427454)"
2018,Mayo,Islas Vírgenes Estadounidenses/Territorio de Estados Unidos,850,2,20,,22,"(10.886611,-74.776708)"
2018,Mayo,Anguila/Territorio Británico de Ultramar,660,0,1,,1,"(3.541112,-76.384584)"
2018,Junio,Afganistán,4,1,0,,1,"(6.171601,-75.427454)"
2018,Junio,Albania,8,1,11,,12,"(4.697144,-74.140516)"
2018,Junio,Albania,8,2,0,,2,"(6.171601,-75.427454)"
2018,Junio,Alemania,276,1,1,,2,"(0.814836,-77.662532)"
2018,Junio,Alemania,276,7,2,,9,"(10.445761,-75.516429)"
2018,Junio,Alemania,276,10,11,,21,"(10.886611,-74.776708)"
2018,Junio,Alemania,276,1,0,,1,"(12.586067,-81.702563)"
2018,Junio,Alemania,276,89,52,,141,"(3.541112,-76.384584)"
2018,Junio,Alemania,276,1724,1808,,3532,"(4.697144,-74.140516)"
2018,Junio,Alemania,276,1,3,,4,"(4.815061,-75.736532)"
2018,Junio,Alemania,276,110,103,,213,"(6.171601,-75.427454)"
2018,Junio,Andorra,20,0,1,,1,"(10.408582,-75.538003)"
2018,Junio,Angola,24,0,1,,1,"(3.541112,-76.384584)"
2018,Junio,Angola,24,2,1,,3,"(4.697144,-74.140516)"
2018,Junio,Antigua y Barbuda,28,1,0,,1,"(3.541112,-76.384584)"
2018,Junio,Antigua y Barbuda,28,2,1,,3,"(4.697144,-74.140516)"
2018,Junio,Países Bajos,528,257,169,,426,"(10.445761,-75.516429)"
2018,Junio,Países Bajos,528,20,9,,29,"(10.886611,-74.776708)"
2018,Junio,Países Bajos,528,83,54,,137,"(3.541112,-76.384584)"
2018,Junio,Países Bajos,528,1375,1222,,2597,"(4.697144,-74.140516)"
2018,Junio,Países Bajos,528,12,5,,17,"(4.815061,-75.736532)"
2018,Junio,Países Bajos,528,118,78,,196,"(6.171601,-75.427454)"
2018,Junio,Arabia Saudita,682,0,1,,1,"(3.541112,-76.384584)"
2018,Junio,Arabia Saudita,682,4,29,,33,"(4.697144,-74.140516)"
2018,Junio,Arabia Saudita,682,0,2,,2,"(6.171601,-75.427454)"
2018,Junio,Argelia,12,6,9,,15,"(4.697144,-74.140516)"
2018,Junio,Argentina,32,6,15,,21,"(0.814836,-77.662532)"
2018,Junio,Argentina,32,56,42,,98,"(10.445761,-75.516429)"
2018,Junio,Argentina,32,41,28,,69,"(10.886611,-74.776708)"
2018,Junio,Argentina,32,1,0,,1,"(12.586067,-81.702563)"
2018,Junio,Argentina,32,86,95,,181,"(3.541112,-76.384584)"
2018,Junio,Argentina,32,2434,2251,,4685,"(4.697144,-74.140516)"
2018,Junio,Argentina,32,24,35,,59,"(4.815061,-75.736532)"
2018,Junio,Argentina,32,194,151,,345,"(6.171601,-75.427454)"
2018,Junio,Argentina,32,1,3,,4,"(7.128456,-73.183637)"
2018,Junio,República de Armenia,51,0,1,,1,"(4.697144,-74.140516)"
2018,Junio,Aruba,533,2716,1895,,4611,"(10.408582,-75.538003)"
2018,Junio,Aruba,533,1,2,,3,"(10.445761,-75.516429)"
2018,Junio,Aruba,533,7,18,,25,"(10.886611,-74.776708)"
2018,Junio,Aruba,533,2,5,,7,"(11.117806,-74.232622)"
2018,Junio,Aruba,533,0,1,,1,"(11.247723,-74.213989)"
2018,Junio,Aruba,533,1,6,,7,"(12.165168,-71.983761)"
2018,Junio,Aruba,533,21,16,,37,"(3.541112,-76.384584)"
2018,Junio,Aruba,533,3073,2385,,5459,"(4.697144,-74.140516)"
2018,Junio,Aruba,533,2,2,,4,"(4.815061,-75.736532)"
2018,Junio,Aruba,533,129,110,,239,"(6.171601,-75.427454)"
2018,Junio,Aruba,533,10,24,,34,"(7.128456,-73.183637)"
2018,Junio,Australia,36,2,3,,5,"(10.445761,-75.516429)"
2018,Junio,Australia,36,1,3,,4,"(10.886611,-74.776708)"
2018,Junio,Australia,36,6,6,,12,"(3.541112,-76.384584)"
2018,Junio,Australia,36,334,265,,599,"(4.697144,-74.140516)"
2018,Junio,Australia,36,1,1,,2,"(4.815061,-75.736532)"
2018,Junio,Australia,36,34,29,,63,"(6.171601,-75.427454)"
2018,Junio,Australia,36,1,0,,1,"(7.128456,-73.183637)"
2018,Junio,Austria,40,0,1,,1,"(10.445761,-75.516429)"
2018,Junio,Austria,40,4,1,,5,"(10.886611,-74.776708)"
2018,Junio,Austria,40,6,5,,11,"(3.541112,-76.384584)"
2018,Junio,Austria,40,37,43,,80,"(4.697144,-74.140516)"
2018,Junio,Austria,40,9,8,,17,"(6.171601,-75.427454)"
2018,Junio,Azerbaiyán,31,4,5,,9,"(4.697144,-74.140516)"
2018,Junio,Bahamas,44,1,1,,2,"(10.445761,-75.516429)"
2018,Junio,Bahamas,44,1,1,,2,"(10.886611,-74.776708)"
2018,Junio,Bahamas,44,8,10,,18,"(3.541112,-76.384584)"
2018,Junio,Bahamas,44,11,14,,25,"(4.697144,-74.140516)"
2018,Junio,Bahamas,44,6,3,,9,"(4.815061,-75.736532)"
2018,Junio,Bahamas,44,28,24,,52,"(6.171601,-75.427454)"
2018,Junio,Bahréin,48,1,0,,1,"(3.541112,-76.384584)"
2018,Junio,Bahréin,48,9,4,,13,"(4.452882,-75.766298)"
2018,Junio,Bahréin,48,1,2,,3,"(4.697144,-74.140516)"
2018,Junio,Bahréin,48,1,0,,1,"(4.815061,-75.736532)"
2018,Junio,Bahréin,48,1,1,,2,"(6.171601,-75.427454)"
2018,Junio,Barbados,52,2,0,,2,"(10.445761,-75.516429)"
2018,Junio,Barbados,52,1,1,,2,"(3.541112,-76.384584)"
2018,Junio,Barbados,52,1,9,,10,"(4.697144,-74.140516)"
2018,Junio,República de Belarús,112,0,1,,1,"(4.697144,-74.140516)"
2018,Junio,Bélgica,56,1,3,,4,"(10.445761,-75.516429)"
2018,Junio,Bélgica,56,4,1,,5,"(10.886611,-74.776708)"
2018,Junio,Bélgica,56,25,19,,44,"(3.541112,-76.384584)"
2018,Junio,Bélgica,56,131,115,,246,"(4.697144,-74.140516)"
2018,Junio,Bélgica,56,26,16,,42,"(6.171601,-75.427454)"
2018,Junio,Bélgica,56,2,1,,3,"(7.128456,-73.183637)"
2018,Junio,Belice,84,1,0,,1,"(10.445761,-75.516429)"
2018,Junio,Belice,84,2,2,,4,"(3.541112,-76.384584)"
2018,Junio,Belice,84,16,16,,32,"(4.697144,-74.140516)"
2018,Junio,Belice,84,1,0,,1,"(4.815061,-75.736532)"
2018,Junio,Belice,84,5,2,,7,"(6.171601,-75.427454)"
2018,Junio,Benín,204,1,0,,1,"(6.171601,-75.427454)"
2018,Junio,Bermudas/Territorio Británico de Ultramar,60,1,0,,1,"(3.541112,-76.384584)"
2018,Junio,Bermudas/Territorio Británico de Ultramar,60,0,1,,1,"(6.171601,-75.427454)"
2018,Junio,Bolivia,68,2,0,,2,"(0.25129,-76.875963)"
2018,Junio,Bolivia,68,3,8,,11,"(0.814836,-77.662532)"
2018,Junio,Bolivia,68,6,4,,10,"(10.445761,-75.516429)"
2018,Junio,Bolivia,68,4,2,,6,"(10.886611,-74.776708)"
2018,Junio,Bolivia,68,13,41,,54,"(3.541112,-76.384584)"
2018,Junio,Bolivia,68,331,511,,842,"(4.697144,-74.140516)"
2018,Junio,Bolivia,68,1,4,,5,"(4.815061,-75.736532)"
2018,Junio,Bolivia,68,29,63,,92,"(6.171601,-75.427454)"
2018,Junio,Bosnia y Herzegovina,70,0,1,,1,"(4.697144,-74.140516)"
2018,Junio,Brasil,76,149,224,,373,"(-4.197703,-69.941278)"
2018,Junio,Brasil,76,20,33,,53,"(-4.223468,-69.945098)"
2018,Junio,Brasil,76,1,4,,5,"(0.814836,-77.662532)"
2018,Junio,Brasil,76,15,8,,23,"(10.445761,-75.516429)"
2018,Junio,Brasil,76,8,11,,19,"(10.886611,-74.776708)"
2018,Junio,Brasil,76,117,114,,231,"(3.541112,-76.384584)"
2018,Junio,Brasil,76,0,2,,2,"(3.866713,-67.927521)"
2018,Junio,Brasil,76,4444,5002,,9447,"(4.697144,-74.140516)"
2018,Junio,Brasil,76,19,23,,42,"(4.815061,-75.736532)"
2018,Junio,Brasil,76,219,234,,453,"(6.171601,-75.427454)"
2018,Junio,Brasil,76,3,3,,6,"(7.128456,-73.183637)"
2018,Junio,Bulgaria,100,5,12,,17,"(4.697144,-74.140516)"
2018,Junio,Bulgaria,100,1,0,,1,"(6.171601,-75.427454)"
2018,Junio,Islas Caimán/Territorio Británico de Ultramar,136,1,0,,1,"(10.445761,-75.516429)"
2018,Junio,Islas Caimán/Territorio Británico de Ultramar,136,2,0,,2,"(12.586067,-81.702563)"
2018,Junio,Islas Caimán/Territorio Británico de Ultramar,136,0,1,,1,"(3.541112,-76.384584)"
2018,Junio,Islas Caimán/Territorio Británico de Ultramar,136,3,1,,4,"(4.697144,-74.140516)"
2018,Junio,Islas Caimán/Territorio Británico de Ultramar,136,1,1,,2,"(6.171601,-75.427454)"
2018,Junio,Canadá,124,52,28,,80,"(10.445761,-75.516429)"
2018,Junio,Canadá,124,69,45,,114,"(10.886611,-74.776708)"
2018,Junio,Canadá,124,150,74,,224,"(3.541112,-76.384584)"
2018,Junio,Canadá,124,3138,2416,,5554,"(4.697144,-74.140516)"
2018,Junio,Canadá,124,31,13,,44,"(4.815061,-75.736532)"
2018,Junio,Canadá,124,462,327,,789,"(6.171601,-75.427454)"
2018,Junio,Canadá,124,28,16,,44,"(7.128456,-73.183637)"
2018,Junio,Chad,148,1,0,,1,"(3.541112,-76.384584)"
2018,Junio,España,724,0,1,,1,"(0.814836,-77.662532)"
2018,Junio,España,724,7,9,,16,"(10.445761,-75.516429)"
2018,Junio,España,724,38,26,,64,"(10.886611,-74.776708)"
2018,Junio,España,724,0,1,,1,"(12.586067,-81.702563)"
2018,Junio,España,724,4525,3047,,7572,"(3.541112,-76.384584)"
2018,Junio,España,724,17608,14581,,32189,"(4.697144,-74.140516)"
2018,Junio,España,724,15,10,,25,"(4.815061,-75.736532)"
2018,Junio,España,724,2813,2169,,4982,"(6.171601,-75.427454)"
2018,Junio,España,724,2,1,,3,"(7.128456,-73.183637)"
2018,Junio,Colombia,170,3,12,,15,"(10.445761,-75.516429)"
2018,Junio,Colombia,170,310,718,,1028,"(4.697144,-74.140516)"
2018,Junio,República Democrática del Congo,180,0,1,,1,"(4.697144,-74.140516)"
2018,Junio,República de Corea,410,21,17,,38,"(4.697144,-74.140516)"
2018,Junio,República de Corea,410,2,2,,4,"(6.171601,-75.427454)"
2018,Junio,Costa de Marfil,384,3,7,,10,"(4.697144,-74.140516)"
2018,Junio,Costa de Marfil,384,1,2,,3,"(6.171601,-75.427454)"
2018,Junio,Costa Rica,188,0,2,,2,"(10.408582,-75.538003)"
2018,Junio,Costa Rica,188,10,10,,20,"(10.445761,-75.516429)"
2018,Junio,Costa Rica,188,26,23,,49,"(10.886611,-74.776708)"
2018,Junio,Costa Rica,188,3,31,,34,"(12.5744111,-81.703935)"
2018,Junio,Costa Rica,188,1,2,,3,"(12.586067,-81.702563)"
2018,Junio,Costa Rica,188,32,18,,50,"(3.541112,-76.384584)"
2018,Junio,Costa Rica,188,1258,1432,,2690,"(4.697144,-74.140516)"
2018,Junio,Costa Rica,188,8,5,,13,"(4.815061,-75.736532)"
2018,Junio,Costa Rica,188,116,113,,229,"(6.171601,-75.427454)"
2018,Junio,Costa Rica,188,4,2,,6,"(7.128456,-73.183637)"
2018,Junio,Croacia,191,0,1,,1,"(10.445761,-75.516429)"
2018,Junio,Croacia,191,0,1,,1,"(3.541112,-76.384584)"
2018,Junio,Croacia,191,9,4,,13,"(4.697144,-74.140516)"
2018,Junio,Croacia,191,4,1,,5,"(6.171601,-75.427454)"
2018,Junio,Cuba,192,14,8,,22,"(10.445761,-75.516429)"
2018,Junio,Cuba,192,26,23,,49,"(10.886611,-74.776708)"
2018,Junio,Cuba,192,1,1,,2,"(12.586067,-81.702563)"
2018,Junio,Cuba,192,24,35,,59,"(3.541112,-76.384584)"
2018,Junio,Cuba,192,1991,1557,,3548,"(4.697144,-74.140516)"
2018,Junio,Cuba,192,15,10,,25,"(4.815061,-75.736532)"
2018,Junio,Cuba,192,160,99,,259,"(6.171601,-75.427454)"
2018,Junio,Cuba,192,14,14,,28,"(7.128456,-73.183637)"
2018,Junio,Curazao,99999,0,1,,1,"(10.886611,-74.776708)"
2018,Junio,Curazao,99999,2,2,,4,"(3.541112,-76.384584)"
2018,Junio,Curazao,99999,734,562,,1296,"(4.697144,-74.140516)"
2018,Junio,Curazao,99999,1,3,,4,"(4.815061,-75.736532)"
2018,Junio,Curazao,99999,4,2,,6,"(6.171601,-75.427454)"
2018,Junio,Curazao,99999,1,5,,6,"(7.128456,-73.183637)"
2018,Junio,República Checa,203,17,11,,28,"(4.697144,-74.140516)"
2018,Junio,República Checa,203,3,5,,8,"(6.171601,-75.427454)"
2018,Junio,República Checa,203,1,1,,2,"(7.128456,-73.183637)"
2018,Junio,Chile,152,99,104,,203,"(0.814836,-77.662532)"
2018,Junio,Chile,152,28,29,,57,"(10.445761,-75.516429)"
2018,Junio,Chile,152,46,25,,71,"(10.886611,-74.776708)"
2018,Junio,Chile,152,2,0,,2,"(12.586067,-81.702563)"
2018,Junio,Chile,152,150,112,,262,"(3.541112,-76.384584)"
2018,Junio,Chile,152,5048,4152,,9200,"(4.697144,-74.140516)"
2018,Junio,Chile,152,52,32,,84,"(4.815061,-75.736532)"
2018,Junio,Chile,152,216,191,,407,"(6.171601,-75.427454)"
2018,Junio,Chile,152,0,7,,7,"(7.128456,-73.183637)"
2018,Junio,China,156,2,2,,4,"(10.445761,-75.516429)"
2018,Junio,China,156,5,6,,11,"(10.886611,-74.776708)"
2018,Junio,China,156,6,17,,23,"(3.541112,-76.384584)"
2018,Junio,China,156,181,288,,469,"(4.697144,-74.140516)"
2018,Junio,China,156,15,47,,62,"(6.171601,-75.427454)"
2018,Junio,Chipre,196,0,1,,1,"(4.697144,-74.140516)"
2018,Junio,Chipre,196,1,1,,2,"(6.171601,-75.427454)"
2018,Junio,Dinamarca,208,1,2,,3,"(10.886611,-74.776708)"
2018,Junio,Dinamarca,208,4,2,,6,"(3.541112,-76.384584)"
2018,Junio,Dinamarca,208,25,26,,51,"(4.697144,-74.140516)"
2018,Junio,Dinamarca,208,4,5,,9,"(6.171601,-75.427454)"
2018,Junio,Dominica,212,0,1,,1,"(10.445761,-75.516429)"
2018,Junio,Dominica,212,0,1,,1,"(3.541112,-76.384584)"
2018,Junio,Dominica,212,1,0,,1,"(4.697144,-74.140516)"
2018,Junio,Ecuador,218,2,0,,2,"(-0.193180,-74.784874)"
2018,Junio,Ecuador,218,641,886,,1527,"(0.25129,-76.875963)"
2018,Junio,Ecuador,218,102,141,,243,"(0.812436,-77.847006)"
2018,Junio,Ecuador,218,6383,6646,,13029,"(0.814836,-77.662532)"
2018,Junio,Ecuador,218,144,169,,313,"(1.813928,-78.763924)"
2018,Junio,Ecuador,218,9,6,,15,"(10.445761,-75.516429)"
2018,Junio,Ecuador,218,6,3,,9,"(10.886611,-74.776708)"
2018,Junio,Ecuador,218,365,372,,737,"(3.541112,-76.384584)"
2018,Junio,Ecuador,218,3464,4654,,8119,"(4.697144,-74.140516)"
2018,Junio,Ecuador,218,3,1,,4,"(4.815061,-75.736532)"
2018,Junio,Ecuador,218,27,31,,58,"(6.171601,-75.427454)"
2018,Junio,Ecuador,218,0,2,,2,"(6.228046,-77.404104)"
2018,Junio,Ecuador,218,1,1,,2,"(7.128456,-73.183637)"
2018,Junio,Egipto,818,24,6,,30,"(4.697144,-74.140516)"
2018,Junio,Egipto,818,5,4,,9,"(6.171601,-75.427454)"
2018,Junio,El Salvador,222,1,3,,4,"(10.445761,-75.516429)"
2018,Junio,El Salvador,222,5,5,,10,"(10.886611,-74.776708)"
2018,Junio,El Salvador,222,5,5,,10,"(3.541112,-76.384584)"
2018,Junio,El Salvador,222,964,1115,,2080,"(4.697144,-74.140516)"
2018,Junio,El Salvador,222,107,121,,228,"(6.171601,-75.427454)"
2018,Junio,Emiratos Árabes,784,2,2,,4,"(10.445761,-75.516429)"
2018,Junio,Emiratos Árabes,784,7,2,,9,"(3.541112,-76.384584)"
2018,Junio,Emiratos Árabes,784,92,110,,202,"(4.697144,-74.140516)"
2018,Junio,Emiratos Árabes,784,5,7,,12,"(6.171601,-75.427454)"
2018,Junio,Emiratos Árabes,784,0,1,,1,"(7.128456,-73.183637)"
2018,Junio,Eslovaquia,703,3,3,,6,"(4.697144,-74.140516)"
2018,Junio,Eslovaquia,703,2,1,,3,"(6.171601,-75.427454)"
2018,Junio,Eslovenia,705,1,3,,4,"(4.697144,-74.140516)"
2018,Junio,Estados Unidos de América,840,4924,3772,,8696,"(10.445761,-75.516429)"
2018,Junio,Estados Unidos de América,840,3710,2760,,6470,"(10.886611,-74.776708)"
2018,Junio,Estados Unidos de América,840,0,1,,1,"(11.117806,-74.232622)"
2018,Junio,Estados Unidos de América,840,1,0,,1,"(11.247723,-74.213989)"
2018,Junio,Estados Unidos de América,840,90,76,,166,"(12.586067,-81.702563)"
2018,Junio,Estados Unidos de América,840,6058,4254,,10312,"(3.541112,-76.384584)"
2018,Junio,Estados Unidos de América,840,885,670,,1555,"(4.452882,-75.766298)"
2018,Junio,Estados Unidos de América,840,46174,37666,,83842,"(4.697144,-74.140516)"
2018,Junio,Estados Unidos de América,840,1462,911,,2374,"(4.815061,-75.736532)"
2018,Junio,Estados Unidos de América,840,14241,10764,,25006,"(6.171601,-75.427454)"
2018,Junio,Estados Unidos de América,840,388,270,,658,"(7.128456,-73.183637)"
2018,Junio,Estonia,233,7,6,,13,"(3.541112,-76.384584)"
2018,Junio,Estonia,233,5,1,,6,"(4.697144,-74.140516)"
2018,Junio,Estonia,233,1,1,,2,"(6.171601,-75.427454)"
2018,Junio,Filipinas,608,2,0,,2,"(3.541112,-76.384584)"
2018,Junio,Filipinas,608,5,4,,9,"(4.697144,-74.140516)"
2018,Junio,Filipinas,608,1,1,,2,"(6.171601,-75.427454)"
2018,Junio,Finlandia,246,0,1,,1,"(10.886611,-74.776708)"
2018,Junio,Finlandia,246,1,2,,3,"(3.541112,-76.384584)"
2018,Junio,Finlandia,246,5,7,,12,"(4.697144,-74.140516)"
2018,Junio,Finlandia,246,6,3,,9,"(6.171601,-75.427454)"
2018,Junio,Francia,250,21,11,,32,"(10.445761,-75.516429)"
2018,Junio,Francia,250,21,11,,32,"(10.886611,-74.776708)"
2018,Junio,Francia,250,138,99,,237,"(3.541112,-76.384584)"
2018,Junio,Francia,250,2647,2216,,4863,"(4.697144,-74.140516)"
2018,Junio,Francia,250,7,2,,9,"(4.815061,-75.736532)"
2018,Junio,Francia,250,197,160,,357,"(6.171601,-75.427454)"
2018,Junio,Francia,250,1,2,,3,"(7.128456,-73.183637)"
2018,Junio,Gabón,266,0,2,,2,"(4.697144,-74.140516)"
2018,Junio,Ghana,288,0,2,,2,"(4.697144,-74.140516)"
2018,Junio,Grecia,300,6,6,,12,"(3.541112,-76.384584)"
2018,Junio,Grecia,300,75,60,,135,"(4.697144,-74.140516)"
2018,Junio,Grecia,300,6,5,,11,"(6.171601,-75.427454)"
2018,Junio,Groenlandia,304,0,2,,2,"(3.541112,-76.384584)"
2018,Junio,Groenlandia,304,1,3,,4,"(4.697144,-74.140516)"
2018,Junio,Guatemala,320,2,1,,3,"(10.408582,-75.538003)"
2018,Junio,Guatemala,320,4,8,,12,"(10.445761,-75.516429)"
2018,Junio,Guatemala,320,11,18,,29,"(10.886611,-74.776708)"
2018,Junio,Guatemala,320,17,34,,51,"(3.541112,-76.384584)"
2018,Junio,Guatemala,320,724,702,,1426,"(4.697144,-74.140516)"
2018,Junio,Guatemala,320,5,16,,21,"(4.815061,-75.736532)"
2018,Junio,Guatemala,320,84,98,,182,"(6.171601,-75.427454)"
2018,Junio,Guatemala,320,4,2,,6,"(7.128456,-73.183637)"
2018,Junio,Guyana,328,0,1,,1,"(10.445761,-75.516429)"
2018,Junio,Guyana,328,1,1,,2,"(10.886611,-74.776708)"
2018,Junio,Guyana,328,0,1,,1,"(3.541112,-76.384584)"
2018,Junio,Guyana,328,5,8,,13,"(4.697144,-74.140516)"
2018,Junio,Guinea,324,1,0,,1,"(4.697144,-74.140516)"
2018,Junio,Guinea Ecuatorial,226,1,1,,2,"(3.541112,-76.384584)"
2018,Junio,Guadalupe/Territorio Francés,312,1,0,,1,"(3.541112,-76.384584)"
2018,Junio,Guadalupe/Territorio Francés,312,2,2,,4,"(4.697144,-74.140516)"
2018,Junio,Guadalupe/Territorio Francés,312,1,0,,1,"(6.171601,-75.427454)"
2018,Junio,Haití,332,0,1,,1,"(10.445761,-75.516429)"
2018,Junio,Haití,332,2,0,,2,"(10.886611,-74.776708)"
2018,Junio,Haití,332,0,4,,4,"(4.697144,-74.140516)"
2018,Junio,Haití,332,1,0,,1,"(6.171601,-75.427454)"
2018,Junio,Honduras,340,2,4,,6,"(10.445761,-75.516429)"
2018,Junio,Honduras,340,5,10,,15,"(10.886611,-74.776708)"
2018,Junio,Honduras,340,0,5,,5,"(12.5744111,-81.703935)"
2018,Junio,Honduras,340,13,19,,32,"(3.541112,-76.384584)"
2018,Junio,Honduras,340,94,158,,252,"(4.697144,-74.140516)"
2018,Junio,Honduras,340,3,2,,5,"(4.815061,-75.736532)"
2018,Junio,Honduras,340,36,59,,95,"(6.171601,-75.427454)"
2018,Junio,Honduras,340,7,4,,11,"(7.128456,-73.183637)"
2018,Junio,Hong Kong,344,1,0,,1,"(10.445761,-75.516429)"
2018,Junio,Hong Kong,344,1,1,,2,"(3.541112,-76.384584)"
2018,Junio,Hong Kong,344,14,25,,39,"(4.697144,-74.140516)"
2018,Junio,Hong Kong,344,2,2,,4,"(6.171601,-75.427454)"
2018,Junio,Hungría,348,1,1,,2,"(3.541112,-76.384584)"
2018,Junio,Hungría,348,6,9,,15,"(4.697144,-74.140516)"
2018,Junio,Hungría,348,2,1,,3,"(6.171601,-75.427454)"
2018,Junio,India,356,0,1,,1,"(10.445761,-75.516429)"
2018,Junio,India,356,26,18,,44,"(4.697144,-74.140516)"
2018,Junio,India,356,0,2,,2,"(6.171601,-75.427454)"
2018,Junio,Indonesia,360,1,1,,2,"(3.541112,-76.384584)"
2018,Junio,Indonesia,360,3,1,,4,"(4.697144,-74.140516)"
2018,Junio,Indonesia,360,2,3,,5,"(6.171601,-75.427454)"
2018,Junio,Iraq,368,1,0,,1,"(3.541112,-76.384584)"
2018,Junio,Iraq,368,1,5,,6,"(4.697144,-74.140516)"
2018,Junio,Irán,364,1,2,,3,"(4.697144,-74.140516)"
2018,Junio,República de Irlanda,372,1,0,,1,"(10.886611,-74.776708)"
2018,Junio,República de Irlanda,372,2,1,,3,"(3.541112,-76.384584)"
2018,Junio,República de Irlanda,372,14,16,,30,"(4.697144,-74.140516)"
2018,Junio,República de Irlanda,372,2,2,,4,"(6.171601,-75.427454)"
2018,Junio,Islandia,352,4,3,,7,"(4.697144,-74.140516)"
2018,Junio,Islandia,352,1,1,,2,"(6.171601,-75.427454)"
2018,Junio,Israel,376,0,1,,1,"(10.886611,-74.776708)"
2018,Junio,Israel,376,12,4,,16,"(3.541112,-76.384584)"
2018,Junio,Israel,376,167,113,,280,"(4.697144,-74.140516)"
2018,Junio,Israel,376,8,5,,13,"(6.171601,-75.427454)"
2018,Junio,Italia,380,33,9,,42,"(10.445761,-75.516429)"
2018,Junio,Italia,380,4,6,,10,"(10.886611,-74.776708)"
2018,Junio,Italia,380,153,84,,237,"(3.541112,-76.384584)"
2018,Junio,Italia,380,659,543,,1202,"(4.697144,-74.140516)"
2018,Junio,Italia,380,3,5,,8,"(4.815061,-75.736532)"
2018,Junio,Italia,380,100,54,,154,"(6.171601,-75.427454)"
2018,Junio,Italia,380,1,1,,2,"(7.128456,-73.183637)"
2018,Junio,Jamaica,388,2,8,,10,"(10.445761,-75.516429)"
2018,Junio,Jamaica,388,2,6,,8,"(10.886611,-74.776708)"
2018,Junio,Jamaica,388,0,7,,7,"(11.247723,-74.213989)"
2018,Junio,Jamaica,388,1,0,,1,"(12.586067,-81.702563)"
2018,Junio,Jamaica,388,6,5,,11,"(3.541112,-76.384584)"
2018,Junio,Jamaica,388,34,52,,86,"(4.697144,-74.140516)"
2018,Junio,Jamaica,388,5,6,,11,"(4.815061,-75.736532)"
2018,Junio,Jamaica,388,16,11,,27,"(6.171601,-75.427454)"
2018,Junio,Jamaica,388,2,1,,3,"(7.128456,-73.183637)"
2018,Junio,Japón,392,1,1,,2,"(10.886611,-74.776708)"
2018,Junio,Japón,392,3,3,,6,"(3.541112,-76.384584)"
2018,Junio,Japón,392,154,126,,280,"(4.697144,-74.140516)"
2018,Junio,Japón,392,13,14,,27,"(6.171601,-75.427454)"
2018,Junio,Jordania,400,1,0,,1,"(10.886611,-74.776708)"
2018,Junio,Jordania,400,4,7,,11,"(4.697144,-74.140516)"
2018,Junio,Kazajistán,398,0,1,,1,"(4.697144,-74.140516)"
2018,Junio,Kazajistán,398,0,1,,1,"(6.171601,-75.427454)"
2018,Junio,Kenia,404,9,4,,13,"(4.697144,-74.140516)"
2018,Junio,Kuwait,414,6,2,,8,"(4.697144,-74.140516)"
2018,Junio,Letonia,428,1,1,,2,"(4.697144,-74.140516)"
2018,Junio,Letonia,428,0,1,,1,"(6.171601,-75.427454)"
2018,Junio,Lituania,440,0,3,,3,"(4.697144,-74.140516)"
2018,Junio,Líbano,422,27,16,,43,"(10.886611,-74.776708)"
2018,Junio,Líbano,422,0,2,,2,"(12.586067,-81.702563)"
2018,Junio,Líbano,422,0,1,,1,"(3.541112,-76.384584)"
2018,Junio,Líbano,422,26,26,,52,"(4.697144,-74.140516)"
2018,Junio,Líbano,422,4,0,,4,"(6.171601,-75.427454)"
2018,Junio,Líbano,422,0,1,,1,"(7.128456,-73.183637)"
2018,Junio,Luxemburgo,442,2,1,,3,"(3.541112,-76.384584)"
2018,Junio,Luxemburgo,442,13,7,,20,"(4.697144,-74.140516)"
2018,Junio,Luxemburgo,442,3,0,,3,"(6.171601,-75.427454)"
2018,Junio,Macedonia,807,1,0,,1,"(4.697144,-74.140516)"
2018,Junio,Malasia,458,1,2,,3,"(3.541112,-76.384584)"
2018,Junio,Malasia,458,3,0,,3,"(4.697144,-74.140516)"
2018,Junio,Malta,470,1,0,,1,"(10.886611,-74.776708)"
2018,Junio,Malta,470,0,4,,4,"(3.541112,-76.384584)"
2018,Junio,Malta,470,25,19,,44,"(4.697144,-74.140516)"
2018,Junio,Malta,470,8,4,,12,"(6.171601,-75.427454)"
2018,Junio,Marruecos,504,1,0,,1,"(3.541112,-76.384584)"
2018,Junio,Marruecos,504,14,13,,27,"(4.697144,-74.140516)"
2018,Junio,Marruecos,504,2,2,,4,"(6.171601,-75.427454)"
2018,Junio,Mauritania,478,0,1,,1,"(4.697144,-74.140516)"
2018,Junio,Martinica/Departamento de Ultramar Francés,474,0,2,,2,"(10.886611,-74.776708)"
2018,Junio,Martinica/Departamento de Ultramar Francés,474,1,1,,2,"(4.697144,-74.140516)"
2018,Junio,México,484,151,102,,253,"(10.445761,-75.516429)"
2018,Junio,México,484,287,215,,502,"(10.886611,-74.776708)"
2018,Junio,México,484,12,6,,18,"(12.586067,-81.702563)"
2018,Junio,México,484,833,632,,1465,"(3.541112,-76.384584)"
2018,Junio,México,484,20969,17478,,38449,"(4.697144,-74.140516)"
2018,Junio,México,484,275,205,,480,"(4.815061,-75.736532)"
2018,Junio,México,484,2910,2265,,5175,"(6.171601,-75.427454)"
2018,Junio,México,484,162,110,,272,"(7.128456,-73.183637)"
2018,Junio,Mónaco,492,1,3,,4,"(4.697144,-74.140516)"
2018,Junio,Mongolia,496,0,1,,1,"(4.697144,-74.140516)"
2018,Junio,Montenegro,499,0,1,,1,"(3.541112,-76.384584)"
2018,Junio,Mozambique,508,1,0,,1,"(4.697144,-74.140516)"
2018,Junio,Myanmar,104,0,2,,2,"(4.697144,-74.140516)"
2018,Junio,Nepal,524,0,3,,3,"(4.697144,-74.140516)"
2018,Junio,Nicaragua,558,0,1,,1,"(10.445761,-75.516429)"
2018,Junio,Nicaragua,558,3,2,,5,"(10.886611,-74.776708)"
2018,Junio,Nicaragua,558,1,9,,10,"(3.541112,-76.384584)"
2018,Junio,Nicaragua,558,20,39,,59,"(4.697144,-74.140516)"
2018,Junio,Nicaragua,558,1,0,,1,"(4.815061,-75.736532)"
2018,Junio,Nicaragua,558,4,23,,27,"(6.171601,-75.427454)"
2018,Junio,Nicaragua,558,0,1,,1,"(7.128456,-73.183637)"
2018,Junio,Nigeria,566,0,3,,3,"(4.697144,-74.140516)"
2018,Junio,Noruega,578,2,1,,3,"(10.445761,-75.516429)"
2018,Junio,Noruega,578,2,2,,4,"(10.886611,-74.776708)"
2018,Junio,Noruega,578,1,4,,5,"(3.541112,-76.384584)"
2018,Junio,Noruega,578,56,28,,84,"(4.697144,-74.140516)"
2018,Junio,Noruega,578,12,3,,15,"(6.171601,-75.427454)"
2018,Junio,Nueva Caledonia/Territorio francés,540,0,1,,1,"(4.697144,-74.140516)"
2018,Junio,Nueva Zelanda,554,45,30,,75,"(4.697144,-74.140516)"
2018,Junio,Nueva Zelanda,554,3,1,,4,"(6.171601,-75.427454)"
2018,Junio,Omán,512,2,5,,7,"(4.697144,-74.140516)"
2018,Junio,Panamá,591,269,281,,550,"(10.408582,-75.538003)"
2018,Junio,Panamá,591,1601,1315,,2917,"(10.445761,-75.516429)"
2018,Junio,Panamá,591,1043,928,,1971,"(10.886611,-74.776708)"
2018,Junio,Panamá,591,1,3,,4,"(10.971302,-74.765397)"
2018,Junio,Panamá,591,0,13,,13,"(12.165168,-71.983761)"
2018,Junio,Panamá,591,2,17,,19,"(12.5744111,-81.703935)"
2018,Junio,Panamá,591,69,69,,138,"(12.586067,-81.702563)"
2018,Junio,Panamá,591,2187,1844,,4031,"(3.541112,-76.384584)"
2018,Junio,Panamá,591,0,4,,4,"(3.893038,-77.067921)"
2018,Junio,Panamá,591,362,217,,579,"(4.452882,-75.766298)"
2018,Junio,Panamá,591,9013,9088,,18101,"(4.697144,-74.140516)"
2018,Junio,Panamá,591,347,259,,606,"(4.815061,-75.736532)"
2018,Junio,Panamá,591,1,2,,3,"(6.17134,-75.427194)"
2018,Junio,Panamá,591,3896,3335,,7231,"(6.171601,-75.427454)"
2018,Junio,Panamá,591,13,22,,35,"(7.102626,-77.762647)"
2018,Junio,Panamá,591,192,153,,345,"(7.128456,-73.183637)"
2018,Junio,Panamá,591,0,16,,16,"(8.066966,-76.735404)"
2018,Junio,Panamá,591,30,52,,82,"(8.635765,-77.346578)"
2018,Junio,Paraguay,600,0,3,,3,"(10.445761,-75.516429)"
2018,Junio,Paraguay,600,1,5,,6,"(10.886611,-74.776708)"
2018,Junio,Paraguay,600,0,1,,1,"(12.586067,-81.702563)"
2018,Junio,Paraguay,600,33,36,,69,"(3.541112,-76.384584)"
2018,Junio,Paraguay,600,87,161,,248,"(4.697144,-74.140516)"
2018,Junio,Paraguay,600,7,12,,19,"(4.815061,-75.736532)"
2018,Junio,Paraguay,600,30,26,,56,"(6.171601,-75.427454)"
2018,Junio,Perú,604,7,9,,16,"(-0.193180,-74.784874)"
2018,Junio,Perú,604,36,59,,95,"(-4.197703,-69.941278)"
2018,Junio,Perú,604,144,162,,306,"(-4.223468,-69.945098)"
2018,Junio,Perú,604,8,7,,15,"(0.25129,-76.875963)"
2018,Junio,Perú,604,105,101,,206,"(0.814836,-77.662532)"
2018,Junio,Perú,604,1,1,,2,"(1.813928,-78.763924)"
2018,Junio,Perú,604,154,108,,262,"(10.445761,-75.516429)"
2018,Junio,Perú,604,11,9,,20,"(10.886611,-74.776708)"
2018,Junio,Perú,604,1,0,,1,"(12.586067,-81.702563)"
2018,Junio,Perú,604,196,175,,371,"(3.541112,-76.384584)"
2018,Junio,Perú,604,6615,6769,,13385,"(4.697144,-74.140516)"
2018,Junio,Perú,604,12,8,,20,"(4.815061,-75.736532)"
2018,Junio,Perú,604,657,584,,1241,"(6.171601,-75.427454)"
2018,Junio,Perú,604,2,4,,6,"(7.128456,-73.183637)"
2018,Junio,Palestina,99999,1,0,,1,"(4.697144,-74.140516)"
2018,Junio,Palestina,99999,0,1,,1,"(6.171601,-75.427454)"
2018,Junio,Polonia,616,3,3,,6,"(3.541112,-76.384584)"
2018,Junio,Polonia,616,20,24,,44,"(4.697144,-74.140516)"
2018,Junio,Polonia,616,2,0,,2,"(4.815061,-75.736532)"
2018,Junio,Polonia,616,3,6,,9,"(6.171601,-75.427454)"
2018,Junio,Portugal,620,0,1,,1,"(10.445761,-75.516429)"
2018,Junio,Portugal,620,2,0,,2,"(10.886611,-74.776708)"
2018,Junio,Portugal,620,14,6,,20,"(3.541112,-76.384584)"
2018,Junio,Portugal,620,122,147,,269,"(4.697144,-74.140516)"
2018,Junio,Portugal,620,15,11,,26,"(6.171601,-75.427454)"
2018,Junio,Portugal,620,0,1,,1,"(7.128456,-73.183637)"
2018,Junio,Puerto Rico/Territorio de Estados Unidos,630,6,4,,10,"(10.445761,-75.516429)"
2018,Junio,Puerto Rico/Territorio de Estados Unidos,630,18,13,,31,"(10.886611,-74.776708)"
2018,Junio,Puerto Rico/Territorio de Estados Unidos,630,1,0,,1,"(12.586067,-81.702563)"
2018,Junio,Puerto Rico/Territorio de Estados Unidos,630,38,21,,59,"(3.541112,-76.384584)"
2018,Junio,Puerto Rico/Territorio de Estados Unidos,630,486,469,,955,"(4.697144,-74.140516)"
2018,Junio,Puerto Rico/Territorio de Estados Unidos,630,6,4,,10,"(4.815061,-75.736532)"
2018,Junio,Puerto Rico/Territorio de Estados Unidos,630,64,43,,107,"(6.171601,-75.427454)"
2018,Junio,Puerto Rico/Territorio de Estados Unidos,630,7,2,,9,"(7.128456,-73.183637)"
2018,Junio,Qatar,634,3,2,,5,"(4.697144,-74.140516)"
2018,Junio,Qatar,634,1,2,,3,"(6.171601,-75.427454)"
2018,Junio,Reino Unido de Gran Bretaña e Irlanda del Norte,826,2,0,,2,"(10.445761,-75.516429)"
2018,Junio,Reino Unido de Gran Bretaña e Irlanda del Norte,826,5,0,,5,"(10.886611,-74.776708)"
2018,Junio,Reino Unido de Gran Bretaña e Irlanda del Norte,826,46,25,,71,"(3.541112,-76.384584)"
2018,Junio,Reino Unido de Gran Bretaña e Irlanda del Norte,826,2201,1577,,3778,"(4.697144,-74.140516)"
2018,Junio,Reino Unido de Gran Bretaña e Irlanda del Norte,826,41,25,,66,"(6.171601,-75.427454)"
2018,Junio,Reino Unido de Gran Bretaña e Irlanda del Norte,826,2,0,,2,"(7.128456,-73.183637)"
2018,Junio,República CentroÁfricana,140,8,5,,13,"(4.697144,-74.140516)"
2018,Junio,Federación de Rusia,643,8,20,,28,"(10.445761,-75.516429)"
2018,Junio,Federación de Rusia,643,12,44,,56,"(10.886611,-74.776708)"
2018,Junio,Federación de Rusia,643,97,295,,392,"(3.541112,-76.384584)"
2018,Junio,Federación de Rusia,643,1479,3794,,5273,"(4.697144,-74.140516)"
2018,Junio,Federación de Rusia,643,1,4,,5,"(4.815061,-75.736532)"
2018,Junio,Federación de Rusia,643,148,415,,563,"(6.171601,-75.427454)"
2018,Junio,Federación de Rusia,643,2,11,,13,"(7.128456,-73.183637)"
2018,Junio,República Dominicana,214,0,3,,3,"(10.408582,-75.538003)"
2018,Junio,República Dominicana,214,8,17,,25,"(10.445761,-75.516429)"
2018,Junio,República Dominicana,214,35,34,,69,"(10.886611,-74.776708)"
2018,Junio,República Dominicana,214,71,64,,135,"(3.541112,-76.384584)"
2018,Junio,República Dominicana,214,5006,4265,,9271,"(4.697144,-74.140516)"
2018,Junio,República Dominicana,214,47,43,,90,"(4.815061,-75.736532)"
2018,Junio,República Dominicana,214,280,181,,461,"(6.171601,-75.427454)"
2018,Junio,República Dominicana,214,29,18,,47,"(7.128456,-73.183637)"
2018,Junio,Reunión,638,1,2,,3,"(4.697144,-74.140516)"
2018,Junio,Rumania,642,0,1,,1,"(3.541112,-76.384584)"
2018,Junio,Rumania,642,4,7,,11,"(4.697144,-74.140516)"
2018,Junio,Rumania,642,1,0,,1,"(4.815061,-75.736532)"
2018,Junio,Rumania,642,1,5,,6,"(6.171601,-75.427454)"
2018,Junio,San Cristóbal y Nevis,659,1,0,,1,"(4.697144,-74.140516)"
2018,Junio,San  Vicente y las Granadinas,670,1,0,,1,"(4.697144,-74.140516)"
2018,Junio,Serbia,688,0,1,,1,"(6.171601,-75.427454)"
2018,Junio,Singapur,702,0,2,,2,"(10.886611,-74.776708)"
2018,Junio,Singapur,702,0,1,,1,"(3.541112,-76.384584)"
2018,Junio,Singapur,702,27,27,,54,"(4.697144,-74.140516)"
2018,Junio,Singapur,702,1,1,,2,"(4.815061,-75.736532)"
2018,Junio,Singapur,702,3,1,,4,"(6.171601,-75.427454)"
2018,Junio,Sudáfrica,710,22,12,,34,"(4.697144,-74.140516)"
2018,Junio,Sudáfrica,710,2,3,,5,"(6.171601,-75.427454)"
2018,Junio,Suecia,752,6,9,,15,"(10.445761,-75.516429)"
2018,Junio,Suecia,752,10,6,,16,"(10.886611,-74.776708)"
2018,Junio,Suecia,752,21,22,,43,"(3.541112,-76.384584)"
2018,Junio,Suecia,752,105,77,,182,"(4.697144,-74.140516)"
2018,Junio,Suecia,752,1,2,,3,"(4.815061,-75.736532)"
2018,Junio,Suecia,752,16,11,,27,"(6.171601,-75.427454)"
2018,Junio,Suiza,756,6,4,,10,"(10.445761,-75.516429)"
2018,Junio,Suiza,756,3,0,,3,"(10.886611,-74.776708)"
2018,Junio,Suiza,756,60,27,,87,"(3.541112,-76.384584)"
2018,Junio,Suiza,756,270,198,,468,"(4.697144,-74.140516)"
2018,Junio,Suiza,756,1,1,,2,"(4.815061,-75.736532)"
2018,Junio,Suiza,756,52,29,,81,"(6.171601,-75.427454)"
2018,Junio,Suiza,756,3,1,,4,"(7.128456,-73.183637)"
2018,Junio,Surinam,740,6,10,,16,"(4.697144,-74.140516)"
2018,Junio,Surinam,740,2,2,,4,"(6.171601,-75.427454)"
2018,Junio,Taiwán,158,0,1,,1,"(3.541112,-76.384584)"
2018,Junio,Taiwán,158,3,6,,9,"(4.697144,-74.140516)"
2018,Junio,República de Tayikistán,762,0,1,,1,"(4.697144,-74.140516)"
2018,Junio,Tailandia,764,19,12,,31,"(4.697144,-74.140516)"
2018,Junio,Tailandia,764,2,2,,4,"(6.171601,-75.427454)"
2018,Junio,Tanzania,834,2,0,,2,"(4.697144,-74.140516)"
2018,Junio,Trinidad y Tobago,780,2,2,,4,"(10.445761,-75.516429)"
2018,Junio,Trinidad y Tobago,780,0,3,,3,"(10.886611,-74.776708)"
2018,Junio,Trinidad y Tobago,780,0,1,,1,"(12.586067,-81.702563)"
2018,Junio,Trinidad y Tobago,780,5,8,,13,"(3.541112,-76.384584)"
2018,Junio,Trinidad y Tobago,780,17,22,,39,"(4.697144,-74.140516)"
2018,Junio,Trinidad y Tobago,780,4,2,,6,"(4.815061,-75.736532)"
2018,Junio,Trinidad y Tobago,780,5,5,,10,"(6.171601,-75.427454)"
2018,Junio,Trinidad y Tobago,780,1,4,,5,"(7.128456,-73.183637)"
2018,Junio,Túnez,788,1,0,,1,"(3.541112,-76.384584)"
2018,Junio,Túnez,788,1,0,,1,"(6.171601,-75.427454)"
2018,Junio,Turquía,792,1,2,,3,"(10.886611,-74.776708)"
2018,Junio,Turquía,792,12,5,,17,"(3.541112,-76.384584)"
2018,Junio,Turquía,792,644,456,,1100,"(4.697144,-74.140516)"
2018,Junio,Turquía,792,12,12,,24,"(6.171601,-75.427454)"
2018,Junio,Turkmenistán,795,6,2,,8,"(4.697144,-74.140516)"
2018,Junio,Ucrania,804,0,1,,1,"(10.445761,-75.516429)"
2018,Junio,Ucrania,804,0,7,,7,"(4.697144,-74.140516)"
2018,Junio,Ucrania,804,0,1,,1,"(6.171601,-75.427454)"
2018,Junio,Uganda,800,0,1,,1,"(4.697144,-74.140516)"
2018,Junio,Uruguay,858,1,0,,1,"(0.814836,-77.662532)"
2018,Junio,Uruguay,858,2,1,,3,"(10.445761,-75.516429)"
2018,Junio,Uruguay,858,2,0,,2,"(10.886611,-74.776708)"
2018,Junio,Uruguay,858,5,18,,23,"(3.541112,-76.384584)"
2018,Junio,Uruguay,858,261,300,,561,"(4.697144,-74.140516)"
2018,Junio,Uruguay,858,6,8,,14,"(4.815061,-75.736532)"
2018,Junio,Uruguay,858,16,13,,29,"(6.171601,-75.427454)"
2018,Junio,Venezuela,862,0,16,,16,"(10.408582,-75.538003)"
2018,Junio,Venezuela,862,4,6,,10,"(10.445761,-75.516429)"
2018,Junio,Venezuela,862,15,13,,28,"(10.886611,-74.776708)"
2018,Junio,Venezuela,862,1995,2084,,4079,"(11.360009,-72.129330)"
2018,Junio,Venezuela,862,0,1,,1,"(12.586067,-81.702563)"
2018,Junio,Venezuela,862,612,408,,1020,"(3.541112,-76.384584)"
2018,Junio,Venezuela,862,5,6,,11,"(3.866713,-67.927521)"
2018,Junio,Venezuela,862,1256,1132,,2388,"(4.697144,-74.140516)"
2018,Junio,Venezuela,862,3,4,,7,"(4.815061,-75.736532)"
2018,Junio,Venezuela,862,1107,880,,1987,"(6.171601,-75.427454)"
2018,Junio,Venezuela,862,72,67,,139,"(6.185799,-67.483929)"
2018,Junio,Venezuela,862,725,648,,1373,"(7.088729,-70.740253)"
2018,Junio,Venezuela,862,8,12,,20,"(7.128456,-73.183637)"
2018,Junio,Venezuela,862,2150,2070,,4220,"(7.818934,-72.453226)"
2018,Junio,Venezuela,862,1,0,,1,"(7.927209,-72.507910)"
2018,Junio,Venezuela,862,185,178,,363,"(8.36068,-72.409396)"
2018,Junio,Vietnam,704,1,0,,1,"(3.541112,-76.384584)"
2018,Junio,Vietnam,704,6,6,,12,"(4.697144,-74.140516)"
2018,Junio,Islas Vírgenes Británicas/Territorio Británico de Ultramar,92,2,0,,2,"(6.171601,-75.427454)"
2018,Junio,Islas Vírgenes Estadounidenses/Territorio de Estados Unidos,850,0,1,,1,"(6.171601,-75.427454)"
2018,Julio,Afganistán,4,0,6,,6,"(4.697144,-74.140516)"
2018,Julio,Albania,8,0,5,,5,"(4.697144,-74.140516)"
2018,Julio,Alemania,276,3,3,,6,"(0.814836,-77.662532)"
2018,Julio,Alemania,276,12,11,,23,"(10.445761,-75.516429)"
2018,Julio,Alemania,276,14,6,,20,"(10.886611,-74.776708)"
2018,Julio,Alemania,276,1,0,,1,"(12.586067,-81.702563)"
2018,Julio,Alemania,276,70,42,,112,"(3.541112,-76.384584)"
2018,Julio,Alemania,276,1352,1128,,2480,"(4.697144,-74.140516)"
2018,Julio,Alemania,276,3,3,,6,"(4.815061,-75.736532)"
2018,Julio,Alemania,276,84,61,,145,"(6.171601,-75.427454)"
2018,Julio,Alemania,276,1,0,,1,"(7.128456,-73.183637)"
2018,Julio,Andorra,20,0,1,,1,"(3.541112,-76.384584)"
2018,Julio,Andorra,20,1,0,,1,"(6.171601,-75.427454)"
2018,Julio,Angola,24,1,6,,7,"(4.697144,-74.140516)"
2018,Julio,Angola,24,0,1,,1,"(6.171601,-75.427454)"
2018,Julio,Antigua y Barbuda,28,1,2,,3,"(4.697144,-74.140516)"
2018,Julio,Países Bajos,528,220,164,,384,"(10.445761,-75.516429)"
2018,Julio,Países Bajos,528,29,18,,47,"(10.886611,-74.776708)"
2018,Julio,Países Bajos,528,5,3,,8,"(11.117806,-74.232622)"
2018,Julio,Países Bajos,528,56,41,,97,"(3.541112,-76.384584)"
2018,Julio,Países Bajos,528,1159,1024,,2183,"(4.697144,-74.140516)"
2018,Julio,Países Bajos,528,9,4,,13,"(4.815061,-75.736532)"
2018,Julio,Países Bajos,528,122,79,,201,"(6.171601,-75.427454)"
2018,Julio,Países Bajos,528,2,3,,5,"(7.128456,-73.183637)"
2018,Julio,Arabia Saudita,682,0,1,,1,"(10.445761,-75.516429)"
2018,Julio,Arabia Saudita,682,0,1,,1,"(3.541112,-76.384584)"
2018,Julio,Arabia Saudita,682,2,33,,35,"(4.697144,-74.140516)"
2018,Julio,Arabia Saudita,682,0,4,,4,"(6.171601,-75.427454)"
2018,Julio,Argelia,12,2,4,,6,"(4.697144,-74.140516)"
2018,Julio,Argentina,32,0,3,,3,"(0.25129,-76.875963)"
2018,Julio,Argentina,32,18,42,,60,"(0.814836,-77.662532)"
2018,Julio,Argentina,32,24,25,,49,"(10.445761,-75.516429)"
2018,Julio,Argentina,32,27,12,,39,"(10.886611,-74.776708)"
2018,Julio,Argentina,32,2,0,,2,"(12.586067,-81.702563)"
2018,Julio,Argentina,32,103,85,,188,"(3.541112,-76.384584)"
2018,Julio,Argentina,32,2147,2218,,4365,"(4.697144,-74.140516)"
2018,Julio,Argentina,32,26,16,,42,"(4.815061,-75.736532)"
2018,Julio,Argentina,32,134,124,,258,"(6.171601,-75.427454)"
2018,Julio,Argentina,32,1,4,,5,"(7.128456,-73.183637)"
2018,Julio,República de Armenia,51,0,1,,1,"(4.697144,-74.140516)"
2018,Julio,Aruba,533,2249,1684,,3933,"(10.408582,-75.538003)"
2018,Julio,Aruba,533,12,8,,20,"(10.445761,-75.516429)"
2018,Julio,Aruba,533,30,18,,48,"(10.886611,-74.776708)"
2018,Julio,Aruba,533,0,7,,7,"(11.247723,-74.213989)"
2018,Julio,Aruba,533,1,20,,21,"(12.165168,-71.983761)"
2018,Julio,Aruba,533,64,47,,111,"(3.541112,-76.384584)"
2018,Julio,Aruba,533,2580,1929,,4509,"(4.697144,-74.140516)"
2018,Julio,Aruba,533,22,9,,31,"(4.815061,-75.736532)"
2018,Julio,Aruba,533,3,3,,6,"(6.17134,-75.427194)"
2018,Julio,Aruba,533,123,91,,214,"(6.171601,-75.427454)"
2018,Julio,Aruba,533,12,39,,51,"(7.128456,-73.183637)"
2018,Julio,Australia,36,0,1,,1,"(10.886611,-74.776708)"
2018,Julio,Australia,36,15,9,,24,"(3.541112,-76.384584)"
2018,Julio,Australia,36,392,298,,690,"(4.697144,-74.140516)"
2018,Julio,Australia,36,0,2,,2,"(4.815061,-75.736532)"
2018,Julio,Australia,36,57,43,,100,"(6.171601,-75.427454)"
2018,Julio,Austria,40,2,0,,2,"(10.445761,-75.516429)"
2018,Julio,Austria,40,1,1,,2,"(10.886611,-74.776708)"
2018,Julio,Austria,40,3,0,,3,"(3.541112,-76.384584)"
2018,Julio,Austria,40,52,37,,89,"(4.697144,-74.140516)"
2018,Julio,Austria,40,1,0,,1,"(4.815061,-75.736532)"
2018,Julio,Austria,40,14,5,,19,"(6.171601,-75.427454)"
2018,Julio,Azerbaiyán,31,3,3,,6,"(4.697144,-74.140516)"
2018,Julio,Bahamas,44,1,0,,1,"(10.408582,-75.538003)"
2018,Julio,Bahamas,44,2,1,,3,"(10.886611,-74.776708)"
2018,Julio,Bahamas,44,0,1,,1,"(12.586067,-81.702563)"
2018,Julio,Bahamas,44,9,3,,12,"(3.541112,-76.384584)"
2018,Julio,Bahamas,44,14,13,,27,"(4.697144,-74.140516)"
2018,Julio,Bahamas,44,4,2,,6,"(4.815061,-75.736532)"
2018,Julio,Bahamas,44,16,9,,25,"(6.171601,-75.427454)"
2018,Julio,Bahréin,48,1,0,,1,"(3.541112,-76.384584)"
2018,Julio,Bahréin,48,3,2,,5,"(4.452882,-75.766298)"
2018,Julio,Bahréin,48,5,3,,8,"(4.697144,-74.140516)"
2018,Julio,Bahréin,48,1,1,,2,"(6.171601,-75.427454)"
2018,Julio,Bangladesh,50,1,2,,3,"(4.697144,-74.140516)"
2018,Julio,Barbados,52,0,1,,1,"(10.886611,-74.776708)"
2018,Julio,Barbados,52,23,0,,23,"(12.586067,-81.702563)"
2018,Julio,Barbados,52,2,0,,2,"(3.541112,-76.384584)"
2018,Julio,Barbados,52,7,10,,17,"(4.697144,-74.140516)"
2018,Julio,Barbados,52,4,1,,5,"(6.171601,-75.427454)"
2018,Julio,República de Belarús,112,13,4,,17,"(4.697144,-74.140516)"
2018,Julio,Bélgica,56,0,1,,1,"(10.445761,-75.516429)"
2018,Julio,Bélgica,56,5,3,,8,"(10.886611,-74.776708)"
2018,Julio,Bélgica,56,23,15,,38,"(3.541112,-76.384584)"
2018,Julio,Bélgica,56,117,100,,217,"(4.697144,-74.140516)"
2018,Julio,Bélgica,56,2,0,,2,"(4.815061,-75.736532)"
2018,Julio,Bélgica,56,57,26,,83,"(6.171601,-75.427454)"
2018,Julio,Belice,84,0,1,,1,"(10.445761,-75.516429)"
2018,Julio,Belice,84,1,2,,3,"(3.541112,-76.384584)"
2018,Julio,Belice,84,15,16,,31,"(4.697144,-74.140516)"
2018,Julio,Belice,84,0,1,,1,"(4.815061,-75.736532)"
2018,Julio,Belice,84,10,11,,21,"(6.171601,-75.427454)"
2018,Julio,Bermudas/Territorio Británico de Ultramar,60,2,2,,4,"(4.697144,-74.140516)"
2018,Julio,Bermudas/Territorio Británico de Ultramar,60,1,0,,1,"(6.171601,-75.427454)"
2018,Julio,Bolivia,68,11,29,,40,"(0.814836,-77.662532)"
2018,Julio,Bolivia,68,4,5,,9,"(10.445761,-75.516429)"
2018,Julio,Bolivia,68,1,1,,2,"(10.886611,-74.776708)"
2018,Julio,Bolivia,68,22,30,,52,"(3.541112,-76.384584)"
2018,Julio,Bolivia,68,324,515,,839,"(4.697144,-74.140516)"
2018,Julio,Bolivia,68,3,8,,11,"(4.815061,-75.736532)"
2018,Julio,Bolivia,68,42,63,,105,"(6.171601,-75.427454)"
2018,Julio,Bolivia,68,2,1,,3,"(7.128456,-73.183637)"
2018,Julio,Bosnia y Herzegovina,70,1,1,,2,"(4.697144,-74.140516)"
2018,Julio,Brasil,76,111,213,,324,"(-4.197703,-69.941278)"
2018,Julio,Brasil,76,6,14,,20,"(-4.223468,-69.945098)"
2018,Julio,Brasil,76,5,5,,10,"(0.814836,-77.662532)"
2018,Julio,Brasil,76,9,13,,22,"(10.445761,-75.516429)"
2018,Julio,Brasil,76,9,15,,24,"(10.886611,-74.776708)"
2018,Julio,Brasil,76,0,1,,1,"(12.586067,-81.702563)"
2018,Julio,Brasil,76,86,88,,174,"(3.541112,-76.384584)"
2018,Julio,Brasil,76,3052,3759,,6811,"(4.697144,-74.140516)"
2018,Julio,Brasil,76,44,41,,85,"(4.815061,-75.736532)"
2018,Julio,Brasil,76,169,222,,391,"(6.171601,-75.427454)"
2018,Julio,Brasil,76,3,4,,7,"(7.128456,-73.183637)"
2018,Julio,Bulgaria,100,5,3,,8,"(4.697144,-74.140516)"
2018,Julio,Burkina Faso,854,0,1,,1,"(4.697144,-74.140516)"
2018,Julio,Bután,64,0,1,,1,"(4.697144,-74.140516)"
2018,Julio,Islas Caimán/Territorio Británico de Ultramar,136,0,1,,1,"(10.445761,-75.516429)"
2018,Julio,Islas Caimán/Territorio Británico de Ultramar,136,8,0,,8,"(12.586067,-81.702563)"
2018,Julio,Islas Caimán/Territorio Británico de Ultramar,136,0,1,,1,"(3.541112,-76.384584)"
2018,Julio,Islas Caimán/Territorio Británico de Ultramar,136,3,3,,6,"(4.697144,-74.140516)"
2018,Julio,Islas Caimán/Territorio Británico de Ultramar,136,2,2,,4,"(6.171601,-75.427454)"
2018,Julio,Camboya,116,1,0,,1,"(3.541112,-76.384584)"
2018,Julio,Camerún,120,2,0,,2,"(3.541112,-76.384584)"
2018,Julio,Camerún,120,0,1,,1,"(4.697144,-74.140516)"
2018,Julio,Canadá,124,64,59,,123,"(10.445761,-75.516429)"
2018,Julio,Canadá,124,51,41,,92,"(10.886611,-74.776708)"
2018,Julio,Canadá,124,1,1,,2,"(12.586067,-81.702563)"
2018,Julio,Canadá,124,197,137,,334,"(3.541112,-76.384584)"
2018,Julio,Canadá,124,1,1,,2,"(4.452882,-75.766298)"
2018,Julio,Canadá,124,2791,2062,,4853,"(4.697144,-74.140516)"
2018,Julio,Canadá,124,27,16,,43,"(4.815061,-75.736532)"
2018,Julio,Canadá,124,382,242,,624,"(6.171601,-75.427454)"
2018,Julio,Canadá,124,35,32,,67,"(7.128456,-73.183637)"
2018,Julio,España,724,15,16,,31,"(10.445761,-75.516429)"
2018,Julio,España,724,13,5,,18,"(10.886611,-74.776708)"
2018,Julio,España,724,3531,2216,,5747,"(3.541112,-76.384584)"
2018,Julio,España,724,14636,10746,,25382,"(4.697144,-74.140516)"
2018,Julio,España,724,13,10,,23,"(4.815061,-75.736532)"
2018,Julio,España,724,2431,1653,,4084,"(6.171601,-75.427454)"
2018,Julio,España,724,2,1,,3,"(7.128456,-73.183637)"
2018,Julio,Colombia,170,2,11,,13,"(10.445761,-75.516429)"
2018,Julio,Colombia,170,205,599,,804,"(4.697144,-74.140516)"
2018,Julio,República Del Congo,178,0,1,,1,"(4.697144,-74.140516)"
2018,Julio,República de Corea,410,29,20,,49,"(4.697144,-74.140516)"
2018,Julio,República de Corea,410,3,6,,9,"(6.171601,-75.427454)"
2018,Julio,Costa de Marfil,384,1,3,,4,"(4.697144,-74.140516)"
2018,Julio,Costa Rica,188,11,15,,26,"(10.445761,-75.516429)"
2018,Julio,Costa Rica,188,25,27,,52,"(10.886611,-74.776708)"
2018,Julio,Costa Rica,188,3,27,,30,"(12.5744111,-81.703935)"
2018,Julio,Costa Rica,188,8,7,,15,"(12.586067,-81.702563)"
2018,Julio,Costa Rica,188,60,43,,103,"(3.541112,-76.384584)"
2018,Julio,Costa Rica,188,0,1,,1,"(3.893038,-77.067921)"
2018,Julio,Costa Rica,188,1260,1366,,2626,"(4.697144,-74.140516)"
2018,Julio,Costa Rica,188,19,15,,34,"(4.815061,-75.736532)"
2018,Julio,Costa Rica,188,154,140,,294,"(6.171601,-75.427454)"
2018,Julio,Costa Rica,188,5,8,,13,"(7.128456,-73.183637)"
2018,Julio,Croacia,191,0,1,,1,"(10.886611,-74.776708)"
2018,Julio,Croacia,191,4,5,,9,"(4.697144,-74.140516)"
2018,Julio,Croacia,191,0,1,,1,"(6.171601,-75.427454)"
2018,Julio,Cuba,192,13,22,,35,"(10.445761,-75.516429)"
2018,Julio,Cuba,192,11,12,,23,"(10.886611,-74.776708)"
2018,Julio,Cuba,192,1,0,,1,"(12.586067,-81.702563)"
2018,Julio,Cuba,192,66,59,,125,"(3.541112,-76.384584)"
2018,Julio,Cuba,192,1635,1379,,3014,"(4.697144,-74.140516)"
2018,Julio,Cuba,192,31,18,,49,"(4.815061,-75.736532)"
2018,Julio,Cuba,192,94,68,,162,"(6.171601,-75.427454)"
2018,Julio,Cuba,192,1,5,,6,"(7.128456,-73.183637)"
2018,Julio,Curazao,99999,0,2,,2,"(10.445761,-75.516429)"
2018,Julio,Curazao,99999,3,1,,4,"(10.886611,-74.776708)"
2018,Julio,Curazao,99999,0,5,,5,"(11.247723,-74.213989)"
2018,Julio,Curazao,99999,9,6,,15,"(3.541112,-76.384584)"
2018,Julio,Curazao,99999,556,390,,947,"(4.697144,-74.140516)"
2018,Julio,Curazao,99999,3,3,,6,"(4.815061,-75.736532)"
2018,Julio,Curazao,99999,12,10,,22,"(6.171601,-75.427454)"
2018,Julio,Curazao,99999,2,1,,3,"(7.128456,-73.183637)"
2018,Julio,República Checa,203,1,1,,2,"(10.445761,-75.516429)"
2018,Julio,República Checa,203,0,1,,1,"(10.886611,-74.776708)"
2018,Julio,República Checa,203,6,3,,9,"(4.697144,-74.140516)"
2018,Julio,República Checa,203,2,0,,2,"(6.171601,-75.427454)"
2018,Julio,Chile,152,181,194,,375,"(0.814836,-77.662532)"
2018,Julio,Chile,152,1,0,,1,"(1.813928,-78.763924)"
2018,Julio,Chile,152,19,18,,37,"(10.445761,-75.516429)"
2018,Julio,Chile,152,23,16,,39,"(10.886611,-74.776708)"
2018,Julio,Chile,152,2,0,,2,"(12.586067,-81.702563)"
2018,Julio,Chile,152,171,120,,291,"(3.541112,-76.384584)"
2018,Julio,Chile,152,4243,3728,,7971,"(4.697144,-74.140516)"
2018,Julio,Chile,152,37,13,,50,"(4.815061,-75.736532)"
2018,Julio,Chile,152,175,118,,293,"(6.171601,-75.427454)"
2018,Julio,Chile,152,4,3,,7,"(7.128456,-73.183637)"
2018,Julio,China,156,5,4,,9,"(10.445761,-75.516429)"
2018,Julio,China,156,0,1,,1,"(10.886611,-74.776708)"
2018,Julio,China,156,12,13,,25,"(3.541112,-76.384584)"
2018,Julio,China,156,129,325,,454,"(4.697144,-74.140516)"
2018,Julio,China,156,20,70,,90,"(6.171601,-75.427454)"
2018,Julio,Chipre,196,2,1,,3,"(4.697144,-74.140516)"
2018,Julio,Chipre,196,2,0,,2,"(4.815061,-75.736532)"
2018,Julio,Dinamarca,208,1,4,,5,"(10.445761,-75.516429)"
2018,Julio,Dinamarca,208,3,1,,4,"(3.541112,-76.384584)"
2018,Julio,Dinamarca,208,64,35,,99,"(4.697144,-74.140516)"
2018,Julio,Dinamarca,208,8,5,,13,"(6.171601,-75.427454)"
2018,Julio,Ecuador,218,3,0,,3,"(-0.193180,-74.784874)"
2018,Julio,Ecuador,218,824,1151,,1975,"(0.25129,-76.875963)"
2018,Julio,Ecuador,218,139,165,,304,"(0.812436,-77.847006)"
2018,Julio,Ecuador,218,7770,7994,,15764,"(0.814836,-77.662532)"
2018,Julio,Ecuador,218,215,223,,438,"(1.813928,-78.763924)"
2018,Julio,Ecuador,218,5,6,,11,"(10.445761,-75.516429)"
2018,Julio,Ecuador,218,5,3,,8,"(10.886611,-74.776708)"
2018,Julio,Ecuador,218,1,3,,4,"(12.586067,-81.702563)"
2018,Julio,Ecuador,218,407,451,,858,"(3.541112,-76.384584)"
2018,Julio,Ecuador,218,3166,4635,,7801,"(4.697144,-74.140516)"
2018,Julio,Ecuador,218,7,3,,10,"(4.815061,-75.736532)"
2018,Julio,Ecuador,218,30,41,,71,"(6.171601,-75.427454)"
2018,Julio,Egipto,818,5,2,,7,"(3.541112,-76.384584)"
2018,Julio,Egipto,818,7,11,,18,"(4.697144,-74.140516)"
2018,Julio,Egipto,818,0,2,,2,"(6.171601,-75.427454)"
2018,Julio,El Salvador,222,1,0,,1,"(10.886611,-74.776708)"
2018,Julio,El Salvador,222,130,116,,246,"(3.541112,-76.384584)"
2018,Julio,El Salvador,222,768,937,,1705,"(4.697144,-74.140516)"
2018,Julio,El Salvador,222,3,1,,4,"(4.815061,-75.736532)"
2018,Julio,El Salvador,222,93,127,,220,"(6.171601,-75.427454)"
2018,Julio,Emiratos Árabes,784,5,2,,7,"(3.541112,-76.384584)"
2018,Julio,Emiratos Árabes,784,80,257,,337,"(4.697144,-74.140516)"
2018,Julio,Emiratos Árabes,784,0,1,,1,"(4.815061,-75.736532)"
2018,Julio,Emiratos Árabes,784,7,7,,14,"(6.171601,-75.427454)"
2018,Julio,Eritrea,232,1,0,,1,"(4.697144,-74.140516)"
2018,Julio,Eslovaquia,703,2,4,,6,"(4.697144,-74.140516)"
2018,Julio,Estados Unidos de América,840,0,5,,5,"(10.408582,-75.538003)"
2018,Julio,Estados Unidos de América,840,4794,3753,,8547,"(10.445761,-75.516429)"
2018,Julio,Estados Unidos de América,840,3365,2652,,6017,"(10.886611,-74.776708)"
2018,Julio,Estados Unidos de América,840,0,2,,2,"(11.247723,-74.213989)"
2018,Julio,Estados Unidos de América,840,53,41,,94,"(12.586067,-81.702563)"
2018,Julio,Estados Unidos de América,840,6904,4759,,11663,"(3.541112,-76.384584)"
2018,Julio,Estados Unidos de América,840,1030,737,,1767,"(4.452882,-75.766298)"
2018,Julio,Estados Unidos de América,840,38359,31872,,70235,"(4.697144,-74.140516)"
2018,Julio,Estados Unidos de América,840,1254,818,,2072,"(4.815061,-75.736532)"
2018,Julio,Estados Unidos de América,840,5,58,,63,"(5.465949,-74.657265)"
2018,Julio,Estados Unidos de América,840,0,5,,5,"(6.17134,-75.427194)"
2018,Julio,Estados Unidos de América,840,12151,9478,,21629,"(6.171601,-75.427454)"
2018,Julio,Estados Unidos de América,840,354,247,,601,"(7.128456,-73.183637)"
2018,Julio,Estonia,233,2,1,,3,"(4.697144,-74.140516)"
2018,Julio,Etiopia,231,0,2,,2,"(4.697144,-74.140516)"
2018,Julio,Filipinas,608,0,1,,1,"(3.541112,-76.384584)"
2018,Julio,Filipinas,608,3,3,,6,"(4.697144,-74.140516)"
2018,Julio,Filipinas,608,1,1,,2,"(6.171601,-75.427454)"
2018,Julio,Finlandia,246,4,2,,6,"(3.541112,-76.384584)"
2018,Julio,Finlandia,246,19,17,,36,"(4.697144,-74.140516)"
2018,Julio,Finlandia,246,1,0,,1,"(4.815061,-75.736532)"
2018,Julio,Finlandia,246,2,1,,3,"(6.171601,-75.427454)"
2018,Julio,Francia,250,13,4,,17,"(10.445761,-75.516429)"
2018,Julio,Francia,250,17,9,,26,"(10.886611,-74.776708)"
2018,Julio,Francia,250,103,62,,165,"(3.541112,-76.384584)"
2018,Julio,Francia,250,2130,1753,,3883,"(4.697144,-74.140516)"
2018,Julio,Francia,250,7,4,,11,"(4.815061,-75.736532)"
2018,Julio,Francia,250,146,114,,260,"(6.171601,-75.427454)"
2018,Julio,Francia,250,1,0,,1,"(7.128456,-73.183637)"
2018,Julio,Gabón,266,0,4,,4,"(4.697144,-74.140516)"
2018,Julio,Georgia,268,0,1,,1,"(4.697144,-74.140516)"
2018,Julio,Gibraltar/Territorio Británico de Ultramar,292,0,1,,1,"(4.697144,-74.140516)"
2018,Julio,Granada,308,0,1,,1,"(4.697144,-74.140516)"
2018,Julio,Grecia,300,1,1,,2,"(10.445761,-75.516429)"
2018,Julio,Grecia,300,4,2,,6,"(3.541112,-76.384584)"
2018,Julio,Grecia,300,42,31,,73,"(4.697144,-74.140516)"
2018,Julio,Grecia,300,7,5,,12,"(6.171601,-75.427454)"
2018,Julio,Groenlandia,304,0,1,,1,"(4.697144,-74.140516)"
2018,Julio,Guatemala,320,6,15,,21,"(10.445761,-75.516429)"
2018,Julio,Guatemala,320,12,13,,25,"(10.886611,-74.776708)"
2018,Julio,Guatemala,320,58,80,,138,"(3.541112,-76.384584)"
2018,Julio,Guatemala,320,586,738,,1324,"(4.697144,-74.140516)"
2018,Julio,Guatemala,320,13,17,,30,"(4.815061,-75.736532)"
2018,Julio,Guatemala,320,108,168,,276,"(6.171601,-75.427454)"
2018,Julio,Guatemala,320,1,5,,6,"(7.128456,-73.183637)"
2018,Julio,Guyana,328,3,3,,6,"(10.886611,-74.776708)"
2018,Julio,Guyana,328,2,0,,2,"(3.541112,-76.384584)"
2018,Julio,Guyana,328,2,2,,4,"(4.697144,-74.140516)"
2018,Julio,Guyana,328,0,1,,1,"(4.815061,-75.736532)"
2018,Julio,Guyana,328,1,0,,1,"(6.171601,-75.427454)"
2018,Julio,Guinea Ecuatorial,226,0,1,,1,"(4.697144,-74.140516)"
2018,Julio,Guadalupe/Territorio Francés,312,0,1,,1,"(10.445761,-75.516429)"
2018,Julio,Guadalupe/Territorio Francés,312,1,1,,2,"(3.541112,-76.384584)"
2018,Julio,Guadalupe/Territorio Francés,312,0,2,,2,"(4.697144,-74.140516)"
2018,Julio,Guadalupe/Territorio Francés,312,0,1,,1,"(6.171601,-75.427454)"
2018,Julio,Guayana Francesa/Departamento de Ultramar Francés,254,1,0,,1,"(10.886611,-74.776708)"
2018,Julio,Guayana Francesa/Departamento de Ultramar Francés,254,0,1,,1,"(7.128456,-73.183637)"
2018,Julio,Haití,332,0,1,,1,"(10.445761,-75.516429)"
2018,Julio,Haití,332,0,1,,1,"(10.886611,-74.776708)"
2018,Julio,Haití,332,2,2,,4,"(4.697144,-74.140516)"
2018,Julio,Haití,332,2,0,,2,"(6.171601,-75.427454)"
2018,Julio,Honduras,340,4,7,,11,"(10.445761,-75.516429)"
2018,Julio,Honduras,340,9,6,,15,"(10.886611,-74.776708)"
2018,Julio,Honduras,340,25,31,,56,"(3.541112,-76.384584)"
2018,Julio,Honduras,340,125,255,,380,"(4.697144,-74.140516)"
2018,Julio,Honduras,340,5,12,,17,"(4.815061,-75.736532)"
2018,Julio,Honduras,340,55,100,,155,"(6.171601,-75.427454)"
2018,Julio,Honduras,340,0,4,,4,"(7.128456,-73.183637)"
2018,Julio,Hong Kong,344,0,1,,1,"(10.445761,-75.516429)"
2018,Julio,Hong Kong,344,1,0,,1,"(3.541112,-76.384584)"
2018,Julio,Hong Kong,344,16,15,,31,"(4.697144,-74.140516)"
2018,Julio,Hong Kong,344,2,5,,7,"(6.171601,-75.427454)"
2018,Julio,Hungría,348,1,0,,1,"(3.541112,-76.384584)"
2018,Julio,Hungría,348,7,5,,12,"(4.697144,-74.140516)"
2018,Julio,Hungría,348,3,0,,3,"(6.171601,-75.427454)"
2018,Julio,India,356,0,4,,4,"(3.541112,-76.384584)"
2018,Julio,India,356,33,16,,49,"(4.697144,-74.140516)"
2018,Julio,India,356,1,1,,2,"(6.171601,-75.427454)"
2018,Julio,Indonesia,360,4,3,,7,"(4.697144,-74.140516)"
2018,Julio,Indonesia,360,1,1,,2,"(6.171601,-75.427454)"
2018,Julio,Iraq,368,0,1,,1,"(10.886611,-74.776708)"
2018,Julio,Iraq,368,0,8,,8,"(4.697144,-74.140516)"
2018,Julio,Irán,364,4,0,,4,"(4.697144,-74.140516)"
2018,Julio,República de Irlanda,372,2,1,,3,"(3.541112,-76.384584)"
2018,Julio,República de Irlanda,372,16,11,,27,"(4.697144,-74.140516)"
2018,Julio,República de Irlanda,372,2,2,,4,"(6.171601,-75.427454)"
2018,Julio,Islandia,352,0,1,,1,"(3.541112,-76.384584)"
2018,Julio,Islandia,352,6,2,,8,"(4.697144,-74.140516)"
2018,Julio,Israel,376,2,0,,2,"(10.445761,-75.516429)"
2018,Julio,Israel,376,20,12,,32,"(3.541112,-76.384584)"
2018,Julio,Israel,376,78,62,,140,"(4.697144,-74.140516)"
2018,Julio,Israel,376,0,1,,1,"(4.815061,-75.736532)"
2018,Julio,Israel,376,12,8,,20,"(6.171601,-75.427454)"
2018,Julio,Italia,380,16,13,,29,"(10.445761,-75.516429)"
2018,Julio,Italia,380,16,7,,23,"(10.886611,-74.776708)"
2018,Julio,Italia,380,1,1,,2,"(12.586067,-81.702563)"
2018,Julio,Italia,380,149,66,,215,"(3.541112,-76.384584)"
2018,Julio,Italia,380,700,505,,1205,"(4.697144,-74.140516)"
2018,Julio,Italia,380,2,2,,4,"(4.815061,-75.736532)"
2018,Julio,Italia,380,116,64,,180,"(6.171601,-75.427454)"
2018,Julio,Italia,380,1,1,,2,"(7.128456,-73.183637)"
2018,Julio,Jamaica,388,0,9,,9,"(10.445761,-75.516429)"
2018,Julio,Jamaica,388,1,1,,2,"(10.886611,-74.776708)"
2018,Julio,Jamaica,388,6,1,,7,"(12.586067,-81.702563)"
2018,Julio,Jamaica,388,10,4,,14,"(3.541112,-76.384584)"
2018,Julio,Jamaica,388,39,51,,90,"(4.697144,-74.140516)"
2018,Julio,Jamaica,388,3,3,,6,"(4.815061,-75.736532)"
2018,Julio,Jamaica,388,7,13,,20,"(6.171601,-75.427454)"
2018,Julio,Japón,392,2,4,,6,"(3.541112,-76.384584)"
2018,Julio,Japón,392,94,93,,187,"(4.697144,-74.140516)"
2018,Julio,Japón,392,4,5,,9,"(6.171601,-75.427454)"
2018,Julio,Jordania,400,1,2,,3,"(4.697144,-74.140516)"
2018,Julio,Kazajistán,398,0,1,,1,"(4.697144,-74.140516)"
2018,Julio,Kenia,404,2,3,,5,"(4.697144,-74.140516)"
2018,Julio,Kuwait,414,3,5,,8,"(4.697144,-74.140516)"
2018,Julio,Kuwait,414,0,1,,1,"(7.128456,-73.183637)"
2018,Julio,República Democrática Popular  Lao,418,1,3,,4,"(4.697144,-74.140516)"
2018,Julio,Lituania,440,2,1,,3,"(4.697144,-74.140516)"
2018,Julio,Lituania,440,1,0,,1,"(6.171601,-75.427454)"
2018,Julio,Líbano,422,2,6,,8,"(10.886611,-74.776708)"
2018,Julio,Líbano,422,2,2,,4,"(12.586067,-81.702563)"
2018,Julio,Líbano,422,1,1,,2,"(3.541112,-76.384584)"
2018,Julio,Líbano,422,18,22,,40,"(4.697144,-74.140516)"
2018,Julio,Líbano,422,1,4,,5,"(6.171601,-75.427454)"
2018,Julio,Luxemburgo,442,1,0,,1,"(3.541112,-76.384584)"
2018,Julio,Luxemburgo,442,5,4,,9,"(4.697144,-74.140516)"
2018,Julio,Luxemburgo,442,1,1,,2,"(6.171601,-75.427454)"
2018,Julio,Madagascar,450,2,3,,5,"(4.697144,-74.140516)"
2018,Julio,Malasia,458,1,0,,1,"(10.445761,-75.516429)"
2018,Julio,Malasia,458,1,0,,1,"(3.541112,-76.384584)"
2018,Julio,Malasia,458,3,2,,5,"(4.697144,-74.140516)"
2018,Julio,Malasia,458,1,1,,2,"(6.171601,-75.427454)"
2018,Julio,Malí,466,0,1,,1,"(4.697144,-74.140516)"
2018,Julio,Malta,470,1,0,,1,"(10.886611,-74.776708)"
2018,Julio,Malta,470,20,11,,31,"(4.697144,-74.140516)"
2018,Julio,Malta,470,4,3,,7,"(6.171601,-75.427454)"
2018,Julio,Marruecos,504,9,2,,11,"(4.697144,-74.140516)"
2018,Julio,Marruecos,504,2,1,,3,"(6.171601,-75.427454)"
2018,Julio,México,484,0,2,,2,"(0.814836,-77.662532)"
2018,Julio,México,484,84,89,,173,"(10.445761,-75.516429)"
2018,Julio,México,484,179,128,,307,"(10.886611,-74.776708)"
2018,Julio,México,484,13,13,,26,"(12.586067,-81.702563)"
2018,Julio,México,484,1123,884,,2007,"(3.541112,-76.384584)"
2018,Julio,México,484,16503,14567,,31070,"(4.697144,-74.140516)"
2018,Julio,México,484,207,174,,381,"(4.815061,-75.736532)"
2018,Julio,México,484,2063,1664,,3727,"(6.171601,-75.427454)"
2018,Julio,México,484,99,65,,164,"(7.128456,-73.183637)"
2018,Julio,Montenegro,499,0,1,,1,"(4.697144,-74.140516)"
2018,Julio,Nauru,520,1,0,,1,"(3.541112,-76.384584)"
2018,Julio,Namibia,516,1,3,,4,"(4.697144,-74.140516)"
2018,Julio,Nicaragua,558,3,0,,3,"(10.445761,-75.516429)"
2018,Julio,Nicaragua,558,2,3,,5,"(10.886611,-74.776708)"
2018,Julio,Nicaragua,558,5,25,,30,"(3.541112,-76.384584)"
2018,Julio,Nicaragua,558,17,32,,49,"(4.697144,-74.140516)"
2018,Julio,Nicaragua,558,0,6,,6,"(4.815061,-75.736532)"
2018,Julio,Nicaragua,558,9,28,,37,"(6.171601,-75.427454)"
2018,Julio,Nigeria,566,0,2,,2,"(10.445761,-75.516429)"
2018,Julio,Nigeria,566,0,8,,8,"(4.697144,-74.140516)"
2018,Julio,Noruega,578,6,3,,9,"(10.445761,-75.516429)"
2018,Julio,Noruega,578,9,7,,16,"(3.541112,-76.384584)"
2018,Julio,Noruega,578,46,21,,67,"(4.697144,-74.140516)"
2018,Julio,Noruega,578,1,0,,1,"(4.815061,-75.736532)"
2018,Julio,Noruega,578,11,5,,16,"(6.171601,-75.427454)"
2018,Julio,Nueva Zelanda,554,45,41,,86,"(4.697144,-74.140516)"
2018,Julio,Nueva Zelanda,554,3,5,,8,"(6.171601,-75.427454)"
2018,Julio,Omán,512,0,1,,1,"(10.886611,-74.776708)"
2018,Julio,Omán,512,3,8,,11,"(4.697144,-74.140516)"
2018,Julio,Omán,512,2,2,,4,"(6.171601,-75.427454)"
2018,Julio,Panamá,591,124,163,,287,"(10.408582,-75.538003)"
2018,Julio,Panamá,591,1367,1174,,2541,"(10.445761,-75.516429)"
2018,Julio,Panamá,591,816,721,,1537,"(10.886611,-74.776708)"
2018,Julio,Panamá,591,0,9,,9,"(12.165168,-71.983761)"
2018,Julio,Panamá,591,4,18,,22,"(12.5744111,-81.703935)"
2018,Julio,Panamá,591,67,74,,141,"(12.586067,-81.702563)"
2018,Julio,Panamá,591,2526,1947,,4473,"(3.541112,-76.384584)"
2018,Julio,Panamá,591,311,185,,496,"(4.452882,-75.766298)"
2018,Julio,Panamá,591,8299,8883,,17182,"(4.697144,-74.140516)"
2018,Julio,Panamá,591,320,265,,585,"(4.815061,-75.736532)"
2018,Julio,Panamá,591,3054,2638,,5692,"(6.171601,-75.427454)"
2018,Julio,Panamá,591,1,5,,6,"(6.228046,-77.404104)"
2018,Julio,Panamá,591,13,15,,28,"(7.102626,-77.762647)"
2018,Julio,Panamá,591,202,170,,372,"(7.128456,-73.183637)"
2018,Julio,Panamá,591,1,9,,10,"(8.066966,-76.735404)"
2018,Julio,Panamá,591,38,73,,111,"(8.635765,-77.346578)"
2018,Julio,Paraguay,600,0,2,,2,"(0.25129,-76.875963)"
2018,Julio,Paraguay,600,0,13,,13,"(0.814836,-77.662532)"
2018,Julio,Paraguay,600,2,3,,5,"(10.445761,-75.516429)"
2018,Julio,Paraguay,600,2,6,,8,"(10.886611,-74.776708)"
2018,Julio,Paraguay,600,13,20,,33,"(3.541112,-76.384584)"
2018,Julio,Paraguay,600,93,235,,328,"(4.697144,-74.140516)"
2018,Julio,Paraguay,600,7,11,,18,"(4.815061,-75.736532)"
2018,Julio,Paraguay,600,22,45,,67,"(6.171601,-75.427454)"
2018,Julio,Perú,604,3,4,,7,"(-0.193180,-74.784874)"
2018,Julio,Perú,604,55,86,,141,"(-4.197703,-69.941278)"
2018,Julio,Perú,604,79,91,,170,"(-4.223468,-69.945098)"
2018,Julio,Perú,604,2,11,,13,"(0.25129,-76.875963)"
2018,Julio,Perú,604,169,169,,338,"(0.814836,-77.662532)"
2018,Julio,Perú,604,0,2,,2,"(1.813928,-78.763924)"
2018,Julio,Perú,604,69,53,,122,"(10.445761,-75.516429)"
2018,Julio,Perú,604,9,3,,12,"(10.886611,-74.776708)"
2018,Julio,Perú,604,1,0,,1,"(12.586067,-81.702563)"
2018,Julio,Perú,604,218,186,,404,"(3.541112,-76.384584)"
2018,Julio,Perú,604,1,6,,7,"(3.893038,-77.067921)"
2018,Julio,Perú,604,5265,5879,,11144,"(4.697144,-74.140516)"
2018,Julio,Perú,604,5,1,,6,"(4.815061,-75.736532)"
2018,Julio,Perú,604,498,515,,1013,"(6.171601,-75.427454)"
2018,Julio,Palestina,99999,1,1,,2,"(4.697144,-74.140516)"
2018,Julio,Polonia,616,1,0,,1,"(10.445761,-75.516429)"
2018,Julio,Polonia,616,1,0,,1,"(3.541112,-76.384584)"
2018,Julio,Polonia,616,18,19,,37,"(4.697144,-74.140516)"
2018,Julio,Polonia,616,1,1,,2,"(6.171601,-75.427454)"
2018,Julio,Portugal,620,2,1,,3,"(10.445761,-75.516429)"
2018,Julio,Portugal,620,2,1,,3,"(10.886611,-74.776708)"
2018,Julio,Portugal,620,21,15,,36,"(3.541112,-76.384584)"
2018,Julio,Portugal,620,154,161,,315,"(4.697144,-74.140516)"
2018,Julio,Portugal,620,11,10,,21,"(6.171601,-75.427454)"
2018,Julio,Portugal,620,1,0,,1,"(7.128456,-73.183637)"
2018,Julio,Puerto Rico/Territorio de Estados Unidos,630,4,6,,10,"(10.445761,-75.516429)"
2018,Julio,Puerto Rico/Territorio de Estados Unidos,630,12,6,,18,"(10.886611,-74.776708)"
2018,Julio,Puerto Rico/Territorio de Estados Unidos,630,30,21,,51,"(3.541112,-76.384584)"
2018,Julio,Puerto Rico/Territorio de Estados Unidos,630,461,435,,896,"(4.697144,-74.140516)"
2018,Julio,Puerto Rico/Territorio de Estados Unidos,630,8,9,,17,"(4.815061,-75.736532)"
2018,Julio,Puerto Rico/Territorio de Estados Unidos,630,57,52,,109,"(6.171601,-75.427454)"
2018,Julio,Puerto Rico/Territorio de Estados Unidos,630,4,0,,4,"(7.128456,-73.183637)"
2018,Julio,Qatar,634,0,2,,2,"(3.541112,-76.384584)"
2018,Julio,Qatar,634,8,19,,27,"(4.697144,-74.140516)"
2018,Julio,Qatar,634,3,1,,4,"(6.171601,-75.427454)"
2018,Julio,Reino Unido de Gran Bretaña e Irlanda del Norte,826,1,1,,2,"(10.445761,-75.516429)"
2018,Julio,Reino Unido de Gran Bretaña e Irlanda del Norte,826,35,25,,60,"(3.541112,-76.384584)"
2018,Julio,Reino Unido de Gran Bretaña e Irlanda del Norte,826,1953,1523,,3476,"(4.697144,-74.140516)"
2018,Julio,Reino Unido de Gran Bretaña e Irlanda del Norte,826,26,22,,48,"(6.171601,-75.427454)"
2018,Julio,Reino Unido de Gran Bretaña e Irlanda del Norte,826,0,1,,1,"(7.128456,-73.183637)"
2018,Julio,República CentroÁfricana,140,0,1,,1,"(4.697144,-74.140516)"
2018,Julio,Federación de Rusia,643,1,0,,1,"(10.886611,-74.776708)"
2018,Julio,Federación de Rusia,643,8,11,,19,"(3.541112,-76.384584)"
2018,Julio,Federación de Rusia,643,111,164,,275,"(4.697144,-74.140516)"
2018,Julio,Federación de Rusia,643,2,2,,4,"(4.815061,-75.736532)"
2018,Julio,Federación de Rusia,643,6,8,,14,"(6.171601,-75.427454)"
2018,Julio,Federación de Rusia,643,0,2,,2,"(7.128456,-73.183637)"
2018,Julio,República Dominicana,214,8,12,,20,"(10.445761,-75.516429)"
2018,Julio,República Dominicana,214,26,28,,54,"(10.886611,-74.776708)"
2018,Julio,República Dominicana,214,0,1,,1,"(11.247723,-74.213989)"
2018,Julio,República Dominicana,214,82,77,,159,"(3.541112,-76.384584)"
2018,Julio,República Dominicana,214,4534,4043,,8577,"(4.697144,-74.140516)"
2018,Julio,República Dominicana,214,33,31,,64,"(4.815061,-75.736532)"
2018,Julio,República Dominicana,214,262,214,,476,"(6.171601,-75.427454)"
2018,Julio,República Dominicana,214,13,8,,21,"(7.128456,-73.183637)"
2018,Julio,Reunión,638,5,1,,6,"(4.697144,-74.140516)"
2018,Julio,República Democrática Popular de Corea,408,0,1,,1,"(4.697144,-74.140516)"
2018,Julio,Rumania,642,5,5,,10,"(4.697144,-74.140516)"
2018,Julio,Rumania,642,1,0,,1,"(6.171601,-75.427454)"
2018,Julio,Rwanda,646,1,0,,1,"(4.697144,-74.140516)"
2018,Julio,Santa Lucia,662,0,1,,1,"(6.171601,-75.427454)"
2018,Julio,Serbia,688,2,5,,7,"(4.697144,-74.140516)"
2018,Julio,Singapur,702,2,1,,3,"(10.445761,-75.516429)"
2018,Julio,Singapur,702,1,1,,2,"(3.541112,-76.384584)"
2018,Julio,Singapur,702,23,20,,43,"(4.697144,-74.140516)"
2018,Julio,Singapur,702,3,2,,5,"(6.171601,-75.427454)"
2018,Julio,Sri Lanka,144,2,1,,3,"(4.697144,-74.140516)"
2018,Julio,Sudáfrica,710,32,28,,60,"(4.697144,-74.140516)"
2018,Julio,Sudáfrica,710,1,1,,2,"(6.171601,-75.427454)"
2018,Julio,Sudán,736,0,1,,1,"(6.171601,-75.427454)"
2018,Julio,Suecia,752,5,1,,6,"(10.445761,-75.516429)"
2018,Julio,Suecia,752,5,6,,11,"(10.886611,-74.776708)"
2018,Julio,Suecia,752,23,14,,37,"(3.541112,-76.384584)"
2018,Julio,Suecia,752,87,74,,161,"(4.697144,-74.140516)"
2018,Julio,Suecia,752,1,0,,1,"(4.815061,-75.736532)"
2018,Julio,Suecia,752,26,14,,40,"(6.171601,-75.427454)"
2018,Julio,Suecia,752,2,0,,2,"(7.128456,-73.183637)"
2018,Julio,Suiza,756,6,6,,12,"(10.445761,-75.516429)"
2018,Julio,Suiza,756,2,2,,4,"(10.886611,-74.776708)"
2018,Julio,Suiza,756,63,25,,88,"(3.541112,-76.384584)"
2018,Julio,Suiza,756,311,207,,518,"(4.697144,-74.140516)"
2018,Julio,Suiza,756,2,3,,5,"(4.815061,-75.736532)"
2018,Julio,Suiza,756,54,38,,92,"(6.171601,-75.427454)"
2018,Julio,Surinam,740,0,10,,10,"(10.408582,-75.538003)"
2018,Julio,Surinam,740,3,6,,9,"(4.697144,-74.140516)"
2018,Julio,Taiwán,158,3,1,,4,"(4.697144,-74.140516)"
2018,Julio,Tailandia,764,1,0,,1,"(10.886611,-74.776708)"
2018,Julio,Tailandia,764,1,0,,1,"(3.541112,-76.384584)"
2018,Julio,Tailandia,764,8,17,,25,"(4.697144,-74.140516)"
2018,Julio,Tailandia,764,0,3,,3,"(6.171601,-75.427454)"
2018,Julio,Tanzania,834,0,1,,1,"(10.886611,-74.776708)"
2018,Julio,Tanzania,834,1,1,,2,"(4.697144,-74.140516)"
2018,Julio,Trinidad y Tobago,780,2,0,,2,"(10.445761,-75.516429)"
2018,Julio,Trinidad y Tobago,780,1,1,,2,"(10.886611,-74.776708)"
2018,Julio,Trinidad y Tobago,780,2,0,,2,"(12.586067,-81.702563)"
2018,Julio,Trinidad y Tobago,780,2,6,,8,"(3.541112,-76.384584)"
2018,Julio,Trinidad y Tobago,780,15,19,,34,"(4.697144,-74.140516)"
2018,Julio,Trinidad y Tobago,780,0,5,,5,"(4.815061,-75.736532)"
2018,Julio,Trinidad y Tobago,780,5,7,,12,"(6.171601,-75.427454)"
2018,Julio,Trinidad y Tobago,780,2,5,,7,"(7.128456,-73.183637)"
2018,Julio,Túnez,788,1,2,,3,"(4.697144,-74.140516)"
2018,Julio,Turquía,792,1,0,,1,"(10.445761,-75.516429)"
2018,Julio,Turquía,792,1,1,,2,"(10.886611,-74.776708)"
2018,Julio,Turquía,792,8,5,,13,"(3.541112,-76.384584)"
2018,Julio,Turquía,792,542,424,,966,"(4.697144,-74.140516)"
2018,Julio,Turquía,792,10,5,,15,"(6.171601,-75.427454)"
2018,Julio,Turkmenistán,795,1,1,,2,"(4.697144,-74.140516)"
2018,Julio,Ucrania,804,0,1,,1,"(3.541112,-76.384584)"
2018,Julio,Ucrania,804,4,7,,11,"(4.697144,-74.140516)"
2018,Julio,Uruguay,858,2,3,,5,"(0.814836,-77.662532)"
2018,Julio,Uruguay,858,0,3,,3,"(10.445761,-75.516429)"
2018,Julio,Uruguay,858,0,1,,1,"(10.886611,-74.776708)"
2018,Julio,Uruguay,858,9,13,,22,"(3.541112,-76.384584)"
2018,Julio,Uruguay,858,254,335,,589,"(4.697144,-74.140516)"
2018,Julio,Uruguay,858,5,8,,13,"(4.815061,-75.736532)"
2018,Julio,Uruguay,858,15,15,,30,"(6.171601,-75.427454)"
2018,Julio,Uruguay,858,3,3,,6,"(7.128456,-73.183637)"
2018,Julio,Uzbekistán,860,1,2,,3,"(4.697144,-74.140516)"
2018,Julio,Venezuela,862,0,16,,16,"(10.408582,-75.538003)"
2018,Julio,Venezuela,862,10,20,,30,"(10.445761,-75.516429)"
2018,Julio,Venezuela,862,22,17,,39,"(10.886611,-74.776708)"
2018,Julio,Venezuela,862,2285,2373,,4658,"(11.360009,-72.129330)"
2018,Julio,Venezuela,862,0,1,,1,"(12.165168,-71.983761)"
2018,Julio,Venezuela,862,702,490,,1192,"(3.541112,-76.384584)"
2018,Julio,Venezuela,862,4,2,,6,"(3.866713,-67.927521)"
2018,Julio,Venezuela,862,1215,1199,,2415,"(4.697144,-74.140516)"
2018,Julio,Venezuela,862,3,0,,3,"(4.815061,-75.736532)"
2018,Julio,Venezuela,862,669,575,,1244,"(6.171601,-75.427454)"
2018,Julio,Venezuela,862,58,61,,119,"(6.185799,-67.483929)"
2018,Julio,Venezuela,862,781,667,,1448,"(7.088729,-70.740253)"
2018,Julio,Venezuela,862,2,2,,4,"(7.128456,-73.183637)"
2018,Julio,Venezuela,862,1765,1693,,3458,"(7.818934,-72.453226)"
2018,Julio,Venezuela,862,151,180,,331,"(8.36068,-72.409396)"
2018,Julio,Vietnam,704,2,1,,3,"(3.541112,-76.384584)"
2018,Julio,Vietnam,704,6,8,,14,"(4.697144,-74.140516)"
2018,Julio,Islas Vírgenes Británicas/Territorio Británico de Ultramar,92,0,1,,1,"(4.815061,-75.736532)"
2018,Julio,Islas Vírgenes Británicas/Territorio Británico de Ultramar,92,0,1,,1,"(6.171601,-75.427454)"
2018,Julio,Zambia,894,1,0,,1,"(4.697144,-74.140516)"
2018,Agosto,Afganistán,4,0,1,,1,"(10.408582,-75.538003)"
2018,Agosto,Afganistán,4,0,1,,1,"(3.541112,-76.384584)"
2018,Agosto,Afganistán,4,0,1,,1,"(4.697144,-74.140516)"
2018,Agosto,Afganistán,4,0,1,,1,"(6.171601,-75.427454)"
2018,Agosto,Albania,8,0,1,,1,"(10.445761,-75.516429)"
2018,Agosto,Albania,8,2,4,,6,"(4.697144,-74.140516)"
2018,Agosto,Alemania,276,0,1,,1,"(0.814836,-77.662532)"
2018,Agosto,Alemania,276,11,7,,18,"(10.445761,-75.516429)"
2018,Agosto,Alemania,276,7,6,,13,"(10.886611,-74.776708)"
2018,Agosto,Alemania,276,81,49,,130,"(3.541112,-76.384584)"
2018,Agosto,Alemania,276,1378,1204,,2582,"(4.697144,-74.140516)"
2018,Agosto,Alemania,276,0,1,,1,"(4.815061,-75.736532)"
2018,Agosto,Alemania,276,75,50,,125,"(6.171601,-75.427454)"
2018,Agosto,Andorra,20,0,1,,1,"(10.408582,-75.538003)"
2018,Agosto,Andorra,20,0,2,,2,"(4.697144,-74.140516)"
2018,Agosto,Angola,24,2,2,,4,"(4.697144,-74.140516)"
2018,Agosto,Antigua y Barbuda,28,2,2,,4,"(4.697144,-74.140516)"
2018,Agosto,Países Bajos,528,154,84,,238,"(10.445761,-75.516429)"
2018,Agosto,Países Bajos,528,38,22,,60,"(10.886611,-74.776708)"
2018,Agosto,Países Bajos,528,92,41,,133,"(3.541112,-76.384584)"
2018,Agosto,Países Bajos,528,983,859,,1842,"(4.697144,-74.140516)"
2018,Agosto,Países Bajos,528,11,3,,14,"(4.815061,-75.736532)"
2018,Agosto,Países Bajos,528,121,76,,197,"(6.171601,-75.427454)"
2018,Agosto,Países Bajos,528,3,0,,3,"(7.128456,-73.183637)"
2018,Agosto,Arabia Saudita,682,0,1,,1,"(10.445761,-75.516429)"
2018,Agosto,Arabia Saudita,682,0,2,,2,"(3.541112,-76.384584)"
2018,Agosto,Arabia Saudita,682,35,44,,79,"(4.697144,-74.140516)"
2018,Agosto,Arabia Saudita,682,1,1,,2,"(6.171601,-75.427454)"
2018,Agosto,Arabia Saudita,682,1,2,,3,"(7.128456,-73.183637)"
2018,Agosto,Argelia,12,3,2,,5,"(4.697144,-74.140516)"
2018,Agosto,Argentina,32,2,0,,2,"(0.25129,-76.875963)"
2018,Agosto,Argentina,32,7,17,,24,"(0.814836,-77.662532)"
2018,Agosto,Argentina,32,24,22,,46,"(10.445761,-75.516429)"
2018,Agosto,Argentina,32,33,8,,41,"(10.886611,-74.776708)"
2018,Agosto,Argentina,32,0,1,,1,"(12.586067,-81.702563)"
2018,Agosto,Argentina,32,115,127,,242,"(3.541112,-76.384584)"
2018,Agosto,Argentina,32,2568,2538,,5106,"(4.697144,-74.140516)"
2018,Agosto,Argentina,32,24,31,,55,"(4.815061,-75.736532)"
2018,Agosto,Argentina,32,169,189,,358,"(6.171601,-75.427454)"
2018,Agosto,Argentina,32,6,8,,14,"(7.128456,-73.183637)"
2018,Agosto,República de Armenia,51,2,0,,2,"(6.171601,-75.427454)"
2018,Agosto,Aruba,533,2154,1595,,3749,"(10.408582,-75.538003)"
2018,Agosto,Aruba,533,4,2,,6,"(10.445761,-75.516429)"
2018,Agosto,Aruba,533,20,11,,31,"(10.886611,-74.776708)"
2018,Agosto,Aruba,533,0,4,,4,"(10.971302,-74.765397)"
2018,Agosto,Aruba,533,0,6,,6,"(11.247723,-74.213989)"
2018,Agosto,Aruba,533,0,20,,20,"(12.165168,-71.983761)"
2018,Agosto,Aruba,533,25,26,,51,"(3.541112,-76.384584)"
2018,Agosto,Aruba,533,2787,1905,,4692,"(4.697144,-74.140516)"
2018,Agosto,Aruba,533,5,3,,8,"(4.815061,-75.736532)"
2018,Agosto,Aruba,533,119,52,,171,"(6.171601,-75.427454)"
2018,Agosto,Aruba,533,16,57,,73,"(7.128456,-73.183637)"
2018,Agosto,Australia,36,1,2,,3,"(10.445761,-75.516429)"
2018,Agosto,Australia,36,1,2,,3,"(10.886611,-74.776708)"
2018,Agosto,Australia,36,15,6,,21,"(3.541112,-76.384584)"
2018,Agosto,Australia,36,377,300,,677,"(4.697144,-74.140516)"
2018,Agosto,Australia,36,31,32,,63,"(6.171601,-75.427454)"
2018,Agosto,Australia,36,1,0,,1,"(7.128456,-73.183637)"
2018,Agosto,Austria,40,1,3,,4,"(10.445761,-75.516429)"
2018,Agosto,Austria,40,0,1,,1,"(10.886611,-74.776708)"
2018,Agosto,Austria,40,4,2,,6,"(3.541112,-76.384584)"
2018,Agosto,Austria,40,63,42,,105,"(4.697144,-74.140516)"
2018,Agosto,Austria,40,11,22,,33,"(6.171601,-75.427454)"
2018,Agosto,Bahamas,44,1,1,,2,"(10.445761,-75.516429)"
2018,Agosto,Bahamas,44,2,0,,2,"(10.886611,-74.776708)"
2018,Agosto,Bahamas,44,0,1,,1,"(12.586067,-81.702563)"
2018,Agosto,Bahamas,44,12,5,,17,"(3.541112,-76.384584)"
2018,Agosto,Bahamas,44,10,6,,16,"(4.697144,-74.140516)"
2018,Agosto,Bahamas,44,10,0,,10,"(4.815061,-75.736532)"
2018,Agosto,Bahamas,44,15,8,,23,"(6.171601,-75.427454)"
2018,Agosto,Bahréin,48,1,1,,2,"(3.541112,-76.384584)"
2018,Agosto,Bahréin,48,0,5,,5,"(4.452882,-75.766298)"
2018,Agosto,Bahréin,48,3,2,,5,"(4.697144,-74.140516)"
2018,Agosto,Bahréin,48,1,2,,3,"(6.171601,-75.427454)"
2018,Agosto,Bangladesh,50,1,2,,3,"(4.697144,-74.140516)"
2018,Agosto,Bangladesh,50,1,3,,4,"(6.171601,-75.427454)"
2018,Agosto,Barbados,52,1,1,,2,"(10.886611,-74.776708)"
2018,Agosto,Barbados,52,1,2,,3,"(3.541112,-76.384584)"
2018,Agosto,Barbados,52,7,7,,14,"(4.697144,-74.140516)"
2018,Agosto,Barbados,52,1,0,,1,"(6.171601,-75.427454)"
2018,Agosto,República de Belarús,112,0,1,,1,"(4.697144,-74.140516)"
2018,Agosto,Bélgica,56,4,4,,8,"(10.445761,-75.516429)"
2018,Agosto,Bélgica,56,1,0,,1,"(10.886611,-74.776708)"
2018,Agosto,Bélgica,56,8,6,,14,"(3.541112,-76.384584)"
2018,Agosto,Bélgica,56,155,109,,264,"(4.697144,-74.140516)"
2018,Agosto,Bélgica,56,0,1,,1,"(4.815061,-75.736532)"
2018,Agosto,Bélgica,56,59,27,,86,"(6.171601,-75.427454)"
2018,Agosto,Belice,84,1,0,,1,"(12.586067,-81.702563)"
2018,Agosto,Belice,84,14,10,,24,"(4.697144,-74.140516)"
2018,Agosto,Belice,84,5,8,,13,"(6.171601,-75.427454)"
2018,Agosto,Bermudas/Territorio Británico de Ultramar,60,1,2,,3,"(10.886611,-74.776708)"
2018,Agosto,Bermudas/Territorio Británico de Ultramar,60,1,0,,1,"(3.541112,-76.384584)"
2018,Agosto,Bolivia,68,3,5,,8,"(0.814836,-77.662532)"
2018,Agosto,Bolivia,68,1,3,,4,"(10.445761,-75.516429)"
2018,Agosto,Bolivia,68,0,5,,5,"(10.886611,-74.776708)"
2018,Agosto,Bolivia,68,23,36,,59,"(3.541112,-76.384584)"
2018,Agosto,Bolivia,68,284,469,,753,"(4.697144,-74.140516)"
2018,Agosto,Bolivia,68,5,6,,11,"(4.815061,-75.736532)"
2018,Agosto,Bolivia,68,24,49,,73,"(6.171601,-75.427454)"
2018,Agosto,Bosnia y Herzegovina,70,0,1,,1,"(3.541112,-76.384584)"
2018,Agosto,Bosnia y Herzegovina,70,2,1,,3,"(4.697144,-74.140516)"
2018,Agosto,Brasil,76,107,227,,334,"(-4.197703,-69.941278)"
2018,Agosto,Brasil,76,5,16,,21,"(-4.223468,-69.945098)"
2018,Agosto,Brasil,76,2,3,,5,"(0.814836,-77.662532)"
2018,Agosto,Brasil,76,9,15,,24,"(10.445761,-75.516429)"
2018,Agosto,Brasil,76,15,14,,29,"(10.886611,-74.776708)"
2018,Agosto,Brasil,76,0,1,,1,"(12.586067,-81.702563)"
2018,Agosto,Brasil,76,153,166,,319,"(3.541112,-76.384584)"
2018,Agosto,Brasil,76,3803,4838,,8641,"(4.697144,-74.140516)"
2018,Agosto,Brasil,76,25,30,,55,"(4.815061,-75.736532)"
2018,Agosto,Brasil,76,191,225,,416,"(6.171601,-75.427454)"
2018,Agosto,Brasil,76,9,3,,12,"(7.128456,-73.183637)"
2018,Agosto,Bulgaria,100,1,2,,3,"(4.697144,-74.140516)"
2018,Agosto,Islas Caimán/Territorio Británico de Ultramar,136,2,2,,4,"(10.445761,-75.516429)"
2018,Agosto,Islas Caimán/Territorio Británico de Ultramar,136,2,0,,2,"(11.117806,-74.232622)"
2018,Agosto,Islas Caimán/Territorio Británico de Ultramar,136,9,2,,11,"(12.586067,-81.702563)"
2018,Agosto,Islas Caimán/Territorio Británico de Ultramar,136,5,0,,5,"(3.541112,-76.384584)"
2018,Agosto,Islas Caimán/Territorio Británico de Ultramar,136,11,4,,15,"(4.697144,-74.140516)"
2018,Agosto,Islas Caimán/Territorio Británico de Ultramar,136,3,1,,4,"(6.171601,-75.427454)"
2018,Agosto,Camboya,116,0,1,,1,"(3.541112,-76.384584)"
2018,Agosto,Camboya,116,0,1,,1,"(4.697144,-74.140516)"
2018,Agosto,Camerún,120,1,0,,1,"(4.697144,-74.140516)"
2018,Agosto,Camerún,120,1,2,,3,"(6.171601,-75.427454)"
2018,Agosto,Canadá,124,50,45,,95,"(10.445761,-75.516429)"
2018,Agosto,Canadá,124,83,43,,126,"(10.886611,-74.776708)"
2018,Agosto,Canadá,124,1,2,,3,"(12.586067,-81.702563)"
2018,Agosto,Canadá,124,192,136,,328,"(3.541112,-76.384584)"
2018,Agosto,Canadá,124,0,2,,2,"(4.452882,-75.766298)"
2018,Agosto,Canadá,124,3009,2397,,5406,"(4.697144,-74.140516)"
2018,Agosto,Canadá,124,19,17,,36,"(4.815061,-75.736532)"
2018,Agosto,Canadá,124,438,318,,756,"(6.171601,-75.427454)"
2018,Agosto,Canadá,124,22,11,,33,"(7.128456,-73.183637)"
2018,Agosto,Chad,148,1,0,,1,"(4.697144,-74.140516)"
2018,Agosto,España,724,1,0,,1,"(0.814836,-77.662532)"
2018,Agosto,España,724,9,7,,16,"(10.445761,-75.516429)"
2018,Agosto,España,724,25,17,,42,"(10.886611,-74.776708)"
2018,Agosto,España,724,0,1,,1,"(12.586067,-81.702563)"
2018,Agosto,España,724,3005,1897,,4902,"(3.541112,-76.384584)"
2018,Agosto,España,724,13448,9408,,22856,"(4.697144,-74.140516)"
2018,Agosto,España,724,7,5,,12,"(4.815061,-75.736532)"
2018,Agosto,España,724,2471,1629,,4100,"(6.171601,-75.427454)"
2018,Agosto,España,724,0,1,,1,"(7.128456,-73.183637)"
2018,Agosto,Colombia,170,1,13,,14,"(10.445761,-75.516429)"
2018,Agosto,Colombia,170,237,598,,836,"(4.697144,-74.140516)"
2018,Agosto,República Del Congo,178,0,2,,2,"(4.697144,-74.140516)"
2018,Agosto,República Democrática del Congo,180,0,2,,2,"(4.697144,-74.140516)"
2018,Agosto,República de Corea,410,25,22,,47,"(4.697144,-74.140516)"
2018,Agosto,República de Corea,410,1,1,,2,"(6.171601,-75.427454)"
2018,Agosto,Costa de Marfil,384,2,6,,8,"(4.697144,-74.140516)"
2018,Agosto,Costa de Marfil,384,0,1,,1,"(6.171601,-75.427454)"
2018,Agosto,Costa Rica,188,6,15,,21,"(10.445761,-75.516429)"
2018,Agosto,Costa Rica,188,13,15,,28,"(10.886611,-74.776708)"
2018,Agosto,Costa Rica,188,1,9,,10,"(12.5744111,-81.703935)"
2018,Agosto,Costa Rica,188,5,1,,6,"(12.586067,-81.702563)"
2018,Agosto,Costa Rica,188,32,25,,57,"(3.541112,-76.384584)"
2018,Agosto,Costa Rica,188,1091,1222,,2313,"(4.697144,-74.140516)"
2018,Agosto,Costa Rica,188,13,10,,23,"(4.815061,-75.736532)"
2018,Agosto,Costa Rica,188,128,122,,250,"(6.171601,-75.427454)"
2018,Agosto,Costa Rica,188,2,1,,3,"(7.128456,-73.183637)"
2018,Agosto,Croacia,191,0,1,,1,"(10.886611,-74.776708)"
2018,Agosto,Croacia,191,12,4,,16,"(4.697144,-74.140516)"
2018,Agosto,Croacia,191,5,2,,7,"(6.171601,-75.427454)"
2018,Agosto,Cuba,192,10,10,,20,"(10.445761,-75.516429)"
2018,Agosto,Cuba,192,14,14,,28,"(10.886611,-74.776708)"
2018,Agosto,Cuba,192,2,1,,3,"(12.586067,-81.702563)"
2018,Agosto,Cuba,192,101,59,,160,"(3.541112,-76.384584)"
2018,Agosto,Cuba,192,1613,1321,,2934,"(4.697144,-74.140516)"
2018,Agosto,Cuba,192,23,15,,38,"(4.815061,-75.736532)"
2018,Agosto,Cuba,192,117,94,,211,"(6.171601,-75.427454)"
2018,Agosto,Cuba,192,5,2,,7,"(7.128456,-73.183637)"
2018,Agosto,Curazao,99999,9,10,,19,"(10.886611,-74.776708)"
2018,Agosto,Curazao,99999,8,2,,10,"(3.541112,-76.384584)"
2018,Agosto,Curazao,99999,884,647,,1531,"(4.697144,-74.140516)"
2018,Agosto,Curazao,99999,15,8,,23,"(4.815061,-75.736532)"
2018,Agosto,Curazao,99999,25,15,,40,"(6.171601,-75.427454)"
2018,Agosto,Curazao,99999,7,2,,9,"(7.128456,-73.183637)"
2018,Agosto,República Checa,203,0,1,,1,"(10.445761,-75.516429)"
2018,Agosto,República Checa,203,0,1,,1,"(3.541112,-76.384584)"
2018,Agosto,República Checa,203,16,13,,29,"(4.697144,-74.140516)"
2018,Agosto,República Checa,203,1,2,,3,"(6.171601,-75.427454)"
2018,Agosto,Chile,152,3,2,,5,"(0.25129,-76.875963)"
2018,Agosto,Chile,152,108,103,,211,"(0.814836,-77.662532)"
2018,Agosto,Chile,152,27,24,,51,"(10.445761,-75.516429)"
2018,Agosto,Chile,152,18,17,,35,"(10.886611,-74.776708)"
2018,Agosto,Chile,152,5,3,,8,"(12.586067,-81.702563)"
2018,Agosto,Chile,152,152,110,,262,"(3.541112,-76.384584)"
2018,Agosto,Chile,152,4981,4313,,9294,"(4.697144,-74.140516)"
2018,Agosto,Chile,152,36,24,,60,"(4.815061,-75.736532)"
2018,Agosto,Chile,152,160,121,,281,"(6.171601,-75.427454)"
2018,Agosto,Chile,152,4,3,,7,"(7.128456,-73.183637)"
2018,Agosto,China,156,8,12,,20,"(10.445761,-75.516429)"
2018,Agosto,China,156,6,12,,18,"(10.886611,-74.776708)"
2018,Agosto,China,156,4,13,,17,"(3.541112,-76.384584)"
2018,Agosto,China,156,176,442,,618,"(4.697144,-74.140516)"
2018,Agosto,China,156,0,1,,1,"(4.815061,-75.736532)"
2018,Agosto,China,156,23,62,,85,"(6.171601,-75.427454)"
2018,Agosto,China,156,0,1,,1,"(7.128456,-73.183637)"
2018,Agosto,Chipre,196,1,1,,2,"(4.697144,-74.140516)"
2018,Agosto,Dinamarca,208,3,0,,3,"(10.445761,-75.516429)"
2018,Agosto,Dinamarca,208,1,2,,3,"(10.886611,-74.776708)"
2018,Agosto,Dinamarca,208,4,2,,6,"(3.541112,-76.384584)"
2018,Agosto,Dinamarca,208,51,38,,89,"(4.697144,-74.140516)"
2018,Agosto,Dinamarca,208,1,0,,1,"(4.815061,-75.736532)"
2018,Agosto,Dinamarca,208,7,8,,15,"(6.171601,-75.427454)"
2018,Agosto,Dominica,212,1,0,,1,"(10.445761,-75.516429)"
2018,Agosto,Dominica,212,1,2,,3,"(4.697144,-74.140516)"
2018,Agosto,Ecuador,218,0,2,,2,"(-0.193180,-74.784874)"
2018,Agosto,Ecuador,218,641,961,,1602,"(0.25129,-76.875963)"
2018,Agosto,Ecuador,218,47,66,,113,"(0.812436,-77.847006)"
2018,Agosto,Ecuador,218,5695,6616,,12311,"(0.814836,-77.662532)"
2018,Agosto,Ecuador,218,181,208,,389,"(1.813928,-78.763924)"
2018,Agosto,Ecuador,218,0,13,,13,"(10.408582,-75.538003)"
2018,Agosto,Ecuador,218,8,3,,11,"(10.445761,-75.516429)"
2018,Agosto,Ecuador,218,4,8,,12,"(10.886611,-74.776708)"
2018,Agosto,Ecuador,218,373,453,,826,"(3.541112,-76.384584)"
2018,Agosto,Ecuador,218,2946,4013,,6959,"(4.697144,-74.140516)"
2018,Agosto,Ecuador,218,4,1,,5,"(4.815061,-75.736532)"
2018,Agosto,Ecuador,218,23,37,,60,"(6.171601,-75.427454)"
2018,Agosto,Ecuador,218,1,1,,2,"(7.128456,-73.183637)"
2018,Agosto,Egipto,818,1,0,,1,"(10.886611,-74.776708)"
2018,Agosto,Egipto,818,22,7,,29,"(4.697144,-74.140516)"
2018,Agosto,El Salvador,222,2,2,,4,"(10.445761,-75.516429)"
2018,Agosto,El Salvador,222,3,1,,4,"(10.886611,-74.776708)"
2018,Agosto,El Salvador,222,136,127,,263,"(3.541112,-76.384584)"
2018,Agosto,El Salvador,222,868,1058,,1926,"(4.697144,-74.140516)"
2018,Agosto,El Salvador,222,1,1,,2,"(4.815061,-75.736532)"
2018,Agosto,El Salvador,222,138,165,,303,"(6.171601,-75.427454)"
2018,Agosto,Emiratos Árabes,784,1,2,,3,"(10.445761,-75.516429)"
2018,Agosto,Emiratos Árabes,784,8,3,,11,"(3.541112,-76.384584)"
2018,Agosto,Emiratos Árabes,784,144,253,,397,"(4.697144,-74.140516)"
2018,Agosto,Emiratos Árabes,784,22,11,,33,"(6.171601,-75.427454)"
2018,Agosto,Emiratos Árabes,784,0,1,,1,"(7.128456,-73.183637)"
2018,Agosto,Eritrea,232,2,0,,2,"(4.697144,-74.140516)"
2018,Agosto,Eslovaquia,703,0,1,,1,"(10.886611,-74.776708)"
2018,Agosto,Eslovaquia,703,1,4,,5,"(4.697144,-74.140516)"
2018,Agosto,Eslovenia,705,1,0,,1,"(4.697144,-74.140516)"
2018,Agosto,Estados Unidos de América,840,0,2,,2,"(10.408582,-75.538003)"
2018,Agosto,Estados Unidos de América,840,4406,3247,,7653,"(10.445761,-75.516429)"
2018,Agosto,Estados Unidos de América,840,3250,2451,,5701,"(10.886611,-74.776708)"
2018,Agosto,Estados Unidos de América,840,1,6,,7,"(11.117806,-74.232622)"
2018,Agosto,Estados Unidos de América,840,83,48,,131,"(12.586067,-81.702563)"
2018,Agosto,Estados Unidos de América,840,6602,4318,,10920,"(3.541112,-76.384584)"
2018,Agosto,Estados Unidos de América,840,931,642,,1573,"(4.452882,-75.766298)"
2018,Agosto,Estados Unidos de América,840,39316,31605,,70922,"(4.697144,-74.140516)"
2018,Agosto,Estados Unidos de América,840,1284,770,,2054,"(4.815061,-75.736532)"
2018,Agosto,Estados Unidos de América,840,11782,8565,,20347,"(6.171601,-75.427454)"
2018,Agosto,Estados Unidos de América,840,318,215,,533,"(7.128456,-73.183637)"
2018,Agosto,Estonia,233,3,2,,5,"(4.697144,-74.140516)"
2018,Agosto,Etiopia,231,2,2,,4,"(4.697144,-74.140516)"
2018,Agosto,Etiopia,231,1,2,,3,"(6.171601,-75.427454)"
2018,Agosto,Filipinas,608,1,1,,2,"(3.541112,-76.384584)"
2018,Agosto,Filipinas,608,4,1,,5,"(4.697144,-74.140516)"
2018,Agosto,Filipinas,608,0,1,,1,"(6.171601,-75.427454)"
2018,Agosto,Finlandia,246,2,2,,4,"(3.541112,-76.384584)"
2018,Agosto,Finlandia,246,16,13,,29,"(4.697144,-74.140516)"
2018,Agosto,Francia,250,20,8,,28,"(10.445761,-75.516429)"
2018,Agosto,Francia,250,26,17,,43,"(10.886611,-74.776708)"
2018,Agosto,Francia,250,158,91,,249,"(3.541112,-76.384584)"
2018,Agosto,Francia,250,2357,1619,,3976,"(4.697144,-74.140516)"
2018,Agosto,Francia,250,26,27,,53,"(4.815061,-75.736532)"
2018,Agosto,Francia,250,207,119,,326,"(6.171601,-75.427454)"
2018,Agosto,Francia,250,0,1,,1,"(7.128456,-73.183637)"
2018,Agosto,Francia,250,0,1,,1,"(8.635765,-77.346578)"
2018,Agosto,Gabón,266,1,2,,3,"(4.697144,-74.140516)"
2018,Agosto,Ghana,288,1,0,,1,"(4.697144,-74.140516)"
2018,Agosto,Granada,308,0,1,,1,"(10.886611,-74.776708)"
2018,Agosto,Granada,308,2,0,,2,"(4.697144,-74.140516)"
2018,Agosto,Grecia,300,3,3,,6,"(10.445761,-75.516429)"
2018,Agosto,Grecia,300,1,0,,1,"(10.886611,-74.776708)"
2018,Agosto,Grecia,300,1,0,,1,"(3.541112,-76.384584)"
2018,Agosto,Grecia,300,48,33,,81,"(4.697144,-74.140516)"
2018,Agosto,Grecia,300,7,3,,10,"(6.171601,-75.427454)"
2018,Agosto,Guatemala,320,4,6,,10,"(10.445761,-75.516429)"
2018,Agosto,Guatemala,320,11,11,,22,"(10.886611,-74.776708)"
2018,Agosto,Guatemala,320,46,59,,105,"(3.541112,-76.384584)"
2018,Agosto,Guatemala,320,471,600,,1071,"(4.697144,-74.140516)"
2018,Agosto,Guatemala,320,12,15,,27,"(4.815061,-75.736532)"
2018,Agosto,Guatemala,320,88,134,,222,"(6.171601,-75.427454)"
2018,Agosto,Guatemala,320,2,4,,6,"(7.128456,-73.183637)"
2018,Agosto,Guyana,328,1,5,,6,"(10.886611,-74.776708)"
2018,Agosto,Guyana,328,0,2,,2,"(3.541112,-76.384584)"
2018,Agosto,Guyana,328,3,5,,8,"(4.697144,-74.140516)"
2018,Agosto,Guyana,328,0,2,,2,"(6.171601,-75.427454)"
2018,Agosto,Guinea Ecuatorial,226,0,2,,2,"(4.697144,-74.140516)"
2018,Agosto,Guadalupe/Territorio Francés,312,0,1,,1,"(6.171601,-75.427454)"
2018,Agosto,Guayana Francesa/Departamento de Ultramar Francés,254,2,2,,4,"(4.697144,-74.140516)"
2018,Agosto,Haití,332,0,1,,1,"(10.445761,-75.516429)"
2018,Agosto,Haití,332,1,2,,3,"(10.886611,-74.776708)"
2018,Agosto,Haití,332,0,2,,2,"(3.541112,-76.384584)"
2018,Agosto,Haití,332,2,3,,5,"(4.697144,-74.140516)"
2018,Agosto,Haití,332,2,1,,3,"(6.171601,-75.427454)"
2018,Agosto,Honduras,340,1,12,,13,"(10.445761,-75.516429)"
2018,Agosto,Honduras,340,5,15,,20,"(10.886611,-74.776708)"
2018,Agosto,Honduras,340,17,29,,46,"(3.541112,-76.384584)"
2018,Agosto,Honduras,340,103,150,,253,"(4.697144,-74.140516)"
2018,Agosto,Honduras,340,10,10,,20,"(4.815061,-75.736532)"
2018,Agosto,Honduras,340,49,85,,134,"(6.171601,-75.427454)"
2018,Agosto,Honduras,340,3,1,,4,"(7.128456,-73.183637)"
2018,Agosto,Hong Kong,344,2,3,,5,"(3.541112,-76.384584)"
2018,Agosto,Hong Kong,344,19,19,,38,"(4.697144,-74.140516)"
2018,Agosto,Hong Kong,344,1,2,,3,"(6.171601,-75.427454)"
2018,Agosto,Hungría,348,7,12,,19,"(4.697144,-74.140516)"
2018,Agosto,Hungría,348,3,1,,4,"(6.171601,-75.427454)"
2018,Agosto,India,356,1,0,,1,"(10.445761,-75.516429)"
2018,Agosto,India,356,0,1,,1,"(3.541112,-76.384584)"
2018,Agosto,India,356,31,22,,53,"(4.697144,-74.140516)"
2018,Agosto,India,356,13,2,,15,"(6.171601,-75.427454)"
2018,Agosto,Indonesia,360,1,1,,2,"(3.541112,-76.384584)"
2018,Agosto,Indonesia,360,4,8,,12,"(4.697144,-74.140516)"
2018,Agosto,Indonesia,360,0,1,,1,"(6.171601,-75.427454)"
2018,Agosto,Iraq,368,0,3,,3,"(4.697144,-74.140516)"
2018,Agosto,Irán,364,0,1,,1,"(4.697144,-74.140516)"
2018,Agosto,República de Irlanda,372,0,1,,1,"(10.445761,-75.516429)"
2018,Agosto,República de Irlanda,372,3,3,,6,"(3.541112,-76.384584)"
2018,Agosto,República de Irlanda,372,30,15,,45,"(4.697144,-74.140516)"
2018,Agosto,República de Irlanda,372,1,0,,1,"(6.171601,-75.427454)"
2018,Agosto,República de Irlanda,372,1,0,,1,"(7.128456,-73.183637)"
2018,Agosto,Islandia,352,1,0,,1,"(10.445761,-75.516429)"
2018,Agosto,Islandia,352,2,1,,3,"(4.697144,-74.140516)"
2018,Agosto,Islandia,352,1,2,,3,"(6.171601,-75.427454)"
2018,Agosto,Israel,376,2,0,,2,"(10.445761,-75.516429)"
2018,Agosto,Israel,376,2,0,,2,"(10.886611,-74.776708)"
2018,Agosto,Israel,376,11,4,,15,"(3.541112,-76.384584)"
2018,Agosto,Israel,376,72,61,,133,"(4.697144,-74.140516)"
2018,Agosto,Israel,376,9,6,,15,"(6.171601,-75.427454)"
2018,Agosto,Israel,376,1,0,,1,"(7.128456,-73.183637)"
2018,Agosto,Italia,380,17,13,,30,"(10.445761,-75.516429)"
2018,Agosto,Italia,380,15,9,,24,"(10.886611,-74.776708)"
2018,Agosto,Italia,380,0,1,,1,"(12.586067,-81.702563)"
2018,Agosto,Italia,380,108,45,,153,"(3.541112,-76.384584)"
2018,Agosto,Italia,380,617,403,,1020,"(4.697144,-74.140516)"
2018,Agosto,Italia,380,8,2,,10,"(4.815061,-75.736532)"
2018,Agosto,Italia,380,126,60,,186,"(6.171601,-75.427454)"
2018,Agosto,Italia,380,1,1,,2,"(7.128456,-73.183637)"
2018,Agosto,Jamaica,388,4,4,,8,"(10.445761,-75.516429)"
2018,Agosto,Jamaica,388,2,0,,2,"(10.886611,-74.776708)"
2018,Agosto,Jamaica,388,0,2,,2,"(12.586067,-81.702563)"
2018,Agosto,Jamaica,388,6,6,,12,"(3.541112,-76.384584)"
2018,Agosto,Jamaica,388,31,38,,69,"(4.697144,-74.140516)"
2018,Agosto,Jamaica,388,6,3,,9,"(4.815061,-75.736532)"
2018,Agosto,Jamaica,388,23,14,,37,"(6.171601,-75.427454)"
2018,Agosto,Islas Salomón,90,0,1,,1,"(4.697144,-74.140516)"
2018,Agosto,Japón,392,3,1,,4,"(10.445761,-75.516429)"
2018,Agosto,Japón,392,1,0,,1,"(10.886611,-74.776708)"
2018,Agosto,Japón,392,75,67,,142,"(4.697144,-74.140516)"
2018,Agosto,Japón,392,7,5,,12,"(6.171601,-75.427454)"
2018,Agosto,Jordania,400,1,0,,1,"(10.886611,-74.776708)"
2018,Agosto,Jordania,400,4,0,,4,"(4.697144,-74.140516)"
2018,Agosto,Kazajistán,398,3,1,,4,"(4.697144,-74.140516)"
2018,Agosto,Kazajistán,398,0,1,,1,"(6.171601,-75.427454)"
2018,Agosto,Kenia,404,5,2,,7,"(4.697144,-74.140516)"
2018,Agosto,Kuwait,414,3,2,,5,"(10.445761,-75.516429)"
2018,Agosto,Kuwait,414,1,0,,1,"(10.886611,-74.776708)"
2018,Agosto,Kuwait,414,7,4,,11,"(4.697144,-74.140516)"
2018,Agosto,Kuwait,414,2,1,,3,"(6.171601,-75.427454)"
2018,Agosto,República Democrática Popular  Lao,418,1,2,,3,"(4.697144,-74.140516)"
2018,Agosto,Letonia,428,4,3,,7,"(4.697144,-74.140516)"
2018,Agosto,Lituania,440,1,0,,1,"(4.697144,-74.140516)"
2018,Agosto,Líbano,422,4,7,,11,"(10.886611,-74.776708)"
2018,Agosto,Líbano,422,1,0,,1,"(3.541112,-76.384584)"
2018,Agosto,Líbano,422,15,16,,31,"(4.697144,-74.140516)"
2018,Agosto,Libia,434,0,1,,1,"(4.697144,-74.140516)"
2018,Agosto,Luxemburgo,442,1,0,,1,"(10.445761,-75.516429)"
2018,Agosto,Luxemburgo,442,2,0,,2,"(3.541112,-76.384584)"
2018,Agosto,Luxemburgo,442,11,7,,18,"(4.697144,-74.140516)"
2018,Agosto,Luxemburgo,442,1,0,,1,"(4.815061,-75.736532)"
2018,Agosto,Luxemburgo,442,3,3,,6,"(6.171601,-75.427454)"
2018,Agosto,Madagascar,450,0,1,,1,"(4.697144,-74.140516)"
2018,Agosto,Madagascar,450,1,0,,1,"(6.171601,-75.427454)"
2018,Agosto,Malasia,458,4,1,,5,"(4.697144,-74.140516)"
2018,Agosto,Malasia,458,1,1,,2,"(6.171601,-75.427454)"
2018,Agosto,Malawi,454,2,2,,4,"(4.697144,-74.140516)"
2018,Agosto,Malta,470,1,0,,1,"(10.445761,-75.516429)"
2018,Agosto,Malta,470,0,1,,1,"(3.541112,-76.384584)"
2018,Agosto,Malta,470,21,15,,36,"(4.697144,-74.140516)"
2018,Agosto,Malta,470,2,3,,5,"(6.171601,-75.427454)"
2018,Agosto,Marruecos,504,10,7,,17,"(4.697144,-74.140516)"
2018,Agosto,Marruecos,504,1,0,,1,"(6.171601,-75.427454)"
2018,Agosto,Mauricio,480,0,2,,2,"(4.697144,-74.140516)"
2018,Agosto,Mauritania,478,0,1,,1,"(4.697144,-74.140516)"
2018,Agosto,Martinica/Departamento de Ultramar Francés,474,1,0,,1,"(10.445761,-75.516429)"
2018,Agosto,Martinica/Departamento de Ultramar Francés,474,1,0,,1,"(10.886611,-74.776708)"
2018,Agosto,Martinica/Departamento de Ultramar Francés,474,0,1,,1,"(4.697144,-74.140516)"
2018,Agosto,México,484,58,74,,132,"(10.408582,-75.538003)"
2018,Agosto,México,484,113,88,,201,"(10.445761,-75.516429)"
2018,Agosto,México,484,178,184,,362,"(10.886611,-74.776708)"
2018,Agosto,México,484,3,5,,8,"(11.117806,-74.232622)"
2018,Agosto,México,484,10,8,,18,"(12.586067,-81.702563)"
2018,Agosto,México,484,1036,822,,1858,"(3.541112,-76.384584)"
2018,Agosto,México,484,0,1,,1,"(4.452882,-75.766298)"
2018,Agosto,México,484,17441,14800,,32241,"(4.697144,-74.140516)"
2018,Agosto,México,484,301,202,,503,"(4.815061,-75.736532)"
2018,Agosto,México,484,2704,2010,,4714,"(6.171601,-75.427454)"
2018,Agosto,México,484,113,68,,181,"(7.128456,-73.183637)"
2018,Agosto,Mongolia,496,1,0,,1,"(4.697144,-74.140516)"
2018,Agosto,Mongolia,496,0,1,,1,"(6.171601,-75.427454)"
2018,Agosto,Montenegro,499,0,1,,1,"(3.541112,-76.384584)"
2018,Agosto,Mozambique,508,1,1,,2,"(4.697144,-74.140516)"
2018,Agosto,Myanmar,104,1,1,,2,"(4.697144,-74.140516)"
2018,Agosto,Nepal,524,0,2,,2,"(4.697144,-74.140516)"
2018,Agosto,Nicaragua,558,3,8,,11,"(10.445761,-75.516429)"
2018,Agosto,Nicaragua,558,3,1,,4,"(10.886611,-74.776708)"
2018,Agosto,Nicaragua,558,5,23,,28,"(3.541112,-76.384584)"
2018,Agosto,Nicaragua,558,23,39,,62,"(4.697144,-74.140516)"
2018,Agosto,Nicaragua,558,4,5,,9,"(4.815061,-75.736532)"
2018,Agosto,Nicaragua,558,17,38,,55,"(6.171601,-75.427454)"
2018,Agosto,Nicaragua,558,0,2,,2,"(7.128456,-73.183637)"
2018,Agosto,Nigeria,566,1,1,,2,"(10.445761,-75.516429)"
2018,Agosto,Nigeria,566,0,1,,1,"(4.697144,-74.140516)"
2018,Agosto,Noruega,578,0,1,,1,"(10.445761,-75.516429)"
2018,Agosto,Noruega,578,3,1,,4,"(10.886611,-74.776708)"
2018,Agosto,Noruega,578,8,6,,14,"(3.541112,-76.384584)"
2018,Agosto,Noruega,578,35,32,,67,"(4.697144,-74.140516)"
2018,Agosto,Noruega,578,1,0,,1,"(4.815061,-75.736532)"
2018,Agosto,Noruega,578,4,7,,11,"(6.171601,-75.427454)"
2018,Agosto,Nueva Zelanda,554,42,29,,71,"(4.697144,-74.140516)"
2018,Agosto,Nueva Zelanda,554,3,0,,3,"(4.815061,-75.736532)"
2018,Agosto,Nueva Zelanda,554,0,2,,2,"(6.171601,-75.427454)"
2018,Agosto,Omán,512,0,1,,1,"(3.541112,-76.384584)"
2018,Agosto,Omán,512,6,10,,16,"(4.697144,-74.140516)"
2018,Agosto,Omán,512,2,3,,5,"(6.171601,-75.427454)"
2018,Agosto,Pakistán,586,0,1,,1,"(4.697144,-74.140516)"
2018,Agosto,Palau,585,1,0,,1,"(4.697144,-74.140516)"
2018,Agosto,Panamá,591,67,114,,181,"(10.408582,-75.538003)"
2018,Agosto,Panamá,591,1191,1048,,2239,"(10.445761,-75.516429)"
2018,Agosto,Panamá,591,779,678,,1457,"(10.886611,-74.776708)"
2018,Agosto,Panamá,591,0,21,,21,"(12.165168,-71.983761)"
2018,Agosto,Panamá,591,4,31,,35,"(12.5744111,-81.703935)"
2018,Agosto,Panamá,591,67,59,,126,"(12.586067,-81.702563)"
2018,Agosto,Panamá,591,0,1,,1,"(13.3387613,-81.372937)"
2018,Agosto,Panamá,591,2194,1903,,4097,"(3.541112,-76.384584)"
2018,Agosto,Panamá,591,269,147,,416,"(4.452882,-75.766298)"
2018,Agosto,Panamá,591,8186,8859,,17045,"(4.697144,-74.140516)"
2018,Agosto,Panamá,591,310,235,,545,"(4.815061,-75.736532)"
2018,Agosto,Panamá,591,3396,2891,,6287,"(6.171601,-75.427454)"
2018,Agosto,Panamá,591,0,1,,1,"(6.228046,-77.404104)"
2018,Agosto,Panamá,591,8,35,,43,"(7.102626,-77.762647)"
2018,Agosto,Panamá,591,228,185,,413,"(7.128456,-73.183637)"
2018,Agosto,Panamá,591,0,17,,17,"(8.066966,-76.735404)"
2018,Agosto,Panamá,591,20,40,,60,"(8.635765,-77.346578)"
2018,Agosto,Paraguay,600,1,1,,2,"(0.814836,-77.662532)"
2018,Agosto,Paraguay,600,0,2,,2,"(10.445761,-75.516429)"
2018,Agosto,Paraguay,600,6,4,,10,"(10.886611,-74.776708)"
2018,Agosto,Paraguay,600,30,34,,64,"(3.541112,-76.384584)"
2018,Agosto,Paraguay,600,96,232,,328,"(4.697144,-74.140516)"
2018,Agosto,Paraguay,600,9,21,,30,"(4.815061,-75.736532)"
2018,Agosto,Paraguay,600,30,53,,83,"(6.171601,-75.427454)"
2018,Agosto,Paraguay,600,6,8,,14,"(7.128456,-73.183637)"
2018,Agosto,Perú,604,4,6,,10,"(-0.193180,-74.784874)"
2018,Agosto,Perú,604,45,51,,96,"(-4.197703,-69.941278)"
2018,Agosto,Perú,604,52,62,,114,"(-4.223468,-69.945098)"
2018,Agosto,Perú,604,11,13,,24,"(0.25129,-76.875963)"
2018,Agosto,Perú,604,3,1,,4,"(0.812436,-77.847006)"
2018,Agosto,Perú,604,87,96,,183,"(0.814836,-77.662532)"
2018,Agosto,Perú,604,57,56,,113,"(10.445761,-75.516429)"
2018,Agosto,Perú,604,7,6,,13,"(10.886611,-74.776708)"
2018,Agosto,Perú,604,3,1,,4,"(12.586067,-81.702563)"
2018,Agosto,Perú,604,185,201,,386,"(3.541112,-76.384584)"
2018,Agosto,Perú,604,5525,5868,,11393,"(4.697144,-74.140516)"
2018,Agosto,Perú,604,3,7,,10,"(4.815061,-75.736532)"
2018,Agosto,Perú,604,548,532,,1080,"(6.171601,-75.427454)"
2018,Agosto,Perú,604,3,3,,6,"(7.128456,-73.183637)"
2018,Agosto,Polonia,616,1,0,,1,"(10.445761,-75.516429)"
2018,Agosto,Polonia,616,1,3,,4,"(3.541112,-76.384584)"
2018,Agosto,Polonia,616,12,26,,38,"(4.697144,-74.140516)"
2018,Agosto,Portugal,620,7,2,,9,"(3.541112,-76.384584)"
2018,Agosto,Portugal,620,74,82,,156,"(4.697144,-74.140516)"
2018,Agosto,Portugal,620,22,17,,39,"(6.171601,-75.427454)"
2018,Agosto,Puerto Rico/Territorio de Estados Unidos,630,4,6,,10,"(10.445761,-75.516429)"
2018,Agosto,Puerto Rico/Territorio de Estados Unidos,630,7,7,,14,"(10.886611,-74.776708)"
2018,Agosto,Puerto Rico/Territorio de Estados Unidos,630,24,19,,43,"(3.541112,-76.384584)"
2018,Agosto,Puerto Rico/Territorio de Estados Unidos,630,505,472,,977,"(4.697144,-74.140516)"
2018,Agosto,Puerto Rico/Territorio de Estados Unidos,630,6,6,,12,"(4.815061,-75.736532)"
2018,Agosto,Puerto Rico/Territorio de Estados Unidos,630,30,20,,50,"(6.171601,-75.427454)"
2018,Agosto,Puerto Rico/Territorio de Estados Unidos,630,3,2,,5,"(7.128456,-73.183637)"
2018,Agosto,Qatar,634,31,22,,53,"(4.697144,-74.140516)"
2018,Agosto,Qatar,634,9,6,,15,"(6.171601,-75.427454)"
2018,Agosto,Reino Unido de Gran Bretaña e Irlanda del Norte,826,7,3,,10,"(10.886611,-74.776708)"
2018,Agosto,Reino Unido de Gran Bretaña e Irlanda del Norte,826,174,123,,297,"(3.541112,-76.384584)"
2018,Agosto,Reino Unido de Gran Bretaña e Irlanda del Norte,826,1742,1204,,2946,"(4.697144,-74.140516)"
2018,Agosto,Reino Unido de Gran Bretaña e Irlanda del Norte,826,1,0,,1,"(4.815061,-75.736532)"
2018,Agosto,Reino Unido de Gran Bretaña e Irlanda del Norte,826,54,40,,94,"(6.171601,-75.427454)"
2018,Agosto,Reino Unido de Gran Bretaña e Irlanda del Norte,826,1,1,,2,"(7.128456,-73.183637)"
2018,Agosto,República CentroÁfricana,140,1,1,,2,"(4.697144,-74.140516)"
2018,Agosto,República CentroÁfricana,140,0,1,,1,"(6.171601,-75.427454)"
2018,Agosto,Federación de Rusia,643,1,2,,3,"(3.541112,-76.384584)"
2018,Agosto,Federación de Rusia,643,49,45,,94,"(4.697144,-74.140516)"
2018,Agosto,Federación de Rusia,643,0,1,,1,"(4.815061,-75.736532)"
2018,Agosto,Federación de Rusia,643,3,8,,11,"(6.171601,-75.427454)"
2018,Agosto,República Dominicana,214,18,22,,40,"(10.445761,-75.516429)"
2018,Agosto,República Dominicana,214,23,33,,56,"(10.886611,-74.776708)"
2018,Agosto,República Dominicana,214,1,1,,2,"(12.586067,-81.702563)"
2018,Agosto,República Dominicana,214,130,111,,241,"(3.541112,-76.384584)"
2018,Agosto,República Dominicana,214,4412,3824,,8236,"(4.697144,-74.140516)"
2018,Agosto,República Dominicana,214,79,60,,139,"(4.815061,-75.736532)"
2018,Agosto,República Dominicana,214,288,202,,490,"(6.171601,-75.427454)"
2018,Agosto,República Dominicana,214,41,31,,72,"(7.128456,-73.183637)"
2018,Agosto,Reunión,638,0,1,,1,"(4.697144,-74.140516)"
2018,Agosto,República Democrática Popular de Corea,408,1,0,,1,"(4.697144,-74.140516)"
2018,Agosto,Rumania,642,0,1,,1,"(10.445761,-75.516429)"
2018,Agosto,Rumania,642,2,2,,4,"(4.697144,-74.140516)"
2018,Agosto,Rumania,642,2,1,,3,"(6.171601,-75.427454)"
2018,Agosto,Rwanda,646,0,2,,2,"(4.697144,-74.140516)"
2018,Agosto,San Marino,674,0,2,,2,"(4.697144,-74.140516)"
2018,Agosto,Santo Tomé y Príncipe,678,0,2,,2,"(4.697144,-74.140516)"
2018,Agosto,Senegal,686,2,1,,3,"(6.171601,-75.427454)"
2018,Agosto,Serbia,688,6,6,,12,"(4.697144,-74.140516)"
2018,Agosto,Singapur,702,6,13,,19,"(4.697144,-74.140516)"
2018,Agosto,Sri Lanka,144,1,0,,1,"(4.697144,-74.140516)"
2018,Agosto,Sudáfrica,710,1,0,,1,"(3.541112,-76.384584)"
2018,Agosto,Sudáfrica,710,20,33,,53,"(4.697144,-74.140516)"
2018,Agosto,Sudáfrica,710,1,1,,2,"(6.171601,-75.427454)"
2018,Agosto,Suecia,752,1,1,,2,"(10.445761,-75.516429)"
2018,Agosto,Suecia,752,4,3,,7,"(10.886611,-74.776708)"
2018,Agosto,Suecia,752,16,10,,26,"(3.541112,-76.384584)"
2018,Agosto,Suecia,752,73,71,,144,"(4.697144,-74.140516)"
2018,Agosto,Suecia,752,0,1,,1,"(4.815061,-75.736532)"
2018,Agosto,Suecia,752,19,9,,28,"(6.171601,-75.427454)"
2018,Agosto,Suiza,756,4,3,,7,"(10.445761,-75.516429)"
2018,Agosto,Suiza,756,2,3,,5,"(10.886611,-74.776708)"
2018,Agosto,Suiza,756,78,40,,118,"(3.541112,-76.384584)"
2018,Agosto,Suiza,756,384,235,,619,"(4.697144,-74.140516)"
2018,Agosto,Suiza,756,44,32,,76,"(6.171601,-75.427454)"
2018,Agosto,Surinam,740,0,8,,8,"(10.408582,-75.538003)"
2018,Agosto,Surinam,740,2,17,,19,"(4.697144,-74.140516)"
2018,Agosto,Taiwán,158,1,1,,2,"(3.541112,-76.384584)"
2018,Agosto,Taiwán,158,4,12,,16,"(4.697144,-74.140516)"
2018,Agosto,República de Tayikistán,762,0,1,,1,"(3.541112,-76.384584)"
2018,Agosto,República de Tayikistán,762,0,1,,1,"(4.697144,-74.140516)"
2018,Agosto,Tailandia,764,1,1,,2,"(10.445761,-75.516429)"
2018,Agosto,Tailandia,764,27,14,,41,"(4.697144,-74.140516)"
2018,Agosto,Tailandia,764,1,0,,1,"(6.171601,-75.427454)"
2018,Agosto,Tanzania,834,6,4,,10,"(4.697144,-74.140516)"
2018,Agosto,Trinidad y Tobago,780,1,1,,2,"(10.408582,-75.538003)"
2018,Agosto,Trinidad y Tobago,780,1,2,,3,"(10.445761,-75.516429)"
2018,Agosto,Trinidad y Tobago,780,0,4,,4,"(10.886611,-74.776708)"
2018,Agosto,Trinidad y Tobago,780,9,1,,10,"(3.541112,-76.384584)"
2018,Agosto,Trinidad y Tobago,780,17,28,,45,"(4.697144,-74.140516)"
2018,Agosto,Trinidad y Tobago,780,0,1,,1,"(4.815061,-75.736532)"
2018,Agosto,Trinidad y Tobago,780,7,6,,13,"(6.171601,-75.427454)"
2018,Agosto,Trinidad y Tobago,780,1,3,,4,"(7.128456,-73.183637)"
2018,Agosto,Túnez,788,3,3,,6,"(4.697144,-74.140516)"
2018,Agosto,Túnez,788,1,0,,1,"(6.171601,-75.427454)"
2018,Agosto,Turquía,792,3,2,,5,"(3.541112,-76.384584)"
2018,Agosto,Turquía,792,731,335,,1066,"(4.697144,-74.140516)"
2018,Agosto,Turquía,792,9,10,,19,"(6.171601,-75.427454)"
2018,Agosto,Turkmenistán,795,7,5,,12,"(4.697144,-74.140516)"
2018,Agosto,Ucrania,804,4,5,,9,"(4.697144,-74.140516)"
2018,Agosto,Uganda,800,0,1,,1,"(4.697144,-74.140516)"
2018,Agosto,Uruguay,858,1,0,,1,"(0.814836,-77.662532)"
2018,Agosto,Uruguay,858,2,0,,2,"(10.445761,-75.516429)"
2018,Agosto,Uruguay,858,1,2,,3,"(10.886611,-74.776708)"
2018,Agosto,Uruguay,858,6,10,,16,"(3.541112,-76.384584)"
2018,Agosto,Uruguay,858,325,343,,668,"(4.697144,-74.140516)"
2018,Agosto,Uruguay,858,4,6,,10,"(4.815061,-75.736532)"
2018,Agosto,Uruguay,858,10,20,,30,"(6.171601,-75.427454)"
2018,Agosto,Vanuatu,548,0,1,,1,"(4.697144,-74.140516)"
2018,Agosto,Venezuela,862,0,11,,11,"(10.408582,-75.538003)"
2018,Agosto,Venezuela,862,5,5,,10,"(10.445761,-75.516429)"
2018,Agosto,Venezuela,862,11,13,,24,"(10.886611,-74.776708)"
2018,Agosto,Venezuela,862,1367,1589,,2956,"(11.360009,-72.129330)"
2018,Agosto,Venezuela,862,0,1,,1,"(12.165168,-71.983761)"
2018,Agosto,Venezuela,862,654,468,,1122,"(3.541112,-76.384584)"
2018,Agosto,Venezuela,862,1,4,,5,"(3.866713,-67.927521)"
2018,Agosto,Venezuela,862,1189,1124,,2313,"(4.697144,-74.140516)"
2018,Agosto,Venezuela,862,3,7,,10,"(4.815061,-75.736532)"
2018,Agosto,Venezuela,862,852,639,,1491,"(6.171601,-75.427454)"
2018,Agosto,Venezuela,862,24,37,,61,"(6.185799,-67.483929)"
2018,Agosto,Venezuela,862,509,528,,1037,"(7.088729,-70.740253)"
2018,Agosto,Venezuela,862,3,2,,5,"(7.128456,-73.183637)"
2018,Agosto,Venezuela,862,822,930,,1752,"(7.818934,-72.453226)"
2018,Agosto,Venezuela,862,0,1,,1,"(7.927209,-72.507910)"
2018,Agosto,Venezuela,862,241,267,,508,"(8.36068,-72.409396)"
2018,Agosto,Vietnam,704,1,1,,2,"(4.697144,-74.140516)"
2018,Agosto,Islas Vírgenes Británicas/Territorio Británico de Ultramar,92,1,0,,1,"(4.697144,-74.140516)"
2018,Agosto,Zambia,894,1,0,,1,"(4.697144,-74.140516)"
2018,Septiembre,Albania,8,0,2,,2,"(4.697144,-74.140516)"
2018,Septiembre,Alemania,276,21,12,,33,"(10.445761,-75.516429)"
2018,Septiembre,Alemania,276,23,17,,40,"(10.886611,-74.776708)"
2018,Septiembre,Alemania,276,1,0,,1,"(12.586067,-81.702563)"
2018,Septiembre,Alemania,276,71,74,,145,"(3.541112,-76.384584)"
2018,Septiembre,Alemania,276,1902,1641,,3543,"(4.697144,-74.140516)"
2018,Septiembre,Alemania,276,3,5,,8,"(4.815061,-75.736532)"
2018,Septiembre,Alemania,276,149,141,,290,"(6.171601,-75.427454)"
2018,Septiembre,Alemania,276,3,1,,4,"(7.128456,-73.183637)"
2018,Septiembre,Andorra,20,3,1,,4,"(4.697144,-74.140516)"
2018,Septiembre,Angola,24,0,1,,1,"(3.541112,-76.384584)"
2018,Septiembre,Angola,24,2,6,,8,"(4.697144,-74.140516)"
2018,Septiembre,Antigua y Barbuda,28,6,5,,11,"(4.697144,-74.140516)"
2018,Septiembre,Antigua y Barbuda,28,0,3,,3,"(4.815061,-75.736532)"
2018,Septiembre,Países Bajos,528,169,117,,286,"(10.445761,-75.516429)"
2018,Septiembre,Países Bajos,528,11,18,,29,"(10.886611,-74.776708)"
2018,Septiembre,Países Bajos,528,0,3,,3,"(11.117806,-74.232622)"
2018,Septiembre,Países Bajos,528,73,41,,114,"(3.541112,-76.384584)"
2018,Septiembre,Países Bajos,528,969,860,,1829,"(4.697144,-74.140516)"
2018,Septiembre,Países Bajos,528,13,6,,19,"(4.815061,-75.736532)"
2018,Septiembre,Países Bajos,528,114,78,,192,"(6.171601,-75.427454)"
2018,Septiembre,Países Bajos,528,1,0,,1,"(7.128456,-73.183637)"
2018,Septiembre,Arabia Saudita,682,4,4,,8,"(3.541112,-76.384584)"
2018,Septiembre,Arabia Saudita,682,10,37,,47,"(4.697144,-74.140516)"
2018,Septiembre,Arabia Saudita,682,2,2,,4,"(6.171601,-75.427454)"
2018,Septiembre,Argelia,12,2,8,,10,"(4.697144,-74.140516)"
2018,Septiembre,Argentina,32,2,5,,7,"(0.814836,-77.662532)"
2018,Septiembre,Argentina,32,0,1,,1,"(1.813928,-78.763924)"
2018,Septiembre,Argentina,32,36,19,,55,"(10.445761,-75.516429)"
2018,Septiembre,Argentina,32,34,28,,62,"(10.886611,-74.776708)"
2018,Septiembre,Argentina,32,2,0,,2,"(12.586067,-81.702563)"
2018,Septiembre,Argentina,32,130,113,,243,"(3.541112,-76.384584)"
2018,Septiembre,Argentina,32,2548,2560,,5108,"(4.697144,-74.140516)"
2018,Septiembre,Argentina,32,42,36,,78,"(4.815061,-75.736532)"
2018,Septiembre,Argentina,32,201,195,,396,"(6.171601,-75.427454)"
2018,Septiembre,Argentina,32,7,8,,15,"(7.128456,-73.183637)"
2018,Septiembre,República de Armenia,51,0,2,,2,"(4.697144,-74.140516)"
2018,Septiembre,Aruba,533,2908,1916,,4824,"(10.408582,-75.538003)"
2018,Septiembre,Aruba,533,3,2,,5,"(10.445761,-75.516429)"
2018,Septiembre,Aruba,533,9,15,,24,"(10.886611,-74.776708)"
2018,Septiembre,Aruba,533,7,9,,16,"(11.247723,-74.213989)"
2018,Septiembre,Aruba,533,2,12,,14,"(12.165168,-71.983761)"
2018,Septiembre,Aruba,533,30,20,,50,"(3.541112,-76.384584)"
2018,Septiembre,Aruba,533,1794,1340,,3134,"(4.697144,-74.140516)"
2018,Septiembre,Aruba,533,4,5,,9,"(4.815061,-75.736532)"
2018,Septiembre,Aruba,533,67,53,,120,"(6.171601,-75.427454)"
2018,Septiembre,Aruba,533,17,29,,46,"(7.128456,-73.183637)"
2018,Septiembre,Australia,36,3,3,,6,"(10.445761,-75.516429)"
2018,Septiembre,Australia,36,1,2,,3,"(10.886611,-74.776708)"
2018,Septiembre,Australia,36,8,9,,17,"(3.541112,-76.384584)"
2018,Septiembre,Australia,36,332,265,,597,"(4.697144,-74.140516)"
2018,Septiembre,Australia,36,9,4,,13,"(4.815061,-75.736532)"
2018,Septiembre,Australia,36,50,31,,81,"(6.171601,-75.427454)"
2018,Septiembre,Australia,36,2,0,,2,"(7.128456,-73.183637)"
2018,Septiembre,Austria,40,1,3,,4,"(10.445761,-75.516429)"
2018,Septiembre,Austria,40,0,3,,3,"(10.886611,-74.776708)"
2018,Septiembre,Austria,40,3,1,,4,"(3.541112,-76.384584)"
2018,Septiembre,Austria,40,60,68,,128,"(4.697144,-74.140516)"
2018,Septiembre,Austria,40,10,15,,25,"(6.171601,-75.427454)"
2018,Septiembre,Azerbaiyán,31,0,1,,1,"(4.697144,-74.140516)"
2018,Septiembre,Bahamas,44,8,5,,13,"(3.541112,-76.384584)"
2018,Septiembre,Bahamas,44,15,24,,39,"(4.697144,-74.140516)"
2018,Septiembre,Bahamas,44,2,2,,4,"(4.815061,-75.736532)"
2018,Septiembre,Bahamas,44,20,23,,43,"(6.171601,-75.427454)"
2018,Septiembre,Bahamas,44,1,0,,1,"(7.128456,-73.183637)"
2018,Septiembre,Bahréin,48,1,1,,2,"(3.541112,-76.384584)"
2018,Septiembre,Bahréin,48,0,1,,1,"(4.452882,-75.766298)"
2018,Septiembre,Bahréin,48,1,4,,5,"(4.697144,-74.140516)"
2018,Septiembre,Bahréin,48,1,0,,1,"(6.171601,-75.427454)"
2018,Septiembre,Bangladesh,50,1,0,,1,"(4.697144,-74.140516)"
2018,Septiembre,Barbados,52,2,5,,7,"(4.697144,-74.140516)"
2018,Septiembre,Barbados,52,1,1,,2,"(4.815061,-75.736532)"
2018,Septiembre,Barbados,52,1,1,,2,"(6.171601,-75.427454)"
2018,Septiembre,República de Belarús,112,0,1,,1,"(11.360009,-72.129330)"
2018,Septiembre,República de Belarús,112,0,1,,1,"(4.697144,-74.140516)"
2018,Septiembre,Bélgica,56,2,0,,2,"(10.445761,-75.516429)"
2018,Septiembre,Bélgica,56,2,4,,6,"(10.886611,-74.776708)"
2018,Septiembre,Bélgica,56,13,11,,24,"(3.541112,-76.384584)"
2018,Septiembre,Bélgica,56,112,90,,202,"(4.697144,-74.140516)"
2018,Septiembre,Bélgica,56,2,2,,4,"(4.815061,-75.736532)"
2018,Septiembre,Bélgica,56,28,32,,60,"(6.171601,-75.427454)"
2018,Septiembre,Belice,84,2,0,,2,"(12.586067,-81.702563)"
2018,Septiembre,Belice,84,10,5,,15,"(4.697144,-74.140516)"
2018,Septiembre,Belice,84,0,1,,1,"(4.815061,-75.736532)"
2018,Septiembre,Belice,84,3,4,,7,"(6.171601,-75.427454)"
2018,Septiembre,Bermudas/Territorio Británico de Ultramar,60,1,1,,2,"(4.697144,-74.140516)"
2018,Septiembre,Bermudas/Territorio Británico de Ultramar,60,2,2,,4,"(6.171601,-75.427454)"
2018,Septiembre,Bermudas/Territorio Británico de Ultramar,60,1,0,,1,"(7.102626,-77.762647)"
2018,Septiembre,Bolivia,68,0,4,,4,"(0.814836,-77.662532)"
2018,Septiembre,Bolivia,68,0,2,,2,"(10.445761,-75.516429)"
2018,Septiembre,Bolivia,68,4,1,,5,"(10.886611,-74.776708)"
2018,Septiembre,Bolivia,68,19,36,,55,"(3.541112,-76.384584)"
2018,Septiembre,Bolivia,68,313,472,,785,"(4.697144,-74.140516)"
2018,Septiembre,Bolivia,68,6,4,,10,"(4.815061,-75.736532)"
2018,Septiembre,Bolivia,68,28,46,,74,"(6.171601,-75.427454)"
2018,Septiembre,Bolivia,68,0,1,,1,"(7.128456,-73.183637)"
2018,Septiembre,Bosnia y Herzegovina,70,4,3,,7,"(4.697144,-74.140516)"
2018,Septiembre,Botsuana,72,1,0,,1,"(10.886611,-74.776708)"
2018,Septiembre,Botsuana,72,0,1,,1,"(4.697144,-74.140516)"
2018,Septiembre,Brasil,76,145,214,,359,"(-4.197703,-69.941278)"
2018,Septiembre,Brasil,76,5,12,,17,"(-4.223468,-69.945098)"
2018,Septiembre,Brasil,76,7,7,,14,"(10.445761,-75.516429)"
2018,Septiembre,Brasil,76,22,18,,40,"(10.886611,-74.776708)"
2018,Septiembre,Brasil,76,2,3,,5,"(12.586067,-81.702563)"
2018,Septiembre,Brasil,76,76,138,,214,"(3.541112,-76.384584)"
2018,Septiembre,Brasil,76,3729,4713,,8443,"(4.697144,-74.140516)"
2018,Septiembre,Brasil,76,20,29,,49,"(4.815061,-75.736532)"
2018,Septiembre,Brasil,76,163,167,,330,"(6.171601,-75.427454)"
2018,Septiembre,Brasil,76,6,6,,12,"(7.128456,-73.183637)"
2018,Septiembre,Bulgaria,100,4,2,,6,"(4.697144,-74.140516)"
2018,Septiembre,Cabo Verde,132,0,1,,1,"(4.697144,-74.140516)"
2018,Septiembre,Islas Caimán/Territorio Británico de Ultramar,136,2,1,,3,"(12.586067,-81.702563)"
2018,Septiembre,Islas Caimán/Territorio Británico de Ultramar,136,1,1,,2,"(3.541112,-76.384584)"
2018,Septiembre,Islas Caimán/Territorio Británico de Ultramar,136,3,4,,7,"(4.697144,-74.140516)"
2018,Septiembre,Camboya,116,1,0,,1,"(4.697144,-74.140516)"
2018,Septiembre,Camboya,116,1,0,,1,"(6.171601,-75.427454)"
2018,Septiembre,Camerún,120,1,0,,1,"(4.697144,-74.140516)"
2018,Septiembre,Canadá,124,37,29,,66,"(10.445761,-75.516429)"
2018,Septiembre,Canadá,124,47,31,,78,"(10.886611,-74.776708)"
2018,Septiembre,Canadá,124,164,119,,283,"(3.541112,-76.384584)"
2018,Septiembre,Canadá,124,1,1,,2,"(4.452882,-75.766298)"
2018,Septiembre,Canadá,124,2172,1734,,3906,"(4.697144,-74.140516)"
2018,Septiembre,Canadá,124,16,24,,40,"(4.815061,-75.736532)"
2018,Septiembre,Canadá,124,338,307,,645,"(6.171601,-75.427454)"
2018,Septiembre,Canadá,124,16,17,,33,"(7.128456,-73.183637)"
2018,Septiembre,Chad,148,0,2,,2,"(4.697144,-74.140516)"
2018,Septiembre,España,724,19,10,,29,"(10.445761,-75.516429)"
2018,Septiembre,España,724,40,40,,80,"(10.886611,-74.776708)"
2018,Septiembre,España,724,0,1,,1,"(12.586067,-81.702563)"
2018,Septiembre,España,724,3025,2113,,5138,"(3.541112,-76.384584)"
2018,Septiembre,España,724,16126,11576,,27702,"(4.697144,-74.140516)"
2018,Septiembre,España,724,16,13,,29,"(4.815061,-75.736532)"
2018,Septiembre,España,724,2577,1811,,4388,"(6.171601,-75.427454)"
2018,Septiembre,España,724,5,2,,7,"(7.128456,-73.183637)"
2018,Septiembre,Colombia,170,2,13,,15,"(10.445761,-75.516429)"
2018,Septiembre,Colombia,170,308,669,,978,"(4.697144,-74.140516)"
2018,Septiembre,República Del Congo,178,0,1,,1,"(4.697144,-74.140516)"
2018,Septiembre,República de Corea,410,1,1,,2,"(3.541112,-76.384584)"
2018,Septiembre,República de Corea,410,30,29,,59,"(4.697144,-74.140516)"
2018,Septiembre,República de Corea,410,4,4,,8,"(6.171601,-75.427454)"
2018,Septiembre,Costa de Marfil,384,2,2,,4,"(4.697144,-74.140516)"
2018,Septiembre,Costa de Marfil,384,1,0,,1,"(6.171601,-75.427454)"
2018,Septiembre,Costa Rica,188,14,14,,28,"(10.445761,-75.516429)"
2018,Septiembre,Costa Rica,188,19,21,,40,"(10.886611,-74.776708)"
2018,Septiembre,Costa Rica,188,1,9,,10,"(12.5744111,-81.703935)"
2018,Septiembre,Costa Rica,188,5,2,,7,"(12.586067,-81.702563)"
2018,Septiembre,Costa Rica,188,48,41,,89,"(3.541112,-76.384584)"
2018,Septiembre,Costa Rica,188,1018,1304,,2322,"(4.697144,-74.140516)"
2018,Septiembre,Costa Rica,188,17,26,,43,"(4.815061,-75.736532)"
2018,Septiembre,Costa Rica,188,120,120,,240,"(6.171601,-75.427454)"
2018,Septiembre,Costa Rica,188,3,4,,7,"(7.128456,-73.183637)"
2018,Septiembre,Croacia,191,0,1,,1,"(3.541112,-76.384584)"
2018,Septiembre,Croacia,191,11,7,,18,"(4.697144,-74.140516)"
2018,Septiembre,Croacia,191,1,0,,1,"(6.171601,-75.427454)"
2018,Septiembre,Cuba,192,14,7,,21,"(10.445761,-75.516429)"
2018,Septiembre,Cuba,192,17,20,,37,"(10.886611,-74.776708)"
2018,Septiembre,Cuba,192,1,0,,1,"(12.586067,-81.702563)"
2018,Septiembre,Cuba,192,103,66,,169,"(3.541112,-76.384584)"
2018,Septiembre,Cuba,192,1271,1119,,2390,"(4.697144,-74.140516)"
2018,Septiembre,Cuba,192,26,15,,41,"(4.815061,-75.736532)"
2018,Septiembre,Cuba,192,127,125,,252,"(6.171601,-75.427454)"
2018,Septiembre,Cuba,192,2,1,,3,"(7.128456,-73.183637)"
2018,Septiembre,Curazao,99999,1,0,,1,"(10.445761,-75.516429)"
2018,Septiembre,Curazao,99999,3,3,,6,"(10.886611,-74.776708)"
2018,Septiembre,Curazao,99999,6,4,,10,"(3.541112,-76.384584)"
2018,Septiembre,Curazao,99999,543,429,,972,"(4.697144,-74.140516)"
2018,Septiembre,Curazao,99999,4,3,,7,"(4.815061,-75.736532)"
2018,Septiembre,Curazao,99999,27,15,,42,"(6.171601,-75.427454)"
2018,Septiembre,Curazao,99999,0,2,,2,"(7.128456,-73.183637)"
2018,Septiembre,República Checa,203,1,0,,1,"(10.445761,-75.516429)"
2018,Septiembre,República Checa,203,2,2,,4,"(3.541112,-76.384584)"
2018,Septiembre,República Checa,203,24,28,,52,"(4.697144,-74.140516)"
2018,Septiembre,República Checa,203,13,3,,16,"(6.171601,-75.427454)"
2018,Septiembre,Chile,152,2,0,,2,"(0.25129,-76.875963)"
2018,Septiembre,Chile,152,55,66,,121,"(0.814836,-77.662532)"
2018,Septiembre,Chile,152,21,14,,35,"(10.445761,-75.516429)"
2018,Septiembre,Chile,152,38,22,,60,"(10.886611,-74.776708)"
2018,Septiembre,Chile,152,200,136,,336,"(3.541112,-76.384584)"
2018,Septiembre,Chile,152,4760,4012,,8772,"(4.697144,-74.140516)"
2018,Septiembre,Chile,152,61,34,,95,"(4.815061,-75.736532)"
2018,Septiembre,Chile,152,184,158,,342,"(6.171601,-75.427454)"
2018,Septiembre,Chile,152,5,6,,11,"(7.128456,-73.183637)"
2018,Septiembre,China,156,1,9,,10,"(10.445761,-75.516429)"
2018,Septiembre,China,156,0,4,,4,"(10.886611,-74.776708)"
2018,Septiembre,China,156,3,7,,10,"(3.541112,-76.384584)"
2018,Septiembre,China,156,179,379,,558,"(4.697144,-74.140516)"
2018,Septiembre,China,156,20,34,,54,"(6.171601,-75.427454)"
2018,Septiembre,Chipre,196,0,2,,2,"(3.541112,-76.384584)"
2018,Septiembre,Chipre,196,2,2,,4,"(4.697144,-74.140516)"
2018,Septiembre,Dinamarca,208,1,1,,2,"(10.445761,-75.516429)"
2018,Septiembre,Dinamarca,208,2,2,,4,"(3.541112,-76.384584)"
2018,Septiembre,Dinamarca,208,24,20,,44,"(4.697144,-74.140516)"
2018,Septiembre,Dinamarca,208,6,5,,11,"(6.171601,-75.427454)"
2018,Septiembre,Dinamarca,208,0,1,,1,"(7.128456,-73.183637)"
2018,Septiembre,Dominica,212,0,1,,1,"(3.541112,-76.384584)"
2018,Septiembre,Dominica,212,0,7,,7,"(4.697144,-74.140516)"
2018,Septiembre,Ecuador,218,4,4,,8,"(-0.193180,-74.784874)"
2018,Septiembre,Ecuador,218,573,891,,1464,"(0.25129,-76.875963)"
2018,Septiembre,Ecuador,218,22,34,,56,"(0.812436,-77.847006)"
2018,Septiembre,Ecuador,218,4805,5469,,10276,"(0.814836,-77.662532)"
2018,Septiembre,Ecuador,218,146,137,,283,"(1.813928,-78.763924)"
2018,Septiembre,Ecuador,218,0,23,,23,"(10.408582,-75.538003)"
2018,Septiembre,Ecuador,218,18,16,,34,"(10.445761,-75.516429)"
2018,Septiembre,Ecuador,218,1,3,,4,"(10.886611,-74.776708)"
2018,Septiembre,Ecuador,218,297,369,,666,"(3.541112,-76.384584)"
2018,Septiembre,Ecuador,218,2825,4162,,6987,"(4.697144,-74.140516)"
2018,Septiembre,Ecuador,218,0,4,,4,"(4.815061,-75.736532)"
2018,Septiembre,Ecuador,218,23,30,,53,"(6.171601,-75.427454)"
2018,Septiembre,Egipto,818,2,1,,3,"(3.541112,-76.384584)"
2018,Septiembre,Egipto,818,24,16,,40,"(4.697144,-74.140516)"
2018,Septiembre,El Salvador,222,1,0,,1,"(10.445761,-75.516429)"
2018,Septiembre,El Salvador,222,1,7,,8,"(10.886611,-74.776708)"
2018,Septiembre,El Salvador,222,115,102,,217,"(3.541112,-76.384584)"
2018,Septiembre,El Salvador,222,850,1112,,1962,"(4.697144,-74.140516)"
2018,Septiembre,El Salvador,222,4,0,,4,"(4.815061,-75.736532)"
2018,Septiembre,El Salvador,222,103,131,,234,"(6.171601,-75.427454)"
2018,Septiembre,Emiratos Árabes,784,3,1,,4,"(10.445761,-75.516429)"
2018,Septiembre,Emiratos Árabes,784,120,228,,348,"(4.697144,-74.140516)"
2018,Septiembre,Emiratos Árabes,784,7,10,,17,"(6.171601,-75.427454)"
2018,Septiembre,Eslovaquia,703,1,0,,1,"(10.886611,-74.776708)"
2018,Septiembre,Eslovaquia,703,2,1,,3,"(4.697144,-74.140516)"
2018,Septiembre,Eslovenia,705,1,0,,1,"(4.697144,-74.140516)"
2018,Septiembre,Eslovenia,705,1,1,,2,"(6.171601,-75.427454)"
2018,Septiembre,Estados Unidos de América,840,0,2,,2,"(10.408582,-75.538003)"
2018,Septiembre,Estados Unidos de América,840,3100,2584,,5684,"(10.445761,-75.516429)"
2018,Septiembre,Estados Unidos de América,840,2773,2343,,5116,"(10.886611,-74.776708)"
2018,Septiembre,Estados Unidos de América,840,53,39,,92,"(12.586067,-81.702563)"
2018,Septiembre,Estados Unidos de América,840,5545,4036,,9581,"(3.541112,-76.384584)"
2018,Septiembre,Estados Unidos de América,840,927,736,,1663,"(4.452882,-75.766298)"
2018,Septiembre,Estados Unidos de América,840,33528,29401,,62929,"(4.697144,-74.140516)"
2018,Septiembre,Estados Unidos de América,840,1061,782,,1843,"(4.815061,-75.736532)"
2018,Septiembre,Estados Unidos de América,840,10345,8272,,18617,"(6.171601,-75.427454)"
2018,Septiembre,Estados Unidos de América,840,223,155,,378,"(7.128456,-73.183637)"
2018,Septiembre,Estonia,233,2,4,,6,"(4.697144,-74.140516)"
2018,Septiembre,Etiopia,231,2,2,,4,"(4.697144,-74.140516)"
2018,Septiembre,Filipinas,608,0,1,,1,"(10.445761,-75.516429)"
2018,Septiembre,Filipinas,608,2,3,,5,"(4.697144,-74.140516)"
2018,Septiembre,Finlandia,246,1,0,,1,"(3.541112,-76.384584)"
2018,Septiembre,Finlandia,246,18,13,,31,"(4.697144,-74.140516)"
2018,Septiembre,Finlandia,246,1,0,,1,"(4.815061,-75.736532)"
2018,Septiembre,Finlandia,246,4,8,,12,"(6.171601,-75.427454)"
2018,Septiembre,Francia,250,19,15,,34,"(10.445761,-75.516429)"
2018,Septiembre,Francia,250,23,18,,41,"(10.886611,-74.776708)"
2018,Septiembre,Francia,250,157,121,,278,"(3.541112,-76.384584)"
2018,Septiembre,Francia,250,2486,1966,,4452,"(4.697144,-74.140516)"
2018,Septiembre,Francia,250,10,6,,16,"(4.815061,-75.736532)"
2018,Septiembre,Francia,250,210,145,,355,"(6.171601,-75.427454)"
2018,Septiembre,Francia,250,2,1,,3,"(7.128456,-73.183637)"
2018,Septiembre,Gabón,266,0,2,,2,"(4.697144,-74.140516)"
2018,Septiembre,Georgia,268,0,3,,3,"(4.697144,-74.140516)"
2018,Septiembre,Ghana,288,2,1,,3,"(4.697144,-74.140516)"
2018,Septiembre,Gibraltar/Territorio Británico de Ultramar,292,0,1,,1,"(4.697144,-74.140516)"
2018,Septiembre,Granada,308,0,1,,1,"(3.541112,-76.384584)"
2018,Septiembre,Grecia,300,0,1,,1,"(10.445761,-75.516429)"
2018,Septiembre,Grecia,300,1,1,,2,"(10.886611,-74.776708)"
2018,Septiembre,Grecia,300,6,1,,7,"(3.541112,-76.384584)"
2018,Septiembre,Grecia,300,62,41,,103,"(4.697144,-74.140516)"
2018,Septiembre,Grecia,300,15,6,,21,"(6.171601,-75.427454)"
2018,Septiembre,Guatemala,320,8,7,,15,"(10.445761,-75.516429)"
2018,Septiembre,Guatemala,320,4,6,,10,"(10.886611,-74.776708)"
2018,Septiembre,Guatemala,320,0,2,,2,"(12.586067,-81.702563)"
2018,Septiembre,Guatemala,320,40,62,,102,"(3.541112,-76.384584)"
2018,Septiembre,Guatemala,320,443,589,,1032,"(4.697144,-74.140516)"
2018,Septiembre,Guatemala,320,9,6,,15,"(4.815061,-75.736532)"
2018,Septiembre,Guatemala,320,93,121,,214,"(6.171601,-75.427454)"
2018,Septiembre,Guatemala,320,2,6,,8,"(7.128456,-73.183637)"
2018,Septiembre,Guyana,328,3,3,,6,"(10.886611,-74.776708)"
2018,Septiembre,Guyana,328,0,1,,1,"(3.541112,-76.384584)"
2018,Septiembre,Guyana,328,2,4,,6,"(4.697144,-74.140516)"
2018,Septiembre,Guyana,328,0,1,,1,"(6.171601,-75.427454)"
2018,Septiembre,Guyana,328,0,1,,1,"(7.128456,-73.183637)"
2018,Septiembre,Guinea,324,2,0,,2,"(4.697144,-74.140516)"
2018,Septiembre,Guinea Ecuatorial,226,1,2,,3,"(4.697144,-74.140516)"
2018,Septiembre,Guinea Ecuatorial,226,1,1,,2,"(6.171601,-75.427454)"
2018,Septiembre,Guinea Bissau,624,1,0,,1,"(4.697144,-74.140516)"
2018,Septiembre,Guadalupe/Territorio Francés,312,3,0,,3,"(4.697144,-74.140516)"
2018,Septiembre,Guadalupe/Territorio Francés,312,1,0,,1,"(4.815061,-75.736532)"
2018,Septiembre,Guadalupe/Territorio Francés,312,1,0,,1,"(6.171601,-75.427454)"
2018,Septiembre,Guayana Francesa/Departamento de Ultramar Francés,254,2,4,,6,"(4.697144,-74.140516)"
2018,Septiembre,Guayana Francesa/Departamento de Ultramar Francés,254,0,1,,1,"(7.128456,-73.183637)"
2018,Septiembre,Haití,332,2,4,,6,"(10.445761,-75.516429)"
2018,Septiembre,Haití,332,1,0,,1,"(10.886611,-74.776708)"
2018,Septiembre,Haití,332,1,3,,4,"(3.541112,-76.384584)"
2018,Septiembre,Haití,332,5,5,,10,"(4.697144,-74.140516)"
2018,Septiembre,Haití,332,1,0,,1,"(4.815061,-75.736532)"
2018,Septiembre,Haití,332,2,1,,3,"(6.171601,-75.427454)"
2018,Septiembre,Honduras,340,1,4,,5,"(10.445761,-75.516429)"
2018,Septiembre,Honduras,340,3,8,,11,"(10.886611,-74.776708)"
2018,Septiembre,Honduras,340,6,19,,25,"(3.541112,-76.384584)"
2018,Septiembre,Honduras,340,74,150,,224,"(4.697144,-74.140516)"
2018,Septiembre,Honduras,340,0,2,,2,"(4.815061,-75.736532)"
2018,Septiembre,Honduras,340,28,55,,83,"(6.171601,-75.427454)"
2018,Septiembre,Honduras,340,1,0,,1,"(7.128456,-73.183637)"
2018,Septiembre,Hong Kong,344,1,0,,1,"(10.445761,-75.516429)"
2018,Septiembre,Hong Kong,344,1,0,,1,"(3.541112,-76.384584)"
2018,Septiembre,Hong Kong,344,26,33,,59,"(4.697144,-74.140516)"
2018,Septiembre,Hong Kong,344,2,2,,4,"(6.171601,-75.427454)"
2018,Septiembre,Hungría,348,8,6,,14,"(4.697144,-74.140516)"
2018,Septiembre,Hungría,348,2,1,,3,"(6.171601,-75.427454)"
2018,Septiembre,India,356,1,1,,2,"(10.886611,-74.776708)"
2018,Septiembre,India,356,4,3,,7,"(3.541112,-76.384584)"
2018,Septiembre,India,356,59,48,,107,"(4.697144,-74.140516)"
2018,Septiembre,India,356,1,1,,2,"(4.815061,-75.736532)"
2018,Septiembre,India,356,10,4,,14,"(6.171601,-75.427454)"
2018,Septiembre,India,356,0,2,,2,"(7.128456,-73.183637)"
2018,Septiembre,Indonesia,360,1,0,,1,"(3.541112,-76.384584)"
2018,Septiembre,Indonesia,360,8,7,,15,"(4.697144,-74.140516)"
2018,Septiembre,Indonesia,360,2,1,,3,"(6.171601,-75.427454)"
2018,Septiembre,Iraq,368,2,1,,3,"(10.886611,-74.776708)"
2018,Septiembre,Iraq,368,0,7,,7,"(4.697144,-74.140516)"
2018,Septiembre,Irán,364,4,1,,5,"(4.697144,-74.140516)"
2018,Septiembre,República de Irlanda,372,0,1,,1,"(10.445761,-75.516429)"
2018,Septiembre,República de Irlanda,372,17,13,,30,"(4.697144,-74.140516)"
2018,Septiembre,República de Irlanda,372,1,0,,1,"(4.815061,-75.736532)"
2018,Septiembre,República de Irlanda,372,1,1,,2,"(6.171601,-75.427454)"
2018,Septiembre,Islandia,352,1,1,,2,"(10.886611,-74.776708)"
2018,Septiembre,Islandia,352,2,0,,2,"(3.541112,-76.384584)"
2018,Septiembre,Islandia,352,8,6,,14,"(4.697144,-74.140516)"
2018,Septiembre,Islandia,352,0,1,,1,"(6.171601,-75.427454)"
2018,Septiembre,Israel,376,3,4,,7,"(10.445761,-75.516429)"
2018,Septiembre,Israel,376,1,2,,3,"(10.886611,-74.776708)"
2018,Septiembre,Israel,376,14,7,,21,"(3.541112,-76.384584)"
2018,Septiembre,Israel,376,220,114,,334,"(4.697144,-74.140516)"
2018,Septiembre,Israel,376,29,12,,41,"(6.171601,-75.427454)"
2018,Septiembre,Italia,380,21,12,,33,"(10.445761,-75.516429)"
2018,Septiembre,Italia,380,7,6,,13,"(10.886611,-74.776708)"
2018,Septiembre,Italia,380,139,64,,203,"(3.541112,-76.384584)"
2018,Septiembre,Italia,380,963,702,,1665,"(4.697144,-74.140516)"
2018,Septiembre,Italia,380,5,2,,7,"(4.815061,-75.736532)"
2018,Septiembre,Italia,380,170,102,,272,"(6.171601,-75.427454)"
2018,Septiembre,Italia,380,2,0,,2,"(7.128456,-73.183637)"
2018,Septiembre,Jamaica,388,2,6,,8,"(10.445761,-75.516429)"
2018,Septiembre,Jamaica,388,0,1,,1,"(10.886611,-74.776708)"
2018,Septiembre,Jamaica,388,1,1,,2,"(12.586067,-81.702563)"
2018,Septiembre,Jamaica,388,8,13,,21,"(3.541112,-76.384584)"
2018,Septiembre,Jamaica,388,24,35,,59,"(4.697144,-74.140516)"
2018,Septiembre,Jamaica,388,1,1,,2,"(4.815061,-75.736532)"
2018,Septiembre,Jamaica,388,15,21,,36,"(6.171601,-75.427454)"
2018,Septiembre,Jamaica,388,2,4,,6,"(7.128456,-73.183637)"
2018,Septiembre,Japón,392,15,8,,23,"(3.541112,-76.384584)"
2018,Septiembre,Japón,392,139,117,,256,"(4.697144,-74.140516)"
2018,Septiembre,Japón,392,3,3,,6,"(4.815061,-75.736532)"
2018,Septiembre,Japón,392,32,15,,47,"(6.171601,-75.427454)"
2018,Septiembre,Jordania,400,1,4,,5,"(4.697144,-74.140516)"
2018,Septiembre,Kazajistán,398,1,2,,3,"(4.697144,-74.140516)"
2018,Septiembre,Kenia,404,1,1,,2,"(3.541112,-76.384584)"
2018,Septiembre,Kenia,404,8,4,,12,"(4.697144,-74.140516)"
2018,Septiembre,Kenia,404,2,1,,3,"(6.171601,-75.427454)"
2018,Septiembre,Kuwait,414,0,1,,1,"(3.541112,-76.384584)"
2018,Septiembre,Kuwait,414,5,4,,9,"(4.697144,-74.140516)"
2018,Septiembre,Kuwait,414,0,1,,1,"(7.128456,-73.183637)"
2018,Septiembre,República Democrática Popular  Lao,418,1,1,,2,"(4.697144,-74.140516)"
2018,Septiembre,Letonia,428,1,0,,1,"(4.697144,-74.140516)"
2018,Septiembre,Líbano,422,4,1,,5,"(12.586067,-81.702563)"
2018,Septiembre,Líbano,422,0,1,,1,"(3.541112,-76.384584)"
2018,Septiembre,Líbano,422,14,14,,28,"(4.697144,-74.140516)"
2018,Septiembre,Luxemburgo,442,1,0,,1,"(10.445761,-75.516429)"
2018,Septiembre,Luxemburgo,442,3,0,,3,"(10.886611,-74.776708)"
2018,Septiembre,Luxemburgo,442,9,8,,17,"(4.697144,-74.140516)"
2018,Septiembre,Luxemburgo,442,2,0,,2,"(4.815061,-75.736532)"
2018,Septiembre,Luxemburgo,442,4,2,,6,"(6.171601,-75.427454)"
2018,Septiembre,Macao,446,0,1,,1,"(4.697144,-74.140516)"
2018,Septiembre,Malasia,458,2,3,,5,"(4.697144,-74.140516)"
2018,Septiembre,Malí,466,1,0,,1,"(4.697144,-74.140516)"
2018,Septiembre,Malta,470,0,2,,2,"(3.541112,-76.384584)"
2018,Septiembre,Malta,470,27,27,,54,"(4.697144,-74.140516)"
2018,Septiembre,Malta,470,4,2,,6,"(6.171601,-75.427454)"
2018,Septiembre,Marruecos,504,23,12,,35,"(4.697144,-74.140516)"
2018,Septiembre,Marruecos,504,3,1,,4,"(6.171601,-75.427454)"
2018,Septiembre,Islas Marshall,584,0,1,,1,"(4.697144,-74.140516)"
2018,Septiembre,Mauritania,478,0,2,,2,"(4.697144,-74.140516)"
2018,Septiembre,Martinica/Departamento de Ultramar Francés,474,0,1,,1,"(4.697144,-74.140516)"
2018,Septiembre,México,484,44,35,,79,"(10.445761,-75.516429)"
2018,Septiembre,México,484,161,120,,281,"(10.886611,-74.776708)"
2018,Septiembre,México,484,4,4,,8,"(12.586067,-81.702563)"
2018,Septiembre,México,484,971,777,,1748,"(3.541112,-76.384584)"
2018,Septiembre,México,484,15706,13671,,29377,"(4.697144,-74.140516)"
2018,Septiembre,México,484,250,199,,449,"(4.815061,-75.736532)"
2018,Septiembre,México,484,2456,1954,,4410,"(6.171601,-75.427454)"
2018,Septiembre,México,484,185,113,,298,"(7.128456,-73.183637)"
2018,Septiembre,Mónaco,492,1,1,,2,"(4.697144,-74.140516)"
2018,Septiembre,Mongolia,496,0,1,,1,"(4.697144,-74.140516)"
2018,Septiembre,Montenegro,499,0,1,,1,"(3.541112,-76.384584)"
2018,Septiembre,Mozambique,508,1,0,,1,"(3.541112,-76.384584)"
2018,Septiembre,Mozambique,508,0,1,,1,"(4.697144,-74.140516)"
2018,Septiembre,Nepal,524,0,1,,1,"(3.541112,-76.384584)"
2018,Septiembre,Nepal,524,0,1,,1,"(4.697144,-74.140516)"
2018,Septiembre,Nicaragua,558,1,1,,2,"(10.445761,-75.516429)"
2018,Septiembre,Nicaragua,558,4,1,,5,"(10.886611,-74.776708)"
2018,Septiembre,Nicaragua,558,6,20,,26,"(3.541112,-76.384584)"
2018,Septiembre,Nicaragua,558,22,31,,53,"(4.697144,-74.140516)"
2018,Septiembre,Nicaragua,558,4,2,,6,"(4.815061,-75.736532)"
2018,Septiembre,Nicaragua,558,8,50,,58,"(6.171601,-75.427454)"
2018,Septiembre,Nicaragua,558,0,1,,1,"(7.128456,-73.183637)"
2018,Septiembre,Nigeria,566,0,1,,1,"(10.445761,-75.516429)"
2018,Septiembre,Nigeria,566,1,0,,1,"(3.541112,-76.384584)"
2018,Septiembre,Nigeria,566,0,5,,5,"(4.697144,-74.140516)"
2018,Septiembre,Níger,562,0,1,,1,"(10.445761,-75.516429)"
2018,Septiembre,Níger,562,0,1,,1,"(4.697144,-74.140516)"
2018,Septiembre,Noruega,578,1,0,,1,"(10.445761,-75.516429)"
2018,Septiembre,Noruega,578,10,3,,13,"(3.541112,-76.384584)"
2018,Septiembre,Noruega,578,21,19,,40,"(4.697144,-74.140516)"
2018,Septiembre,Noruega,578,1,1,,2,"(6.171601,-75.427454)"
2018,Septiembre,Nueva Zelanda,554,23,17,,40,"(4.697144,-74.140516)"
2018,Septiembre,Nueva Zelanda,554,0,1,,1,"(6.171601,-75.427454)"
2018,Septiembre,Omán,512,1,0,,1,"(10.445761,-75.516429)"
2018,Septiembre,Omán,512,1,0,,1,"(3.541112,-76.384584)"
2018,Septiembre,Omán,512,1,2,,3,"(4.697144,-74.140516)"
2018,Septiembre,Omán,512,0,1,,1,"(6.171601,-75.427454)"
2018,Septiembre,Pakistán,586,0,1,,1,"(4.697144,-74.140516)"
2018,Septiembre,Panamá,591,100,135,,235,"(10.408582,-75.538003)"
2018,Septiembre,Panamá,591,1191,1039,,2230,"(10.445761,-75.516429)"
2018,Septiembre,Panamá,591,769,756,,1525,"(10.886611,-74.776708)"
2018,Septiembre,Panamá,591,0,12,,12,"(12.165168,-71.983761)"
2018,Septiembre,Panamá,591,2,20,,22,"(12.5744111,-81.703935)"
2018,Septiembre,Panamá,591,61,62,,123,"(12.586067,-81.702563)"
2018,Septiembre,Panamá,591,2392,1972,,4364,"(3.541112,-76.384584)"
2018,Septiembre,Panamá,591,1,0,,1,"(3.893038,-77.067921)"
2018,Septiembre,Panamá,591,213,126,,339,"(4.452882,-75.766298)"
2018,Septiembre,Panamá,591,6763,7902,,14666,"(4.697144,-74.140516)"
2018,Septiembre,Panamá,591,441,326,,767,"(4.815061,-75.736532)"
2018,Septiembre,Panamá,591,0,1,,1,"(6.17134,-75.427194)"
2018,Septiembre,Panamá,591,2987,2551,,5538,"(6.171601,-75.427454)"
2018,Septiembre,Panamá,591,1,3,,4,"(6.228046,-77.404104)"
2018,Septiembre,Panamá,591,4,19,,23,"(7.102626,-77.762647)"
2018,Septiembre,Panamá,591,194,149,,343,"(7.128456,-73.183637)"
2018,Septiembre,Panamá,591,0,25,,25,"(8.066966,-76.735404)"
2018,Septiembre,Panamá,591,24,64,,88,"(8.635765,-77.346578)"
2018,Septiembre,Paraguay,600,0,4,,4,"(10.445761,-75.516429)"
2018,Septiembre,Paraguay,600,8,20,,28,"(10.886611,-74.776708)"
2018,Septiembre,Paraguay,600,11,23,,34,"(3.541112,-76.384584)"
2018,Septiembre,Paraguay,600,99,224,,323,"(4.697144,-74.140516)"
2018,Septiembre,Paraguay,600,11,13,,24,"(4.815061,-75.736532)"
2018,Septiembre,Paraguay,600,19,38,,57,"(6.171601,-75.427454)"
2018,Septiembre,Paraguay,600,0,1,,1,"(7.128456,-73.183637)"
2018,Septiembre,Perú,604,6,4,,10,"(-0.193180,-74.784874)"
2018,Septiembre,Perú,604,29,27,,56,"(-4.197703,-69.941278)"
2018,Septiembre,Perú,604,67,93,,160,"(-4.223468,-69.945098)"
2018,Septiembre,Perú,604,5,8,,13,"(0.25129,-76.875963)"
2018,Septiembre,Perú,604,49,41,,90,"(0.814836,-77.662532)"
2018,Septiembre,Perú,604,0,4,,4,"(1.813928,-78.763924)"
2018,Septiembre,Perú,604,50,47,,97,"(10.445761,-75.516429)"
2018,Septiembre,Perú,604,9,11,,20,"(10.886611,-74.776708)"
2018,Septiembre,Perú,604,1,2,,3,"(12.586067,-81.702563)"
2018,Septiembre,Perú,604,194,190,,384,"(3.541112,-76.384584)"
2018,Septiembre,Perú,604,5299,5938,,11237,"(4.697144,-74.140516)"
2018,Septiembre,Perú,604,9,8,,17,"(4.815061,-75.736532)"
2018,Septiembre,Perú,604,551,581,,1132,"(6.171601,-75.427454)"
2018,Septiembre,Perú,604,8,12,,20,"(7.128456,-73.183637)"
2018,Septiembre,Palestina,99999,1,0,,1,"(3.541112,-76.384584)"
2018,Septiembre,Palestina,99999,1,0,,1,"(6.171601,-75.427454)"
2018,Septiembre,Polonia,616,27,38,,65,"(4.697144,-74.140516)"
2018,Septiembre,Polonia,616,2,4,,6,"(6.171601,-75.427454)"
2018,Septiembre,Portugal,620,0,1,,1,"(10.445761,-75.516429)"
2018,Septiembre,Portugal,620,2,1,,3,"(10.886611,-74.776708)"
2018,Septiembre,Portugal,620,7,9,,16,"(3.541112,-76.384584)"
2018,Septiembre,Portugal,620,230,201,,431,"(4.697144,-74.140516)"
2018,Septiembre,Portugal,620,1,1,,2,"(4.815061,-75.736532)"
2018,Septiembre,Portugal,620,19,11,,30,"(6.171601,-75.427454)"
2018,Septiembre,Portugal,620,1,0,,1,"(7.128456,-73.183637)"
2018,Septiembre,Polinesia Francesa/Colectividad de Ultramar Francesa,258,1,1,,2,"(4.697144,-74.140516)"
2018,Septiembre,Puerto Rico/Territorio de Estados Unidos,630,5,4,,9,"(10.445761,-75.516429)"
2018,Septiembre,Puerto Rico/Territorio de Estados Unidos,630,6,3,,9,"(10.886611,-74.776708)"
2018,Septiembre,Puerto Rico/Territorio de Estados Unidos,630,21,15,,36,"(3.541112,-76.384584)"
2018,Septiembre,Puerto Rico/Territorio de Estados Unidos,630,305,299,,604,"(4.697144,-74.140516)"
2018,Septiembre,Puerto Rico/Territorio de Estados Unidos,630,5,3,,8,"(4.815061,-75.736532)"
2018,Septiembre,Puerto Rico/Territorio de Estados Unidos,630,36,48,,84,"(6.171601,-75.427454)"
2018,Septiembre,Puerto Rico/Territorio de Estados Unidos,630,1,1,,2,"(7.128456,-73.183637)"
2018,Septiembre,Qatar,634,3,1,,4,"(3.541112,-76.384584)"
2018,Septiembre,Qatar,634,10,12,,22,"(4.697144,-74.140516)"
2018,Septiembre,Qatar,634,4,6,,10,"(6.171601,-75.427454)"
2018,Septiembre,Reino Unido de Gran Bretaña e Irlanda del Norte,826,9,3,,12,"(10.445761,-75.516429)"
2018,Septiembre,Reino Unido de Gran Bretaña e Irlanda del Norte,826,2,4,,6,"(10.886611,-74.776708)"
2018,Septiembre,Reino Unido de Gran Bretaña e Irlanda del Norte,826,121,77,,198,"(3.541112,-76.384584)"
2018,Septiembre,Reino Unido de Gran Bretaña e Irlanda del Norte,826,1914,1488,,3403,"(4.697144,-74.140516)"
2018,Septiembre,Reino Unido de Gran Bretaña e Irlanda del Norte,826,68,49,,117,"(6.171601,-75.427454)"
2018,Septiembre,Reino Unido de Gran Bretaña e Irlanda del Norte,826,0,1,,1,"(7.128456,-73.183637)"
2018,Septiembre,República CentroÁfricana,140,1,1,,2,"(4.697144,-74.140516)"
2018,Septiembre,Federación de Rusia,643,1,2,,3,"(10.445761,-75.516429)"
2018,Septiembre,Federación de Rusia,643,1,3,,4,"(3.541112,-76.384584)"
2018,Septiembre,Federación de Rusia,643,109,131,,240,"(4.697144,-74.140516)"
2018,Septiembre,Federación de Rusia,643,7,6,,13,"(6.171601,-75.427454)"
2018,Septiembre,República Dominicana,214,5,10,,15,"(10.445761,-75.516429)"
2018,Septiembre,República Dominicana,214,34,31,,65,"(10.886611,-74.776708)"
2018,Septiembre,República Dominicana,214,134,109,,243,"(3.541112,-76.384584)"
2018,Septiembre,República Dominicana,214,3677,3124,,6801,"(4.697144,-74.140516)"
2018,Septiembre,República Dominicana,214,55,51,,106,"(4.815061,-75.736532)"
2018,Septiembre,República Dominicana,214,389,303,,692,"(6.171601,-75.427454)"
2018,Septiembre,República Dominicana,214,58,51,,109,"(7.128456,-73.183637)"
2018,Septiembre,Reunión,638,0,1,,1,"(4.697144,-74.140516)"
2018,Septiembre,República Democrática Popular de Corea,408,0,3,,3,"(4.697144,-74.140516)"
2018,Septiembre,Rumania,642,0,1,,1,"(3.541112,-76.384584)"
2018,Septiembre,Rumania,642,19,8,,27,"(4.697144,-74.140516)"
2018,Septiembre,Santa Lucia,662,0,1,,1,"(4.697144,-74.140516)"
2018,Septiembre,Santa Sede/Ciudad del Vaticano,336,0,2,,2,"(4.697144,-74.140516)"
2018,Septiembre,Santo Tomé y Príncipe,678,1,0,,1,"(4.697144,-74.140516)"
2018,Septiembre,Senegal,686,0,1,,1,"(4.697144,-74.140516)"
2018,Septiembre,Serbia,688,1,2,,3,"(4.697144,-74.140516)"
2018,Septiembre,Sierra Leona,694,0,1,,1,"(4.697144,-74.140516)"
2018,Septiembre,Sierra Leona,694,1,1,,2,"(6.171601,-75.427454)"
2018,Septiembre,Singapur,702,0,1,,1,"(3.541112,-76.384584)"
2018,Septiembre,Singapur,702,7,7,,14,"(4.697144,-74.140516)"
2018,Septiembre,Singapur,702,1,1,,2,"(6.171601,-75.427454)"
2018,Septiembre,República Árabe Siria,760,0,1,,1,"(4.697144,-74.140516)"
2018,Septiembre,Somalia,706,1,0,,1,"(4.697144,-74.140516)"
2018,Septiembre,Sri Lanka,144,2,2,,4,"(4.697144,-74.140516)"
2018,Septiembre,Sudáfrica,710,14,10,,24,"(4.697144,-74.140516)"
2018,Septiembre,Sudáfrica,710,1,1,,2,"(6.171601,-75.427454)"
2018,Septiembre,Suecia,752,4,1,,5,"(10.445761,-75.516429)"
2018,Septiembre,Suecia,752,3,2,,5,"(10.886611,-74.776708)"
2018,Septiembre,Suecia,752,14,8,,22,"(3.541112,-76.384584)"
2018,Septiembre,Suecia,752,43,50,,93,"(4.697144,-74.140516)"
2018,Septiembre,Suecia,752,1,0,,1,"(4.815061,-75.736532)"
2018,Septiembre,Suecia,752,11,8,,19,"(6.171601,-75.427454)"
2018,Septiembre,Suiza,756,10,2,,12,"(10.445761,-75.516429)"
2018,Septiembre,Suiza,756,1,0,,1,"(10.886611,-74.776708)"
2018,Septiembre,Suiza,756,29,15,,44,"(3.541112,-76.384584)"
2018,Septiembre,Suiza,756,231,209,,440,"(4.697144,-74.140516)"
2018,Septiembre,Suiza,756,1,1,,2,"(4.815061,-75.736532)"
2018,Septiembre,Suiza,756,33,24,,57,"(6.171601,-75.427454)"
2018,Septiembre,Surinam,740,3,5,,8,"(4.697144,-74.140516)"
2018,Septiembre,Surinam,740,0,1,,1,"(6.171601,-75.427454)"
2018,Septiembre,Taiwán,158,4,8,,12,"(4.697144,-74.140516)"
2018,Septiembre,Tailandia,764,1,4,,5,"(3.541112,-76.384584)"
2018,Septiembre,Tailandia,764,14,19,,33,"(4.697144,-74.140516)"
2018,Septiembre,Tailandia,764,2,1,,3,"(6.171601,-75.427454)"
2018,Septiembre,Tanzania,834,1,0,,1,"(4.697144,-74.140516)"
2018,Septiembre,Trinidad y Tobago,780,1,2,,3,"(10.445761,-75.516429)"
2018,Septiembre,Trinidad y Tobago,780,2,3,,5,"(10.886611,-74.776708)"
2018,Septiembre,Trinidad y Tobago,780,1,12,,13,"(3.541112,-76.384584)"
2018,Septiembre,Trinidad y Tobago,780,19,37,,56,"(4.697144,-74.140516)"
2018,Septiembre,Trinidad y Tobago,780,1,3,,4,"(4.815061,-75.736532)"
2018,Septiembre,Trinidad y Tobago,780,5,7,,12,"(6.171601,-75.427454)"
2018,Septiembre,Trinidad y Tobago,780,1,0,,1,"(7.128456,-73.183637)"
2018,Septiembre,Túnez,788,2,2,,4,"(4.697144,-74.140516)"
2018,Septiembre,Turquía,792,2,2,,4,"(10.445761,-75.516429)"
2018,Septiembre,Turquía,792,3,1,,4,"(10.886611,-74.776708)"
2018,Septiembre,Turquía,792,10,4,,14,"(3.541112,-76.384584)"
2018,Septiembre,Turquía,792,1300,588,,1888,"(4.697144,-74.140516)"
2018,Septiembre,Turquía,792,31,18,,49,"(6.171601,-75.427454)"
2018,Septiembre,Turkmenistán,795,4,1,,5,"(4.697144,-74.140516)"
2018,Septiembre,Ucrania,804,2,6,,8,"(4.697144,-74.140516)"
2018,Septiembre,Ucrania,804,1,0,,1,"(6.171601,-75.427454)"
2018,Septiembre,Uganda,800,1,0,,1,"(4.815061,-75.736532)"
2018,Septiembre,Uruguay,858,0,1,,1,"(0.25129,-76.875963)"
2018,Septiembre,Uruguay,858,0,3,,3,"(10.445761,-75.516429)"
2018,Septiembre,Uruguay,858,0,1,,1,"(10.886611,-74.776708)"
2018,Septiembre,Uruguay,858,11,28,,39,"(3.541112,-76.384584)"
2018,Septiembre,Uruguay,858,277,322,,599,"(4.697144,-74.140516)"
2018,Septiembre,Uruguay,858,4,5,,9,"(4.815061,-75.736532)"
2018,Septiembre,Uruguay,858,15,18,,33,"(6.171601,-75.427454)"
2018,Septiembre,Venezuela,862,0,1,,1,"(10.408582,-75.538003)"
2018,Septiembre,Venezuela,862,6,8,,14,"(10.445761,-75.516429)"
2018,Septiembre,Venezuela,862,18,15,,33,"(10.886611,-74.776708)"
2018,Septiembre,Venezuela,862,1,0,,1,"(11.117806,-74.232622)"
2018,Septiembre,Venezuela,862,1668,1681,,3349,"(11.360009,-72.129330)"
2018,Septiembre,Venezuela,862,1,0,,1,"(12.586067,-81.702563)"
2018,Septiembre,Venezuela,862,495,373,,868,"(3.541112,-76.384584)"
2018,Septiembre,Venezuela,862,6,11,,17,"(3.866713,-67.927521)"
2018,Septiembre,Venezuela,862,1404,1305,,2709,"(4.697144,-74.140516)"
2018,Septiembre,Venezuela,862,1,3,,4,"(4.815061,-75.736532)"
2018,Septiembre,Venezuela,862,763,562,,1325,"(6.171601,-75.427454)"
2018,Septiembre,Venezuela,862,29,40,,69,"(6.185799,-67.483929)"
2018,Septiembre,Venezuela,862,478,399,,877,"(7.088729,-70.740253)"
2018,Septiembre,Venezuela,862,2,2,,4,"(7.128456,-73.183637)"
2018,Septiembre,Venezuela,862,848,894,,1743,"(7.818934,-72.453226)"
2018,Septiembre,Venezuela,862,0,1,,1,"(7.927209,-72.507910)"
2018,Septiembre,Venezuela,862,117,154,,271,"(8.36068,-72.409396)"
2018,Septiembre,Vietnam,704,6,5,,11,"(4.697144,-74.140516)"
2018,Septiembre,Vietnam,704,0,1,,1,"(6.171601,-75.427454)"
2018,Septiembre,Zambia,894,0,1,,1,"(10.886611,-74.776708)"
2018,Octubre,Afganistán,4,0,1,,1,"(4.697144,-74.140516)"
2018,Octubre,Afganistán,4,1,0,,1,"(6.171601,-75.427454)"
2018,Octubre,Albania,8,1,3,,4,"(4.697144,-74.140516)"
2018,Octubre,Alemania,276,1,1,,2,"(0.814836,-77.662532)"
2018,Octubre,Alemania,276,29,13,,42,"(10.445761,-75.516429)"
2018,Octubre,Alemania,276,13,8,,21,"(10.886611,-74.776708)"
2018,Octubre,Alemania,276,66,43,,109,"(3.541112,-76.384584)"
2018,Octubre,Alemania,276,1604,1615,,3219,"(4.697144,-74.140516)"
2018,Octubre,Alemania,276,1,2,,3,"(4.815061,-75.736532)"
2018,Octubre,Alemania,276,62,51,,113,"(6.171601,-75.427454)"
2018,Octubre,Alemania,276,0,1,,1,"(7.128456,-73.183637)"
2018,Octubre,Andorra,20,1,0,,1,"(4.697144,-74.140516)"
2018,Octubre,Angola,24,5,2,,7,"(4.697144,-74.140516)"
2018,Octubre,Antigua y Barbuda,28,5,3,,8,"(4.697144,-74.140516)"
2018,Octubre,Antigua y Barbuda,28,1,0,,1,"(6.171601,-75.427454)"
2018,Octubre,Países Bajos,528,2,15,,17,"(10.408582,-75.538003)"
2018,Octubre,Países Bajos,528,125,96,,221,"(10.445761,-75.516429)"
2018,Octubre,Países Bajos,528,22,19,,41,"(10.886611,-74.776708)"
2018,Octubre,Países Bajos,528,0,1,,1,"(11.247723,-74.213989)"
2018,Octubre,Países Bajos,528,64,24,,88,"(3.541112,-76.384584)"
2018,Octubre,Países Bajos,528,1263,1167,,2430,"(4.697144,-74.140516)"
2018,Octubre,Países Bajos,528,10,8,,18,"(4.815061,-75.736532)"
2018,Octubre,Países Bajos,528,127,90,,217,"(6.171601,-75.427454)"
2018,Octubre,Países Bajos,528,0,1,,1,"(7.128456,-73.183637)"
2018,Octubre,Arabia Saudita,682,1,1,,2,"(10.445761,-75.516429)"
2018,Octubre,Arabia Saudita,682,0,7,,7,"(3.541112,-76.384584)"
2018,Octubre,Arabia Saudita,682,7,41,,48,"(4.697144,-74.140516)"
2018,Octubre,Arabia Saudita,682,0,1,,1,"(6.171601,-75.427454)"
2018,Octubre,Arabia Saudita,682,0,1,,1,"(7.128456,-73.183637)"
2018,Octubre,Argelia,12,6,13,,19,"(4.697144,-74.140516)"
2018,Octubre,Argentina,32,5,9,,14,"(0.814836,-77.662532)"
2018,Octubre,Argentina,32,43,60,,103,"(10.445761,-75.516429)"
2018,Octubre,Argentina,32,45,34,,79,"(10.886611,-74.776708)"
2018,Octubre,Argentina,32,137,116,,253,"(3.541112,-76.384584)"
2018,Octubre,Argentina,32,3131,3021,,6152,"(4.697144,-74.140516)"
2018,Octubre,Argentina,32,19,28,,47,"(4.815061,-75.736532)"
2018,Octubre,Argentina,32,245,231,,476,"(6.171601,-75.427454)"
2018,Octubre,Argentina,32,12,5,,17,"(7.128456,-73.183637)"
2018,Octubre,República de Armenia,51,3,2,,5,"(4.697144,-74.140516)"
2018,Octubre,Aruba,533,2896,1877,,4773,"(10.408582,-75.538003)"
2018,Octubre,Aruba,533,8,3,,11,"(10.445761,-75.516429)"
2018,Octubre,Aruba,533,25,27,,52,"(10.886611,-74.776708)"
2018,Octubre,Aruba,533,0,5,,5,"(11.247723,-74.213989)"
2018,Octubre,Aruba,533,23,13,,36,"(3.541112,-76.384584)"
2018,Octubre,Aruba,533,2208,1781,,3989,"(4.697144,-74.140516)"
2018,Octubre,Aruba,533,9,6,,15,"(4.815061,-75.736532)"
2018,Octubre,Aruba,533,60,59,,119,"(6.171601,-75.427454)"
2018,Octubre,Aruba,533,10,40,,50,"(7.128456,-73.183637)"
2018,Octubre,Australia,36,3,0,,3,"(10.445761,-75.516429)"
2018,Octubre,Australia,36,3,3,,6,"(10.886611,-74.776708)"
2018,Octubre,Australia,36,12,4,,16,"(3.541112,-76.384584)"
2018,Octubre,Australia,36,373,276,,649,"(4.697144,-74.140516)"
2018,Octubre,Australia,36,3,2,,5,"(4.815061,-75.736532)"
2018,Octubre,Australia,36,45,27,,72,"(6.171601,-75.427454)"
2018,Octubre,Australia,36,2,0,,2,"(7.128456,-73.183637)"
2018,Octubre,Austria,40,1,5,,6,"(3.541112,-76.384584)"
2018,Octubre,Austria,40,32,40,,72,"(4.697144,-74.140516)"
2018,Octubre,Austria,40,0,1,,1,"(4.815061,-75.736532)"
2018,Octubre,Austria,40,4,2,,6,"(6.171601,-75.427454)"
2018,Octubre,Bahamas,44,2,2,,4,"(10.445761,-75.516429)"
2018,Octubre,Bahamas,44,21,14,,35,"(3.541112,-76.384584)"
2018,Octubre,Bahamas,44,24,22,,46,"(4.697144,-74.140516)"
2018,Octubre,Bahamas,44,2,0,,2,"(4.815061,-75.736532)"
2018,Octubre,Bahamas,44,27,25,,52,"(6.171601,-75.427454)"
2018,Octubre,Bahamas,44,1,0,,1,"(7.128456,-73.183637)"
2018,Octubre,Bahréin,48,1,2,,3,"(4.697144,-74.140516)"
2018,Octubre,Barbados,52,2,1,,3,"(12.586067,-81.702563)"
2018,Octubre,Barbados,52,1,3,,4,"(3.541112,-76.384584)"
2018,Octubre,Barbados,52,7,11,,18,"(4.697144,-74.140516)"
2018,Octubre,Barbados,52,1,0,,1,"(4.815061,-75.736532)"
2018,Octubre,Barbados,52,4,2,,6,"(6.171601,-75.427454)"
2018,Octubre,República de Belarús,112,1,2,,3,"(4.697144,-74.140516)"
2018,Octubre,República de Belarús,112,1,0,,1,"(6.171601,-75.427454)"
2018,Octubre,Bélgica,56,3,1,,4,"(10.445761,-75.516429)"
2018,Octubre,Bélgica,56,2,1,,3,"(10.886611,-74.776708)"
2018,Octubre,Bélgica,56,17,11,,28,"(3.541112,-76.384584)"
2018,Octubre,Bélgica,56,76,52,,128,"(4.697144,-74.140516)"
2018,Octubre,Bélgica,56,1,0,,1,"(4.815061,-75.736532)"
2018,Octubre,Bélgica,56,21,14,,35,"(6.171601,-75.427454)"
2018,Octubre,Belice,84,1,0,,1,"(10.886611,-74.776708)"
2018,Octubre,Belice,84,3,5,,8,"(3.541112,-76.384584)"
2018,Octubre,Belice,84,8,12,,20,"(4.697144,-74.140516)"
2018,Octubre,Belice,84,0,1,,1,"(6.171601,-75.427454)"
2018,Octubre,Benín,204,1,0,,1,"(4.697144,-74.140516)"
2018,Octubre,Bermudas/Territorio Británico de Ultramar,60,2,0,,2,"(4.697144,-74.140516)"
2018,Octubre,Bolivia,68,0,2,,2,"(0.814836,-77.662532)"
2018,Octubre,Bolivia,68,4,6,,10,"(10.445761,-75.516429)"
2018,Octubre,Bolivia,68,2,2,,4,"(10.886611,-74.776708)"
2018,Octubre,Bolivia,68,26,49,,75,"(3.541112,-76.384584)"
2018,Octubre,Bolivia,68,365,506,,871,"(4.697144,-74.140516)"
2018,Octubre,Bolivia,68,4,7,,11,"(4.815061,-75.736532)"
2018,Octubre,Bolivia,68,30,47,,77,"(6.171601,-75.427454)"
2018,Octubre,Bosnia y Herzegovina,70,8,1,,9,"(4.697144,-74.140516)"
2018,Octubre,Brasil,76,119,250,,369,"(-4.197703,-69.941278)"
2018,Octubre,Brasil,76,7,15,,22,"(-4.223468,-69.945098)"
2018,Octubre,Brasil,76,4,5,,9,"(0.814836,-77.662532)"
2018,Octubre,Brasil,76,12,16,,28,"(10.445761,-75.516429)"
2018,Octubre,Brasil,76,30,19,,49,"(10.886611,-74.776708)"
2018,Octubre,Brasil,76,130,152,,282,"(3.541112,-76.384584)"
2018,Octubre,Brasil,76,3993,4766,,8759,"(4.697144,-74.140516)"
2018,Octubre,Brasil,76,31,51,,82,"(4.815061,-75.736532)"
2018,Octubre,Brasil,76,163,199,,362,"(6.171601,-75.427454)"
2018,Octubre,Brasil,76,10,15,,25,"(7.128456,-73.183637)"
2018,Octubre,Bulgaria,100,3,2,,5,"(4.697144,-74.140516)"
2018,Octubre,Bulgaria,100,2,0,,2,"(6.171601,-75.427454)"
2018,Octubre,Islas Caimán/Territorio Británico de Ultramar,136,2,0,,2,"(10.445761,-75.516429)"
2018,Octubre,Islas Caimán/Territorio Británico de Ultramar,136,1,3,,4,"(12.586067,-81.702563)"
2018,Octubre,Islas Caimán/Territorio Británico de Ultramar,136,0,3,,3,"(3.541112,-76.384584)"
2018,Octubre,Islas Caimán/Territorio Británico de Ultramar,136,1,3,,4,"(4.697144,-74.140516)"
2018,Octubre,Islas Caimán/Territorio Británico de Ultramar,136,1,1,,2,"(6.171601,-75.427454)"
2018,Octubre,Camboya,116,1,0,,1,"(4.697144,-74.140516)"
2018,Octubre,Canadá,124,27,20,,47,"(10.445761,-75.516429)"
2018,Octubre,Canadá,124,26,29,,55,"(10.886611,-74.776708)"
2018,Octubre,Canadá,124,128,107,,235,"(3.541112,-76.384584)"
2018,Octubre,Canadá,124,1,0,,1,"(4.452882,-75.766298)"
2018,Octubre,Canadá,124,1582,1307,,2889,"(4.697144,-74.140516)"
2018,Octubre,Canadá,124,13,11,,24,"(4.815061,-75.736532)"
2018,Octubre,Canadá,124,235,180,,415,"(6.171601,-75.427454)"
2018,Octubre,Canadá,124,8,8,,16,"(7.128456,-73.183637)"
2018,Octubre,Chad,148,1,0,,1,"(4.697144,-74.140516)"
2018,Octubre,España,724,17,20,,37,"(10.445761,-75.516429)"
2018,Octubre,España,724,21,16,,37,"(10.886611,-74.776708)"
2018,Octubre,España,724,3683,2661,,6345,"(3.541112,-76.384584)"
2018,Octubre,España,724,16052,12348,,28400,"(4.697144,-74.140516)"
2018,Octubre,España,724,8,6,,14,"(4.815061,-75.736532)"
2018,Octubre,España,724,2823,2039,,4862,"(6.171601,-75.427454)"
2018,Octubre,España,724,2,4,,6,"(7.128456,-73.183637)"
2018,Octubre,Colombia,170,2,18,,20,"(10.445761,-75.516429)"
2018,Octubre,Colombia,170,338,819,,1158,"(4.697144,-74.140516)"
2018,Octubre,República Democrática del Congo,180,1,0,,1,"(4.697144,-74.140516)"
2018,Octubre,República de Corea,410,2,1,,3,"(3.541112,-76.384584)"
2018,Octubre,República de Corea,410,28,45,,73,"(4.697144,-74.140516)"
2018,Octubre,República de Corea,410,3,2,,5,"(6.171601,-75.427454)"
2018,Octubre,Costa de Marfil,384,9,8,,17,"(4.697144,-74.140516)"
2018,Octubre,Costa Rica,188,7,11,,18,"(10.445761,-75.516429)"
2018,Octubre,Costa Rica,188,29,25,,54,"(10.886611,-74.776708)"
2018,Octubre,Costa Rica,188,2,19,,21,"(12.5744111,-81.703935)"
2018,Octubre,Costa Rica,188,4,5,,9,"(12.586067,-81.702563)"
2018,Octubre,Costa Rica,188,39,37,,76,"(3.541112,-76.384584)"
2018,Octubre,Costa Rica,188,1109,1300,,2409,"(4.697144,-74.140516)"
2018,Octubre,Costa Rica,188,14,12,,26,"(4.815061,-75.736532)"
2018,Octubre,Costa Rica,188,112,108,,220,"(6.171601,-75.427454)"
2018,Octubre,Costa Rica,188,2,0,,2,"(7.128456,-73.183637)"
2018,Octubre,Croacia,191,3,3,,6,"(4.697144,-74.140516)"
2018,Octubre,Cuba,192,0,7,,7,"(10.408582,-75.538003)"
2018,Octubre,Cuba,192,12,7,,19,"(10.445761,-75.516429)"
2018,Octubre,Cuba,192,21,24,,45,"(10.886611,-74.776708)"
2018,Octubre,Cuba,192,0,1,,1,"(12.586067,-81.702563)"
2018,Octubre,Cuba,192,107,78,,185,"(3.541112,-76.384584)"
2018,Octubre,Cuba,192,1484,1313,,2797,"(4.697144,-74.140516)"
2018,Octubre,Cuba,192,26,23,,49,"(4.815061,-75.736532)"
2018,Octubre,Cuba,192,182,115,,297,"(6.171601,-75.427454)"
2018,Octubre,Cuba,192,15,18,,33,"(7.128456,-73.183637)"
2018,Octubre,Curazao,99999,0,1,,1,"(10.445761,-75.516429)"
2018,Octubre,Curazao,99999,6,3,,9,"(10.886611,-74.776708)"
2018,Octubre,Curazao,99999,0,4,,4,"(12.586067,-81.702563)"
2018,Octubre,Curazao,99999,14,11,,25,"(3.541112,-76.384584)"
2018,Octubre,Curazao,99999,594,501,,1095,"(4.697144,-74.140516)"
2018,Octubre,Curazao,99999,1,1,,2,"(4.815061,-75.736532)"
2018,Octubre,Curazao,99999,31,16,,47,"(6.171601,-75.427454)"
2018,Octubre,Curazao,99999,4,3,,7,"(7.128456,-73.183637)"
2018,Octubre,Curazao,99999,1,2,,3,"(7.927209,-72.507910)"
2018,Octubre,República Checa,203,0,2,,2,"(10.886611,-74.776708)"
2018,Octubre,República Checa,203,0,2,,2,"(3.541112,-76.384584)"
2018,Octubre,República Checa,203,3,5,,8,"(4.697144,-74.140516)"
2018,Octubre,República Checa,203,0,1,,1,"(6.171601,-75.427454)"
2018,Octubre,Chile,152,2,11,,13,"(0.25129,-76.875963)"
2018,Octubre,Chile,152,57,75,,132,"(0.814836,-77.662532)"
2018,Octubre,Chile,152,1,0,,1,"(1.813928,-78.763924)"
2018,Octubre,Chile,152,31,25,,56,"(10.445761,-75.516429)"
2018,Octubre,Chile,152,48,40,,88,"(10.886611,-74.776708)"
2018,Octubre,Chile,152,163,107,,270,"(3.541112,-76.384584)"
2018,Octubre,Chile,152,5386,4592,,9978,"(4.697144,-74.140516)"
2018,Octubre,Chile,152,96,80,,176,"(4.815061,-75.736532)"
2018,Octubre,Chile,152,238,187,,425,"(6.171601,-75.427454)"
2018,Octubre,Chile,152,2,2,,4,"(7.128456,-73.183637)"
2018,Octubre,China,156,2,8,,10,"(10.445761,-75.516429)"
2018,Octubre,China,156,3,7,,10,"(10.886611,-74.776708)"
2018,Octubre,China,156,14,19,,33,"(3.541112,-76.384584)"
2018,Octubre,China,156,232,498,,730,"(4.697144,-74.140516)"
2018,Octubre,China,156,1,1,,2,"(4.815061,-75.736532)"
2018,Octubre,China,156,31,74,,105,"(6.171601,-75.427454)"
2018,Octubre,Dinamarca,208,0,2,,2,"(10.445761,-75.516429)"
2018,Octubre,Dinamarca,208,1,1,,2,"(10.886611,-74.776708)"
2018,Octubre,Dinamarca,208,1,5,,6,"(3.541112,-76.384584)"
2018,Octubre,Dinamarca,208,0,1,,1,"(4.452882,-75.766298)"
2018,Octubre,Dinamarca,208,17,20,,37,"(4.697144,-74.140516)"
2018,Octubre,Dinamarca,208,5,1,,6,"(6.171601,-75.427454)"
2018,Octubre,Dominica,212,2,1,,3,"(3.541112,-76.384584)"
2018,Octubre,Dominica,212,0,1,,1,"(4.697144,-74.140516)"
2018,Octubre,Ecuador,218,1,5,,6,"(-0.193180,-74.784874)"
2018,Octubre,Ecuador,218,734,1052,,1786,"(0.25129,-76.875963)"
2018,Octubre,Ecuador,218,43,52,,95,"(0.812436,-77.847006)"
2018,Octubre,Ecuador,218,5417,6447,,11864,"(0.814836,-77.662532)"
2018,Octubre,Ecuador,218,181,174,,355,"(1.813928,-78.763924)"
2018,Octubre,Ecuador,218,2,2,,4,"(10.445761,-75.516429)"
2018,Octubre,Ecuador,218,3,3,,6,"(10.886611,-74.776708)"
2018,Octubre,Ecuador,218,404,516,,920,"(3.541112,-76.384584)"
2018,Octubre,Ecuador,218,3141,4621,,7762,"(4.697144,-74.140516)"
2018,Octubre,Ecuador,218,0,3,,3,"(4.815061,-75.736532)"
2018,Octubre,Ecuador,218,39,61,,100,"(6.171601,-75.427454)"
2018,Octubre,Ecuador,218,1,1,,2,"(7.128456,-73.183637)"
2018,Octubre,Egipto,818,2,1,,3,"(3.541112,-76.384584)"
2018,Octubre,Egipto,818,30,41,,71,"(4.697144,-74.140516)"
2018,Octubre,Egipto,818,1,0,,1,"(6.171601,-75.427454)"
2018,Octubre,El Salvador,222,9,5,,14,"(10.445761,-75.516429)"
2018,Octubre,El Salvador,222,5,2,,7,"(10.886611,-74.776708)"
2018,Octubre,El Salvador,222,145,149,,295,"(3.541112,-76.384584)"
2018,Octubre,El Salvador,222,805,1092,,1897,"(4.697144,-74.140516)"
2018,Octubre,El Salvador,222,122,150,,272,"(6.171601,-75.427454)"
2018,Octubre,Emiratos Árabes,784,1,1,,2,"(10.445761,-75.516429)"
2018,Octubre,Emiratos Árabes,784,3,2,,5,"(3.541112,-76.384584)"
2018,Octubre,Emiratos Árabes,784,120,173,,293,"(4.697144,-74.140516)"
2018,Octubre,Emiratos Árabes,784,12,5,,17,"(6.171601,-75.427454)"
2018,Octubre,Eritrea,232,3,1,,4,"(4.697144,-74.140516)"
2018,Octubre,Eslovenia,705,1,0,,1,"(3.541112,-76.384584)"
2018,Octubre,Eslovenia,705,1,0,,1,"(4.697144,-74.140516)"
2018,Octubre,Estados Unidos de América,840,1,0,,1,"(10.408582,-75.538003)"
2018,Octubre,Estados Unidos de América,840,3940,3219,,7159,"(10.445761,-75.516429)"
2018,Octubre,Estados Unidos de América,840,3069,2582,,5651,"(10.886611,-74.776708)"
2018,Octubre,Estados Unidos de América,840,1,0,,1,"(11.117806,-74.232622)"
2018,Octubre,Estados Unidos de América,840,54,26,,80,"(12.586067,-81.702563)"
2018,Octubre,Estados Unidos de América,840,5557,4080,,9638,"(3.541112,-76.384584)"
2018,Octubre,Estados Unidos de América,840,858,666,,1524,"(4.452882,-75.766298)"
2018,Octubre,Estados Unidos de América,840,35995,32336,,68333,"(4.697144,-74.140516)"
2018,Octubre,Estados Unidos de América,840,1008,660,,1668,"(4.815061,-75.736532)"
2018,Octubre,Estados Unidos de América,840,10967,8874,,19841,"(6.171601,-75.427454)"
2018,Octubre,Estados Unidos de América,840,245,150,,395,"(7.128456,-73.183637)"
2018,Octubre,Estonia,233,0,2,,2,"(4.697144,-74.140516)"
2018,Octubre,Etiopia,231,1,2,,3,"(3.541112,-76.384584)"
2018,Octubre,Etiopia,231,1,2,,3,"(4.697144,-74.140516)"
2018,Octubre,Filipinas,608,2,0,,2,"(3.541112,-76.384584)"
2018,Octubre,Filipinas,608,7,9,,16,"(4.697144,-74.140516)"
2018,Octubre,Filipinas,608,2,2,,4,"(6.171601,-75.427454)"
2018,Octubre,Finlandia,246,2,2,,4,"(10.886611,-74.776708)"
2018,Octubre,Finlandia,246,1,0,,1,"(3.541112,-76.384584)"
2018,Octubre,Finlandia,246,3,7,,10,"(4.697144,-74.140516)"
2018,Octubre,Finlandia,246,1,0,,1,"(6.171601,-75.427454)"
2018,Octubre,Francia,250,16,13,,29,"(10.445761,-75.516429)"
2018,Octubre,Francia,250,10,5,,15,"(10.886611,-74.776708)"
2018,Octubre,Francia,250,68,44,,112,"(3.541112,-76.384584)"
2018,Octubre,Francia,250,1912,1676,,3589,"(4.697144,-74.140516)"
2018,Octubre,Francia,250,90,80,,170,"(6.171601,-75.427454)"
2018,Octubre,Francia,250,0,2,,2,"(7.128456,-73.183637)"
2018,Octubre,Gabón,266,0,3,,3,"(4.697144,-74.140516)"
2018,Octubre,Gambia,270,0,1,,1,"(10.445761,-75.516429)"
2018,Octubre,Georgia,268,1,0,,1,"(4.697144,-74.140516)"
2018,Octubre,Ghana,288,0,1,,1,"(4.697144,-74.140516)"
2018,Octubre,Granada,308,2,1,,3,"(4.697144,-74.140516)"
2018,Octubre,Grecia,300,0,1,,1,"(10.445761,-75.516429)"
2018,Octubre,Grecia,300,1,0,,1,"(10.886611,-74.776708)"
2018,Octubre,Grecia,300,1,4,,5,"(3.541112,-76.384584)"
2018,Octubre,Grecia,300,41,23,,64,"(4.697144,-74.140516)"
2018,Octubre,Grecia,300,8,3,,11,"(6.171601,-75.427454)"
2018,Octubre,Groenlandia,304,1,0,,1,"(4.697144,-74.140516)"
2018,Octubre,Guatemala,320,11,11,,22,"(10.445761,-75.516429)"
2018,Octubre,Guatemala,320,7,29,,36,"(10.886611,-74.776708)"
2018,Octubre,Guatemala,320,1,6,,7,"(11.528919,-72.919681)"
2018,Octubre,Guatemala,320,68,109,,177,"(3.541112,-76.384584)"
2018,Octubre,Guatemala,320,533,622,,1155,"(4.697144,-74.140516)"
2018,Octubre,Guatemala,320,12,17,,29,"(4.815061,-75.736532)"
2018,Octubre,Guatemala,320,87,119,,206,"(6.171601,-75.427454)"
2018,Octubre,Guatemala,320,7,7,,14,"(7.128456,-73.183637)"
2018,Octubre,Guyana,328,1,0,,1,"(3.541112,-76.384584)"
2018,Octubre,Guyana,328,2,7,,9,"(4.697144,-74.140516)"
2018,Octubre,Guyana,328,1,2,,3,"(4.815061,-75.736532)"
2018,Octubre,Guyana,328,2,4,,6,"(6.171601,-75.427454)"
2018,Octubre,Guinea,324,1,0,,1,"(4.697144,-74.140516)"
2018,Octubre,Guinea Ecuatorial,226,2,3,,5,"(4.697144,-74.140516)"
2018,Octubre,Guinea Ecuatorial,226,2,1,,3,"(6.171601,-75.427454)"
2018,Octubre,Guinea Bissau,624,0,1,,1,"(4.697144,-74.140516)"
2018,Octubre,Guadalupe/Territorio Francés,312,2,2,,4,"(4.697144,-74.140516)"
2018,Octubre,Guadalupe/Territorio Francés,312,0,1,,1,"(6.171601,-75.427454)"
2018,Octubre,Guayana Francesa/Departamento de Ultramar Francés,254,1,1,,2,"(6.171601,-75.427454)"
2018,Octubre,Haití,332,0,2,,2,"(10.886611,-74.776708)"
2018,Octubre,Haití,332,2,0,,2,"(3.541112,-76.384584)"
2018,Octubre,Haití,332,0,4,,4,"(4.697144,-74.140516)"
2018,Octubre,Haití,332,1,0,,1,"(4.815061,-75.736532)"
2018,Octubre,Haití,332,2,2,,4,"(6.171601,-75.427454)"
2018,Octubre,Honduras,340,3,8,,11,"(10.445761,-75.516429)"
2018,Octubre,Honduras,340,6,18,,24,"(10.886611,-74.776708)"
2018,Octubre,Honduras,340,7,26,,33,"(3.541112,-76.384584)"
2018,Octubre,Honduras,340,71,153,,224,"(4.697144,-74.140516)"
2018,Octubre,Honduras,340,5,11,,16,"(4.815061,-75.736532)"
2018,Octubre,Honduras,340,30,82,,112,"(6.171601,-75.427454)"
2018,Octubre,Honduras,340,0,2,,2,"(7.128456,-73.183637)"
2018,Octubre,Hong Kong,344,33,52,,85,"(4.697144,-74.140516)"
2018,Octubre,Hong Kong,344,1,2,,3,"(6.171601,-75.427454)"
2018,Octubre,Hungría,348,1,0,,1,"(3.541112,-76.384584)"
2018,Octubre,Hungría,348,3,10,,13,"(4.697144,-74.140516)"
2018,Octubre,India,356,2,0,,2,"(10.886611,-74.776708)"
2018,Octubre,India,356,2,7,,9,"(3.541112,-76.384584)"
2018,Octubre,India,356,80,27,,107,"(4.697144,-74.140516)"
2018,Octubre,India,356,1,1,,2,"(4.815061,-75.736532)"
2018,Octubre,India,356,3,3,,6,"(6.171601,-75.427454)"
2018,Octubre,Indonesia,360,0,2,,2,"(3.541112,-76.384584)"
2018,Octubre,Indonesia,360,8,7,,15,"(4.697144,-74.140516)"
2018,Octubre,Indonesia,360,3,2,,5,"(6.171601,-75.427454)"
2018,Octubre,Iraq,368,0,5,,5,"(4.697144,-74.140516)"
2018,Octubre,Irán,364,1,2,,3,"(6.171601,-75.427454)"
2018,Octubre,República de Irlanda,372,3,2,,5,"(3.541112,-76.384584)"
2018,Octubre,República de Irlanda,372,18,11,,29,"(4.697144,-74.140516)"
2018,Octubre,República de Irlanda,372,1,1,,2,"(6.171601,-75.427454)"
2018,Octubre,Islandia,352,1,0,,1,"(10.445761,-75.516429)"
2018,Octubre,Islandia,352,2,3,,5,"(4.697144,-74.140516)"
2018,Octubre,Islandia,352,1,1,,2,"(6.171601,-75.427454)"
2018,Octubre,Israel,376,2,1,,3,"(10.445761,-75.516429)"
2018,Octubre,Israel,376,2,3,,5,"(10.886611,-74.776708)"
2018,Octubre,Israel,376,9,4,,13,"(3.541112,-76.384584)"
2018,Octubre,Israel,376,1,0,,1,"(4.452882,-75.766298)"
2018,Octubre,Israel,376,357,206,,563,"(4.697144,-74.140516)"
2018,Octubre,Israel,376,16,10,,26,"(6.171601,-75.427454)"
2018,Octubre,Italia,380,18,5,,23,"(10.445761,-75.516429)"
2018,Octubre,Italia,380,18,24,,42,"(10.886611,-74.776708)"
2018,Octubre,Italia,380,100,66,,166,"(3.541112,-76.384584)"
2018,Octubre,Italia,380,689,478,,1167,"(4.697144,-74.140516)"
2018,Octubre,Italia,380,3,0,,3,"(4.815061,-75.736532)"
2018,Octubre,Italia,380,86,51,,137,"(6.171601,-75.427454)"
2018,Octubre,Italia,380,2,1,,3,"(7.128456,-73.183637)"
2018,Octubre,Jamaica,388,7,7,,14,"(10.445761,-75.516429)"
2018,Octubre,Jamaica,388,2,5,,7,"(10.886611,-74.776708)"
2018,Octubre,Jamaica,388,0,2,,2,"(12.586067,-81.702563)"
2018,Octubre,Jamaica,388,4,9,,13,"(3.541112,-76.384584)"
2018,Octubre,Jamaica,388,44,41,,85,"(4.697144,-74.140516)"
2018,Octubre,Jamaica,388,2,4,,6,"(4.815061,-75.736532)"
2018,Octubre,Jamaica,388,16,16,,32,"(6.171601,-75.427454)"
2018,Octubre,Jamaica,388,9,12,,21,"(7.128456,-73.183637)"
2018,Octubre,Japón,392,1,1,,2,"(10.445761,-75.516429)"
2018,Octubre,Japón,392,1,0,,1,"(10.886611,-74.776708)"
2018,Octubre,Japón,392,3,1,,4,"(3.541112,-76.384584)"
2018,Octubre,Japón,392,108,136,,244,"(4.697144,-74.140516)"
2018,Octubre,Japón,392,5,4,,9,"(4.815061,-75.736532)"
2018,Octubre,Japón,392,6,7,,13,"(6.171601,-75.427454)"
2018,Octubre,Jordania,400,0,1,,1,"(3.541112,-76.384584)"
2018,Octubre,Kazajistán,398,0,7,,7,"(4.697144,-74.140516)"
2018,Octubre,Kenia,404,3,3,,6,"(4.697144,-74.140516)"
2018,Octubre,Kirguistán,417,0,1,,1,"(4.697144,-74.140516)"
2018,Octubre,Kuwait,414,1,0,,1,"(3.541112,-76.384584)"
2018,Octubre,Kuwait,414,1,3,,4,"(4.697144,-74.140516)"
2018,Octubre,Kuwait,414,1,1,,2,"(6.171601,-75.427454)"
2018,Octubre,Letonia,428,0,2,,2,"(4.697144,-74.140516)"
2018,Octubre,Lituania,440,0,1,,1,"(3.541112,-76.384584)"
2018,Octubre,Lituania,440,1,1,,2,"(4.697144,-74.140516)"
2018,Octubre,Líbano,422,1,3,,4,"(10.886611,-74.776708)"
2018,Octubre,Líbano,422,0,1,,1,"(12.586067,-81.702563)"
2018,Octubre,Líbano,422,1,0,,1,"(3.541112,-76.384584)"
2018,Octubre,Líbano,422,10,4,,14,"(4.697144,-74.140516)"
2018,Octubre,Líbano,422,1,1,,2,"(6.171601,-75.427454)"
2018,Octubre,Luxemburgo,442,1,0,,1,"(3.541112,-76.384584)"
2018,Octubre,Luxemburgo,442,2,6,,8,"(4.697144,-74.140516)"
2018,Octubre,Luxemburgo,442,2,0,,2,"(6.171601,-75.427454)"
2018,Octubre,Madagascar,450,0,3,,3,"(4.697144,-74.140516)"
2018,Octubre,Malasia,458,7,13,,20,"(4.697144,-74.140516)"
2018,Octubre,Malasia,458,0,3,,3,"(6.171601,-75.427454)"
2018,Octubre,Malawi,454,1,0,,1,"(6.171601,-75.427454)"
2018,Octubre,Malí,466,2,0,,2,"(4.697144,-74.140516)"
2018,Octubre,Malta,470,1,0,,1,"(3.541112,-76.384584)"
2018,Octubre,Malta,470,24,14,,38,"(4.697144,-74.140516)"
2018,Octubre,Malta,470,2,4,,6,"(6.171601,-75.427454)"
2018,Octubre,Malta,470,0,1,,1,"(7.128456,-73.183637)"
2018,Octubre,Marruecos,504,2,1,,3,"(3.541112,-76.384584)"
2018,Octubre,Marruecos,504,25,13,,38,"(4.697144,-74.140516)"
2018,Octubre,Marruecos,504,1,2,,3,"(6.171601,-75.427454)"
2018,Octubre,Marruecos,504,1,0,,1,"(7.128456,-73.183637)"
2018,Octubre,Mauritania,478,0,2,,2,"(4.697144,-74.140516)"
2018,Octubre,Martinica/Departamento de Ultramar Francés,474,0,1,,1,"(4.697144,-74.140516)"
2018,Octubre,México,484,122,86,,208,"(10.445761,-75.516429)"
2018,Octubre,México,484,252,200,,452,"(10.886611,-74.776708)"
2018,Octubre,México,484,29,26,,55,"(12.586067,-81.702563)"
2018,Octubre,México,484,1064,864,,1928,"(3.541112,-76.384584)"
2018,Octubre,México,484,19145,16604,,35750,"(4.697144,-74.140516)"
2018,Octubre,México,484,308,226,,534,"(4.815061,-75.736532)"
2018,Octubre,México,484,3151,2588,,5739,"(6.171601,-75.427454)"
2018,Octubre,México,484,242,176,,418,"(7.128456,-73.183637)"
2018,Octubre,Mónaco,492,1,1,,2,"(4.697144,-74.140516)"
2018,Octubre,Montenegro,499,1,0,,1,"(3.541112,-76.384584)"
2018,Octubre,Myanmar,104,1,2,,3,"(4.697144,-74.140516)"
2018,Octubre,Nauru,520,1,0,,1,"(4.697144,-74.140516)"
2018,Octubre,Nepal,524,1,2,,3,"(4.697144,-74.140516)"
2018,Octubre,Nicaragua,558,7,5,,12,"(10.445761,-75.516429)"
2018,Octubre,Nicaragua,558,1,1,,2,"(10.886611,-74.776708)"
2018,Octubre,Nicaragua,558,0,1,,1,"(12.5744111,-81.703935)"
2018,Octubre,Nicaragua,558,0,1,,1,"(12.586067,-81.702563)"
2018,Octubre,Nicaragua,558,10,17,,27,"(3.541112,-76.384584)"
2018,Octubre,Nicaragua,558,18,48,,66,"(4.697144,-74.140516)"
2018,Octubre,Nicaragua,558,4,4,,8,"(4.815061,-75.736532)"
2018,Octubre,Nicaragua,558,9,36,,45,"(6.171601,-75.427454)"
2018,Octubre,Nicaragua,558,0,1,,1,"(7.128456,-73.183637)"
2018,Octubre,Nigeria,566,0,6,,6,"(4.697144,-74.140516)"
2018,Octubre,Níger,562,0,1,,1,"(4.697144,-74.140516)"
2018,Octubre,Noruega,578,3,1,,4,"(10.445761,-75.516429)"
2018,Octubre,Noruega,578,8,2,,10,"(3.541112,-76.384584)"
2018,Octubre,Noruega,578,12,15,,27,"(4.697144,-74.140516)"
2018,Octubre,Noruega,578,2,2,,4,"(6.171601,-75.427454)"
2018,Octubre,Nueva Caledonia/Territorio francés,540,0,1,,1,"(4.697144,-74.140516)"
2018,Octubre,Nueva Zelanda,554,38,29,,67,"(4.697144,-74.140516)"
2018,Octubre,Nueva Zelanda,554,3,1,,4,"(6.171601,-75.427454)"
2018,Octubre,Omán,512,0,1,,1,"(10.445761,-75.516429)"
2018,Octubre,Omán,512,2,4,,6,"(4.697144,-74.140516)"
2018,Octubre,Pakistán,586,2,1,,3,"(4.697144,-74.140516)"
2018,Octubre,Pakistán,586,1,1,,2,"(6.171601,-75.427454)"
2018,Octubre,Panamá,591,83,132,,215,"(10.408582,-75.538003)"
2018,Octubre,Panamá,591,1298,1170,,2468,"(10.445761,-75.516429)"
2018,Octubre,Panamá,591,900,841,,1741,"(10.886611,-74.776708)"
2018,Octubre,Panamá,591,7,143,,150,"(10.971302,-74.765397)"
2018,Octubre,Panamá,591,0,2,,2,"(11.117806,-74.232622)"
2018,Octubre,Panamá,591,0,1,,1,"(11.247723,-74.213989)"
2018,Octubre,Panamá,591,2,16,,18,"(12.5744111,-81.703935)"
2018,Octubre,Panamá,591,124,100,,224,"(12.586067,-81.702563)"
2018,Octubre,Panamá,591,2544,2143,,4687,"(3.541112,-76.384584)"
2018,Octubre,Panamá,591,153,102,,255,"(4.452882,-75.766298)"
2018,Octubre,Panamá,591,8654,9550,,18204,"(4.697144,-74.140516)"
2018,Octubre,Panamá,591,462,363,,825,"(4.815061,-75.736532)"
2018,Octubre,Panamá,591,3420,3044,,6464,"(6.171601,-75.427454)"
2018,Octubre,Panamá,591,1,3,,4,"(6.228046,-77.404104)"
2018,Octubre,Panamá,591,3,9,,12,"(7.102626,-77.762647)"
2018,Octubre,Panamá,591,184,130,,314,"(7.128456,-73.183637)"
2018,Octubre,Panamá,591,0,10,,10,"(8.066966,-76.735404)"
2018,Octubre,Panamá,591,21,65,,86,"(8.635765,-77.346578)"
2018,Octubre,Paraguay,600,3,0,,3,"(10.445761,-75.516429)"
2018,Octubre,Paraguay,600,3,14,,17,"(10.886611,-74.776708)"
2018,Octubre,Paraguay,600,22,18,,40,"(3.541112,-76.384584)"
2018,Octubre,Paraguay,600,77,166,,243,"(4.697144,-74.140516)"
2018,Octubre,Paraguay,600,6,10,,16,"(4.815061,-75.736532)"
2018,Octubre,Paraguay,600,18,35,,53,"(6.171601,-75.427454)"
2018,Octubre,Paraguay,600,3,2,,5,"(7.128456,-73.183637)"
2018,Octubre,Perú,604,4,9,,13,"(-0.193180,-74.784874)"
2018,Octubre,Perú,604,115,157,,272,"(-4.197703,-69.941278)"
2018,Octubre,Perú,604,54,76,,130,"(-4.223468,-69.945098)"
2018,Octubre,Perú,604,7,17,,24,"(0.25129,-76.875963)"
2018,Octubre,Perú,604,55,62,,117,"(0.814836,-77.662532)"
2018,Octubre,Perú,604,4,0,,4,"(1.813928,-78.763924)"
2018,Octubre,Perú,604,42,47,,89,"(10.445761,-75.516429)"
2018,Octubre,Perú,604,10,12,,22,"(10.886611,-74.776708)"
2018,Octubre,Perú,604,0,1,,1,"(12.586067,-81.702563)"
2018,Octubre,Perú,604,270,268,,538,"(3.541112,-76.384584)"
2018,Octubre,Perú,604,6044,6493,,12537,"(4.697144,-74.140516)"
2018,Octubre,Perú,604,16,17,,33,"(4.815061,-75.736532)"
2018,Octubre,Perú,604,691,653,,1344,"(6.171601,-75.427454)"
2018,Octubre,Perú,604,2,2,,4,"(7.128456,-73.183637)"
2018,Octubre,Palestina,99999,0,1,,1,"(4.697144,-74.140516)"
2018,Octubre,Polonia,616,0,1,,1,"(10.886611,-74.776708)"
2018,Octubre,Polonia,616,14,31,,45,"(4.697144,-74.140516)"
2018,Octubre,Polonia,616,1,0,,1,"(6.171601,-75.427454)"
2018,Octubre,Portugal,620,3,2,,5,"(10.445761,-75.516429)"
2018,Octubre,Portugal,620,1,2,,3,"(10.886611,-74.776708)"
2018,Octubre,Portugal,620,10,6,,16,"(3.541112,-76.384584)"
2018,Octubre,Portugal,620,92,60,,152,"(4.697144,-74.140516)"
2018,Octubre,Portugal,620,1,0,,1,"(4.815061,-75.736532)"
2018,Octubre,Portugal,620,9,7,,16,"(6.171601,-75.427454)"
2018,Octubre,Polinesia Francesa/Colectividad de Ultramar Francesa,258,0,1,,1,"(4.697144,-74.140516)"
2018,Octubre,Puerto Rico/Territorio de Estados Unidos,630,7,6,,13,"(10.445761,-75.516429)"
2018,Octubre,Puerto Rico/Territorio de Estados Unidos,630,12,9,,21,"(10.886611,-74.776708)"
2018,Octubre,Puerto Rico/Territorio de Estados Unidos,630,1,0,,1,"(12.586067,-81.702563)"
2018,Octubre,Puerto Rico/Territorio de Estados Unidos,630,32,30,,62,"(3.541112,-76.384584)"
2018,Octubre,Puerto Rico/Territorio de Estados Unidos,630,377,323,,700,"(4.697144,-74.140516)"
2018,Octubre,Puerto Rico/Territorio de Estados Unidos,630,6,4,,10,"(4.815061,-75.736532)"
2018,Octubre,Puerto Rico/Territorio de Estados Unidos,630,44,37,,81,"(6.171601,-75.427454)"
2018,Octubre,Puerto Rico/Territorio de Estados Unidos,630,5,4,,9,"(7.128456,-73.183637)"
2018,Octubre,Qatar,634,6,11,,17,"(4.697144,-74.140516)"
2018,Octubre,Qatar,634,0,3,,3,"(6.171601,-75.427454)"
2018,Octubre,Reino Unido de Gran Bretaña e Irlanda del Norte,826,5,1,,6,"(10.445761,-75.516429)"
2018,Octubre,Reino Unido de Gran Bretaña e Irlanda del Norte,826,0,1,,1,"(10.886611,-74.776708)"
2018,Octubre,Reino Unido de Gran Bretaña e Irlanda del Norte,826,32,28,,60,"(3.541112,-76.384584)"
2018,Octubre,Reino Unido de Gran Bretaña e Irlanda del Norte,826,1502,1183,,2685,"(4.697144,-74.140516)"
2018,Octubre,Reino Unido de Gran Bretaña e Irlanda del Norte,826,22,13,,35,"(6.171601,-75.427454)"
2018,Octubre,República CentroÁfricana,140,5,4,,9,"(4.697144,-74.140516)"
2018,Octubre,Federación de Rusia,643,2,0,,2,"(3.541112,-76.384584)"
2018,Octubre,Federación de Rusia,643,39,68,,107,"(4.697144,-74.140516)"
2018,Octubre,Federación de Rusia,643,0,1,,1,"(6.171601,-75.427454)"
2018,Octubre,República Dominicana,214,23,24,,47,"(10.445761,-75.516429)"
2018,Octubre,República Dominicana,214,50,48,,98,"(10.886611,-74.776708)"
2018,Octubre,República Dominicana,214,1,0,,1,"(12.586067,-81.702563)"
2018,Octubre,República Dominicana,214,149,131,,280,"(3.541112,-76.384584)"
2018,Octubre,República Dominicana,214,4838,4046,,8884,"(4.697144,-74.140516)"
2018,Octubre,República Dominicana,214,54,45,,99,"(4.815061,-75.736532)"
2018,Octubre,República Dominicana,214,470,372,,842,"(6.171601,-75.427454)"
2018,Octubre,República Dominicana,214,63,51,,115,"(7.128456,-73.183637)"
2018,Octubre,Reunión,638,1,1,,2,"(4.697144,-74.140516)"
2018,Octubre,Rumania,642,2,4,,6,"(4.697144,-74.140516)"
2018,Octubre,Rumania,642,1,2,,3,"(6.171601,-75.427454)"
2018,Octubre,Rwanda,646,0,1,,1,"(10.445761,-75.516429)"
2018,Octubre,Rwanda,646,1,0,,1,"(4.697144,-74.140516)"
2018,Octubre,Sahara Occidental/Desierto Sahara,732,2,0,,2,"(4.697144,-74.140516)"
2018,Octubre,Senegal,686,0,1,,1,"(4.697144,-74.140516)"
2018,Octubre,Serbia,688,4,0,,4,"(4.697144,-74.140516)"
2018,Octubre,Serbia,688,1,0,,1,"(6.171601,-75.427454)"
2018,Octubre,Sierra Leona,694,0,1,,1,"(4.697144,-74.140516)"
2018,Octubre,Singapur,702,2,2,,4,"(10.445761,-75.516429)"
2018,Octubre,Singapur,702,3,6,,9,"(3.541112,-76.384584)"
2018,Octubre,Singapur,702,23,30,,53,"(4.697144,-74.140516)"
2018,Octubre,Singapur,702,2,3,,5,"(6.171601,-75.427454)"
2018,Octubre,Sudáfrica,710,1,2,,3,"(10.886611,-74.776708)"
2018,Octubre,Sudáfrica,710,17,19,,36,"(4.697144,-74.140516)"
2018,Octubre,Sudáfrica,710,2,1,,3,"(6.171601,-75.427454)"
2018,Octubre,Sudán,736,1,0,,1,"(3.541112,-76.384584)"
2018,Octubre,Suecia,752,3,5,,8,"(10.886611,-74.776708)"
2018,Octubre,Suecia,752,11,15,,26,"(3.541112,-76.384584)"
2018,Octubre,Suecia,752,45,31,,76,"(4.697144,-74.140516)"
2018,Octubre,Suecia,752,8,3,,11,"(6.171601,-75.427454)"
2018,Octubre,Suiza,756,9,4,,13,"(10.445761,-75.516429)"
2018,Octubre,Suiza,756,3,1,,4,"(10.886611,-74.776708)"
2018,Octubre,Suiza,756,43,22,,65,"(3.541112,-76.384584)"
2018,Octubre,Suiza,756,209,151,,360,"(4.697144,-74.140516)"
2018,Octubre,Suiza,756,0,1,,1,"(4.815061,-75.736532)"
2018,Octubre,Suiza,756,30,23,,53,"(6.171601,-75.427454)"
2018,Octubre,Surinam,740,4,11,,15,"(4.697144,-74.140516)"
2018,Octubre,Surinam,740,1,0,,1,"(6.171601,-75.427454)"
2018,Octubre,Taiwán,158,7,5,,12,"(4.697144,-74.140516)"
2018,Octubre,Tailandia,764,49,35,,84,"(4.697144,-74.140516)"
2018,Octubre,Tailandia,764,3,2,,5,"(6.171601,-75.427454)"
2018,Octubre,Tanzania,834,1,1,,2,"(4.697144,-74.140516)"
2018,Octubre,Tanzania,834,0,1,,1,"(6.171601,-75.427454)"
2018,Octubre,Togo,768,1,0,,1,"(11.360009,-72.129330)"
2018,Octubre,Trinidad y Tobago,780,0,2,,2,"(10.445761,-75.516429)"
2018,Octubre,Trinidad y Tobago,780,2,5,,7,"(10.886611,-74.776708)"
2018,Octubre,Trinidad y Tobago,780,0,1,,1,"(12.586067,-81.702563)"
2018,Octubre,Trinidad y Tobago,780,3,7,,10,"(3.541112,-76.384584)"
2018,Octubre,Trinidad y Tobago,780,25,29,,54,"(4.697144,-74.140516)"
2018,Octubre,Trinidad y Tobago,780,2,2,,4,"(4.815061,-75.736532)"
2018,Octubre,Trinidad y Tobago,780,8,5,,13,"(6.171601,-75.427454)"
2018,Octubre,Trinidad y Tobago,780,2,3,,5,"(7.128456,-73.183637)"
2018,Octubre,Turquía,792,1,1,,2,"(10.445761,-75.516429)"
2018,Octubre,Turquía,792,14,5,,19,"(3.541112,-76.384584)"
2018,Octubre,Turquía,792,1297,653,,1950,"(4.697144,-74.140516)"
2018,Octubre,Turquía,792,1,0,,1,"(4.815061,-75.736532)"
2018,Octubre,Turquía,792,36,17,,53,"(6.171601,-75.427454)"
2018,Octubre,Turkmenistán,795,4,1,,5,"(4.697144,-74.140516)"
2018,Octubre,Ucrania,804,0,1,,1,"(10.445761,-75.516429)"
2018,Octubre,Ucrania,804,1,1,,2,"(4.697144,-74.140516)"
2018,Octubre,Uganda,800,1,1,,2,"(4.697144,-74.140516)"
2018,Octubre,Uruguay,858,5,3,,8,"(10.445761,-75.516429)"
2018,Octubre,Uruguay,858,3,2,,5,"(10.886611,-74.776708)"
2018,Octubre,Uruguay,858,11,16,,27,"(3.541112,-76.384584)"
2018,Octubre,Uruguay,858,366,356,,722,"(4.697144,-74.140516)"
2018,Octubre,Uruguay,858,0,9,,9,"(4.815061,-75.736532)"
2018,Octubre,Uruguay,858,27,25,,52,"(6.171601,-75.427454)"
2018,Octubre,Venezuela,862,1,1,,2,"(0.814836,-77.662532)"
2018,Octubre,Venezuela,862,0,1,,1,"(10.408582,-75.538003)"
2018,Octubre,Venezuela,862,5,7,,12,"(10.445761,-75.516429)"
2018,Octubre,Venezuela,862,17,13,,30,"(10.886611,-74.776708)"
2018,Octubre,Venezuela,862,0,2,,2,"(11.117806,-74.232622)"
2018,Octubre,Venezuela,862,1492,1657,,3149,"(11.360009,-72.129330)"
2018,Octubre,Venezuela,862,575,420,,995,"(3.541112,-76.384584)"
2018,Octubre,Venezuela,862,0,5,,5,"(3.866713,-67.927521)"
2018,Octubre,Venezuela,862,1722,1480,,3202,"(4.697144,-74.140516)"
2018,Octubre,Venezuela,862,0,3,,3,"(4.815061,-75.736532)"
2018,Octubre,Venezuela,862,787,609,,1396,"(6.171601,-75.427454)"
2018,Octubre,Venezuela,862,17,42,,59,"(6.185799,-67.483929)"
2018,Octubre,Venezuela,862,573,489,,1062,"(7.088729,-70.740253)"
2018,Octubre,Venezuela,862,1,1,,2,"(7.128456,-73.183637)"
2018,Octubre,Venezuela,862,1038,966,,2004,"(7.818934,-72.453226)"
2018,Octubre,Venezuela,862,1,1,,2,"(7.927209,-72.507910)"
2018,Octubre,Venezuela,862,118,162,,280,"(8.36068,-72.409396)"
2018,Octubre,Vietnam,704,3,6,,9,"(4.697144,-74.140516)"
2018,Octubre,Vietnam,704,0,2,,2,"(6.171601,-75.427454)"
2018,Octubre,Islas Turcas y Caicos/Territorio Británico de Ultramar,796,1,0,,1,"(3.541112,-76.384584)"
2018,Octubre,Islas Turcas y Caicos/Territorio Británico de Ultramar,796,0,1,,1,"(4.697144,-74.140516)"
2018,Noviembre,Afganistán,4,0,2,,2,"(4.697144,-74.140516)"
2018,Noviembre,Albania,8,1,0,,1,"(0.814836,-77.662532)"
2018,Noviembre,Albania,8,1,0,,1,"(3.541112,-76.384584)"
2018,Noviembre,Albania,8,1,0,,1,"(4.697144,-74.140516)"
2018,Noviembre,Alemania,276,2,2,,4,"(0.814836,-77.662532)"
2018,Noviembre,Alemania,276,11,6,,17,"(10.445761,-75.516429)"
2018,Noviembre,Alemania,276,7,4,,11,"(10.886611,-74.776708)"
2018,Noviembre,Alemania,276,34,34,,68,"(3.541112,-76.384584)"
2018,Noviembre,Alemania,276,1659,1634,,3293,"(4.697144,-74.140516)"
2018,Noviembre,Alemania,276,63,63,,126,"(6.171601,-75.427454)"
2018,Noviembre,Andorra,20,5,0,,5,"(4.697144,-74.140516)"
2018,Noviembre,Angola,24,1,0,,1,"(10.886611,-74.776708)"
2018,Noviembre,Angola,24,1,3,,4,"(4.697144,-74.140516)"
2018,Noviembre,Antigua y Barbuda,28,5,8,,13,"(4.697144,-74.140516)"
2018,Noviembre,Antigua y Barbuda,28,1,0,,1,"(6.171601,-75.427454)"
2018,Noviembre,Países Bajos,528,1,0,,1,"(10.408582,-75.538003)"
2018,Noviembre,Países Bajos,528,94,71,,165,"(10.445761,-75.516429)"
2018,Noviembre,Países Bajos,528,12,17,,29,"(10.886611,-74.776708)"
2018,Noviembre,Países Bajos,528,56,28,,84,"(3.541112,-76.384584)"
2018,Noviembre,Países Bajos,528,1337,1147,,2484,"(4.697144,-74.140516)"
2018,Noviembre,Países Bajos,528,5,0,,5,"(4.815061,-75.736532)"
2018,Noviembre,Países Bajos,528,87,77,,164,"(6.171601,-75.427454)"
2018,Noviembre,Países Bajos,528,4,2,,6,"(7.128456,-73.183637)"
2018,Noviembre,Países Bajos,528,1,3,,4,"(7.927209,-72.507910)"
2018,Noviembre,Arabia Saudita,682,0,1,,1,"(10.445761,-75.516429)"
2018,Noviembre,Arabia Saudita,682,0,1,,1,"(10.886611,-74.776708)"
2018,Noviembre,Arabia Saudita,682,0,2,,2,"(3.541112,-76.384584)"
2018,Noviembre,Arabia Saudita,682,4,28,,32,"(4.697144,-74.140516)"
2018,Noviembre,Arabia Saudita,682,0,2,,2,"(6.171601,-75.427454)"
2018,Noviembre,Argelia,12,1,0,,1,"(0.814836,-77.662532)"
2018,Noviembre,Argelia,12,1,1,,2,"(3.541112,-76.384584)"
2018,Noviembre,Argelia,12,3,4,,7,"(4.697144,-74.140516)"
2018,Noviembre,Argentina,32,0,2,,2,"(0.25129,-76.875963)"
2018,Noviembre,Argentina,32,3,10,,13,"(0.814836,-77.662532)"
2018,Noviembre,Argentina,32,1,2,,3,"(1.813928,-78.763924)"
2018,Noviembre,Argentina,32,54,50,,104,"(10.445761,-75.516429)"
2018,Noviembre,Argentina,32,42,32,,74,"(10.886611,-74.776708)"
2018,Noviembre,Argentina,32,162,153,,315,"(3.541112,-76.384584)"
2018,Noviembre,Argentina,32,3289,3136,,6425,"(4.697144,-74.140516)"
2018,Noviembre,Argentina,32,31,23,,54,"(4.815061,-75.736532)"
2018,Noviembre,Argentina,32,342,328,,670,"(6.171601,-75.427454)"
2018,Noviembre,Argentina,32,7,6,,13,"(7.128456,-73.183637)"
2018,Noviembre,República de Armenia,51,1,1,,2,"(4.697144,-74.140516)"
2018,Noviembre,Aruba,533,2994,1911,,4905,"(10.408582,-75.538003)"
2018,Noviembre,Aruba,533,6,4,,10,"(10.445761,-75.516429)"
2018,Noviembre,Aruba,533,10,11,,21,"(10.886611,-74.776708)"
2018,Noviembre,Aruba,533,1,1,,2,"(11.247723,-74.213989)"
2018,Noviembre,Aruba,533,34,27,,61,"(3.541112,-76.384584)"
2018,Noviembre,Aruba,533,2089,1565,,3654,"(4.697144,-74.140516)"
2018,Noviembre,Aruba,533,15,12,,27,"(4.815061,-75.736532)"
2018,Noviembre,Aruba,533,16,16,,32,"(6.171601,-75.427454)"
2018,Noviembre,Aruba,533,8,17,,25,"(7.128456,-73.183637)"
2018,Noviembre,Australia,36,1,1,,2,"(10.445761,-75.516429)"
2018,Noviembre,Australia,36,0,4,,4,"(10.886611,-74.776708)"
2018,Noviembre,Australia,36,4,7,,11,"(3.541112,-76.384584)"
2018,Noviembre,Australia,36,415,287,,702,"(4.697144,-74.140516)"
2018,Noviembre,Australia,36,2,0,,2,"(4.815061,-75.736532)"
2018,Noviembre,Australia,36,31,25,,56,"(6.171601,-75.427454)"
2018,Noviembre,Austria,40,4,0,,4,"(3.541112,-76.384584)"
2018,Noviembre,Austria,40,22,25,,47,"(4.697144,-74.140516)"
2018,Noviembre,Austria,40,4,3,,7,"(6.171601,-75.427454)"
2018,Noviembre,Azerbaiyán,31,0,3,,3,"(4.697144,-74.140516)"
2018,Noviembre,Azerbaiyán,31,1,0,,1,"(6.171601,-75.427454)"
2018,Noviembre,Bahamas,44,0,2,,2,"(10.886611,-74.776708)"
2018,Noviembre,Bahamas,44,11,4,,15,"(3.541112,-76.384584)"
2018,Noviembre,Bahamas,44,13,12,,25,"(4.697144,-74.140516)"
2018,Noviembre,Bahamas,44,1,0,,1,"(4.815061,-75.736532)"
2018,Noviembre,Bahamas,44,15,7,,22,"(6.171601,-75.427454)"
2018,Noviembre,Bahréin,48,1,0,,1,"(4.452882,-75.766298)"
2018,Noviembre,Bahréin,48,2,1,,3,"(4.697144,-74.140516)"
2018,Noviembre,Bangladesh,50,0,2,,2,"(4.697144,-74.140516)"
2018,Noviembre,Barbados,52,0,2,,2,"(10.886611,-74.776708)"
2018,Noviembre,Barbados,52,2,3,,5,"(3.541112,-76.384584)"
2018,Noviembre,Barbados,52,9,9,,18,"(4.697144,-74.140516)"
2018,Noviembre,República de Belarús,112,0,1,,1,"(4.697144,-74.140516)"
2018,Noviembre,Bélgica,56,2,0,,2,"(10.445761,-75.516429)"
2018,Noviembre,Bélgica,56,1,0,,1,"(10.886611,-74.776708)"
2018,Noviembre,Bélgica,56,9,7,,16,"(3.541112,-76.384584)"
2018,Noviembre,Bélgica,56,87,50,,137,"(4.697144,-74.140516)"
2018,Noviembre,Bélgica,56,4,0,,4,"(4.815061,-75.736532)"
2018,Noviembre,Bélgica,56,19,13,,32,"(6.171601,-75.427454)"
2018,Noviembre,Bélgica,56,1,0,,1,"(7.128456,-73.183637)"
2018,Noviembre,Belice,84,1,0,,1,"(10.445761,-75.516429)"
2018,Noviembre,Belice,84,0,1,,1,"(10.886611,-74.776708)"
2018,Noviembre,Belice,84,3,2,,5,"(3.541112,-76.384584)"
2018,Noviembre,Belice,84,9,9,,18,"(4.697144,-74.140516)"
2018,Noviembre,Belice,84,3,2,,5,"(6.171601,-75.427454)"
2018,Noviembre,Benín,204,2,0,,2,"(4.697144,-74.140516)"
2018,Noviembre,Bermudas/Territorio Británico de Ultramar,60,1,1,,2,"(4.697144,-74.140516)"
2018,Noviembre,Bolivia,68,0,2,,2,"(0.814836,-77.662532)"
2018,Noviembre,Bolivia,68,4,5,,9,"(10.445761,-75.516429)"
2018,Noviembre,Bolivia,68,3,3,,6,"(10.886611,-74.776708)"
2018,Noviembre,Bolivia,68,20,31,,51,"(3.541112,-76.384584)"
2018,Noviembre,Bolivia,68,354,532,,886,"(4.697144,-74.140516)"
2018,Noviembre,Bolivia,68,2,3,,5,"(4.815061,-75.736532)"
2018,Noviembre,Bolivia,68,16,30,,46,"(6.171601,-75.427454)"
2018,Noviembre,Bolivia,68,2,3,,5,"(7.128456,-73.183637)"
2018,Noviembre,Bosnia y Herzegovina,70,1,2,,3,"(4.697144,-74.140516)"
2018,Noviembre,Brasil,76,122,208,,330,"(-4.197703,-69.941278)"
2018,Noviembre,Brasil,76,19,16,,35,"(-4.223468,-69.945098)"
2018,Noviembre,Brasil,76,15,19,,34,"(10.445761,-75.516429)"
2018,Noviembre,Brasil,76,39,22,,61,"(10.886611,-74.776708)"
2018,Noviembre,Brasil,76,164,131,,295,"(3.541112,-76.384584)"
2018,Noviembre,Brasil,76,3849,4644,,8493,"(4.697144,-74.140516)"
2018,Noviembre,Brasil,76,26,42,,68,"(4.815061,-75.736532)"
2018,Noviembre,Brasil,76,243,268,,511,"(6.171601,-75.427454)"
2018,Noviembre,Brasil,76,4,8,,12,"(7.128456,-73.183637)"
2018,Noviembre,Bulgaria,100,3,1,,4,"(4.697144,-74.140516)"
2018,Noviembre,Islas Caimán/Territorio Británico de Ultramar,136,1,2,,3,"(10.445761,-75.516429)"
2018,Noviembre,Islas Caimán/Territorio Británico de Ultramar,136,0,1,,1,"(10.886611,-74.776708)"
2018,Noviembre,Islas Caimán/Territorio Británico de Ultramar,136,1,0,,1,"(3.541112,-76.384584)"
2018,Noviembre,Islas Caimán/Territorio Británico de Ultramar,136,5,1,,6,"(4.697144,-74.140516)"
2018,Noviembre,Camboya,116,5,8,,13,"(4.697144,-74.140516)"
2018,Noviembre,Camboya,116,2,0,,2,"(6.171601,-75.427454)"
2018,Noviembre,Antártida,10,0,1,,1,"(3.893038,-77.067921)"
2018,Noviembre,Canadá,124,23,24,,47,"(10.445761,-75.516429)"
2018,Noviembre,Canadá,124,29,29,,58,"(10.886611,-74.776708)"
2018,Noviembre,Canadá,124,3,1,,4,"(12.586067,-81.702563)"
2018,Noviembre,Canadá,124,109,76,,185,"(3.541112,-76.384584)"
2018,Noviembre,Canadá,124,1258,1121,,2379,"(4.697144,-74.140516)"
2018,Noviembre,Canadá,124,16,6,,22,"(4.815061,-75.736532)"
2018,Noviembre,Canadá,124,207,118,,325,"(6.171601,-75.427454)"
2018,Noviembre,Canadá,124,10,9,,19,"(7.128456,-73.183637)"
2018,Noviembre,España,724,1,0,,1,"(0.814836,-77.662532)"
2018,Noviembre,España,724,10,9,,19,"(10.445761,-75.516429)"
2018,Noviembre,España,724,4,5,,9,"(10.886611,-74.776708)"
2018,Noviembre,España,724,3045,2151,,5196,"(3.541112,-76.384584)"
2018,Noviembre,España,724,12926,10112,,23039,"(4.697144,-74.140516)"
2018,Noviembre,España,724,9,7,,16,"(4.815061,-75.736532)"
2018,Noviembre,España,724,2141,1542,,3683,"(6.171601,-75.427454)"
2018,Noviembre,España,724,0,1,,1,"(7.128456,-73.183637)"
2018,Noviembre,Colombia,170,1,16,,17,"(10.445761,-75.516429)"
2018,Noviembre,Colombia,170,256,625,,881,"(4.697144,-74.140516)"
2018,Noviembre,República de Corea,410,1,0,,1,"(3.541112,-76.384584)"
2018,Noviembre,República de Corea,410,28,38,,66,"(4.697144,-74.140516)"
2018,Noviembre,República de Corea,410,2,8,,10,"(6.171601,-75.427454)"
2018,Noviembre,Costa de Marfil,384,8,4,,12,"(4.697144,-74.140516)"
2018,Noviembre,Costa de Marfil,384,0,1,,1,"(6.171601,-75.427454)"
2018,Noviembre,Costa Rica,188,9,11,,20,"(10.445761,-75.516429)"
2018,Noviembre,Costa Rica,188,14,21,,35,"(10.886611,-74.776708)"
2018,Noviembre,Costa Rica,188,3,26,,29,"(12.5744111,-81.703935)"
2018,Noviembre,Costa Rica,188,5,3,,8,"(12.586067,-81.702563)"
2018,Noviembre,Costa Rica,188,59,43,,102,"(3.541112,-76.384584)"
2018,Noviembre,Costa Rica,188,985,1238,,2223,"(4.697144,-74.140516)"
2018,Noviembre,Costa Rica,188,9,17,,26,"(4.815061,-75.736532)"
2018,Noviembre,Costa Rica,188,0,3,,3,"(6.17134,-75.427194)"
2018,Noviembre,Costa Rica,188,109,114,,223,"(6.171601,-75.427454)"
2018,Noviembre,Costa Rica,188,1,4,,5,"(7.128456,-73.183637)"
2018,Noviembre,Croacia,191,1,2,,3,"(4.697144,-74.140516)"
2018,Noviembre,Cuba,192,14,14,,28,"(10.445761,-75.516429)"
2018,Noviembre,Cuba,192,16,11,,27,"(10.886611,-74.776708)"
2018,Noviembre,Cuba,192,0,1,,1,"(12.586067,-81.702563)"
2018,Noviembre,Cuba,192,44,34,,78,"(3.541112,-76.384584)"
2018,Noviembre,Cuba,192,1683,1311,,2994,"(4.697144,-74.140516)"
2018,Noviembre,Cuba,192,7,5,,12,"(4.815061,-75.736532)"
2018,Noviembre,Cuba,192,89,64,,153,"(6.171601,-75.427454)"
2018,Noviembre,Cuba,192,4,2,,6,"(7.128456,-73.183637)"
2018,Noviembre,Curazao,99999,0,1,,1,"(10.445761,-75.516429)"
2018,Noviembre,Curazao,99999,3,3,,6,"(10.886611,-74.776708)"
2018,Noviembre,Curazao,99999,3,1,,4,"(3.541112,-76.384584)"
2018,Noviembre,Curazao,99999,611,532,,1143,"(4.697144,-74.140516)"
2018,Noviembre,Curazao,99999,2,2,,4,"(4.815061,-75.736532)"
2018,Noviembre,Curazao,99999,8,6,,14,"(6.171601,-75.427454)"
2018,Noviembre,República Checa,203,1,3,,4,"(10.445761,-75.516429)"
2018,Noviembre,República Checa,203,12,6,,18,"(4.697144,-74.140516)"
2018,Noviembre,República Checa,203,2,2,,4,"(6.171601,-75.427454)"
2018,Noviembre,Chile,152,0,1,,1,"(0.25129,-76.875963)"
2018,Noviembre,Chile,152,80,86,,166,"(0.814836,-77.662532)"
2018,Noviembre,Chile,152,39,21,,60,"(10.445761,-75.516429)"
2018,Noviembre,Chile,152,35,22,,57,"(10.886611,-74.776708)"
2018,Noviembre,Chile,152,7,70,,77,"(10.971302,-74.765397)"
2018,Noviembre,Chile,152,327,188,,515,"(3.541112,-76.384584)"
2018,Noviembre,Chile,152,5019,4400,,9419,"(4.697144,-74.140516)"
2018,Noviembre,Chile,152,52,35,,87,"(4.815061,-75.736532)"
2018,Noviembre,Chile,152,288,251,,539,"(6.171601,-75.427454)"
2018,Noviembre,Chile,152,3,5,,8,"(7.128456,-73.183637)"
2018,Noviembre,China,156,0,1,,1,"(10.445761,-75.516429)"
2018,Noviembre,China,156,0,3,,3,"(10.886611,-74.776708)"
2018,Noviembre,China,156,0,1,,1,"(11.360009,-72.129330)"
2018,Noviembre,China,156,2,9,,11,"(3.541112,-76.384584)"
2018,Noviembre,China,156,133,304,,437,"(4.697144,-74.140516)"
2018,Noviembre,China,156,14,44,,58,"(6.171601,-75.427454)"
2018,Noviembre,China,156,1,1,,2,"(7.128456,-73.183637)"
2018,Noviembre,Dinamarca,208,1,1,,2,"(10.445761,-75.516429)"
2018,Noviembre,Dinamarca,208,4,3,,7,"(3.541112,-76.384584)"
2018,Noviembre,Dinamarca,208,23,23,,46,"(4.697144,-74.140516)"
2018,Noviembre,Dinamarca,208,1,0,,1,"(4.815061,-75.736532)"
2018,Noviembre,Dinamarca,208,2,1,,3,"(6.171601,-75.427454)"
2018,Noviembre,Dominica,212,0,6,,6,"(3.541112,-76.384584)"
2018,Noviembre,Dominica,212,0,1,,1,"(4.697144,-74.140516)"
2018,Noviembre,Ecuador,218,604,863,,1467,"(0.25129,-76.875963)"
2018,Noviembre,Ecuador,218,20,15,,35,"(0.812436,-77.847006)"
2018,Noviembre,Ecuador,218,5161,5894,,11055,"(0.814836,-77.662532)"
2018,Noviembre,Ecuador,218,159,198,,357,"(1.813928,-78.763924)"
2018,Noviembre,Ecuador,218,8,5,,13,"(10.445761,-75.516429)"
2018,Noviembre,Ecuador,218,12,10,,22,"(10.886611,-74.776708)"
2018,Noviembre,Ecuador,218,398,559,,957,"(3.541112,-76.384584)"
2018,Noviembre,Ecuador,218,0,1,,1,"(3.893038,-77.067921)"
2018,Noviembre,Ecuador,218,2872,4201,,7073,"(4.697144,-74.140516)"
2018,Noviembre,Ecuador,218,6,2,,8,"(4.815061,-75.736532)"
2018,Noviembre,Ecuador,218,29,64,,93,"(6.171601,-75.427454)"
2018,Noviembre,Ecuador,218,1,3,,4,"(7.128456,-73.183637)"
2018,Noviembre,Egipto,818,2,1,,3,"(3.541112,-76.384584)"
2018,Noviembre,Egipto,818,30,16,,46,"(4.697144,-74.140516)"
2018,Noviembre,El Salvador,222,36,34,,70,"(10.445761,-75.516429)"
2018,Noviembre,El Salvador,222,5,8,,13,"(10.886611,-74.776708)"
2018,Noviembre,El Salvador,222,142,122,,264,"(3.541112,-76.384584)"
2018,Noviembre,El Salvador,222,744,990,,1734,"(4.697144,-74.140516)"
2018,Noviembre,El Salvador,222,1,2,,3,"(4.815061,-75.736532)"
2018,Noviembre,El Salvador,222,18,22,,40,"(6.171601,-75.427454)"
2018,Noviembre,El Salvador,222,0,1,,1,"(7.128456,-73.183637)"
2018,Noviembre,Emiratos Árabes,784,3,1,,4,"(10.445761,-75.516429)"
2018,Noviembre,Emiratos Árabes,784,1,4,,5,"(3.541112,-76.384584)"
2018,Noviembre,Emiratos Árabes,784,170,363,,533,"(4.697144,-74.140516)"
2018,Noviembre,Emiratos Árabes,784,8,8,,16,"(6.171601,-75.427454)"
2018,Noviembre,Eritrea,232,1,0,,1,"(4.697144,-74.140516)"
2018,Noviembre,Eslovaquia,703,2,2,,4,"(4.697144,-74.140516)"
2018,Noviembre,Eslovenia,705,1,0,,1,"(10.445761,-75.516429)"
2018,Noviembre,Eslovenia,705,1,1,,2,"(4.697144,-74.140516)"
2018,Noviembre,Estados Unidos de América,840,1,0,,1,"(10.408582,-75.538003)"
2018,Noviembre,Estados Unidos de América,840,4302,3433,,7735,"(10.445761,-75.516429)"
2018,Noviembre,Estados Unidos de América,840,3274,2530,,5804,"(10.886611,-74.776708)"
2018,Noviembre,Estados Unidos de América,840,4,5,,9,"(11.117806,-74.232622)"
2018,Noviembre,Estados Unidos de América,840,66,55,,121,"(12.586067,-81.702563)"
2018,Noviembre,Estados Unidos de América,840,5930,3984,,9914,"(3.541112,-76.384584)"
2018,Noviembre,Estados Unidos de América,840,848,583,,1431,"(4.452882,-75.766298)"
2018,Noviembre,Estados Unidos de América,840,39430,33753,,73185,"(4.697144,-74.140516)"
2018,Noviembre,Estados Unidos de América,840,892,578,,1470,"(4.815061,-75.736532)"
2018,Noviembre,Estados Unidos de América,840,11739,9005,,20744,"(6.171601,-75.427454)"
2018,Noviembre,Estados Unidos de América,840,258,181,,439,"(7.128456,-73.183637)"
2018,Noviembre,Estonia,233,0,1,,1,"(10.445761,-75.516429)"
2018,Noviembre,Estonia,233,6,4,,10,"(4.697144,-74.140516)"
2018,Noviembre,Estonia,233,0,2,,2,"(6.171601,-75.427454)"
2018,Noviembre,Etiopia,231,5,3,,8,"(4.697144,-74.140516)"
2018,Noviembre,Etiopia,231,0,1,,1,"(6.171601,-75.427454)"
2018,Noviembre,Filipinas,608,2,0,,2,"(3.541112,-76.384584)"
2018,Noviembre,Filipinas,608,2,9,,11,"(4.697144,-74.140516)"
2018,Noviembre,Filipinas,608,0,1,,1,"(6.171601,-75.427454)"
2018,Noviembre,Finlandia,246,0,1,,1,"(10.445761,-75.516429)"
2018,Noviembre,Finlandia,246,2,10,,12,"(4.697144,-74.140516)"
2018,Noviembre,Francia,250,11,7,,18,"(10.445761,-75.516429)"
2018,Noviembre,Francia,250,2,2,,4,"(10.886611,-74.776708)"
2018,Noviembre,Francia,250,69,39,,108,"(3.541112,-76.384584)"
2018,Noviembre,Francia,250,1351,1143,,2494,"(4.697144,-74.140516)"
2018,Noviembre,Francia,250,3,5,,8,"(4.815061,-75.736532)"
2018,Noviembre,Francia,250,61,45,,106,"(6.171601,-75.427454)"
2018,Noviembre,Gabón,266,0,2,,2,"(4.697144,-74.140516)"
2018,Noviembre,Gabón,266,0,1,,1,"(6.171601,-75.427454)"
2018,Noviembre,Ghana,288,0,1,,1,"(10.445761,-75.516429)"
2018,Noviembre,Ghana,288,0,3,,3,"(4.697144,-74.140516)"
2018,Noviembre,Granada,308,1,0,,1,"(10.886611,-74.776708)"
2018,Noviembre,Grecia,300,2,1,,3,"(10.445761,-75.516429)"
2018,Noviembre,Grecia,300,1,0,,1,"(12.586067,-81.702563)"
2018,Noviembre,Grecia,300,1,1,,2,"(3.541112,-76.384584)"
2018,Noviembre,Grecia,300,11,6,,17,"(4.697144,-74.140516)"
2018,Noviembre,Grecia,300,2,1,,3,"(6.171601,-75.427454)"
2018,Noviembre,Guatemala,320,1,9,,10,"(10.445761,-75.516429)"
2018,Noviembre,Guatemala,320,13,12,,25,"(10.886611,-74.776708)"
2018,Noviembre,Guatemala,320,2,1,,3,"(12.586067,-81.702563)"
2018,Noviembre,Guatemala,320,77,108,,185,"(3.541112,-76.384584)"
2018,Noviembre,Guatemala,320,595,718,,1313,"(4.697144,-74.140516)"
2018,Noviembre,Guatemala,320,5,7,,12,"(4.815061,-75.736532)"
2018,Noviembre,Guatemala,320,81,101,,182,"(6.171601,-75.427454)"
2018,Noviembre,Guatemala,320,3,5,,8,"(7.128456,-73.183637)"
2018,Noviembre,Guyana,328,0,1,,1,"(10.445761,-75.516429)"
2018,Noviembre,Guyana,328,3,0,,3,"(3.541112,-76.384584)"
2018,Noviembre,Guyana,328,9,18,,27,"(4.697144,-74.140516)"
2018,Noviembre,Guyana,328,0,2,,2,"(4.815061,-75.736532)"
2018,Noviembre,Guyana,328,5,8,,13,"(6.171601,-75.427454)"
2018,Noviembre,Guinea,324,3,0,,3,"(0.814836,-77.662532)"
2018,Noviembre,Guinea Ecuatorial,226,2,0,,2,"(3.541112,-76.384584)"
2018,Noviembre,Guinea Ecuatorial,226,0,3,,3,"(4.697144,-74.140516)"
2018,Noviembre,Guadalupe/Territorio Francés,312,0,1,,1,"(10.408582,-75.538003)"
2018,Noviembre,Guam/Territorio no incorporado de Estados Unidos,316,1,0,,1,"(4.697144,-74.140516)"
2018,Noviembre,Guayana Francesa/Departamento de Ultramar Francés,254,5,3,,8,"(4.697144,-74.140516)"
2018,Noviembre,Guayana Francesa/Departamento de Ultramar Francés,254,1,2,,3,"(6.171601,-75.427454)"
2018,Noviembre,Haití,332,0,1,,1,"(3.541112,-76.384584)"
2018,Noviembre,Haití,332,2,6,,8,"(4.697144,-74.140516)"
2018,Noviembre,Haití,332,2,0,,2,"(6.171601,-75.427454)"
2018,Noviembre,Honduras,340,0,14,,14,"(10.408582,-75.538003)"
2018,Noviembre,Honduras,340,4,10,,14,"(10.445761,-75.516429)"
2018,Noviembre,Honduras,340,9,13,,22,"(10.886611,-74.776708)"
2018,Noviembre,Honduras,340,1,3,,4,"(12.5744111,-81.703935)"
2018,Noviembre,Honduras,340,1,3,,4,"(12.586067,-81.702563)"
2018,Noviembre,Honduras,340,15,34,,49,"(3.541112,-76.384584)"
2018,Noviembre,Honduras,340,66,143,,209,"(4.697144,-74.140516)"
2018,Noviembre,Honduras,340,5,4,,9,"(4.815061,-75.736532)"
2018,Noviembre,Honduras,340,29,53,,82,"(6.171601,-75.427454)"
2018,Noviembre,Honduras,340,1,0,,1,"(7.128456,-73.183637)"
2018,Noviembre,Hong Kong,344,1,0,,1,"(3.541112,-76.384584)"
2018,Noviembre,Hong Kong,344,17,33,,50,"(4.697144,-74.140516)"
2018,Noviembre,Hong Kong,344,1,1,,2,"(6.171601,-75.427454)"
2018,Noviembre,Hungría,348,9,10,,19,"(3.541112,-76.384584)"
2018,Noviembre,Hungría,348,8,4,,12,"(4.697144,-74.140516)"
2018,Noviembre,Hungría,348,3,4,,7,"(6.171601,-75.427454)"
2018,Noviembre,India,356,7,4,,11,"(10.886611,-74.776708)"
2018,Noviembre,India,356,4,3,,7,"(3.541112,-76.384584)"
2018,Noviembre,India,356,49,35,,84,"(4.697144,-74.140516)"
2018,Noviembre,India,356,25,9,,34,"(6.171601,-75.427454)"
2018,Noviembre,Indonesia,360,0,1,,1,"(10.445761,-75.516429)"
2018,Noviembre,Indonesia,360,4,4,,8,"(4.697144,-74.140516)"
2018,Noviembre,Indonesia,360,2,0,,2,"(6.171601,-75.427454)"
2018,Noviembre,Iraq,368,1,4,,5,"(4.697144,-74.140516)"
2018,Noviembre,República de Irlanda,372,1,0,,1,"(3.541112,-76.384584)"
2018,Noviembre,República de Irlanda,372,8,5,,13,"(4.697144,-74.140516)"
2018,Noviembre,República de Irlanda,372,1,1,,2,"(6.171601,-75.427454)"
2018,Noviembre,Islandia,352,3,3,,6,"(4.697144,-74.140516)"
2018,Noviembre,Islandia,352,2,2,,4,"(6.171601,-75.427454)"
2018,Noviembre,Israel,376,3,2,,5,"(10.445761,-75.516429)"
2018,Noviembre,Israel,376,1,0,,1,"(10.886611,-74.776708)"
2018,Noviembre,Israel,376,5,5,,10,"(3.541112,-76.384584)"
2018,Noviembre,Israel,376,226,137,,363,"(4.697144,-74.140516)"
2018,Noviembre,Israel,376,8,1,,9,"(6.171601,-75.427454)"
2018,Noviembre,Italia,380,24,6,,30,"(10.445761,-75.516429)"
2018,Noviembre,Italia,380,11,6,,17,"(10.886611,-74.776708)"
2018,Noviembre,Italia,380,94,37,,131,"(3.541112,-76.384584)"
2018,Noviembre,Italia,380,459,353,,812,"(4.697144,-74.140516)"
2018,Noviembre,Italia,380,7,4,,11,"(4.815061,-75.736532)"
2018,Noviembre,Italia,380,62,47,,109,"(6.171601,-75.427454)"
2018,Noviembre,Jamaica,388,0,2,,2,"(10.408582,-75.538003)"
2018,Noviembre,Jamaica,388,0,5,,5,"(10.445761,-75.516429)"
2018,Noviembre,Jamaica,388,3,3,,6,"(10.886611,-74.776708)"
2018,Noviembre,Jamaica,388,6,5,,11,"(3.541112,-76.384584)"
2018,Noviembre,Jamaica,388,22,26,,48,"(4.697144,-74.140516)"
2018,Noviembre,Jamaica,388,1,3,,4,"(4.815061,-75.736532)"
2018,Noviembre,Jamaica,388,2,2,,4,"(6.17134,-75.427194)"
2018,Noviembre,Jamaica,388,7,7,,14,"(6.171601,-75.427454)"
2018,Noviembre,Jamaica,388,0,3,,3,"(7.128456,-73.183637)"
2018,Noviembre,Japón,392,1,1,,2,"(3.541112,-76.384584)"
2018,Noviembre,Japón,392,83,68,,151,"(4.697144,-74.140516)"
2018,Noviembre,Japón,392,5,3,,8,"(6.171601,-75.427454)"
2018,Noviembre,Jordania,400,2,0,,2,"(4.697144,-74.140516)"
2018,Noviembre,Jordania,400,1,0,,1,"(6.171601,-75.427454)"
2018,Noviembre,Kazajistán,398,0,7,,7,"(4.697144,-74.140516)"
2018,Noviembre,Kenia,404,0,1,,1,"(10.445761,-75.516429)"
2018,Noviembre,Kenia,404,0,1,,1,"(12.586067,-81.702563)"
2018,Noviembre,Kenia,404,1,0,,1,"(3.541112,-76.384584)"
2018,Noviembre,Kenia,404,1,4,,5,"(4.697144,-74.140516)"
2018,Noviembre,Kuwait,414,0,1,,1,"(10.445761,-75.516429)"
2018,Noviembre,Kuwait,414,0,1,,1,"(3.541112,-76.384584)"
2018,Noviembre,Kuwait,414,0,2,,2,"(4.697144,-74.140516)"
2018,Noviembre,Kuwait,414,0,1,,1,"(7.128456,-73.183637)"
2018,Noviembre,República Democrática Popular  Lao,418,1,0,,1,"(4.697144,-74.140516)"
2018,Noviembre,Lesoto,426,0,1,,1,"(4.697144,-74.140516)"
2018,Noviembre,Lituania,440,0,1,,1,"(6.171601,-75.427454)"
2018,Noviembre,Líbano,422,0,1,,1,"(10.886611,-74.776708)"
2018,Noviembre,Líbano,422,1,1,,2,"(3.541112,-76.384584)"
2018,Noviembre,Líbano,422,9,9,,18,"(4.697144,-74.140516)"
2018,Noviembre,Luxemburgo,442,1,2,,3,"(3.541112,-76.384584)"
2018,Noviembre,Luxemburgo,442,3,6,,9,"(4.697144,-74.140516)"
2018,Noviembre,Madagascar,450,0,1,,1,"(4.697144,-74.140516)"
2018,Noviembre,Malasia,458,0,2,,2,"(4.697144,-74.140516)"
2018,Noviembre,Malasia,458,1,0,,1,"(6.171601,-75.427454)"
2018,Noviembre,Maldivas,462,0,1,,1,"(4.697144,-74.140516)"
2018,Noviembre,Malí,466,0,1,,1,"(4.697144,-74.140516)"
2018,Noviembre,Malta,470,1,0,,1,"(10.886611,-74.776708)"
2018,Noviembre,Malta,470,1,1,,2,"(3.541112,-76.384584)"
2018,Noviembre,Malta,470,23,14,,37,"(4.697144,-74.140516)"
2018,Noviembre,Malta,470,4,3,,7,"(6.171601,-75.427454)"
2018,Noviembre,Marruecos,504,5,6,,11,"(4.697144,-74.140516)"
2018,Noviembre,Marruecos,504,1,2,,3,"(6.171601,-75.427454)"
2018,Noviembre,Mauricio,480,2,0,,2,"(4.697144,-74.140516)"
2018,Noviembre,Martinica/Departamento de Ultramar Francés,474,1,0,,1,"(10.886611,-74.776708)"
2018,Noviembre,Martinica/Departamento de Ultramar Francés,474,1,1,,2,"(4.697144,-74.140516)"
2018,Noviembre,México,484,0,9,,9,"(10.408582,-75.538003)"
2018,Noviembre,México,484,136,90,,226,"(10.445761,-75.516429)"
2018,Noviembre,México,484,218,181,,399,"(10.886611,-74.776708)"
2018,Noviembre,México,484,0,1,,1,"(12.5744111,-81.703935)"
2018,Noviembre,México,484,0,2,,2,"(12.586067,-81.702563)"
2018,Noviembre,México,484,856,679,,1535,"(3.541112,-76.384584)"
2018,Noviembre,México,484,17400,15340,,32740,"(4.697144,-74.140516)"
2018,Noviembre,México,484,190,148,,338,"(4.815061,-75.736532)"
2018,Noviembre,México,484,3,3,,6,"(6.17134,-75.427194)"
2018,Noviembre,México,484,2665,2182,,4847,"(6.171601,-75.427454)"
2018,Noviembre,México,484,160,106,,266,"(7.128456,-73.183637)"
2018,Noviembre,República de Moldavia,498,1,0,,1,"(4.697144,-74.140516)"
2018,Noviembre,Mónaco,492,0,3,,3,"(4.697144,-74.140516)"
2018,Noviembre,Mozambique,508,0,2,,2,"(4.697144,-74.140516)"
2018,Noviembre,Myanmar,104,3,0,,3,"(4.697144,-74.140516)"
2018,Noviembre,Nauru,520,1,0,,1,"(4.697144,-74.140516)"
2018,Noviembre,Namibia,516,1,0,,1,"(4.697144,-74.140516)"
2018,Noviembre,Nepal,524,1,0,,1,"(3.541112,-76.384584)"
2018,Noviembre,Nepal,524,0,2,,2,"(4.697144,-74.140516)"
2018,Noviembre,Nepal,524,0,1,,1,"(4.815061,-75.736532)"
2018,Noviembre,Nicaragua,558,1,3,,4,"(10.445761,-75.516429)"
2018,Noviembre,Nicaragua,558,5,6,,11,"(10.886611,-74.776708)"
2018,Noviembre,Nicaragua,558,0,4,,4,"(12.5744111,-81.703935)"
2018,Noviembre,Nicaragua,558,9,37,,46,"(3.541112,-76.384584)"
2018,Noviembre,Nicaragua,558,17,49,,66,"(4.697144,-74.140516)"
2018,Noviembre,Nicaragua,558,3,4,,7,"(4.815061,-75.736532)"
2018,Noviembre,Nicaragua,558,14,50,,64,"(6.171601,-75.427454)"
2018,Noviembre,Nicaragua,558,1,2,,3,"(7.128456,-73.183637)"
2018,Noviembre,Nigeria,566,0,1,,1,"(10.445761,-75.516429)"
2018,Noviembre,Nigeria,566,0,3,,3,"(4.697144,-74.140516)"
2018,Noviembre,Noruega,578,2,1,,3,"(10.445761,-75.516429)"
2018,Noviembre,Noruega,578,1,0,,1,"(10.886611,-74.776708)"
2018,Noviembre,Noruega,578,3,2,,5,"(3.541112,-76.384584)"
2018,Noviembre,Noruega,578,23,15,,38,"(4.697144,-74.140516)"
2018,Noviembre,Noruega,578,5,1,,6,"(6.171601,-75.427454)"
2018,Noviembre,Nueva Zelanda,554,1,0,,1,"(3.541112,-76.384584)"
2018,Noviembre,Nueva Zelanda,554,27,27,,54,"(4.697144,-74.140516)"
2018,Noviembre,Nueva Zelanda,554,1,1,,2,"(6.171601,-75.427454)"
2018,Noviembre,Omán,512,1,0,,1,"(10.445761,-75.516429)"
2018,Noviembre,Omán,512,4,7,,11,"(4.697144,-74.140516)"
2018,Noviembre,Omán,512,2,0,,2,"(6.171601,-75.427454)"
2018,Noviembre,Pakistán,586,0,1,,1,"(6.171601,-75.427454)"
2018,Noviembre,Panamá,591,149,165,,314,"(10.408582,-75.538003)"
2018,Noviembre,Panamá,591,1357,1150,,2507,"(10.445761,-75.516429)"
2018,Noviembre,Panamá,591,1061,924,,1985,"(10.886611,-74.776708)"
2018,Noviembre,Panamá,591,1,81,,82,"(10.971302,-74.765397)"
2018,Noviembre,Panamá,591,1,2,,3,"(11.117806,-74.232622)"
2018,Noviembre,Panamá,591,4,20,,24,"(12.5744111,-81.703935)"
2018,Noviembre,Panamá,591,100,97,,197,"(12.586067,-81.702563)"
2018,Noviembre,Panamá,591,2218,1887,,4106,"(3.541112,-76.384584)"
2018,Noviembre,Panamá,591,163,103,,266,"(4.452882,-75.766298)"
2018,Noviembre,Panamá,591,7969,8755,,16724,"(4.697144,-74.140516)"
2018,Noviembre,Panamá,591,503,395,,898,"(4.815061,-75.736532)"
2018,Noviembre,Panamá,591,3413,2931,,6344,"(6.171601,-75.427454)"
2018,Noviembre,Panamá,591,13,28,,41,"(7.102626,-77.762647)"
2018,Noviembre,Panamá,591,236,210,,446,"(7.128456,-73.183637)"
2018,Noviembre,Panamá,591,0,7,,7,"(8.066966,-76.735404)"
2018,Noviembre,Panamá,591,14,90,,104,"(8.635765,-77.346578)"
2018,Noviembre,Paraguay,600,2,4,,6,"(10.445761,-75.516429)"
2018,Noviembre,Paraguay,600,11,16,,27,"(10.886611,-74.776708)"
2018,Noviembre,Paraguay,600,14,20,,34,"(3.541112,-76.384584)"
2018,Noviembre,Paraguay,600,111,192,,303,"(4.697144,-74.140516)"
2018,Noviembre,Paraguay,600,5,5,,10,"(4.815061,-75.736532)"
2018,Noviembre,Paraguay,600,21,30,,51,"(6.171601,-75.427454)"
2018,Noviembre,Paraguay,600,0,1,,1,"(7.128456,-73.183637)"
2018,Noviembre,Perú,604,3,5,,8,"(-0.193180,-74.784874)"
2018,Noviembre,Perú,604,54,68,,122,"(-4.197703,-69.941278)"
2018,Noviembre,Perú,604,68,130,,198,"(-4.223468,-69.945098)"
2018,Noviembre,Perú,604,14,10,,24,"(0.25129,-76.875963)"
2018,Noviembre,Perú,604,50,60,,110,"(0.814836,-77.662532)"
2018,Noviembre,Perú,604,0,2,,2,"(1.813928,-78.763924)"
2018,Noviembre,Perú,604,104,96,,200,"(10.445761,-75.516429)"
2018,Noviembre,Perú,604,15,19,,34,"(10.886611,-74.776708)"
2018,Noviembre,Perú,604,0,1,,1,"(12.586067,-81.702563)"
2018,Noviembre,Perú,604,335,303,,638,"(3.541112,-76.384584)"
2018,Noviembre,Perú,604,6650,7338,,13989,"(4.697144,-74.140516)"
2018,Noviembre,Perú,604,8,11,,19,"(4.815061,-75.736532)"
2018,Noviembre,Perú,604,840,868,,1708,"(6.171601,-75.427454)"
2018,Noviembre,Perú,604,6,4,,10,"(7.128456,-73.183637)"
2018,Noviembre,Palestina,99999,1,0,,1,"(4.697144,-74.140516)"
2018,Noviembre,Polonia,616,13,34,,47,"(4.697144,-74.140516)"
2018,Noviembre,Polonia,616,1,1,,2,"(6.171601,-75.427454)"
2018,Noviembre,Portugal,620,2,0,,2,"(10.445761,-75.516429)"
2018,Noviembre,Portugal,620,11,8,,19,"(3.541112,-76.384584)"
2018,Noviembre,Portugal,620,62,56,,118,"(4.697144,-74.140516)"
2018,Noviembre,Portugal,620,0,1,,1,"(4.815061,-75.736532)"
2018,Noviembre,Portugal,620,7,4,,11,"(6.171601,-75.427454)"
2018,Noviembre,Polinesia Francesa/Colectividad de Ultramar Francesa,258,1,1,,2,"(4.697144,-74.140516)"
2018,Noviembre,Puerto Rico/Territorio de Estados Unidos,630,11,5,,16,"(10.445761,-75.516429)"
2018,Noviembre,Puerto Rico/Territorio de Estados Unidos,630,11,6,,17,"(10.886611,-74.776708)"
2018,Noviembre,Puerto Rico/Territorio de Estados Unidos,630,33,16,,49,"(3.541112,-76.384584)"
2018,Noviembre,Puerto Rico/Territorio de Estados Unidos,630,503,406,,909,"(4.697144,-74.140516)"
2018,Noviembre,Puerto Rico/Territorio de Estados Unidos,630,4,3,,7,"(4.815061,-75.736532)"
2018,Noviembre,Puerto Rico/Territorio de Estados Unidos,630,33,35,,68,"(6.171601,-75.427454)"
2018,Noviembre,Puerto Rico/Territorio de Estados Unidos,630,2,2,,4,"(7.128456,-73.183637)"
2018,Noviembre,Qatar,634,1,1,,2,"(10.445761,-75.516429)"
2018,Noviembre,Qatar,634,1,1,,2,"(3.541112,-76.384584)"
2018,Noviembre,Qatar,634,7,8,,15,"(4.697144,-74.140516)"
2018,Noviembre,Qatar,634,4,0,,4,"(6.171601,-75.427454)"
2018,Noviembre,Reino Unido de Gran Bretaña e Irlanda del Norte,826,1,0,,1,"(10.445761,-75.516429)"
2018,Noviembre,Reino Unido de Gran Bretaña e Irlanda del Norte,826,1,0,,1,"(10.886611,-74.776708)"
2018,Noviembre,Reino Unido de Gran Bretaña e Irlanda del Norte,826,25,21,,46,"(3.541112,-76.384584)"
2018,Noviembre,Reino Unido de Gran Bretaña e Irlanda del Norte,826,1183,966,,2149,"(4.697144,-74.140516)"
2018,Noviembre,Reino Unido de Gran Bretaña e Irlanda del Norte,826,12,24,,36,"(6.171601,-75.427454)"
2018,Noviembre,República CentroÁfricana,140,9,2,,11,"(4.697144,-74.140516)"
2018,Noviembre,Federación de Rusia,643,1,1,,2,"(3.541112,-76.384584)"
2018,Noviembre,Federación de Rusia,643,16,26,,42,"(4.697144,-74.140516)"
2018,Noviembre,Federación de Rusia,643,1,1,,2,"(6.171601,-75.427454)"
2018,Noviembre,República Dominicana,214,19,23,,42,"(10.445761,-75.516429)"
2018,Noviembre,República Dominicana,214,49,46,,95,"(10.886611,-74.776708)"
2018,Noviembre,República Dominicana,214,1,0,,1,"(12.586067,-81.702563)"
2018,Noviembre,República Dominicana,214,118,111,,229,"(3.541112,-76.384584)"
2018,Noviembre,República Dominicana,214,4664,3982,,8647,"(4.697144,-74.140516)"
2018,Noviembre,República Dominicana,214,40,32,,72,"(4.815061,-75.736532)"
2018,Noviembre,República Dominicana,214,334,253,,587,"(6.171601,-75.427454)"
2018,Noviembre,República Dominicana,214,36,25,,61,"(7.128456,-73.183637)"
2018,Noviembre,Reunión,638,0,1,,1,"(4.697144,-74.140516)"
2018,Noviembre,República Democrática Popular de Corea,408,1,0,,1,"(6.171601,-75.427454)"
2018,Noviembre,Rumania,642,0,2,,2,"(3.541112,-76.384584)"
2018,Noviembre,Rumania,642,6,15,,21,"(4.697144,-74.140516)"
2018,Noviembre,San Cristóbal y Nevis,659,0,1,,1,"(4.697144,-74.140516)"
2018,Noviembre,San  Vicente y las Granadinas,670,1,0,,1,"(4.697144,-74.140516)"
2018,Noviembre,Senegal,686,1,2,,3,"(4.697144,-74.140516)"
2018,Noviembre,Singapur,702,0,1,,1,"(10.445761,-75.516429)"
2018,Noviembre,Singapur,702,1,0,,1,"(3.541112,-76.384584)"
2018,Noviembre,Singapur,702,14,17,,31,"(4.697144,-74.140516)"
2018,Noviembre,Singapur,702,2,3,,5,"(6.171601,-75.427454)"
2018,Noviembre,Sudáfrica,710,1,0,,1,"(10.445761,-75.516429)"
2018,Noviembre,Sudáfrica,710,1,0,,1,"(3.541112,-76.384584)"
2018,Noviembre,Sudáfrica,710,11,12,,23,"(4.697144,-74.140516)"
2018,Noviembre,Sudáfrica,710,2,2,,4,"(6.171601,-75.427454)"
2018,Noviembre,Suecia,752,2,0,,2,"(10.445761,-75.516429)"
2018,Noviembre,Suecia,752,3,1,,4,"(10.886611,-74.776708)"
2018,Noviembre,Suecia,752,11,10,,21,"(3.541112,-76.384584)"
2018,Noviembre,Suecia,752,56,46,,102,"(4.697144,-74.140516)"
2018,Noviembre,Suecia,752,0,1,,1,"(4.815061,-75.736532)"
2018,Noviembre,Suecia,752,8,2,,10,"(6.171601,-75.427454)"
2018,Noviembre,Suiza,756,2,0,,2,"(10.445761,-75.516429)"
2018,Noviembre,Suiza,756,1,0,,1,"(10.886611,-74.776708)"
2018,Noviembre,Suiza,756,0,1,,1,"(12.586067,-81.702563)"
2018,Noviembre,Suiza,756,29,9,,38,"(3.541112,-76.384584)"
2018,Noviembre,Suiza,756,196,128,,324,"(4.697144,-74.140516)"
2018,Noviembre,Suiza,756,22,11,,33,"(6.171601,-75.427454)"
2018,Noviembre,Suiza,756,1,0,,1,"(7.128456,-73.183637)"
2018,Noviembre,Surinam,740,2,12,,14,"(4.697144,-74.140516)"
2018,Noviembre,Surinam,740,1,7,,8,"(6.171601,-75.427454)"
2018,Noviembre,Taiwán,158,5,13,,18,"(4.697144,-74.140516)"
2018,Noviembre,Taiwán,158,1,0,,1,"(6.171601,-75.427454)"
2018,Noviembre,Tailandia,764,2,1,,3,"(3.541112,-76.384584)"
2018,Noviembre,Tailandia,764,45,36,,81,"(4.697144,-74.140516)"
2018,Noviembre,Tailandia,764,9,10,,19,"(6.171601,-75.427454)"
2018,Noviembre,Tanzania,834,1,1,,2,"(10.886611,-74.776708)"
2018,Noviembre,Tanzania,834,2,1,,3,"(4.697144,-74.140516)"
2018,Noviembre,Togo,768,1,0,,1,"(4.697144,-74.140516)"
2018,Noviembre,Trinidad y Tobago,780,2,3,,5,"(10.445761,-75.516429)"
2018,Noviembre,Trinidad y Tobago,780,1,4,,5,"(10.886611,-74.776708)"
2018,Noviembre,Trinidad y Tobago,780,2,5,,7,"(3.541112,-76.384584)"
2018,Noviembre,Trinidad y Tobago,780,19,24,,43,"(4.697144,-74.140516)"
2018,Noviembre,Trinidad y Tobago,780,2,2,,4,"(4.815061,-75.736532)"
2018,Noviembre,Trinidad y Tobago,780,7,10,,17,"(6.171601,-75.427454)"
2018,Noviembre,Trinidad y Tobago,780,2,2,,4,"(7.128456,-73.183637)"
2018,Noviembre,Túnez,788,2,0,,2,"(4.697144,-74.140516)"
2018,Noviembre,Turquía,792,7,2,,9,"(3.541112,-76.384584)"
2018,Noviembre,Turquía,792,1092,475,,1567,"(4.697144,-74.140516)"
2018,Noviembre,Turquía,792,14,14,,28,"(6.171601,-75.427454)"
2018,Noviembre,Turquía,792,1,0,,1,"(7.128456,-73.183637)"
2018,Noviembre,Turkmenistán,795,0,1,,1,"(3.541112,-76.384584)"
2018,Noviembre,Turkmenistán,795,4,1,,5,"(4.697144,-74.140516)"
2018,Noviembre,Ucrania,804,0,6,,6,"(4.697144,-74.140516)"
2018,Noviembre,Ucrania,804,1,0,,1,"(6.171601,-75.427454)"
2018,Noviembre,Uganda,800,1,1,,2,"(4.697144,-74.140516)"
2018,Noviembre,Uganda,800,1,0,,1,"(6.171601,-75.427454)"
2018,Noviembre,Uruguay,858,0,3,,3,"(10.445761,-75.516429)"
2018,Noviembre,Uruguay,858,3,2,,5,"(10.886611,-74.776708)"
2018,Noviembre,Uruguay,858,32,22,,54,"(3.541112,-76.384584)"
2018,Noviembre,Uruguay,858,525,545,,1070,"(4.697144,-74.140516)"
2018,Noviembre,Uruguay,858,1,2,,3,"(4.815061,-75.736532)"
2018,Noviembre,Uruguay,858,62,47,,109,"(6.171601,-75.427454)"
2018,Noviembre,Venezuela,862,0,32,,32,"(10.408582,-75.538003)"
2018,Noviembre,Venezuela,862,6,9,,15,"(10.445761,-75.516429)"
2018,Noviembre,Venezuela,862,10,14,,24,"(10.886611,-74.776708)"
2018,Noviembre,Venezuela,862,1504,1833,,3337,"(11.360009,-72.129330)"
2018,Noviembre,Venezuela,862,692,480,,1172,"(3.541112,-76.384584)"
2018,Noviembre,Venezuela,862,5,1,,6,"(3.866713,-67.927521)"
2018,Noviembre,Venezuela,862,1597,1622,,3219,"(4.697144,-74.140516)"
2018,Noviembre,Venezuela,862,4,1,,5,"(4.815061,-75.736532)"
2018,Noviembre,Venezuela,862,697,559,,1256,"(6.171601,-75.427454)"
2018,Noviembre,Venezuela,862,20,39,,59,"(6.185799,-67.483929)"
2018,Noviembre,Venezuela,862,530,467,,997,"(7.088729,-70.740253)"
2018,Noviembre,Venezuela,862,6,1,,7,"(7.128456,-73.183637)"
2018,Noviembre,Venezuela,862,1142,1029,,2171,"(7.818934,-72.453226)"
2018,Noviembre,Venezuela,862,0,4,,4,"(7.927209,-72.507910)"
2018,Noviembre,Venezuela,862,100,113,,213,"(8.36068,-72.409396)"
2018,Noviembre,Vietnam,704,7,9,,16,"(4.697144,-74.140516)"
2018,Noviembre,Vietnam,704,0,1,,1,"(6.171601,-75.427454)"
2018,Noviembre,Islas Vírgenes Estadounidenses/Territorio de Estados Unidos,850,0,1,,1,"(4.697144,-74.140516)"
2018,Diciembre,Afganistán,4,0,2,,2,"(4.697144,-74.140516)"
2018,Diciembre,Albania,8,3,3,,6,"(4.697144,-74.140516)"
2018,Diciembre,Alemania,276,11,9,,20,"(10.445761,-75.516429)"
2018,Diciembre,Alemania,276,21,8,,29,"(10.886611,-74.776708)"
2018,Diciembre,Alemania,276,60,37,,97,"(3.541112,-76.384584)"
2018,Diciembre,Alemania,276,2664,2125,,4789,"(4.697144,-74.140516)"
2018,Diciembre,Alemania,276,1,0,,1,"(4.815061,-75.736532)"
2018,Diciembre,Alemania,276,75,48,,123,"(6.171601,-75.427454)"
2018,Diciembre,Andorra,20,3,5,,8,"(4.697144,-74.140516)"
2018,Diciembre,Andorra,20,2,2,,4,"(6.171601,-75.427454)"
2018,Diciembre,Angola,24,1,4,,5,"(4.697144,-74.140516)"
2018,Diciembre,Antigua y Barbuda,28,5,6,,11,"(4.697144,-74.140516)"
2018,Diciembre,Países Bajos,528,2,2,,4,"(10.408582,-75.538003)"
2018,Diciembre,Países Bajos,528,161,116,,277,"(10.445761,-75.516429)"
2018,Diciembre,Países Bajos,528,34,23,,57,"(10.886611,-74.776708)"
2018,Diciembre,Países Bajos,528,78,32,,110,"(3.541112,-76.384584)"
2018,Diciembre,Países Bajos,528,1857,1512,,3369,"(4.697144,-74.140516)"
2018,Diciembre,Países Bajos,528,7,4,,11,"(4.815061,-75.736532)"
2018,Diciembre,Países Bajos,528,106,75,,181,"(6.171601,-75.427454)"
2018,Diciembre,Países Bajos,528,1,2,,3,"(7.128456,-73.183637)"
2018,Diciembre,Arabia Saudita,682,0,2,,2,"(10.445761,-75.516429)"
2018,Diciembre,Arabia Saudita,682,0,1,,1,"(3.541112,-76.384584)"
2018,Diciembre,Arabia Saudita,682,6,18,,24,"(4.697144,-74.140516)"
2018,Diciembre,Arabia Saudita,682,2,2,,4,"(6.171601,-75.427454)"
2018,Diciembre,Argelia,12,9,9,,18,"(4.697144,-74.140516)"
2018,Diciembre,Argentina,32,0,1,,1,"(-4.223468,-69.945098)"
2018,Diciembre,Argentina,32,6,9,,15,"(0.814836,-77.662532)"
2018,Diciembre,Argentina,32,69,68,,137,"(10.445761,-75.516429)"
2018,Diciembre,Argentina,32,37,19,,56,"(10.886611,-74.776708)"
2018,Diciembre,Argentina,32,0,2,,2,"(12.586067,-81.702563)"
2018,Diciembre,Argentina,32,228,187,,415,"(3.541112,-76.384584)"
2018,Diciembre,Argentina,32,4360,3408,,7768,"(4.697144,-74.140516)"
2018,Diciembre,Argentina,32,27,13,,40,"(4.815061,-75.736532)"
2018,Diciembre,Argentina,32,283,240,,523,"(6.171601,-75.427454)"
2018,Diciembre,Argentina,32,4,2,,6,"(7.128456,-73.183637)"
2018,Diciembre,República de Armenia,51,1,1,,2,"(4.697144,-74.140516)"
2018,Diciembre,Aruba,533,2372,1609,,3981,"(10.408582,-75.538003)"
2018,Diciembre,Aruba,533,3,4,,7,"(10.445761,-75.516429)"
2018,Diciembre,Aruba,533,32,25,,57,"(10.886611,-74.776708)"
2018,Diciembre,Aruba,533,54,43,,97,"(3.541112,-76.384584)"
2018,Diciembre,Aruba,533,3349,2622,,5971,"(4.697144,-74.140516)"
2018,Diciembre,Aruba,533,31,18,,49,"(4.815061,-75.736532)"
2018,Diciembre,Aruba,533,104,81,,185,"(6.171601,-75.427454)"
2018,Diciembre,Aruba,533,12,27,,39,"(7.128456,-73.183637)"
2018,Diciembre,Australia,36,2,3,,5,"(10.886611,-74.776708)"
2018,Diciembre,Australia,36,13,12,,25,"(3.541112,-76.384584)"
2018,Diciembre,Australia,36,478,335,,813,"(4.697144,-74.140516)"
2018,Diciembre,Australia,36,8,3,,11,"(4.815061,-75.736532)"
2018,Diciembre,Australia,36,48,30,,78,"(6.171601,-75.427454)"
2018,Diciembre,Australia,36,1,1,,2,"(7.128456,-73.183637)"
2018,Diciembre,Austria,40,1,0,,1,"(10.445761,-75.516429)"
2018,Diciembre,Austria,40,1,1,,2,"(10.886611,-74.776708)"
2018,Diciembre,Austria,40,2,2,,4,"(3.541112,-76.384584)"
2018,Diciembre,Austria,40,48,45,,93,"(4.697144,-74.140516)"
2018,Diciembre,Austria,40,9,4,,13,"(6.171601,-75.427454)"
2018,Diciembre,Azerbaiyán,31,1,0,,1,"(4.697144,-74.140516)"
2018,Diciembre,Bahamas,44,10,7,,17,"(3.541112,-76.384584)"
2018,Diciembre,Bahamas,44,35,23,,58,"(4.697144,-74.140516)"
2018,Diciembre,Bahamas,44,3,2,,5,"(4.815061,-75.736532)"
2018,Diciembre,Bahamas,44,22,20,,42,"(6.171601,-75.427454)"
2018,Diciembre,Bahréin,48,1,0,,1,"(4.452882,-75.766298)"
2018,Diciembre,Bahréin,48,1,6,,7,"(4.697144,-74.140516)"
2018,Diciembre,Bahréin,48,1,2,,3,"(6.171601,-75.427454)"
2018,Diciembre,Bangladesh,50,0,1,,1,"(4.697144,-74.140516)"
2018,Diciembre,Bangladesh,50,0,1,,1,"(4.815061,-75.736532)"
2018,Diciembre,Barbados,52,2,9,,11,"(4.697144,-74.140516)"
2018,Diciembre,Barbados,52,6,3,,9,"(6.171601,-75.427454)"
2018,Diciembre,República de Belarús,112,1,2,,3,"(4.697144,-74.140516)"
2018,Diciembre,Bélgica,56,1,4,,5,"(10.445761,-75.516429)"
2018,Diciembre,Bélgica,56,4,3,,7,"(10.886611,-74.776708)"
2018,Diciembre,Bélgica,56,13,12,,25,"(3.541112,-76.384584)"
2018,Diciembre,Bélgica,56,117,80,,197,"(4.697144,-74.140516)"
2018,Diciembre,Bélgica,56,0,1,,1,"(4.815061,-75.736532)"
2018,Diciembre,Bélgica,56,27,14,,41,"(6.171601,-75.427454)"
2018,Diciembre,Belice,84,1,1,,2,"(3.541112,-76.384584)"
2018,Diciembre,Belice,84,14,13,,27,"(4.697144,-74.140516)"
2018,Diciembre,Belice,84,1,0,,1,"(4.815061,-75.736532)"
2018,Diciembre,Benín,204,0,1,,1,"(6.171601,-75.427454)"
2018,Diciembre,Bermudas/Territorio Británico de Ultramar,60,1,1,,2,"(4.697144,-74.140516)"
2018,Diciembre,Bermudas/Territorio Británico de Ultramar,60,0,1,,1,"(6.171601,-75.427454)"
2018,Diciembre,Bolivia,68,2,3,,5,"(0.25129,-76.875963)"
2018,Diciembre,Bolivia,68,1,1,,2,"(0.814836,-77.662532)"
2018,Diciembre,Bolivia,68,2,2,,4,"(10.445761,-75.516429)"
2018,Diciembre,Bolivia,68,2,0,,2,"(10.886611,-74.776708)"
2018,Diciembre,Bolivia,68,16,13,,29,"(3.541112,-76.384584)"
2018,Diciembre,Bolivia,68,567,574,,1141,"(4.697144,-74.140516)"
2018,Diciembre,Bolivia,68,0,1,,1,"(4.815061,-75.736532)"
2018,Diciembre,Bolivia,68,23,18,,41,"(6.171601,-75.427454)"
2018,Diciembre,Bolivia,68,2,0,,2,"(7.128456,-73.183637)"
2018,Diciembre,Brasil,76,130,179,,309,"(-4.197703,-69.941278)"
2018,Diciembre,Brasil,76,35,34,,69,"(-4.223468,-69.945098)"
2018,Diciembre,Brasil,76,1,0,,1,"(0.814836,-77.662532)"
2018,Diciembre,Brasil,76,12,17,,29,"(10.445761,-75.516429)"
2018,Diciembre,Brasil,76,20,96,,116,"(10.886611,-74.776708)"
2018,Diciembre,Brasil,76,0,1,,1,"(12.586067,-81.702563)"
2018,Diciembre,Brasil,76,138,126,,264,"(3.541112,-76.384584)"
2018,Diciembre,Brasil,76,4428,4519,,8947,"(4.697144,-74.140516)"
2018,Diciembre,Brasil,76,34,29,,63,"(4.815061,-75.736532)"
2018,Diciembre,Brasil,76,206,209,,415,"(6.171601,-75.427454)"
2018,Diciembre,Brasil,76,2,6,,8,"(7.128456,-73.183637)"
2018,Diciembre,Bulgaria,100,0,4,,4,"(4.697144,-74.140516)"
2018,Diciembre,Bulgaria,100,0,1,,1,"(6.171601,-75.427454)"
2018,Diciembre,Cabo Verde,132,0,1,,1,"(4.697144,-74.140516)"
2018,Diciembre,Islas Caimán/Territorio Británico de Ultramar,136,2,1,,3,"(10.445761,-75.516429)"
2018,Diciembre,Islas Caimán/Territorio Británico de Ultramar,136,0,1,,1,"(12.5744111,-81.703935)"
2018,Diciembre,Islas Caimán/Territorio Británico de Ultramar,136,8,2,,10,"(12.586067,-81.702563)"
2018,Diciembre,Islas Caimán/Territorio Británico de Ultramar,136,0,1,,1,"(3.541112,-76.384584)"
2018,Diciembre,Islas Caimán/Territorio Británico de Ultramar,136,5,2,,7,"(4.697144,-74.140516)"
2018,Diciembre,Islas Caimán/Territorio Británico de Ultramar,136,1,0,,1,"(6.171601,-75.427454)"
2018,Diciembre,Camboya,116,0,1,,1,"(4.697144,-74.140516)"
2018,Diciembre,Antártida,10,0,1,,1,"(4.697144,-74.140516)"
2018,Diciembre,Canadá,124,127,96,,223,"(10.445761,-75.516429)"
2018,Diciembre,Canadá,124,25,22,,47,"(10.886611,-74.776708)"
2018,Diciembre,Canadá,124,4,2,,6,"(12.586067,-81.702563)"
2018,Diciembre,Canadá,124,167,116,,283,"(3.541112,-76.384584)"
2018,Diciembre,Canadá,124,2386,1885,,4271,"(4.697144,-74.140516)"
2018,Diciembre,Canadá,124,16,9,,25,"(4.815061,-75.736532)"
2018,Diciembre,Canadá,124,209,146,,355,"(6.171601,-75.427454)"
2018,Diciembre,Canadá,124,10,8,,18,"(7.128456,-73.183637)"
2018,Diciembre,España,724,25,18,,43,"(10.445761,-75.516429)"
2018,Diciembre,España,724,7,6,,13,"(10.886611,-74.776708)"
2018,Diciembre,España,724,1,0,,1,"(12.586067,-81.702563)"
2018,Diciembre,España,724,3123,2144,,5267,"(3.541112,-76.384584)"
2018,Diciembre,España,724,1,0,,1,"(4.452882,-75.766298)"
2018,Diciembre,España,724,15777,12042,,27819,"(4.697144,-74.140516)"
2018,Diciembre,España,724,16,16,,32,"(4.815061,-75.736532)"
2018,Diciembre,España,724,2503,1818,,4321,"(6.171601,-75.427454)"
2018,Diciembre,España,724,3,2,,5,"(7.128456,-73.183637)"
2018,Diciembre,Colombia,170,5,12,,17,"(10.445761,-75.516429)"
2018,Diciembre,Colombia,170,207,482,,689,"(4.697144,-74.140516)"
2018,Diciembre,República Del Congo,178,0,1,,1,"(4.697144,-74.140516)"
2018,Diciembre,República de Corea,410,16,8,,24,"(4.697144,-74.140516)"
2018,Diciembre,República de Corea,410,1,0,,1,"(6.171601,-75.427454)"
2018,Diciembre,Costa de Marfil,384,3,3,,6,"(4.697144,-74.140516)"
2018,Diciembre,Costa Rica,188,1,1,,2,"(10.408582,-75.538003)"
2018,Diciembre,Costa Rica,188,14,13,,27,"(10.445761,-75.516429)"
2018,Diciembre,Costa Rica,188,18,12,,30,"(10.886611,-74.776708)"
2018,Diciembre,Costa Rica,188,2,17,,19,"(12.5744111,-81.703935)"
2018,Diciembre,Costa Rica,188,5,3,,8,"(12.586067,-81.702563)"
2018,Diciembre,Costa Rica,188,43,45,,88,"(3.541112,-76.384584)"
2018,Diciembre,Costa Rica,188,1565,1431,,2996,"(4.697144,-74.140516)"
2018,Diciembre,Costa Rica,188,8,11,,19,"(4.815061,-75.736532)"
2018,Diciembre,Costa Rica,188,118,102,,220,"(6.171601,-75.427454)"
2018,Diciembre,Costa Rica,188,9,3,,12,"(7.128456,-73.183637)"
2018,Diciembre,Croacia,191,3,1,,4,"(4.697144,-74.140516)"
2018,Diciembre,Cuba,192,0,1,,1,"(10.408582,-75.538003)"
2018,Diciembre,Cuba,192,22,22,,44,"(10.445761,-75.516429)"
2018,Diciembre,Cuba,192,17,15,,32,"(10.886611,-74.776708)"
2018,Diciembre,Cuba,192,55,50,,105,"(3.541112,-76.384584)"
2018,Diciembre,Cuba,192,2091,1705,,3796,"(4.697144,-74.140516)"
2018,Diciembre,Cuba,192,19,13,,32,"(4.815061,-75.736532)"
2018,Diciembre,Cuba,192,102,88,,190,"(6.171601,-75.427454)"
2018,Diciembre,Cuba,192,5,3,,8,"(7.128456,-73.183637)"
2018,Diciembre,Curazao,99999,3,1,,4,"(10.445761,-75.516429)"
2018,Diciembre,Curazao,99999,6,4,,10,"(10.886611,-74.776708)"
2018,Diciembre,Curazao,99999,11,16,,27,"(3.541112,-76.384584)"
2018,Diciembre,Curazao,99999,1125,872,,1997,"(4.697144,-74.140516)"
2018,Diciembre,Curazao,99999,8,7,,15,"(4.815061,-75.736532)"
2018,Diciembre,Curazao,99999,22,23,,45,"(6.171601,-75.427454)"
2018,Diciembre,Curazao,99999,6,5,,11,"(7.128456,-73.183637)"
2018,Diciembre,República Checa,203,1,1,,2,"(10.445761,-75.516429)"
2018,Diciembre,República Checa,203,8,9,,17,"(4.697144,-74.140516)"
2018,Diciembre,República Checa,203,1,0,,1,"(4.815061,-75.736532)"
2018,Diciembre,Chile,152,1,1,,2,"(0.25129,-76.875963)"
2018,Diciembre,Chile,152,67,50,,117,"(0.814836,-77.662532)"
2018,Diciembre,Chile,152,3,3,,6,"(1.813928,-78.763924)"
2018,Diciembre,Chile,152,83,59,,142,"(10.445761,-75.516429)"
2018,Diciembre,Chile,152,25,28,,53,"(10.886611,-74.776708)"
2018,Diciembre,Chile,152,1,3,,4,"(12.586067,-81.702563)"
2018,Diciembre,Chile,152,578,323,,901,"(3.541112,-76.384584)"
2018,Diciembre,Chile,152,7546,5608,,13155,"(4.697144,-74.140516)"
2018,Diciembre,Chile,152,42,33,,75,"(4.815061,-75.736532)"
2018,Diciembre,Chile,152,284,223,,507,"(6.171601,-75.427454)"
2018,Diciembre,Chile,152,6,5,,11,"(7.128456,-73.183637)"
2018,Diciembre,China,156,1,0,,1,"(10.445761,-75.516429)"
2018,Diciembre,China,156,2,7,,9,"(3.541112,-76.384584)"
2018,Diciembre,China,156,92,156,,248,"(4.697144,-74.140516)"
2018,Diciembre,China,156,1,2,,3,"(4.815061,-75.736532)"
2018,Diciembre,China,156,12,10,,22,"(6.171601,-75.427454)"
2018,Diciembre,Chipre,196,1,1,,2,"(4.697144,-74.140516)"
2018,Diciembre,Dinamarca,208,1,2,,3,"(10.445761,-75.516429)"
2018,Diciembre,Dinamarca,208,1,1,,2,"(10.886611,-74.776708)"
2018,Diciembre,Dinamarca,208,1,0,,1,"(3.541112,-76.384584)"
2018,Diciembre,Dinamarca,208,30,15,,45,"(4.697144,-74.140516)"
2018,Diciembre,Dinamarca,208,4,1,,5,"(6.171601,-75.427454)"
2018,Diciembre,Dominica,212,0,2,,2,"(3.541112,-76.384584)"
2018,Diciembre,Dominica,212,1,0,,1,"(4.697144,-74.140516)"
2018,Diciembre,Ecuador,218,6,2,,8,"(-0.193180,-74.784874)"
2018,Diciembre,Ecuador,218,1164,1324,,2488,"(0.25129,-76.875963)"
2018,Diciembre,Ecuador,218,56,52,,108,"(0.812436,-77.847006)"
2018,Diciembre,Ecuador,218,9287,9340,,18627,"(0.814836,-77.662532)"
2018,Diciembre,Ecuador,218,249,207,,456,"(1.813928,-78.763924)"
2018,Diciembre,Ecuador,218,0,21,,21,"(10.408582,-75.538003)"
2018,Diciembre,Ecuador,218,2,6,,8,"(10.445761,-75.516429)"
2018,Diciembre,Ecuador,218,4,4,,8,"(10.886611,-74.776708)"
2018,Diciembre,Ecuador,218,1,0,,1,"(12.586067,-81.702563)"
2018,Diciembre,Ecuador,218,570,560,,1130,"(3.541112,-76.384584)"
2018,Diciembre,Ecuador,218,3606,4107,,7713,"(4.697144,-74.140516)"
2018,Diciembre,Ecuador,218,2,2,,4,"(4.815061,-75.736532)"
2018,Diciembre,Ecuador,218,13,30,,43,"(6.171601,-75.427454)"
2018,Diciembre,Egipto,818,2,2,,4,"(3.541112,-76.384584)"
2018,Diciembre,Egipto,818,29,18,,47,"(4.697144,-74.140516)"
2018,Diciembre,Egipto,818,2,1,,3,"(6.171601,-75.427454)"
2018,Diciembre,El Salvador,222,70,83,,153,"(10.445761,-75.516429)"
2018,Diciembre,El Salvador,222,3,5,,8,"(10.886611,-74.776708)"
2018,Diciembre,El Salvador,222,140,122,,262,"(3.541112,-76.384584)"
2018,Diciembre,El Salvador,222,1114,1006,,2120,"(4.697144,-74.140516)"
2018,Diciembre,El Salvador,222,7,15,,22,"(6.171601,-75.427454)"
2018,Diciembre,El Salvador,222,3,2,,5,"(7.128456,-73.183637)"
2018,Diciembre,Emiratos Árabes,784,1,2,,3,"(10.445761,-75.516429)"
2018,Diciembre,Emiratos Árabes,784,0,1,,1,"(12.586067,-81.702563)"
2018,Diciembre,Emiratos Árabes,784,11,4,,15,"(3.541112,-76.384584)"
2018,Diciembre,Emiratos Árabes,784,198,274,,472,"(4.697144,-74.140516)"
2018,Diciembre,Emiratos Árabes,784,16,17,,33,"(6.171601,-75.427454)"
2018,Diciembre,Eritrea,232,0,2,,2,"(4.697144,-74.140516)"
2018,Diciembre,Eslovaquia,703,3,7,,10,"(4.697144,-74.140516)"
2018,Diciembre,Eslovenia,705,2,1,,3,"(4.697144,-74.140516)"
2018,Diciembre,Eslovenia,705,1,3,,4,"(6.171601,-75.427454)"
2018,Diciembre,Estados Unidos de América,840,0,1,,1,"(10.408582,-75.538003)"
2018,Diciembre,Estados Unidos de América,840,5513,4443,,9956,"(10.445761,-75.516429)"
2018,Diciembre,Estados Unidos de América,840,3802,2901,,6703,"(10.886611,-74.776708)"
2018,Diciembre,Estados Unidos de América,840,278,261,,539,"(11.117806,-74.232622)"
2018,Diciembre,Estados Unidos de América,840,79,47,,126,"(12.586067,-81.702563)"
2018,Diciembre,Estados Unidos de América,840,6917,4970,,11887,"(3.541112,-76.384584)"
2018,Diciembre,Estados Unidos de América,840,797,556,,1353,"(4.452882,-75.766298)"
2018,Diciembre,Estados Unidos de América,840,49326,39516,,88843,"(4.697144,-74.140516)"
2018,Diciembre,Estados Unidos de América,840,1440,1017,,2457,"(4.815061,-75.736532)"
2018,Diciembre,Estados Unidos de América,840,13844,10834,,24678,"(6.171601,-75.427454)"
2018,Diciembre,Estados Unidos de América,840,335,219,,554,"(7.128456,-73.183637)"
2018,Diciembre,Estonia,233,4,2,,6,"(4.697144,-74.140516)"
2018,Diciembre,Filipinas,608,3,5,,8,"(4.697144,-74.140516)"
2018,Diciembre,Finlandia,246,0,1,,1,"(10.445761,-75.516429)"
2018,Diciembre,Finlandia,246,11,10,,21,"(4.697144,-74.140516)"
2018,Diciembre,Finlandia,246,0,4,,4,"(6.171601,-75.427454)"
2018,Diciembre,Francia,250,9,9,,18,"(10.445761,-75.516429)"
2018,Diciembre,Francia,250,6,5,,11,"(10.886611,-74.776708)"
2018,Diciembre,Francia,250,89,47,,136,"(3.541112,-76.384584)"
2018,Diciembre,Francia,250,1912,1417,,3329,"(4.697144,-74.140516)"
2018,Diciembre,Francia,250,10,8,,18,"(4.815061,-75.736532)"
2018,Diciembre,Francia,250,89,58,,147,"(6.171601,-75.427454)"
2018,Diciembre,Ghana,288,0,3,,3,"(4.697144,-74.140516)"
2018,Diciembre,Grecia,300,2,0,,2,"(3.541112,-76.384584)"
2018,Diciembre,Grecia,300,21,12,,33,"(4.697144,-74.140516)"
2018,Diciembre,Grecia,300,3,1,,4,"(6.171601,-75.427454)"
2018,Diciembre,Guatemala,320,8,6,,14,"(10.445761,-75.516429)"
2018,Diciembre,Guatemala,320,7,8,,15,"(10.886611,-74.776708)"
2018,Diciembre,Guatemala,320,67,66,,133,"(3.541112,-76.384584)"
2018,Diciembre,Guatemala,320,706,680,,1386,"(4.697144,-74.140516)"
2018,Diciembre,Guatemala,320,7,8,,15,"(4.815061,-75.736532)"
2018,Diciembre,Guatemala,320,62,63,,125,"(6.171601,-75.427454)"
2018,Diciembre,Guatemala,320,9,6,,15,"(7.128456,-73.183637)"
2018,Diciembre,Guyana,328,0,1,,1,"(10.445761,-75.516429)"
2018,Diciembre,Guyana,328,1,0,,1,"(10.886611,-74.776708)"
2018,Diciembre,Guyana,328,2,2,,4,"(4.697144,-74.140516)"
2018,Diciembre,Guyana,328,0,1,,1,"(6.171601,-75.427454)"
2018,Diciembre,Guinea Ecuatorial,226,1,0,,1,"(3.541112,-76.384584)"
2018,Diciembre,Guadalupe/Territorio Francés,312,1,0,,1,"(4.697144,-74.140516)"
2018,Diciembre,Guayana Francesa/Departamento de Ultramar Francés,254,1,1,,2,"(4.697144,-74.140516)"
2018,Diciembre,Guayana Francesa/Departamento de Ultramar Francés,254,0,1,,1,"(4.815061,-75.736532)"
2018,Diciembre,Haití,332,1,8,,9,"(10.445761,-75.516429)"
2018,Diciembre,Haití,332,1,0,,1,"(3.541112,-76.384584)"
2018,Diciembre,Haití,332,0,4,,4,"(4.697144,-74.140516)"
2018,Diciembre,Haití,332,0,1,,1,"(4.815061,-75.736532)"
2018,Diciembre,Haití,332,0,2,,2,"(6.171601,-75.427454)"
2018,Diciembre,Honduras,340,6,10,,16,"(10.445761,-75.516429)"
2018,Diciembre,Honduras,340,7,19,,26,"(10.886611,-74.776708)"
2018,Diciembre,Honduras,340,10,24,,34,"(3.541112,-76.384584)"
2018,Diciembre,Honduras,340,67,101,,168,"(4.697144,-74.140516)"
2018,Diciembre,Honduras,340,5,3,,8,"(4.815061,-75.736532)"
2018,Diciembre,Honduras,340,23,42,,65,"(6.171601,-75.427454)"
2018,Diciembre,Honduras,340,3,2,,5,"(7.128456,-73.183637)"
2018,Diciembre,Hong Kong,344,0,1,,1,"(10.445761,-75.516429)"
2018,Diciembre,Hong Kong,344,1,0,,1,"(3.541112,-76.384584)"
2018,Diciembre,Hong Kong,344,25,24,,49,"(4.697144,-74.140516)"
2018,Diciembre,Hong Kong,344,2,2,,4,"(6.171601,-75.427454)"
2018,Diciembre,Hungría,348,0,1,,1,"(3.541112,-76.384584)"
2018,Diciembre,Hungría,348,7,3,,10,"(4.697144,-74.140516)"
2018,Diciembre,India,356,1,1,,2,"(10.445761,-75.516429)"
2018,Diciembre,India,356,0,2,,2,"(3.541112,-76.384584)"
2018,Diciembre,India,356,48,30,,78,"(4.697144,-74.140516)"
2018,Diciembre,India,356,6,4,,10,"(6.171601,-75.427454)"
2018,Diciembre,Indonesia,360,7,4,,11,"(4.697144,-74.140516)"
2018,Diciembre,Iraq,368,0,4,,4,"(4.697144,-74.140516)"
2018,Diciembre,Iraq,368,0,1,,1,"(6.171601,-75.427454)"
2018,Diciembre,Irán,364,0,1,,1,"(4.697144,-74.140516)"
2018,Diciembre,Irán,364,0,2,,2,"(6.171601,-75.427454)"
2018,Diciembre,República de Irlanda,372,1,0,,1,"(10.445761,-75.516429)"
2018,Diciembre,República de Irlanda,372,13,11,,24,"(4.697144,-74.140516)"
2018,Diciembre,República de Irlanda,372,1,0,,1,"(6.171601,-75.427454)"
2018,Diciembre,Islandia,352,2,3,,5,"(4.697144,-74.140516)"
2018,Diciembre,Israel,376,0,1,,1,"(10.445761,-75.516429)"
2018,Diciembre,Israel,376,9,11,,20,"(3.541112,-76.384584)"
2018,Diciembre,Israel,376,144,126,,270,"(4.697144,-74.140516)"
2018,Diciembre,Israel,376,7,5,,12,"(6.171601,-75.427454)"
2018,Diciembre,Italia,380,25,16,,41,"(10.445761,-75.516429)"
2018,Diciembre,Italia,380,4,2,,6,"(10.886611,-74.776708)"
2018,Diciembre,Italia,380,1,0,,1,"(12.586067,-81.702563)"
2018,Diciembre,Italia,380,86,43,,129,"(3.541112,-76.384584)"
2018,Diciembre,Italia,380,671,455,,1126,"(4.697144,-74.140516)"
2018,Diciembre,Italia,380,2,3,,5,"(4.815061,-75.736532)"
2018,Diciembre,Italia,380,63,35,,98,"(6.171601,-75.427454)"
2018,Diciembre,Italia,380,3,0,,3,"(7.128456,-73.183637)"
2018,Diciembre,Jamaica,388,1611,1239,,2850,"(10.408582,-75.538003)"
2018,Diciembre,Jamaica,388,3,6,,9,"(10.886611,-74.776708)"
2018,Diciembre,Jamaica,388,1,0,,1,"(12.586067,-81.702563)"
2018,Diciembre,Jamaica,388,8,9,,17,"(3.541112,-76.384584)"
2018,Diciembre,Jamaica,388,38,44,,82,"(4.697144,-74.140516)"
2018,Diciembre,Jamaica,388,5,1,,6,"(4.815061,-75.736532)"
2018,Diciembre,Jamaica,388,22,18,,40,"(6.171601,-75.427454)"
2018,Diciembre,Japón,392,3,1,,4,"(10.886611,-74.776708)"
2018,Diciembre,Japón,392,2,1,,3,"(3.541112,-76.384584)"
2018,Diciembre,Japón,392,90,143,,233,"(4.697144,-74.140516)"
2018,Diciembre,Japón,392,8,10,,18,"(6.171601,-75.427454)"
2018,Diciembre,Jordania,400,1,1,,2,"(4.697144,-74.140516)"
2018,Diciembre,Kazajistán,398,0,2,,2,"(4.697144,-74.140516)"
2018,Diciembre,Kenia,404,5,6,,11,"(4.697144,-74.140516)"
2018,Diciembre,Kuwait,414,1,1,,2,"(10.445761,-75.516429)"
2018,Diciembre,Kuwait,414,5,7,,12,"(4.697144,-74.140516)"
2018,Diciembre,Kuwait,414,4,1,,5,"(6.171601,-75.427454)"
2018,Diciembre,Letonia,428,1,0,,1,"(4.697144,-74.140516)"
2018,Diciembre,Lituania,440,1,0,,1,"(4.697144,-74.140516)"
2018,Diciembre,Líbano,422,1,3,,4,"(10.886611,-74.776708)"
2018,Diciembre,Líbano,422,1,1,,2,"(3.541112,-76.384584)"
2018,Diciembre,Líbano,422,7,13,,20,"(4.697144,-74.140516)"
2018,Diciembre,Libia,434,0,1,,1,"(4.697144,-74.140516)"
2018,Diciembre,Luxemburgo,442,3,2,,5,"(10.445761,-75.516429)"
2018,Diciembre,Luxemburgo,442,2,2,,4,"(3.541112,-76.384584)"
2018,Diciembre,Luxemburgo,442,9,8,,17,"(4.697144,-74.140516)"
2018,Diciembre,Luxemburgo,442,1,0,,1,"(6.171601,-75.427454)"
2018,Diciembre,Macao,446,1,0,,1,"(6.171601,-75.427454)"
2018,Diciembre,Malasia,458,5,2,,7,"(4.697144,-74.140516)"
2018,Diciembre,Malí,466,1,0,,1,"(4.697144,-74.140516)"
2018,Diciembre,Malta,470,0,1,,1,"(10.445761,-75.516429)"
2018,Diciembre,Malta,470,1,0,,1,"(10.886611,-74.776708)"
2018,Diciembre,Malta,470,3,1,,4,"(3.541112,-76.384584)"
2018,Diciembre,Malta,470,13,11,,24,"(4.697144,-74.140516)"
2018,Diciembre,Malta,470,2,1,,3,"(6.171601,-75.427454)"
2018,Diciembre,Marruecos,504,0,1,,1,"(3.541112,-76.384584)"
2018,Diciembre,Marruecos,504,33,12,,45,"(4.697144,-74.140516)"
2018,Diciembre,Marruecos,504,5,3,,8,"(6.171601,-75.427454)"
2018,Diciembre,Islas Marshall,584,1,0,,1,"(4.697144,-74.140516)"
2018,Diciembre,Mauricio,480,0,1,,1,"(4.697144,-74.140516)"
2018,Diciembre,Mauritania,478,1,1,,2,"(4.697144,-74.140516)"
2018,Diciembre,Martinica/Departamento de Ultramar Francés,474,1,1,,2,"(4.697144,-74.140516)"
2018,Diciembre,México,484,84,77,,161,"(10.445761,-75.516429)"
2018,Diciembre,México,484,233,164,,397,"(10.886611,-74.776708)"
2018,Diciembre,México,484,1,0,,1,"(12.5744111,-81.703935)"
2018,Diciembre,México,484,2,4,,6,"(12.586067,-81.702563)"
2018,Diciembre,México,484,1055,822,,1877,"(3.541112,-76.384584)"
2018,Diciembre,México,484,21015,17034,,38049,"(4.697144,-74.140516)"
2018,Diciembre,México,484,205,163,,368,"(4.815061,-75.736532)"
2018,Diciembre,México,484,2982,2136,,5118,"(6.171601,-75.427454)"
2018,Diciembre,México,484,100,74,,174,"(7.128456,-73.183637)"
2018,Diciembre,Mónaco,492,1,0,,1,"(4.697144,-74.140516)"
2018,Diciembre,Mozambique,508,2,1,,3,"(4.697144,-74.140516)"
2018,Diciembre,Nicaragua,558,4,1,,5,"(10.445761,-75.516429)"
2018,Diciembre,Nicaragua,558,2,4,,6,"(10.886611,-74.776708)"
2018,Diciembre,Nicaragua,558,0,3,,3,"(12.5744111,-81.703935)"
2018,Diciembre,Nicaragua,558,1,1,,2,"(12.586067,-81.702563)"
2018,Diciembre,Nicaragua,558,8,28,,36,"(3.541112,-76.384584)"
2018,Diciembre,Nicaragua,558,17,32,,49,"(4.697144,-74.140516)"
2018,Diciembre,Nicaragua,558,4,0,,4,"(4.815061,-75.736532)"
2018,Diciembre,Nicaragua,558,8,19,,27,"(6.171601,-75.427454)"
2018,Diciembre,Nicaragua,558,0,2,,2,"(7.128456,-73.183637)"
2018,Diciembre,Nigeria,566,1,4,,5,"(4.697144,-74.140516)"
2018,Diciembre,Noruega,578,3,2,,5,"(10.445761,-75.516429)"
2018,Diciembre,Noruega,578,1,0,,1,"(10.886611,-74.776708)"
2018,Diciembre,Noruega,578,4,0,,4,"(3.541112,-76.384584)"
2018,Diciembre,Noruega,578,25,31,,56,"(4.697144,-74.140516)"
2018,Diciembre,Noruega,578,1,0,,1,"(4.815061,-75.736532)"
2018,Diciembre,Noruega,578,6,3,,9,"(6.171601,-75.427454)"
2018,Diciembre,Nueva Zelanda,554,1,0,,1,"(10.886611,-74.776708)"
2018,Diciembre,Nueva Zelanda,554,1,0,,1,"(3.541112,-76.384584)"
2018,Diciembre,Nueva Zelanda,554,58,35,,93,"(4.697144,-74.140516)"
2018,Diciembre,Nueva Zelanda,554,4,1,,5,"(6.171601,-75.427454)"
2018,Diciembre,Omán,512,0,5,,5,"(4.697144,-74.140516)"
2018,Diciembre,Panamá,591,35,108,,143,"(10.408582,-75.538003)"
2018,Diciembre,Panamá,591,1568,1245,,2813,"(10.445761,-75.516429)"
2018,Diciembre,Panamá,591,1089,895,,1984,"(10.886611,-74.776708)"
2018,Diciembre,Panamá,591,0,1,,1,"(10.971302,-74.765397)"
2018,Diciembre,Panamá,591,1,2,,3,"(11.247723,-74.213989)"
2018,Diciembre,Panamá,591,4,30,,34,"(12.5744111,-81.703935)"
2018,Diciembre,Panamá,591,195,124,,319,"(12.586067,-81.702563)"
2018,Diciembre,Panamá,591,2527,2139,,4666,"(3.541112,-76.384584)"
2018,Diciembre,Panamá,591,205,138,,343,"(4.452882,-75.766298)"
2018,Diciembre,Panamá,591,10598,10054,,20652,"(4.697144,-74.140516)"
2018,Diciembre,Panamá,591,566,423,,989,"(4.815061,-75.736532)"
2018,Diciembre,Panamá,591,4,19,,23,"(6.17134,-75.427194)"
2018,Diciembre,Panamá,591,3839,3130,,6970,"(6.171601,-75.427454)"
2018,Diciembre,Panamá,591,0,2,,2,"(6.228046,-77.404104)"
2018,Diciembre,Panamá,591,15,24,,39,"(7.102626,-77.762647)"
2018,Diciembre,Panamá,591,259,235,,494,"(7.128456,-73.183637)"
2018,Diciembre,Panamá,591,0,16,,16,"(8.066966,-76.735404)"
2018,Diciembre,Panamá,591,32,56,,88,"(8.635765,-77.346578)"
2018,Diciembre,Paraguay,600,1,4,,5,"(10.445761,-75.516429)"
2018,Diciembre,Paraguay,600,2,4,,6,"(10.886611,-74.776708)"
2018,Diciembre,Paraguay,600,19,18,,37,"(3.541112,-76.384584)"
2018,Diciembre,Paraguay,600,113,156,,269,"(4.697144,-74.140516)"
2018,Diciembre,Paraguay,600,10,9,,19,"(4.815061,-75.736532)"
2018,Diciembre,Paraguay,600,16,33,,49,"(6.171601,-75.427454)"
2018,Diciembre,Paraguay,600,1,2,,3,"(7.128456,-73.183637)"
2018,Diciembre,Perú,604,10,4,,14,"(-0.193180,-74.784874)"
2018,Diciembre,Perú,604,59,56,,115,"(-4.197703,-69.941278)"
2018,Diciembre,Perú,604,201,159,,360,"(-4.223468,-69.945098)"
2018,Diciembre,Perú,604,22,33,,55,"(0.25129,-76.875963)"
2018,Diciembre,Perú,604,73,87,,160,"(0.814836,-77.662532)"
2018,Diciembre,Perú,604,3,1,,4,"(1.813928,-78.763924)"
2018,Diciembre,Perú,604,158,103,,261,"(10.445761,-75.516429)"
2018,Diciembre,Perú,604,26,18,,44,"(10.886611,-74.776708)"
2018,Diciembre,Perú,604,3,1,,4,"(12.586067,-81.702563)"
2018,Diciembre,Perú,604,588,497,,1085,"(3.541112,-76.384584)"
2018,Diciembre,Perú,604,7912,7076,,14989,"(4.697144,-74.140516)"
2018,Diciembre,Perú,604,7,7,,14,"(4.815061,-75.736532)"
2018,Diciembre,Perú,604,1321,1072,,2393,"(6.171601,-75.427454)"
2018,Diciembre,Perú,604,3,4,,7,"(7.128456,-73.183637)"
2018,Diciembre,Polonia,616,2,1,,3,"(10.445761,-75.516429)"
2018,Diciembre,Polonia,616,3,0,,3,"(3.541112,-76.384584)"
2018,Diciembre,Polonia,616,21,28,,49,"(4.697144,-74.140516)"
2018,Diciembre,Polonia,616,1,2,,3,"(6.171601,-75.427454)"
2018,Diciembre,Portugal,620,0,1,,1,"(10.445761,-75.516429)"
2018,Diciembre,Portugal,620,8,3,,11,"(3.541112,-76.384584)"
2018,Diciembre,Portugal,620,113,73,,186,"(4.697144,-74.140516)"
2018,Diciembre,Portugal,620,7,2,,9,"(6.171601,-75.427454)"
2018,Diciembre,Polinesia Francesa/Colectividad de Ultramar Francesa,258,4,2,,6,"(4.697144,-74.140516)"
2018,Diciembre,Puerto Rico/Territorio de Estados Unidos,630,14,6,,20,"(10.445761,-75.516429)"
2018,Diciembre,Puerto Rico/Territorio de Estados Unidos,630,24,16,,40,"(10.886611,-74.776708)"
2018,Diciembre,Puerto Rico/Territorio de Estados Unidos,630,1,2,,3,"(12.586067,-81.702563)"
2018,Diciembre,Puerto Rico/Territorio de Estados Unidos,630,38,23,,61,"(3.541112,-76.384584)"
2018,Diciembre,Puerto Rico/Territorio de Estados Unidos,630,796,652,,1448,"(4.697144,-74.140516)"
2018,Diciembre,Puerto Rico/Territorio de Estados Unidos,630,21,12,,33,"(4.815061,-75.736532)"
2018,Diciembre,Puerto Rico/Territorio de Estados Unidos,630,55,39,,94,"(6.171601,-75.427454)"
2018,Diciembre,Qatar,634,10,9,,19,"(4.697144,-74.140516)"
2018,Diciembre,Qatar,634,3,2,,5,"(6.171601,-75.427454)"
2018,Diciembre,Reino Unido de Gran Bretaña e Irlanda del Norte,826,4,2,,6,"(10.445761,-75.516429)"
2018,Diciembre,Reino Unido de Gran Bretaña e Irlanda del Norte,826,1,1,,2,"(10.886611,-74.776708)"
2018,Diciembre,Reino Unido de Gran Bretaña e Irlanda del Norte,826,24,16,,40,"(3.541112,-76.384584)"
2018,Diciembre,Reino Unido de Gran Bretaña e Irlanda del Norte,826,1695,1252,,2947,"(4.697144,-74.140516)"
2018,Diciembre,Reino Unido de Gran Bretaña e Irlanda del Norte,826,27,17,,44,"(6.171601,-75.427454)"
2018,Diciembre,República CentroÁfricana,140,4,2,,6,"(4.697144,-74.140516)"
2018,Diciembre,República CentroÁfricana,140,0,1,,1,"(6.171601,-75.427454)"
2018,Diciembre,Federación de Rusia,643,1,0,,1,"(10.445761,-75.516429)"
2018,Diciembre,Federación de Rusia,643,5,1,,6,"(3.541112,-76.384584)"
2018,Diciembre,Federación de Rusia,643,23,47,,70,"(4.697144,-74.140516)"
2018,Diciembre,Federación de Rusia,643,1,1,,2,"(6.171601,-75.427454)"
2018,Diciembre,República Dominicana,214,33,26,,59,"(10.445761,-75.516429)"
2018,Diciembre,República Dominicana,214,50,66,,116,"(10.886611,-74.776708)"
2018,Diciembre,República Dominicana,214,9,10,,19,"(11.117806,-74.232622)"
2018,Diciembre,República Dominicana,214,1,0,,1,"(12.586067,-81.702563)"
2018,Diciembre,República Dominicana,214,186,142,,328,"(3.541112,-76.384584)"
2018,Diciembre,República Dominicana,214,5970,5002,,10972,"(4.697144,-74.140516)"
2018,Diciembre,República Dominicana,214,45,38,,83,"(4.815061,-75.736532)"
2018,Diciembre,República Dominicana,214,457,389,,846,"(6.171601,-75.427454)"
2018,Diciembre,República Dominicana,214,54,48,,102,"(7.128456,-73.183637)"
2018,Diciembre,Rumania,642,1,0,,1,"(10.445761,-75.516429)"
2018,Diciembre,Rumania,642,2,2,,4,"(4.697144,-74.140516)"
2018,Diciembre,Rumania,642,1,0,,1,"(6.171601,-75.427454)"
2018,Diciembre,Senegal,686,1,1,,2,"(4.697144,-74.140516)"
2018,Diciembre,Serbia,688,2,3,,5,"(4.697144,-74.140516)"
2018,Diciembre,Sierra Leona,694,0,1,,1,"(6.171601,-75.427454)"
2018,Diciembre,Singapur,702,26,26,,52,"(4.697144,-74.140516)"
2018,Diciembre,Singapur,702,6,2,,8,"(6.171601,-75.427454)"
2018,Diciembre,Sri Lanka,144,1,0,,1,"(4.697144,-74.140516)"
2018,Diciembre,Sudáfrica,710,1,1,,2,"(3.541112,-76.384584)"
2018,Diciembre,Sudáfrica,710,30,22,,52,"(4.697144,-74.140516)"
2018,Diciembre,Sudáfrica,710,2,4,,6,"(6.171601,-75.427454)"
2018,Diciembre,Suecia,752,6,6,,12,"(10.445761,-75.516429)"
2018,Diciembre,Suecia,752,6,5,,11,"(10.886611,-74.776708)"
2018,Diciembre,Suecia,752,10,7,,17,"(3.541112,-76.384584)"
2018,Diciembre,Suecia,752,76,59,,135,"(4.697144,-74.140516)"
2018,Diciembre,Suecia,752,6,3,,9,"(4.815061,-75.736532)"
2018,Diciembre,Suecia,752,5,3,,8,"(6.171601,-75.427454)"
2018,Diciembre,Suecia,752,0,1,,1,"(7.128456,-73.183637)"
2018,Diciembre,Suiza,756,6,1,,7,"(10.445761,-75.516429)"
2018,Diciembre,Suiza,756,2,0,,2,"(10.886611,-74.776708)"
2018,Diciembre,Suiza,756,51,34,,85,"(3.541112,-76.384584)"
2018,Diciembre,Suiza,756,284,168,,452,"(4.697144,-74.140516)"
2018,Diciembre,Suiza,756,2,0,,2,"(4.815061,-75.736532)"
2018,Diciembre,Suiza,756,41,20,,61,"(6.171601,-75.427454)"
2018,Diciembre,Surinam,740,0,1,,1,"(10.445761,-75.516429)"
2018,Diciembre,Surinam,740,0,1,,1,"(10.886611,-74.776708)"
2018,Diciembre,Surinam,740,4,7,,11,"(4.697144,-74.140516)"
2018,Diciembre,Surinam,740,1,0,,1,"(6.171601,-75.427454)"
2018,Diciembre,Taiwán,158,0,1,,1,"(10.445761,-75.516429)"
2018,Diciembre,Taiwán,158,3,4,,7,"(4.697144,-74.140516)"
2018,Diciembre,Tailandia,764,1,0,,1,"(10.445761,-75.516429)"
2018,Diciembre,Tailandia,764,1,1,,2,"(3.541112,-76.384584)"
2018,Diciembre,Tailandia,764,69,50,,119,"(4.697144,-74.140516)"
2018,Diciembre,Tailandia,764,6,3,,9,"(6.171601,-75.427454)"
2018,Diciembre,Togo,768,1,0,,1,"(4.697144,-74.140516)"
2018,Diciembre,Trinidad y Tobago,780,2,2,,4,"(10.408582,-75.538003)"
2018,Diciembre,Trinidad y Tobago,780,5,4,,9,"(10.445761,-75.516429)"
2018,Diciembre,Trinidad y Tobago,780,2,3,,5,"(10.886611,-74.776708)"
2018,Diciembre,Trinidad y Tobago,780,4,2,,6,"(3.541112,-76.384584)"
2018,Diciembre,Trinidad y Tobago,780,11,10,,21,"(4.697144,-74.140516)"
2018,Diciembre,Trinidad y Tobago,780,1,3,,4,"(4.815061,-75.736532)"
2018,Diciembre,Trinidad y Tobago,780,3,6,,9,"(6.171601,-75.427454)"
2018,Diciembre,Trinidad y Tobago,780,0,3,,3,"(7.128456,-73.183637)"
2018,Diciembre,Turquía,792,4,3,,7,"(10.445761,-75.516429)"
2018,Diciembre,Turquía,792,0,1,,1,"(10.886611,-74.776708)"
2018,Diciembre,Turquía,792,3,2,,5,"(3.541112,-76.384584)"
2018,Diciembre,Turquía,792,894,563,,1457,"(4.697144,-74.140516)"
2018,Diciembre,Turquía,792,13,7,,20,"(6.171601,-75.427454)"
2018,Diciembre,Turkmenistán,795,2,0,,2,"(4.697144,-74.140516)"
2018,Diciembre,Ucrania,804,0,2,,2,"(4.697144,-74.140516)"
2018,Diciembre,Uganda,800,2,1,,3,"(4.697144,-74.140516)"
2018,Diciembre,Uganda,800,1,0,,1,"(6.171601,-75.427454)"
2018,Diciembre,Uruguay,858,3,2,,5,"(10.445761,-75.516429)"
2018,Diciembre,Uruguay,858,5,3,,8,"(10.886611,-74.776708)"
2018,Diciembre,Uruguay,858,24,15,,39,"(3.541112,-76.384584)"
2018,Diciembre,Uruguay,858,551,501,,1052,"(4.697144,-74.140516)"
2018,Diciembre,Uruguay,858,5,6,,11,"(4.815061,-75.736532)"
2018,Diciembre,Uruguay,858,29,25,,54,"(6.171601,-75.427454)"
2018,Diciembre,Venezuela,862,12,3,,15,"(10.445761,-75.516429)"
2018,Diciembre,Venezuela,862,28,27,,55,"(10.886611,-74.776708)"
2018,Diciembre,Venezuela,862,0,1,,1,"(11.117806,-74.232622)"
2018,Diciembre,Venezuela,862,1564,1906,,3470,"(11.360009,-72.129330)"
2018,Diciembre,Venezuela,862,3,0,,3,"(12.586067,-81.702563)"
2018,Diciembre,Venezuela,862,916,578,,1494,"(3.541112,-76.384584)"
2018,Diciembre,Venezuela,862,6,9,,15,"(3.866713,-67.927521)"
2018,Diciembre,Venezuela,862,2502,2116,,4618,"(4.697144,-74.140516)"
2018,Diciembre,Venezuela,862,3,3,,6,"(4.815061,-75.736532)"
2018,Diciembre,Venezuela,862,1445,1080,,2525,"(6.171601,-75.427454)"
2018,Diciembre,Venezuela,862,39,47,,86,"(6.185799,-67.483929)"
2018,Diciembre,Venezuela,862,638,647,,1285,"(7.088729,-70.740253)"
2018,Diciembre,Venezuela,862,6,8,,14,"(7.128456,-73.183637)"
2018,Diciembre,Venezuela,862,1300,1356,,2656,"(7.818934,-72.453226)"
2018,Diciembre,Venezuela,862,1,0,,1,"(7.927209,-72.507910)"
2018,Diciembre,Venezuela,862,237,293,,530,"(8.36068,-72.409396)"
2018,Diciembre,Vietnam,704,4,7,,11,"(4.697144,-74.140516)"
2018,Diciembre,Islas Vírgenes Británicas/Territorio Británico de Ultramar,92,0,1,,1,"(4.815061,-75.736532)"
2018,Diciembre,República Árabe de Yemen,887,0,1,,1,"(4.697144,-74.140516)"
2019,Enero,Afganistán,4,0,5,,5,"(4.697144,-74.140516)"
2019,Enero,Albania,8,0,10,,10,"(4.697144,-74.140516)"
2019,Enero,Alemania,276,19,13,,32,"(10.445761,-75.516429)"
2019,Enero,Alemania,276,10,8,,18,"(10.886611,-74.776708)"
2019,Enero,Alemania,276,65,48,,113,"(3.541112,-76.384584)"
2019,Enero,Alemania,276,2091,1951,,4042,"(4.697144,-74.140516)"
2019,Enero,Alemania,276,3,1,,4,"(4.815061,-75.736532)"
2019,Enero,Alemania,276,83,82,,165,"(6.171601,-75.427454)"
2019,Enero,Angola,24,2,13,,15,"(4.697144,-74.140516)"
2019,Enero,Angola,24,2,1,,3,"(7.128456,-73.183637)"
2019,Enero,Antigua y Barbuda,28,4,3,,7,"(4.697144,-74.140516)"
2019,Enero,Antigua y Barbuda,28,0,2,,2,"(6.171601,-75.427454)"
2019,Enero,Países Bajos,528,0,7,,7,"(10.408582,-75.538003)"
2019,Enero,Países Bajos,528,187,135,,322,"(10.445761,-75.516429)"
2019,Enero,Países Bajos,528,13,4,,17,"(10.886611,-74.776708)"
2019,Enero,Países Bajos,528,54,29,,83,"(3.541112,-76.384584)"
2019,Enero,Países Bajos,528,1710,1389,,3099,"(4.697144,-74.140516)"
2019,Enero,Países Bajos,528,6,4,,10,"(4.815061,-75.736532)"
2019,Enero,Países Bajos,528,101,76,,177,"(6.171601,-75.427454)"
2019,Enero,Países Bajos,528,1,0,,1,"(7.128456,-73.183637)"
2019,Enero,Arabia Saudita,682,3,2,,5,"(10.445761,-75.516429)"
2019,Enero,Arabia Saudita,682,3,8,,11,"(3.541112,-76.384584)"
2019,Enero,Arabia Saudita,682,25,60,,85,"(4.697144,-74.140516)"
2019,Enero,Arabia Saudita,682,0,3,,3,"(6.171601,-75.427454)"
2019,Enero,Arabia Saudita,682,1,5,,6,"(7.128456,-73.183637)"
2019,Enero,Argelia,12,1,0,,1,"(3.541112,-76.384584)"
2019,Enero,Argelia,12,5,8,,13,"(4.697144,-74.140516)"
2019,Enero,Argentina,32,1,0,,1,"(-4.197703,-69.941278)"
2019,Enero,Argentina,32,1,2,,3,"(0.25129,-76.875963)"
2019,Enero,Argentina,32,12,24,,36,"(0.814836,-77.662532)"
2019,Enero,Argentina,32,92,65,,157,"(10.445761,-75.516429)"
2019,Enero,Argentina,32,50,44,,94,"(10.886611,-74.776708)"
2019,Enero,Argentina,32,3,1,,4,"(12.586067,-81.702563)"
2019,Enero,Argentina,32,315,288,,603,"(3.541112,-76.384584)"
2019,Enero,Argentina,32,4007,3738,,7745,"(4.697144,-74.140516)"
2019,Enero,Argentina,32,24,32,,56,"(4.815061,-75.736532)"
2019,Enero,Argentina,32,279,258,,537,"(6.171601,-75.427454)"
2019,Enero,Argentina,32,1,5,,6,"(7.128456,-73.183637)"
2019,Enero,República de Armenia,51,0,1,,1,"(4.697144,-74.140516)"
2019,Enero,Aruba,533,2250,1757,,4007,"(10.408582,-75.538003)"
2019,Enero,Aruba,533,3,3,,6,"(10.445761,-75.516429)"
2019,Enero,Aruba,533,16,12,,28,"(10.886611,-74.776708)"
2019,Enero,Aruba,533,0,25,,25,"(12.165168,-71.983761)"
2019,Enero,Aruba,533,53,38,,91,"(3.541112,-76.384584)"
2019,Enero,Aruba,533,2770,2228,,4998,"(4.697144,-74.140516)"
2019,Enero,Aruba,533,9,5,,14,"(4.815061,-75.736532)"
2019,Enero,Aruba,533,66,44,,110,"(6.171601,-75.427454)"
2019,Enero,Aruba,533,11,32,,43,"(7.128456,-73.183637)"
2019,Enero,Australia,36,8,3,,11,"(10.445761,-75.516429)"
2019,Enero,Australia,36,4,5,,9,"(10.886611,-74.776708)"
2019,Enero,Australia,36,50,37,,87,"(3.541112,-76.384584)"
2019,Enero,Australia,36,999,813,,1812,"(4.697144,-74.140516)"
2019,Enero,Australia,36,2,2,,4,"(4.815061,-75.736532)"
2019,Enero,Australia,36,110,117,,227,"(6.171601,-75.427454)"
2019,Enero,Australia,36,4,2,,6,"(7.128456,-73.183637)"
2019,Enero,Austria,40,1,0,,1,"(10.886611,-74.776708)"
2019,Enero,Austria,40,3,3,,6,"(3.541112,-76.384584)"
2019,Enero,Austria,40,61,39,,100,"(4.697144,-74.140516)"
2019,Enero,Austria,40,2,6,,8,"(6.171601,-75.427454)"
2019,Enero,Bahamas,44,1,1,,2,"(10.408582,-75.538003)"
2019,Enero,Bahamas,44,0,1,,1,"(10.445761,-75.516429)"
2019,Enero,Bahamas,44,4,5,,9,"(10.886611,-74.776708)"
2019,Enero,Bahamas,44,14,10,,24,"(3.541112,-76.384584)"
2019,Enero,Bahamas,44,9,16,,25,"(4.697144,-74.140516)"
2019,Enero,Bahamas,44,8,4,,12,"(4.815061,-75.736532)"
2019,Enero,Bahamas,44,21,42,,63,"(6.171601,-75.427454)"
2019,Enero,Bahréin,48,1,0,,1,"(3.541112,-76.384584)"
2019,Enero,Bahréin,48,6,6,,12,"(4.697144,-74.140516)"
2019,Enero,Bahréin,48,2,0,,2,"(6.171601,-75.427454)"
2019,Enero,Bangladesh,50,0,1,,1,"(4.697144,-74.140516)"
2019,Enero,Barbados,52,0,1,,1,"(10.886611,-74.776708)"
2019,Enero,Barbados,52,4,7,,11,"(3.541112,-76.384584)"
2019,Enero,Barbados,52,7,7,,14,"(4.697144,-74.140516)"
2019,Enero,Barbados,52,1,2,,3,"(4.815061,-75.736532)"
2019,Enero,Barbados,52,1,0,,1,"(6.171601,-75.427454)"
2019,Enero,Bélgica,56,9,5,,14,"(10.445761,-75.516429)"
2019,Enero,Bélgica,56,2,1,,3,"(10.886611,-74.776708)"
2019,Enero,Bélgica,56,0,1,,1,"(11.117806,-74.232622)"
2019,Enero,Bélgica,56,14,20,,34,"(3.541112,-76.384584)"
2019,Enero,Bélgica,56,179,121,,300,"(4.697144,-74.140516)"
2019,Enero,Bélgica,56,1,2,,3,"(4.815061,-75.736532)"
2019,Enero,Bélgica,56,26,20,,46,"(6.171601,-75.427454)"
2019,Enero,Belice,84,0,1,,1,"(3.541112,-76.384584)"
2019,Enero,Belice,84,11,15,,26,"(4.697144,-74.140516)"
2019,Enero,Belice,84,1,1,,2,"(4.815061,-75.736532)"
2019,Enero,Belice,84,5,1,,6,"(6.171601,-75.427454)"
2019,Enero,Benín,204,0,1,,1,"(4.697144,-74.140516)"
2019,Enero,Benín,204,1,0,,1,"(6.171601,-75.427454)"
2019,Enero,Bermudas/Territorio Británico de Ultramar,60,1,1,,2,"(3.541112,-76.384584)"
2019,Enero,Bermudas/Territorio Británico de Ultramar,60,1,1,,2,"(4.697144,-74.140516)"
2019,Enero,Bermudas/Territorio Británico de Ultramar,60,2,1,,3,"(6.171601,-75.427454)"
2019,Enero,Bolivia,68,0,1,,1,"(0.25129,-76.875963)"
2019,Enero,Bolivia,68,6,8,,14,"(0.814836,-77.662532)"
2019,Enero,Bolivia,68,1,2,,3,"(10.445761,-75.516429)"
2019,Enero,Bolivia,68,1,0,,1,"(10.886611,-74.776708)"
2019,Enero,Bolivia,68,22,42,,64,"(3.541112,-76.384584)"
2019,Enero,Bolivia,68,623,1022,,1645,"(4.697144,-74.140516)"
2019,Enero,Bolivia,68,1,15,,16,"(4.815061,-75.736532)"
2019,Enero,Bolivia,68,37,61,,98,"(6.171601,-75.427454)"
2019,Enero,Bosnia y Herzegovina,70,2,1,,3,"(4.697144,-74.140516)"
2019,Enero,Brasil,76,192,350,,542,"(-4.197703,-69.941278)"
2019,Enero,Brasil,76,25,26,,51,"(-4.223468,-69.945098)"
2019,Enero,Brasil,76,2,3,,5,"(0.814836,-77.662532)"
2019,Enero,Brasil,76,16,30,,46,"(10.445761,-75.516429)"
2019,Enero,Brasil,76,16,21,,37,"(10.886611,-74.776708)"
2019,Enero,Brasil,76,2,1,,3,"(12.586067,-81.702563)"
2019,Enero,Brasil,76,171,250,,421,"(3.541112,-76.384584)"
2019,Enero,Brasil,76,3,2,,5,"(3.866713,-67.927521)"
2019,Enero,Brasil,76,3208,4158,,7367,"(4.697144,-74.140516)"
2019,Enero,Brasil,76,25,43,,68,"(4.815061,-75.736532)"
2019,Enero,Brasil,76,171,233,,404,"(6.171601,-75.427454)"
2019,Enero,Brasil,76,4,5,,9,"(7.128456,-73.183637)"
2019,Enero,Bulgaria,100,2,1,,3,"(4.697144,-74.140516)"
2019,Enero,Bulgaria,100,1,0,,1,"(6.171601,-75.427454)"
2019,Enero,Burkina Faso,854,0,2,,2,"(4.697144,-74.140516)"
2019,Enero,Cabo Verde,132,0,1,,1,"(4.697144,-74.140516)"
2019,Enero,Islas Caimán/Territorio Británico de Ultramar,136,0,1,,1,"(10.445761,-75.516429)"
2019,Enero,Islas Caimán/Territorio Británico de Ultramar,136,2,4,,6,"(10.886611,-74.776708)"
2019,Enero,Islas Caimán/Territorio Británico de Ultramar,136,6,3,,9,"(12.586067,-81.702563)"
2019,Enero,Islas Caimán/Territorio Británico de Ultramar,136,3,2,,5,"(3.541112,-76.384584)"
2019,Enero,Islas Caimán/Territorio Británico de Ultramar,136,3,14,,17,"(4.697144,-74.140516)"
2019,Enero,Islas Caimán/Territorio Británico de Ultramar,136,3,3,,6,"(6.171601,-75.427454)"
2019,Enero,Camboya,116,2,0,,2,"(4.697144,-74.140516)"
2019,Enero,Antártida,10,1,0,,1,"(10.445761,-75.516429)"
2019,Enero,Antártida,10,3,2,,5,"(4.697144,-74.140516)"
2019,Enero,Camerún,120,2,2,,4,"(4.697144,-74.140516)"
2019,Enero,Canadá,124,453,380,,833,"(10.445761,-75.516429)"
2019,Enero,Canadá,124,81,80,,161,"(10.886611,-74.776708)"
2019,Enero,Canadá,124,0,1,,1,"(11.117806,-74.232622)"
2019,Enero,Canadá,124,27,25,,52,"(12.586067,-81.702563)"
2019,Enero,Canadá,124,268,236,,504,"(3.541112,-76.384584)"
2019,Enero,Canadá,124,7,9,,16,"(4.452882,-75.766298)"
2019,Enero,Canadá,124,4359,3894,,8253,"(4.697144,-74.140516)"
2019,Enero,Canadá,124,39,45,,84,"(4.815061,-75.736532)"
2019,Enero,Canadá,124,476,376,,852,"(6.171601,-75.427454)"
2019,Enero,Canadá,124,25,18,,43,"(7.128456,-73.183637)"
2019,Enero,Chad,148,2,2,,4,"(4.697144,-74.140516)"
2019,Enero,España,724,1,0,,1,"(0.814836,-77.662532)"
2019,Enero,España,724,25,16,,41,"(10.445761,-75.516429)"
2019,Enero,España,724,52,23,,75,"(10.886611,-74.776708)"
2019,Enero,España,724,2859,1997,,4856,"(3.541112,-76.384584)"
2019,Enero,España,724,13849,10286,,24135,"(4.697144,-74.140516)"
2019,Enero,España,724,8,6,,14,"(4.815061,-75.736532)"
2019,Enero,España,724,2149,1533,,3682,"(6.171601,-75.427454)"
2019,Enero,Colombia,170,6,13,,19,"(10.445761,-75.516429)"
2019,Enero,Colombia,170,189,519,,708,"(4.697144,-74.140516)"
2019,Enero,República Del Congo,178,2,1,,3,"(4.697144,-74.140516)"
2019,Enero,República Democrática del Congo,180,0,1,,1,"(4.697144,-74.140516)"
2019,Enero,República Democrática del Congo,180,0,1,,1,"(6.171601,-75.427454)"
2019,Enero,República de Corea,410,1,0,,1,"(3.541112,-76.384584)"
2019,Enero,República de Corea,410,14,14,,28,"(4.697144,-74.140516)"
2019,Enero,República de Corea,410,6,2,,8,"(6.171601,-75.427454)"
2019,Enero,Costa de Marfil,384,1,0,,1,"(3.541112,-76.384584)"
2019,Enero,Costa de Marfil,384,5,12,,17,"(4.697144,-74.140516)"
2019,Enero,Costa de Marfil,384,3,2,,5,"(6.171601,-75.427454)"
2019,Enero,Costa de Marfil,384,0,1,,1,"(7.128456,-73.183637)"
2019,Enero,Costa Rica,188,1,2,,3,"(10.408582,-75.538003)"
2019,Enero,Costa Rica,188,34,29,,63,"(10.445761,-75.516429)"
2019,Enero,Costa Rica,188,27,30,,57,"(10.886611,-74.776708)"
2019,Enero,Costa Rica,188,2,1,,3,"(11.247723,-74.213989)"
2019,Enero,Costa Rica,188,3,24,,27,"(12.5744111,-81.703935)"
2019,Enero,Costa Rica,188,12,9,,21,"(12.586067,-81.702563)"
2019,Enero,Costa Rica,188,110,117,,227,"(3.541112,-76.384584)"
2019,Enero,Costa Rica,188,1521,1529,,3050,"(4.697144,-74.140516)"
2019,Enero,Costa Rica,188,32,30,,62,"(4.815061,-75.736532)"
2019,Enero,Costa Rica,188,266,208,,474,"(6.171601,-75.427454)"
2019,Enero,Costa Rica,188,6,12,,18,"(7.128456,-73.183637)"
2019,Enero,Croacia,191,2,4,,6,"(4.697144,-74.140516)"
2019,Enero,Cuba,192,16,16,,32,"(10.445761,-75.516429)"
2019,Enero,Cuba,192,18,12,,30,"(10.886611,-74.776708)"
2019,Enero,Cuba,192,0,2,,2,"(12.586067,-81.702563)"
2019,Enero,Cuba,192,95,77,,172,"(3.541112,-76.384584)"
2019,Enero,Cuba,192,1846,1671,,3517,"(4.697144,-74.140516)"
2019,Enero,Cuba,192,10,9,,19,"(4.815061,-75.736532)"
2019,Enero,Cuba,192,112,101,,213,"(6.171601,-75.427454)"
2019,Enero,Cuba,192,8,6,,14,"(7.128456,-73.183637)"
2019,Enero,Curazao,99999,1,3,,4,"(10.445761,-75.516429)"
2019,Enero,Curazao,99999,5,1,,6,"(10.886611,-74.776708)"
2019,Enero,Curazao,99999,22,22,,44,"(3.541112,-76.384584)"
2019,Enero,Curazao,99999,929,764,,1693,"(4.697144,-74.140516)"
2019,Enero,Curazao,99999,7,4,,11,"(4.815061,-75.736532)"
2019,Enero,Curazao,99999,24,9,,33,"(6.171601,-75.427454)"
2019,Enero,Curazao,99999,1,1,,2,"(7.128456,-73.183637)"
2019,Enero,República Checa,203,0,1,,1,"(10.445761,-75.516429)"
2019,Enero,República Checa,203,14,22,,36,"(4.697144,-74.140516)"
2019,Enero,República Checa,203,2,0,,2,"(6.171601,-75.427454)"
2019,Enero,Chile,152,2,3,,5,"(0.25129,-76.875963)"
2019,Enero,Chile,152,159,173,,332,"(0.814836,-77.662532)"
2019,Enero,Chile,152,76,51,,127,"(10.445761,-75.516429)"
2019,Enero,Chile,152,69,63,,132,"(10.886611,-74.776708)"
2019,Enero,Chile,152,1,0,,1,"(12.586067,-81.702563)"
2019,Enero,Chile,152,1422,922,,2344,"(3.541112,-76.384584)"
2019,Enero,Chile,152,8107,6816,,14923,"(4.697144,-74.140516)"
2019,Enero,Chile,152,116,92,,208,"(4.815061,-75.736532)"
2019,Enero,Chile,152,391,332,,723,"(6.171601,-75.427454)"
2019,Enero,Chile,152,7,4,,11,"(7.128456,-73.183637)"
2019,Enero,China,156,1,1,,2,"(10.445761,-75.516429)"
2019,Enero,China,156,8,7,,15,"(3.541112,-76.384584)"
2019,Enero,China,156,89,191,,280,"(4.697144,-74.140516)"
2019,Enero,China,156,0,1,,1,"(4.815061,-75.736532)"
2019,Enero,China,156,8,10,,18,"(6.171601,-75.427454)"
2019,Enero,Chipre,196,1,3,,4,"(4.697144,-74.140516)"
2019,Enero,Chipre,196,0,1,,1,"(6.171601,-75.427454)"
2019,Enero,Dinamarca,208,1,2,,3,"(10.445761,-75.516429)"
2019,Enero,Dinamarca,208,1,2,,3,"(3.541112,-76.384584)"
2019,Enero,Dinamarca,208,51,36,,87,"(4.697144,-74.140516)"
2019,Enero,Dinamarca,208,1,1,,2,"(4.815061,-75.736532)"
2019,Enero,Dinamarca,208,5,1,,6,"(6.171601,-75.427454)"
2019,Enero,Dominica,212,0,6,,6,"(3.541112,-76.384584)"
2019,Enero,Dominica,212,1,3,,4,"(4.697144,-74.140516)"
2019,Enero,Ecuador,218,3,4,,7,"(-0.193180,-74.784874)"
2019,Enero,Ecuador,218,1293,1705,,2998,"(0.25129,-76.875963)"
2019,Enero,Ecuador,218,34,58,,92,"(0.812436,-77.847006)"
2019,Enero,Ecuador,218,12768,13745,,26513,"(0.814836,-77.662532)"
2019,Enero,Ecuador,218,199,228,,427,"(1.813928,-78.763924)"
2019,Enero,Ecuador,218,4,5,,9,"(10.445761,-75.516429)"
2019,Enero,Ecuador,218,8,9,,17,"(10.886611,-74.776708)"
2019,Enero,Ecuador,218,586,650,,1236,"(3.541112,-76.384584)"
2019,Enero,Ecuador,218,3305,4354,,7659,"(4.697144,-74.140516)"
2019,Enero,Ecuador,218,2,3,,5,"(4.815061,-75.736532)"
2019,Enero,Ecuador,218,20,70,,90,"(6.171601,-75.427454)"
2019,Enero,Egipto,818,1,0,,1,"(10.445761,-75.516429)"
2019,Enero,Egipto,818,1,1,,2,"(3.541112,-76.384584)"
2019,Enero,Egipto,818,28,18,,46,"(4.697144,-74.140516)"
2019,Enero,Egipto,818,0,2,,2,"(4.815061,-75.736532)"
2019,Enero,Egipto,818,1,2,,3,"(6.171601,-75.427454)"
2019,Enero,El Salvador,222,87,97,,184,"(10.445761,-75.516429)"
2019,Enero,El Salvador,222,7,5,,12,"(10.886611,-74.776708)"
2019,Enero,El Salvador,222,110,117,,227,"(3.541112,-76.384584)"
2019,Enero,El Salvador,222,0,1,,1,"(4.452882,-75.766298)"
2019,Enero,El Salvador,222,914,1051,,1965,"(4.697144,-74.140516)"
2019,Enero,El Salvador,222,1,0,,1,"(4.815061,-75.736532)"
2019,Enero,El Salvador,222,25,28,,53,"(6.171601,-75.427454)"
2019,Enero,El Salvador,222,2,2,,4,"(7.128456,-73.183637)"
2019,Enero,Emiratos Árabes,784,3,1,,4,"(10.445761,-75.516429)"
2019,Enero,Emiratos Árabes,784,0,1,,1,"(12.586067,-81.702563)"
2019,Enero,Emiratos Árabes,784,7,3,,10,"(3.541112,-76.384584)"
2019,Enero,Emiratos Árabes,784,151,432,,583,"(4.697144,-74.140516)"
2019,Enero,Emiratos Árabes,784,11,8,,19,"(6.171601,-75.427454)"
2019,Enero,Eritrea,232,0,1,,1,"(4.697144,-74.140516)"
2019,Enero,Eslovaquia,703,3,6,,9,"(4.697144,-74.140516)"
2019,Enero,Eslovenia,705,2,3,,5,"(4.697144,-74.140516)"
2019,Enero,Eslovenia,705,1,1,,2,"(6.171601,-75.427454)"
2019,Enero,Estados Unidos de América,840,1,0,,1,"(10.408582,-75.538003)"
2019,Enero,Estados Unidos de América,840,4669,3901,,8570,"(10.445761,-75.516429)"
2019,Enero,Estados Unidos de América,840,3517,2796,,6313,"(10.886611,-74.776708)"
2019,Enero,Estados Unidos de América,840,442,419,,861,"(11.117806,-74.232622)"
2019,Enero,Estados Unidos de América,840,81,62,,143,"(12.586067,-81.702563)"
2019,Enero,Estados Unidos de América,840,7751,6039,,13790,"(3.541112,-76.384584)"
2019,Enero,Estados Unidos de América,840,767,682,,1449,"(4.452882,-75.766298)"
2019,Enero,Estados Unidos de América,840,41093,35754,,76847,"(4.697144,-74.140516)"
2019,Enero,Estados Unidos de América,840,1733,1298,,3031,"(4.815061,-75.736532)"
2019,Enero,Estados Unidos de América,840,12043,9881,,21924,"(6.171601,-75.427454)"
2019,Enero,Estados Unidos de América,840,181,154,,335,"(7.128456,-73.183637)"
2019,Enero,Estados Unidos de América,840,0,1,,1,"(8.635765,-77.346578)"
2019,Enero,Estonia,233,1,6,,7,"(4.697144,-74.140516)"
2019,Enero,Etiopia,231,1,7,,8,"(4.697144,-74.140516)"
2019,Enero,Etiopia,231,0,1,,1,"(6.171601,-75.427454)"
2019,Enero,Filipinas,608,1,0,,1,"(10.445761,-75.516429)"
2019,Enero,Filipinas,608,0,1,,1,"(3.541112,-76.384584)"
2019,Enero,Filipinas,608,3,9,,12,"(4.697144,-74.140516)"
2019,Enero,Filipinas,608,1,2,,3,"(6.171601,-75.427454)"
2019,Enero,Finlandia,246,0,1,,1,"(10.445761,-75.516429)"
2019,Enero,Finlandia,246,2,0,,2,"(10.886611,-74.776708)"
2019,Enero,Finlandia,246,3,0,,3,"(3.541112,-76.384584)"
2019,Enero,Finlandia,246,14,14,,28,"(4.697144,-74.140516)"
2019,Enero,Finlandia,246,1,1,,2,"(6.171601,-75.427454)"
2019,Enero,Francia,250,11,9,,20,"(10.445761,-75.516429)"
2019,Enero,Francia,250,8,4,,12,"(10.886611,-74.776708)"
2019,Enero,Francia,250,115,95,,210,"(3.541112,-76.384584)"
2019,Enero,Francia,250,1978,1511,,3489,"(4.697144,-74.140516)"
2019,Enero,Francia,250,8,10,,18,"(4.815061,-75.736532)"
2019,Enero,Francia,250,130,72,,202,"(6.171601,-75.427454)"
2019,Enero,Gabón,266,1,1,,2,"(4.697144,-74.140516)"
2019,Enero,Georgia,268,0,1,,1,"(4.697144,-74.140516)"
2019,Enero,Ghana,288,4,2,,6,"(4.697144,-74.140516)"
2019,Enero,Granada,308,0,1,,1,"(4.697144,-74.140516)"
2019,Enero,Grecia,300,21,7,,28,"(4.697144,-74.140516)"
2019,Enero,Grecia,300,1,0,,1,"(6.171601,-75.427454)"
2019,Enero,Guatemala,320,10,11,,21,"(10.445761,-75.516429)"
2019,Enero,Guatemala,320,14,26,,40,"(10.886611,-74.776708)"
2019,Enero,Guatemala,320,55,103,,158,"(3.541112,-76.384584)"
2019,Enero,Guatemala,320,749,864,,1613,"(4.697144,-74.140516)"
2019,Enero,Guatemala,320,16,22,,38,"(4.815061,-75.736532)"
2019,Enero,Guatemala,320,63,96,,159,"(6.171601,-75.427454)"
2019,Enero,Guatemala,320,4,6,,10,"(7.128456,-73.183637)"
2019,Enero,Guyana,328,4,8,,12,"(10.886611,-74.776708)"
2019,Enero,Guyana,328,1,1,,2,"(3.541112,-76.384584)"
2019,Enero,Guyana,328,3,7,,10,"(4.697144,-74.140516)"
2019,Enero,Guyana,328,1,3,,4,"(4.815061,-75.736532)"
2019,Enero,Guyana,328,2,1,,3,"(6.171601,-75.427454)"
2019,Enero,Guinea,324,2,1,,3,"(4.697144,-74.140516)"
2019,Enero,Guinea Ecuatorial,226,4,5,,9,"(3.541112,-76.384584)"
2019,Enero,Guinea Ecuatorial,226,3,6,,9,"(4.697144,-74.140516)"
2019,Enero,Guinea Ecuatorial,226,1,2,,3,"(6.171601,-75.427454)"
2019,Enero,Guadalupe/Territorio Francés,312,0,2,,2,"(3.541112,-76.384584)"
2019,Enero,Guadalupe/Territorio Francés,312,5,1,,6,"(4.697144,-74.140516)"
2019,Enero,Guadalupe/Territorio Francés,312,0,1,,1,"(6.171601,-75.427454)"
2019,Enero,Guayana Francesa/Departamento de Ultramar Francés,254,1,1,,2,"(10.886611,-74.776708)"
2019,Enero,Guayana Francesa/Departamento de Ultramar Francés,254,2,1,,3,"(4.697144,-74.140516)"
2019,Enero,Guayana Francesa/Departamento de Ultramar Francés,254,0,1,,1,"(6.171601,-75.427454)"
2019,Enero,Haití,332,1,0,,1,"(10.445761,-75.516429)"
2019,Enero,Haití,332,0,3,,3,"(10.886611,-74.776708)"
2019,Enero,Haití,332,8,13,,21,"(4.697144,-74.140516)"
2019,Enero,Haití,332,1,2,,3,"(4.815061,-75.736532)"
2019,Enero,Haití,332,4,2,,6,"(6.171601,-75.427454)"
2019,Enero,Honduras,340,1,7,,8,"(10.445761,-75.516429)"
2019,Enero,Honduras,340,11,18,,29,"(10.886611,-74.776708)"
2019,Enero,Honduras,340,0,4,,4,"(12.586067,-81.702563)"
2019,Enero,Honduras,340,28,36,,64,"(3.541112,-76.384584)"
2019,Enero,Honduras,340,118,184,,302,"(4.697144,-74.140516)"
2019,Enero,Honduras,340,5,9,,14,"(4.815061,-75.736532)"
2019,Enero,Honduras,340,35,73,,108,"(6.171601,-75.427454)"
2019,Enero,Honduras,340,5,9,,14,"(7.128456,-73.183637)"
2019,Enero,Hong Kong,344,3,1,,4,"(3.541112,-76.384584)"
2019,Enero,Hong Kong,344,24,33,,57,"(4.697144,-74.140516)"
2019,Enero,Hong Kong,344,3,2,,5,"(6.171601,-75.427454)"
2019,Enero,Hungría,348,1,0,,1,"(10.445761,-75.516429)"
2019,Enero,Hungría,348,3,10,,13,"(4.697144,-74.140516)"
2019,Enero,Hungría,348,2,0,,2,"(6.171601,-75.427454)"
2019,Enero,India,356,0,1,,1,"(10.445761,-75.516429)"
2019,Enero,India,356,8,2,,10,"(3.541112,-76.384584)"
2019,Enero,India,356,53,31,,84,"(4.697144,-74.140516)"
2019,Enero,India,356,10,10,,20,"(6.171601,-75.427454)"
2019,Enero,Indonesia,360,1,0,,1,"(10.445761,-75.516429)"
2019,Enero,Indonesia,360,1,0,,1,"(3.541112,-76.384584)"
2019,Enero,Indonesia,360,3,7,,10,"(4.697144,-74.140516)"
2019,Enero,Indonesia,360,0,2,,2,"(6.171601,-75.427454)"
2019,Enero,Iraq,368,1,0,,1,"(3.541112,-76.384584)"
2019,Enero,Iraq,368,2,10,,12,"(4.697144,-74.140516)"
2019,Enero,Irán,364,1,0,,1,"(4.697144,-74.140516)"
2019,Enero,República de Irlanda,372,0,2,,2,"(3.541112,-76.384584)"
2019,Enero,República de Irlanda,372,37,14,,51,"(4.697144,-74.140516)"
2019,Enero,República de Irlanda,372,1,2,,3,"(6.171601,-75.427454)"
2019,Enero,Islandia,352,1,0,,1,"(10.445761,-75.516429)"
2019,Enero,Islandia,352,2,6,,8,"(4.697144,-74.140516)"
2019,Enero,Islandia,352,0,1,,1,"(6.171601,-75.427454)"
2019,Enero,Israel,376,1,0,,1,"(0.814836,-77.662532)"
2019,Enero,Israel,376,2,0,,2,"(10.445761,-75.516429)"
2019,Enero,Israel,376,10,10,,20,"(3.541112,-76.384584)"
2019,Enero,Israel,376,142,77,,219,"(4.697144,-74.140516)"
2019,Enero,Israel,376,2,0,,2,"(4.815061,-75.736532)"
2019,Enero,Israel,376,28,5,,33,"(6.171601,-75.427454)"
2019,Enero,Italia,380,19,15,,34,"(10.445761,-75.516429)"
2019,Enero,Italia,380,7,1,,8,"(10.886611,-74.776708)"
2019,Enero,Italia,380,156,81,,237,"(3.541112,-76.384584)"
2019,Enero,Italia,380,839,551,,1390,"(4.697144,-74.140516)"
2019,Enero,Italia,380,1,1,,2,"(4.815061,-75.736532)"
2019,Enero,Italia,380,120,63,,183,"(6.171601,-75.427454)"
2019,Enero,Italia,380,1,2,,3,"(7.128456,-73.183637)"
2019,Enero,Jamaica,388,2,4,,6,"(10.408582,-75.538003)"
2019,Enero,Jamaica,388,3,4,,7,"(10.445761,-75.516429)"
2019,Enero,Jamaica,388,2,7,,9,"(10.886611,-74.776708)"
2019,Enero,Jamaica,388,5,3,,8,"(12.586067,-81.702563)"
2019,Enero,Jamaica,388,17,12,,29,"(3.541112,-76.384584)"
2019,Enero,Jamaica,388,81,71,,152,"(4.697144,-74.140516)"
2019,Enero,Jamaica,388,2,4,,6,"(4.815061,-75.736532)"
2019,Enero,Jamaica,388,23,18,,41,"(6.171601,-75.427454)"
2019,Enero,Jamaica,388,1,2,,3,"(7.128456,-73.183637)"
2019,Enero,Islas Marianas del Norte,580,1,0,,1,"(4.697144,-74.140516)"
2019,Enero,Japón,392,1,0,,1,"(10.886611,-74.776708)"
2019,Enero,Japón,392,4,4,,8,"(3.541112,-76.384584)"
2019,Enero,Japón,392,61,63,,124,"(4.697144,-74.140516)"
2019,Enero,Japón,392,12,4,,16,"(6.171601,-75.427454)"
2019,Enero,Japón,392,0,1,,1,"(7.128456,-73.183637)"
2019,Enero,Jordania,400,0,1,,1,"(3.541112,-76.384584)"
2019,Enero,Jordania,400,1,1,,2,"(4.697144,-74.140516)"
2019,Enero,Kazajistán,398,0,1,,1,"(10.445761,-75.516429)"
2019,Enero,Kazajistán,398,3,5,,8,"(4.697144,-74.140516)"
2019,Enero,Kenia,404,2,1,,3,"(10.445761,-75.516429)"
2019,Enero,Kenia,404,0,1,,1,"(10.886611,-74.776708)"
2019,Enero,Kenia,404,0,1,,1,"(3.541112,-76.384584)"
2019,Enero,Kenia,404,7,8,,15,"(4.697144,-74.140516)"
2019,Enero,Kenia,404,0,1,,1,"(6.171601,-75.427454)"
2019,Enero,Kuwait,414,6,9,,15,"(4.697144,-74.140516)"
2019,Enero,República Democrática Popular  Lao,418,0,2,,2,"(4.697144,-74.140516)"
2019,Enero,Letonia,428,1,0,,1,"(4.697144,-74.140516)"
2019,Enero,Lituania,440,0,1,,1,"(4.697144,-74.140516)"
2019,Enero,Líbano,422,1,3,,4,"(10.886611,-74.776708)"
2019,Enero,Líbano,422,0,1,,1,"(3.541112,-76.384584)"
2019,Enero,Líbano,422,8,14,,22,"(4.697144,-74.140516)"
2019,Enero,Luxemburgo,442,2,0,,2,"(10.445761,-75.516429)"
2019,Enero,Luxemburgo,442,3,2,,5,"(3.541112,-76.384584)"
2019,Enero,Luxemburgo,442,24,22,,46,"(4.697144,-74.140516)"
2019,Enero,Luxemburgo,442,3,1,,4,"(6.171601,-75.427454)"
2019,Enero,Malasia,458,6,9,,15,"(4.697144,-74.140516)"
2019,Enero,Malasia,458,3,3,,6,"(6.171601,-75.427454)"
2019,Enero,Malawi,454,1,1,,2,"(4.697144,-74.140516)"
2019,Enero,Malta,470,1,0,,1,"(11.117806,-74.232622)"
2019,Enero,Malta,470,2,0,,2,"(3.541112,-76.384584)"
2019,Enero,Malta,470,56,28,,84,"(4.697144,-74.140516)"
2019,Enero,Malta,470,6,4,,10,"(6.171601,-75.427454)"
2019,Enero,Marruecos,504,8,2,,10,"(4.697144,-74.140516)"
2019,Enero,Marruecos,504,1,1,,2,"(6.171601,-75.427454)"
2019,Enero,Islas Marshall,584,0,1,,1,"(4.697144,-74.140516)"
2019,Enero,Mauritania,478,0,1,,1,"(4.697144,-74.140516)"
2019,Enero,Martinica/Departamento de Ultramar Francés,474,1,0,,1,"(3.541112,-76.384584)"
2019,Enero,Martinica/Departamento de Ultramar Francés,474,1,1,,2,"(4.697144,-74.140516)"
2019,Enero,México,484,132,86,,218,"(10.445761,-75.516429)"
2019,Enero,México,484,175,163,,338,"(10.886611,-74.776708)"
2019,Enero,México,484,4,4,,8,"(12.586067,-81.702563)"
2019,Enero,México,484,800,701,,1501,"(3.541112,-76.384584)"
2019,Enero,México,484,18531,16581,,35112,"(4.697144,-74.140516)"
2019,Enero,México,484,148,115,,263,"(4.815061,-75.736532)"
2019,Enero,México,484,2407,1955,,4362,"(6.171601,-75.427454)"
2019,Enero,México,484,87,66,,153,"(7.128456,-73.183637)"
2019,Enero,República de Moldavia,498,1,0,,1,"(4.697144,-74.140516)"
2019,Enero,Mónaco,492,2,1,,3,"(4.697144,-74.140516)"
2019,Enero,Mongolia,496,2,2,,4,"(6.171601,-75.427454)"
2019,Enero,Montenegro,499,0,1,,1,"(4.697144,-74.140516)"
2019,Enero,Mozambique,508,3,1,,4,"(4.697144,-74.140516)"
2019,Enero,Nauru,520,0,1,,1,"(4.697144,-74.140516)"
2019,Enero,Nicaragua,558,2,8,,10,"(10.445761,-75.516429)"
2019,Enero,Nicaragua,558,5,7,,12,"(10.886611,-74.776708)"
2019,Enero,Nicaragua,558,3,1,,4,"(12.586067,-81.702563)"
2019,Enero,Nicaragua,558,17,27,,44,"(3.541112,-76.384584)"
2019,Enero,Nicaragua,558,52,104,,156,"(4.697144,-74.140516)"
2019,Enero,Nicaragua,558,0,9,,9,"(4.815061,-75.736532)"
2019,Enero,Nicaragua,558,14,44,,58,"(6.171601,-75.427454)"
2019,Enero,Nicaragua,558,0,1,,1,"(7.128456,-73.183637)"
2019,Enero,Nigeria,566,0,1,,1,"(10.408582,-75.538003)"
2019,Enero,Nigeria,566,0,1,,1,"(10.445761,-75.516429)"
2019,Enero,Nigeria,566,0,1,,1,"(3.541112,-76.384584)"
2019,Enero,Nigeria,566,1,10,,11,"(4.697144,-74.140516)"
2019,Enero,Noruega,578,2,4,,6,"(10.445761,-75.516429)"
2019,Enero,Noruega,578,9,3,,12,"(3.541112,-76.384584)"
2019,Enero,Noruega,578,51,37,,88,"(4.697144,-74.140516)"
2019,Enero,Noruega,578,1,4,,5,"(6.171601,-75.427454)"
2019,Enero,Nueva Caledonia/Territorio francés,540,0,1,,1,"(4.697144,-74.140516)"
2019,Enero,Nueva Caledonia/Territorio francés,540,0,1,,1,"(6.171601,-75.427454)"
2019,Enero,Nueva Zelanda,554,5,6,,11,"(3.541112,-76.384584)"
2019,Enero,Nueva Zelanda,554,107,66,,173,"(4.697144,-74.140516)"
2019,Enero,Nueva Zelanda,554,4,6,,10,"(6.171601,-75.427454)"
2019,Enero,Omán,512,0,2,,2,"(10.445761,-75.516429)"
2019,Enero,Omán,512,0,1,,1,"(10.886611,-74.776708)"
2019,Enero,Omán,512,4,15,,19,"(4.697144,-74.140516)"
2019,Enero,Papúa Nueva Guinea,598,0,1,,1,"(4.697144,-74.140516)"
2019,Enero,Papúa Nueva Guinea,598,0,1,,1,"(6.171601,-75.427454)"
2019,Enero,Panamá,591,21,91,,112,"(10.408582,-75.538003)"
2019,Enero,Panamá,591,1825,1355,,3180,"(10.445761,-75.516429)"
2019,Enero,Panamá,591,1204,875,,2079,"(10.886611,-74.776708)"
2019,Enero,Panamá,591,0,13,,13,"(10.971302,-74.765397)"
2019,Enero,Panamá,591,0,4,,4,"(11.247723,-74.213989)"
2019,Enero,Panamá,591,0,1,,1,"(12.165168,-71.983761)"
2019,Enero,Panamá,591,1,10,,11,"(12.5744111,-81.703935)"
2019,Enero,Panamá,591,131,139,,270,"(12.586067,-81.702563)"
2019,Enero,Panamá,591,0,1,,1,"(13.3387613,-81.372937)"
2019,Enero,Panamá,591,2865,2458,,5323,"(3.541112,-76.384584)"
2019,Enero,Panamá,591,255,161,,416,"(4.452882,-75.766298)"
2019,Enero,Panamá,591,10015,10022,,20037,"(4.697144,-74.140516)"
2019,Enero,Panamá,591,633,471,,1104,"(4.815061,-75.736532)"
2019,Enero,Panamá,591,0,3,,3,"(6.17134,-75.427194)"
2019,Enero,Panamá,591,4591,3949,,8540,"(6.171601,-75.427454)"
2019,Enero,Panamá,591,1,5,,6,"(6.228046,-77.404104)"
2019,Enero,Panamá,591,17,33,,50,"(7.102626,-77.762647)"
2019,Enero,Panamá,591,263,235,,498,"(7.128456,-73.183637)"
2019,Enero,Panamá,591,0,7,,7,"(8.066966,-76.735404)"
2019,Enero,Panamá,591,41,96,,137,"(8.635765,-77.346578)"
2019,Enero,Paraguay,600,2,1,,3,"(0.814836,-77.662532)"
2019,Enero,Paraguay,600,0,1,,1,"(10.445761,-75.516429)"
2019,Enero,Paraguay,600,3,4,,7,"(10.886611,-74.776708)"
2019,Enero,Paraguay,600,2,1,,3,"(12.586067,-81.702563)"
2019,Enero,Paraguay,600,38,49,,87,"(3.541112,-76.384584)"
2019,Enero,Paraguay,600,76,184,,260,"(4.697144,-74.140516)"
2019,Enero,Paraguay,600,5,9,,14,"(4.815061,-75.736532)"
2019,Enero,Paraguay,600,40,56,,96,"(6.171601,-75.427454)"
2019,Enero,Paraguay,600,1,0,,1,"(7.128456,-73.183637)"
2019,Enero,Perú,604,4,8,,12,"(-0.193180,-74.784874)"
2019,Enero,Perú,604,28,58,,86,"(-4.197703,-69.941278)"
2019,Enero,Perú,604,160,175,,335,"(-4.223468,-69.945098)"
2019,Enero,Perú,604,2,4,,6,"(0.25129,-76.875963)"
2019,Enero,Perú,604,92,131,,223,"(0.814836,-77.662532)"
2019,Enero,Perú,604,2,1,,3,"(1.813928,-78.763924)"
2019,Enero,Perú,604,64,72,,136,"(10.445761,-75.516429)"
2019,Enero,Perú,604,17,15,,32,"(10.886611,-74.776708)"
2019,Enero,Perú,604,0,1,,1,"(12.586067,-81.702563)"
2019,Enero,Perú,604,640,558,,1198,"(3.541112,-76.384584)"
2019,Enero,Perú,604,6641,6752,,13393,"(4.697144,-74.140516)"
2019,Enero,Perú,604,7,3,,10,"(4.815061,-75.736532)"
2019,Enero,Perú,604,1217,1142,,2359,"(6.171601,-75.427454)"
2019,Enero,Perú,604,5,4,,9,"(7.128456,-73.183637)"
2019,Enero,Polonia,616,1,0,,1,"(3.541112,-76.384584)"
2019,Enero,Polonia,616,24,48,,72,"(4.697144,-74.140516)"
2019,Enero,Polonia,616,1,1,,2,"(6.171601,-75.427454)"
2019,Enero,Portugal,620,1,0,,1,"(10.886611,-74.776708)"
2019,Enero,Portugal,620,7,7,,14,"(3.541112,-76.384584)"
2019,Enero,Portugal,620,80,87,,167,"(4.697144,-74.140516)"
2019,Enero,Portugal,620,6,10,,16,"(6.171601,-75.427454)"
2019,Enero,Puerto Rico/Territorio de Estados Unidos,630,14,17,,31,"(10.445761,-75.516429)"
2019,Enero,Puerto Rico/Territorio de Estados Unidos,630,24,20,,44,"(10.886611,-74.776708)"
2019,Enero,Puerto Rico/Territorio de Estados Unidos,630,1,3,,4,"(12.586067,-81.702563)"
2019,Enero,Puerto Rico/Territorio de Estados Unidos,630,56,40,,96,"(3.541112,-76.384584)"
2019,Enero,Puerto Rico/Territorio de Estados Unidos,630,617,526,,1143,"(4.697144,-74.140516)"
2019,Enero,Puerto Rico/Territorio de Estados Unidos,630,7,4,,11,"(4.815061,-75.736532)"
2019,Enero,Puerto Rico/Territorio de Estados Unidos,630,52,42,,94,"(6.171601,-75.427454)"
2019,Enero,Puerto Rico/Territorio de Estados Unidos,630,11,8,,19,"(7.128456,-73.183637)"
2019,Enero,Qatar,634,0,1,,1,"(10.445761,-75.516429)"
2019,Enero,Qatar,634,2,0,,2,"(3.541112,-76.384584)"
2019,Enero,Qatar,634,21,13,,34,"(4.697144,-74.140516)"
2019,Enero,Qatar,634,10,6,,16,"(6.171601,-75.427454)"
2019,Enero,Reino Unido de Gran Bretaña e Irlanda del Norte,826,6,4,,10,"(10.445761,-75.516429)"
2019,Enero,Reino Unido de Gran Bretaña e Irlanda del Norte,826,5,7,,12,"(10.886611,-74.776708)"
2019,Enero,Reino Unido de Gran Bretaña e Irlanda del Norte,826,177,111,,288,"(3.541112,-76.384584)"
2019,Enero,Reino Unido de Gran Bretaña e Irlanda del Norte,826,2405,1960,,4365,"(4.697144,-74.140516)"
2019,Enero,Reino Unido de Gran Bretaña e Irlanda del Norte,826,2,2,,4,"(4.815061,-75.736532)"
2019,Enero,Reino Unido de Gran Bretaña e Irlanda del Norte,826,93,71,,164,"(6.171601,-75.427454)"
2019,Enero,República CentroÁfricana,140,3,0,,3,"(4.697144,-74.140516)"
2019,Enero,Federación de Rusia,643,1,0,,1,"(10.445761,-75.516429)"
2019,Enero,Federación de Rusia,643,0,2,,2,"(3.541112,-76.384584)"
2019,Enero,Federación de Rusia,643,27,58,,85,"(4.697144,-74.140516)"
2019,Enero,Federación de Rusia,643,0,3,,3,"(6.171601,-75.427454)"
2019,Enero,República Dominicana,214,31,38,,69,"(10.445761,-75.516429)"
2019,Enero,República Dominicana,214,51,49,,100,"(10.886611,-74.776708)"
2019,Enero,República Dominicana,214,0,5,,5,"(11.117806,-74.232622)"
2019,Enero,República Dominicana,214,3,1,,4,"(12.586067,-81.702563)"
2019,Enero,República Dominicana,214,136,131,,267,"(3.541112,-76.384584)"
2019,Enero,República Dominicana,214,4660,4249,,8909,"(4.697144,-74.140516)"
2019,Enero,República Dominicana,214,43,34,,77,"(4.815061,-75.736532)"
2019,Enero,República Dominicana,214,381,313,,694,"(6.171601,-75.427454)"
2019,Enero,República Dominicana,214,31,28,,59,"(7.128456,-73.183637)"
2019,Enero,Reunión,638,0,1,,1,"(4.697144,-74.140516)"
2019,Enero,Rumania,642,3,5,,8,"(4.697144,-74.140516)"
2019,Enero,Sahara Occidental/Desierto Sahara,732,1,0,,1,"(4.697144,-74.140516)"
2019,Enero,San Cristóbal y Nevis,659,1,1,,2,"(4.697144,-74.140516)"
2019,Enero,San Marino,674,2,0,,2,"(3.541112,-76.384584)"
2019,Enero,San  Vicente y las Granadinas,670,0,1,,1,"(4.697144,-74.140516)"
2019,Enero,Santo Tomé y Príncipe,678,0,1,,1,"(4.697144,-74.140516)"
2019,Enero,Serbia,688,0,2,,2,"(4.697144,-74.140516)"
2019,Enero,Sierra Leona,694,1,0,,1,"(10.445761,-75.516429)"
2019,Enero,Singapur,702,0,1,,1,"(3.541112,-76.384584)"
2019,Enero,Singapur,702,20,51,,71,"(4.697144,-74.140516)"
2019,Enero,Singapur,702,2,4,,6,"(6.171601,-75.427454)"
2019,Enero,República Árabe Siria,760,2,0,,2,"(4.697144,-74.140516)"
2019,Enero,Sri Lanka,144,2,2,,4,"(4.697144,-74.140516)"
2019,Enero,Sudáfrica,710,1,1,,2,"(10.445761,-75.516429)"
2019,Enero,Sudáfrica,710,0,1,,1,"(3.541112,-76.384584)"
2019,Enero,Sudáfrica,710,14,15,,29,"(4.697144,-74.140516)"
2019,Enero,Sudáfrica,710,1,1,,2,"(6.171601,-75.427454)"
2019,Enero,Sudán,736,1,2,,3,"(4.697144,-74.140516)"
2019,Enero,Suecia,752,21,16,,37,"(10.445761,-75.516429)"
2019,Enero,Suecia,752,7,8,,15,"(10.886611,-74.776708)"
2019,Enero,Suecia,752,31,19,,50,"(3.541112,-76.384584)"
2019,Enero,Suecia,752,193,151,,344,"(4.697144,-74.140516)"
2019,Enero,Suecia,752,29,11,,40,"(6.171601,-75.427454)"
2019,Enero,Suecia,752,0,1,,1,"(7.128456,-73.183637)"
2019,Enero,Suiza,756,8,2,,10,"(10.445761,-75.516429)"
2019,Enero,Suiza,756,8,20,,28,"(10.886611,-74.776708)"
2019,Enero,Suiza,756,90,53,,143,"(3.541112,-76.384584)"
2019,Enero,Suiza,756,514,335,,849,"(4.697144,-74.140516)"
2019,Enero,Suiza,756,1,0,,1,"(4.815061,-75.736532)"
2019,Enero,Suiza,756,53,18,,71,"(6.171601,-75.427454)"
2019,Enero,Surinam,740,0,9,,9,"(10.408582,-75.538003)"
2019,Enero,Surinam,740,5,12,,17,"(4.697144,-74.140516)"
2019,Enero,Taiwán,158,1,0,,1,"(3.541112,-76.384584)"
2019,Enero,Taiwán,158,1,3,,4,"(4.697144,-74.140516)"
2019,Enero,Tailandia,764,1,0,,1,"(3.541112,-76.384584)"
2019,Enero,Tailandia,764,24,20,,44,"(4.697144,-74.140516)"
2019,Enero,Tanzania,834,1,0,,1,"(4.697144,-74.140516)"
2019,Enero,Togo,768,1,0,,1,"(3.541112,-76.384584)"
2019,Enero,Trinidad y Tobago,780,4,3,,7,"(10.445761,-75.516429)"
2019,Enero,Trinidad y Tobago,780,0,8,,8,"(10.886611,-74.776708)"
2019,Enero,Trinidad y Tobago,780,12,31,,43,"(3.541112,-76.384584)"
2019,Enero,Trinidad y Tobago,780,27,33,,60,"(4.697144,-74.140516)"
2019,Enero,Trinidad y Tobago,780,2,6,,8,"(4.815061,-75.736532)"
2019,Enero,Trinidad y Tobago,780,12,15,,27,"(6.171601,-75.427454)"
2019,Enero,Trinidad y Tobago,780,1,2,,3,"(7.128456,-73.183637)"
2019,Enero,Túnez,788,0,1,,1,"(3.541112,-76.384584)"
2019,Enero,Túnez,788,1,1,,2,"(4.697144,-74.140516)"
2019,Enero,Turquía,792,0,1,,1,"(10.886611,-74.776708)"
2019,Enero,Turquía,792,1,1,,2,"(3.541112,-76.384584)"
2019,Enero,Turquía,792,349,241,,590,"(4.697144,-74.140516)"
2019,Enero,Turquía,792,11,6,,17,"(6.171601,-75.427454)"
2019,Enero,Turkmenistán,795,0,2,,2,"(4.697144,-74.140516)"
2019,Enero,Ucrania,804,0,1,,1,"(3.541112,-76.384584)"
2019,Enero,Ucrania,804,2,4,,6,"(4.697144,-74.140516)"
2019,Enero,Uganda,800,0,1,,1,"(3.541112,-76.384584)"
2019,Enero,Uganda,800,0,1,,1,"(4.697144,-74.140516)"
2019,Enero,Uruguay,858,4,4,,8,"(10.445761,-75.516429)"
2019,Enero,Uruguay,858,1,0,,1,"(10.886611,-74.776708)"
2019,Enero,Uruguay,858,33,53,,86,"(3.541112,-76.384584)"
2019,Enero,Uruguay,858,354,421,,775,"(4.697144,-74.140516)"
2019,Enero,Uruguay,858,3,10,,13,"(4.815061,-75.736532)"
2019,Enero,Uruguay,858,18,28,,46,"(6.171601,-75.427454)"
2019,Enero,Venezuela,862,1,15,,16,"(10.408582,-75.538003)"
2019,Enero,Venezuela,862,19,12,,31,"(10.445761,-75.516429)"
2019,Enero,Venezuela,862,53,57,,110,"(10.886611,-74.776708)"
2019,Enero,Venezuela,862,2112,1992,,4104,"(11.360009,-72.129330)"
2019,Enero,Venezuela,862,724,604,,1329,"(3.541112,-76.384584)"
2019,Enero,Venezuela,862,4,5,,9,"(3.866713,-67.927521)"
2019,Enero,Venezuela,862,2241,1995,,4236,"(4.697144,-74.140516)"
2019,Enero,Venezuela,862,10,5,,15,"(4.815061,-75.736532)"
2019,Enero,Venezuela,862,0,1,,1,"(6.17134,-75.427194)"
2019,Enero,Venezuela,862,1554,1293,,2848,"(6.171601,-75.427454)"
2019,Enero,Venezuela,862,38,51,,89,"(6.185799,-67.483929)"
2019,Enero,Venezuela,862,434,446,,880,"(7.088729,-70.740253)"
2019,Enero,Venezuela,862,4,5,,9,"(7.128456,-73.183637)"
2019,Enero,Venezuela,862,1220,1443,,2663,"(7.818934,-72.453226)"
2019,Enero,Venezuela,862,1,0,,1,"(7.927209,-72.507910)"
2019,Enero,Venezuela,862,241,281,,522,"(8.36068,-72.409396)"
2019,Enero,Vietnam,704,3,5,,8,"(4.697144,-74.140516)"
2019,Enero,Islas Vírgenes Británicas/Territorio Británico de Ultramar,92,1,0,,1,"(10.886611,-74.776708)"
2019,Enero,Islas Vírgenes Británicas/Territorio Británico de Ultramar,92,0,1,,1,"(4.815061,-75.736532)"
2019,Enero,Islas Vírgenes Británicas/Territorio Británico de Ultramar,92,0,7,,7,"(6.171601,-75.427454)"
2019,Enero,Islas Turcas y Caicos/Territorio Británico de Ultramar,796,1,4,,5,"(10.886611,-74.776708)"
2019,Febrero,Afganistán,4,0,1,,1,"(4.697144,-74.140516)"
2019,Febrero,Albania,8,0,2,,2,"(4.697144,-74.140516)"
2019,Febrero,Alemania,276,1,0,,1,"(0.814836,-77.662532)"
2019,Febrero,Alemania,276,10,9,,19,"(10.445761,-75.516429)"
2019,Febrero,Alemania,276,5,0,,5,"(10.886611,-74.776708)"
2019,Febrero,Alemania,276,60,37,,97,"(3.541112,-76.384584)"
2019,Febrero,Alemania,276,1486,1405,,2891,"(4.697144,-74.140516)"
2019,Febrero,Alemania,276,0,1,,1,"(4.815061,-75.736532)"
2019,Febrero,Alemania,276,67,48,,115,"(6.171601,-75.427454)"
2019,Febrero,Alemania,276,0,1,,1,"(7.128456,-73.183637)"
2019,Febrero,Andorra,20,1,1,,2,"(4.697144,-74.140516)"
2019,Febrero,Andorra,20,2,2,,4,"(6.171601,-75.427454)"
2019,Febrero,Angola,24,0,1,,1,"(4.697144,-74.140516)"
2019,Febrero,Angola,24,0,1,,1,"(6.171601,-75.427454)"
2019,Febrero,Antigua y Barbuda,28,12,1,,13,"(4.697144,-74.140516)"
2019,Febrero,Antigua y Barbuda,28,0,2,,2,"(6.171601,-75.427454)"
2019,Febrero,Países Bajos,528,1,0,,1,"(10.408582,-75.538003)"
2019,Febrero,Países Bajos,528,75,64,,139,"(10.445761,-75.516429)"
2019,Febrero,Países Bajos,528,4,7,,11,"(10.886611,-74.776708)"
2019,Febrero,Países Bajos,528,50,25,,75,"(3.541112,-76.384584)"
2019,Febrero,Países Bajos,528,1018,833,,1851,"(4.697144,-74.140516)"
2019,Febrero,Países Bajos,528,3,2,,5,"(4.815061,-75.736532)"
2019,Febrero,Países Bajos,528,51,41,,92,"(6.171601,-75.427454)"
2019,Febrero,Arabia Saudita,682,1,1,,2,"(3.541112,-76.384584)"
2019,Febrero,Arabia Saudita,682,5,20,,25,"(4.697144,-74.140516)"
2019,Febrero,Arabia Saudita,682,1,0,,1,"(4.815061,-75.736532)"
2019,Febrero,Arabia Saudita,682,2,1,,3,"(6.171601,-75.427454)"
2019,Febrero,Argelia,12,1,0,,1,"(3.541112,-76.384584)"
2019,Febrero,Argelia,12,2,5,,7,"(4.697144,-74.140516)"
2019,Febrero,Argelia,12,1,0,,1,"(6.171601,-75.427454)"
2019,Febrero,Argentina,32,0,5,,5,"(0.25129,-76.875963)"
2019,Febrero,Argentina,32,0,1,,1,"(0.812436,-77.847006)"
2019,Febrero,Argentina,32,4,9,,13,"(0.814836,-77.662532)"
2019,Febrero,Argentina,32,53,26,,79,"(10.445761,-75.516429)"
2019,Febrero,Argentina,32,50,36,,86,"(10.886611,-74.776708)"
2019,Febrero,Argentina,32,262,207,,469,"(3.541112,-76.384584)"
2019,Febrero,Argentina,32,2621,2375,,4996,"(4.697144,-74.140516)"
2019,Febrero,Argentina,32,21,19,,40,"(4.815061,-75.736532)"
2019,Febrero,Argentina,32,257,206,,463,"(6.171601,-75.427454)"
2019,Febrero,Argentina,32,7,7,,14,"(7.128456,-73.183637)"
2019,Febrero,Aruba,533,821,580,,1401,"(10.408582,-75.538003)"
2019,Febrero,Aruba,533,1,0,,1,"(10.445761,-75.516429)"
2019,Febrero,Aruba,533,18,15,,33,"(10.886611,-74.776708)"
2019,Febrero,Aruba,533,49,25,,74,"(3.541112,-76.384584)"
2019,Febrero,Aruba,533,1298,1043,,2341,"(4.697144,-74.140516)"
2019,Febrero,Aruba,533,4,4,,8,"(4.815061,-75.736532)"
2019,Febrero,Aruba,533,24,18,,42,"(6.171601,-75.427454)"
2019,Febrero,Aruba,533,7,30,,37,"(7.128456,-73.183637)"
2019,Febrero,Australia,36,4,4,,8,"(10.445761,-75.516429)"
2019,Febrero,Australia,36,1,2,,3,"(10.886611,-74.776708)"
2019,Febrero,Australia,36,28,25,,53,"(3.541112,-76.384584)"
2019,Febrero,Australia,36,529,449,,978,"(4.697144,-74.140516)"
2019,Febrero,Australia,36,2,0,,2,"(4.815061,-75.736532)"
2019,Febrero,Australia,36,62,49,,111,"(6.171601,-75.427454)"
2019,Febrero,Australia,36,0,1,,1,"(7.128456,-73.183637)"
2019,Febrero,Austria,40,1,1,,2,"(10.886611,-74.776708)"
2019,Febrero,Austria,40,2,2,,4,"(3.541112,-76.384584)"
2019,Febrero,Austria,40,42,30,,72,"(4.697144,-74.140516)"
2019,Febrero,Austria,40,0,2,,2,"(4.815061,-75.736532)"
2019,Febrero,Austria,40,5,4,,9,"(6.171601,-75.427454)"
2019,Febrero,Azerbaiyán,31,0,1,,1,"(4.697144,-74.140516)"
2019,Febrero,Bahamas,44,1,1,,2,"(10.445761,-75.516429)"
2019,Febrero,Bahamas,44,1,10,,11,"(10.886611,-74.776708)"
2019,Febrero,Bahamas,44,18,10,,28,"(3.541112,-76.384584)"
2019,Febrero,Bahamas,44,11,15,,26,"(4.697144,-74.140516)"
2019,Febrero,Bahamas,44,2,0,,2,"(4.815061,-75.736532)"
2019,Febrero,Bahamas,44,21,3,,24,"(6.171601,-75.427454)"
2019,Febrero,Bahréin,48,0,1,,1,"(10.886611,-74.776708)"
2019,Febrero,Bahréin,48,3,1,,4,"(4.697144,-74.140516)"
2019,Febrero,Bangladesh,50,0,2,,2,"(4.697144,-74.140516)"
2019,Febrero,Barbados,52,2,1,,3,"(10.886611,-74.776708)"
2019,Febrero,Barbados,52,2,1,,3,"(3.541112,-76.384584)"
2019,Febrero,Barbados,52,3,5,,8,"(4.697144,-74.140516)"
2019,Febrero,Barbados,52,3,3,,6,"(6.171601,-75.427454)"
2019,Febrero,Barbados,52,1,0,,1,"(7.128456,-73.183637)"
2019,Febrero,República de Belarús,112,0,1,,1,"(11.360009,-72.129330)"
2019,Febrero,República de Belarús,112,0,1,,1,"(4.697144,-74.140516)"
2019,Febrero,Bélgica,56,1,1,,2,"(10.445761,-75.516429)"
2019,Febrero,Bélgica,56,1,0,,1,"(10.886611,-74.776708)"
2019,Febrero,Bélgica,56,19,9,,28,"(3.541112,-76.384584)"
2019,Febrero,Bélgica,56,95,52,,147,"(4.697144,-74.140516)"
2019,Febrero,Bélgica,56,11,15,,26,"(6.171601,-75.427454)"
2019,Febrero,Belice,84,3,3,,6,"(3.541112,-76.384584)"
2019,Febrero,Belice,84,5,6,,11,"(4.697144,-74.140516)"
2019,Febrero,Belice,84,0,2,,2,"(4.815061,-75.736532)"
2019,Febrero,Belice,84,2,2,,4,"(6.171601,-75.427454)"
2019,Febrero,Bermudas/Territorio Británico de Ultramar,60,1,0,,1,"(10.886611,-74.776708)"
2019,Febrero,Bermudas/Territorio Británico de Ultramar,60,2,1,,3,"(6.171601,-75.427454)"
2019,Febrero,Bolivia,68,1,6,,7,"(0.814836,-77.662532)"
2019,Febrero,Bolivia,68,2,2,,4,"(10.445761,-75.516429)"
2019,Febrero,Bolivia,68,0,1,,1,"(10.886611,-74.776708)"
2019,Febrero,Bolivia,68,29,37,,66,"(3.541112,-76.384584)"
2019,Febrero,Bolivia,68,452,763,,1215,"(4.697144,-74.140516)"
2019,Febrero,Bolivia,68,2,2,,4,"(4.815061,-75.736532)"
2019,Febrero,Bolivia,68,24,35,,59,"(6.171601,-75.427454)"
2019,Febrero,Bolivia,68,1,0,,1,"(7.128456,-73.183637)"
2019,Febrero,Brasil,76,169,314,,483,"(-4.197703,-69.941278)"
2019,Febrero,Brasil,76,25,39,,64,"(-4.223468,-69.945098)"
2019,Febrero,Brasil,76,16,10,,26,"(10.445761,-75.516429)"
2019,Febrero,Brasil,76,14,11,,25,"(10.886611,-74.776708)"
2019,Febrero,Brasil,76,5,4,,9,"(12.586067,-81.702563)"
2019,Febrero,Brasil,76,220,349,,569,"(3.541112,-76.384584)"
2019,Febrero,Brasil,76,1,4,,5,"(3.866713,-67.927521)"
2019,Febrero,Brasil,76,2983,3866,,6849,"(4.697144,-74.140516)"
2019,Febrero,Brasil,76,34,70,,104,"(4.815061,-75.736532)"
2019,Febrero,Brasil,76,196,285,,481,"(6.171601,-75.427454)"
2019,Febrero,Brasil,76,4,4,,8,"(7.128456,-73.183637)"
2019,Febrero,Bulgaria,100,1,0,,1,"(3.541112,-76.384584)"
2019,Febrero,Bulgaria,100,1,3,,4,"(4.697144,-74.140516)"
2019,Febrero,Islas Caimán/Territorio Británico de Ultramar,136,3,0,,3,"(10.445761,-75.516429)"
2019,Febrero,Islas Caimán/Territorio Británico de Ultramar,136,1,0,,1,"(10.886611,-74.776708)"
2019,Febrero,Islas Caimán/Territorio Británico de Ultramar,136,2,1,,3,"(12.586067,-81.702563)"
2019,Febrero,Islas Caimán/Territorio Británico de Ultramar,136,2,1,,3,"(4.697144,-74.140516)"
2019,Febrero,Islas Caimán/Territorio Británico de Ultramar,136,1,0,,1,"(6.171601,-75.427454)"
2019,Febrero,Camboya,116,1,1,,2,"(4.697144,-74.140516)"
2019,Febrero,Camerún,120,1,0,,1,"(4.697144,-74.140516)"
2019,Febrero,Canadá,124,171,120,,291,"(10.445761,-75.516429)"
2019,Febrero,Canadá,124,30,22,,52,"(10.886611,-74.776708)"
2019,Febrero,Canadá,124,6,4,,10,"(12.586067,-81.702563)"
2019,Febrero,Canadá,124,176,119,,295,"(3.541112,-76.384584)"
2019,Febrero,Canadá,124,1,2,,3,"(4.452882,-75.766298)"
2019,Febrero,Canadá,124,1827,1562,,3389,"(4.697144,-74.140516)"
2019,Febrero,Canadá,124,29,16,,45,"(4.815061,-75.736532)"
2019,Febrero,Canadá,124,222,179,,401,"(6.171601,-75.427454)"
2019,Febrero,Canadá,124,4,4,,8,"(7.128456,-73.183637)"
2019,Febrero,Chad,148,1,0,,1,"(4.697144,-74.140516)"
2019,Febrero,España,724,7,16,,23,"(10.445761,-75.516429)"
2019,Febrero,España,724,18,7,,25,"(10.886611,-74.776708)"
2019,Febrero,España,724,2480,1710,,4190,"(3.541112,-76.384584)"
2019,Febrero,España,724,12161,9635,,21796,"(4.697144,-74.140516)"
2019,Febrero,España,724,7,4,,11,"(4.815061,-75.736532)"
2019,Febrero,España,724,1854,1397,,3251,"(6.171601,-75.427454)"
2019,Febrero,Colombia,170,3,9,,12,"(10.445761,-75.516429)"
2019,Febrero,Colombia,170,245,701,,946,"(4.697144,-74.140516)"
2019,Febrero,República Democrática del Congo,180,1,0,,1,"(3.541112,-76.384584)"
2019,Febrero,República Democrática del Congo,180,0,1,,1,"(4.697144,-74.140516)"
2019,Febrero,República de Corea,410,3,2,,5,"(10.445761,-75.516429)"
2019,Febrero,República de Corea,410,0,2,,2,"(3.541112,-76.384584)"
2019,Febrero,República de Corea,410,29,21,,50,"(4.697144,-74.140516)"
2019,Febrero,República de Corea,410,2,1,,3,"(6.171601,-75.427454)"
2019,Febrero,Costa de Marfil,384,1,0,,1,"(3.541112,-76.384584)"
2019,Febrero,Costa de Marfil,384,2,4,,6,"(4.697144,-74.140516)"
2019,Febrero,Costa de Marfil,384,0,2,,2,"(6.171601,-75.427454)"
2019,Febrero,Costa Rica,188,17,13,,30,"(10.445761,-75.516429)"
2019,Febrero,Costa Rica,188,26,32,,58,"(10.886611,-74.776708)"
2019,Febrero,Costa Rica,188,1,9,,10,"(12.5744111,-81.703935)"
2019,Febrero,Costa Rica,188,2,1,,3,"(12.586067,-81.702563)"
2019,Febrero,Costa Rica,188,74,78,,152,"(3.541112,-76.384584)"
2019,Febrero,Costa Rica,188,887,1089,,1976,"(4.697144,-74.140516)"
2019,Febrero,Costa Rica,188,21,14,,35,"(4.815061,-75.736532)"
2019,Febrero,Costa Rica,188,0,3,,3,"(6.17134,-75.427194)"
2019,Febrero,Costa Rica,188,136,119,,255,"(6.171601,-75.427454)"
2019,Febrero,Costa Rica,188,3,4,,7,"(7.128456,-73.183637)"
2019,Febrero,Costa Rica,188,1,0,,1,"(8.635765,-77.346578)"
2019,Febrero,Croacia,191,5,1,,6,"(4.697144,-74.140516)"
2019,Febrero,Cuba,192,9,6,,15,"(10.445761,-75.516429)"
2019,Febrero,Cuba,192,16,11,,27,"(10.886611,-74.776708)"
2019,Febrero,Cuba,192,1,0,,1,"(12.586067,-81.702563)"
2019,Febrero,Cuba,192,84,67,,151,"(3.541112,-76.384584)"
2019,Febrero,Cuba,192,911,818,,1729,"(4.697144,-74.140516)"
2019,Febrero,Cuba,192,19,13,,32,"(4.815061,-75.736532)"
2019,Febrero,Cuba,192,79,60,,139,"(6.171601,-75.427454)"
2019,Febrero,Cuba,192,6,7,,13,"(7.128456,-73.183637)"
2019,Febrero,Curazao,99999,8,7,,15,"(10.445761,-75.516429)"
2019,Febrero,Curazao,99999,4,2,,6,"(10.886611,-74.776708)"
2019,Febrero,Curazao,99999,5,2,,7,"(3.541112,-76.384584)"
2019,Febrero,Curazao,99999,500,384,,884,"(4.697144,-74.140516)"
2019,Febrero,Curazao,99999,1,0,,1,"(4.815061,-75.736532)"
2019,Febrero,Curazao,99999,9,4,,13,"(6.171601,-75.427454)"
2019,Febrero,República Checa,203,1,1,,2,"(3.541112,-76.384584)"
2019,Febrero,República Checa,203,16,17,,33,"(4.697144,-74.140516)"
2019,Febrero,Chile,152,3,0,,3,"(0.25129,-76.875963)"
2019,Febrero,Chile,152,117,77,,194,"(0.814836,-77.662532)"
2019,Febrero,Chile,152,3,2,,5,"(1.813928,-78.763924)"
2019,Febrero,Chile,152,25,21,,46,"(10.445761,-75.516429)"
2019,Febrero,Chile,152,32,29,,61,"(10.886611,-74.776708)"
2019,Febrero,Chile,152,0,1,,1,"(12.586067,-81.702563)"
2019,Febrero,Chile,152,920,535,,1455,"(3.541112,-76.384584)"
2019,Febrero,Chile,152,4299,3335,,7634,"(4.697144,-74.140516)"
2019,Febrero,Chile,152,44,27,,71,"(4.815061,-75.736532)"
2019,Febrero,Chile,152,249,168,,417,"(6.171601,-75.427454)"
2019,Febrero,Chile,152,2,2,,4,"(7.128456,-73.183637)"
2019,Febrero,Chile,152,1,0,,1,"(7.927209,-72.507910)"
2019,Febrero,China,156,3,8,,11,"(10.445761,-75.516429)"
2019,Febrero,China,156,2,1,,3,"(10.886611,-74.776708)"
2019,Febrero,China,156,11,27,,38,"(3.541112,-76.384584)"
2019,Febrero,China,156,167,382,,549,"(4.697144,-74.140516)"
2019,Febrero,China,156,3,3,,6,"(4.815061,-75.736532)"
2019,Febrero,China,156,25,48,,73,"(6.171601,-75.427454)"
2019,Febrero,Chipre,196,1,4,,5,"(3.541112,-76.384584)"
2019,Febrero,Chipre,196,0,2,,2,"(4.697144,-74.140516)"
2019,Febrero,Dinamarca,208,1,1,,2,"(10.445761,-75.516429)"
2019,Febrero,Dinamarca,208,2,0,,2,"(3.541112,-76.384584)"
2019,Febrero,Dinamarca,208,19,20,,39,"(4.697144,-74.140516)"
2019,Febrero,Dinamarca,208,1,1,,2,"(6.171601,-75.427454)"
2019,Febrero,Ecuador,218,3,2,,5,"(-0.193180,-74.784874)"
2019,Febrero,Ecuador,218,654,975,,1629,"(0.25129,-76.875963)"
2019,Febrero,Ecuador,218,21,34,,55,"(0.812436,-77.847006)"
2019,Febrero,Ecuador,218,6036,7089,,13125,"(0.814836,-77.662532)"
2019,Febrero,Ecuador,218,143,175,,318,"(1.813928,-78.763924)"
2019,Febrero,Ecuador,218,0,12,,12,"(10.408582,-75.538003)"
2019,Febrero,Ecuador,218,3,4,,7,"(10.445761,-75.516429)"
2019,Febrero,Ecuador,218,7,8,,15,"(10.886611,-74.776708)"
2019,Febrero,Ecuador,218,248,374,,622,"(3.541112,-76.384584)"
2019,Febrero,Ecuador,218,2331,3632,,5963,"(4.697144,-74.140516)"
2019,Febrero,Ecuador,218,9,4,,13,"(4.815061,-75.736532)"
2019,Febrero,Ecuador,218,33,80,,113,"(6.171601,-75.427454)"
2019,Febrero,Ecuador,218,0,3,,3,"(7.128456,-73.183637)"
2019,Febrero,Ecuador,218,1,6,,7,"(7.927209,-72.507910)"
2019,Febrero,Egipto,818,1,2,,3,"(3.541112,-76.384584)"
2019,Febrero,Egipto,818,13,14,,27,"(4.697144,-74.140516)"
2019,Febrero,Egipto,818,0,4,,4,"(6.171601,-75.427454)"
2019,Febrero,El Salvador,222,12,23,,35,"(10.445761,-75.516429)"
2019,Febrero,El Salvador,222,2,1,,3,"(10.886611,-74.776708)"
2019,Febrero,El Salvador,222,87,94,,181,"(3.541112,-76.384584)"
2019,Febrero,El Salvador,222,610,865,,1475,"(4.697144,-74.140516)"
2019,Febrero,El Salvador,222,0,1,,1,"(4.815061,-75.736532)"
2019,Febrero,El Salvador,222,5,17,,22,"(6.171601,-75.427454)"
2019,Febrero,Emiratos Árabes,784,3,1,,4,"(3.541112,-76.384584)"
2019,Febrero,Emiratos Árabes,784,68,183,,251,"(4.697144,-74.140516)"
2019,Febrero,Emiratos Árabes,784,8,7,,15,"(6.171601,-75.427454)"
2019,Febrero,Eslovaquia,703,1,1,,2,"(4.697144,-74.140516)"
2019,Febrero,Eslovenia,705,1,0,,1,"(3.541112,-76.384584)"
2019,Febrero,Eslovenia,705,1,1,,2,"(4.697144,-74.140516)"
2019,Febrero,Estados Unidos de América,840,2576,2054,,4630,"(10.445761,-75.516429)"
2019,Febrero,Estados Unidos de América,840,2420,1880,,4300,"(10.886611,-74.776708)"
2019,Febrero,Estados Unidos de América,840,120,111,,231,"(11.117806,-74.232622)"
2019,Febrero,Estados Unidos de América,840,37,28,,65,"(12.586067,-81.702563)"
2019,Febrero,Estados Unidos de América,840,0,1,,1,"(13.3387613,-81.372937)"
2019,Febrero,Estados Unidos de América,840,5228,3992,,9220,"(3.541112,-76.384584)"
2019,Febrero,Estados Unidos de América,840,541,439,,980,"(4.452882,-75.766298)"
2019,Febrero,Estados Unidos de América,840,26593,24378,,50972,"(4.697144,-74.140516)"
2019,Febrero,Estados Unidos de América,840,1136,833,,1969,"(4.815061,-75.736532)"
2019,Febrero,Estados Unidos de América,840,7909,6270,,14179,"(6.171601,-75.427454)"
2019,Febrero,Estados Unidos de América,840,156,116,,272,"(7.128456,-73.183637)"
2019,Febrero,Estados Unidos de América,840,1,15,,16,"(7.927209,-72.507910)"
2019,Febrero,Estonia,233,0,3,,3,"(4.697144,-74.140516)"
2019,Febrero,Etiopia,231,0,2,,2,"(4.697144,-74.140516)"
2019,Febrero,Etiopia,231,2,0,,2,"(6.171601,-75.427454)"
2019,Febrero,Filipinas,608,4,4,,8,"(4.697144,-74.140516)"
2019,Febrero,Filipinas,608,1,0,,1,"(6.171601,-75.427454)"
2019,Febrero,Finlandia,246,1,0,,1,"(10.445761,-75.516429)"
2019,Febrero,Finlandia,246,12,8,,20,"(4.697144,-74.140516)"
2019,Febrero,Finlandia,246,1,1,,2,"(6.171601,-75.427454)"
2019,Febrero,Francia,250,7,6,,13,"(10.445761,-75.516429)"
2019,Febrero,Francia,250,6,1,,7,"(10.886611,-74.776708)"
2019,Febrero,Francia,250,53,45,,98,"(3.541112,-76.384584)"
2019,Febrero,Francia,250,1080,951,,2031,"(4.697144,-74.140516)"
2019,Febrero,Francia,250,5,3,,8,"(4.815061,-75.736532)"
2019,Febrero,Francia,250,89,59,,148,"(6.171601,-75.427454)"
2019,Febrero,Francia,250,0,1,,1,"(7.128456,-73.183637)"
2019,Febrero,Gabón,266,0,2,,2,"(4.697144,-74.140516)"
2019,Febrero,Ghana,288,1,5,,6,"(4.697144,-74.140516)"
2019,Febrero,Gibraltar/Territorio Británico de Ultramar,292,1,0,,1,"(0.814836,-77.662532)"
2019,Febrero,Granada,308,0,1,,1,"(4.697144,-74.140516)"
2019,Febrero,Grecia,300,1,0,,1,"(10.886611,-74.776708)"
2019,Febrero,Grecia,300,1,0,,1,"(3.541112,-76.384584)"
2019,Febrero,Grecia,300,11,5,,16,"(4.697144,-74.140516)"
2019,Febrero,Grecia,300,1,0,,1,"(6.171601,-75.427454)"
2019,Febrero,Guatemala,320,5,8,,13,"(10.445761,-75.516429)"
2019,Febrero,Guatemala,320,3,12,,15,"(10.886611,-74.776708)"
2019,Febrero,Guatemala,320,2,1,,3,"(12.586067,-81.702563)"
2019,Febrero,Guatemala,320,49,71,,120,"(3.541112,-76.384584)"
2019,Febrero,Guatemala,320,504,645,,1149,"(4.697144,-74.140516)"
2019,Febrero,Guatemala,320,13,13,,26,"(4.815061,-75.736532)"
2019,Febrero,Guatemala,320,57,99,,156,"(6.171601,-75.427454)"
2019,Febrero,Guatemala,320,1,7,,8,"(7.128456,-73.183637)"
2019,Febrero,Guyana,328,0,2,,2,"(10.445761,-75.516429)"
2019,Febrero,Guyana,328,2,4,,6,"(10.886611,-74.776708)"
2019,Febrero,Guyana,328,4,6,,10,"(4.697144,-74.140516)"
2019,Febrero,Guyana,328,0,2,,2,"(4.815061,-75.736532)"
2019,Febrero,Guyana,328,0,3,,3,"(6.171601,-75.427454)"
2019,Febrero,Guinea Ecuatorial,226,0,1,,1,"(4.697144,-74.140516)"
2019,Febrero,Guadalupe/Territorio Francés,312,1,0,,1,"(3.541112,-76.384584)"
2019,Febrero,Guayana Francesa/Departamento de Ultramar Francés,254,1,0,,1,"(4.697144,-74.140516)"
2019,Febrero,Haití,332,0,1,,1,"(10.408582,-75.538003)"
2019,Febrero,Haití,332,0,1,,1,"(10.445761,-75.516429)"
2019,Febrero,Haití,332,0,3,,3,"(10.886611,-74.776708)"
2019,Febrero,Haití,332,1,4,,5,"(4.697144,-74.140516)"
2019,Febrero,Haití,332,3,2,,5,"(6.171601,-75.427454)"
2019,Febrero,Honduras,340,0,19,,19,"(10.408582,-75.538003)"
2019,Febrero,Honduras,340,2,3,,5,"(10.445761,-75.516429)"
2019,Febrero,Honduras,340,7,16,,23,"(10.886611,-74.776708)"
2019,Febrero,Honduras,340,1,1,,2,"(12.5744111,-81.703935)"
2019,Febrero,Honduras,340,1,0,,1,"(12.586067,-81.702563)"
2019,Febrero,Honduras,340,17,33,,50,"(3.541112,-76.384584)"
2019,Febrero,Honduras,340,85,150,,235,"(4.697144,-74.140516)"
2019,Febrero,Honduras,340,9,5,,14,"(4.815061,-75.736532)"
2019,Febrero,Honduras,340,16,64,,80,"(6.171601,-75.427454)"
2019,Febrero,Honduras,340,1,3,,4,"(7.128456,-73.183637)"
2019,Febrero,Hong Kong,344,1,1,,2,"(3.541112,-76.384584)"
2019,Febrero,Hong Kong,344,25,49,,74,"(4.697144,-74.140516)"
2019,Febrero,Hong Kong,344,6,2,,8,"(6.171601,-75.427454)"
2019,Febrero,Hungría,348,9,4,,13,"(4.697144,-74.140516)"
2019,Febrero,Hungría,348,1,1,,2,"(6.171601,-75.427454)"
2019,Febrero,India,356,1,0,,1,"(10.445761,-75.516429)"
2019,Febrero,India,356,1,2,,3,"(3.541112,-76.384584)"
2019,Febrero,India,356,57,53,,110,"(4.697144,-74.140516)"
2019,Febrero,India,356,7,5,,12,"(6.171601,-75.427454)"
2019,Febrero,Indonesia,360,3,3,,6,"(4.697144,-74.140516)"
2019,Febrero,Iraq,368,1,5,,6,"(4.697144,-74.140516)"
2019,Febrero,Irán,364,1,1,,2,"(4.697144,-74.140516)"
2019,Febrero,República de Irlanda,372,0,1,,1,"(10.445761,-75.516429)"
2019,Febrero,República de Irlanda,372,1,0,,1,"(3.541112,-76.384584)"
2019,Febrero,República de Irlanda,372,14,5,,19,"(4.697144,-74.140516)"
2019,Febrero,Islandia,352,0,1,,1,"(3.541112,-76.384584)"
2019,Febrero,Islandia,352,4,1,,5,"(4.697144,-74.140516)"
2019,Febrero,Israel,376,0,1,,1,"(10.445761,-75.516429)"
2019,Febrero,Israel,376,5,5,,10,"(3.541112,-76.384584)"
2019,Febrero,Israel,376,105,58,,163,"(4.697144,-74.140516)"
2019,Febrero,Israel,376,2,0,,2,"(4.815061,-75.736532)"
2019,Febrero,Israel,376,13,7,,20,"(6.171601,-75.427454)"
2019,Febrero,Italia,380,16,2,,18,"(10.445761,-75.516429)"
2019,Febrero,Italia,380,6,2,,8,"(10.886611,-74.776708)"
2019,Febrero,Italia,380,160,57,,217,"(3.541112,-76.384584)"
2019,Febrero,Italia,380,652,436,,1088,"(4.697144,-74.140516)"
2019,Febrero,Italia,380,1,0,,1,"(4.815061,-75.736532)"
2019,Febrero,Italia,380,126,65,,191,"(6.171601,-75.427454)"
2019,Febrero,Italia,380,0,1,,1,"(7.128456,-73.183637)"
2019,Febrero,Jamaica,388,650,477,,1127,"(10.408582,-75.538003)"
2019,Febrero,Jamaica,388,2,5,,7,"(10.445761,-75.516429)"
2019,Febrero,Jamaica,388,2,0,,2,"(10.886611,-74.776708)"
2019,Febrero,Jamaica,388,1,0,,1,"(10.971302,-74.765397)"
2019,Febrero,Jamaica,388,0,1,,1,"(11.117806,-74.232622)"
2019,Febrero,Jamaica,388,4,2,,6,"(11.247723,-74.213989)"
2019,Febrero,Jamaica,388,2,2,,4,"(12.586067,-81.702563)"
2019,Febrero,Jamaica,388,1,2,,3,"(3.541112,-76.384584)"
2019,Febrero,Jamaica,388,15,20,,35,"(4.697144,-74.140516)"
2019,Febrero,Jamaica,388,2,2,,4,"(4.815061,-75.736532)"
2019,Febrero,Jamaica,388,7,4,,11,"(6.171601,-75.427454)"
2019,Febrero,Jamaica,388,1,0,,1,"(7.128456,-73.183637)"
2019,Febrero,Japón,392,2,2,,4,"(3.541112,-76.384584)"
2019,Febrero,Japón,392,51,35,,86,"(4.697144,-74.140516)"
2019,Febrero,Japón,392,12,4,,16,"(6.171601,-75.427454)"
2019,Febrero,Jordania,400,2,1,,3,"(4.697144,-74.140516)"
2019,Febrero,Jordania,400,0,2,,2,"(6.171601,-75.427454)"
2019,Febrero,Kazajistán,398,1,4,,5,"(4.697144,-74.140516)"
2019,Febrero,Kenia,404,3,2,,5,"(4.697144,-74.140516)"
2019,Febrero,Kuwait,414,0,1,,1,"(3.541112,-76.384584)"
2019,Febrero,Kuwait,414,2,2,,4,"(4.697144,-74.140516)"
2019,Febrero,Kuwait,414,0,1,,1,"(6.171601,-75.427454)"
2019,Febrero,República Democrática Popular  Lao,418,0,1,,1,"(4.697144,-74.140516)"
2019,Febrero,Letonia,428,1,1,,2,"(4.697144,-74.140516)"
2019,Febrero,Lituania,440,0,1,,1,"(3.541112,-76.384584)"
2019,Febrero,Líbano,422,4,10,,14,"(4.697144,-74.140516)"
2019,Febrero,Líbano,422,0,1,,1,"(7.128456,-73.183637)"
2019,Febrero,Liberia,430,0,1,,1,"(4.697144,-74.140516)"
2019,Febrero,Luxemburgo,442,0,1,,1,"(3.541112,-76.384584)"
2019,Febrero,Luxemburgo,442,4,6,,10,"(4.697144,-74.140516)"
2019,Febrero,Macao,446,1,1,,2,"(4.697144,-74.140516)"
2019,Febrero,Macedonia,807,1,0,,1,"(4.697144,-74.140516)"
2019,Febrero,Malasia,458,0,1,,1,"(3.541112,-76.384584)"
2019,Febrero,Malasia,458,3,3,,6,"(4.697144,-74.140516)"
2019,Febrero,Malasia,458,1,1,,2,"(6.171601,-75.427454)"
2019,Febrero,Malta,470,1,1,,2,"(10.445761,-75.516429)"
2019,Febrero,Malta,470,0,1,,1,"(10.886611,-74.776708)"
2019,Febrero,Malta,470,2,0,,2,"(3.541112,-76.384584)"
2019,Febrero,Malta,470,46,33,,79,"(4.697144,-74.140516)"
2019,Febrero,Malta,470,1,0,,1,"(4.815061,-75.736532)"
2019,Febrero,Malta,470,3,5,,8,"(6.171601,-75.427454)"
2019,Febrero,Malta,470,0,1,,1,"(7.128456,-73.183637)"
2019,Febrero,Marruecos,504,1,2,,3,"(10.886611,-74.776708)"
2019,Febrero,Marruecos,504,10,0,,10,"(4.697144,-74.140516)"
2019,Febrero,Mauritania,478,1,0,,1,"(4.697144,-74.140516)"
2019,Febrero,Mauritania,478,0,1,,1,"(7.927209,-72.507910)"
2019,Febrero,Martinica/Departamento de Ultramar Francés,474,0,1,,1,"(4.697144,-74.140516)"
2019,Febrero,Martinica/Departamento de Ultramar Francés,474,0,1,,1,"(7.927209,-72.507910)"
2019,Febrero,México,484,45,30,,75,"(10.445761,-75.516429)"
2019,Febrero,México,484,102,97,,199,"(10.886611,-74.776708)"
2019,Febrero,México,484,0,7,,7,"(11.247723,-74.213989)"
2019,Febrero,México,484,2,1,,3,"(12.586067,-81.702563)"
2019,Febrero,México,484,868,719,,1587,"(3.541112,-76.384584)"
2019,Febrero,México,484,11907,11235,,23142,"(4.697144,-74.140516)"
2019,Febrero,México,484,135,111,,246,"(4.815061,-75.736532)"
2019,Febrero,México,484,1806,1400,,3206,"(6.171601,-75.427454)"
2019,Febrero,México,484,67,65,,132,"(7.128456,-73.183637)"
2019,Febrero,Mónaco,492,1,0,,1,"(4.697144,-74.140516)"
2019,Febrero,Nepal,524,2,1,,3,"(4.697144,-74.140516)"
2019,Febrero,Nicaragua,558,0,10,,10,"(10.408582,-75.538003)"
2019,Febrero,Nicaragua,558,3,3,,6,"(10.445761,-75.516429)"
2019,Febrero,Nicaragua,558,8,8,,16,"(10.886611,-74.776708)"
2019,Febrero,Nicaragua,558,0,1,,1,"(12.5744111,-81.703935)"
2019,Febrero,Nicaragua,558,6,22,,28,"(3.541112,-76.384584)"
2019,Febrero,Nicaragua,558,27,52,,79,"(4.697144,-74.140516)"
2019,Febrero,Nicaragua,558,3,2,,5,"(4.815061,-75.736532)"
2019,Febrero,Nicaragua,558,12,43,,55,"(6.171601,-75.427454)"
2019,Febrero,Nicaragua,558,0,2,,2,"(7.128456,-73.183637)"
2019,Febrero,Nigeria,566,1,0,,1,"(3.541112,-76.384584)"
2019,Febrero,Nigeria,566,1,3,,4,"(4.697144,-74.140516)"
2019,Febrero,Níger,562,0,1,,1,"(4.697144,-74.140516)"
2019,Febrero,Noruega,578,0,2,,2,"(10.408582,-75.538003)"
2019,Febrero,Noruega,578,0,1,,1,"(10.886611,-74.776708)"
2019,Febrero,Noruega,578,1,2,,3,"(3.541112,-76.384584)"
2019,Febrero,Noruega,578,16,13,,29,"(4.697144,-74.140516)"
2019,Febrero,Noruega,578,2,0,,2,"(6.171601,-75.427454)"
2019,Febrero,Nueva Caledonia/Territorio francés,540,0,1,,1,"(6.171601,-75.427454)"
2019,Febrero,Nueva Zelanda,554,2,0,,2,"(3.541112,-76.384584)"
2019,Febrero,Nueva Zelanda,554,45,37,,82,"(4.697144,-74.140516)"
2019,Febrero,Nueva Zelanda,554,5,6,,11,"(6.171601,-75.427454)"
2019,Febrero,Omán,512,7,8,,15,"(4.697144,-74.140516)"
2019,Febrero,Omán,512,0,1,,1,"(6.171601,-75.427454)"
2019,Febrero,Pakistán,586,0,1,,1,"(4.697144,-74.140516)"
2019,Febrero,Panamá,591,17,67,,84,"(10.408582,-75.538003)"
2019,Febrero,Panamá,591,1092,831,,1923,"(10.445761,-75.516429)"
2019,Febrero,Panamá,591,1002,956,,1958,"(10.886611,-74.776708)"
2019,Febrero,Panamá,591,0,4,,4,"(10.971302,-74.765397)"
2019,Febrero,Panamá,591,0,1,,1,"(11.247723,-74.213989)"
2019,Febrero,Panamá,591,0,8,,8,"(12.165168,-71.983761)"
2019,Febrero,Panamá,591,3,24,,27,"(12.5744111,-81.703935)"
2019,Febrero,Panamá,591,56,63,,119,"(12.586067,-81.702563)"
2019,Febrero,Panamá,591,2841,2187,,5028,"(3.541112,-76.384584)"
2019,Febrero,Panamá,591,0,1,,1,"(3.893038,-77.067921)"
2019,Febrero,Panamá,591,15,8,,23,"(4.452882,-75.766298)"
2019,Febrero,Panamá,591,6758,7804,,14562,"(4.697144,-74.140516)"
2019,Febrero,Panamá,591,753,496,,1249,"(4.815061,-75.736532)"
2019,Febrero,Panamá,591,0,1,,1,"(6.17134,-75.427194)"
2019,Febrero,Panamá,591,2729,2379,,5108,"(6.171601,-75.427454)"
2019,Febrero,Panamá,591,2,4,,6,"(6.228046,-77.404104)"
2019,Febrero,Panamá,591,11,23,,34,"(7.102626,-77.762647)"
2019,Febrero,Panamá,591,316,287,,603,"(7.128456,-73.183637)"
2019,Febrero,Panamá,591,29,76,,105,"(8.635765,-77.346578)"
2019,Febrero,Paraguay,600,2,2,,4,"(10.445761,-75.516429)"
2019,Febrero,Paraguay,600,8,17,,25,"(10.886611,-74.776708)"
2019,Febrero,Paraguay,600,30,46,,76,"(3.541112,-76.384584)"
2019,Febrero,Paraguay,600,83,195,,278,"(4.697144,-74.140516)"
2019,Febrero,Paraguay,600,8,36,,44,"(4.815061,-75.736532)"
2019,Febrero,Paraguay,600,23,26,,49,"(6.171601,-75.427454)"
2019,Febrero,Paraguay,600,0,1,,1,"(7.128456,-73.183637)"
2019,Febrero,Perú,604,2,4,,6,"(-0.193180,-74.784874)"
2019,Febrero,Perú,604,2,8,,10,"(-4.197703,-69.941278)"
2019,Febrero,Perú,604,198,225,,423,"(-4.223468,-69.945098)"
2019,Febrero,Perú,604,1,0,,1,"(0.25129,-76.875963)"
2019,Febrero,Perú,604,34,39,,73,"(0.814836,-77.662532)"
2019,Febrero,Perú,604,2,0,,2,"(1.813928,-78.763924)"
2019,Febrero,Perú,604,41,36,,77,"(10.445761,-75.516429)"
2019,Febrero,Perú,604,16,12,,28,"(10.886611,-74.776708)"
2019,Febrero,Perú,604,2,2,,4,"(12.586067,-81.702563)"
2019,Febrero,Perú,604,525,519,,1044,"(3.541112,-76.384584)"
2019,Febrero,Perú,604,3921,4451,,8372,"(4.697144,-74.140516)"
2019,Febrero,Perú,604,21,8,,29,"(4.815061,-75.736532)"
2019,Febrero,Perú,604,768,799,,1567,"(6.171601,-75.427454)"
2019,Febrero,Perú,604,3,1,,4,"(7.128456,-73.183637)"
2019,Febrero,Palestina,99999,0,1,,1,"(4.697144,-74.140516)"
2019,Febrero,Polonia,616,1,1,,2,"(10.445761,-75.516429)"
2019,Febrero,Polonia,616,0,1,,1,"(3.541112,-76.384584)"
2019,Febrero,Polonia,616,24,13,,37,"(4.697144,-74.140516)"
2019,Febrero,Polonia,616,1,0,,1,"(6.171601,-75.427454)"
2019,Febrero,Portugal,620,1,0,,1,"(10.445761,-75.516429)"
2019,Febrero,Portugal,620,8,3,,11,"(3.541112,-76.384584)"
2019,Febrero,Portugal,620,52,47,,99,"(4.697144,-74.140516)"
2019,Febrero,Portugal,620,2,1,,3,"(4.815061,-75.736532)"
2019,Febrero,Portugal,620,10,8,,18,"(6.171601,-75.427454)"
2019,Febrero,Puerto Rico/Territorio de Estados Unidos,630,8,5,,13,"(10.445761,-75.516429)"
2019,Febrero,Puerto Rico/Territorio de Estados Unidos,630,15,18,,33,"(10.886611,-74.776708)"
2019,Febrero,Puerto Rico/Territorio de Estados Unidos,630,0,1,,1,"(12.586067,-81.702563)"
2019,Febrero,Puerto Rico/Territorio de Estados Unidos,630,26,13,,39,"(3.541112,-76.384584)"
2019,Febrero,Puerto Rico/Territorio de Estados Unidos,630,393,371,,764,"(4.697144,-74.140516)"
2019,Febrero,Puerto Rico/Territorio de Estados Unidos,630,8,3,,11,"(4.815061,-75.736532)"
2019,Febrero,Puerto Rico/Territorio de Estados Unidos,630,36,34,,70,"(6.171601,-75.427454)"
2019,Febrero,Puerto Rico/Territorio de Estados Unidos,630,0,1,,1,"(7.128456,-73.183637)"
2019,Febrero,Qatar,634,0,1,,1,"(10.886611,-74.776708)"
2019,Febrero,Qatar,634,6,13,,19,"(4.697144,-74.140516)"
2019,Febrero,Qatar,634,2,0,,2,"(6.171601,-75.427454)"
2019,Febrero,Reino Unido de Gran Bretaña e Irlanda del Norte,826,3,0,,3,"(10.445761,-75.516429)"
2019,Febrero,Reino Unido de Gran Bretaña e Irlanda del Norte,826,2,1,,3,"(10.886611,-74.776708)"
2019,Febrero,Reino Unido de Gran Bretaña e Irlanda del Norte,826,17,20,,37,"(3.541112,-76.384584)"
2019,Febrero,Reino Unido de Gran Bretaña e Irlanda del Norte,826,1269,1004,,2273,"(4.697144,-74.140516)"
2019,Febrero,Reino Unido de Gran Bretaña e Irlanda del Norte,826,0,3,,3,"(4.815061,-75.736532)"
2019,Febrero,Reino Unido de Gran Bretaña e Irlanda del Norte,826,26,10,,36,"(6.171601,-75.427454)"
2019,Febrero,República CentroÁfricana,140,3,2,,5,"(4.697144,-74.140516)"
2019,Febrero,Federación de Rusia,643,3,1,,4,"(10.445761,-75.516429)"
2019,Febrero,Federación de Rusia,643,38,46,,84,"(4.697144,-74.140516)"
2019,Febrero,Federación de Rusia,643,2,4,,6,"(6.171601,-75.427454)"
2019,Febrero,República Dominicana,214,1,1,,2,"(10.408582,-75.538003)"
2019,Febrero,República Dominicana,214,33,36,,69,"(10.445761,-75.516429)"
2019,Febrero,República Dominicana,214,50,41,,91,"(10.886611,-74.776708)"
2019,Febrero,República Dominicana,214,0,1,,1,"(10.971302,-74.765397)"
2019,Febrero,República Dominicana,214,3,4,,7,"(11.117806,-74.232622)"
2019,Febrero,República Dominicana,214,1,0,,1,"(12.586067,-81.702563)"
2019,Febrero,República Dominicana,214,148,110,,258,"(3.541112,-76.384584)"
2019,Febrero,República Dominicana,214,2200,2013,,4213,"(4.697144,-74.140516)"
2019,Febrero,República Dominicana,214,50,38,,88,"(4.815061,-75.736532)"
2019,Febrero,República Dominicana,214,258,189,,447,"(6.171601,-75.427454)"
2019,Febrero,República Dominicana,214,24,23,,47,"(7.128456,-73.183637)"
2019,Febrero,Rumania,642,0,1,,1,"(10.445761,-75.516429)"
2019,Febrero,Rumania,642,1,0,,1,"(3.541112,-76.384584)"
2019,Febrero,Rumania,642,3,1,,4,"(4.697144,-74.140516)"
2019,Febrero,San Marino,674,0,4,,4,"(4.697144,-74.140516)"
2019,Febrero,San  Vicente y las Granadinas,670,0,1,,1,"(4.697144,-74.140516)"
2019,Febrero,Serbia,688,2,0,,2,"(4.697144,-74.140516)"
2019,Febrero,Singapur,702,1,0,,1,"(10.445761,-75.516429)"
2019,Febrero,Singapur,702,15,12,,27,"(4.697144,-74.140516)"
2019,Febrero,Singapur,702,3,2,,5,"(6.171601,-75.427454)"
2019,Febrero,Sri Lanka,144,1,0,,1,"(4.697144,-74.140516)"
2019,Febrero,Sri Lanka,144,1,0,,1,"(6.171601,-75.427454)"
2019,Febrero,Sudáfrica,710,0,1,,1,"(3.541112,-76.384584)"
2019,Febrero,Sudáfrica,710,10,13,,23,"(4.697144,-74.140516)"
2019,Febrero,Sudáfrica,710,0,1,,1,"(6.171601,-75.427454)"
2019,Febrero,Sudán,736,1,0,,1,"(4.697144,-74.140516)"
2019,Febrero,Suecia,752,3,2,,5,"(10.445761,-75.516429)"
2019,Febrero,Suecia,752,2,0,,2,"(10.886611,-74.776708)"
2019,Febrero,Suecia,752,15,16,,31,"(3.541112,-76.384584)"
2019,Febrero,Suecia,752,83,76,,159,"(4.697144,-74.140516)"
2019,Febrero,Suecia,752,1,0,,1,"(4.815061,-75.736532)"
2019,Febrero,Suecia,752,10,4,,14,"(6.171601,-75.427454)"
2019,Febrero,Suecia,752,1,0,,1,"(7.128456,-73.183637)"
2019,Febrero,Suiza,756,5,0,,5,"(10.445761,-75.516429)"
2019,Febrero,Suiza,756,3,1,,4,"(10.886611,-74.776708)"
2019,Febrero,Suiza,756,58,29,,87,"(3.541112,-76.384584)"
2019,Febrero,Suiza,756,294,143,,437,"(4.697144,-74.140516)"
2019,Febrero,Suiza,756,0,1,,1,"(4.815061,-75.736532)"
2019,Febrero,Suiza,756,27,16,,43,"(6.171601,-75.427454)"
2019,Febrero,Surinam,740,0,1,,1,"(10.408582,-75.538003)"
2019,Febrero,Surinam,740,5,4,,9,"(4.697144,-74.140516)"
2019,Febrero,Taiwán,158,7,8,,15,"(4.697144,-74.140516)"
2019,Febrero,Tailandia,764,0,1,,1,"(10.445761,-75.516429)"
2019,Febrero,Tailandia,764,1,0,,1,"(3.541112,-76.384584)"
2019,Febrero,Tailandia,764,17,21,,38,"(4.697144,-74.140516)"
2019,Febrero,Tailandia,764,1,4,,5,"(6.171601,-75.427454)"
2019,Febrero,Tanzania,834,1,0,,1,"(10.886611,-74.776708)"
2019,Febrero,Tanzania,834,1,0,,1,"(4.697144,-74.140516)"
2019,Febrero,Trinidad y Tobago,780,0,6,,6,"(10.408582,-75.538003)"
2019,Febrero,Trinidad y Tobago,780,2,0,,2,"(10.445761,-75.516429)"
2019,Febrero,Trinidad y Tobago,780,2,2,,4,"(10.886611,-74.776708)"
2019,Febrero,Trinidad y Tobago,780,6,4,,10,"(3.541112,-76.384584)"
2019,Febrero,Trinidad y Tobago,780,9,33,,42,"(4.697144,-74.140516)"
2019,Febrero,Trinidad y Tobago,780,0,2,,2,"(4.815061,-75.736532)"
2019,Febrero,Trinidad y Tobago,780,5,5,,10,"(6.171601,-75.427454)"
2019,Febrero,Trinidad y Tobago,780,1,1,,2,"(7.128456,-73.183637)"
2019,Febrero,Túnez,788,1,0,,1,"(4.697144,-74.140516)"
2019,Febrero,Turquía,792,0,1,,1,"(3.541112,-76.384584)"
2019,Febrero,Turquía,792,432,244,,676,"(4.697144,-74.140516)"
2019,Febrero,Turquía,792,4,1,,5,"(6.171601,-75.427454)"
2019,Febrero,Turkmenistán,795,0,2,,2,"(4.697144,-74.140516)"
2019,Febrero,Ucrania,804,4,2,,6,"(4.697144,-74.140516)"
2019,Febrero,Uganda,800,0,1,,1,"(4.697144,-74.140516)"
2019,Febrero,Uruguay,858,2,0,,2,"(10.886611,-74.776708)"
2019,Febrero,Uruguay,858,23,40,,63,"(3.541112,-76.384584)"
2019,Febrero,Uruguay,858,269,304,,573,"(4.697144,-74.140516)"
2019,Febrero,Uruguay,858,10,15,,25,"(4.815061,-75.736532)"
2019,Febrero,Uruguay,858,13,24,,37,"(6.171601,-75.427454)"
2019,Febrero,Uruguay,858,1,1,,2,"(7.128456,-73.183637)"
2019,Febrero,Venezuela,862,5,6,,11,"(10.445761,-75.516429)"
2019,Febrero,Venezuela,862,16,16,,32,"(10.886611,-74.776708)"
2019,Febrero,Venezuela,862,1009,1152,,2161,"(11.360009,-72.129330)"
2019,Febrero,Venezuela,862,544,414,,958,"(3.541112,-76.384584)"
2019,Febrero,Venezuela,862,3,3,,6,"(3.866713,-67.927521)"
2019,Febrero,Venezuela,862,1195,1161,,2356,"(4.697144,-74.140516)"
2019,Febrero,Venezuela,862,1,1,,2,"(4.815061,-75.736532)"
2019,Febrero,Venezuela,862,551,497,,1048,"(6.171601,-75.427454)"
2019,Febrero,Venezuela,862,15,23,,38,"(6.185799,-67.483929)"
2019,Febrero,Venezuela,862,178,218,,396,"(7.088729,-70.740253)"
2019,Febrero,Venezuela,862,4,2,,6,"(7.128456,-73.183637)"
2019,Febrero,Venezuela,862,435,572,,1007,"(7.818934,-72.453226)"
2019,Febrero,Venezuela,862,0,2,,2,"(7.927209,-72.507910)"
2019,Febrero,Venezuela,862,51,91,,142,"(8.36068,-72.409396)"
2019,Febrero,Vietnam,704,1,0,,1,"(10.886611,-74.776708)"
2019,Febrero,Vietnam,704,1,3,,4,"(4.697144,-74.140516)"
2019,Febrero,Islas Vírgenes Británicas/Territorio Británico de Ultramar,92,0,8,,8,"(10.408582,-75.538003)"
2019,Febrero,Islas Vírgenes Británicas/Territorio Británico de Ultramar,92,0,4,,4,"(6.171601,-75.427454)"
2019,Febrero,República Árabe de Yemen,887,0,1,,1,"(3.541112,-76.384584)"
2019,Febrero,Zambia,894,1,0,,1,"(4.697144,-74.140516)"
2019,Marzo,Afganistán,4,1,1,,2,"(4.697144,-74.140516)"
2019,Marzo,Albania,8,3,3,,6,"(4.697144,-74.140516)"
2019,Marzo,Alemania,276,7,6,,13,"(10.445761,-75.516429)"
2019,Marzo,Alemania,276,3,7,,10,"(10.886611,-74.776708)"
2019,Marzo,Alemania,276,47,29,,76,"(3.541112,-76.384584)"
2019,Marzo,Alemania,276,2186,2156,,4342,"(4.697144,-74.140516)"
2019,Marzo,Alemania,276,5,1,,6,"(4.815061,-75.736532)"
2019,Marzo,Alemania,276,72,56,,128,"(6.171601,-75.427454)"
2019,Marzo,Angola,24,0,4,,4,"(4.697144,-74.140516)"
2019,Marzo,Antigua y Barbuda,28,9,1,,10,"(4.697144,-74.140516)"
2019,Marzo,Antigua y Barbuda,28,0,1,,1,"(6.171601,-75.427454)"
2019,Marzo,Países Bajos,528,0,2,,2,"(10.408582,-75.538003)"
2019,Marzo,Países Bajos,528,108,77,,185,"(10.445761,-75.516429)"
2019,Marzo,Países Bajos,528,19,7,,26,"(10.886611,-74.776708)"
2019,Marzo,Países Bajos,528,59,21,,80,"(3.541112,-76.384584)"
2019,Marzo,Países Bajos,528,1021,912,,1933,"(4.697144,-74.140516)"
2019,Marzo,Países Bajos,528,5,0,,5,"(4.815061,-75.736532)"
2019,Marzo,Países Bajos,528,70,47,,117,"(6.171601,-75.427454)"
2019,Marzo,Arabia Saudita,682,0,3,,3,"(3.541112,-76.384584)"
2019,Marzo,Arabia Saudita,682,3,20,,23,"(4.697144,-74.140516)"
2019,Marzo,Arabia Saudita,682,1,2,,3,"(6.171601,-75.427454)"
2019,Marzo,Arabia Saudita,682,0,1,,1,"(7.128456,-73.183637)"
2019,Marzo,Argelia,12,0,1,,1,"(3.541112,-76.384584)"
2019,Marzo,Argelia,12,5,4,,9,"(4.697144,-74.140516)"
2019,Marzo,Argelia,12,0,1,,1,"(6.171601,-75.427454)"
2019,Marzo,Argentina,32,0,1,,1,"(-4.197703,-69.941278)"
2019,Marzo,Argentina,32,0,2,,2,"(0.25129,-76.875963)"
2019,Marzo,Argentina,32,1,1,,2,"(0.812436,-77.847006)"
2019,Marzo,Argentina,32,7,12,,19,"(0.814836,-77.662532)"
2019,Marzo,Argentina,32,44,29,,73,"(10.445761,-75.516429)"
2019,Marzo,Argentina,32,71,46,,117,"(10.886611,-74.776708)"
2019,Marzo,Argentina,32,1,1,,2,"(12.586067,-81.702563)"
2019,Marzo,Argentina,32,234,241,,475,"(3.541112,-76.384584)"
2019,Marzo,Argentina,32,3251,3262,,6513,"(4.697144,-74.140516)"
2019,Marzo,Argentina,32,26,21,,47,"(4.815061,-75.736532)"
2019,Marzo,Argentina,32,243,230,,473,"(6.171601,-75.427454)"
2019,Marzo,Argentina,32,12,10,,22,"(7.128456,-73.183637)"
2019,Marzo,Aruba,533,2036,1503,,3539,"(10.408582,-75.538003)"
2019,Marzo,Aruba,533,2,1,,3,"(10.445761,-75.516429)"
2019,Marzo,Aruba,533,14,20,,34,"(10.886611,-74.776708)"
2019,Marzo,Aruba,533,0,2,,2,"(10.971302,-74.765397)"
2019,Marzo,Aruba,533,0,1,,1,"(11.247723,-74.213989)"
2019,Marzo,Aruba,533,2,7,,9,"(11.528919,-72.919681)"
2019,Marzo,Aruba,533,1,0,,1,"(12.586067,-81.702563)"
2019,Marzo,Aruba,533,44,33,,77,"(3.541112,-76.384584)"
2019,Marzo,Aruba,533,1567,1303,,2870,"(4.697144,-74.140516)"
2019,Marzo,Aruba,533,10,8,,18,"(4.815061,-75.736532)"
2019,Marzo,Aruba,533,1,1,,2,"(6.17134,-75.427194)"
2019,Marzo,Aruba,533,53,50,,103,"(6.171601,-75.427454)"
2019,Marzo,Aruba,533,13,49,,62,"(7.128456,-73.183637)"
2019,Marzo,Aruba,533,3,3,,6,"(7.927209,-72.507910)"
2019,Marzo,Australia,36,2,0,,2,"(10.445761,-75.516429)"
2019,Marzo,Australia,36,3,0,,3,"(10.886611,-74.776708)"
2019,Marzo,Australia,36,14,10,,24,"(3.541112,-76.384584)"
2019,Marzo,Australia,36,409,322,,731,"(4.697144,-74.140516)"
2019,Marzo,Australia,36,2,3,,5,"(4.815061,-75.736532)"
2019,Marzo,Australia,36,33,31,,64,"(6.171601,-75.427454)"
2019,Marzo,Austria,40,1,0,,1,"(10.445761,-75.516429)"
2019,Marzo,Austria,40,0,1,,1,"(10.886611,-74.776708)"
2019,Marzo,Austria,40,2,3,,5,"(3.541112,-76.384584)"
2019,Marzo,Austria,40,59,57,,116,"(4.697144,-74.140516)"
2019,Marzo,Austria,40,6,8,,14,"(6.171601,-75.427454)"
2019,Marzo,Azerbaiyán,31,0,2,,2,"(4.697144,-74.140516)"
2019,Marzo,Bahamas,44,2,2,,4,"(10.445761,-75.516429)"
2019,Marzo,Bahamas,44,4,6,,10,"(10.886611,-74.776708)"
2019,Marzo,Bahamas,44,0,1,,1,"(13.3387613,-81.372937)"
2019,Marzo,Bahamas,44,19,11,,30,"(3.541112,-76.384584)"
2019,Marzo,Bahamas,44,19,9,,28,"(4.697144,-74.140516)"
2019,Marzo,Bahamas,44,8,3,,11,"(4.815061,-75.736532)"
2019,Marzo,Bahamas,44,19,6,,25,"(6.171601,-75.427454)"
2019,Marzo,Bahréin,48,1,0,,1,"(10.445761,-75.516429)"
2019,Marzo,Bahréin,48,1,3,,4,"(4.697144,-74.140516)"
2019,Marzo,Bahréin,48,1,1,,2,"(6.171601,-75.427454)"
2019,Marzo,Bahréin,48,3,0,,3,"(7.128456,-73.183637)"
2019,Marzo,Bangladesh,50,0,1,,1,"(4.697144,-74.140516)"
2019,Marzo,Bangladesh,50,0,1,,1,"(4.815061,-75.736532)"
2019,Marzo,Barbados,52,2,2,,4,"(10.886611,-74.776708)"
2019,Marzo,Barbados,52,1,1,,2,"(3.541112,-76.384584)"
2019,Marzo,Barbados,52,5,8,,13,"(4.697144,-74.140516)"
2019,Marzo,Barbados,52,0,1,,1,"(6.171601,-75.427454)"
2019,Marzo,República de Belarús,112,0,1,,1,"(11.360009,-72.129330)"
2019,Marzo,Bélgica,56,1,2,,3,"(10.445761,-75.516429)"
2019,Marzo,Bélgica,56,1,1,,2,"(10.886611,-74.776708)"
2019,Marzo,Bélgica,56,6,7,,13,"(3.541112,-76.384584)"
2019,Marzo,Bélgica,56,97,77,,174,"(4.697144,-74.140516)"
2019,Marzo,Bélgica,56,18,12,,30,"(6.171601,-75.427454)"
2019,Marzo,Belice,84,1,2,,3,"(3.541112,-76.384584)"
2019,Marzo,Belice,84,3,2,,5,"(4.697144,-74.140516)"
2019,Marzo,Belice,84,3,0,,3,"(6.171601,-75.427454)"
2019,Marzo,Bermudas/Territorio Británico de Ultramar,60,1,4,,5,"(4.697144,-74.140516)"
2019,Marzo,Bermudas/Territorio Británico de Ultramar,60,2,0,,2,"(6.171601,-75.427454)"
2019,Marzo,Bolivia,68,1,5,,6,"(0.814836,-77.662532)"
2019,Marzo,Bolivia,68,1,1,,2,"(10.445761,-75.516429)"
2019,Marzo,Bolivia,68,1,4,,5,"(10.886611,-74.776708)"
2019,Marzo,Bolivia,68,14,42,,56,"(3.541112,-76.384584)"
2019,Marzo,Bolivia,68,399,652,,1051,"(4.697144,-74.140516)"
2019,Marzo,Bolivia,68,1,7,,8,"(4.815061,-75.736532)"
2019,Marzo,Bolivia,68,23,47,,70,"(6.171601,-75.427454)"
2019,Marzo,Bolivia,68,0,1,,1,"(7.128456,-73.183637)"
2019,Marzo,Bosnia y Herzegovina,70,2,0,,2,"(4.697144,-74.140516)"
2019,Marzo,Brasil,76,141,255,,396,"(-4.197703,-69.941278)"
2019,Marzo,Brasil,76,17,37,,54,"(-4.223468,-69.945098)"
2019,Marzo,Brasil,76,0,2,,2,"(0.814836,-77.662532)"
2019,Marzo,Brasil,76,10,12,,22,"(10.445761,-75.516429)"
2019,Marzo,Brasil,76,15,7,,22,"(10.886611,-74.776708)"
2019,Marzo,Brasil,76,3,2,,5,"(12.586067,-81.702563)"
2019,Marzo,Brasil,76,190,276,,466,"(3.541112,-76.384584)"
2019,Marzo,Brasil,76,2556,3459,,6015,"(4.697144,-74.140516)"
2019,Marzo,Brasil,76,42,64,,106,"(4.815061,-75.736532)"
2019,Marzo,Brasil,76,190,267,,457,"(6.171601,-75.427454)"
2019,Marzo,Brasil,76,7,12,,19,"(7.128456,-73.183637)"
2019,Marzo,Bulgaria,100,1,2,,3,"(4.697144,-74.140516)"
2019,Marzo,Cabo Verde,132,0,1,,1,"(6.171601,-75.427454)"
2019,Marzo,Islas Caimán/Territorio Británico de Ultramar,136,1,0,,1,"(10.886611,-74.776708)"
2019,Marzo,Islas Caimán/Territorio Británico de Ultramar,136,3,4,,7,"(4.697144,-74.140516)"
2019,Marzo,Islas Caimán/Territorio Británico de Ultramar,136,0,2,,2,"(6.171601,-75.427454)"
2019,Marzo,Camboya,116,1,1,,2,"(4.697144,-74.140516)"
2019,Marzo,Antártida,10,0,1,,1,"(4.697144,-74.140516)"
2019,Marzo,Camerún,120,0,1,,1,"(4.697144,-74.140516)"
2019,Marzo,Camerún,120,1,2,,3,"(6.171601,-75.427454)"
2019,Marzo,Canadá,124,238,166,,404,"(10.445761,-75.516429)"
2019,Marzo,Canadá,124,50,27,,77,"(10.886611,-74.776708)"
2019,Marzo,Canadá,124,17,17,,34,"(12.586067,-81.702563)"
2019,Marzo,Canadá,124,188,175,,363,"(3.541112,-76.384584)"
2019,Marzo,Canadá,124,3,1,,4,"(4.452882,-75.766298)"
2019,Marzo,Canadá,124,2250,1952,,4202,"(4.697144,-74.140516)"
2019,Marzo,Canadá,124,33,17,,50,"(4.815061,-75.736532)"
2019,Marzo,Canadá,124,234,204,,438,"(6.171601,-75.427454)"
2019,Marzo,Canadá,124,18,12,,30,"(7.128456,-73.183637)"
2019,Marzo,Chad,148,1,0,,1,"(4.697144,-74.140516)"
2019,Marzo,España,724,10,13,,23,"(10.445761,-75.516429)"
2019,Marzo,España,724,26,13,,39,"(10.886611,-74.776708)"
2019,Marzo,España,724,2723,1852,,4575,"(3.541112,-76.384584)"
2019,Marzo,España,724,14458,11442,,25900,"(4.697144,-74.140516)"
2019,Marzo,España,724,2,5,,7,"(4.815061,-75.736532)"
2019,Marzo,España,724,2136,1425,,3562,"(6.171601,-75.427454)"
2019,Marzo,Colombia,170,3,7,,10,"(10.445761,-75.516429)"
2019,Marzo,Colombia,170,306,847,,1153,"(4.697144,-74.140516)"
2019,Marzo,República Del Congo,178,1,1,,2,"(4.697144,-74.140516)"
2019,Marzo,República Del Congo,178,0,1,,1,"(6.171601,-75.427454)"
2019,Marzo,República de Corea,410,1,0,,1,"(3.541112,-76.384584)"
2019,Marzo,República de Corea,410,21,29,,50,"(4.697144,-74.140516)"
2019,Marzo,República de Corea,410,1,2,,3,"(6.171601,-75.427454)"
2019,Marzo,Costa de Marfil,384,1,0,,1,"(3.541112,-76.384584)"
2019,Marzo,Costa de Marfil,384,3,5,,8,"(4.697144,-74.140516)"
2019,Marzo,Costa Rica,188,13,15,,28,"(10.445761,-75.516429)"
2019,Marzo,Costa Rica,188,26,34,,60,"(10.886611,-74.776708)"
2019,Marzo,Costa Rica,188,2,18,,20,"(12.5744111,-81.703935)"
2019,Marzo,Costa Rica,188,4,8,,12,"(12.586067,-81.702563)"
2019,Marzo,Costa Rica,188,78,92,,170,"(3.541112,-76.384584)"
2019,Marzo,Costa Rica,188,949,1139,,2088,"(4.697144,-74.140516)"
2019,Marzo,Costa Rica,188,15,7,,22,"(4.815061,-75.736532)"
2019,Marzo,Costa Rica,188,173,145,,318,"(6.171601,-75.427454)"
2019,Marzo,Costa Rica,188,7,5,,12,"(7.128456,-73.183637)"
2019,Marzo,Croacia,191,4,8,,12,"(4.697144,-74.140516)"
2019,Marzo,Cuba,192,3,5,,8,"(10.445761,-75.516429)"
2019,Marzo,Cuba,192,10,18,,28,"(10.886611,-74.776708)"
2019,Marzo,Cuba,192,92,67,,159,"(3.541112,-76.384584)"
2019,Marzo,Cuba,192,1061,926,,1987,"(4.697144,-74.140516)"
2019,Marzo,Cuba,192,14,8,,22,"(4.815061,-75.736532)"
2019,Marzo,Cuba,192,98,79,,177,"(6.171601,-75.427454)"
2019,Marzo,Cuba,192,5,5,,10,"(7.128456,-73.183637)"
2019,Marzo,Curazao,99999,2,2,,4,"(10.886611,-74.776708)"
2019,Marzo,Curazao,99999,11,6,,17,"(3.541112,-76.384584)"
2019,Marzo,Curazao,99999,504,431,,935,"(4.697144,-74.140516)"
2019,Marzo,Curazao,99999,3,3,,6,"(4.815061,-75.736532)"
2019,Marzo,Curazao,99999,11,19,,30,"(6.171601,-75.427454)"
2019,Marzo,República Checa,203,16,8,,24,"(4.697144,-74.140516)"
2019,Marzo,Chile,152,3,6,,9,"(0.25129,-76.875963)"
2019,Marzo,Chile,152,101,91,,192,"(0.814836,-77.662532)"
2019,Marzo,Chile,152,2,0,,2,"(1.813928,-78.763924)"
2019,Marzo,Chile,152,29,17,,46,"(10.445761,-75.516429)"
2019,Marzo,Chile,152,80,54,,134,"(10.886611,-74.776708)"
2019,Marzo,Chile,152,2,2,,4,"(12.586067,-81.702563)"
2019,Marzo,Chile,152,1177,718,,1895,"(3.541112,-76.384584)"
2019,Marzo,Chile,152,5114,4680,,9794,"(4.697144,-74.140516)"
2019,Marzo,Chile,152,158,94,,252,"(4.815061,-75.736532)"
2019,Marzo,Chile,152,300,226,,526,"(6.171601,-75.427454)"
2019,Marzo,Chile,152,8,12,,20,"(7.128456,-73.183637)"
2019,Marzo,China,156,2,10,,12,"(10.445761,-75.516429)"
2019,Marzo,China,156,0,8,,8,"(10.886611,-74.776708)"
2019,Marzo,China,156,14,50,,64,"(3.541112,-76.384584)"
2019,Marzo,China,156,290,889,,1179,"(4.697144,-74.140516)"
2019,Marzo,China,156,2,3,,5,"(4.815061,-75.736532)"
2019,Marzo,China,156,39,105,,144,"(6.171601,-75.427454)"
2019,Marzo,Dinamarca,208,0,1,,1,"(10.445761,-75.516429)"
2019,Marzo,Dinamarca,208,1,0,,1,"(10.886611,-74.776708)"
2019,Marzo,Dinamarca,208,24,18,,42,"(4.697144,-74.140516)"
2019,Marzo,Dinamarca,208,7,1,,8,"(6.171601,-75.427454)"
2019,Marzo,Dominica,212,1,3,,4,"(3.541112,-76.384584)"
2019,Marzo,Dominica,212,1,3,,4,"(4.697144,-74.140516)"
2019,Marzo,Ecuador,218,614,978,,1592,"(0.25129,-76.875963)"
2019,Marzo,Ecuador,218,17,42,,59,"(0.812436,-77.847006)"
2019,Marzo,Ecuador,218,4314,5367,,9681,"(0.814836,-77.662532)"
2019,Marzo,Ecuador,218,109,145,,254,"(1.813928,-78.763924)"
2019,Marzo,Ecuador,218,14,11,,25,"(10.445761,-75.516429)"
2019,Marzo,Ecuador,218,9,26,,35,"(10.886611,-74.776708)"
2019,Marzo,Ecuador,218,1,0,,1,"(12.586067,-81.702563)"
2019,Marzo,Ecuador,218,382,512,,894,"(3.541112,-76.384584)"
2019,Marzo,Ecuador,218,2435,4006,,6441,"(4.697144,-74.140516)"
2019,Marzo,Ecuador,218,5,6,,11,"(4.815061,-75.736532)"
2019,Marzo,Ecuador,218,66,105,,171,"(6.171601,-75.427454)"
2019,Marzo,Ecuador,218,1,4,,5,"(7.128456,-73.183637)"
2019,Marzo,Egipto,818,0,2,,2,"(3.541112,-76.384584)"
2019,Marzo,Egipto,818,13,13,,26,"(4.697144,-74.140516)"
2019,Marzo,Egipto,818,2,0,,2,"(6.171601,-75.427454)"
2019,Marzo,El Salvador,222,16,23,,39,"(10.445761,-75.516429)"
2019,Marzo,El Salvador,222,4,4,,8,"(10.886611,-74.776708)"
2019,Marzo,El Salvador,222,125,109,,234,"(3.541112,-76.384584)"
2019,Marzo,El Salvador,222,728,938,,1666,"(4.697144,-74.140516)"
2019,Marzo,El Salvador,222,0,1,,1,"(4.815061,-75.736532)"
2019,Marzo,El Salvador,222,12,22,,34,"(6.171601,-75.427454)"
2019,Marzo,Emiratos Árabes,784,0,1,,1,"(10.445761,-75.516429)"
2019,Marzo,Emiratos Árabes,784,1,0,,1,"(10.886611,-74.776708)"
2019,Marzo,Emiratos Árabes,784,2,1,,3,"(3.541112,-76.384584)"
2019,Marzo,Emiratos Árabes,784,227,358,,585,"(4.697144,-74.140516)"
2019,Marzo,Emiratos Árabes,784,10,21,,31,"(6.171601,-75.427454)"
2019,Marzo,Eritrea,232,0,2,,2,"(4.697144,-74.140516)"
2019,Marzo,Eslovaquia,703,2,1,,3,"(3.541112,-76.384584)"
2019,Marzo,Eslovenia,705,2,0,,2,"(4.697144,-74.140516)"
2019,Marzo,Estados Unidos de América,840,0,1,,1,"(0.814836,-77.662532)"
2019,Marzo,Estados Unidos de América,840,1,2,,3,"(10.408582,-75.538003)"
2019,Marzo,Estados Unidos de América,840,3422,2803,,6226,"(10.445761,-75.516429)"
2019,Marzo,Estados Unidos de América,840,3087,2471,,5558,"(10.886611,-74.776708)"
2019,Marzo,Estados Unidos de América,840,121,97,,218,"(11.117806,-74.232622)"
2019,Marzo,Estados Unidos de América,840,0,12,,12,"(11.247723,-74.213989)"
2019,Marzo,Estados Unidos de América,840,34,33,,67,"(12.586067,-81.702563)"
2019,Marzo,Estados Unidos de América,840,6726,4848,,11575,"(3.541112,-76.384584)"
2019,Marzo,Estados Unidos de América,840,629,499,,1128,"(4.452882,-75.766298)"
2019,Marzo,Estados Unidos de América,840,34041,30869,,64910,"(4.697144,-74.140516)"
2019,Marzo,Estados Unidos de América,840,1458,996,,2454,"(4.815061,-75.736532)"
2019,Marzo,Estados Unidos de América,840,1,7,,8,"(6.17134,-75.427194)"
2019,Marzo,Estados Unidos de América,840,9238,7377,,16615,"(6.171601,-75.427454)"
2019,Marzo,Estados Unidos de América,840,249,173,,422,"(7.128456,-73.183637)"
2019,Marzo,Estados Unidos de América,840,1,1,,2,"(7.927209,-72.507910)"
2019,Marzo,Estonia,233,1,0,,1,"(4.697144,-74.140516)"
2019,Marzo,Etiopia,231,1,1,,2,"(4.697144,-74.140516)"
2019,Marzo,Filipinas,608,7,7,,14,"(4.697144,-74.140516)"
2019,Marzo,Filipinas,608,0,1,,1,"(6.171601,-75.427454)"
2019,Marzo,Finlandia,246,1,0,,1,"(10.445761,-75.516429)"
2019,Marzo,Finlandia,246,9,7,,16,"(4.697144,-74.140516)"
2019,Marzo,Finlandia,246,3,4,,7,"(6.171601,-75.427454)"
2019,Marzo,Francia,250,5,4,,9,"(10.445761,-75.516429)"
2019,Marzo,Francia,250,8,8,,16,"(10.886611,-74.776708)"
2019,Marzo,Francia,250,82,49,,131,"(3.541112,-76.384584)"
2019,Marzo,Francia,250,1456,1218,,2674,"(4.697144,-74.140516)"
2019,Marzo,Francia,250,7,4,,11,"(4.815061,-75.736532)"
2019,Marzo,Francia,250,100,73,,173,"(6.171601,-75.427454)"
2019,Marzo,Francia,250,0,1,,1,"(7.128456,-73.183637)"
2019,Marzo,Gabón,266,0,1,,1,"(4.697144,-74.140516)"
2019,Marzo,Georgia,268,0,1,,1,"(4.697144,-74.140516)"
2019,Marzo,Ghana,288,0,2,,2,"(4.697144,-74.140516)"
2019,Marzo,Granada,308,2,0,,2,"(4.697144,-74.140516)"
2019,Marzo,Grecia,300,12,14,,26,"(4.697144,-74.140516)"
2019,Marzo,Grecia,300,1,1,,2,"(6.171601,-75.427454)"
2019,Marzo,Guatemala,320,3,9,,12,"(10.445761,-75.516429)"
2019,Marzo,Guatemala,320,9,9,,18,"(10.886611,-74.776708)"
2019,Marzo,Guatemala,320,0,12,,12,"(12.586067,-81.702563)"
2019,Marzo,Guatemala,320,42,63,,105,"(3.541112,-76.384584)"
2019,Marzo,Guatemala,320,523,661,,1184,"(4.697144,-74.140516)"
2019,Marzo,Guatemala,320,1,15,,16,"(4.815061,-75.736532)"
2019,Marzo,Guatemala,320,75,121,,196,"(6.171601,-75.427454)"
2019,Marzo,Guatemala,320,4,3,,7,"(7.128456,-73.183637)"
2019,Marzo,Guyana,328,2,8,,10,"(4.697144,-74.140516)"
2019,Marzo,Guyana,328,0,1,,1,"(4.815061,-75.736532)"
2019,Marzo,Guyana,328,1,3,,4,"(6.171601,-75.427454)"
2019,Marzo,Guinea Ecuatorial,226,0,2,,2,"(4.697144,-74.140516)"
2019,Marzo,Guadalupe/Territorio Francés,312,1,0,,1,"(3.541112,-76.384584)"
2019,Marzo,Guadalupe/Territorio Francés,312,1,2,,3,"(4.697144,-74.140516)"
2019,Marzo,Guayana Francesa/Departamento de Ultramar Francés,254,0,1,,1,"(4.697144,-74.140516)"
2019,Marzo,Guayana Francesa/Departamento de Ultramar Francés,254,0,1,,1,"(4.815061,-75.736532)"
2019,Marzo,Haití,332,1,3,,4,"(10.445761,-75.516429)"
2019,Marzo,Haití,332,0,2,,2,"(10.886611,-74.776708)"
2019,Marzo,Haití,332,2,6,,8,"(4.697144,-74.140516)"
2019,Marzo,Haití,332,2,0,,2,"(6.171601,-75.427454)"
2019,Marzo,Haití,332,0,1,,1,"(7.128456,-73.183637)"
2019,Marzo,Honduras,340,4,4,,8,"(10.445761,-75.516429)"
2019,Marzo,Honduras,340,2,15,,17,"(10.886611,-74.776708)"
2019,Marzo,Honduras,340,0,2,,2,"(12.5744111,-81.703935)"
2019,Marzo,Honduras,340,0,2,,2,"(12.586067,-81.702563)"
2019,Marzo,Honduras,340,10,32,,42,"(3.541112,-76.384584)"
2019,Marzo,Honduras,340,87,156,,243,"(4.697144,-74.140516)"
2019,Marzo,Honduras,340,3,7,,10,"(4.815061,-75.736532)"
2019,Marzo,Honduras,340,23,61,,84,"(6.171601,-75.427454)"
2019,Marzo,Honduras,340,6,5,,11,"(7.128456,-73.183637)"
2019,Marzo,Hong Kong,344,21,44,,65,"(4.697144,-74.140516)"
2019,Marzo,Hong Kong,344,2,1,,3,"(6.171601,-75.427454)"
2019,Marzo,Hungría,348,0,3,,3,"(10.445761,-75.516429)"
2019,Marzo,Hungría,348,6,8,,14,"(4.697144,-74.140516)"
2019,Marzo,India,356,0,2,,2,"(10.886611,-74.776708)"
2019,Marzo,India,356,2,3,,5,"(3.541112,-76.384584)"
2019,Marzo,India,356,43,28,,71,"(4.697144,-74.140516)"
2019,Marzo,India,356,1,0,,1,"(4.815061,-75.736532)"
2019,Marzo,India,356,5,6,,11,"(6.171601,-75.427454)"
2019,Marzo,Indonesia,360,1,0,,1,"(3.541112,-76.384584)"
2019,Marzo,Indonesia,360,3,5,,8,"(4.697144,-74.140516)"
2019,Marzo,Iraq,368,0,4,,4,"(4.697144,-74.140516)"
2019,Marzo,Irán,364,0,2,,2,"(4.697144,-74.140516)"
2019,Marzo,República de Irlanda,372,0,1,,1,"(3.541112,-76.384584)"
2019,Marzo,República de Irlanda,372,20,15,,35,"(4.697144,-74.140516)"
2019,Marzo,República de Irlanda,372,1,0,,1,"(6.171601,-75.427454)"
2019,Marzo,Islandia,352,6,2,,8,"(4.697144,-74.140516)"
2019,Marzo,Islandia,352,1,0,,1,"(6.171601,-75.427454)"
2019,Marzo,Israel,376,7,4,,11,"(3.541112,-76.384584)"
2019,Marzo,Israel,376,140,100,,240,"(4.697144,-74.140516)"
2019,Marzo,Israel,376,12,11,,23,"(6.171601,-75.427454)"
2019,Marzo,Italia,380,9,5,,14,"(10.445761,-75.516429)"
2019,Marzo,Italia,380,10,9,,19,"(10.886611,-74.776708)"
2019,Marzo,Italia,380,139,59,,198,"(3.541112,-76.384584)"
2019,Marzo,Italia,380,725,442,,1167,"(4.697144,-74.140516)"
2019,Marzo,Italia,380,0,2,,2,"(4.815061,-75.736532)"
2019,Marzo,Italia,380,89,60,,149,"(6.171601,-75.427454)"
2019,Marzo,Italia,380,1,0,,1,"(7.128456,-73.183637)"
2019,Marzo,Jamaica,388,495,354,,849,"(10.408582,-75.538003)"
2019,Marzo,Jamaica,388,1,2,,3,"(10.445761,-75.516429)"
2019,Marzo,Jamaica,388,1,2,,3,"(11.247723,-74.213989)"
2019,Marzo,Jamaica,388,11,4,,15,"(3.541112,-76.384584)"
2019,Marzo,Jamaica,388,29,35,,64,"(4.697144,-74.140516)"
2019,Marzo,Jamaica,388,3,3,,6,"(4.815061,-75.736532)"
2019,Marzo,Jamaica,388,2,3,,5,"(6.17134,-75.427194)"
2019,Marzo,Jamaica,388,14,9,,23,"(6.171601,-75.427454)"
2019,Marzo,Jamaica,388,1,2,,3,"(7.128456,-73.183637)"
2019,Marzo,Japón,392,1,0,,1,"(10.886611,-74.776708)"
2019,Marzo,Japón,392,6,5,,11,"(3.541112,-76.384584)"
2019,Marzo,Japón,392,140,148,,288,"(4.697144,-74.140516)"
2019,Marzo,Japón,392,1,1,,2,"(4.815061,-75.736532)"
2019,Marzo,Japón,392,19,17,,36,"(6.171601,-75.427454)"
2019,Marzo,Jordania,400,1,0,,1,"(3.541112,-76.384584)"
2019,Marzo,Jordania,400,3,0,,3,"(4.697144,-74.140516)"
2019,Marzo,Kazajistán,398,0,1,,1,"(4.697144,-74.140516)"
2019,Marzo,Kenia,404,6,9,,15,"(4.697144,-74.140516)"
2019,Marzo,Kenia,404,0,1,,1,"(6.171601,-75.427454)"
2019,Marzo,Kuwait,414,0,1,,1,"(10.445761,-75.516429)"
2019,Marzo,Kuwait,414,2,3,,5,"(4.697144,-74.140516)"
2019,Marzo,Kuwait,414,1,0,,1,"(6.171601,-75.427454)"
2019,Marzo,República Democrática Popular  Lao,418,1,2,,3,"(4.697144,-74.140516)"
2019,Marzo,Letonia,428,2,1,,3,"(4.697144,-74.140516)"
2019,Marzo,Lituania,440,0,1,,1,"(6.171601,-75.427454)"
2019,Marzo,Líbano,422,0,2,,2,"(10.408582,-75.538003)"
2019,Marzo,Líbano,422,0,2,,2,"(10.886611,-74.776708)"
2019,Marzo,Líbano,422,0,1,,1,"(12.586067,-81.702563)"
2019,Marzo,Líbano,422,1,0,,1,"(3.541112,-76.384584)"
2019,Marzo,Líbano,422,5,5,,10,"(4.697144,-74.140516)"
2019,Marzo,Liberia,430,0,1,,1,"(6.171601,-75.427454)"
2019,Marzo,Luxemburgo,442,1,0,,1,"(10.886611,-74.776708)"
2019,Marzo,Luxemburgo,442,6,5,,11,"(4.697144,-74.140516)"
2019,Marzo,Luxemburgo,442,0,2,,2,"(6.171601,-75.427454)"
2019,Marzo,Macao,446,0,1,,1,"(4.697144,-74.140516)"
2019,Marzo,Malasia,458,1,3,,4,"(4.697144,-74.140516)"
2019,Marzo,Malasia,458,2,0,,2,"(6.171601,-75.427454)"
2019,Marzo,Maldivas,462,1,0,,1,"(4.697144,-74.140516)"
2019,Marzo,Malta,470,1,0,,1,"(10.445761,-75.516429)"
2019,Marzo,Malta,470,4,2,,6,"(3.541112,-76.384584)"
2019,Marzo,Malta,470,35,23,,58,"(4.697144,-74.140516)"
2019,Marzo,Malta,470,0,1,,1,"(4.815061,-75.736532)"
2019,Marzo,Malta,470,1,3,,4,"(6.171601,-75.427454)"
2019,Marzo,Marruecos,504,1,0,,1,"(3.541112,-76.384584)"
2019,Marzo,Marruecos,504,9,4,,13,"(4.697144,-74.140516)"
2019,Marzo,Marruecos,504,1,0,,1,"(6.171601,-75.427454)"
2019,Marzo,México,484,44,37,,81,"(10.445761,-75.516429)"
2019,Marzo,México,484,160,149,,309,"(10.886611,-74.776708)"
2019,Marzo,México,484,1,0,,1,"(12.586067,-81.702563)"
2019,Marzo,México,484,818,689,,1507,"(3.541112,-76.384584)"
2019,Marzo,México,484,13610,12645,,26255,"(4.697144,-74.140516)"
2019,Marzo,México,484,122,97,,219,"(4.815061,-75.736532)"
2019,Marzo,México,484,2249,1806,,4055,"(6.171601,-75.427454)"
2019,Marzo,México,484,46,42,,88,"(7.128456,-73.183637)"
2019,Marzo,Mónaco,492,4,0,,4,"(4.697144,-74.140516)"
2019,Marzo,Montenegro,499,0,1,,1,"(4.697144,-74.140516)"
2019,Marzo,Micronesia,583,0,1,,1,"(4.697144,-74.140516)"
2019,Marzo,Mozambique,508,0,2,,2,"(4.697144,-74.140516)"
2019,Marzo,Nauru,520,1,0,,1,"(4.697144,-74.140516)"
2019,Marzo,Nauru,520,1,0,,1,"(6.171601,-75.427454)"
2019,Marzo,Nepal,524,1,0,,1,"(3.541112,-76.384584)"
2019,Marzo,Nepal,524,1,0,,1,"(4.697144,-74.140516)"
2019,Marzo,Nepal,524,1,1,,2,"(6.171601,-75.427454)"
2019,Marzo,Nicaragua,558,1,0,,1,"(10.445761,-75.516429)"
2019,Marzo,Nicaragua,558,4,1,,5,"(10.886611,-74.776708)"
2019,Marzo,Nicaragua,558,0,1,,1,"(10.971302,-74.765397)"
2019,Marzo,Nicaragua,558,0,4,,4,"(12.5744111,-81.703935)"
2019,Marzo,Nicaragua,558,6,18,,24,"(3.541112,-76.384584)"
2019,Marzo,Nicaragua,558,17,35,,52,"(4.697144,-74.140516)"
2019,Marzo,Nicaragua,558,4,3,,7,"(4.815061,-75.736532)"
2019,Marzo,Nicaragua,558,11,40,,51,"(6.171601,-75.427454)"
2019,Marzo,Nicaragua,558,0,2,,2,"(7.128456,-73.183637)"
2019,Marzo,Nigeria,566,0,2,,2,"(10.445761,-75.516429)"
2019,Marzo,Nigeria,566,1,5,,6,"(4.697144,-74.140516)"
2019,Marzo,Noruega,578,0,1,,1,"(10.886611,-74.776708)"
2019,Marzo,Noruega,578,2,2,,4,"(3.541112,-76.384584)"
2019,Marzo,Noruega,578,17,11,,28,"(4.697144,-74.140516)"
2019,Marzo,Noruega,578,2,2,,4,"(6.171601,-75.427454)"
2019,Marzo,Nueva Zelanda,554,4,4,,8,"(3.541112,-76.384584)"
2019,Marzo,Nueva Zelanda,554,49,38,,87,"(4.697144,-74.140516)"
2019,Marzo,Nueva Zelanda,554,1,1,,2,"(6.171601,-75.427454)"
2019,Marzo,Omán,512,0,2,,2,"(10.445761,-75.516429)"
2019,Marzo,Omán,512,4,2,,6,"(4.697144,-74.140516)"
2019,Marzo,Panamá,591,55,117,,172,"(10.408582,-75.538003)"
2019,Marzo,Panamá,591,1202,1017,,2219,"(10.445761,-75.516429)"
2019,Marzo,Panamá,591,1005,915,,1920,"(10.886611,-74.776708)"
2019,Marzo,Panamá,591,2,1,,3,"(11.247723,-74.213989)"
2019,Marzo,Panamá,591,0,17,,17,"(12.165168,-71.983761)"
2019,Marzo,Panamá,591,2,15,,17,"(12.5744111,-81.703935)"
2019,Marzo,Panamá,591,47,71,,118,"(12.586067,-81.702563)"
2019,Marzo,Panamá,591,1,0,,1,"(13.3387613,-81.372937)"
2019,Marzo,Panamá,591,2878,2375,,5253,"(3.541112,-76.384584)"
2019,Marzo,Panamá,591,6958,8161,,15119,"(4.697144,-74.140516)"
2019,Marzo,Panamá,591,661,439,,1100,"(4.815061,-75.736532)"
2019,Marzo,Panamá,591,0,2,,2,"(6.17134,-75.427194)"
2019,Marzo,Panamá,591,2889,2746,,5635,"(6.171601,-75.427454)"
2019,Marzo,Panamá,591,0,1,,1,"(6.228046,-77.404104)"
2019,Marzo,Panamá,591,8,21,,29,"(7.102626,-77.762647)"
2019,Marzo,Panamá,591,227,201,,428,"(7.128456,-73.183637)"
2019,Marzo,Panamá,591,0,15,,15,"(8.066966,-76.735404)"
2019,Marzo,Panamá,591,19,63,,82,"(8.635765,-77.346578)"
2019,Marzo,Paraguay,600,0,2,,2,"(0.814836,-77.662532)"
2019,Marzo,Paraguay,600,0,5,,5,"(10.445761,-75.516429)"
2019,Marzo,Paraguay,600,6,8,,14,"(10.886611,-74.776708)"
2019,Marzo,Paraguay,600,0,2,,2,"(12.586067,-81.702563)"
2019,Marzo,Paraguay,600,27,43,,70,"(3.541112,-76.384584)"
2019,Marzo,Paraguay,600,78,187,,265,"(4.697144,-74.140516)"
2019,Marzo,Paraguay,600,11,18,,29,"(4.815061,-75.736532)"
2019,Marzo,Paraguay,600,28,44,,72,"(6.171601,-75.427454)"
2019,Marzo,Paraguay,600,2,10,,12,"(7.128456,-73.183637)"
2019,Marzo,Perú,604,0,4,,4,"(-0.193180,-74.784874)"
2019,Marzo,Perú,604,5,12,,17,"(-4.197703,-69.941278)"
2019,Marzo,Perú,604,261,295,,556,"(-4.223468,-69.945098)"
2019,Marzo,Perú,604,7,10,,17,"(0.25129,-76.875963)"
2019,Marzo,Perú,604,31,49,,80,"(0.814836,-77.662532)"
2019,Marzo,Perú,604,46,52,,98,"(10.445761,-75.516429)"
2019,Marzo,Perú,604,27,15,,42,"(10.886611,-74.776708)"
2019,Marzo,Perú,604,0,2,,2,"(12.586067,-81.702563)"
2019,Marzo,Perú,604,663,670,,1333,"(3.541112,-76.384584)"
2019,Marzo,Perú,604,4952,5521,,10473,"(4.697144,-74.140516)"
2019,Marzo,Perú,604,33,29,,62,"(4.815061,-75.736532)"
2019,Marzo,Perú,604,858,856,,1714,"(6.171601,-75.427454)"
2019,Marzo,Perú,604,25,17,,42,"(7.128456,-73.183637)"
2019,Marzo,Polonia,616,8,23,,31,"(4.697144,-74.140516)"
2019,Marzo,Polonia,616,0,1,,1,"(4.815061,-75.736532)"
2019,Marzo,Polonia,616,1,0,,1,"(6.171601,-75.427454)"
2019,Marzo,Portugal,620,3,0,,3,"(3.541112,-76.384584)"
2019,Marzo,Portugal,620,77,65,,142,"(4.697144,-74.140516)"
2019,Marzo,Portugal,620,11,4,,15,"(6.171601,-75.427454)"
2019,Marzo,Polinesia Francesa/Colectividad de Ultramar Francesa,258,1,0,,1,"(1.813928,-78.763924)"
2019,Marzo,Polinesia Francesa/Colectividad de Ultramar Francesa,258,1,0,,1,"(3.541112,-76.384584)"
2019,Marzo,Puerto Rico/Territorio de Estados Unidos,630,3,10,,13,"(10.445761,-75.516429)"
2019,Marzo,Puerto Rico/Territorio de Estados Unidos,630,5,7,,12,"(10.886611,-74.776708)"
2019,Marzo,Puerto Rico/Territorio de Estados Unidos,630,28,20,,48,"(3.541112,-76.384584)"
2019,Marzo,Puerto Rico/Territorio de Estados Unidos,630,514,513,,1027,"(4.697144,-74.140516)"
2019,Marzo,Puerto Rico/Territorio de Estados Unidos,630,6,3,,9,"(4.815061,-75.736532)"
2019,Marzo,Puerto Rico/Territorio de Estados Unidos,630,36,32,,68,"(6.171601,-75.427454)"
2019,Marzo,Puerto Rico/Territorio de Estados Unidos,630,5,1,,6,"(7.128456,-73.183637)"
2019,Marzo,Qatar,634,6,1,,7,"(3.541112,-76.384584)"
2019,Marzo,Qatar,634,8,6,,14,"(4.697144,-74.140516)"
2019,Marzo,Qatar,634,0,1,,1,"(6.171601,-75.427454)"
2019,Marzo,Reino Unido de Gran Bretaña e Irlanda del Norte,826,0,1,,1,"(10.445761,-75.516429)"
2019,Marzo,Reino Unido de Gran Bretaña e Irlanda del Norte,826,5,1,,6,"(10.886611,-74.776708)"
2019,Marzo,Reino Unido de Gran Bretaña e Irlanda del Norte,826,8,14,,22,"(3.541112,-76.384584)"
2019,Marzo,Reino Unido de Gran Bretaña e Irlanda del Norte,826,1397,1117,,2514,"(4.697144,-74.140516)"
2019,Marzo,Reino Unido de Gran Bretaña e Irlanda del Norte,826,27,20,,47,"(6.171601,-75.427454)"
2019,Marzo,Reino Unido de Gran Bretaña e Irlanda del Norte,826,2,0,,2,"(7.128456,-73.183637)"
2019,Marzo,República CentroÁfricana,140,1,1,,2,"(4.697144,-74.140516)"
2019,Marzo,Federación de Rusia,643,0,2,,2,"(3.541112,-76.384584)"
2019,Marzo,Federación de Rusia,643,21,28,,49,"(4.697144,-74.140516)"
2019,Marzo,Federación de Rusia,643,0,2,,2,"(6.171601,-75.427454)"
2019,Marzo,República Dominicana,214,1,0,,1,"(10.408582,-75.538003)"
2019,Marzo,República Dominicana,214,21,27,,48,"(10.445761,-75.516429)"
2019,Marzo,República Dominicana,214,35,38,,73,"(10.886611,-74.776708)"
2019,Marzo,República Dominicana,214,10,12,,22,"(11.117806,-74.232622)"
2019,Marzo,República Dominicana,214,0,4,,4,"(12.586067,-81.702563)"
2019,Marzo,República Dominicana,214,91,79,,170,"(3.541112,-76.384584)"
2019,Marzo,República Dominicana,214,2298,2130,,4428,"(4.697144,-74.140516)"
2019,Marzo,República Dominicana,214,45,38,,83,"(4.815061,-75.736532)"
2019,Marzo,República Dominicana,214,264,199,,463,"(6.171601,-75.427454)"
2019,Marzo,República Dominicana,214,29,22,,51,"(7.128456,-73.183637)"
2019,Marzo,República Democrática Popular de Corea,408,0,1,,1,"(3.541112,-76.384584)"
2019,Marzo,República Democrática Popular de Corea,408,1,0,,1,"(4.697144,-74.140516)"
2019,Marzo,Rumania,642,4,4,,8,"(4.697144,-74.140516)"
2019,Marzo,Rwanda,646,1,0,,1,"(4.697144,-74.140516)"
2019,Marzo,San Cristóbal y Nevis,659,1,2,,3,"(3.541112,-76.384584)"
2019,Marzo,San  Vicente y las Granadinas,670,0,1,,1,"(4.697144,-74.140516)"
2019,Marzo,Santa Lucia,662,0,1,,1,"(4.697144,-74.140516)"
2019,Marzo,Santa Sede/Ciudad del Vaticano,336,0,1,,1,"(4.697144,-74.140516)"
2019,Marzo,Senegal,686,1,0,,1,"(4.697144,-74.140516)"
2019,Marzo,Serbia,688,1,2,,3,"(4.697144,-74.140516)"
2019,Marzo,Seychelles,690,1,0,,1,"(4.697144,-74.140516)"
2019,Marzo,Sierra Leona,694,1,0,,1,"(10.886611,-74.776708)"
2019,Marzo,Singapur,702,0,1,,1,"(10.445761,-75.516429)"
2019,Marzo,Singapur,702,16,27,,43,"(4.697144,-74.140516)"
2019,Marzo,Singapur,702,1,5,,6,"(6.171601,-75.427454)"
2019,Marzo,República Árabe Siria,760,1,0,,1,"(4.697144,-74.140516)"
2019,Marzo,Sri Lanka,144,1,1,,2,"(4.697144,-74.140516)"
2019,Marzo,Sudáfrica,710,0,1,,1,"(3.541112,-76.384584)"
2019,Marzo,Sudáfrica,710,6,7,,13,"(4.697144,-74.140516)"
2019,Marzo,Sudáfrica,710,3,2,,5,"(6.171601,-75.427454)"
2019,Marzo,Sudán,736,0,1,,1,"(4.697144,-74.140516)"
2019,Marzo,Suecia,752,2,0,,2,"(10.445761,-75.516429)"
2019,Marzo,Suecia,752,4,0,,4,"(10.886611,-74.776708)"
2019,Marzo,Suecia,752,17,12,,29,"(3.541112,-76.384584)"
2019,Marzo,Suecia,752,84,57,,141,"(4.697144,-74.140516)"
2019,Marzo,Suecia,752,3,3,,6,"(4.815061,-75.736532)"
2019,Marzo,Suecia,752,8,9,,17,"(6.171601,-75.427454)"
2019,Marzo,Suiza,756,0,1,,1,"(10.445761,-75.516429)"
2019,Marzo,Suiza,756,3,2,,5,"(10.886611,-74.776708)"
2019,Marzo,Suiza,756,34,15,,49,"(3.541112,-76.384584)"
2019,Marzo,Suiza,756,285,181,,466,"(4.697144,-74.140516)"
2019,Marzo,Suiza,756,1,0,,1,"(4.815061,-75.736532)"
2019,Marzo,Suiza,756,45,26,,71,"(6.171601,-75.427454)"
2019,Marzo,Surinam,740,8,9,,17,"(4.697144,-74.140516)"
2019,Marzo,Taiwán,158,1,0,,1,"(3.541112,-76.384584)"
2019,Marzo,Taiwán,158,6,10,,16,"(4.697144,-74.140516)"
2019,Marzo,Taiwán,158,1,0,,1,"(6.171601,-75.427454)"
2019,Marzo,Tailandia,764,25,28,,53,"(4.697144,-74.140516)"
2019,Marzo,Tailandia,764,1,2,,3,"(6.171601,-75.427454)"
2019,Marzo,Togo,768,1,1,,2,"(4.697144,-74.140516)"
2019,Marzo,Trinidad y Tobago,780,2,0,,2,"(10.445761,-75.516429)"
2019,Marzo,Trinidad y Tobago,780,2,3,,5,"(10.886611,-74.776708)"
2019,Marzo,Trinidad y Tobago,780,2,1,,3,"(12.586067,-81.702563)"
2019,Marzo,Trinidad y Tobago,780,4,10,,14,"(3.541112,-76.384584)"
2019,Marzo,Trinidad y Tobago,780,12,19,,31,"(4.697144,-74.140516)"
2019,Marzo,Trinidad y Tobago,780,0,3,,3,"(4.815061,-75.736532)"
2019,Marzo,Trinidad y Tobago,780,6,5,,11,"(6.171601,-75.427454)"
2019,Marzo,Trinidad y Tobago,780,0,6,,6,"(7.128456,-73.183637)"
2019,Marzo,Túnez,788,0,1,,1,"(4.697144,-74.140516)"
2019,Marzo,Turquía,792,786,473,,1259,"(4.697144,-74.140516)"
2019,Marzo,Turquía,792,15,9,,24,"(6.171601,-75.427454)"
2019,Marzo,Turkmenistán,795,3,2,,5,"(4.697144,-74.140516)"
2019,Marzo,Ucrania,804,1,2,,3,"(4.697144,-74.140516)"
2019,Marzo,Uruguay,858,4,4,,8,"(10.445761,-75.516429)"
2019,Marzo,Uruguay,858,1,2,,3,"(10.886611,-74.776708)"
2019,Marzo,Uruguay,858,35,57,,92,"(3.541112,-76.384584)"
2019,Marzo,Uruguay,858,149,154,,303,"(4.697144,-74.140516)"
2019,Marzo,Uruguay,858,6,8,,14,"(4.815061,-75.736532)"
2019,Marzo,Uruguay,858,48,34,,82,"(6.171601,-75.427454)"
2019,Marzo,Uruguay,858,6,1,,7,"(7.128456,-73.183637)"
2019,Marzo,Venezuela,862,7,16,,23,"(10.445761,-75.516429)"
2019,Marzo,Venezuela,862,30,21,,51,"(10.886611,-74.776708)"
2019,Marzo,Venezuela,862,782,937,,1719,"(11.360009,-72.129330)"
2019,Marzo,Venezuela,862,401,282,,683,"(3.541112,-76.384584)"
2019,Marzo,Venezuela,862,1,0,,1,"(3.866713,-67.927521)"
2019,Marzo,Venezuela,862,870,825,,1695,"(4.697144,-74.140516)"
2019,Marzo,Venezuela,862,1,0,,1,"(4.815061,-75.736532)"
2019,Marzo,Venezuela,862,410,408,,818,"(6.171601,-75.427454)"
2019,Marzo,Venezuela,862,14,16,,30,"(6.185799,-67.483929)"
2019,Marzo,Venezuela,862,9,20,,29,"(7.088729,-70.740253)"
2019,Marzo,Venezuela,862,7,4,,11,"(7.128456,-73.183637)"
2019,Marzo,Venezuela,862,58,65,,123,"(7.818934,-72.453226)"
2019,Marzo,Venezuela,862,1,1,,2,"(7.927209,-72.507910)"
2019,Marzo,Venezuela,862,1,6,,7,"(8.36068,-72.409396)"
2019,Marzo,Vietnam,704,0,1,,1,"(3.541112,-76.384584)"
2019,Marzo,Vietnam,704,2,1,,3,"(4.697144,-74.140516)"
2019,Marzo,Vietnam,704,0,1,,1,"(6.171601,-75.427454)"
2019,Marzo,Islas Vírgenes Británicas/Territorio Británico de Ultramar,92,1,1,,2,"(3.541112,-76.384584)"
2019,Marzo,Islas Vírgenes Británicas/Territorio Británico de Ultramar,92,0,1,,1,"(4.815061,-75.736532)"
2019,Marzo,Islas Vírgenes Estadounidenses/Territorio de Estados Unidos,850,1,20,,21,"(10.408582,-75.538003)"
2019,Marzo,Islas Vírgenes Estadounidenses/Territorio de Estados Unidos,850,0,2,,2,"(10.445761,-75.516429)"
2019,Marzo,Islas Vírgenes Estadounidenses/Territorio de Estados Unidos,850,1,1,,2,"(4.697144,-74.140516)"
2019,Abril,Afganistán,4,0,2,,2,"(4.697144,-74.140516)"
2019,Abril,Afganistán,4,0,1,,1,"(6.171601,-75.427454)"
2019,Abril,Albania,8,1,1,,2,"(4.697144,-74.140516)"
2019,Abril,Alemania,276,12,5,,17,"(10.445761,-75.516429)"
2019,Abril,Alemania,276,11,8,,19,"(10.886611,-74.776708)"
2019,Abril,Alemania,276,57,30,,87,"(3.541112,-76.384584)"
2019,Abril,Alemania,276,2679,2597,,5276,"(4.697144,-74.140516)"
2019,Abril,Alemania,276,0,1,,1,"(4.815061,-75.736532)"
2019,Abril,Alemania,276,57,44,,101,"(6.171601,-75.427454)"
2019,Abril,Alemania,276,0,1,,1,"(7.128456,-73.183637)"
2019,Abril,Andorra,20,4,3,,7,"(4.697144,-74.140516)"
2019,Abril,Andorra,20,1,1,,2,"(6.171601,-75.427454)"
2019,Abril,Angola,24,2,1,,3,"(4.697144,-74.140516)"
2019,Abril,Antigua y Barbuda,28,0,1,,1,"(10.886611,-74.776708)"
2019,Abril,Antigua y Barbuda,28,4,7,,11,"(4.697144,-74.140516)"
2019,Abril,Antigua y Barbuda,28,1,0,,1,"(6.171601,-75.427454)"
2019,Abril,Países Bajos,528,0,1,,1,"(10.408582,-75.538003)"
2019,Abril,Países Bajos,528,111,87,,198,"(10.445761,-75.516429)"
2019,Abril,Países Bajos,528,10,3,,13,"(10.886611,-74.776708)"
2019,Abril,Países Bajos,528,56,19,,75,"(3.541112,-76.384584)"
2019,Abril,Países Bajos,528,1241,1102,,2343,"(4.697144,-74.140516)"
2019,Abril,Países Bajos,528,7,4,,11,"(4.815061,-75.736532)"
2019,Abril,Países Bajos,528,95,83,,178,"(6.171601,-75.427454)"
2019,Abril,Arabia Saudita,682,0,1,,1,"(10.445761,-75.516429)"
2019,Abril,Arabia Saudita,682,1,1,,2,"(10.886611,-74.776708)"
2019,Abril,Arabia Saudita,682,9,36,,45,"(4.697144,-74.140516)"
2019,Abril,Arabia Saudita,682,1,2,,3,"(6.171601,-75.427454)"
2019,Abril,Argelia,12,4,10,,14,"(4.697144,-74.140516)"
2019,Abril,Argentina,32,2,1,,3,"(0.25129,-76.875963)"
2019,Abril,Argentina,32,10,19,,29,"(0.814836,-77.662532)"
2019,Abril,Argentina,32,26,23,,49,"(10.445761,-75.516429)"
2019,Abril,Argentina,32,52,30,,82,"(10.886611,-74.776708)"
2019,Abril,Argentina,32,0,1,,1,"(12.586067,-81.702563)"
2019,Abril,Argentina,32,191,202,,393,"(3.541112,-76.384584)"
2019,Abril,Argentina,32,1,4,,5,"(4.452882,-75.766298)"
2019,Abril,Argentina,32,2980,2867,,5847,"(4.697144,-74.140516)"
2019,Abril,Argentina,32,15,20,,35,"(4.815061,-75.736532)"
2019,Abril,Argentina,32,208,209,,417,"(6.171601,-75.427454)"
2019,Abril,Argentina,32,5,3,,8,"(7.128456,-73.183637)"
2019,Abril,República de Armenia,51,1,0,,1,"(4.697144,-74.140516)"
2019,Abril,Aruba,533,1215,858,,2073,"(10.408582,-75.538003)"
2019,Abril,Aruba,533,5,0,,5,"(10.445761,-75.516429)"
2019,Abril,Aruba,533,23,28,,51,"(10.886611,-74.776708)"
2019,Abril,Aruba,533,0,8,,8,"(11.117806,-74.232622)"
2019,Abril,Aruba,533,8,5,,13,"(11.247723,-74.213989)"
2019,Abril,Aruba,533,1,2,,3,"(11.528919,-72.919681)"
2019,Abril,Aruba,533,81,57,,138,"(3.541112,-76.384584)"
2019,Abril,Aruba,533,1845,1373,,3218,"(4.697144,-74.140516)"
2019,Abril,Aruba,533,7,5,,12,"(4.815061,-75.736532)"
2019,Abril,Aruba,533,84,50,,134,"(6.171601,-75.427454)"
2019,Abril,Aruba,533,16,49,,65,"(7.128456,-73.183637)"
2019,Abril,Australia,36,2,3,,5,"(10.445761,-75.516429)"
2019,Abril,Australia,36,4,2,,6,"(10.886611,-74.776708)"
2019,Abril,Australia,36,8,6,,14,"(3.541112,-76.384584)"
2019,Abril,Australia,36,394,342,,736,"(4.697144,-74.140516)"
2019,Abril,Australia,36,2,0,,2,"(4.815061,-75.736532)"
2019,Abril,Australia,36,31,20,,51,"(6.171601,-75.427454)"
2019,Abril,Australia,36,0,1,,1,"(7.128456,-73.183637)"
2019,Abril,Austria,40,2,1,,3,"(10.445761,-75.516429)"
2019,Abril,Austria,40,2,0,,2,"(10.886611,-74.776708)"
2019,Abril,Austria,40,5,2,,7,"(3.541112,-76.384584)"
2019,Abril,Austria,40,36,34,,70,"(4.697144,-74.140516)"
2019,Abril,Austria,40,8,6,,14,"(6.171601,-75.427454)"
2019,Abril,Austria,40,1,0,,1,"(7.128456,-73.183637)"
2019,Abril,Azerbaiyán,31,1,0,,1,"(6.171601,-75.427454)"
2019,Abril,Bahamas,44,3,2,,5,"(10.886611,-74.776708)"
2019,Abril,Bahamas,44,15,11,,26,"(3.541112,-76.384584)"
2019,Abril,Bahamas,44,30,40,,70,"(4.697144,-74.140516)"
2019,Abril,Bahamas,44,6,3,,9,"(4.815061,-75.736532)"
2019,Abril,Bahamas,44,33,14,,47,"(6.171601,-75.427454)"
2019,Abril,Bahréin,48,0,1,,1,"(3.541112,-76.384584)"
2019,Abril,Bahréin,48,3,1,,4,"(4.697144,-74.140516)"
2019,Abril,Bahréin,48,0,2,,2,"(6.171601,-75.427454)"
2019,Abril,Bangladesh,50,0,1,,1,"(4.697144,-74.140516)"
2019,Abril,Barbados,52,2,1,,3,"(10.886611,-74.776708)"
2019,Abril,Barbados,52,3,2,,5,"(3.541112,-76.384584)"
2019,Abril,Barbados,52,3,3,,6,"(4.697144,-74.140516)"
2019,Abril,Barbados,52,5,2,,7,"(6.171601,-75.427454)"
2019,Abril,Bélgica,56,2,3,,5,"(10.445761,-75.516429)"
2019,Abril,Bélgica,56,3,1,,4,"(10.886611,-74.776708)"
2019,Abril,Bélgica,56,10,7,,17,"(3.541112,-76.384584)"
2019,Abril,Bélgica,56,86,75,,161,"(4.697144,-74.140516)"
2019,Abril,Bélgica,56,14,11,,25,"(6.171601,-75.427454)"
2019,Abril,Belice,84,5,5,,10,"(3.541112,-76.384584)"
2019,Abril,Belice,84,12,21,,33,"(4.697144,-74.140516)"
2019,Abril,Belice,84,14,7,,21,"(6.171601,-75.427454)"
2019,Abril,Benín,204,0,1,,1,"(6.171601,-75.427454)"
2019,Abril,Bermudas/Territorio Británico de Ultramar,60,1,0,,1,"(4.815061,-75.736532)"
2019,Abril,Bolivia,68,1,7,,8,"(0.814836,-77.662532)"
2019,Abril,Bolivia,68,0,2,,2,"(10.445761,-75.516429)"
2019,Abril,Bolivia,68,1,1,,2,"(10.886611,-74.776708)"
2019,Abril,Bolivia,68,18,38,,56,"(3.541112,-76.384584)"
2019,Abril,Bolivia,68,433,677,,1110,"(4.697144,-74.140516)"
2019,Abril,Bolivia,68,5,5,,10,"(4.815061,-75.736532)"
2019,Abril,Bolivia,68,33,56,,89,"(6.171601,-75.427454)"
2019,Abril,Bosnia y Herzegovina,70,1,0,,1,"(4.697144,-74.140516)"
2019,Abril,Brasil,76,133,249,,382,"(-4.197703,-69.941278)"
2019,Abril,Brasil,76,27,43,,70,"(-4.223468,-69.945098)"
2019,Abril,Brasil,76,1,1,,2,"(0.25129,-76.875963)"
2019,Abril,Brasil,76,0,2,,2,"(0.814836,-77.662532)"
2019,Abril,Brasil,76,15,11,,26,"(10.445761,-75.516429)"
2019,Abril,Brasil,76,17,27,,44,"(10.886611,-74.776708)"
2019,Abril,Brasil,76,166,200,,366,"(3.541112,-76.384584)"
2019,Abril,Brasil,76,2843,3798,,6641,"(4.697144,-74.140516)"
2019,Abril,Brasil,76,31,50,,81,"(4.815061,-75.736532)"
2019,Abril,Brasil,76,204,240,,444,"(6.171601,-75.427454)"
2019,Abril,Brasil,76,6,3,,9,"(7.128456,-73.183637)"
2019,Abril,Bulgaria,100,2,1,,3,"(4.697144,-74.140516)"
2019,Abril,Cabo Verde,132,1,0,,1,"(4.697144,-74.140516)"
2019,Abril,Islas Caimán/Territorio Británico de Ultramar,136,1,1,,2,"(10.445761,-75.516429)"
2019,Abril,Islas Caimán/Territorio Británico de Ultramar,136,1,0,,1,"(10.886611,-74.776708)"
2019,Abril,Islas Caimán/Territorio Británico de Ultramar,136,4,1,,5,"(12.586067,-81.702563)"
2019,Abril,Islas Caimán/Territorio Británico de Ultramar,136,0,1,,1,"(3.541112,-76.384584)"
2019,Abril,Islas Caimán/Territorio Británico de Ultramar,136,4,2,,6,"(4.697144,-74.140516)"
2019,Abril,Islas Caimán/Territorio Británico de Ultramar,136,1,2,,3,"(6.171601,-75.427454)"
2019,Abril,Camboya,116,3,2,,5,"(4.697144,-74.140516)"
2019,Abril,Canadá,124,92,54,,146,"(10.445761,-75.516429)"
2019,Abril,Canadá,124,38,40,,78,"(10.886611,-74.776708)"
2019,Abril,Canadá,124,1,1,,2,"(12.586067,-81.702563)"
2019,Abril,Canadá,124,214,144,,358,"(3.541112,-76.384584)"
2019,Abril,Canadá,124,1,0,,1,"(4.452882,-75.766298)"
2019,Abril,Canadá,124,2212,1895,,4107,"(4.697144,-74.140516)"
2019,Abril,Canadá,124,21,21,,42,"(4.815061,-75.736532)"
2019,Abril,Canadá,124,292,255,,547,"(6.171601,-75.427454)"
2019,Abril,Canadá,124,15,12,,27,"(7.128456,-73.183637)"
2019,Abril,España,724,11,8,,19,"(10.445761,-75.516429)"
2019,Abril,España,724,22,12,,34,"(10.886611,-74.776708)"
2019,Abril,España,724,0,1,,1,"(12.586067,-81.702563)"
2019,Abril,España,724,2813,1905,,4718,"(3.541112,-76.384584)"
2019,Abril,España,724,15033,11805,,26838,"(4.697144,-74.140516)"
2019,Abril,España,724,10,7,,17,"(4.815061,-75.736532)"
2019,Abril,España,724,2363,1820,,4183,"(6.171601,-75.427454)"
2019,Abril,España,724,3,1,,4,"(7.128456,-73.183637)"
2019,Abril,Colombia,170,0,1,,1,"(1.813928,-78.763924)"
2019,Abril,Colombia,170,3,1,,4,"(10.445761,-75.516429)"
2019,Abril,Colombia,170,334,768,,1102,"(4.697144,-74.140516)"
2019,Abril,República Democrática del Congo,180,1,1,,2,"(4.697144,-74.140516)"
2019,Abril,República de Corea,410,21,9,,30,"(4.697144,-74.140516)"
2019,Abril,República de Corea,410,0,1,,1,"(6.171601,-75.427454)"
2019,Abril,Costa de Marfil,384,4,1,,5,"(4.697144,-74.140516)"
2019,Abril,Costa de Marfil,384,2,1,,3,"(6.171601,-75.427454)"
2019,Abril,Costa Rica,188,0,1,,1,"(10.408582,-75.538003)"
2019,Abril,Costa Rica,188,20,11,,31,"(10.445761,-75.516429)"
2019,Abril,Costa Rica,188,32,34,,66,"(10.886611,-74.776708)"
2019,Abril,Costa Rica,188,2,21,,23,"(12.5744111,-81.703935)"
2019,Abril,Costa Rica,188,6,3,,9,"(12.586067,-81.702563)"
2019,Abril,Costa Rica,188,66,90,,156,"(3.541112,-76.384584)"
2019,Abril,Costa Rica,188,910,1006,,1916,"(4.697144,-74.140516)"
2019,Abril,Costa Rica,188,23,15,,38,"(4.815061,-75.736532)"
2019,Abril,Costa Rica,188,142,135,,277,"(6.171601,-75.427454)"
2019,Abril,Costa Rica,188,7,4,,11,"(7.128456,-73.183637)"
2019,Abril,Croacia,191,6,4,,10,"(4.697144,-74.140516)"
2019,Abril,Croacia,191,1,1,,2,"(6.171601,-75.427454)"
2019,Abril,Cuba,192,6,13,,19,"(10.445761,-75.516429)"
2019,Abril,Cuba,192,29,26,,55,"(10.886611,-74.776708)"
2019,Abril,Cuba,192,2,1,,3,"(12.586067,-81.702563)"
2019,Abril,Cuba,192,118,101,,219,"(3.541112,-76.384584)"
2019,Abril,Cuba,192,1569,1340,,2909,"(4.697144,-74.140516)"
2019,Abril,Cuba,192,23,17,,40,"(4.815061,-75.736532)"
2019,Abril,Cuba,192,200,158,,358,"(6.171601,-75.427454)"
2019,Abril,Cuba,192,9,11,,20,"(7.128456,-73.183637)"
2019,Abril,Curazao,99999,3,3,,6,"(10.886611,-74.776708)"
2019,Abril,Curazao,99999,15,8,,23,"(3.541112,-76.384584)"
2019,Abril,Curazao,99999,874,753,,1627,"(4.697144,-74.140516)"
2019,Abril,Curazao,99999,1,1,,2,"(4.815061,-75.736532)"
2019,Abril,Curazao,99999,15,10,,25,"(6.171601,-75.427454)"
2019,Abril,Curazao,99999,4,2,,6,"(7.128456,-73.183637)"
2019,Abril,República Checa,203,4,1,,5,"(10.445761,-75.516429)"
2019,Abril,República Checa,203,13,9,,22,"(4.697144,-74.140516)"
2019,Abril,Chile,152,2,1,,3,"(0.25129,-76.875963)"
2019,Abril,Chile,152,199,139,,338,"(0.814836,-77.662532)"
2019,Abril,Chile,152,17,13,,30,"(10.445761,-75.516429)"
2019,Abril,Chile,152,46,20,,66,"(10.886611,-74.776708)"
2019,Abril,Chile,152,856,619,,1475,"(3.541112,-76.384584)"
2019,Abril,Chile,152,5145,4544,,9689,"(4.697144,-74.140516)"
2019,Abril,Chile,152,87,57,,144,"(4.815061,-75.736532)"
2019,Abril,Chile,152,283,244,,527,"(6.171601,-75.427454)"
2019,Abril,Chile,152,6,6,,12,"(7.128456,-73.183637)"
2019,Abril,Chile,152,0,2,,2,"(7.927209,-72.507910)"
2019,Abril,China,156,6,14,,20,"(10.445761,-75.516429)"
2019,Abril,China,156,3,6,,9,"(10.886611,-74.776708)"
2019,Abril,China,156,11,21,,32,"(3.541112,-76.384584)"
2019,Abril,China,156,245,619,,864,"(4.697144,-74.140516)"
2019,Abril,China,156,1,3,,4,"(4.815061,-75.736532)"
2019,Abril,China,156,21,87,,108,"(6.171601,-75.427454)"
2019,Abril,China,156,1,1,,2,"(7.128456,-73.183637)"
2019,Abril,Chipre,196,1,5,,6,"(4.697144,-74.140516)"
2019,Abril,Dinamarca,208,1,0,,1,"(0.814836,-77.662532)"
2019,Abril,Dinamarca,208,2,1,,3,"(3.541112,-76.384584)"
2019,Abril,Dinamarca,208,22,24,,46,"(4.697144,-74.140516)"
2019,Abril,Dinamarca,208,2,3,,5,"(6.171601,-75.427454)"
2019,Abril,Dinamarca,208,1,0,,1,"(7.128456,-73.183637)"
2019,Abril,Dominica,212,2,0,,2,"(3.541112,-76.384584)"
2019,Abril,Dominica,212,0,3,,3,"(4.697144,-74.140516)"
2019,Abril,Ecuador,218,1,3,,4,"(-0.193180,-74.784874)"
2019,Abril,Ecuador,218,898,1338,,2236,"(0.25129,-76.875963)"
2019,Abril,Ecuador,218,32,34,,66,"(0.812436,-77.847006)"
2019,Abril,Ecuador,218,6629,7435,,14064,"(0.814836,-77.662532)"
2019,Abril,Ecuador,218,214,175,,389,"(1.813928,-78.763924)"
2019,Abril,Ecuador,218,0,13,,13,"(10.408582,-75.538003)"
2019,Abril,Ecuador,218,1,4,,5,"(10.445761,-75.516429)"
2019,Abril,Ecuador,218,6,18,,24,"(10.886611,-74.776708)"
2019,Abril,Ecuador,218,454,497,,951,"(3.541112,-76.384584)"
2019,Abril,Ecuador,218,2886,3849,,6735,"(4.697144,-74.140516)"
2019,Abril,Ecuador,218,5,10,,15,"(4.815061,-75.736532)"
2019,Abril,Ecuador,218,82,93,,175,"(6.171601,-75.427454)"
2019,Abril,Ecuador,218,4,5,,9,"(7.128456,-73.183637)"
2019,Abril,Egipto,818,1,1,,2,"(3.541112,-76.384584)"
2019,Abril,Egipto,818,27,58,,85,"(4.697144,-74.140516)"
2019,Abril,Egipto,818,2,3,,5,"(6.171601,-75.427454)"
2019,Abril,El Salvador,222,21,14,,35,"(10.445761,-75.516429)"
2019,Abril,El Salvador,222,4,4,,8,"(10.886611,-74.776708)"
2019,Abril,El Salvador,222,141,124,,265,"(3.541112,-76.384584)"
2019,Abril,El Salvador,222,898,1145,,2043,"(4.697144,-74.140516)"
2019,Abril,El Salvador,222,2,0,,2,"(4.815061,-75.736532)"
2019,Abril,El Salvador,222,231,222,,453,"(6.171601,-75.427454)"
2019,Abril,Emiratos Árabes,784,4,3,,7,"(10.445761,-75.516429)"
2019,Abril,Emiratos Árabes,784,1,1,,2,"(10.886611,-74.776708)"
2019,Abril,Emiratos Árabes,784,11,8,,19,"(3.541112,-76.384584)"
2019,Abril,Emiratos Árabes,784,132,180,,312,"(4.697144,-74.140516)"
2019,Abril,Emiratos Árabes,784,12,7,,19,"(6.171601,-75.427454)"
2019,Abril,Emiratos Árabes,784,2,1,,3,"(7.128456,-73.183637)"
2019,Abril,Eritrea,232,0,1,,1,"(4.697144,-74.140516)"
2019,Abril,Eslovaquia,703,0,1,,1,"(3.541112,-76.384584)"
2019,Abril,Eslovaquia,703,2,1,,3,"(4.697144,-74.140516)"
2019,Abril,Eslovaquia,703,0,1,,1,"(6.171601,-75.427454)"
2019,Abril,Eslovenia,705,1,0,,1,"(6.171601,-75.427454)"
2019,Abril,Estados Unidos de América,840,2,2,,4,"(0.814836,-77.662532)"
2019,Abril,Estados Unidos de América,840,1,5,,6,"(10.408582,-75.538003)"
2019,Abril,Estados Unidos de América,840,0,3,,3,"(10.433609,-73.247863)"
2019,Abril,Estados Unidos de América,840,3795,3057,,6853,"(10.445761,-75.516429)"
2019,Abril,Estados Unidos de América,840,3509,2779,,6288,"(10.886611,-74.776708)"
2019,Abril,Estados Unidos de América,840,124,113,,237,"(11.117806,-74.232622)"
2019,Abril,Estados Unidos de América,840,33,32,,65,"(12.586067,-81.702563)"
2019,Abril,Estados Unidos de América,840,7431,5661,,13092,"(3.541112,-76.384584)"
2019,Abril,Estados Unidos de América,840,674,548,,1222,"(4.452882,-75.766298)"
2019,Abril,Estados Unidos de América,840,40034,34864,,74898,"(4.697144,-74.140516)"
2019,Abril,Estados Unidos de América,840,1542,1121,,2663,"(4.815061,-75.736532)"
2019,Abril,Estados Unidos de América,840,11430,9154,,20584,"(6.171601,-75.427454)"
2019,Abril,Estados Unidos de América,840,328,253,,581,"(7.128456,-73.183637)"
2019,Abril,Estonia,233,4,6,,10,"(4.697144,-74.140516)"
2019,Abril,Etiopia,231,1,5,,6,"(4.697144,-74.140516)"
2019,Abril,Etiopia,231,0,1,,1,"(6.171601,-75.427454)"
2019,Abril,Filipinas,608,1,0,,1,"(10.886611,-74.776708)"
2019,Abril,Filipinas,608,0,1,,1,"(3.541112,-76.384584)"
2019,Abril,Filipinas,608,2,4,,6,"(4.697144,-74.140516)"
2019,Abril,Finlandia,246,16,5,,21,"(4.697144,-74.140516)"
2019,Abril,Francia,250,1,0,,1,"(0.814836,-77.662532)"
2019,Abril,Francia,250,9,12,,21,"(10.445761,-75.516429)"
2019,Abril,Francia,250,5,9,,14,"(10.886611,-74.776708)"
2019,Abril,Francia,250,87,59,,146,"(3.541112,-76.384584)"
2019,Abril,Francia,250,1867,1656,,3523,"(4.697144,-74.140516)"
2019,Abril,Francia,250,4,4,,8,"(4.815061,-75.736532)"
2019,Abril,Francia,250,108,72,,180,"(6.171601,-75.427454)"
2019,Abril,Gabón,266,0,1,,1,"(4.697144,-74.140516)"
2019,Abril,Georgia,268,1,1,,2,"(4.697144,-74.140516)"
2019,Abril,Ghana,288,0,1,,1,"(3.541112,-76.384584)"
2019,Abril,Ghana,288,0,1,,1,"(4.697144,-74.140516)"
2019,Abril,Granada,308,0,1,,1,"(4.697144,-74.140516)"
2019,Abril,Grecia,300,4,2,,6,"(3.541112,-76.384584)"
2019,Abril,Grecia,300,25,18,,43,"(4.697144,-74.140516)"
2019,Abril,Grecia,300,1,1,,2,"(6.171601,-75.427454)"
2019,Abril,Guatemala,320,0,1,,1,"(1.813928,-78.763924)"
2019,Abril,Guatemala,320,1,0,,1,"(10.408582,-75.538003)"
2019,Abril,Guatemala,320,5,6,,11,"(10.445761,-75.516429)"
2019,Abril,Guatemala,320,7,18,,25,"(10.886611,-74.776708)"
2019,Abril,Guatemala,320,0,5,,5,"(12.586067,-81.702563)"
2019,Abril,Guatemala,320,57,74,,131,"(3.541112,-76.384584)"
2019,Abril,Guatemala,320,631,687,,1318,"(4.697144,-74.140516)"
2019,Abril,Guatemala,320,16,17,,33,"(4.815061,-75.736532)"
2019,Abril,Guatemala,320,103,131,,234,"(6.171601,-75.427454)"
2019,Abril,Guatemala,320,4,13,,17,"(7.128456,-73.183637)"
2019,Abril,Guyana,328,1,0,,1,"(10.445761,-75.516429)"
2019,Abril,Guyana,328,1,2,,3,"(10.886611,-74.776708)"
2019,Abril,Guyana,328,1,7,,8,"(3.541112,-76.384584)"
2019,Abril,Guyana,328,4,7,,11,"(4.697144,-74.140516)"
2019,Abril,Guyana,328,0,5,,5,"(4.815061,-75.736532)"
2019,Abril,Guyana,328,1,3,,4,"(6.171601,-75.427454)"
2019,Abril,Guinea Ecuatorial,226,0,1,,1,"(3.541112,-76.384584)"
2019,Abril,Guinea Ecuatorial,226,1,2,,3,"(4.697144,-74.140516)"
2019,Abril,Guinea Bissau,624,0,1,,1,"(4.697144,-74.140516)"
2019,Abril,Guadalupe/Territorio Francés,312,0,1,,1,"(3.541112,-76.384584)"
2019,Abril,Guadalupe/Territorio Francés,312,1,2,,3,"(4.697144,-74.140516)"
2019,Abril,Guayana Francesa/Departamento de Ultramar Francés,254,0,1,,1,"(10.886611,-74.776708)"
2019,Abril,Guayana Francesa/Departamento de Ultramar Francés,254,0,1,,1,"(3.541112,-76.384584)"
2019,Abril,Guayana Francesa/Departamento de Ultramar Francés,254,1,1,,2,"(4.697144,-74.140516)"
2019,Abril,Haití,332,0,1,,1,"(10.445761,-75.516429)"
2019,Abril,Haití,332,0,1,,1,"(10.886611,-74.776708)"
2019,Abril,Haití,332,0,2,,2,"(3.541112,-76.384584)"
2019,Abril,Haití,332,3,3,,6,"(4.697144,-74.140516)"
2019,Abril,Haití,332,1,2,,3,"(6.171601,-75.427454)"
2019,Abril,Honduras,340,1,11,,12,"(1.813928,-78.763924)"
2019,Abril,Honduras,340,0,5,,5,"(10.445761,-75.516429)"
2019,Abril,Honduras,340,8,15,,23,"(10.886611,-74.776708)"
2019,Abril,Honduras,340,25,39,,64,"(3.541112,-76.384584)"
2019,Abril,Honduras,340,62,154,,216,"(4.697144,-74.140516)"
2019,Abril,Honduras,340,4,2,,6,"(4.815061,-75.736532)"
2019,Abril,Honduras,340,40,55,,95,"(6.171601,-75.427454)"
2019,Abril,Honduras,340,1,6,,7,"(7.128456,-73.183637)"
2019,Abril,Hong Kong,344,2,0,,2,"(3.541112,-76.384584)"
2019,Abril,Hong Kong,344,27,49,,76,"(4.697144,-74.140516)"
2019,Abril,Hong Kong,344,1,6,,7,"(6.171601,-75.427454)"
2019,Abril,Hungría,348,8,4,,12,"(4.697144,-74.140516)"
2019,Abril,Hungría,348,1,1,,2,"(6.171601,-75.427454)"
2019,Abril,India,356,1,0,,1,"(10.408582,-75.538003)"
2019,Abril,India,356,20,20,,40,"(4.697144,-74.140516)"
2019,Abril,India,356,8,7,,15,"(6.171601,-75.427454)"
2019,Abril,Indonesia,360,9,6,,15,"(4.697144,-74.140516)"
2019,Abril,Iraq,368,0,2,,2,"(4.697144,-74.140516)"
2019,Abril,Iraq,368,1,0,,1,"(6.171601,-75.427454)"
2019,Abril,Irán,364,3,0,,3,"(4.697144,-74.140516)"
2019,Abril,República de Irlanda,372,10,9,,19,"(4.697144,-74.140516)"
2019,Abril,República de Irlanda,372,0,1,,1,"(6.171601,-75.427454)"
2019,Abril,Islandia,352,1,2,,3,"(4.697144,-74.140516)"
2019,Abril,Islandia,352,1,0,,1,"(6.171601,-75.427454)"
2019,Abril,Isla de Man,833,1,2,,3,"(4.697144,-74.140516)"
2019,Abril,Israel,376,0,1,,1,"(10.445761,-75.516429)"
2019,Abril,Israel,376,2,2,,4,"(10.886611,-74.776708)"
2019,Abril,Israel,376,8,4,,12,"(3.541112,-76.384584)"
2019,Abril,Israel,376,113,68,,181,"(4.697144,-74.140516)"
2019,Abril,Israel,376,10,8,,18,"(6.171601,-75.427454)"
2019,Abril,Italia,380,18,9,,27,"(10.445761,-75.516429)"
2019,Abril,Italia,380,13,1,,14,"(10.886611,-74.776708)"
2019,Abril,Italia,380,108,37,,145,"(3.541112,-76.384584)"
2019,Abril,Italia,380,688,451,,1139,"(4.697144,-74.140516)"
2019,Abril,Italia,380,0,1,,1,"(4.815061,-75.736532)"
2019,Abril,Italia,380,105,74,,179,"(6.171601,-75.427454)"
2019,Abril,Jamaica,388,1119,826,,1945,"(10.408582,-75.538003)"
2019,Abril,Jamaica,388,0,3,,3,"(10.445761,-75.516429)"
2019,Abril,Jamaica,388,11,8,,19,"(10.886611,-74.776708)"
2019,Abril,Jamaica,388,1,1,,2,"(12.586067,-81.702563)"
2019,Abril,Jamaica,388,6,6,,12,"(3.541112,-76.384584)"
2019,Abril,Jamaica,388,38,41,,79,"(4.697144,-74.140516)"
2019,Abril,Jamaica,388,1,2,,3,"(4.815061,-75.736532)"
2019,Abril,Jamaica,388,0,2,,2,"(6.17134,-75.427194)"
2019,Abril,Jamaica,388,13,18,,31,"(6.171601,-75.427454)"
2019,Abril,Jamaica,388,5,4,,9,"(7.128456,-73.183637)"
2019,Abril,Japón,392,1,1,,2,"(10.445761,-75.516429)"
2019,Abril,Japón,392,7,5,,12,"(3.541112,-76.384584)"
2019,Abril,Japón,392,129,139,,268,"(4.697144,-74.140516)"
2019,Abril,Japón,392,5,1,,6,"(4.815061,-75.736532)"
2019,Abril,Japón,392,11,5,,16,"(6.171601,-75.427454)"
2019,Abril,Jordania,400,2,1,,3,"(4.697144,-74.140516)"
2019,Abril,Kazajistán,398,1,2,,3,"(4.697144,-74.140516)"
2019,Abril,Kenia,404,2,7,,9,"(4.697144,-74.140516)"
2019,Abril,Kenia,404,0,1,,1,"(6.171601,-75.427454)"
2019,Abril,Kuwait,414,2,5,,7,"(4.697144,-74.140516)"
2019,Abril,República Democrática Popular  Lao,418,0,1,,1,"(4.697144,-74.140516)"
2019,Abril,Lesoto,426,1,0,,1,"(4.697144,-74.140516)"
2019,Abril,Lituania,440,0,1,,1,"(4.697144,-74.140516)"
2019,Abril,Líbano,422,3,1,,4,"(10.886611,-74.776708)"
2019,Abril,Líbano,422,1,1,,2,"(12.586067,-81.702563)"
2019,Abril,Líbano,422,6,11,,17,"(4.697144,-74.140516)"
2019,Abril,Liberia,430,0,1,,1,"(10.886611,-74.776708)"
2019,Abril,Liberia,430,1,2,,3,"(4.697144,-74.140516)"
2019,Abril,Liechtenstein,438,1,0,,1,"(6.171601,-75.427454)"
2019,Abril,Luxemburgo,442,2,0,,2,"(3.541112,-76.384584)"
2019,Abril,Luxemburgo,442,9,3,,12,"(4.697144,-74.140516)"
2019,Abril,Macao,446,0,1,,1,"(4.815061,-75.736532)"
2019,Abril,Malasia,458,3,4,,7,"(4.697144,-74.140516)"
2019,Abril,Malasia,458,0,3,,3,"(6.171601,-75.427454)"
2019,Abril,Maldivas,462,1,0,,1,"(4.697144,-74.140516)"
2019,Abril,Malta,470,4,0,,4,"(3.541112,-76.384584)"
2019,Abril,Malta,470,48,29,,77,"(4.697144,-74.140516)"
2019,Abril,Malta,470,0,2,,2,"(6.171601,-75.427454)"
2019,Abril,Marruecos,504,0,1,,1,"(10.886611,-74.776708)"
2019,Abril,Marruecos,504,0,1,,1,"(3.541112,-76.384584)"
2019,Abril,Marruecos,504,16,15,,31,"(4.697144,-74.140516)"
2019,Abril,Marruecos,504,5,3,,8,"(6.171601,-75.427454)"
2019,Abril,Mauritania,478,0,1,,1,"(4.697144,-74.140516)"
2019,Abril,Martinica/Departamento de Ultramar Francés,474,1,1,,2,"(4.697144,-74.140516)"
2019,Abril,Martinica/Departamento de Ultramar Francés,474,1,0,,1,"(4.815061,-75.736532)"
2019,Abril,México,484,79,55,,134,"(10.445761,-75.516429)"
2019,Abril,México,484,168,120,,288,"(10.886611,-74.776708)"
2019,Abril,México,484,7,3,,10,"(12.586067,-81.702563)"
2019,Abril,México,484,937,767,,1704,"(3.541112,-76.384584)"
2019,Abril,México,484,15982,13993,,29975,"(4.697144,-74.140516)"
2019,Abril,México,484,157,129,,286,"(4.815061,-75.736532)"
2019,Abril,México,484,2796,2227,,5023,"(6.171601,-75.427454)"
2019,Abril,México,484,79,66,,145,"(7.128456,-73.183637)"
2019,Abril,República de Moldavia,498,0,1,,1,"(4.697144,-74.140516)"
2019,Abril,Mónaco,492,2,1,,3,"(4.697144,-74.140516)"
2019,Abril,Mónaco,492,0,1,,1,"(6.171601,-75.427454)"
2019,Abril,Mozambique,508,1,1,,2,"(4.697144,-74.140516)"
2019,Abril,Myanmar,104,0,3,,3,"(4.697144,-74.140516)"
2019,Abril,Nauru,520,0,1,,1,"(4.697144,-74.140516)"
2019,Abril,Nepal,524,2,1,,3,"(4.697144,-74.140516)"
2019,Abril,Nicaragua,558,0,2,,2,"(10.445761,-75.516429)"
2019,Abril,Nicaragua,558,0,1,,1,"(10.886611,-74.776708)"
2019,Abril,Nicaragua,558,3,8,,11,"(12.5744111,-81.703935)"
2019,Abril,Nicaragua,558,1,1,,2,"(12.586067,-81.702563)"
2019,Abril,Nicaragua,558,6,21,,27,"(3.541112,-76.384584)"
2019,Abril,Nicaragua,558,26,44,,70,"(4.697144,-74.140516)"
2019,Abril,Nicaragua,558,2,0,,2,"(4.815061,-75.736532)"
2019,Abril,Nicaragua,558,13,37,,50,"(6.171601,-75.427454)"
2019,Abril,Nigeria,566,0,7,,7,"(4.697144,-74.140516)"
2019,Abril,Níger,562,1,1,,2,"(4.697144,-74.140516)"
2019,Abril,Noruega,578,1,1,,2,"(10.445761,-75.516429)"
2019,Abril,Noruega,578,1,0,,1,"(10.886611,-74.776708)"
2019,Abril,Noruega,578,1,1,,2,"(3.541112,-76.384584)"
2019,Abril,Noruega,578,24,21,,45,"(4.697144,-74.140516)"
2019,Abril,Noruega,578,1,2,,3,"(6.171601,-75.427454)"
2019,Abril,Nueva Zelanda,554,47,28,,75,"(4.697144,-74.140516)"
2019,Abril,Nueva Zelanda,554,5,3,,8,"(6.171601,-75.427454)"
2019,Abril,Omán,512,0,2,,2,"(10.445761,-75.516429)"
2019,Abril,Omán,512,1,1,,2,"(4.697144,-74.140516)"
2019,Abril,Papúa Nueva Guinea,598,0,1,,1,"(4.697144,-74.140516)"
2019,Abril,Panamá,591,136,164,,300,"(10.408582,-75.538003)"
2019,Abril,Panamá,591,1332,1125,,2457,"(10.445761,-75.516429)"
2019,Abril,Panamá,591,1011,895,,1906,"(10.886611,-74.776708)"
2019,Abril,Panamá,591,0,6,,6,"(12.165168,-71.983761)"
2019,Abril,Panamá,591,2,22,,24,"(12.5744111,-81.703935)"
2019,Abril,Panamá,591,47,77,,124,"(12.586067,-81.702563)"
2019,Abril,Panamá,591,0,2,,2,"(13.3387613,-81.372937)"
2019,Abril,Panamá,591,2716,2240,,4956,"(3.541112,-76.384584)"
2019,Abril,Panamá,591,7275,7939,,15214,"(4.697144,-74.140516)"
2019,Abril,Panamá,591,519,388,,907,"(4.815061,-75.736532)"
2019,Abril,Panamá,591,3166,2908,,6074,"(6.171601,-75.427454)"
2019,Abril,Panamá,591,1,4,,5,"(6.228046,-77.404104)"
2019,Abril,Panamá,591,12,36,,48,"(7.102626,-77.762647)"
2019,Abril,Panamá,591,184,146,,330,"(7.128456,-73.183637)"
2019,Abril,Panamá,591,23,63,,86,"(8.635765,-77.346578)"
2019,Abril,Paraguay,600,1,1,,2,"(0.814836,-77.662532)"
2019,Abril,Paraguay,600,5,3,,8,"(10.445761,-75.516429)"
2019,Abril,Paraguay,600,1,16,,17,"(10.886611,-74.776708)"
2019,Abril,Paraguay,600,0,1,,1,"(12.586067,-81.702563)"
2019,Abril,Paraguay,600,16,55,,71,"(3.541112,-76.384584)"
2019,Abril,Paraguay,600,87,167,,254,"(4.697144,-74.140516)"
2019,Abril,Paraguay,600,8,12,,20,"(4.815061,-75.736532)"
2019,Abril,Paraguay,600,18,36,,54,"(6.171601,-75.427454)"
2019,Abril,Paraguay,600,2,2,,4,"(7.128456,-73.183637)"
2019,Abril,Perú,604,55,38,,93,"(-0.193180,-74.784874)"
2019,Abril,Perú,604,24,21,,45,"(-4.197703,-69.941278)"
2019,Abril,Perú,604,235,233,,468,"(-4.223468,-69.945098)"
2019,Abril,Perú,604,2,3,,5,"(0.25129,-76.875963)"
2019,Abril,Perú,604,1,0,,1,"(0.812436,-77.847006)"
2019,Abril,Perú,604,99,109,,208,"(0.814836,-77.662532)"
2019,Abril,Perú,604,0,2,,2,"(1.813928,-78.763924)"
2019,Abril,Perú,604,56,54,,110,"(10.445761,-75.516429)"
2019,Abril,Perú,604,20,19,,39,"(10.886611,-74.776708)"
2019,Abril,Perú,604,0,1,,1,"(12.586067,-81.702563)"
2019,Abril,Perú,604,724,693,,1417,"(3.541112,-76.384584)"
2019,Abril,Perú,604,5908,6053,,11961,"(4.697144,-74.140516)"
2019,Abril,Perú,604,20,13,,33,"(4.815061,-75.736532)"
2019,Abril,Perú,604,1210,1031,,2241,"(6.171601,-75.427454)"
2019,Abril,Perú,604,2,4,,6,"(7.128456,-73.183637)"
2019,Abril,Palestina,99999,0,1,,1,"(4.697144,-74.140516)"
2019,Abril,Polonia,616,1,0,,1,"(3.541112,-76.384584)"
2019,Abril,Polonia,616,7,10,,17,"(4.697144,-74.140516)"
2019,Abril,Polonia,616,2,1,,3,"(6.171601,-75.427454)"
2019,Abril,Portugal,620,0,2,,2,"(10.445761,-75.516429)"
2019,Abril,Portugal,620,0,1,,1,"(10.886611,-74.776708)"
2019,Abril,Portugal,620,6,2,,8,"(3.541112,-76.384584)"
2019,Abril,Portugal,620,149,163,,312,"(4.697144,-74.140516)"
2019,Abril,Portugal,620,8,3,,11,"(6.171601,-75.427454)"
2019,Abril,Puerto Rico/Territorio de Estados Unidos,630,14,14,,28,"(10.445761,-75.516429)"
2019,Abril,Puerto Rico/Territorio de Estados Unidos,630,18,9,,27,"(10.886611,-74.776708)"
2019,Abril,Puerto Rico/Territorio de Estados Unidos,630,0,1,,1,"(12.586067,-81.702563)"
2019,Abril,Puerto Rico/Territorio de Estados Unidos,630,52,38,,90,"(3.541112,-76.384584)"
2019,Abril,Puerto Rico/Territorio de Estados Unidos,630,608,488,,1096,"(4.697144,-74.140516)"
2019,Abril,Puerto Rico/Territorio de Estados Unidos,630,4,3,,7,"(4.815061,-75.736532)"
2019,Abril,Puerto Rico/Territorio de Estados Unidos,630,71,57,,128,"(6.171601,-75.427454)"
2019,Abril,Puerto Rico/Territorio de Estados Unidos,630,9,4,,13,"(7.128456,-73.183637)"
2019,Abril,Qatar,634,1,1,,2,"(3.541112,-76.384584)"
2019,Abril,Qatar,634,6,8,,14,"(4.697144,-74.140516)"
2019,Abril,Qatar,634,7,4,,11,"(6.171601,-75.427454)"
2019,Abril,Reino Unido de Gran Bretaña e Irlanda del Norte,826,5,2,,7,"(10.445761,-75.516429)"
2019,Abril,Reino Unido de Gran Bretaña e Irlanda del Norte,826,1,0,,1,"(10.886611,-74.776708)"
2019,Abril,Reino Unido de Gran Bretaña e Irlanda del Norte,826,0,1,,1,"(11.117806,-74.232622)"
2019,Abril,Reino Unido de Gran Bretaña e Irlanda del Norte,826,28,22,,50,"(3.541112,-76.384584)"
2019,Abril,Reino Unido de Gran Bretaña e Irlanda del Norte,826,1663,1241,,2904,"(4.697144,-74.140516)"
2019,Abril,Reino Unido de Gran Bretaña e Irlanda del Norte,826,36,21,,57,"(6.171601,-75.427454)"
2019,Abril,Reino Unido de Gran Bretaña e Irlanda del Norte,826,1,0,,1,"(7.128456,-73.183637)"
2019,Abril,República CentroÁfricana,140,2,1,,3,"(4.697144,-74.140516)"
2019,Abril,Federación de Rusia,643,0,1,,1,"(3.541112,-76.384584)"
2019,Abril,Federación de Rusia,643,14,39,,53,"(4.697144,-74.140516)"
2019,Abril,Federación de Rusia,643,2,1,,3,"(6.171601,-75.427454)"
2019,Abril,República Dominicana,214,1,1,,2,"(10.408582,-75.538003)"
2019,Abril,República Dominicana,214,20,24,,44,"(10.445761,-75.516429)"
2019,Abril,República Dominicana,214,48,48,,96,"(10.886611,-74.776708)"
2019,Abril,República Dominicana,214,14,17,,31,"(11.117806,-74.232622)"
2019,Abril,República Dominicana,214,152,158,,310,"(3.541112,-76.384584)"
2019,Abril,República Dominicana,214,3378,3108,,6486,"(4.697144,-74.140516)"
2019,Abril,República Dominicana,214,65,52,,117,"(4.815061,-75.736532)"
2019,Abril,República Dominicana,214,346,285,,631,"(6.171601,-75.427454)"
2019,Abril,República Dominicana,214,35,32,,67,"(7.128456,-73.183637)"
2019,Abril,Reunión,638,2,0,,2,"(4.697144,-74.140516)"
2019,Abril,República Democrática Popular de Corea,408,2,1,,3,"(4.697144,-74.140516)"
2019,Abril,Rumania,642,3,5,,8,"(4.697144,-74.140516)"
2019,Abril,Rumania,642,0,1,,1,"(6.171601,-75.427454)"
2019,Abril,Rwanda,646,0,1,,1,"(4.697144,-74.140516)"
2019,Abril,San Cristóbal y Nevis,659,2,1,,3,"(4.815061,-75.736532)"
2019,Abril,San Marino,674,5,0,,5,"(3.541112,-76.384584)"
2019,Abril,Senegal,686,1,1,,2,"(4.697144,-74.140516)"
2019,Abril,Serbia,688,0,1,,1,"(10.445761,-75.516429)"
2019,Abril,Serbia,688,0,1,,1,"(4.697144,-74.140516)"
2019,Abril,Singapur,702,1,1,,2,"(3.541112,-76.384584)"
2019,Abril,Singapur,702,14,14,,28,"(4.697144,-74.140516)"
2019,Abril,Singapur,702,7,1,,8,"(6.171601,-75.427454)"
2019,Abril,Sri Lanka,144,1,0,,1,"(4.697144,-74.140516)"
2019,Abril,Sudáfrica,710,14,14,,28,"(4.697144,-74.140516)"
2019,Abril,Sudáfrica,710,1,1,,2,"(6.171601,-75.427454)"
2019,Abril,Sudán,736,0,1,,1,"(4.697144,-74.140516)"
2019,Abril,Suecia,752,2,1,,3,"(10.445761,-75.516429)"
2019,Abril,Suecia,752,4,2,,6,"(10.886611,-74.776708)"
2019,Abril,Suecia,752,9,10,,19,"(3.541112,-76.384584)"
2019,Abril,Suecia,752,51,33,,84,"(4.697144,-74.140516)"
2019,Abril,Suecia,752,9,7,,16,"(6.171601,-75.427454)"
2019,Abril,Suiza,756,6,0,,6,"(10.445761,-75.516429)"
2019,Abril,Suiza,756,2,0,,2,"(10.886611,-74.776708)"
2019,Abril,Suiza,756,27,21,,48,"(3.541112,-76.384584)"
2019,Abril,Suiza,756,259,156,,415,"(4.697144,-74.140516)"
2019,Abril,Suiza,756,21,16,,37,"(6.171601,-75.427454)"
2019,Abril,Surinam,740,1,8,,9,"(4.697144,-74.140516)"
2019,Abril,Taiwán,158,0,1,,1,"(10.886611,-74.776708)"
2019,Abril,Taiwán,158,5,4,,9,"(4.697144,-74.140516)"
2019,Abril,Tailandia,764,1,1,,2,"(3.541112,-76.384584)"
2019,Abril,Tailandia,764,14,11,,25,"(4.697144,-74.140516)"
2019,Abril,Tailandia,764,4,2,,6,"(6.171601,-75.427454)"
2019,Abril,Tanzania,834,2,3,,5,"(4.697144,-74.140516)"
2019,Abril,Trinidad y Tobago,780,0,1,,1,"(10.445761,-75.516429)"
2019,Abril,Trinidad y Tobago,780,4,6,,10,"(10.886611,-74.776708)"
2019,Abril,Trinidad y Tobago,780,1,4,,5,"(12.586067,-81.702563)"
2019,Abril,Trinidad y Tobago,780,1,5,,6,"(3.541112,-76.384584)"
2019,Abril,Trinidad y Tobago,780,24,31,,55,"(4.697144,-74.140516)"
2019,Abril,Trinidad y Tobago,780,1,8,,9,"(4.815061,-75.736532)"
2019,Abril,Trinidad y Tobago,780,5,2,,7,"(6.171601,-75.427454)"
2019,Abril,Trinidad y Tobago,780,0,5,,5,"(7.128456,-73.183637)"
2019,Abril,Trinidad y Tobago,780,1,3,,4,"(7.927209,-72.507910)"
2019,Abril,Túnez,788,7,4,,11,"(4.697144,-74.140516)"
2019,Abril,Turquía,792,2,0,,2,"(10.445761,-75.516429)"
2019,Abril,Turquía,792,20,17,,37,"(3.541112,-76.384584)"
2019,Abril,Turquía,792,1086,564,,1650,"(4.697144,-74.140516)"
2019,Abril,Turquía,792,30,18,,48,"(6.171601,-75.427454)"
2019,Abril,Turkmenistán,795,7,5,,12,"(4.697144,-74.140516)"
2019,Abril,Ucrania,804,0,3,,3,"(4.697144,-74.140516)"
2019,Abril,Uruguay,858,1,1,,2,"(0.814836,-77.662532)"
2019,Abril,Uruguay,858,2,2,,4,"(10.445761,-75.516429)"
2019,Abril,Uruguay,858,4,2,,6,"(10.886611,-74.776708)"
2019,Abril,Uruguay,858,14,30,,44,"(3.541112,-76.384584)"
2019,Abril,Uruguay,858,97,100,,197,"(4.697144,-74.140516)"
2019,Abril,Uruguay,858,6,6,,12,"(4.815061,-75.736532)"
2019,Abril,Uruguay,858,40,31,,71,"(6.171601,-75.427454)"
2019,Abril,Uruguay,858,3,1,,4,"(7.128456,-73.183637)"
2019,Abril,Venezuela,862,0,2,,2,"(10.433609,-73.247863)"
2019,Abril,Venezuela,862,10,20,,30,"(10.445761,-75.516429)"
2019,Abril,Venezuela,862,27,31,,58,"(10.886611,-74.776708)"
2019,Abril,Venezuela,862,0,3,,3,"(11.117806,-74.232622)"
2019,Abril,Venezuela,862,916,1069,,1985,"(11.360009,-72.129330)"
2019,Abril,Venezuela,862,311,218,,529,"(3.541112,-76.384584)"
2019,Abril,Venezuela,862,1,1,,2,"(3.866713,-67.927521)"
2019,Abril,Venezuela,862,893,896,,1789,"(4.697144,-74.140516)"
2019,Abril,Venezuela,862,4,3,,7,"(4.815061,-75.736532)"
2019,Abril,Venezuela,862,606,502,,1108,"(6.171601,-75.427454)"
2019,Abril,Venezuela,862,15,16,,31,"(6.185799,-67.483929)"
2019,Abril,Venezuela,862,34,26,,60,"(7.088729,-70.740253)"
2019,Abril,Venezuela,862,4,2,,6,"(7.128456,-73.183637)"
2019,Abril,Venezuela,862,107,116,,223,"(7.818934,-72.453226)"
2019,Abril,Venezuela,862,1,2,,3,"(7.927209,-72.507910)"
2019,Abril,Venezuela,862,19,18,,37,"(8.36068,-72.409396)"
2019,Abril,Vietnam,704,2,1,,3,"(3.541112,-76.384584)"
2019,Abril,Vietnam,704,8,10,,18,"(4.697144,-74.140516)"
2019,Abril,Islas Vírgenes Británicas/Territorio Británico de Ultramar,92,2,0,,2,"(4.697144,-74.140516)"
2019,Abril,Islas Vírgenes Estadounidenses/Territorio de Estados Unidos,850,1,0,,1,"(6.171601,-75.427454)"
2019,Abril,Islas Turcas y Caicos/Territorio Británico de Ultramar,796,3,1,,4,"(4.697144,-74.140516)"
2019,Mayo,Afganistán,4,2,4,,6,"(4.697144,-74.140516)"
2019,Mayo,Albania,8,1,5,,6,"(4.697144,-74.140516)"
2019,Mayo,Alemania,276,1,0,,1,"(0.25129,-76.875963)"
2019,Mayo,Alemania,276,0,1,,1,"(0.814836,-77.662532)"
2019,Mayo,Alemania,276,26,20,,46,"(10.445761,-75.516429)"
2019,Mayo,Alemania,276,12,12,,24,"(10.886611,-74.776708)"
2019,Mayo,Alemania,276,63,48,,111,"(3.541112,-76.384584)"
2019,Mayo,Alemania,276,2955,2759,,5714,"(4.697144,-74.140516)"
2019,Mayo,Alemania,276,83,82,,165,"(6.171601,-75.427454)"
2019,Mayo,Alemania,276,3,2,,5,"(7.128456,-73.183637)"
2019,Mayo,Andorra,20,2,0,,2,"(3.541112,-76.384584)"
2019,Mayo,Andorra,20,1,1,,2,"(4.697144,-74.140516)"
2019,Mayo,Andorra,20,2,1,,3,"(6.171601,-75.427454)"
2019,Mayo,Angola,24,0,6,,6,"(4.697144,-74.140516)"
2019,Mayo,Antigua y Barbuda,28,0,1,,1,"(3.541112,-76.384584)"
2019,Mayo,Antigua y Barbuda,28,4,4,,8,"(4.697144,-74.140516)"
2019,Mayo,Antigua y Barbuda,28,1,1,,2,"(6.171601,-75.427454)"
2019,Mayo,Países Bajos,528,0,1,,1,"(10.408582,-75.538003)"
2019,Mayo,Países Bajos,528,176,119,,295,"(10.445761,-75.516429)"
2019,Mayo,Países Bajos,528,15,13,,28,"(10.886611,-74.776708)"
2019,Mayo,Países Bajos,528,78,33,,111,"(3.541112,-76.384584)"
2019,Mayo,Países Bajos,528,1475,1246,,2721,"(4.697144,-74.140516)"
2019,Mayo,Países Bajos,528,5,1,,6,"(4.815061,-75.736532)"
2019,Mayo,Países Bajos,528,2,2,,4,"(6.17134,-75.427194)"
2019,Mayo,Países Bajos,528,128,87,,215,"(6.171601,-75.427454)"
2019,Mayo,Países Bajos,528,1,2,,3,"(7.128456,-73.183637)"
2019,Mayo,Arabia Saudita,682,1,0,,1,"(10.408582,-75.538003)"
2019,Mayo,Arabia Saudita,682,0,1,,1,"(3.541112,-76.384584)"
2019,Mayo,Arabia Saudita,682,7,31,,38,"(4.697144,-74.140516)"
2019,Mayo,Arabia Saudita,682,0,1,,1,"(6.171601,-75.427454)"
2019,Mayo,Argelia,12,4,5,,9,"(4.697144,-74.140516)"
2019,Mayo,Argelia,12,1,0,,1,"(6.171601,-75.427454)"
2019,Mayo,Argentina,32,7,10,,17,"(0.814836,-77.662532)"
2019,Mayo,Argentina,32,23,14,,37,"(10.445761,-75.516429)"
2019,Mayo,Argentina,32,45,30,,75,"(10.886611,-74.776708)"
2019,Mayo,Argentina,32,192,165,,357,"(3.541112,-76.384584)"
2019,Mayo,Argentina,32,2421,2408,,4829,"(4.697144,-74.140516)"
2019,Mayo,Argentina,32,16,23,,39,"(4.815061,-75.736532)"
2019,Mayo,Argentina,32,181,144,,325,"(6.171601,-75.427454)"
2019,Mayo,Argentina,32,1,0,,1,"(7.128456,-73.183637)"
2019,Mayo,Aruba,533,2210,1391,,3601,"(10.408582,-75.538003)"
2019,Mayo,Aruba,533,7,5,,12,"(10.445761,-75.516429)"
2019,Mayo,Aruba,533,5,9,,14,"(10.886611,-74.776708)"
2019,Mayo,Aruba,533,0,2,,2,"(11.117806,-74.232622)"
2019,Mayo,Aruba,533,0,2,,2,"(11.247723,-74.213989)"
2019,Mayo,Aruba,533,1,3,,4,"(11.528919,-72.919681)"
2019,Mayo,Aruba,533,53,28,,81,"(3.541112,-76.384584)"
2019,Mayo,Aruba,533,1994,1534,,3528,"(4.697144,-74.140516)"
2019,Mayo,Aruba,533,5,2,,7,"(4.815061,-75.736532)"
2019,Mayo,Aruba,533,2,2,,4,"(6.17134,-75.427194)"
2019,Mayo,Aruba,533,82,69,,151,"(6.171601,-75.427454)"
2019,Mayo,Aruba,533,8,31,,39,"(7.128456,-73.183637)"
2019,Mayo,Australia,36,1,0,,1,"(0.812436,-77.847006)"
2019,Mayo,Australia,36,2,2,,4,"(10.445761,-75.516429)"
2019,Mayo,Australia,36,0,1,,1,"(10.886611,-74.776708)"
2019,Mayo,Australia,36,9,5,,14,"(3.541112,-76.384584)"
2019,Mayo,Australia,36,444,356,,800,"(4.697144,-74.140516)"
2019,Mayo,Australia,36,0,2,,2,"(4.815061,-75.736532)"
2019,Mayo,Australia,36,26,27,,53,"(6.171601,-75.427454)"
2019,Mayo,Austria,40,3,4,,7,"(10.445761,-75.516429)"
2019,Mayo,Austria,40,0,2,,2,"(10.886611,-74.776708)"
2019,Mayo,Austria,40,3,3,,6,"(3.541112,-76.384584)"
2019,Mayo,Austria,40,52,54,,106,"(4.697144,-74.140516)"
2019,Mayo,Austria,40,6,3,,9,"(6.171601,-75.427454)"
2019,Mayo,Azerbaiyán,31,1,1,,2,"(4.697144,-74.140516)"
2019,Mayo,Bahamas,44,2,0,,2,"(10.445761,-75.516429)"
2019,Mayo,Bahamas,44,1,2,,3,"(10.886611,-74.776708)"
2019,Mayo,Bahamas,44,9,6,,15,"(3.541112,-76.384584)"
2019,Mayo,Bahamas,44,11,12,,23,"(4.697144,-74.140516)"
2019,Mayo,Bahamas,44,9,5,,14,"(4.815061,-75.736532)"
2019,Mayo,Bahamas,44,26,5,,31,"(6.171601,-75.427454)"
2019,Mayo,Bahamas,44,1,0,,1,"(7.128456,-73.183637)"
2019,Mayo,Bahréin,48,0,1,,1,"(10.445761,-75.516429)"
2019,Mayo,Bahréin,48,0,1,,1,"(3.541112,-76.384584)"
2019,Mayo,Bahréin,48,6,2,,8,"(4.697144,-74.140516)"
2019,Mayo,Barbados,52,2,0,,2,"(10.886611,-74.776708)"
2019,Mayo,Barbados,52,2,2,,4,"(3.541112,-76.384584)"
2019,Mayo,Barbados,52,10,7,,17,"(4.697144,-74.140516)"
2019,Mayo,Barbados,52,3,4,,7,"(6.171601,-75.427454)"
2019,Mayo,República de Belarús,112,1,1,,2,"(4.697144,-74.140516)"
2019,Mayo,Bélgica,56,2,3,,5,"(10.445761,-75.516429)"
2019,Mayo,Bélgica,56,1,1,,2,"(10.886611,-74.776708)"
2019,Mayo,Bélgica,56,9,4,,13,"(3.541112,-76.384584)"
2019,Mayo,Bélgica,56,84,55,,139,"(4.697144,-74.140516)"
2019,Mayo,Bélgica,56,32,14,,46,"(6.171601,-75.427454)"
2019,Mayo,Belice,84,0,1,,1,"(3.541112,-76.384584)"
2019,Mayo,Belice,84,6,9,,15,"(4.697144,-74.140516)"
2019,Mayo,Belice,84,3,3,,6,"(6.171601,-75.427454)"
2019,Mayo,Benín,204,1,0,,1,"(4.697144,-74.140516)"
2019,Mayo,Bermudas/Territorio Británico de Ultramar,60,0,1,,1,"(10.408582,-75.538003)"
2019,Mayo,Bermudas/Territorio Británico de Ultramar,60,1,0,,1,"(10.445761,-75.516429)"
2019,Mayo,Bermudas/Territorio Británico de Ultramar,60,2,0,,2,"(4.697144,-74.140516)"
2019,Mayo,Bermudas/Territorio Británico de Ultramar,60,1,0,,1,"(6.171601,-75.427454)"
2019,Mayo,Bolivia,68,1,0,,1,"(-4.197703,-69.941278)"
2019,Mayo,Bolivia,68,1,11,,12,"(0.814836,-77.662532)"
2019,Mayo,Bolivia,68,1,4,,5,"(10.445761,-75.516429)"
2019,Mayo,Bolivia,68,1,0,,1,"(10.886611,-74.776708)"
2019,Mayo,Bolivia,68,24,45,,69,"(3.541112,-76.384584)"
2019,Mayo,Bolivia,68,385,635,,1020,"(4.697144,-74.140516)"
2019,Mayo,Bolivia,68,8,8,,16,"(4.815061,-75.736532)"
2019,Mayo,Bolivia,68,22,63,,85,"(6.171601,-75.427454)"
2019,Mayo,Bolivia,68,0,1,,1,"(7.128456,-73.183637)"
2019,Mayo,Brasil,76,121,237,,358,"(-4.197703,-69.941278)"
2019,Mayo,Brasil,76,13,42,,55,"(-4.223468,-69.945098)"
2019,Mayo,Brasil,76,0,4,,4,"(0.814836,-77.662532)"
2019,Mayo,Brasil,76,8,12,,20,"(10.445761,-75.516429)"
2019,Mayo,Brasil,76,9,14,,23,"(10.886611,-74.776708)"
2019,Mayo,Brasil,76,133,186,,319,"(3.541112,-76.384584)"
2019,Mayo,Brasil,76,1,1,,2,"(3.866713,-67.927521)"
2019,Mayo,Brasil,76,2676,3572,,6248,"(4.697144,-74.140516)"
2019,Mayo,Brasil,76,21,26,,47,"(4.815061,-75.736532)"
2019,Mayo,Brasil,76,196,261,,457,"(6.171601,-75.427454)"
2019,Mayo,Brasil,76,1,1,,2,"(7.128456,-73.183637)"
2019,Mayo,Brunei Darussalam,96,1,0,,1,"(4.697144,-74.140516)"
2019,Mayo,Bulgaria,100,1,0,,1,"(10.445761,-75.516429)"
2019,Mayo,Bulgaria,100,2,1,,3,"(4.697144,-74.140516)"
2019,Mayo,Bulgaria,100,3,0,,3,"(6.171601,-75.427454)"
2019,Mayo,Burkina Faso,854,0,1,,1,"(6.171601,-75.427454)"
2019,Mayo,Islas Caimán/Territorio Británico de Ultramar,136,3,3,,6,"(10.445761,-75.516429)"
2019,Mayo,Islas Caimán/Territorio Británico de Ultramar,136,0,2,,2,"(12.5744111,-81.703935)"
2019,Mayo,Islas Caimán/Territorio Británico de Ultramar,136,0,2,,2,"(12.586067,-81.702563)"
2019,Mayo,Islas Caimán/Territorio Británico de Ultramar,136,1,1,,2,"(3.541112,-76.384584)"
2019,Mayo,Islas Caimán/Territorio Británico de Ultramar,136,5,2,,7,"(4.697144,-74.140516)"
2019,Mayo,Islas Caimán/Territorio Británico de Ultramar,136,2,0,,2,"(4.815061,-75.736532)"
2019,Mayo,Islas Caimán/Territorio Británico de Ultramar,136,1,1,,2,"(6.171601,-75.427454)"
2019,Mayo,Camboya,116,0,1,,1,"(4.697144,-74.140516)"
2019,Mayo,Camerún,120,0,2,,2,"(4.697144,-74.140516)"
2019,Mayo,Canadá,124,34,24,,58,"(10.445761,-75.516429)"
2019,Mayo,Canadá,124,36,28,,64,"(10.886611,-74.776708)"
2019,Mayo,Canadá,124,2,2,,4,"(12.586067,-81.702563)"
2019,Mayo,Canadá,124,209,141,,350,"(3.541112,-76.384584)"
2019,Mayo,Canadá,124,0,2,,2,"(4.452882,-75.766298)"
2019,Mayo,Canadá,124,2731,2213,,4944,"(4.697144,-74.140516)"
2019,Mayo,Canadá,124,22,9,,31,"(4.815061,-75.736532)"
2019,Mayo,Canadá,124,417,314,,731,"(6.171601,-75.427454)"
2019,Mayo,Canadá,124,25,16,,41,"(7.128456,-73.183637)"
2019,Mayo,España,724,43,33,,76,"(10.445761,-75.516429)"
2019,Mayo,España,724,23,16,,39,"(10.886611,-74.776708)"
2019,Mayo,España,724,0,1,,1,"(12.586067,-81.702563)"
2019,Mayo,España,724,3353,2348,,5701,"(3.541112,-76.384584)"
2019,Mayo,España,724,1,0,,1,"(4.452882,-75.766298)"
2019,Mayo,España,724,18461,14133,,32594,"(4.697144,-74.140516)"
2019,Mayo,España,724,18,15,,33,"(4.815061,-75.736532)"
2019,Mayo,España,724,3038,2208,,5246,"(6.171601,-75.427454)"
2019,Mayo,España,724,0,1,,1,"(7.128456,-73.183637)"
2019,Mayo,Colombia,170,2,4,,6,"(10.445761,-75.516429)"
2019,Mayo,Colombia,170,330,771,,1101,"(4.697144,-74.140516)"
2019,Mayo,República Del Congo,178,0,3,,3,"(4.697144,-74.140516)"
2019,Mayo,República Democrática del Congo,180,0,1,,1,"(3.541112,-76.384584)"
2019,Mayo,República de Corea,410,1,0,,1,"(3.541112,-76.384584)"
2019,Mayo,República de Corea,410,36,28,,64,"(4.697144,-74.140516)"
2019,Mayo,República de Corea,410,2,4,,6,"(6.171601,-75.427454)"
2019,Mayo,Costa de Marfil,384,3,3,,6,"(4.697144,-74.140516)"
2019,Mayo,Costa de Marfil,384,1,1,,2,"(6.171601,-75.427454)"
2019,Mayo,Costa Rica,188,15,13,,28,"(10.445761,-75.516429)"
2019,Mayo,Costa Rica,188,25,25,,50,"(10.886611,-74.776708)"
2019,Mayo,Costa Rica,188,2,18,,20,"(12.5744111,-81.703935)"
2019,Mayo,Costa Rica,188,5,2,,7,"(12.586067,-81.702563)"
2019,Mayo,Costa Rica,188,55,64,,119,"(3.541112,-76.384584)"
2019,Mayo,Costa Rica,188,843,1128,,1971,"(4.697144,-74.140516)"
2019,Mayo,Costa Rica,188,21,15,,36,"(4.815061,-75.736532)"
2019,Mayo,Costa Rica,188,0,3,,3,"(6.17134,-75.427194)"
2019,Mayo,Costa Rica,188,141,151,,292,"(6.171601,-75.427454)"
2019,Mayo,Costa Rica,188,4,2,,6,"(7.128456,-73.183637)"
2019,Mayo,Costa Rica,188,0,1,,1,"(8.635765,-77.346578)"
2019,Mayo,Croacia,191,4,2,,6,"(10.445761,-75.516429)"
2019,Mayo,Croacia,191,2,1,,3,"(3.541112,-76.384584)"
2019,Mayo,Croacia,191,12,9,,21,"(4.697144,-74.140516)"
2019,Mayo,Cuba,192,0,1,,1,"(10.408582,-75.538003)"
2019,Mayo,Cuba,192,10,11,,21,"(10.445761,-75.516429)"
2019,Mayo,Cuba,192,29,16,,45,"(10.886611,-74.776708)"
2019,Mayo,Cuba,192,52,41,,93,"(3.541112,-76.384584)"
2019,Mayo,Cuba,192,1406,1130,,2536,"(4.697144,-74.140516)"
2019,Mayo,Cuba,192,19,22,,41,"(4.815061,-75.736532)"
2019,Mayo,Cuba,192,165,127,,292,"(6.171601,-75.427454)"
2019,Mayo,Cuba,192,11,10,,21,"(7.128456,-73.183637)"
2019,Mayo,Curazao,99999,2,0,,2,"(10.445761,-75.516429)"
2019,Mayo,Curazao,99999,0,1,,1,"(10.886611,-74.776708)"
2019,Mayo,Curazao,99999,19,8,,27,"(3.541112,-76.384584)"
2019,Mayo,Curazao,99999,978,752,,1730,"(4.697144,-74.140516)"
2019,Mayo,Curazao,99999,1,3,,4,"(4.815061,-75.736532)"
2019,Mayo,Curazao,99999,21,14,,35,"(6.171601,-75.427454)"
2019,Mayo,República Checa,203,1,1,,2,"(10.445761,-75.516429)"
2019,Mayo,República Checa,203,1,1,,2,"(3.541112,-76.384584)"
2019,Mayo,República Checa,203,18,10,,28,"(4.697144,-74.140516)"
2019,Mayo,República Checa,203,4,0,,4,"(6.171601,-75.427454)"
2019,Mayo,Chile,152,0,1,,1,"(0.25129,-76.875963)"
2019,Mayo,Chile,152,121,134,,256,"(0.814836,-77.662532)"
2019,Mayo,Chile,152,1,0,,1,"(1.813928,-78.763924)"
2019,Mayo,Chile,152,17,17,,34,"(10.445761,-75.516429)"
2019,Mayo,Chile,152,55,40,,95,"(10.886611,-74.776708)"
2019,Mayo,Chile,152,1,0,,1,"(12.586067,-81.702563)"
2019,Mayo,Chile,152,761,526,,1287,"(3.541112,-76.384584)"
2019,Mayo,Chile,152,3956,3645,,7601,"(4.697144,-74.140516)"
2019,Mayo,Chile,152,68,73,,141,"(4.815061,-75.736532)"
2019,Mayo,Chile,152,296,275,,571,"(6.171601,-75.427454)"
2019,Mayo,Chile,152,9,12,,21,"(7.128456,-73.183637)"
2019,Mayo,China,156,1,10,,11,"(10.445761,-75.516429)"
2019,Mayo,China,156,0,2,,2,"(10.886611,-74.776708)"
2019,Mayo,China,156,10,10,,20,"(3.541112,-76.384584)"
2019,Mayo,China,156,226,422,,648,"(4.697144,-74.140516)"
2019,Mayo,China,156,29,75,,104,"(6.171601,-75.427454)"
2019,Mayo,Chipre,196,0,3,,3,"(3.541112,-76.384584)"
2019,Mayo,Chipre,196,1,2,,3,"(4.697144,-74.140516)"
2019,Mayo,Dinamarca,208,1,2,,3,"(10.445761,-75.516429)"
2019,Mayo,Dinamarca,208,1,1,,2,"(10.886611,-74.776708)"
2019,Mayo,Dinamarca,208,2,2,,4,"(3.541112,-76.384584)"
2019,Mayo,Dinamarca,208,35,22,,57,"(4.697144,-74.140516)"
2019,Mayo,Dinamarca,208,6,0,,6,"(6.171601,-75.427454)"
2019,Mayo,Dinamarca,208,1,1,,2,"(7.128456,-73.183637)"
2019,Mayo,Dominica,212,1,3,,4,"(3.541112,-76.384584)"
2019,Mayo,Dominica,212,6,7,,13,"(4.697144,-74.140516)"
2019,Mayo,Dominica,212,0,1,,1,"(4.815061,-75.736532)"
2019,Mayo,Dominica,212,0,2,,2,"(6.171601,-75.427454)"
2019,Mayo,Ecuador,218,9,7,,16,"(-0.193180,-74.784874)"
2019,Mayo,Ecuador,218,572,984,,1556,"(0.25129,-76.875963)"
2019,Mayo,Ecuador,218,30,32,,62,"(0.812436,-77.847006)"
2019,Mayo,Ecuador,218,5215,6530,,11745,"(0.814836,-77.662532)"
2019,Mayo,Ecuador,218,180,167,,347,"(1.813928,-78.763924)"
2019,Mayo,Ecuador,218,0,1,,1,"(10.408582,-75.538003)"
2019,Mayo,Ecuador,218,2,3,,5,"(10.445761,-75.516429)"
2019,Mayo,Ecuador,218,7,12,,19,"(10.886611,-74.776708)"
2019,Mayo,Ecuador,218,0,1,,1,"(12.586067,-81.702563)"
2019,Mayo,Ecuador,218,289,364,,653,"(3.541112,-76.384584)"
2019,Mayo,Ecuador,218,2556,3969,,6525,"(4.697144,-74.140516)"
2019,Mayo,Ecuador,218,4,4,,8,"(4.815061,-75.736532)"
2019,Mayo,Ecuador,218,74,95,,169,"(6.171601,-75.427454)"
2019,Mayo,Ecuador,218,44,16,,60,"(7.128456,-73.183637)"
2019,Mayo,Egipto,818,1,0,,1,"(3.541112,-76.384584)"
2019,Mayo,Egipto,818,26,18,,44,"(4.697144,-74.140516)"
2019,Mayo,Egipto,818,3,3,,6,"(6.171601,-75.427454)"
2019,Mayo,El Salvador,222,48,46,,94,"(10.445761,-75.516429)"
2019,Mayo,El Salvador,222,4,1,,5,"(10.886611,-74.776708)"
2019,Mayo,El Salvador,222,239,228,,467,"(3.541112,-76.384584)"
2019,Mayo,El Salvador,222,909,1280,,2189,"(4.697144,-74.140516)"
2019,Mayo,El Salvador,222,1,3,,4,"(4.815061,-75.736532)"
2019,Mayo,El Salvador,222,212,221,,433,"(6.171601,-75.427454)"
2019,Mayo,El Salvador,222,1,2,,3,"(7.128456,-73.183637)"
2019,Mayo,Emiratos Árabes,784,1,0,,1,"(10.445761,-75.516429)"
2019,Mayo,Emiratos Árabes,784,102,263,,365,"(4.697144,-74.140516)"
2019,Mayo,Emiratos Árabes,784,0,1,,1,"(4.815061,-75.736532)"
2019,Mayo,Emiratos Árabes,784,7,2,,9,"(6.171601,-75.427454)"
2019,Mayo,Eritrea,232,0,2,,2,"(4.697144,-74.140516)"
2019,Mayo,Eslovaquia,703,1,0,,1,"(3.541112,-76.384584)"
2019,Mayo,Eslovaquia,703,1,0,,1,"(4.697144,-74.140516)"
2019,Mayo,Eslovenia,705,1,1,,2,"(3.541112,-76.384584)"
2019,Mayo,Eslovenia,705,1,4,,5,"(4.697144,-74.140516)"
2019,Mayo,Eslovenia,705,1,0,,1,"(6.171601,-75.427454)"
2019,Mayo,Estados Unidos de América,840,3087,2440,,5527,"(10.445761,-75.516429)"
2019,Mayo,Estados Unidos de América,840,3205,2470,,5675,"(10.886611,-74.776708)"
2019,Mayo,Estados Unidos de América,840,43,27,,70,"(12.586067,-81.702563)"
2019,Mayo,Estados Unidos de América,840,7838,5444,,13282,"(3.541112,-76.384584)"
2019,Mayo,Estados Unidos de América,840,820,595,,1415,"(4.452882,-75.766298)"
2019,Mayo,Estados Unidos de América,840,37525,32706,,70232,"(4.697144,-74.140516)"
2019,Mayo,Estados Unidos de América,840,1534,890,,2424,"(4.815061,-75.736532)"
2019,Mayo,Estados Unidos de América,840,2,0,,2,"(6.17134,-75.427194)"
2019,Mayo,Estados Unidos de América,840,12049,9006,,21056,"(6.171601,-75.427454)"
2019,Mayo,Estados Unidos de América,840,345,247,,592,"(7.128456,-73.183637)"
2019,Mayo,Estonia,233,1,1,,2,"(4.697144,-74.140516)"
2019,Mayo,Estonia,233,1,0,,1,"(6.171601,-75.427454)"
2019,Mayo,Etiopia,231,1,2,,3,"(4.697144,-74.140516)"
2019,Mayo,Islas Fiji,242,1,1,,2,"(4.697144,-74.140516)"
2019,Mayo,Filipinas,608,1,0,,1,"(10.445761,-75.516429)"
2019,Mayo,Filipinas,608,7,5,,12,"(4.697144,-74.140516)"
2019,Mayo,Filipinas,608,1,0,,1,"(6.171601,-75.427454)"
2019,Mayo,Finlandia,246,2,0,,2,"(10.886611,-74.776708)"
2019,Mayo,Finlandia,246,8,16,,24,"(4.697144,-74.140516)"
2019,Mayo,Finlandia,246,2,3,,5,"(6.171601,-75.427454)"
2019,Mayo,Francia,250,18,14,,32,"(10.445761,-75.516429)"
2019,Mayo,Francia,250,13,6,,19,"(10.886611,-74.776708)"
2019,Mayo,Francia,250,111,65,,176,"(3.541112,-76.384584)"
2019,Mayo,Francia,250,2261,1937,,4198,"(4.697144,-74.140516)"
2019,Mayo,Francia,250,1,4,,5,"(4.815061,-75.736532)"
2019,Mayo,Francia,250,122,86,,208,"(6.171601,-75.427454)"
2019,Mayo,Francia,250,0,1,,1,"(7.128456,-73.183637)"
2019,Mayo,Gabón,266,0,1,,1,"(4.697144,-74.140516)"
2019,Mayo,Georgia,268,0,1,,1,"(4.697144,-74.140516)"
2019,Mayo,Ghana,288,0,2,,2,"(4.697144,-74.140516)"
2019,Mayo,Granada,308,0,1,,1,"(4.697144,-74.140516)"
2019,Mayo,Grecia,300,0,3,,3,"(10.445761,-75.516429)"
2019,Mayo,Grecia,300,5,1,,6,"(3.541112,-76.384584)"
2019,Mayo,Grecia,300,51,39,,90,"(4.697144,-74.140516)"
2019,Mayo,Grecia,300,0,2,,2,"(6.171601,-75.427454)"
2019,Mayo,Guatemala,320,6,9,,15,"(10.445761,-75.516429)"
2019,Mayo,Guatemala,320,6,8,,14,"(10.886611,-74.776708)"
2019,Mayo,Guatemala,320,0,3,,3,"(12.586067,-81.702563)"
2019,Mayo,Guatemala,320,1,0,,1,"(13.3387613,-81.372937)"
2019,Mayo,Guatemala,320,35,77,,112,"(3.541112,-76.384584)"
2019,Mayo,Guatemala,320,535,655,,1190,"(4.697144,-74.140516)"
2019,Mayo,Guatemala,320,6,12,,18,"(4.815061,-75.736532)"
2019,Mayo,Guatemala,320,95,118,,213,"(6.171601,-75.427454)"
2019,Mayo,Guatemala,320,2,1,,3,"(7.128456,-73.183637)"
2019,Mayo,Guyana,328,0,4,,4,"(10.886611,-74.776708)"
2019,Mayo,Guyana,328,0,1,,1,"(3.541112,-76.384584)"
2019,Mayo,Guyana,328,3,6,,9,"(4.697144,-74.140516)"
2019,Mayo,Guyana,328,0,3,,3,"(6.171601,-75.427454)"
2019,Mayo,Guinea,324,1,0,,1,"(4.697144,-74.140516)"
2019,Mayo,Guinea Ecuatorial,226,1,1,,2,"(4.697144,-74.140516)"
2019,Mayo,Guadalupe/Territorio Francés,312,0,2,,2,"(3.541112,-76.384584)"
2019,Mayo,Guadalupe/Territorio Francés,312,2,0,,2,"(4.697144,-74.140516)"
2019,Mayo,Guam/Territorio no incorporado de Estados Unidos,316,1,1,,2,"(0.25129,-76.875963)"
2019,Mayo,Guayana Francesa/Departamento de Ultramar Francés,254,1,0,,1,"(10.886611,-74.776708)"
2019,Mayo,Guayana Francesa/Departamento de Ultramar Francés,254,1,1,,2,"(4.697144,-74.140516)"
2019,Mayo,Haití,332,1,1,,2,"(10.886611,-74.776708)"
2019,Mayo,Haití,332,1,1,,2,"(3.541112,-76.384584)"
2019,Mayo,Haití,332,3,3,,6,"(4.697144,-74.140516)"
2019,Mayo,Haití,332,0,2,,2,"(6.171601,-75.427454)"
2019,Mayo,Honduras,340,2,3,,5,"(10.445761,-75.516429)"
2019,Mayo,Honduras,340,5,15,,20,"(10.886611,-74.776708)"
2019,Mayo,Honduras,340,1,3,,4,"(12.586067,-81.702563)"
2019,Mayo,Honduras,340,13,51,,64,"(3.541112,-76.384584)"
2019,Mayo,Honduras,340,65,147,,212,"(4.697144,-74.140516)"
2019,Mayo,Honduras,340,4,9,,13,"(4.815061,-75.736532)"
2019,Mayo,Honduras,340,42,80,,122,"(6.171601,-75.427454)"
2019,Mayo,Honduras,340,5,12,,17,"(7.128456,-73.183637)"
2019,Mayo,Hong Kong,344,0,1,,1,"(3.541112,-76.384584)"
2019,Mayo,Hong Kong,344,15,23,,38,"(4.697144,-74.140516)"
2019,Mayo,Hong Kong,344,0,1,,1,"(4.815061,-75.736532)"
2019,Mayo,Hungría,348,0,1,,1,"(10.445761,-75.516429)"
2019,Mayo,Hungría,348,1,0,,1,"(3.541112,-76.384584)"
2019,Mayo,Hungría,348,11,7,,18,"(4.697144,-74.140516)"
2019,Mayo,India,356,6,15,,21,"(4.697144,-74.140516)"
2019,Mayo,India,356,3,4,,7,"(6.171601,-75.427454)"
2019,Mayo,Indonesia,360,4,4,,8,"(4.697144,-74.140516)"
2019,Mayo,Indonesia,360,1,1,,2,"(6.171601,-75.427454)"
2019,Mayo,Iraq,368,0,3,,3,"(4.697144,-74.140516)"
2019,Mayo,Irán,364,2,1,,3,"(4.697144,-74.140516)"
2019,Mayo,República de Irlanda,372,1,0,,1,"(3.541112,-76.384584)"
2019,Mayo,República de Irlanda,372,10,9,,19,"(4.697144,-74.140516)"
2019,Mayo,República de Irlanda,372,2,1,,3,"(6.171601,-75.427454)"
2019,Mayo,Islandia,352,2,0,,2,"(3.541112,-76.384584)"
2019,Mayo,Islandia,352,3,5,,8,"(4.697144,-74.140516)"
2019,Mayo,Islandia,352,2,1,,3,"(6.171601,-75.427454)"
2019,Mayo,Israel,376,3,0,,3,"(10.445761,-75.516429)"
2019,Mayo,Israel,376,1,2,,3,"(10.886611,-74.776708)"
2019,Mayo,Israel,376,6,8,,14,"(3.541112,-76.384584)"
2019,Mayo,Israel,376,182,135,,317,"(4.697144,-74.140516)"
2019,Mayo,Israel,376,22,11,,33,"(6.171601,-75.427454)"
2019,Mayo,Italia,380,26,10,,36,"(10.445761,-75.516429)"
2019,Mayo,Italia,380,6,2,,8,"(10.886611,-74.776708)"
2019,Mayo,Italia,380,1,1,,2,"(12.586067,-81.702563)"
2019,Mayo,Italia,380,158,50,,208,"(3.541112,-76.384584)"
2019,Mayo,Italia,380,770,543,,1313,"(4.697144,-74.140516)"
2019,Mayo,Italia,380,3,2,,5,"(4.815061,-75.736532)"
2019,Mayo,Italia,380,154,102,,256,"(6.171601,-75.427454)"
2019,Mayo,Jamaica,388,2,1,,3,"(10.408582,-75.538003)"
2019,Mayo,Jamaica,388,2,3,,5,"(10.445761,-75.516429)"
2019,Mayo,Jamaica,388,13,5,,18,"(10.886611,-74.776708)"
2019,Mayo,Jamaica,388,11,5,,16,"(3.541112,-76.384584)"
2019,Mayo,Jamaica,388,68,54,,122,"(4.697144,-74.140516)"
2019,Mayo,Jamaica,388,3,5,,8,"(4.815061,-75.736532)"
2019,Mayo,Jamaica,388,22,16,,38,"(6.171601,-75.427454)"
2019,Mayo,Japón,392,0,1,,1,"(10.445761,-75.516429)"
2019,Mayo,Japón,392,0,1,,1,"(10.886611,-74.776708)"
2019,Mayo,Japón,392,1,1,,2,"(3.541112,-76.384584)"
2019,Mayo,Japón,392,83,109,,192,"(4.697144,-74.140516)"
2019,Mayo,Japón,392,1,0,,1,"(4.815061,-75.736532)"
2019,Mayo,Japón,392,14,23,,37,"(6.171601,-75.427454)"
2019,Mayo,Jordania,400,1,3,,4,"(4.697144,-74.140516)"
2019,Mayo,Kazajistán,398,0,2,,2,"(4.697144,-74.140516)"
2019,Mayo,Kenia,404,0,1,,1,"(3.541112,-76.384584)"
2019,Mayo,Kenia,404,4,4,,8,"(4.697144,-74.140516)"
2019,Mayo,Kenia,404,1,0,,1,"(6.171601,-75.427454)"
2019,Mayo,Kuwait,414,1,2,,3,"(4.697144,-74.140516)"
2019,Mayo,Kuwait,414,0,4,,4,"(6.171601,-75.427454)"
2019,Mayo,República Democrática Popular  Lao,418,0,3,,3,"(4.697144,-74.140516)"
2019,Mayo,República Democrática Popular  Lao,418,1,0,,1,"(6.171601,-75.427454)"
2019,Mayo,Lituania,440,0,1,,1,"(4.697144,-74.140516)"
2019,Mayo,Lituania,440,1,0,,1,"(6.171601,-75.427454)"
2019,Mayo,Líbano,422,0,1,,1,"(10.445761,-75.516429)"
2019,Mayo,Líbano,422,13,11,,24,"(10.886611,-74.776708)"
2019,Mayo,Líbano,422,19,11,,30,"(4.697144,-74.140516)"
2019,Mayo,Líbano,422,3,2,,5,"(6.171601,-75.427454)"
2019,Mayo,Líbano,422,2,1,,3,"(7.128456,-73.183637)"
2019,Mayo,Luxemburgo,442,0,1,,1,"(3.541112,-76.384584)"
2019,Mayo,Luxemburgo,442,9,9,,18,"(4.697144,-74.140516)"
2019,Mayo,Luxemburgo,442,1,0,,1,"(6.171601,-75.427454)"
2019,Mayo,Madagascar,450,0,2,,2,"(4.697144,-74.140516)"
2019,Mayo,Malasia,458,2,3,,5,"(4.697144,-74.140516)"
2019,Mayo,Malasia,458,1,0,,1,"(6.171601,-75.427454)"
2019,Mayo,Malí,466,0,1,,1,"(4.697144,-74.140516)"
2019,Mayo,Malta,470,1,1,,2,"(3.541112,-76.384584)"
2019,Mayo,Malta,470,28,23,,51,"(4.697144,-74.140516)"
2019,Mayo,Malta,470,4,3,,7,"(6.171601,-75.427454)"
2019,Mayo,Marruecos,504,1,0,,1,"(10.886611,-74.776708)"
2019,Mayo,Marruecos,504,0,1,,1,"(3.541112,-76.384584)"
2019,Mayo,Marruecos,504,13,6,,19,"(4.697144,-74.140516)"
2019,Mayo,Marruecos,504,5,2,,7,"(6.171601,-75.427454)"
2019,Mayo,Islas Marshall,584,0,1,,1,"(4.697144,-74.140516)"
2019,Mayo,Mauritania,478,0,1,,1,"(4.697144,-74.140516)"
2019,Mayo,Martinica/Departamento de Ultramar Francés,474,0,2,,2,"(4.697144,-74.140516)"
2019,Mayo,México,484,0,6,,6,"(10.408582,-75.538003)"
2019,Mayo,México,484,88,69,,157,"(10.445761,-75.516429)"
2019,Mayo,México,484,152,126,,278,"(10.886611,-74.776708)"
2019,Mayo,México,484,1,0,,1,"(12.586067,-81.702563)"
2019,Mayo,México,484,1007,836,,1843,"(3.541112,-76.384584)"
2019,Mayo,México,484,15983,13899,,29883,"(4.697144,-74.140516)"
2019,Mayo,México,484,162,113,,275,"(4.815061,-75.736532)"
2019,Mayo,México,484,3291,2537,,5828,"(6.171601,-75.427454)"
2019,Mayo,México,484,140,83,,223,"(7.128456,-73.183637)"
2019,Mayo,Mónaco,492,2,1,,3,"(4.697144,-74.140516)"
2019,Mayo,Montserrat/Territorio Británico de Ultramar,500,0,1,,1,"(4.697144,-74.140516)"
2019,Mayo,Micronesia,583,1,0,,1,"(6.171601,-75.427454)"
2019,Mayo,Mozambique,508,1,0,,1,"(4.697144,-74.140516)"
2019,Mayo,Nicaragua,558,1,11,,12,"(10.408582,-75.538003)"
2019,Mayo,Nicaragua,558,2,4,,6,"(10.445761,-75.516429)"
2019,Mayo,Nicaragua,558,3,2,,5,"(10.886611,-74.776708)"
2019,Mayo,Nicaragua,558,3,17,,20,"(3.541112,-76.384584)"
2019,Mayo,Nicaragua,558,19,43,,62,"(4.697144,-74.140516)"
2019,Mayo,Nicaragua,558,8,3,,11,"(4.815061,-75.736532)"
2019,Mayo,Nicaragua,558,17,46,,63,"(6.171601,-75.427454)"
2019,Mayo,Nicaragua,558,0,3,,3,"(7.128456,-73.183637)"
2019,Mayo,Nigeria,566,0,4,,4,"(4.697144,-74.140516)"
2019,Mayo,Noruega,578,2,1,,3,"(10.445761,-75.516429)"
2019,Mayo,Noruega,578,4,4,,8,"(3.541112,-76.384584)"
2019,Mayo,Noruega,578,19,17,,36,"(4.697144,-74.140516)"
2019,Mayo,Noruega,578,6,4,,10,"(6.171601,-75.427454)"
2019,Mayo,Noruega,578,1,0,,1,"(7.128456,-73.183637)"
2019,Mayo,Nueva Zelanda,554,1,1,,2,"(3.541112,-76.384584)"
2019,Mayo,Nueva Zelanda,554,29,23,,52,"(4.697144,-74.140516)"
2019,Mayo,Nueva Zelanda,554,0,1,,1,"(6.171601,-75.427454)"
2019,Mayo,Omán,512,0,1,,1,"(10.445761,-75.516429)"
2019,Mayo,Omán,512,1,2,,3,"(4.697144,-74.140516)"
2019,Mayo,Papúa Nueva Guinea,598,0,1,,1,"(4.697144,-74.140516)"
2019,Mayo,Panamá,591,0,5,,5,"(1.813928,-78.763924)"
2019,Mayo,Panamá,591,16,119,,135,"(10.408582,-75.538003)"
2019,Mayo,Panamá,591,1223,1096,,2319,"(10.445761,-75.516429)"
2019,Mayo,Panamá,591,802,707,,1509,"(10.886611,-74.776708)"
2019,Mayo,Panamá,591,0,3,,3,"(10.971302,-74.765397)"
2019,Mayo,Panamá,591,3,1,,4,"(11.247723,-74.213989)"
2019,Mayo,Panamá,591,3,18,,21,"(12.5744111,-81.703935)"
2019,Mayo,Panamá,591,45,74,,119,"(12.586067,-81.702563)"
2019,Mayo,Panamá,591,2667,2182,,4849,"(3.541112,-76.384584)"
2019,Mayo,Panamá,591,0,4,,4,"(3.893038,-77.067921)"
2019,Mayo,Panamá,591,7158,8080,,15238,"(4.697144,-74.140516)"
2019,Mayo,Panamá,591,471,310,,781,"(4.815061,-75.736532)"
2019,Mayo,Panamá,591,3054,2738,,5792,"(6.171601,-75.427454)"
2019,Mayo,Panamá,591,2,7,,9,"(6.228046,-77.404104)"
2019,Mayo,Panamá,591,2,15,,17,"(7.102626,-77.762647)"
2019,Mayo,Panamá,591,170,118,,288,"(7.128456,-73.183637)"
2019,Mayo,Panamá,591,0,16,,16,"(8.066966,-76.735404)"
2019,Mayo,Panamá,591,29,80,,109,"(8.635765,-77.346578)"
2019,Mayo,Paraguay,600,0,2,,2,"(10.445761,-75.516429)"
2019,Mayo,Paraguay,600,5,8,,13,"(10.886611,-74.776708)"
2019,Mayo,Paraguay,600,2,1,,3,"(12.586067,-81.702563)"
2019,Mayo,Paraguay,600,39,57,,96,"(3.541112,-76.384584)"
2019,Mayo,Paraguay,600,64,176,,240,"(4.697144,-74.140516)"
2019,Mayo,Paraguay,600,4,3,,7,"(4.815061,-75.736532)"
2019,Mayo,Paraguay,600,20,36,,56,"(6.171601,-75.427454)"
2019,Mayo,Paraguay,600,2,1,,3,"(7.128456,-73.183637)"
2019,Mayo,Perú,604,23,29,,52,"(-0.193180,-74.784874)"
2019,Mayo,Perú,604,7,16,,23,"(-4.197703,-69.941278)"
2019,Mayo,Perú,604,195,294,,489,"(-4.223468,-69.945098)"
2019,Mayo,Perú,604,3,4,,7,"(0.25129,-76.875963)"
2019,Mayo,Perú,604,1,1,,2,"(0.812436,-77.847006)"
2019,Mayo,Perú,604,60,83,,143,"(0.814836,-77.662532)"
2019,Mayo,Perú,604,0,3,,3,"(1.813928,-78.763924)"
2019,Mayo,Perú,604,43,65,,108,"(10.445761,-75.516429)"
2019,Mayo,Perú,604,15,15,,30,"(10.886611,-74.776708)"
2019,Mayo,Perú,604,0,1,,1,"(12.586067,-81.702563)"
2019,Mayo,Perú,604,513,552,,1065,"(3.541112,-76.384584)"
2019,Mayo,Perú,604,4950,5683,,10633,"(4.697144,-74.140516)"
2019,Mayo,Perú,604,15,2,,17,"(4.815061,-75.736532)"
2019,Mayo,Perú,604,982,1048,,2030,"(6.171601,-75.427454)"
2019,Mayo,Perú,604,6,8,,14,"(7.128456,-73.183637)"
2019,Mayo,Palestina,99999,0,1,,1,"(4.697144,-74.140516)"
2019,Mayo,Polonia,616,0,1,,1,"(10.886611,-74.776708)"
2019,Mayo,Polonia,616,0,1,,1,"(3.541112,-76.384584)"
2019,Mayo,Polonia,616,9,26,,35,"(4.697144,-74.140516)"
2019,Mayo,Polonia,616,0,2,,2,"(6.171601,-75.427454)"
2019,Mayo,Portugal,620,1,0,,1,"(10.445761,-75.516429)"
2019,Mayo,Portugal,620,1,2,,3,"(10.886611,-74.776708)"
2019,Mayo,Portugal,620,7,6,,13,"(3.541112,-76.384584)"
2019,Mayo,Portugal,620,156,181,,337,"(4.697144,-74.140516)"
2019,Mayo,Portugal,620,10,7,,17,"(6.171601,-75.427454)"
2019,Mayo,Puerto Rico/Territorio de Estados Unidos,630,15,7,,22,"(10.445761,-75.516429)"
2019,Mayo,Puerto Rico/Territorio de Estados Unidos,630,16,18,,34,"(10.886611,-74.776708)"
2019,Mayo,Puerto Rico/Territorio de Estados Unidos,630,32,17,,49,"(3.541112,-76.384584)"
2019,Mayo,Puerto Rico/Territorio de Estados Unidos,630,465,431,,896,"(4.697144,-74.140516)"
2019,Mayo,Puerto Rico/Territorio de Estados Unidos,630,9,8,,17,"(4.815061,-75.736532)"
2019,Mayo,Puerto Rico/Territorio de Estados Unidos,630,43,42,,85,"(6.171601,-75.427454)"
2019,Mayo,Puerto Rico/Territorio de Estados Unidos,630,4,5,,9,"(7.128456,-73.183637)"
2019,Mayo,Qatar,634,3,5,,8,"(4.697144,-74.140516)"
2019,Mayo,Qatar,634,3,3,,6,"(6.171601,-75.427454)"
2019,Mayo,Reino Unido de Gran Bretaña e Irlanda del Norte,826,5,2,,7,"(10.445761,-75.516429)"
2019,Mayo,Reino Unido de Gran Bretaña e Irlanda del Norte,826,1,1,,2,"(10.886611,-74.776708)"
2019,Mayo,Reino Unido de Gran Bretaña e Irlanda del Norte,826,22,23,,45,"(3.541112,-76.384584)"
2019,Mayo,Reino Unido de Gran Bretaña e Irlanda del Norte,826,1673,1257,,2930,"(4.697144,-74.140516)"
2019,Mayo,Reino Unido de Gran Bretaña e Irlanda del Norte,826,24,15,,39,"(6.171601,-75.427454)"
2019,Mayo,República CentroÁfricana,140,2,3,,5,"(4.697144,-74.140516)"
2019,Mayo,Federación de Rusia,643,1,2,,3,"(3.541112,-76.384584)"
2019,Mayo,Federación de Rusia,643,36,43,,79,"(4.697144,-74.140516)"
2019,Mayo,Federación de Rusia,643,9,12,,21,"(6.171601,-75.427454)"
2019,Mayo,República Dominicana,214,21,26,,48,"(10.445761,-75.516429)"
2019,Mayo,República Dominicana,214,52,39,,91,"(10.886611,-74.776708)"
2019,Mayo,República Dominicana,214,0,2,,2,"(11.117806,-74.232622)"
2019,Mayo,República Dominicana,214,156,139,,295,"(3.541112,-76.384584)"
2019,Mayo,República Dominicana,214,3122,2913,,6035,"(4.697144,-74.140516)"
2019,Mayo,República Dominicana,214,49,35,,84,"(4.815061,-75.736532)"
2019,Mayo,República Dominicana,214,411,285,,696,"(6.171601,-75.427454)"
2019,Mayo,República Dominicana,214,45,33,,78,"(7.128456,-73.183637)"
2019,Mayo,Rumania,642,1,0,,1,"(3.541112,-76.384584)"
2019,Mayo,Rumania,642,5,12,,17,"(4.697144,-74.140516)"
2019,Mayo,Rumania,642,4,3,,7,"(6.171601,-75.427454)"
2019,Mayo,San  Vicente y las Granadinas,670,0,1,,1,"(10.445761,-75.516429)"
2019,Mayo,San  Vicente y las Granadinas,670,2,2,,4,"(4.697144,-74.140516)"
2019,Mayo,Santa Lucia,662,1,0,,1,"(4.697144,-74.140516)"
2019,Mayo,Senegal,686,0,2,,2,"(4.697144,-74.140516)"
2019,Mayo,Serbia,688,2,4,,6,"(4.697144,-74.140516)"
2019,Mayo,Singapur,702,1,1,,2,"(3.541112,-76.384584)"
2019,Mayo,Singapur,702,14,18,,32,"(4.697144,-74.140516)"
2019,Mayo,Singapur,702,1,1,,2,"(6.171601,-75.427454)"
2019,Mayo,República Árabe Siria,760,1,0,,1,"(4.697144,-74.140516)"
2019,Mayo,Sudáfrica,710,7,3,,10,"(4.697144,-74.140516)"
2019,Mayo,Sudán,736,1,0,,1,"(4.697144,-74.140516)"
2019,Mayo,Suecia,752,1,2,,3,"(10.445761,-75.516429)"
2019,Mayo,Suecia,752,5,1,,6,"(10.886611,-74.776708)"
2019,Mayo,Suecia,752,15,26,,41,"(3.541112,-76.384584)"
2019,Mayo,Suecia,752,60,66,,126,"(4.697144,-74.140516)"
2019,Mayo,Suecia,752,3,2,,5,"(4.815061,-75.736532)"
2019,Mayo,Suecia,752,15,11,,26,"(6.171601,-75.427454)"
2019,Mayo,Suiza,756,12,8,,20,"(10.445761,-75.516429)"
2019,Mayo,Suiza,756,2,5,,7,"(10.886611,-74.776708)"
2019,Mayo,Suiza,756,42,18,,60,"(3.541112,-76.384584)"
2019,Mayo,Suiza,756,254,164,,418,"(4.697144,-74.140516)"
2019,Mayo,Suiza,756,31,39,,70,"(6.171601,-75.427454)"
2019,Mayo,Surinam,740,5,7,,12,"(4.697144,-74.140516)"
2019,Mayo,Taiwán,158,4,3,,7,"(4.697144,-74.140516)"
2019,Mayo,Taiwán,158,0,2,,2,"(6.171601,-75.427454)"
2019,Mayo,Tailandia,764,16,21,,37,"(4.697144,-74.140516)"
2019,Mayo,Tailandia,764,7,6,,13,"(6.171601,-75.427454)"
2019,Mayo,Tanzania,834,0,1,,1,"(3.541112,-76.384584)"
2019,Mayo,Tanzania,834,0,1,,1,"(4.697144,-74.140516)"
2019,Mayo,Trinidad y Tobago,780,0,3,,3,"(10.445761,-75.516429)"
2019,Mayo,Trinidad y Tobago,780,0,1,,1,"(10.886611,-74.776708)"
2019,Mayo,Trinidad y Tobago,780,9,3,,12,"(3.541112,-76.384584)"
2019,Mayo,Trinidad y Tobago,780,25,34,,59,"(4.697144,-74.140516)"
2019,Mayo,Trinidad y Tobago,780,3,2,,5,"(4.815061,-75.736532)"
2019,Mayo,Trinidad y Tobago,780,6,5,,11,"(6.171601,-75.427454)"
2019,Mayo,Trinidad y Tobago,780,5,7,,12,"(7.128456,-73.183637)"
2019,Mayo,Túnez,788,1,1,,2,"(4.697144,-74.140516)"
2019,Mayo,Turquía,792,3,1,,4,"(10.445761,-75.516429)"
2019,Mayo,Turquía,792,6,8,,14,"(3.541112,-76.384584)"
2019,Mayo,Turquía,792,1391,629,,2020,"(4.697144,-74.140516)"
2019,Mayo,Turquía,792,33,16,,49,"(6.171601,-75.427454)"
2019,Mayo,Turkmenistán,795,10,3,,13,"(4.697144,-74.140516)"
2019,Mayo,Ucrania,804,4,2,,6,"(4.697144,-74.140516)"
2019,Mayo,Uganda,800,0,1,,1,"(3.541112,-76.384584)"
2019,Mayo,Uganda,800,1,0,,1,"(4.697144,-74.140516)"
2019,Mayo,Uruguay,858,3,0,,3,"(10.445761,-75.516429)"
2019,Mayo,Uruguay,858,2,1,,3,"(10.886611,-74.776708)"
2019,Mayo,Uruguay,858,33,78,,111,"(3.541112,-76.384584)"
2019,Mayo,Uruguay,858,84,138,,222,"(4.697144,-74.140516)"
2019,Mayo,Uruguay,858,3,12,,15,"(4.815061,-75.736532)"
2019,Mayo,Uruguay,858,23,37,,60,"(6.171601,-75.427454)"
2019,Mayo,Vanuatu,548,1,0,,1,"(4.697144,-74.140516)"
2019,Mayo,Venezuela,862,5,2,,7,"(10.445761,-75.516429)"
2019,Mayo,Venezuela,862,23,29,,52,"(10.886611,-74.776708)"
2019,Mayo,Venezuela,862,0,1,,1,"(11.117806,-74.232622)"
2019,Mayo,Venezuela,862,930,1011,,1941,"(11.360009,-72.129330)"
2019,Mayo,Venezuela,862,0,1,,1,"(12.586067,-81.702563)"
2019,Mayo,Venezuela,862,368,259,,627,"(3.541112,-76.384584)"
2019,Mayo,Venezuela,862,2,2,,4,"(3.866713,-67.927521)"
2019,Mayo,Venezuela,862,710,755,,1465,"(4.697144,-74.140516)"
2019,Mayo,Venezuela,862,2,2,,4,"(4.815061,-75.736532)"
2019,Mayo,Venezuela,862,317,254,,571,"(6.171601,-75.427454)"
2019,Mayo,Venezuela,862,10,20,,30,"(6.185799,-67.483929)"
2019,Mayo,Venezuela,862,9,17,,26,"(7.088729,-70.740253)"
2019,Mayo,Venezuela,862,2,6,,8,"(7.128456,-73.183637)"
2019,Mayo,Venezuela,862,179,187,,366,"(7.818934,-72.453226)"
2019,Mayo,Venezuela,862,2,3,,5,"(7.927209,-72.507910)"
2019,Mayo,Venezuela,862,9,17,,26,"(8.36068,-72.409396)"
2019,Mayo,Vietnam,704,2,7,,9,"(4.697144,-74.140516)"
2019,Mayo,Vietnam,704,1,1,,2,"(6.171601,-75.427454)"
2019,Mayo,Islas Vírgenes Estadounidenses/Territorio de Estados Unidos,850,0,1,,1,"(10.445761,-75.516429)"
2019,Mayo,Islas Vírgenes Estadounidenses/Territorio de Estados Unidos,850,1,2,,3,"(4.697144,-74.140516)"
2019,Mayo,Zambia,894,0,1,,1,"(4.697144,-74.140516)"
2019,Mayo,Islas Turcas y Caicos/Territorio Británico de Ultramar,796,1,0,,1,"(4.697144,-74.140516)"
2019,Mayo,Islas Turcas y Caicos/Territorio Británico de Ultramar,796,1,0,,1,"(6.171601,-75.427454)"
2019,Junio,Afganistán,4,1,0,,1,"(10.408582,-75.538003)"
2019,Junio,Afganistán,4,0,2,,2,"(4.697144,-74.140516)"
2019,Junio,Afganistán,4,0,1,,1,"(6.171601,-75.427454)"
2019,Junio,Albania,8,2,3,,5,"(4.697144,-74.140516)"
2019,Junio,Alemania,276,1,1,,2,"(0.25129,-76.875963)"
2019,Junio,Alemania,276,25,12,,37,"(10.445761,-75.516429)"
2019,Junio,Alemania,276,49,26,,75,"(10.886611,-74.776708)"
2019,Junio,Alemania,276,109,69,,178,"(3.541112,-76.384584)"
2019,Junio,Alemania,276,3484,3249,,6733,"(4.697144,-74.140516)"
2019,Junio,Alemania,276,1,1,,2,"(4.815061,-75.736532)"
2019,Junio,Alemania,276,111,116,,227,"(6.171601,-75.427454)"
2019,Junio,Alemania,276,2,0,,2,"(7.128456,-73.183637)"
2019,Junio,Andorra,20,3,1,,4,"(4.697144,-74.140516)"
2019,Junio,Angola,24,1,1,,2,"(4.697144,-74.140516)"
2019,Junio,Antigua y Barbuda,28,0,1,,1,"(3.541112,-76.384584)"
2019,Junio,Antigua y Barbuda,28,1,4,,5,"(4.697144,-74.140516)"
2019,Junio,Antigua y Barbuda,28,0,1,,1,"(6.171601,-75.427454)"
2019,Junio,Países Bajos,528,191,122,,313,"(10.445761,-75.516429)"
2019,Junio,Países Bajos,528,27,19,,46,"(10.886611,-74.776708)"
2019,Junio,Países Bajos,528,70,34,,104,"(3.541112,-76.384584)"
2019,Junio,Países Bajos,528,1696,1415,,3111,"(4.697144,-74.140516)"
2019,Junio,Países Bajos,528,2,0,,2,"(4.815061,-75.736532)"
2019,Junio,Países Bajos,528,116,69,,185,"(6.171601,-75.427454)"
2019,Junio,Países Bajos,528,0,1,,1,"(7.128456,-73.183637)"
2019,Junio,Arabia Saudita,682,0,1,,1,"(10.445761,-75.516429)"
2019,Junio,Arabia Saudita,682,1,3,,4,"(3.541112,-76.384584)"
2019,Junio,Arabia Saudita,682,10,32,,42,"(4.697144,-74.140516)"
2019,Junio,Arabia Saudita,682,1,5,,6,"(6.171601,-75.427454)"
2019,Junio,Argelia,12,7,5,,12,"(4.697144,-74.140516)"
2019,Junio,Argentina,32,2,7,,9,"(0.814836,-77.662532)"
2019,Junio,Argentina,32,0,1,,1,"(1.813928,-78.763924)"
2019,Junio,Argentina,32,30,28,,58,"(10.445761,-75.516429)"
2019,Junio,Argentina,32,56,35,,91,"(10.886611,-74.776708)"
2019,Junio,Argentina,32,153,156,,309,"(3.541112,-76.384584)"
2019,Junio,Argentina,32,2600,2479,,5079,"(4.697144,-74.140516)"
2019,Junio,Argentina,32,20,19,,39,"(4.815061,-75.736532)"
2019,Junio,Argentina,32,161,160,,321,"(6.171601,-75.427454)"
2019,Junio,Argentina,32,2,4,,6,"(7.128456,-73.183637)"
2019,Junio,Aruba,533,4120,2848,,6968,"(10.408582,-75.538003)"
2019,Junio,Aruba,533,10,6,,16,"(10.445761,-75.516429)"
2019,Junio,Aruba,533,2,12,,14,"(10.886611,-74.776708)"
2019,Junio,Aruba,533,5,10,,15,"(11.528919,-72.919681)"
2019,Junio,Aruba,533,11,8,,19,"(3.541112,-76.384584)"
2019,Junio,Aruba,533,3056,2290,,5346,"(4.697144,-74.140516)"
2019,Junio,Aruba,533,3,4,,7,"(4.815061,-75.736532)"
2019,Junio,Aruba,533,57,45,,102,"(6.171601,-75.427454)"
2019,Junio,Aruba,533,17,46,,63,"(7.128456,-73.183637)"
2019,Junio,Australia,36,1,0,,1,"(10.408582,-75.538003)"
2019,Junio,Australia,36,2,1,,3,"(10.445761,-75.516429)"
2019,Junio,Australia,36,1,0,,1,"(10.886611,-74.776708)"
2019,Junio,Australia,36,6,3,,9,"(3.541112,-76.384584)"
2019,Junio,Australia,36,450,382,,832,"(4.697144,-74.140516)"
2019,Junio,Australia,36,17,13,,30,"(6.171601,-75.427454)"
2019,Junio,Australia,36,1,0,,1,"(7.128456,-73.183637)"
2019,Junio,Austria,40,3,1,,4,"(10.445761,-75.516429)"
2019,Junio,Austria,40,0,1,,1,"(10.886611,-74.776708)"
2019,Junio,Austria,40,8,5,,13,"(3.541112,-76.384584)"
2019,Junio,Austria,40,61,52,,113,"(4.697144,-74.140516)"
2019,Junio,Austria,40,13,4,,17,"(6.171601,-75.427454)"
2019,Junio,Bahamas,44,7,6,,13,"(10.445761,-75.516429)"
2019,Junio,Bahamas,44,1,1,,2,"(10.886611,-74.776708)"
2019,Junio,Bahamas,44,0,1,,1,"(12.586067,-81.702563)"
2019,Junio,Bahamas,44,19,19,,38,"(3.541112,-76.384584)"
2019,Junio,Bahamas,44,22,9,,31,"(4.697144,-74.140516)"
2019,Junio,Bahamas,44,8,6,,14,"(4.815061,-75.736532)"
2019,Junio,Bahamas,44,32,16,,48,"(6.171601,-75.427454)"
2019,Junio,Bahréin,48,2,1,,3,"(3.541112,-76.384584)"
2019,Junio,Bahréin,48,8,3,,11,"(4.697144,-74.140516)"
2019,Junio,Bahréin,48,2,0,,2,"(6.171601,-75.427454)"
2019,Junio,Bangladesh,50,1,0,,1,"(3.541112,-76.384584)"
2019,Junio,Bangladesh,50,1,0,,1,"(4.697144,-74.140516)"
2019,Junio,Barbados,52,1,0,,1,"(10.445761,-75.516429)"
2019,Junio,Barbados,52,1,4,,5,"(10.886611,-74.776708)"
2019,Junio,Barbados,52,1,1,,2,"(3.541112,-76.384584)"
2019,Junio,Barbados,52,2,4,,6,"(4.697144,-74.140516)"
2019,Junio,Barbados,52,1,0,,1,"(4.815061,-75.736532)"
2019,Junio,Barbados,52,2,2,,4,"(6.171601,-75.427454)"
2019,Junio,Barbados,52,0,1,,1,"(7.128456,-73.183637)"
2019,Junio,República de Belarús,112,3,1,,4,"(4.697144,-74.140516)"
2019,Junio,Bélgica,56,3,2,,5,"(10.445761,-75.516429)"
2019,Junio,Bélgica,56,3,2,,5,"(10.886611,-74.776708)"
2019,Junio,Bélgica,56,22,14,,36,"(3.541112,-76.384584)"
2019,Junio,Bélgica,56,122,96,,218,"(4.697144,-74.140516)"
2019,Junio,Bélgica,56,1,1,,2,"(4.815061,-75.736532)"
2019,Junio,Bélgica,56,33,28,,61,"(6.171601,-75.427454)"
2019,Junio,Belice,84,1,1,,2,"(12.586067,-81.702563)"
2019,Junio,Belice,84,1,1,,2,"(3.541112,-76.384584)"
2019,Junio,Belice,84,16,14,,30,"(4.697144,-74.140516)"
2019,Junio,Belice,84,4,6,,10,"(6.171601,-75.427454)"
2019,Junio,Bermudas/Territorio Británico de Ultramar,60,4,10,,14,"(4.697144,-74.140516)"
2019,Junio,Bermudas/Territorio Británico de Ultramar,60,2,2,,4,"(6.171601,-75.427454)"
2019,Junio,Bolivia,68,2,6,,8,"(0.814836,-77.662532)"
2019,Junio,Bolivia,68,0,2,,2,"(10.445761,-75.516429)"
2019,Junio,Bolivia,68,1,1,,2,"(10.886611,-74.776708)"
2019,Junio,Bolivia,68,10,28,,38,"(3.541112,-76.384584)"
2019,Junio,Bolivia,68,395,595,,990,"(4.697144,-74.140516)"
2019,Junio,Bolivia,68,4,7,,11,"(4.815061,-75.736532)"
2019,Junio,Bolivia,68,23,52,,75,"(6.171601,-75.427454)"
2019,Junio,Bosnia y Herzegovina,70,0,1,,1,"(4.697144,-74.140516)"
2019,Junio,Brasil,76,198,317,,515,"(-4.197703,-69.941278)"
2019,Junio,Brasil,76,41,71,,112,"(-4.223468,-69.945098)"
2019,Junio,Brasil,76,0,6,,6,"(0.814836,-77.662532)"
2019,Junio,Brasil,76,36,56,,92,"(10.445761,-75.516429)"
2019,Junio,Brasil,76,31,51,,82,"(10.886611,-74.776708)"
2019,Junio,Brasil,76,1,4,,5,"(12.586067,-81.702563)"
2019,Junio,Brasil,76,238,366,,604,"(3.541112,-76.384584)"
2019,Junio,Brasil,76,1,0,,1,"(3.866713,-67.927521)"
2019,Junio,Brasil,76,4521,7502,,12023,"(4.697144,-74.140516)"
2019,Junio,Brasil,76,37,72,,109,"(4.815061,-75.736532)"
2019,Junio,Brasil,76,391,677,,1068,"(6.171601,-75.427454)"
2019,Junio,Brasil,76,15,24,,39,"(7.128456,-73.183637)"
2019,Junio,Brunei Darussalam,96,1,0,,1,"(4.697144,-74.140516)"
2019,Junio,Bulgaria,100,1,0,,1,"(10.445761,-75.516429)"
2019,Junio,Bulgaria,100,3,7,,10,"(4.697144,-74.140516)"
2019,Junio,Bulgaria,100,1,2,,3,"(6.171601,-75.427454)"
2019,Junio,Cabo Verde,132,1,0,,1,"(4.697144,-74.140516)"
2019,Junio,Islas Caimán/Territorio Británico de Ultramar,136,1,1,,2,"(10.445761,-75.516429)"
2019,Junio,Islas Caimán/Territorio Británico de Ultramar,136,7,3,,10,"(12.586067,-81.702563)"
2019,Junio,Islas Caimán/Territorio Británico de Ultramar,136,5,3,,8,"(4.697144,-74.140516)"
2019,Junio,Islas Caimán/Territorio Británico de Ultramar,136,3,0,,3,"(6.171601,-75.427454)"
2019,Junio,Camboya,116,0,4,,4,"(4.697144,-74.140516)"
2019,Junio,Camerún,120,1,0,,1,"(4.697144,-74.140516)"
2019,Junio,Canadá,124,55,45,,100,"(10.445761,-75.516429)"
2019,Junio,Canadá,124,69,42,,111,"(10.886611,-74.776708)"
2019,Junio,Canadá,124,1,1,,2,"(12.586067,-81.702563)"
2019,Junio,Canadá,124,170,113,,283,"(3.541112,-76.384584)"
2019,Junio,Canadá,124,3789,2704,,6493,"(4.697144,-74.140516)"
2019,Junio,Canadá,124,13,12,,25,"(4.815061,-75.736532)"
2019,Junio,Canadá,124,564,435,,999,"(6.171601,-75.427454)"
2019,Junio,Canadá,124,8,4,,12,"(7.128456,-73.183637)"
2019,Junio,España,724,40,25,,65,"(10.445761,-75.516429)"
2019,Junio,España,724,22,17,,39,"(10.886611,-74.776708)"
2019,Junio,España,724,1,0,,1,"(12.586067,-81.702563)"
2019,Junio,España,724,3354,2251,,5605,"(3.541112,-76.384584)"
2019,Junio,España,724,20316,14998,,35314,"(4.697144,-74.140516)"
2019,Junio,España,724,17,6,,23,"(4.815061,-75.736532)"
2019,Junio,España,724,4726,3463,,8191,"(6.171601,-75.427454)"
2019,Junio,España,724,1,0,,1,"(7.128456,-73.183637)"
2019,Junio,Colombia,170,5,11,,16,"(10.445761,-75.516429)"
2019,Junio,Colombia,170,295,679,,974,"(4.697144,-74.140516)"
2019,Junio,República de Corea,410,2,0,,2,"(3.541112,-76.384584)"
2019,Junio,República de Corea,410,40,18,,58,"(4.697144,-74.140516)"
2019,Junio,República de Corea,410,3,4,,7,"(6.171601,-75.427454)"
2019,Junio,Costa de Marfil,384,6,4,,10,"(4.697144,-74.140516)"
2019,Junio,Costa de Marfil,384,2,1,,3,"(6.171601,-75.427454)"
2019,Junio,Costa Rica,188,13,6,,19,"(10.445761,-75.516429)"
2019,Junio,Costa Rica,188,11,25,,36,"(10.886611,-74.776708)"
2019,Junio,Costa Rica,188,1,10,,11,"(12.5744111,-81.703935)"
2019,Junio,Costa Rica,188,1,4,,5,"(12.586067,-81.702563)"
2019,Junio,Costa Rica,188,30,29,,59,"(3.541112,-76.384584)"
2019,Junio,Costa Rica,188,1281,1409,,2690,"(4.697144,-74.140516)"
2019,Junio,Costa Rica,188,13,8,,21,"(4.815061,-75.736532)"
2019,Junio,Costa Rica,188,99,117,,216,"(6.171601,-75.427454)"
2019,Junio,Costa Rica,188,4,1,,5,"(7.128456,-73.183637)"
2019,Junio,Croacia,191,4,2,,6,"(3.541112,-76.384584)"
2019,Junio,Croacia,191,19,16,,35,"(4.697144,-74.140516)"
2019,Junio,Croacia,191,2,5,,7,"(6.171601,-75.427454)"
2019,Junio,Cuba,192,14,13,,27,"(10.445761,-75.516429)"
2019,Junio,Cuba,192,13,20,,33,"(10.886611,-74.776708)"
2019,Junio,Cuba,192,2,3,,5,"(12.586067,-81.702563)"
2019,Junio,Cuba,192,47,43,,90,"(3.541112,-76.384584)"
2019,Junio,Cuba,192,1790,1441,,3231,"(4.697144,-74.140516)"
2019,Junio,Cuba,192,15,14,,29,"(4.815061,-75.736532)"
2019,Junio,Cuba,192,150,102,,252,"(6.171601,-75.427454)"
2019,Junio,Cuba,192,17,7,,24,"(7.128456,-73.183637)"
2019,Junio,Curazao,99999,1,1,,2,"(10.445761,-75.516429)"
2019,Junio,Curazao,99999,2,0,,2,"(10.886611,-74.776708)"
2019,Junio,Curazao,99999,0,1,,1,"(11.117806,-74.232622)"
2019,Junio,Curazao,99999,2,1,,3,"(12.586067,-81.702563)"
2019,Junio,Curazao,99999,4,2,,6,"(3.541112,-76.384584)"
2019,Junio,Curazao,99999,1212,919,,2131,"(4.697144,-74.140516)"
2019,Junio,Curazao,99999,1,1,,2,"(4.815061,-75.736532)"
2019,Junio,Curazao,99999,13,3,,16,"(6.171601,-75.427454)"
2019,Junio,República Checa,203,0,1,,1,"(10.445761,-75.516429)"
2019,Junio,República Checa,203,0,1,,1,"(10.886611,-74.776708)"
2019,Junio,República Checa,203,1,0,,1,"(3.541112,-76.384584)"
2019,Junio,República Checa,203,11,12,,23,"(4.697144,-74.140516)"
2019,Junio,Chile,152,0,1,,1,"(0.25129,-76.875963)"
2019,Junio,Chile,152,106,112,,218,"(0.814836,-77.662532)"
2019,Junio,Chile,152,0,2,,2,"(1.813928,-78.763924)"
2019,Junio,Chile,152,28,10,,38,"(10.445761,-75.516429)"
2019,Junio,Chile,152,45,41,,86,"(10.886611,-74.776708)"
2019,Junio,Chile,152,0,1,,1,"(12.586067,-81.702563)"
2019,Junio,Chile,152,651,423,,1074,"(3.541112,-76.384584)"
2019,Junio,Chile,152,4706,4320,,9026,"(4.697144,-74.140516)"
2019,Junio,Chile,152,81,45,,126,"(4.815061,-75.736532)"
2019,Junio,Chile,152,284,241,,525,"(6.171601,-75.427454)"
2019,Junio,Chile,152,3,1,,4,"(7.128456,-73.183637)"
2019,Junio,China,156,5,11,,16,"(10.445761,-75.516429)"
2019,Junio,China,156,4,1,,5,"(10.886611,-74.776708)"
2019,Junio,China,156,3,8,,11,"(3.541112,-76.384584)"
2019,Junio,China,156,180,300,,480,"(4.697144,-74.140516)"
2019,Junio,China,156,0,1,,1,"(4.815061,-75.736532)"
2019,Junio,China,156,25,59,,84,"(6.171601,-75.427454)"
2019,Junio,Chipre,196,1,0,,1,"(3.541112,-76.384584)"
2019,Junio,Chipre,196,2,3,,5,"(4.697144,-74.140516)"
2019,Junio,Chipre,196,0,1,,1,"(6.171601,-75.427454)"
2019,Junio,Dinamarca,208,1,2,,3,"(10.445761,-75.516429)"
2019,Junio,Dinamarca,208,2,2,,4,"(10.886611,-74.776708)"
2019,Junio,Dinamarca,208,3,1,,4,"(3.541112,-76.384584)"
2019,Junio,Dinamarca,208,40,28,,68,"(4.697144,-74.140516)"
2019,Junio,Dinamarca,208,7,5,,12,"(6.171601,-75.427454)"
2019,Junio,Dominica,212,0,1,,1,"(4.697144,-74.140516)"
2019,Junio,Ecuador,218,1,3,,4,"(-0.193180,-74.784874)"
2019,Junio,Ecuador,218,689,976,,1665,"(0.25129,-76.875963)"
2019,Junio,Ecuador,218,34,42,,76,"(0.812436,-77.847006)"
2019,Junio,Ecuador,218,6897,7689,,14586,"(0.814836,-77.662532)"
2019,Junio,Ecuador,218,181,149,,330,"(1.813928,-78.763924)"
2019,Junio,Ecuador,218,0,13,,13,"(10.408582,-75.538003)"
2019,Junio,Ecuador,218,3,6,,9,"(10.445761,-75.516429)"
2019,Junio,Ecuador,218,9,4,,13,"(10.886611,-74.776708)"
2019,Junio,Ecuador,218,436,461,,898,"(3.541112,-76.384584)"
2019,Junio,Ecuador,218,2764,3936,,6700,"(4.697144,-74.140516)"
2019,Junio,Ecuador,218,3,4,,7,"(4.815061,-75.736532)"
2019,Junio,Ecuador,218,32,54,,86,"(6.171601,-75.427454)"
2019,Junio,Ecuador,218,0,2,,2,"(7.128456,-73.183637)"
2019,Junio,Egipto,818,1,0,,1,"(3.541112,-76.384584)"
2019,Junio,Egipto,818,30,20,,50,"(4.697144,-74.140516)"
2019,Junio,Egipto,818,5,4,,9,"(6.171601,-75.427454)"
2019,Junio,El Salvador,222,2,0,,2,"(10.445761,-75.516429)"
2019,Junio,El Salvador,222,3,1,,4,"(10.886611,-74.776708)"
2019,Junio,El Salvador,222,8,6,,14,"(3.541112,-76.384584)"
2019,Junio,El Salvador,222,1224,1480,,2704,"(4.697144,-74.140516)"
2019,Junio,El Salvador,222,0,3,,3,"(4.815061,-75.736532)"
2019,Junio,El Salvador,222,193,206,,399,"(6.171601,-75.427454)"
2019,Junio,El Salvador,222,2,2,,4,"(7.128456,-73.183637)"
2019,Junio,Emiratos Árabes,784,5,2,,7,"(10.445761,-75.516429)"
2019,Junio,Emiratos Árabes,784,2,0,,2,"(3.541112,-76.384584)"
2019,Junio,Emiratos Árabes,784,147,204,,351,"(4.697144,-74.140516)"
2019,Junio,Emiratos Árabes,784,10,12,,22,"(6.171601,-75.427454)"
2019,Junio,Eritrea,232,1,2,,3,"(4.697144,-74.140516)"
2019,Junio,Eslovaquia,703,3,2,,5,"(4.697144,-74.140516)"
2019,Junio,Eslovenia,705,2,3,,5,"(4.697144,-74.140516)"
2019,Junio,Estados Unidos de América,840,15,179,,194,"(10.408582,-75.538003)"
2019,Junio,Estados Unidos de América,840,4444,3498,,7942,"(10.445761,-75.516429)"
2019,Junio,Estados Unidos de América,840,3435,2714,,6149,"(10.886611,-74.776708)"
2019,Junio,Estados Unidos de América,840,0,5,,5,"(11.117806,-74.232622)"
2019,Junio,Estados Unidos de América,840,68,63,,131,"(12.586067,-81.702563)"
2019,Junio,Estados Unidos de América,840,7870,5779,,13649,"(3.541112,-76.384584)"
2019,Junio,Estados Unidos de América,840,867,631,,1498,"(4.452882,-75.766298)"
2019,Junio,Estados Unidos de América,840,43241,35872,,79114,"(4.697144,-74.140516)"
2019,Junio,Estados Unidos de América,840,1409,851,,2260,"(4.815061,-75.736532)"
2019,Junio,Estados Unidos de América,840,15077,11570,,26649,"(6.171601,-75.427454)"
2019,Junio,Estados Unidos de América,840,387,276,,663,"(7.128456,-73.183637)"
2019,Junio,Estonia,233,7,2,,9,"(4.697144,-74.140516)"
2019,Junio,Estonia,233,0,1,,1,"(6.171601,-75.427454)"
2019,Junio,Etiopia,231,1,2,,3,"(4.697144,-74.140516)"
2019,Junio,Etiopia,231,1,0,,1,"(4.815061,-75.736532)"
2019,Junio,Filipinas,608,1,1,,2,"(3.541112,-76.384584)"
2019,Junio,Filipinas,608,2,6,,8,"(4.697144,-74.140516)"
2019,Junio,Finlandia,246,2,3,,5,"(10.445761,-75.516429)"
2019,Junio,Finlandia,246,2,1,,3,"(10.886611,-74.776708)"
2019,Junio,Finlandia,246,5,6,,11,"(3.541112,-76.384584)"
2019,Junio,Finlandia,246,10,17,,27,"(4.697144,-74.140516)"
2019,Junio,Finlandia,246,1,3,,4,"(6.171601,-75.427454)"
2019,Junio,Francia,250,18,7,,25,"(10.445761,-75.516429)"
2019,Junio,Francia,250,17,13,,30,"(10.886611,-74.776708)"
2019,Junio,Francia,250,100,52,,152,"(3.541112,-76.384584)"
2019,Junio,Francia,250,2616,2058,,4674,"(4.697144,-74.140516)"
2019,Junio,Francia,250,4,6,,10,"(4.815061,-75.736532)"
2019,Junio,Francia,250,179,127,,306,"(6.171601,-75.427454)"
2019,Junio,Gabón,266,1,2,,3,"(4.697144,-74.140516)"
2019,Junio,Georgia,268,0,4,,4,"(4.697144,-74.140516)"
2019,Junio,Ghana,288,1,3,,4,"(4.697144,-74.140516)"
2019,Junio,Grecia,300,1,0,,1,"(10.445761,-75.516429)"
2019,Junio,Grecia,300,2,0,,2,"(3.541112,-76.384584)"
2019,Junio,Grecia,300,68,44,,112,"(4.697144,-74.140516)"
2019,Junio,Grecia,300,19,13,,32,"(6.171601,-75.427454)"
2019,Junio,Guatemala,320,4,5,,9,"(10.445761,-75.516429)"
2019,Junio,Guatemala,320,14,3,,17,"(10.886611,-74.776708)"
2019,Junio,Guatemala,320,0,1,,1,"(11.117806,-74.232622)"
2019,Junio,Guatemala,320,22,26,,48,"(3.541112,-76.384584)"
2019,Junio,Guatemala,320,582,707,,1289,"(4.697144,-74.140516)"
2019,Junio,Guatemala,320,10,8,,18,"(4.815061,-75.736532)"
2019,Junio,Guatemala,320,83,78,,161,"(6.171601,-75.427454)"
2019,Junio,Guatemala,320,7,2,,9,"(7.128456,-73.183637)"
2019,Junio,Guyana,328,0,2,,2,"(10.886611,-74.776708)"
2019,Junio,Guyana,328,2,0,,2,"(3.541112,-76.384584)"
2019,Junio,Guyana,328,2,9,,11,"(4.697144,-74.140516)"
2019,Junio,Guyana,328,0,2,,2,"(4.815061,-75.736532)"
2019,Junio,Guyana,328,0,1,,1,"(6.171601,-75.427454)"
2019,Junio,Guyana,328,0,1,,1,"(7.128456,-73.183637)"
2019,Junio,Guinea Ecuatorial,226,1,1,,2,"(3.541112,-76.384584)"
2019,Junio,Guinea Ecuatorial,226,0,1,,1,"(4.697144,-74.140516)"
2019,Junio,Guinea Ecuatorial,226,0,1,,1,"(6.171601,-75.427454)"
2019,Junio,Guadalupe/Territorio Francés,312,1,0,,1,"(10.445761,-75.516429)"
2019,Junio,Guadalupe/Territorio Francés,312,0,1,,1,"(11.117806,-74.232622)"
2019,Junio,Guadalupe/Territorio Francés,312,0,1,,1,"(3.541112,-76.384584)"
2019,Junio,Guadalupe/Territorio Francés,312,1,1,,2,"(4.697144,-74.140516)"
2019,Junio,Guam/Territorio no incorporado de Estados Unidos,316,1,1,,2,"(0.25129,-76.875963)"
2019,Junio,Guayana Francesa/Departamento de Ultramar Francés,254,0,1,,1,"(3.541112,-76.384584)"
2019,Junio,Guayana Francesa/Departamento de Ultramar Francés,254,1,0,,1,"(4.697144,-74.140516)"
2019,Junio,Guayana Francesa/Departamento de Ultramar Francés,254,0,1,,1,"(4.815061,-75.736532)"
2019,Junio,Haití,332,0,1,,1,"(10.445761,-75.516429)"
2019,Junio,Haití,332,1,1,,2,"(10.886611,-74.776708)"
2019,Junio,Haití,332,0,3,,3,"(3.541112,-76.384584)"
2019,Junio,Haití,332,1,5,,6,"(4.697144,-74.140516)"
2019,Junio,Haití,332,2,0,,2,"(6.171601,-75.427454)"
2019,Junio,Honduras,340,1,10,,11,"(10.408582,-75.538003)"
2019,Junio,Honduras,340,1,5,,6,"(10.445761,-75.516429)"
2019,Junio,Honduras,340,5,7,,12,"(10.886611,-74.776708)"
2019,Junio,Honduras,340,1,1,,2,"(12.5744111,-81.703935)"
2019,Junio,Honduras,340,1,0,,1,"(12.586067,-81.702563)"
2019,Junio,Honduras,340,6,29,,35,"(3.541112,-76.384584)"
2019,Junio,Honduras,340,73,144,,217,"(4.697144,-74.140516)"
2019,Junio,Honduras,340,2,9,,11,"(4.815061,-75.736532)"
2019,Junio,Honduras,340,39,64,,103,"(6.171601,-75.427454)"
2019,Junio,Honduras,340,2,12,,14,"(7.128456,-73.183637)"
2019,Junio,Hong Kong,344,2,1,,3,"(3.541112,-76.384584)"
2019,Junio,Hong Kong,344,12,23,,35,"(4.697144,-74.140516)"
2019,Junio,Hong Kong,344,4,3,,7,"(6.171601,-75.427454)"
2019,Junio,Hungría,348,0,1,,1,"(10.886611,-74.776708)"
2019,Junio,Hungría,348,10,13,,23,"(4.697144,-74.140516)"
2019,Junio,Hungría,348,0,2,,2,"(6.171601,-75.427454)"
2019,Junio,India,356,2,4,,6,"(3.541112,-76.384584)"
2019,Junio,India,356,29,25,,54,"(4.697144,-74.140516)"
2019,Junio,India,356,3,1,,4,"(6.171601,-75.427454)"
2019,Junio,Indonesia,360,8,7,,15,"(4.697144,-74.140516)"
2019,Junio,Indonesia,360,1,2,,3,"(6.171601,-75.427454)"
2019,Junio,Iraq,368,0,4,,4,"(4.697144,-74.140516)"
2019,Junio,Irán,364,0,1,,1,"(10.445761,-75.516429)"
2019,Junio,Irán,364,4,2,,6,"(4.697144,-74.140516)"
2019,Junio,República de Irlanda,372,1,0,,1,"(10.445761,-75.516429)"
2019,Junio,República de Irlanda,372,1,0,,1,"(10.886611,-74.776708)"
2019,Junio,República de Irlanda,372,1,0,,1,"(3.541112,-76.384584)"
2019,Junio,República de Irlanda,372,17,14,,31,"(4.697144,-74.140516)"
2019,Junio,República de Irlanda,372,2,1,,3,"(6.171601,-75.427454)"
2019,Junio,Islandia,352,1,0,,1,"(10.886611,-74.776708)"
2019,Junio,Islandia,352,5,5,,10,"(4.697144,-74.140516)"
2019,Junio,Islandia,352,0,1,,1,"(6.171601,-75.427454)"
2019,Junio,Israel,376,1,0,,1,"(10.445761,-75.516429)"
2019,Junio,Israel,376,1,1,,2,"(10.886611,-74.776708)"
2019,Junio,Israel,376,5,5,,10,"(3.541112,-76.384584)"
2019,Junio,Israel,376,181,105,,286,"(4.697144,-74.140516)"
2019,Junio,Israel,376,10,2,,12,"(6.171601,-75.427454)"
2019,Junio,Italia,380,35,20,,55,"(10.445761,-75.516429)"
2019,Junio,Italia,380,17,12,,29,"(10.886611,-74.776708)"
2019,Junio,Italia,380,0,1,,1,"(12.586067,-81.702563)"
2019,Junio,Italia,380,146,55,,201,"(3.541112,-76.384584)"
2019,Junio,Italia,380,1,0,,1,"(4.452882,-75.766298)"
2019,Junio,Italia,380,817,587,,1404,"(4.697144,-74.140516)"
2019,Junio,Italia,380,0,1,,1,"(4.815061,-75.736532)"
2019,Junio,Italia,380,175,139,,314,"(6.171601,-75.427454)"
2019,Junio,Italia,380,1,1,,2,"(7.128456,-73.183637)"
2019,Junio,Jamaica,388,3,5,,8,"(10.445761,-75.516429)"
2019,Junio,Jamaica,388,4,5,,9,"(10.886611,-74.776708)"
2019,Junio,Jamaica,388,4,1,,5,"(12.586067,-81.702563)"
2019,Junio,Jamaica,388,3,5,,8,"(3.541112,-76.384584)"
2019,Junio,Jamaica,388,45,35,,80,"(4.697144,-74.140516)"
2019,Junio,Jamaica,388,0,9,,9,"(4.815061,-75.736532)"
2019,Junio,Jamaica,388,17,16,,33,"(6.171601,-75.427454)"
2019,Junio,Jamaica,388,4,10,,14,"(7.128456,-73.183637)"
2019,Junio,Japón,392,4,3,,7,"(3.541112,-76.384584)"
2019,Junio,Japón,392,201,158,,359,"(4.697144,-74.140516)"
2019,Junio,Japón,392,37,28,,65,"(6.171601,-75.427454)"
2019,Junio,Jordania,400,2,1,,3,"(4.697144,-74.140516)"
2019,Junio,Kazajistán,398,1,1,,2,"(4.697144,-74.140516)"
2019,Junio,Kenia,404,6,2,,8,"(3.541112,-76.384584)"
2019,Junio,Kenia,404,16,14,,30,"(4.697144,-74.140516)"
2019,Junio,Kenia,404,5,2,,7,"(6.171601,-75.427454)"
2019,Junio,Kuwait,414,1,0,,1,"(10.445761,-75.516429)"
2019,Junio,Kuwait,414,4,7,,11,"(4.697144,-74.140516)"
2019,Junio,Kuwait,414,0,1,,1,"(6.171601,-75.427454)"
2019,Junio,República Democrática Popular  Lao,418,0,1,,1,"(4.697144,-74.140516)"
2019,Junio,Letonia,428,2,1,,3,"(4.697144,-74.140516)"
2019,Junio,Letonia,428,0,1,,1,"(6.171601,-75.427454)"
2019,Junio,Lituania,440,0,1,,1,"(4.697144,-74.140516)"
2019,Junio,Líbano,422,29,15,,44,"(10.886611,-74.776708)"
2019,Junio,Líbano,422,2,1,,3,"(12.586067,-81.702563)"
2019,Junio,Líbano,422,35,36,,71,"(4.697144,-74.140516)"
2019,Junio,Líbano,422,0,1,,1,"(6.171601,-75.427454)"
2019,Junio,Líbano,422,4,2,,6,"(7.128456,-73.183637)"
2019,Junio,Luxemburgo,442,0,1,,1,"(10.445761,-75.516429)"
2019,Junio,Luxemburgo,442,1,0,,1,"(3.541112,-76.384584)"
2019,Junio,Luxemburgo,442,11,9,,20,"(4.697144,-74.140516)"
2019,Junio,Luxemburgo,442,1,0,,1,"(6.171601,-75.427454)"
2019,Junio,Macao,446,0,1,,1,"(6.171601,-75.427454)"
2019,Junio,Macedonia,807,1,1,,2,"(4.697144,-74.140516)"
2019,Junio,Malasia,458,3,4,,7,"(4.697144,-74.140516)"
2019,Junio,Malasia,458,0,1,,1,"(6.171601,-75.427454)"
2019,Junio,Maldivas,462,0,1,,1,"(6.171601,-75.427454)"
2019,Junio,Malí,466,0,1,,1,"(4.697144,-74.140516)"
2019,Junio,Malta,470,26,23,,49,"(4.697144,-74.140516)"
2019,Junio,Malta,470,10,6,,16,"(6.171601,-75.427454)"
2019,Junio,Marruecos,504,9,8,,17,"(4.697144,-74.140516)"
2019,Junio,Marruecos,504,3,3,,6,"(6.171601,-75.427454)"
2019,Junio,Mauritania,478,0,1,,1,"(4.697144,-74.140516)"
2019,Junio,Martinica/Departamento de Ultramar Francés,474,1,1,,2,"(3.541112,-76.384584)"
2019,Junio,Martinica/Departamento de Ultramar Francés,474,1,0,,1,"(4.697144,-74.140516)"
2019,Junio,Martinica/Departamento de Ultramar Francés,474,0,1,,1,"(6.171601,-75.427454)"
2019,Junio,México,484,170,113,,283,"(10.445761,-75.516429)"
2019,Junio,México,484,181,188,,369,"(10.886611,-74.776708)"
2019,Junio,México,484,3,2,,5,"(12.586067,-81.702563)"
2019,Junio,México,484,729,641,,1370,"(3.541112,-76.384584)"
2019,Junio,México,484,19514,16586,,36100,"(4.697144,-74.140516)"
2019,Junio,México,484,208,134,,342,"(4.815061,-75.736532)"
2019,Junio,México,484,6006,4572,,10578,"(6.171601,-75.427454)"
2019,Junio,México,484,123,84,,207,"(7.128456,-73.183637)"
2019,Junio,Mónaco,492,0,1,,1,"(4.697144,-74.140516)"
2019,Junio,Mónaco,492,1,0,,1,"(6.171601,-75.427454)"
2019,Junio,Mongolia,496,1,1,,2,"(4.697144,-74.140516)"
2019,Junio,Montenegro,499,0,1,,1,"(4.697144,-74.140516)"
2019,Junio,Montenegro,499,0,2,,2,"(6.171601,-75.427454)"
2019,Junio,Mozambique,508,0,1,,1,"(4.697144,-74.140516)"
2019,Junio,Nauru,520,4,1,,5,"(4.697144,-74.140516)"
2019,Junio,Nicaragua,558,2,2,,4,"(10.445761,-75.516429)"
2019,Junio,Nicaragua,558,2,3,,5,"(10.886611,-74.776708)"
2019,Junio,Nicaragua,558,3,0,,3,"(12.5744111,-81.703935)"
2019,Junio,Nicaragua,558,2,9,,11,"(3.541112,-76.384584)"
2019,Junio,Nicaragua,558,21,56,,77,"(4.697144,-74.140516)"
2019,Junio,Nicaragua,558,2,0,,2,"(4.815061,-75.736532)"
2019,Junio,Nicaragua,558,34,80,,114,"(6.171601,-75.427454)"
2019,Junio,Nicaragua,558,1,3,,4,"(7.128456,-73.183637)"
2019,Junio,Nigeria,566,0,5,,5,"(4.697144,-74.140516)"
2019,Junio,Noruega,578,2,3,,5,"(10.408582,-75.538003)"
2019,Junio,Noruega,578,1,1,,2,"(10.445761,-75.516429)"
2019,Junio,Noruega,578,1,0,,1,"(10.886611,-74.776708)"
2019,Junio,Noruega,578,1,0,,1,"(12.586067,-81.702563)"
2019,Junio,Noruega,578,5,1,,6,"(3.541112,-76.384584)"
2019,Junio,Noruega,578,43,28,,71,"(4.697144,-74.140516)"
2019,Junio,Noruega,578,5,5,,10,"(6.171601,-75.427454)"
2019,Junio,Nueva Zelanda,554,37,27,,64,"(4.697144,-74.140516)"
2019,Junio,Nueva Zelanda,554,1,0,,1,"(6.171601,-75.427454)"
2019,Junio,Omán,512,0,1,,1,"(10.445761,-75.516429)"
2019,Junio,Omán,512,2,5,,7,"(4.697144,-74.140516)"
2019,Junio,Omán,512,0,1,,1,"(6.171601,-75.427454)"
2019,Junio,Pakistán,586,0,2,,2,"(4.697144,-74.140516)"
2019,Junio,Panamá,591,61,102,,163,"(10.408582,-75.538003)"
2019,Junio,Panamá,591,1779,1465,,3244,"(10.445761,-75.516429)"
2019,Junio,Panamá,591,737,645,,1382,"(10.886611,-74.776708)"
2019,Junio,Panamá,591,0,8,,8,"(11.360009,-72.129330)"
2019,Junio,Panamá,591,1,14,,15,"(12.5744111,-81.703935)"
2019,Junio,Panamá,591,68,91,,159,"(12.586067,-81.702563)"
2019,Junio,Panamá,591,2841,2349,,5190,"(3.541112,-76.384584)"
2019,Junio,Panamá,591,4,0,,4,"(3.893038,-77.067921)"
2019,Junio,Panamá,591,8446,8744,,17190,"(4.697144,-74.140516)"
2019,Junio,Panamá,591,469,359,,828,"(4.815061,-75.736532)"
2019,Junio,Panamá,591,0,4,,4,"(6.17134,-75.427194)"
2019,Junio,Panamá,591,3466,3056,,6522,"(6.171601,-75.427454)"
2019,Junio,Panamá,591,7,27,,34,"(7.102626,-77.762647)"
2019,Junio,Panamá,591,147,118,,265,"(7.128456,-73.183637)"
2019,Junio,Panamá,591,0,8,,8,"(8.066966,-76.735404)"
2019,Junio,Panamá,591,26,69,,95,"(8.635765,-77.346578)"
2019,Junio,Paraguay,600,3,3,,6,"(10.445761,-75.516429)"
2019,Junio,Paraguay,600,1,3,,4,"(10.886611,-74.776708)"
2019,Junio,Paraguay,600,7,18,,25,"(3.541112,-76.384584)"
2019,Junio,Paraguay,600,111,161,,272,"(4.697144,-74.140516)"
2019,Junio,Paraguay,600,7,4,,11,"(4.815061,-75.736532)"
2019,Junio,Paraguay,600,31,31,,62,"(6.171601,-75.427454)"
2019,Junio,Paraguay,600,2,0,,2,"(7.128456,-73.183637)"
2019,Junio,Perú,604,9,9,,18,"(-0.193180,-74.784874)"
2019,Junio,Perú,604,10,16,,26,"(-4.197703,-69.941278)"
2019,Junio,Perú,604,292,359,,651,"(-4.223468,-69.945098)"
2019,Junio,Perú,604,9,9,,18,"(0.25129,-76.875963)"
2019,Junio,Perú,604,64,65,,129,"(0.814836,-77.662532)"
2019,Junio,Perú,604,0,2,,2,"(1.813928,-78.763924)"
2019,Junio,Perú,604,164,160,,324,"(10.445761,-75.516429)"
2019,Junio,Perú,604,18,13,,31,"(10.886611,-74.776708)"
2019,Junio,Perú,604,1,0,,1,"(12.586067,-81.702563)"
2019,Junio,Perú,604,460,452,,912,"(3.541112,-76.384584)"
2019,Junio,Perú,604,6414,6809,,13223,"(4.697144,-74.140516)"
2019,Junio,Perú,604,7,2,,9,"(4.815061,-75.736532)"
2019,Junio,Perú,604,1057,1094,,2151,"(6.171601,-75.427454)"
2019,Junio,Perú,604,3,1,,4,"(7.128456,-73.183637)"
2019,Junio,Polonia,616,2,2,,4,"(10.445761,-75.516429)"
2019,Junio,Polonia,616,2,1,,3,"(3.541112,-76.384584)"
2019,Junio,Polonia,616,16,23,,39,"(4.697144,-74.140516)"
2019,Junio,Polonia,616,1,3,,4,"(6.171601,-75.427454)"
2019,Junio,Portugal,620,5,2,,7,"(10.445761,-75.516429)"
2019,Junio,Portugal,620,5,5,,10,"(10.886611,-74.776708)"
2019,Junio,Portugal,620,8,2,,10,"(3.541112,-76.384584)"
2019,Junio,Portugal,620,212,242,,454,"(4.697144,-74.140516)"
2019,Junio,Portugal,620,35,26,,61,"(6.171601,-75.427454)"
2019,Junio,Puerto Rico/Territorio de Estados Unidos,630,8,8,,16,"(10.445761,-75.516429)"
2019,Junio,Puerto Rico/Territorio de Estados Unidos,630,19,14,,33,"(10.886611,-74.776708)"
2019,Junio,Puerto Rico/Territorio de Estados Unidos,630,0,1,,1,"(12.586067,-81.702563)"
2019,Junio,Puerto Rico/Territorio de Estados Unidos,630,41,37,,78,"(3.541112,-76.384584)"
2019,Junio,Puerto Rico/Territorio de Estados Unidos,630,466,464,,930,"(4.697144,-74.140516)"
2019,Junio,Puerto Rico/Territorio de Estados Unidos,630,4,3,,7,"(4.815061,-75.736532)"
2019,Junio,Puerto Rico/Territorio de Estados Unidos,630,65,36,,101,"(6.171601,-75.427454)"
2019,Junio,Puerto Rico/Territorio de Estados Unidos,630,1,2,,3,"(7.128456,-73.183637)"
2019,Junio,Qatar,634,0,2,,2,"(3.541112,-76.384584)"
2019,Junio,Qatar,634,9,5,,14,"(4.697144,-74.140516)"
2019,Junio,Qatar,634,0,1,,1,"(6.171601,-75.427454)"
2019,Junio,Reino Unido de Gran Bretaña e Irlanda del Norte,826,3,4,,7,"(10.445761,-75.516429)"
2019,Junio,Reino Unido de Gran Bretaña e Irlanda del Norte,826,3,2,,5,"(10.886611,-74.776708)"
2019,Junio,Reino Unido de Gran Bretaña e Irlanda del Norte,826,23,14,,37,"(3.541112,-76.384584)"
2019,Junio,Reino Unido de Gran Bretaña e Irlanda del Norte,826,2378,1698,,4076,"(4.697144,-74.140516)"
2019,Junio,Reino Unido de Gran Bretaña e Irlanda del Norte,826,1,2,,3,"(4.815061,-75.736532)"
2019,Junio,Reino Unido de Gran Bretaña e Irlanda del Norte,826,39,35,,74,"(6.171601,-75.427454)"
2019,Junio,República CentroÁfricana,140,3,2,,5,"(4.697144,-74.140516)"
2019,Junio,Federación de Rusia,643,1,1,,2,"(10.445761,-75.516429)"
2019,Junio,Federación de Rusia,643,1,1,,2,"(10.886611,-74.776708)"
2019,Junio,Federación de Rusia,643,1,3,,4,"(3.541112,-76.384584)"
2019,Junio,Federación de Rusia,643,69,61,,130,"(4.697144,-74.140516)"
2019,Junio,Federación de Rusia,643,9,6,,15,"(6.171601,-75.427454)"
2019,Junio,República Dominicana,214,26,23,,49,"(10.445761,-75.516429)"
2019,Junio,República Dominicana,214,11,21,,32,"(10.886611,-74.776708)"
2019,Junio,República Dominicana,214,2,0,,2,"(12.586067,-81.702563)"
2019,Junio,República Dominicana,214,133,133,,266,"(3.541112,-76.384584)"
2019,Junio,República Dominicana,214,4574,3905,,8479,"(4.697144,-74.140516)"
2019,Junio,República Dominicana,214,45,33,,78,"(4.815061,-75.736532)"
2019,Junio,República Dominicana,214,419,343,,762,"(6.171601,-75.427454)"
2019,Junio,República Dominicana,214,55,52,,107,"(7.128456,-73.183637)"
2019,Junio,Reunión,638,1,1,,2,"(4.697144,-74.140516)"
2019,Junio,Rumania,642,3,3,,6,"(4.697144,-74.140516)"
2019,Junio,Rumania,642,1,1,,2,"(6.171601,-75.427454)"
2019,Junio,Rwanda,646,0,2,,2,"(4.697144,-74.140516)"
2019,Junio,San Pedro y Miquelón/territorio de Ultramar de La Unión Europea,666,2,0,,2,"(4.697144,-74.140516)"
2019,Junio,Santa Lucia,662,1,2,,3,"(6.171601,-75.427454)"
2019,Junio,Serbia,688,1,3,,4,"(4.697144,-74.140516)"
2019,Junio,Serbia,688,0,1,,1,"(6.171601,-75.427454)"
2019,Junio,Singapur,702,24,16,,40,"(4.697144,-74.140516)"
2019,Junio,Singapur,702,5,6,,11,"(6.171601,-75.427454)"
2019,Junio,Sudáfrica,710,10,12,,22,"(4.697144,-74.140516)"
2019,Junio,Sudáfrica,710,0,2,,2,"(6.171601,-75.427454)"
2019,Junio,Suecia,752,3,2,,5,"(10.445761,-75.516429)"
2019,Junio,Suecia,752,3,2,,5,"(10.886611,-74.776708)"
2019,Junio,Suecia,752,0,1,,1,"(12.586067,-81.702563)"
2019,Junio,Suecia,752,31,14,,45,"(3.541112,-76.384584)"
2019,Junio,Suecia,752,93,61,,154,"(4.697144,-74.140516)"
2019,Junio,Suecia,752,2,1,,3,"(4.815061,-75.736532)"
2019,Junio,Suecia,752,18,9,,27,"(6.171601,-75.427454)"
2019,Junio,Suecia,752,1,1,,2,"(7.128456,-73.183637)"
2019,Junio,Suiza,756,6,5,,11,"(10.445761,-75.516429)"
2019,Junio,Suiza,756,10,4,,14,"(10.886611,-74.776708)"
2019,Junio,Suiza,756,44,19,,63,"(3.541112,-76.384584)"
2019,Junio,Suiza,756,307,219,,526,"(4.697144,-74.140516)"
2019,Junio,Suiza,756,1,2,,3,"(4.815061,-75.736532)"
2019,Junio,Suiza,756,53,33,,86,"(6.171601,-75.427454)"
2019,Junio,Surinam,740,0,1,,1,"(3.541112,-76.384584)"
2019,Junio,Surinam,740,7,1,,8,"(4.697144,-74.140516)"
2019,Junio,Taiwán,158,1,3,,4,"(4.697144,-74.140516)"
2019,Junio,Taiwán,158,1,0,,1,"(6.171601,-75.427454)"
2019,Junio,Tailandia,764,0,1,,1,"(10.445761,-75.516429)"
2019,Junio,Tailandia,764,4,4,,8,"(3.541112,-76.384584)"
2019,Junio,Tailandia,764,40,26,,66,"(4.697144,-74.140516)"
2019,Junio,Tailandia,764,6,2,,8,"(6.171601,-75.427454)"
2019,Junio,Tanzania,834,1,2,,3,"(4.697144,-74.140516)"
2019,Junio,Trinidad y Tobago,780,2,4,,6,"(10.445761,-75.516429)"
2019,Junio,Trinidad y Tobago,780,1,3,,4,"(10.886611,-74.776708)"
2019,Junio,Trinidad y Tobago,780,2,3,,5,"(3.541112,-76.384584)"
2019,Junio,Trinidad y Tobago,780,18,17,,35,"(4.697144,-74.140516)"
2019,Junio,Trinidad y Tobago,780,2,4,,6,"(4.815061,-75.736532)"
2019,Junio,Trinidad y Tobago,780,11,5,,16,"(6.171601,-75.427454)"
2019,Junio,Túnez,788,0,1,,1,"(3.541112,-76.384584)"
2019,Junio,Túnez,788,3,2,,5,"(4.697144,-74.140516)"
2019,Junio,Túnez,788,1,0,,1,"(6.171601,-75.427454)"
2019,Junio,Turquía,792,6,3,,9,"(10.445761,-75.516429)"
2019,Junio,Turquía,792,5,2,,7,"(10.886611,-74.776708)"
2019,Junio,Turquía,792,1,1,,2,"(3.541112,-76.384584)"
2019,Junio,Turquía,792,1251,683,,1934,"(4.697144,-74.140516)"
2019,Junio,Turquía,792,30,15,,45,"(6.171601,-75.427454)"
2019,Junio,Turkmenistán,795,5,1,,6,"(4.697144,-74.140516)"
2019,Junio,Ucrania,804,6,3,,9,"(4.697144,-74.140516)"
2019,Junio,Ucrania,804,1,0,,1,"(6.171601,-75.427454)"
2019,Junio,Uruguay,858,3,6,,9,"(10.445761,-75.516429)"
2019,Junio,Uruguay,858,19,25,,44,"(3.541112,-76.384584)"
2019,Junio,Uruguay,858,95,131,,226,"(4.697144,-74.140516)"
2019,Junio,Uruguay,858,7,6,,13,"(4.815061,-75.736532)"
2019,Junio,Uruguay,858,21,34,,55,"(6.171601,-75.427454)"
2019,Junio,Venezuela,862,4,6,,10,"(10.445761,-75.516429)"
2019,Junio,Venezuela,862,46,49,,95,"(10.886611,-74.776708)"
2019,Junio,Venezuela,862,1,0,,1,"(11.117806,-74.232622)"
2019,Junio,Venezuela,862,0,1,,1,"(11.247723,-74.213989)"
2019,Junio,Venezuela,862,1247,1169,,2416,"(11.360009,-72.129330)"
2019,Junio,Venezuela,862,430,251,,681,"(3.541112,-76.384584)"
2019,Junio,Venezuela,862,1,2,,3,"(3.866713,-67.927521)"
2019,Junio,Venezuela,862,808,874,,1682,"(4.697144,-74.140516)"
2019,Junio,Venezuela,862,4,0,,4,"(4.815061,-75.736532)"
2019,Junio,Venezuela,862,347,334,,681,"(6.171601,-75.427454)"
2019,Junio,Venezuela,862,13,29,,42,"(6.185799,-67.483929)"
2019,Junio,Venezuela,862,179,193,,372,"(7.088729,-70.740253)"
2019,Junio,Venezuela,862,3,0,,3,"(7.128456,-73.183637)"
2019,Junio,Venezuela,862,521,475,,996,"(7.818934,-72.453226)"
2019,Junio,Venezuela,862,1,8,,9,"(7.927209,-72.507910)"
2019,Junio,Venezuela,862,45,56,,101,"(8.36068,-72.409396)"
2019,Junio,Vietnam,704,0,1,,1,"(3.541112,-76.384584)"
2019,Junio,Vietnam,704,9,4,,13,"(4.697144,-74.140516)"
2019,Junio,Islas Vírgenes Británicas/Territorio Británico de Ultramar,92,1,0,,1,"(4.697144,-74.140516)"
2019,Junio,Islas Vírgenes Estadounidenses/Territorio de Estados Unidos,850,0,3,,3,"(10.445761,-75.516429)"
2019,Junio,República Árabe de Yemen,887,0,1,,1,"(4.697144,-74.140516)"
2019,Junio,Zimbabue,716,2,0,,2,"(4.697144,-74.140516)"
2019,Julio,Afganistán,4,0,5,,5,"(4.697144,-74.140516)"
2019,Julio,Albania,8,3,2,,5,"(4.697144,-74.140516)"
2019,Julio,Alemania,276,0,1,,1,"(0.814836,-77.662532)"
2019,Julio,Alemania,276,20,11,,31,"(10.445761,-75.516429)"
2019,Julio,Alemania,276,18,11,,29,"(10.886611,-74.776708)"
2019,Julio,Alemania,276,0,1,,1,"(12.586067,-81.702563)"
2019,Julio,Alemania,276,47,27,,74,"(3.541112,-76.384584)"
2019,Julio,Alemania,276,2614,2292,,4906,"(4.697144,-74.140516)"
2019,Julio,Alemania,276,1,0,,1,"(4.815061,-75.736532)"
2019,Julio,Alemania,276,82,83,,165,"(6.171601,-75.427454)"
2019,Julio,Andorra,20,1,3,,4,"(4.697144,-74.140516)"
2019,Julio,Andorra,20,1,1,,2,"(6.171601,-75.427454)"
2019,Julio,Angola,24,2,4,,6,"(4.697144,-74.140516)"
2019,Julio,Antigua y Barbuda,28,0,1,,1,"(3.541112,-76.384584)"
2019,Julio,Antigua y Barbuda,28,2,8,,10,"(4.697144,-74.140516)"
2019,Julio,Países Bajos,528,170,109,,279,"(10.445761,-75.516429)"
2019,Julio,Países Bajos,528,29,21,,50,"(10.886611,-74.776708)"
2019,Julio,Países Bajos,528,60,34,,94,"(3.541112,-76.384584)"
2019,Julio,Países Bajos,528,1421,1266,,2687,"(4.697144,-74.140516)"
2019,Julio,Países Bajos,528,2,2,,4,"(4.815061,-75.736532)"
2019,Julio,Países Bajos,528,111,73,,184,"(6.171601,-75.427454)"
2019,Julio,Países Bajos,528,2,4,,6,"(7.128456,-73.183637)"
2019,Julio,Arabia Saudita,682,1,4,,5,"(3.541112,-76.384584)"
2019,Julio,Arabia Saudita,682,6,44,,50,"(4.697144,-74.140516)"
2019,Julio,Arabia Saudita,682,0,4,,4,"(6.171601,-75.427454)"
2019,Julio,Arabia Saudita,682,0,1,,1,"(7.128456,-73.183637)"
2019,Julio,Argelia,12,1,0,,1,"(3.541112,-76.384584)"
2019,Julio,Argelia,12,1,5,,6,"(4.697144,-74.140516)"
2019,Julio,Argelia,12,0,1,,1,"(6.171601,-75.427454)"
2019,Julio,Argentina,32,2,1,,3,"(0.812436,-77.847006)"
2019,Julio,Argentina,32,6,19,,25,"(0.814836,-77.662532)"
2019,Julio,Argentina,32,15,11,,26,"(10.445761,-75.516429)"
2019,Julio,Argentina,32,32,24,,56,"(10.886611,-74.776708)"
2019,Julio,Argentina,32,0,1,,1,"(12.586067,-81.702563)"
2019,Julio,Argentina,32,187,170,,357,"(3.541112,-76.384584)"
2019,Julio,Argentina,32,2383,2417,,4800,"(4.697144,-74.140516)"
2019,Julio,Argentina,32,13,15,,28,"(4.815061,-75.736532)"
2019,Julio,Argentina,32,145,142,,287,"(6.171601,-75.427454)"
2019,Julio,Argentina,32,3,2,,5,"(7.128456,-73.183637)"
2019,Julio,República de Armenia,51,0,1,,1,"(10.445761,-75.516429)"
2019,Julio,Aruba,533,2299,1673,,3972,"(10.408582,-75.538003)"
2019,Julio,Aruba,533,9,4,,13,"(10.445761,-75.516429)"
2019,Julio,Aruba,533,17,23,,40,"(10.886611,-74.776708)"
2019,Julio,Aruba,533,4,0,,4,"(11.117806,-74.232622)"
2019,Julio,Aruba,533,0,1,,1,"(11.247723,-74.213989)"
2019,Julio,Aruba,533,1,12,,13,"(11.528919,-72.919681)"
2019,Julio,Aruba,533,34,30,,64,"(3.541112,-76.384584)"
2019,Julio,Aruba,533,1853,1594,,3447,"(4.697144,-74.140516)"
2019,Julio,Aruba,533,22,12,,34,"(4.815061,-75.736532)"
2019,Julio,Aruba,533,89,51,,140,"(6.171601,-75.427454)"
2019,Julio,Aruba,533,20,54,,74,"(7.128456,-73.183637)"
2019,Julio,Australia,36,0,1,,1,"(10.445761,-75.516429)"
2019,Julio,Australia,36,1,0,,1,"(10.886611,-74.776708)"
2019,Julio,Australia,36,6,6,,12,"(3.541112,-76.384584)"
2019,Julio,Australia,36,528,427,,955,"(4.697144,-74.140516)"
2019,Julio,Australia,36,1,3,,4,"(4.815061,-75.736532)"
2019,Julio,Australia,36,24,19,,43,"(6.171601,-75.427454)"
2019,Julio,Australia,36,1,0,,1,"(7.128456,-73.183637)"
2019,Julio,Austria,40,4,0,,4,"(10.445761,-75.516429)"
2019,Julio,Austria,40,0,1,,1,"(10.886611,-74.776708)"
2019,Julio,Austria,40,3,0,,3,"(3.541112,-76.384584)"
2019,Julio,Austria,40,39,37,,76,"(4.697144,-74.140516)"
2019,Julio,Austria,40,6,11,,17,"(6.171601,-75.427454)"
2019,Julio,Azerbaiyán,31,4,1,,5,"(4.697144,-74.140516)"
2019,Julio,Bahamas,44,8,4,,12,"(10.886611,-74.776708)"
2019,Julio,Bahamas,44,18,6,,24,"(3.541112,-76.384584)"
2019,Julio,Bahamas,44,26,22,,48,"(4.697144,-74.140516)"
2019,Julio,Bahamas,44,11,4,,15,"(4.815061,-75.736532)"
2019,Julio,Bahamas,44,26,26,,52,"(6.171601,-75.427454)"
2019,Julio,Bahréin,48,1,0,,1,"(3.541112,-76.384584)"
2019,Julio,Bahréin,48,1,3,,4,"(4.697144,-74.140516)"
2019,Julio,Bahréin,48,1,1,,2,"(6.171601,-75.427454)"
2019,Julio,Bahréin,48,0,1,,1,"(7.128456,-73.183637)"
2019,Julio,Bangladesh,50,1,0,,1,"(4.697144,-74.140516)"
2019,Julio,Bangladesh,50,0,1,,1,"(6.171601,-75.427454)"
2019,Julio,Barbados,52,1,1,,2,"(10.445761,-75.516429)"
2019,Julio,Barbados,52,1,0,,1,"(10.886611,-74.776708)"
2019,Julio,Barbados,52,4,4,,8,"(3.541112,-76.384584)"
2019,Julio,Barbados,52,6,7,,13,"(4.697144,-74.140516)"
2019,Julio,Barbados,52,4,6,,10,"(6.171601,-75.427454)"
2019,Julio,República de Belarús,112,1,0,,1,"(4.697144,-74.140516)"
2019,Julio,Bélgica,56,5,0,,5,"(10.445761,-75.516429)"
2019,Julio,Bélgica,56,3,1,,4,"(10.886611,-74.776708)"
2019,Julio,Bélgica,56,25,22,,47,"(3.541112,-76.384584)"
2019,Julio,Bélgica,56,175,129,,304,"(4.697144,-74.140516)"
2019,Julio,Bélgica,56,2,1,,3,"(4.815061,-75.736532)"
2019,Julio,Bélgica,56,82,73,,155,"(6.171601,-75.427454)"
2019,Julio,Belice,84,1,1,,2,"(3.541112,-76.384584)"
2019,Julio,Belice,84,18,20,,38,"(4.697144,-74.140516)"
2019,Julio,Belice,84,1,3,,4,"(6.171601,-75.427454)"
2019,Julio,Bermudas/Territorio Británico de Ultramar,60,4,2,,6,"(10.445761,-75.516429)"
2019,Julio,Bermudas/Territorio Británico de Ultramar,60,0,3,,3,"(4.697144,-74.140516)"
2019,Julio,Bermudas/Territorio Británico de Ultramar,60,4,6,,10,"(6.171601,-75.427454)"
2019,Julio,Bolivia,68,10,8,,18,"(0.814836,-77.662532)"
2019,Julio,Bolivia,68,28,34,,62,"(3.541112,-76.384584)"
2019,Julio,Bolivia,68,346,662,,1008,"(4.697144,-74.140516)"
2019,Julio,Bolivia,68,1,0,,1,"(4.815061,-75.736532)"
2019,Julio,Bolivia,68,13,35,,48,"(6.171601,-75.427454)"
2019,Julio,Brasil,76,164,250,,414,"(-4.197703,-69.941278)"
2019,Julio,Brasil,76,28,54,,82,"(-4.223468,-69.945098)"
2019,Julio,Brasil,76,5,6,,11,"(10.445761,-75.516429)"
2019,Julio,Brasil,76,9,14,,23,"(10.886611,-74.776708)"
2019,Julio,Brasil,76,2,2,,4,"(12.586067,-81.702563)"
2019,Julio,Brasil,76,86,114,,200,"(3.541112,-76.384584)"
2019,Julio,Brasil,76,2611,3638,,6249,"(4.697144,-74.140516)"
2019,Julio,Brasil,76,22,33,,55,"(4.815061,-75.736532)"
2019,Julio,Brasil,76,126,144,,270,"(6.171601,-75.427454)"
2019,Julio,Brasil,76,4,4,,8,"(7.128456,-73.183637)"
2019,Julio,Bulgaria,100,4,6,,10,"(4.697144,-74.140516)"
2019,Julio,Islas Caimán/Territorio Británico de Ultramar,136,2,2,,4,"(10.886611,-74.776708)"
2019,Julio,Islas Caimán/Territorio Británico de Ultramar,136,3,1,,4,"(12.586067,-81.702563)"
2019,Julio,Islas Caimán/Territorio Británico de Ultramar,136,1,2,,3,"(3.541112,-76.384584)"
2019,Julio,Islas Caimán/Territorio Británico de Ultramar,136,1,2,,3,"(6.171601,-75.427454)"
2019,Julio,Camboya,116,1,2,,3,"(4.697144,-74.140516)"
2019,Julio,Camerún,120,0,3,,3,"(4.697144,-74.140516)"
2019,Julio,Canadá,124,33,25,,58,"(10.445761,-75.516429)"
2019,Julio,Canadá,124,63,52,,115,"(10.886611,-74.776708)"
2019,Julio,Canadá,124,0,2,,2,"(12.586067,-81.702563)"
2019,Julio,Canadá,124,157,103,,261,"(3.541112,-76.384584)"
2019,Julio,Canadá,124,1,0,,1,"(4.452882,-75.766298)"
2019,Julio,Canadá,124,3136,2333,,5469,"(4.697144,-74.140516)"
2019,Julio,Canadá,124,24,18,,42,"(4.815061,-75.736532)"
2019,Julio,Canadá,124,449,314,,763,"(6.171601,-75.427454)"
2019,Julio,Canadá,124,12,8,,20,"(7.128456,-73.183637)"
2019,Julio,Chad,148,1,0,,1,"(4.697144,-74.140516)"
2019,Julio,Chad,148,0,1,,1,"(6.171601,-75.427454)"
2019,Julio,España,724,36,24,,60,"(10.445761,-75.516429)"
2019,Julio,España,724,24,19,,43,"(10.886611,-74.776708)"
2019,Julio,España,724,1,2,,3,"(12.586067,-81.702563)"
2019,Julio,España,724,3077,1947,,5024,"(3.541112,-76.384584)"
2019,Julio,España,724,18448,13553,,32001,"(4.697144,-74.140516)"
2019,Julio,España,724,39,27,,66,"(4.815061,-75.736532)"
2019,Julio,España,724,3680,2781,,6461,"(6.171601,-75.427454)"
2019,Julio,España,724,8,6,,14,"(7.128456,-73.183637)"
2019,Julio,Colombia,170,0,5,,5,"(10.445761,-75.516429)"
2019,Julio,Colombia,170,272,643,,915,"(4.697144,-74.140516)"
2019,Julio,República Del Congo,178,1,1,,2,"(4.697144,-74.140516)"
2019,Julio,República Democrática del Congo,180,1,0,,1,"(4.697144,-74.140516)"
2019,Julio,República de Corea,410,2,2,,4,"(3.541112,-76.384584)"
2019,Julio,República de Corea,410,32,26,,58,"(4.697144,-74.140516)"
2019,Julio,República de Corea,410,13,18,,31,"(6.171601,-75.427454)"
2019,Julio,Costa de Marfil,384,2,5,,7,"(4.697144,-74.140516)"
2019,Julio,Costa Rica,188,7,6,,13,"(10.445761,-75.516429)"
2019,Julio,Costa Rica,188,30,24,,54,"(10.886611,-74.776708)"
2019,Julio,Costa Rica,188,1,9,,10,"(12.5744111,-81.703935)"
2019,Julio,Costa Rica,188,2,4,,6,"(12.586067,-81.702563)"
2019,Julio,Costa Rica,188,48,49,,97,"(3.541112,-76.384584)"
2019,Julio,Costa Rica,188,1176,1205,,2381,"(4.697144,-74.140516)"
2019,Julio,Costa Rica,188,17,17,,34,"(4.815061,-75.736532)"
2019,Julio,Costa Rica,188,162,153,,315,"(6.171601,-75.427454)"
2019,Julio,Costa Rica,188,2,5,,7,"(7.128456,-73.183637)"
2019,Julio,Croacia,191,1,0,,1,"(3.541112,-76.384584)"
2019,Julio,Croacia,191,16,13,,29,"(4.697144,-74.140516)"
2019,Julio,Croacia,191,1,3,,4,"(6.171601,-75.427454)"
2019,Julio,Cuba,192,2,6,,8,"(10.445761,-75.516429)"
2019,Julio,Cuba,192,14,8,,22,"(10.886611,-74.776708)"
2019,Julio,Cuba,192,27,16,,43,"(3.541112,-76.384584)"
2019,Julio,Cuba,192,1617,1253,,2870,"(4.697144,-74.140516)"
2019,Julio,Cuba,192,8,7,,15,"(4.815061,-75.736532)"
2019,Julio,Cuba,192,101,75,,176,"(6.171601,-75.427454)"
2019,Julio,Cuba,192,2,1,,3,"(7.128456,-73.183637)"
2019,Julio,Curazao,99999,2,4,,6,"(10.445761,-75.516429)"
2019,Julio,Curazao,99999,1,1,,2,"(10.886611,-74.776708)"
2019,Julio,Curazao,99999,2,2,,4,"(3.541112,-76.384584)"
2019,Julio,Curazao,99999,1046,913,,1959,"(4.697144,-74.140516)"
2019,Julio,Curazao,99999,15,8,,23,"(6.171601,-75.427454)"
2019,Julio,Curazao,99999,1,0,,1,"(7.128456,-73.183637)"
2019,Julio,República Checa,203,9,13,,22,"(4.697144,-74.140516)"
2019,Julio,República Checa,203,0,1,,1,"(6.171601,-75.427454)"
2019,Julio,Chile,152,0,1,,1,"(0.812436,-77.847006)"
2019,Julio,Chile,152,64,101,,165,"(0.814836,-77.662532)"
2019,Julio,Chile,152,0,2,,2,"(1.813928,-78.763924)"
2019,Julio,Chile,152,26,20,,46,"(10.445761,-75.516429)"
2019,Julio,Chile,152,38,25,,63,"(10.886611,-74.776708)"
2019,Julio,Chile,152,478,316,,794,"(3.541112,-76.384584)"
2019,Julio,Chile,152,4407,4031,,8438,"(4.697144,-74.140516)"
2019,Julio,Chile,152,42,34,,76,"(4.815061,-75.736532)"
2019,Julio,Chile,152,213,175,,388,"(6.171601,-75.427454)"
2019,Julio,Chile,152,4,5,,9,"(7.128456,-73.183637)"
2019,Julio,China,156,1,0,,1,"(10.445761,-75.516429)"
2019,Julio,China,156,0,3,,3,"(10.886611,-74.776708)"
2019,Julio,China,156,8,12,,20,"(3.541112,-76.384584)"
2019,Julio,China,156,205,476,,681,"(4.697144,-74.140516)"
2019,Julio,China,156,25,90,,115,"(6.171601,-75.427454)"
2019,Julio,Chipre,196,0,2,,2,"(3.541112,-76.384584)"
2019,Julio,Chipre,196,1,2,,3,"(4.697144,-74.140516)"
2019,Julio,Dinamarca,208,1,1,,2,"(10.445761,-75.516429)"
2019,Julio,Dinamarca,208,1,1,,2,"(10.886611,-74.776708)"
2019,Julio,Dinamarca,208,4,1,,5,"(3.541112,-76.384584)"
2019,Julio,Dinamarca,208,77,74,,151,"(4.697144,-74.140516)"
2019,Julio,Dinamarca,208,13,8,,21,"(6.171601,-75.427454)"
2019,Julio,Dinamarca,208,0,1,,1,"(7.128456,-73.183637)"
2019,Julio,Dominica,212,1,0,,1,"(3.541112,-76.384584)"
2019,Julio,Dominica,212,1,1,,2,"(4.697144,-74.140516)"
2019,Julio,Ecuador,218,1,2,,3,"(-0.193180,-74.784874)"
2019,Julio,Ecuador,218,714,997,,1711,"(0.25129,-76.875963)"
2019,Julio,Ecuador,218,56,59,,115,"(0.812436,-77.847006)"
2019,Julio,Ecuador,218,7799,8527,,16326,"(0.814836,-77.662532)"
2019,Julio,Ecuador,218,188,177,,365,"(1.813928,-78.763924)"
2019,Julio,Ecuador,218,2,1,,3,"(10.445761,-75.516429)"
2019,Julio,Ecuador,218,3,4,,7,"(10.886611,-74.776708)"
2019,Julio,Ecuador,218,404,404,,808,"(3.541112,-76.384584)"
2019,Julio,Ecuador,218,2843,4217,,7060,"(4.697144,-74.140516)"
2019,Julio,Ecuador,218,1,2,,3,"(4.815061,-75.736532)"
2019,Julio,Ecuador,218,19,35,,54,"(6.171601,-75.427454)"
2019,Julio,Ecuador,218,2,0,,2,"(7.128456,-73.183637)"
2019,Julio,Egipto,818,1,0,,1,"(10.886611,-74.776708)"
2019,Julio,Egipto,818,25,24,,49,"(4.697144,-74.140516)"
2019,Julio,Egipto,818,4,5,,9,"(6.171601,-75.427454)"
2019,Julio,El Salvador,222,0,1,,1,"(10.445761,-75.516429)"
2019,Julio,El Salvador,222,1,2,,3,"(10.886611,-74.776708)"
2019,Julio,El Salvador,222,3,13,,16,"(3.541112,-76.384584)"
2019,Julio,El Salvador,222,1021,1269,,2290,"(4.697144,-74.140516)"
2019,Julio,El Salvador,222,219,255,,474,"(6.171601,-75.427454)"
2019,Julio,Emiratos Árabes,784,3,1,,4,"(10.445761,-75.516429)"
2019,Julio,Emiratos Árabes,784,0,1,,1,"(10.886611,-74.776708)"
2019,Julio,Emiratos Árabes,784,1,1,,2,"(4.452882,-75.766298)"
2019,Julio,Emiratos Árabes,784,100,297,,397,"(4.697144,-74.140516)"
2019,Julio,Emiratos Árabes,784,5,11,,16,"(6.171601,-75.427454)"
2019,Julio,Eritrea,232,1,0,,1,"(4.697144,-74.140516)"
2019,Julio,Eslovaquia,703,0,2,,2,"(4.697144,-74.140516)"
2019,Julio,Eslovenia,705,3,5,,8,"(4.697144,-74.140516)"
2019,Julio,Eslovenia,705,1,0,,1,"(6.171601,-75.427454)"
2019,Julio,Estados Unidos de América,840,4050,3216,,7266,"(10.445761,-75.516429)"
2019,Julio,Estados Unidos de América,840,3056,2358,,5414,"(10.886611,-74.776708)"
2019,Julio,Estados Unidos de América,840,2,7,,9,"(11.117806,-74.232622)"
2019,Julio,Estados Unidos de América,840,0,2,,2,"(11.528919,-72.919681)"
2019,Julio,Estados Unidos de América,840,58,38,,96,"(12.586067,-81.702563)"
2019,Julio,Estados Unidos de América,840,8170,5729,,13899,"(3.541112,-76.384584)"
2019,Julio,Estados Unidos de América,840,835,623,,1458,"(4.452882,-75.766298)"
2019,Julio,Estados Unidos de América,840,37060,30767,,67829,"(4.697144,-74.140516)"
2019,Julio,Estados Unidos de América,840,1463,950,,2413,"(4.815061,-75.736532)"
2019,Julio,Estados Unidos de América,840,1,0,,1,"(6.17134,-75.427194)"
2019,Julio,Estados Unidos de América,840,12019,9149,,21168,"(6.171601,-75.427454)"
2019,Julio,Estados Unidos de América,840,414,282,,696,"(7.128456,-73.183637)"
2019,Julio,Estonia,233,1,0,,1,"(10.445761,-75.516429)"
2019,Julio,Estonia,233,4,3,,7,"(4.697144,-74.140516)"
2019,Julio,Estonia,233,0,1,,1,"(6.171601,-75.427454)"
2019,Julio,Etiopia,231,1,2,,3,"(4.697144,-74.140516)"
2019,Julio,Etiopia,231,1,0,,1,"(6.171601,-75.427454)"
2019,Julio,Filipinas,608,5,5,,10,"(4.697144,-74.140516)"
2019,Julio,Filipinas,608,3,1,,4,"(6.171601,-75.427454)"
2019,Julio,Finlandia,246,1,0,,1,"(10.445761,-75.516429)"
2019,Julio,Finlandia,246,1,1,,2,"(3.541112,-76.384584)"
2019,Julio,Finlandia,246,20,11,,31,"(4.697144,-74.140516)"
2019,Julio,Francia,250,9,8,,17,"(10.445761,-75.516429)"
2019,Julio,Francia,250,12,8,,20,"(10.886611,-74.776708)"
2019,Julio,Francia,250,76,49,,125,"(3.541112,-76.384584)"
2019,Julio,Francia,250,2274,1703,,3977,"(4.697144,-74.140516)"
2019,Julio,Francia,250,6,11,,17,"(4.815061,-75.736532)"
2019,Julio,Francia,250,143,102,,245,"(6.171601,-75.427454)"
2019,Julio,Gambia,270,0,1,,1,"(4.697144,-74.140516)"
2019,Julio,Georgia,268,0,1,,1,"(4.697144,-74.140516)"
2019,Julio,Ghana,288,5,3,,8,"(4.697144,-74.140516)"
2019,Julio,Granada,308,1,0,,1,"(11.247723,-74.213989)"
2019,Julio,Granada,308,2,0,,2,"(4.697144,-74.140516)"
2019,Julio,Grecia,300,1,0,,1,"(3.541112,-76.384584)"
2019,Julio,Grecia,300,61,32,,93,"(4.697144,-74.140516)"
2019,Julio,Grecia,300,4,4,,8,"(6.171601,-75.427454)"
2019,Julio,Guatemala,320,1,3,,4,"(10.445761,-75.516429)"
2019,Julio,Guatemala,320,9,6,,15,"(10.886611,-74.776708)"
2019,Julio,Guatemala,320,1,2,,3,"(12.586067,-81.702563)"
2019,Julio,Guatemala,320,16,33,,49,"(3.541112,-76.384584)"
2019,Julio,Guatemala,320,576,702,,1278,"(4.697144,-74.140516)"
2019,Julio,Guatemala,320,16,23,,39,"(4.815061,-75.736532)"
2019,Julio,Guatemala,320,107,138,,245,"(6.171601,-75.427454)"
2019,Julio,Guatemala,320,6,2,,8,"(7.128456,-73.183637)"
2019,Julio,Guyana,328,0,2,,2,"(10.445761,-75.516429)"
2019,Julio,Guyana,328,3,3,,6,"(10.886611,-74.776708)"
2019,Julio,Guyana,328,0,1,,1,"(3.541112,-76.384584)"
2019,Julio,Guyana,328,3,9,,12,"(4.697144,-74.140516)"
2019,Julio,Guyana,328,4,2,,6,"(4.815061,-75.736532)"
2019,Julio,Guyana,328,4,3,,7,"(6.171601,-75.427454)"
2019,Julio,Guinea,324,1,0,,1,"(4.697144,-74.140516)"
2019,Julio,Guinea Ecuatorial,226,0,2,,2,"(3.541112,-76.384584)"
2019,Julio,Guinea Ecuatorial,226,1,3,,4,"(4.697144,-74.140516)"
2019,Julio,Guayana Francesa/Departamento de Ultramar Francés,254,0,1,,1,"(10.886611,-74.776708)"
2019,Julio,Guayana Francesa/Departamento de Ultramar Francés,254,0,1,,1,"(4.697144,-74.140516)"
2019,Julio,Guayana Francesa/Departamento de Ultramar Francés,254,1,0,,1,"(6.171601,-75.427454)"
2019,Julio,Haití,332,0,1,,1,"(10.886611,-74.776708)"
2019,Julio,Haití,332,0,1,,1,"(3.541112,-76.384584)"
2019,Julio,Haití,332,3,5,,8,"(4.697144,-74.140516)"
2019,Julio,Haití,332,0,6,,6,"(6.171601,-75.427454)"
2019,Julio,Honduras,340,2,20,,22,"(10.408582,-75.538003)"
2019,Julio,Honduras,340,0,15,,15,"(10.445761,-75.516429)"
2019,Julio,Honduras,340,5,10,,15,"(10.886611,-74.776708)"
2019,Julio,Honduras,340,0,2,,2,"(12.586067,-81.702563)"
2019,Julio,Honduras,340,1,0,,1,"(13.3387613,-81.372937)"
2019,Julio,Honduras,340,20,55,,75,"(3.541112,-76.384584)"
2019,Julio,Honduras,340,104,163,,267,"(4.697144,-74.140516)"
2019,Julio,Honduras,340,4,4,,8,"(4.815061,-75.736532)"
2019,Julio,Honduras,340,46,85,,131,"(6.171601,-75.427454)"
2019,Julio,Honduras,340,3,10,,13,"(7.128456,-73.183637)"
2019,Julio,Hong Kong,344,2,3,,5,"(10.445761,-75.516429)"
2019,Julio,Hong Kong,344,1,0,,1,"(3.541112,-76.384584)"
2019,Julio,Hong Kong,344,10,14,,24,"(4.697144,-74.140516)"
2019,Julio,Hong Kong,344,2,4,,6,"(6.171601,-75.427454)"
2019,Julio,Hungría,348,10,16,,26,"(4.697144,-74.140516)"
2019,Julio,India,356,0,1,,1,"(10.445761,-75.516429)"
2019,Julio,India,356,1,0,,1,"(10.886611,-74.776708)"
2019,Julio,India,356,2,5,,7,"(3.541112,-76.384584)"
2019,Julio,India,356,34,12,,46,"(4.697144,-74.140516)"
2019,Julio,India,356,5,6,,11,"(6.171601,-75.427454)"
2019,Julio,Indonesia,360,8,9,,17,"(4.697144,-74.140516)"
2019,Julio,Iraq,368,2,5,,7,"(4.697144,-74.140516)"
2019,Julio,Iraq,368,0,2,,2,"(6.171601,-75.427454)"
2019,Julio,Irán,364,0,1,,1,"(4.697144,-74.140516)"
2019,Julio,República de Irlanda,372,1,0,,1,"(10.886611,-74.776708)"
2019,Julio,República de Irlanda,372,0,1,,1,"(3.541112,-76.384584)"
2019,Julio,República de Irlanda,372,12,5,,17,"(4.697144,-74.140516)"
2019,Julio,República de Irlanda,372,1,4,,5,"(6.171601,-75.427454)"
2019,Julio,Islandia,352,5,1,,6,"(4.697144,-74.140516)"
2019,Julio,Israel,376,3,4,,7,"(3.541112,-76.384584)"
2019,Julio,Israel,376,110,89,,199,"(4.697144,-74.140516)"
2019,Julio,Israel,376,6,4,,10,"(6.171601,-75.427454)"
2019,Julio,Italia,380,26,13,,39,"(10.445761,-75.516429)"
2019,Julio,Italia,380,11,5,,16,"(10.886611,-74.776708)"
2019,Julio,Italia,380,0,1,,1,"(12.586067,-81.702563)"
2019,Julio,Italia,380,125,55,,180,"(3.541112,-76.384584)"
2019,Julio,Italia,380,823,544,,1367,"(4.697144,-74.140516)"
2019,Julio,Italia,380,3,4,,7,"(4.815061,-75.736532)"
2019,Julio,Italia,380,108,67,,175,"(6.171601,-75.427454)"
2019,Julio,Italia,380,0,1,,1,"(7.128456,-73.183637)"
2019,Julio,Jamaica,388,1,0,,1,"(10.408582,-75.538003)"
2019,Julio,Jamaica,388,3,8,,11,"(10.445761,-75.516429)"
2019,Julio,Jamaica,388,2,5,,7,"(10.886611,-74.776708)"
2019,Julio,Jamaica,388,16,12,,28,"(3.541112,-76.384584)"
2019,Julio,Jamaica,388,50,62,,112,"(4.697144,-74.140516)"
2019,Julio,Jamaica,388,3,7,,10,"(4.815061,-75.736532)"
2019,Julio,Jamaica,388,15,17,,32,"(6.171601,-75.427454)"
2019,Julio,Jamaica,388,0,1,,1,"(7.128456,-73.183637)"
2019,Julio,Japón,392,0,2,,2,"(10.886611,-74.776708)"
2019,Julio,Japón,392,1,1,,2,"(3.541112,-76.384584)"
2019,Julio,Japón,392,67,76,,143,"(4.697144,-74.140516)"
2019,Julio,Japón,392,2,0,,2,"(4.815061,-75.736532)"
2019,Julio,Japón,392,11,9,,20,"(6.171601,-75.427454)"
2019,Julio,Jordania,400,5,4,,9,"(4.697144,-74.140516)"
2019,Julio,Kazajistán,398,1,2,,3,"(4.697144,-74.140516)"
2019,Julio,Kenia,404,1,0,,1,"(3.541112,-76.384584)"
2019,Julio,Kenia,404,4,8,,12,"(4.697144,-74.140516)"
2019,Julio,Kenia,404,2,0,,2,"(6.171601,-75.427454)"
2019,Julio,Kuwait,414,1,0,,1,"(3.541112,-76.384584)"
2019,Julio,Kuwait,414,4,6,,10,"(4.697144,-74.140516)"
2019,Julio,Kuwait,414,0,1,,1,"(6.171601,-75.427454)"
2019,Julio,Letonia,428,1,2,,3,"(4.697144,-74.140516)"
2019,Julio,Letonia,428,0,1,,1,"(6.171601,-75.427454)"
2019,Julio,Lituania,440,1,0,,1,"(4.697144,-74.140516)"
2019,Julio,Líbano,422,6,12,,18,"(10.886611,-74.776708)"
2019,Julio,Líbano,422,3,2,,5,"(3.541112,-76.384584)"
2019,Julio,Líbano,422,18,21,,39,"(4.697144,-74.140516)"
2019,Julio,Líbano,422,0,1,,1,"(4.815061,-75.736532)"
2019,Julio,Líbano,422,0,1,,1,"(7.128456,-73.183637)"
2019,Julio,Luxemburgo,442,2,0,,2,"(10.886611,-74.776708)"
2019,Julio,Luxemburgo,442,13,10,,23,"(4.697144,-74.140516)"
2019,Julio,Madagascar,450,2,0,,2,"(4.697144,-74.140516)"
2019,Julio,Malasia,458,5,5,,10,"(4.697144,-74.140516)"
2019,Julio,Malta,470,0,2,,2,"(3.541112,-76.384584)"
2019,Julio,Malta,470,28,26,,54,"(4.697144,-74.140516)"
2019,Julio,Malta,470,6,2,,8,"(6.171601,-75.427454)"
2019,Julio,Marruecos,504,13,9,,22,"(4.697144,-74.140516)"
2019,Julio,Marruecos,504,1,1,,2,"(6.171601,-75.427454)"
2019,Julio,Mauricio,480,1,0,,1,"(4.697144,-74.140516)"
2019,Julio,Mauritania,478,0,4,,4,"(4.697144,-74.140516)"
2019,Julio,Martinica/Departamento de Ultramar Francés,474,1,1,,2,"(4.697144,-74.140516)"
2019,Julio,México,484,83,63,,146,"(10.445761,-75.516429)"
2019,Julio,México,484,139,101,,240,"(10.886611,-74.776708)"
2019,Julio,México,484,1,0,,1,"(12.586067,-81.702563)"
2019,Julio,México,484,900,692,,1592,"(3.541112,-76.384584)"
2019,Julio,México,484,2,3,,5,"(4.452882,-75.766298)"
2019,Julio,México,484,15257,13909,,29166,"(4.697144,-74.140516)"
2019,Julio,México,484,169,153,,322,"(4.815061,-75.736532)"
2019,Julio,México,484,4241,3365,,7606,"(6.171601,-75.427454)"
2019,Julio,México,484,90,79,,169,"(7.128456,-73.183637)"
2019,Julio,República de Moldavia,498,0,1,,1,"(4.697144,-74.140516)"
2019,Julio,Mónaco,492,1,1,,2,"(4.697144,-74.140516)"
2019,Julio,Mónaco,492,0,1,,1,"(6.171601,-75.427454)"
2019,Julio,Mongolia,496,1,0,,1,"(10.886611,-74.776708)"
2019,Julio,Montenegro,499,1,1,,2,"(4.697144,-74.140516)"
2019,Julio,Mozambique,508,0,1,,1,"(3.541112,-76.384584)"
2019,Julio,Mozambique,508,0,1,,1,"(4.697144,-74.140516)"
2019,Julio,Nauru,520,1,1,,2,"(4.697144,-74.140516)"
2019,Julio,Nepal,524,1,0,,1,"(4.697144,-74.140516)"
2019,Julio,Nicaragua,558,2,3,,5,"(10.445761,-75.516429)"
2019,Julio,Nicaragua,558,0,5,,5,"(10.886611,-74.776708)"
2019,Julio,Nicaragua,558,1,0,,1,"(12.586067,-81.702563)"
2019,Julio,Nicaragua,558,7,26,,33,"(3.541112,-76.384584)"
2019,Julio,Nicaragua,558,35,85,,120,"(4.697144,-74.140516)"
2019,Julio,Nicaragua,558,3,3,,6,"(4.815061,-75.736532)"
2019,Julio,Nicaragua,558,27,74,,101,"(6.171601,-75.427454)"
2019,Julio,Nicaragua,558,0,2,,2,"(7.128456,-73.183637)"
2019,Julio,Nigeria,566,2,6,,8,"(4.697144,-74.140516)"
2019,Julio,Níger,562,0,2,,2,"(4.697144,-74.140516)"
2019,Julio,Noruega,578,4,1,,5,"(10.445761,-75.516429)"
2019,Julio,Noruega,578,1,0,,1,"(10.886611,-74.776708)"
2019,Julio,Noruega,578,7,4,,11,"(3.541112,-76.384584)"
2019,Julio,Noruega,578,43,27,,70,"(4.697144,-74.140516)"
2019,Julio,Noruega,578,6,4,,10,"(6.171601,-75.427454)"
2019,Julio,Noruega,578,0,1,,1,"(7.128456,-73.183637)"
2019,Julio,Nueva Caledonia/Territorio francés,540,0,1,,1,"(4.697144,-74.140516)"
2019,Julio,Nueva Zelanda,554,0,2,,2,"(3.541112,-76.384584)"
2019,Julio,Nueva Zelanda,554,48,38,,86,"(4.697144,-74.140516)"
2019,Julio,Nueva Zelanda,554,1,2,,3,"(6.171601,-75.427454)"
2019,Julio,Omán,512,5,8,,13,"(4.697144,-74.140516)"
2019,Julio,Omán,512,0,1,,1,"(6.171601,-75.427454)"
2019,Julio,Panamá,591,18,61,,79,"(10.408582,-75.538003)"
2019,Julio,Panamá,591,1362,1198,,2560,"(10.445761,-75.516429)"
2019,Julio,Panamá,591,715,578,,1293,"(10.886611,-74.776708)"
2019,Julio,Panamá,591,0,18,,18,"(11.360009,-72.129330)"
2019,Julio,Panamá,591,3,20,,23,"(12.5744111,-81.703935)"
2019,Julio,Panamá,591,99,107,,206,"(12.586067,-81.702563)"
2019,Julio,Panamá,591,2884,2290,,5174,"(3.541112,-76.384584)"
2019,Julio,Panamá,591,8305,8911,,17216,"(4.697144,-74.140516)"
2019,Julio,Panamá,591,490,361,,851,"(4.815061,-75.736532)"
2019,Julio,Panamá,591,4,5,,9,"(6.17134,-75.427194)"
2019,Julio,Panamá,591,2680,2549,,5230,"(6.171601,-75.427454)"
2019,Julio,Panamá,591,2,6,,8,"(6.228046,-77.404104)"
2019,Julio,Panamá,591,4,12,,16,"(7.102626,-77.762647)"
2019,Julio,Panamá,591,170,136,,306,"(7.128456,-73.183637)"
2019,Julio,Panamá,591,24,80,,104,"(8.635765,-77.346578)"
2019,Julio,Paraguay,600,1,0,,1,"(10.445761,-75.516429)"
2019,Julio,Paraguay,600,1,2,,3,"(10.886611,-74.776708)"
2019,Julio,Paraguay,600,7,9,,16,"(3.541112,-76.384584)"
2019,Julio,Paraguay,600,82,147,,229,"(4.697144,-74.140516)"
2019,Julio,Paraguay,600,10,3,,13,"(4.815061,-75.736532)"
2019,Julio,Paraguay,600,22,36,,58,"(6.171601,-75.427454)"
2019,Julio,Paraguay,600,0,1,,1,"(7.128456,-73.183637)"
2019,Julio,Perú,604,8,12,,20,"(-0.193180,-74.784874)"
2019,Julio,Perú,604,3,6,,9,"(-4.197703,-69.941278)"
2019,Julio,Perú,604,170,219,,389,"(-4.223468,-69.945098)"
2019,Julio,Perú,604,1,1,,2,"(0.25129,-76.875963)"
2019,Julio,Perú,604,75,120,,195,"(0.814836,-77.662532)"
2019,Julio,Perú,604,1,2,,3,"(1.813928,-78.763924)"
2019,Julio,Perú,604,80,109,,189,"(10.445761,-75.516429)"
2019,Julio,Perú,604,2,11,,13,"(10.886611,-74.776708)"
2019,Julio,Perú,604,0,1,,1,"(12.586067,-81.702563)"
2019,Julio,Perú,604,359,341,,700,"(3.541112,-76.384584)"
2019,Julio,Perú,604,5007,5919,,10926,"(4.697144,-74.140516)"
2019,Julio,Perú,604,9,10,,19,"(4.815061,-75.736532)"
2019,Julio,Perú,604,888,858,,1746,"(6.171601,-75.427454)"
2019,Julio,Perú,604,5,4,,9,"(7.128456,-73.183637)"
2019,Julio,Polonia,616,0,2,,2,"(10.445761,-75.516429)"
2019,Julio,Polonia,616,0,1,,1,"(10.886611,-74.776708)"
2019,Julio,Polonia,616,10,24,,34,"(4.697144,-74.140516)"
2019,Julio,Polonia,616,1,1,,2,"(6.171601,-75.427454)"
2019,Julio,Portugal,620,1,1,,2,"(10.886611,-74.776708)"
2019,Julio,Portugal,620,0,1,,1,"(12.586067,-81.702563)"
2019,Julio,Portugal,620,8,4,,12,"(3.541112,-76.384584)"
2019,Julio,Portugal,620,190,254,,444,"(4.697144,-74.140516)"
2019,Julio,Portugal,620,20,30,,50,"(6.171601,-75.427454)"
2019,Julio,Puerto Rico/Territorio de Estados Unidos,630,11,9,,20,"(10.445761,-75.516429)"
2019,Julio,Puerto Rico/Territorio de Estados Unidos,630,12,20,,32,"(10.886611,-74.776708)"
2019,Julio,Puerto Rico/Territorio de Estados Unidos,630,51,39,,90,"(3.541112,-76.384584)"
2019,Julio,Puerto Rico/Territorio de Estados Unidos,630,341,323,,664,"(4.697144,-74.140516)"
2019,Julio,Puerto Rico/Territorio de Estados Unidos,630,3,4,,7,"(4.815061,-75.736532)"
2019,Julio,Puerto Rico/Territorio de Estados Unidos,630,47,30,,77,"(6.171601,-75.427454)"
2019,Julio,Puerto Rico/Territorio de Estados Unidos,630,7,4,,11,"(7.128456,-73.183637)"
2019,Julio,Qatar,634,1,0,,1,"(10.886611,-74.776708)"
2019,Julio,Qatar,634,3,3,,6,"(3.541112,-76.384584)"
2019,Julio,Qatar,634,9,6,,15,"(4.697144,-74.140516)"
2019,Julio,Qatar,634,3,2,,5,"(6.171601,-75.427454)"
2019,Julio,Reino Unido de Gran Bretaña e Irlanda del Norte,826,2,2,,4,"(10.445761,-75.516429)"
2019,Julio,Reino Unido de Gran Bretaña e Irlanda del Norte,826,2,2,,4,"(10.886611,-74.776708)"
2019,Julio,Reino Unido de Gran Bretaña e Irlanda del Norte,826,15,10,,25,"(3.541112,-76.384584)"
2019,Julio,Reino Unido de Gran Bretaña e Irlanda del Norte,826,1848,1443,,3291,"(4.697144,-74.140516)"
2019,Julio,Reino Unido de Gran Bretaña e Irlanda del Norte,826,22,27,,49,"(6.171601,-75.427454)"
2019,Julio,República CentroÁfricana,140,5,3,,8,"(4.697144,-74.140516)"
2019,Julio,Federación de Rusia,643,1,1,,2,"(10.886611,-74.776708)"
2019,Julio,Federación de Rusia,643,1,0,,1,"(3.541112,-76.384584)"
2019,Julio,Federación de Rusia,643,55,57,,112,"(4.697144,-74.140516)"
2019,Julio,Federación de Rusia,643,0,1,,1,"(4.815061,-75.736532)"
2019,Julio,Federación de Rusia,643,5,5,,10,"(6.171601,-75.427454)"
2019,Julio,República Dominicana,214,28,25,,53,"(10.445761,-75.516429)"
2019,Julio,República Dominicana,214,11,15,,26,"(10.886611,-74.776708)"
2019,Julio,República Dominicana,214,0,1,,1,"(12.586067,-81.702563)"
2019,Julio,República Dominicana,214,188,134,,322,"(3.541112,-76.384584)"
2019,Julio,República Dominicana,214,3409,3243,,6652,"(4.697144,-74.140516)"
2019,Julio,República Dominicana,214,36,26,,62,"(4.815061,-75.736532)"
2019,Julio,República Dominicana,214,273,235,,508,"(6.171601,-75.427454)"
2019,Julio,República Dominicana,214,26,24,,50,"(7.128456,-73.183637)"
2019,Julio,Reunión,638,0,2,,2,"(4.697144,-74.140516)"
2019,Julio,Rumania,642,16,9,,25,"(4.697144,-74.140516)"
2019,Julio,Rwanda,646,0,1,,1,"(4.697144,-74.140516)"
2019,Julio,Sahara Occidental/Desierto Sahara,732,0,1,,1,"(4.697144,-74.140516)"
2019,Julio,Santa Lucia,662,0,2,,2,"(4.697144,-74.140516)"
2019,Julio,Senegal,686,0,1,,1,"(4.697144,-74.140516)"
2019,Julio,Serbia,688,0,1,,1,"(10.445761,-75.516429)"
2019,Julio,Serbia,688,2,5,,7,"(4.697144,-74.140516)"
2019,Julio,Singapur,702,1,2,,3,"(10.445761,-75.516429)"
2019,Julio,Singapur,702,0,1,,1,"(3.541112,-76.384584)"
2019,Julio,Singapur,702,15,13,,28,"(4.697144,-74.140516)"
2019,Julio,Singapur,702,0,1,,1,"(6.171601,-75.427454)"
2019,Julio,Sri Lanka,144,1,1,,2,"(4.697144,-74.140516)"
2019,Julio,Sudáfrica,710,9,5,,14,"(4.697144,-74.140516)"
2019,Julio,Sudáfrica,710,1,0,,1,"(6.171601,-75.427454)"
2019,Julio,Suecia,752,5,4,,9,"(10.445761,-75.516429)"
2019,Julio,Suecia,752,4,2,,6,"(10.886611,-74.776708)"
2019,Julio,Suecia,752,15,12,,27,"(3.541112,-76.384584)"
2019,Julio,Suecia,752,122,88,,210,"(4.697144,-74.140516)"
2019,Julio,Suecia,752,2,1,,3,"(4.815061,-75.736532)"
2019,Julio,Suecia,752,22,13,,35,"(6.171601,-75.427454)"
2019,Julio,Suiza,756,16,5,,21,"(10.445761,-75.516429)"
2019,Julio,Suiza,756,6,0,,6,"(10.886611,-74.776708)"
2019,Julio,Suiza,756,47,38,,85,"(3.541112,-76.384584)"
2019,Julio,Suiza,756,367,233,,600,"(4.697144,-74.140516)"
2019,Julio,Suiza,756,57,35,,92,"(6.171601,-75.427454)"
2019,Julio,Surinam,740,0,3,,3,"(10.886611,-74.776708)"
2019,Julio,Surinam,740,3,35,,38,"(3.541112,-76.384584)"
2019,Julio,Surinam,740,5,14,,19,"(4.697144,-74.140516)"
2019,Julio,Surinam,740,2,2,,4,"(6.171601,-75.427454)"
2019,Julio,Taiwán,158,2,1,,3,"(4.697144,-74.140516)"
2019,Julio,Taiwán,158,0,3,,3,"(6.171601,-75.427454)"
2019,Julio,República de Tayikistán,762,0,1,,1,"(4.697144,-74.140516)"
2019,Julio,Tailandia,764,0,1,,1,"(10.886611,-74.776708)"
2019,Julio,Tailandia,764,26,30,,56,"(4.697144,-74.140516)"
2019,Julio,Tailandia,764,3,3,,6,"(6.171601,-75.427454)"
2019,Julio,Tanzania,834,1,1,,2,"(4.697144,-74.140516)"
2019,Julio,Tanzania,834,1,0,,1,"(6.171601,-75.427454)"
2019,Julio,Trinidad y Tobago,780,3,7,,10,"(10.445761,-75.516429)"
2019,Julio,Trinidad y Tobago,780,3,4,,7,"(10.886611,-74.776708)"
2019,Julio,Trinidad y Tobago,780,4,11,,15,"(3.541112,-76.384584)"
2019,Julio,Trinidad y Tobago,780,22,41,,63,"(4.697144,-74.140516)"
2019,Julio,Trinidad y Tobago,780,2,8,,10,"(4.815061,-75.736532)"
2019,Julio,Trinidad y Tobago,780,14,8,,22,"(6.171601,-75.427454)"
2019,Julio,Trinidad y Tobago,780,2,6,,8,"(7.128456,-73.183637)"
2019,Julio,Túnez,788,1,1,,2,"(4.697144,-74.140516)"
2019,Julio,Túnez,788,1,1,,2,"(6.171601,-75.427454)"
2019,Julio,Turquía,792,0,1,,1,"(10.445761,-75.516429)"
2019,Julio,Turquía,792,2,3,,5,"(3.541112,-76.384584)"
2019,Julio,Turquía,792,617,413,,1030,"(4.697144,-74.140516)"
2019,Julio,Turquía,792,7,5,,12,"(6.171601,-75.427454)"
2019,Julio,Turkmenistán,795,0,2,,2,"(4.697144,-74.140516)"
2019,Julio,Ucrania,804,1,4,,5,"(4.697144,-74.140516)"
2019,Julio,Ucrania,804,0,1,,1,"(6.171601,-75.427454)"
2019,Julio,Uganda,800,0,3,,3,"(4.697144,-74.140516)"
2019,Julio,Uruguay,858,0,1,,1,"(0.814836,-77.662532)"
2019,Julio,Uruguay,858,1,2,,3,"(10.445761,-75.516429)"
2019,Julio,Uruguay,858,0,3,,3,"(10.886611,-74.776708)"
2019,Julio,Uruguay,858,14,19,,33,"(3.541112,-76.384584)"
2019,Julio,Uruguay,858,89,126,,215,"(4.697144,-74.140516)"
2019,Julio,Uruguay,858,6,14,,20,"(4.815061,-75.736532)"
2019,Julio,Uruguay,858,10,22,,32,"(6.171601,-75.427454)"
2019,Julio,Uruguay,858,1,2,,3,"(7.128456,-73.183637)"
2019,Julio,Uzbekistán,860,0,1,,1,"(4.697144,-74.140516)"
2019,Julio,Venezuela,862,7,13,,20,"(10.445761,-75.516429)"
2019,Julio,Venezuela,862,33,50,,83,"(10.886611,-74.776708)"
2019,Julio,Venezuela,862,4,0,,4,"(11.117806,-74.232622)"
2019,Julio,Venezuela,862,1040,1233,,2273,"(11.360009,-72.129330)"
2019,Julio,Venezuela,862,531,360,,891,"(3.541112,-76.384584)"
2019,Julio,Venezuela,862,1,1,,2,"(3.866713,-67.927521)"
2019,Julio,Venezuela,862,774,885,,1659,"(4.697144,-74.140516)"
2019,Julio,Venezuela,862,2,2,,4,"(4.815061,-75.736532)"
2019,Julio,Venezuela,862,212,220,,432,"(6.171601,-75.427454)"
2019,Julio,Venezuela,862,15,30,,45,"(6.185799,-67.483929)"
2019,Julio,Venezuela,862,250,219,,469,"(7.088729,-70.740253)"
2019,Julio,Venezuela,862,3,3,,6,"(7.128456,-73.183637)"
2019,Julio,Venezuela,862,719,751,,1470,"(7.818934,-72.453226)"
2019,Julio,Venezuela,862,76,91,,167,"(8.36068,-72.409396)"
2019,Julio,Vietnam,704,3,4,,7,"(4.697144,-74.140516)"
2019,Julio,Vietnam,704,1,0,,1,"(6.171601,-75.427454)"
2019,Julio,Islas Vírgenes Británicas/Territorio Británico de Ultramar,92,1,1,,2,"(3.541112,-76.384584)"
2019,Julio,Islas Vírgenes Británicas/Territorio Británico de Ultramar,92,1,1,,2,"(6.171601,-75.427454)"
2019,Julio,Islas Vírgenes Estadounidenses/Territorio de Estados Unidos,850,0,1,,1,"(10.445761,-75.516429)"
2019,Julio,Zambia,894,0,1,,1,"(4.697144,-74.140516)"
2019,Agosto,Afganistán,4,2,5,,7,"(4.697144,-74.140516)"
2019,Agosto,Afganistán,4,0,1,,1,"(6.171601,-75.427454)"
2019,Agosto,Albania,8,2,1,,3,"(3.541112,-76.384584)"
2019,Agosto,Alemania,276,0,1,,1,"(0.25129,-76.875963)"
2019,Agosto,Alemania,276,1,0,,1,"(0.814836,-77.662532)"
2019,Agosto,Alemania,276,7,3,,10,"(10.445761,-75.516429)"
2019,Agosto,Alemania,276,8,4,,12,"(10.886611,-74.776708)"
2019,Agosto,Alemania,276,51,23,,74,"(3.541112,-76.384584)"
2019,Agosto,Alemania,276,2378,1946,,4324,"(4.697144,-74.140516)"
2019,Agosto,Alemania,276,4,0,,4,"(4.815061,-75.736532)"
2019,Agosto,Alemania,276,82,60,,142,"(6.171601,-75.427454)"
2019,Agosto,Andorra,20,1,0,,1,"(6.171601,-75.427454)"
2019,Agosto,Angola,24,0,1,,1,"(3.541112,-76.384584)"
2019,Agosto,Angola,24,0,5,,5,"(4.697144,-74.140516)"
2019,Agosto,Antigua y Barbuda,28,1,2,,3,"(4.697144,-74.140516)"
2019,Agosto,Antigua y Barbuda,28,1,0,,1,"(6.171601,-75.427454)"
2019,Agosto,Países Bajos,528,153,97,,250,"(10.445761,-75.516429)"
2019,Agosto,Países Bajos,528,15,17,,32,"(10.886611,-74.776708)"
2019,Agosto,Países Bajos,528,70,31,,101,"(3.541112,-76.384584)"
2019,Agosto,Países Bajos,528,909,833,,1742,"(4.697144,-74.140516)"
2019,Agosto,Países Bajos,528,4,3,,7,"(4.815061,-75.736532)"
2019,Agosto,Países Bajos,528,135,77,,212,"(6.171601,-75.427454)"
2019,Agosto,Países Bajos,528,1,0,,1,"(7.128456,-73.183637)"
2019,Agosto,Arabia Saudita,682,0,2,,2,"(10.445761,-75.516429)"
2019,Agosto,Arabia Saudita,682,0,1,,1,"(10.886611,-74.776708)"
2019,Agosto,Arabia Saudita,682,4,3,,7,"(3.541112,-76.384584)"
2019,Agosto,Arabia Saudita,682,26,48,,74,"(4.697144,-74.140516)"
2019,Agosto,Arabia Saudita,682,5,3,,8,"(6.171601,-75.427454)"
2019,Agosto,Argelia,12,1,7,,8,"(4.697144,-74.140516)"
2019,Agosto,Argentina,32,5,1,,6,"(0.814836,-77.662532)"
2019,Agosto,Argentina,32,27,12,,39,"(10.445761,-75.516429)"
2019,Agosto,Argentina,32,20,16,,36,"(10.886611,-74.776708)"
2019,Agosto,Argentina,32,1,0,,1,"(12.586067,-81.702563)"
2019,Agosto,Argentina,32,126,125,,251,"(3.541112,-76.384584)"
2019,Agosto,Argentina,32,2594,2568,,5162,"(4.697144,-74.140516)"
2019,Agosto,Argentina,32,23,15,,38,"(4.815061,-75.736532)"
2019,Agosto,Argentina,32,144,128,,272,"(6.171601,-75.427454)"
2019,Agosto,Argentina,32,6,1,,7,"(7.128456,-73.183637)"
2019,Agosto,República de Armenia,51,1,0,,1,"(3.541112,-76.384584)"
2019,Agosto,República de Armenia,51,1,1,,2,"(4.697144,-74.140516)"
2019,Agosto,Aruba,533,3421,2379,,5800,"(10.408582,-75.538003)"
2019,Agosto,Aruba,533,5,1,,6,"(10.445761,-75.516429)"
2019,Agosto,Aruba,533,64,36,,100,"(10.886611,-74.776708)"
2019,Agosto,Aruba,533,7,13,,20,"(11.528919,-72.919681)"
2019,Agosto,Aruba,533,36,18,,54,"(3.541112,-76.384584)"
2019,Agosto,Aruba,533,2237,1708,,3945,"(4.697144,-74.140516)"
2019,Agosto,Aruba,533,30,11,,41,"(4.815061,-75.736532)"
2019,Agosto,Aruba,533,54,41,,95,"(6.171601,-75.427454)"
2019,Agosto,Aruba,533,9,45,,54,"(7.128456,-73.183637)"
2019,Agosto,Australia,36,5,9,,14,"(3.541112,-76.384584)"
2019,Agosto,Australia,36,546,460,,1006,"(4.697144,-74.140516)"
2019,Agosto,Australia,36,2,0,,2,"(4.815061,-75.736532)"
2019,Agosto,Australia,36,19,22,,41,"(6.171601,-75.427454)"
2019,Agosto,Austria,40,1,1,,2,"(10.886611,-74.776708)"
2019,Agosto,Austria,40,5,0,,5,"(3.541112,-76.384584)"
2019,Agosto,Austria,40,49,43,,92,"(4.697144,-74.140516)"
2019,Agosto,Austria,40,9,8,,17,"(6.171601,-75.427454)"
2019,Agosto,Azerbaiyán,31,2,5,,7,"(4.697144,-74.140516)"
2019,Agosto,Bahamas,44,2,1,,3,"(10.445761,-75.516429)"
2019,Agosto,Bahamas,44,3,1,,4,"(10.886611,-74.776708)"
2019,Agosto,Bahamas,44,0,1,,1,"(12.586067,-81.702563)"
2019,Agosto,Bahamas,44,19,8,,27,"(3.541112,-76.384584)"
2019,Agosto,Bahamas,44,24,18,,42,"(4.697144,-74.140516)"
2019,Agosto,Bahamas,44,3,1,,4,"(4.815061,-75.736532)"
2019,Agosto,Bahamas,44,18,13,,31,"(6.171601,-75.427454)"
2019,Agosto,Bahamas,44,1,0,,1,"(7.128456,-73.183637)"
2019,Agosto,Bahréin,48,1,2,,3,"(3.541112,-76.384584)"
2019,Agosto,Bahréin,48,2,3,,5,"(4.697144,-74.140516)"
2019,Agosto,Bangladesh,50,2,0,,2,"(4.697144,-74.140516)"
2019,Agosto,Bangladesh,50,0,1,,1,"(6.171601,-75.427454)"
2019,Agosto,Barbados,52,3,1,,4,"(3.541112,-76.384584)"
2019,Agosto,Barbados,52,7,13,,20,"(4.697144,-74.140516)"
2019,Agosto,Barbados,52,1,1,,2,"(4.815061,-75.736532)"
2019,Agosto,Barbados,52,5,2,,7,"(6.171601,-75.427454)"
2019,Agosto,República de Belarús,112,3,0,,3,"(4.697144,-74.140516)"
2019,Agosto,República de Belarús,112,1,0,,1,"(7.818934,-72.453226)"
2019,Agosto,Bélgica,56,1,1,,2,"(10.445761,-75.516429)"
2019,Agosto,Bélgica,56,7,5,,12,"(10.886611,-74.776708)"
2019,Agosto,Bélgica,56,19,10,,29,"(3.541112,-76.384584)"
2019,Agosto,Bélgica,56,136,90,,226,"(4.697144,-74.140516)"
2019,Agosto,Bélgica,56,0,1,,1,"(4.815061,-75.736532)"
2019,Agosto,Bélgica,56,42,38,,80,"(6.171601,-75.427454)"
2019,Agosto,Belice,84,1,1,,2,"(10.886611,-74.776708)"
2019,Agosto,Belice,84,31,32,,63,"(4.697144,-74.140516)"
2019,Agosto,Belice,84,2,3,,5,"(6.171601,-75.427454)"
2019,Agosto,Benín,204,1,0,,1,"(10.445761,-75.516429)"
2019,Agosto,Benín,204,1,0,,1,"(4.697144,-74.140516)"
2019,Agosto,Bermudas/Territorio Británico de Ultramar,60,1,0,,1,"(3.541112,-76.384584)"
2019,Agosto,Bermudas/Territorio Británico de Ultramar,60,0,1,,1,"(4.697144,-74.140516)"
2019,Agosto,Bermudas/Territorio Británico de Ultramar,60,2,0,,2,"(6.171601,-75.427454)"
2019,Agosto,Bolivia,68,0,6,,6,"(0.814836,-77.662532)"
2019,Agosto,Bolivia,68,0,1,,1,"(10.445761,-75.516429)"
2019,Agosto,Bolivia,68,1,1,,2,"(10.886611,-74.776708)"
2019,Agosto,Bolivia,68,0,1,,1,"(12.586067,-81.702563)"
2019,Agosto,Bolivia,68,15,33,,48,"(3.541112,-76.384584)"
2019,Agosto,Bolivia,68,400,626,,1026,"(4.697144,-74.140516)"
2019,Agosto,Bolivia,68,10,15,,25,"(4.815061,-75.736532)"
2019,Agosto,Bolivia,68,23,30,,53,"(6.171601,-75.427454)"
2019,Agosto,Bolivia,68,1,0,,1,"(7.128456,-73.183637)"
2019,Agosto,Bosnia y Herzegovina,70,11,7,,18,"(4.697144,-74.140516)"
2019,Agosto,Botsuana,72,1,0,,1,"(4.697144,-74.140516)"
2019,Agosto,Brasil,76,139,252,,391,"(-4.197703,-69.941278)"
2019,Agosto,Brasil,76,8,30,,38,"(-4.223468,-69.945098)"
2019,Agosto,Brasil,76,1,0,,1,"(0.814836,-77.662532)"
2019,Agosto,Brasil,76,9,16,,25,"(10.445761,-75.516429)"
2019,Agosto,Brasil,76,15,24,,39,"(10.886611,-74.776708)"
2019,Agosto,Brasil,76,3,3,,6,"(12.586067,-81.702563)"
2019,Agosto,Brasil,76,109,150,,259,"(3.541112,-76.384584)"
2019,Agosto,Brasil,76,3252,4394,,7646,"(4.697144,-74.140516)"
2019,Agosto,Brasil,76,29,46,,75,"(4.815061,-75.736532)"
2019,Agosto,Brasil,76,161,197,,358,"(6.171601,-75.427454)"
2019,Agosto,Brasil,76,2,0,,2,"(7.128456,-73.183637)"
2019,Agosto,Brunei Darussalam,96,1,0,,1,"(4.697144,-74.140516)"
2019,Agosto,Bulgaria,100,3,3,,6,"(4.697144,-74.140516)"
2019,Agosto,Islas Caimán/Territorio Británico de Ultramar,136,4,0,,4,"(10.886611,-74.776708)"
2019,Agosto,Islas Caimán/Territorio Británico de Ultramar,136,5,1,,6,"(12.586067,-81.702563)"
2019,Agosto,Islas Caimán/Territorio Británico de Ultramar,136,1,0,,1,"(3.541112,-76.384584)"
2019,Agosto,Islas Caimán/Territorio Británico de Ultramar,136,6,6,,12,"(4.697144,-74.140516)"
2019,Agosto,Islas Caimán/Territorio Británico de Ultramar,136,5,1,,6,"(6.171601,-75.427454)"
2019,Agosto,Camboya,116,1,1,,2,"(4.697144,-74.140516)"
2019,Agosto,Camboya,116,1,0,,1,"(6.171601,-75.427454)"
2019,Agosto,Camerún,120,1,0,,1,"(4.697144,-74.140516)"
2019,Agosto,Canadá,124,37,26,,63,"(10.445761,-75.516429)"
2019,Agosto,Canadá,124,72,54,,126,"(10.886611,-74.776708)"
2019,Agosto,Canadá,124,1,0,,1,"(12.586067,-81.702563)"
2019,Agosto,Canadá,124,170,125,,295,"(3.541112,-76.384584)"
2019,Agosto,Canadá,124,0,2,,2,"(4.452882,-75.766298)"
2019,Agosto,Canadá,124,3228,2463,,5691,"(4.697144,-74.140516)"
2019,Agosto,Canadá,124,36,23,,59,"(4.815061,-75.736532)"
2019,Agosto,Canadá,124,428,320,,748,"(6.171601,-75.427454)"
2019,Agosto,Canadá,124,15,14,,29,"(7.128456,-73.183637)"
2019,Agosto,España,724,26,13,,39,"(10.445761,-75.516429)"
2019,Agosto,España,724,16,13,,29,"(10.886611,-74.776708)"
2019,Agosto,España,724,1,2,,3,"(12.586067,-81.702563)"
2019,Agosto,España,724,2416,1651,,4067,"(3.541112,-76.384584)"
2019,Agosto,España,724,0,1,,1,"(4.452882,-75.766298)"
2019,Agosto,España,724,15013,10647,,25660,"(4.697144,-74.140516)"
2019,Agosto,España,724,32,26,,58,"(4.815061,-75.736532)"
2019,Agosto,España,724,3312,2385,,5697,"(6.171601,-75.427454)"
2019,Agosto,España,724,3,1,,4,"(7.128456,-73.183637)"
2019,Agosto,Colombia,170,0,2,,2,"(10.445761,-75.516429)"
2019,Agosto,Colombia,170,348,780,,1128,"(4.697144,-74.140516)"
2019,Agosto,República Del Congo,178,1,0,,1,"(6.171601,-75.427454)"
2019,Agosto,Islas Heard Y Mcdonald,334,0,1,,1,"(4.697144,-74.140516)"
2019,Agosto,República de Corea,410,1,0,,1,"(3.541112,-76.384584)"
2019,Agosto,República de Corea,410,51,39,,90,"(4.697144,-74.140516)"
2019,Agosto,República de Corea,410,8,7,,15,"(6.171601,-75.427454)"
2019,Agosto,Costa de Marfil,384,1,0,,1,"(3.541112,-76.384584)"
2019,Agosto,Costa de Marfil,384,2,3,,5,"(4.697144,-74.140516)"
2019,Agosto,Costa de Marfil,384,0,4,,4,"(6.171601,-75.427454)"
2019,Agosto,Costa Rica,188,8,10,,18,"(10.445761,-75.516429)"
2019,Agosto,Costa Rica,188,19,14,,33,"(10.886611,-74.776708)"
2019,Agosto,Costa Rica,188,2,22,,24,"(12.5744111,-81.703935)"
2019,Agosto,Costa Rica,188,7,6,,13,"(12.586067,-81.702563)"
2019,Agosto,Costa Rica,188,40,47,,87,"(3.541112,-76.384584)"
2019,Agosto,Costa Rica,188,1045,1150,,2195,"(4.697144,-74.140516)"
2019,Agosto,Costa Rica,188,16,9,,25,"(4.815061,-75.736532)"
2019,Agosto,Costa Rica,188,110,112,,222,"(6.171601,-75.427454)"
2019,Agosto,Costa Rica,188,1,5,,6,"(7.128456,-73.183637)"
2019,Agosto,Croacia,191,1,1,,2,"(10.445761,-75.516429)"
2019,Agosto,Croacia,191,1,0,,1,"(3.541112,-76.384584)"
2019,Agosto,Croacia,191,15,13,,28,"(4.697144,-74.140516)"
2019,Agosto,Croacia,191,2,3,,5,"(6.171601,-75.427454)"
2019,Agosto,Cuba,192,5,9,,14,"(10.445761,-75.516429)"
2019,Agosto,Cuba,192,16,17,,33,"(10.886611,-74.776708)"
2019,Agosto,Cuba,192,2,0,,2,"(12.586067,-81.702563)"
2019,Agosto,Cuba,192,49,39,,88,"(3.541112,-76.384584)"
2019,Agosto,Cuba,192,1716,1413,,3129,"(4.697144,-74.140516)"
2019,Agosto,Cuba,192,19,17,,36,"(4.815061,-75.736532)"
2019,Agosto,Cuba,192,85,55,,140,"(6.171601,-75.427454)"
2019,Agosto,Cuba,192,9,8,,17,"(7.128456,-73.183637)"
2019,Agosto,Curazao,99999,1,1,,2,"(10.408582,-75.538003)"
2019,Agosto,Curazao,99999,3,3,,6,"(10.445761,-75.516429)"
2019,Agosto,Curazao,99999,16,16,,32,"(10.886611,-74.776708)"
2019,Agosto,Curazao,99999,4,6,,10,"(11.117806,-74.232622)"
2019,Agosto,Curazao,99999,0,1,,1,"(11.247723,-74.213989)"
2019,Agosto,Curazao,99999,9,8,,17,"(3.541112,-76.384584)"
2019,Agosto,Curazao,99999,1494,1209,,2703,"(4.697144,-74.140516)"
2019,Agosto,Curazao,99999,5,2,,7,"(4.815061,-75.736532)"
2019,Agosto,Curazao,99999,7,6,,13,"(6.171601,-75.427454)"
2019,Agosto,Curazao,99999,2,0,,2,"(7.128456,-73.183637)"
2019,Agosto,República Checa,203,1,0,,1,"(10.445761,-75.516429)"
2019,Agosto,República Checa,203,39,22,,61,"(4.697144,-74.140516)"
2019,Agosto,República Checa,203,2,3,,5,"(6.171601,-75.427454)"
2019,Agosto,Chile,152,1,0,,1,"(0.25129,-76.875963)"
2019,Agosto,Chile,152,46,66,,112,"(0.814836,-77.662532)"
2019,Agosto,Chile,152,0,4,,4,"(1.813928,-78.763924)"
2019,Agosto,Chile,152,24,10,,34,"(10.445761,-75.516429)"
2019,Agosto,Chile,152,68,37,,105,"(10.886611,-74.776708)"
2019,Agosto,Chile,152,4,4,,8,"(12.586067,-81.702563)"
2019,Agosto,Chile,152,624,387,,1011,"(3.541112,-76.384584)"
2019,Agosto,Chile,152,4947,4338,,9285,"(4.697144,-74.140516)"
2019,Agosto,Chile,152,109,71,,180,"(4.815061,-75.736532)"
2019,Agosto,Chile,152,229,161,,390,"(6.171601,-75.427454)"
2019,Agosto,Chile,152,5,5,,10,"(7.128456,-73.183637)"
2019,Agosto,China,156,3,7,,10,"(10.445761,-75.516429)"
2019,Agosto,China,156,10,4,,14,"(10.886611,-74.776708)"
2019,Agosto,China,156,5,29,,34,"(3.541112,-76.384584)"
2019,Agosto,China,156,196,425,,621,"(4.697144,-74.140516)"
2019,Agosto,China,156,1,3,,4,"(4.815061,-75.736532)"
2019,Agosto,China,156,28,68,,96,"(6.171601,-75.427454)"
2019,Agosto,China,156,1,3,,4,"(7.128456,-73.183637)"
2019,Agosto,Chipre,196,3,0,,3,"(4.697144,-74.140516)"
2019,Agosto,Chipre,196,0,1,,1,"(6.171601,-75.427454)"
2019,Agosto,Dinamarca,208,2,3,,5,"(10.445761,-75.516429)"
2019,Agosto,Dinamarca,208,1,0,,1,"(10.886611,-74.776708)"
2019,Agosto,Dinamarca,208,2,0,,2,"(3.541112,-76.384584)"
2019,Agosto,Dinamarca,208,52,35,,87,"(4.697144,-74.140516)"
2019,Agosto,Dinamarca,208,1,0,,1,"(4.815061,-75.736532)"
2019,Agosto,Dinamarca,208,3,3,,6,"(6.171601,-75.427454)"
2019,Agosto,Dominica,212,0,3,,3,"(3.541112,-76.384584)"
2019,Agosto,Dominica,212,1,4,,5,"(4.697144,-74.140516)"
2019,Agosto,Ecuador,218,2,3,,5,"(-0.193180,-74.784874)"
2019,Agosto,Ecuador,218,727,959,,1686,"(0.25129,-76.875963)"
2019,Agosto,Ecuador,218,24,25,,49,"(0.812436,-77.847006)"
2019,Agosto,Ecuador,218,6014,7014,,13028,"(0.814836,-77.662532)"
2019,Agosto,Ecuador,218,155,170,,325,"(1.813928,-78.763924)"
2019,Agosto,Ecuador,218,2,1,,3,"(10.445761,-75.516429)"
2019,Agosto,Ecuador,218,6,4,,10,"(10.886611,-74.776708)"
2019,Agosto,Ecuador,218,3,1,,4,"(12.586067,-81.702563)"
2019,Agosto,Ecuador,218,341,416,,757,"(3.541112,-76.384584)"
2019,Agosto,Ecuador,218,2752,3906,,6658,"(4.697144,-74.140516)"
2019,Agosto,Ecuador,218,2,5,,7,"(4.815061,-75.736532)"
2019,Agosto,Ecuador,218,25,40,,65,"(6.171601,-75.427454)"
2019,Agosto,Ecuador,218,1,3,,4,"(7.128456,-73.183637)"
2019,Agosto,Egipto,818,1,0,,1,"(3.541112,-76.384584)"
2019,Agosto,Egipto,818,12,15,,27,"(4.697144,-74.140516)"
2019,Agosto,El Salvador,222,1,4,,5,"(10.445761,-75.516429)"
2019,Agosto,El Salvador,222,3,2,,5,"(10.886611,-74.776708)"
2019,Agosto,El Salvador,222,10,14,,24,"(3.541112,-76.384584)"
2019,Agosto,El Salvador,222,1110,1330,,2440,"(4.697144,-74.140516)"
2019,Agosto,El Salvador,222,4,1,,5,"(4.815061,-75.736532)"
2019,Agosto,El Salvador,222,20,32,,52,"(6.171601,-75.427454)"
2019,Agosto,El Salvador,222,0,1,,1,"(7.128456,-73.183637)"
2019,Agosto,Emiratos Árabes,784,0,1,,1,"(10.445761,-75.516429)"
2019,Agosto,Emiratos Árabes,784,0,1,,1,"(10.886611,-74.776708)"
2019,Agosto,Emiratos Árabes,784,6,2,,8,"(3.541112,-76.384584)"
2019,Agosto,Emiratos Árabes,784,170,228,,398,"(4.697144,-74.140516)"
2019,Agosto,Emiratos Árabes,784,22,15,,37,"(6.171601,-75.427454)"
2019,Agosto,Emiratos Árabes,784,1,0,,1,"(7.128456,-73.183637)"
2019,Agosto,Eritrea,232,2,0,,2,"(4.697144,-74.140516)"
2019,Agosto,Eslovaquia,703,3,1,,4,"(3.541112,-76.384584)"
2019,Agosto,Eslovaquia,703,4,3,,7,"(4.697144,-74.140516)"
2019,Agosto,Eslovenia,705,2,1,,3,"(4.697144,-74.140516)"
2019,Agosto,Estados Unidos de América,840,0,5,,5,"(10.408582,-75.538003)"
2019,Agosto,Estados Unidos de América,840,4074,3107,,7182,"(10.445761,-75.516429)"
2019,Agosto,Estados Unidos de América,840,3301,2477,,5778,"(10.886611,-74.776708)"
2019,Agosto,Estados Unidos de América,840,66,38,,104,"(12.586067,-81.702563)"
2019,Agosto,Estados Unidos de América,840,7611,5360,,12971,"(3.541112,-76.384584)"
2019,Agosto,Estados Unidos de América,840,937,688,,1625,"(4.452882,-75.766298)"
2019,Agosto,Estados Unidos de América,840,37191,30293,,67485,"(4.697144,-74.140516)"
2019,Agosto,Estados Unidos de América,840,1401,895,,2296,"(4.815061,-75.736532)"
2019,Agosto,Estados Unidos de América,840,12569,9374,,21943,"(6.171601,-75.427454)"
2019,Agosto,Estados Unidos de América,840,313,201,,514,"(7.128456,-73.183637)"
2019,Agosto,Estonia,233,1,0,,1,"(10.886611,-74.776708)"
2019,Agosto,Estonia,233,3,0,,3,"(4.697144,-74.140516)"
2019,Agosto,Estonia,233,1,1,,2,"(6.171601,-75.427454)"
2019,Agosto,Etiopia,231,0,1,,1,"(6.171601,-75.427454)"
2019,Agosto,Filipinas,608,1,1,,2,"(3.541112,-76.384584)"
2019,Agosto,Filipinas,608,7,5,,12,"(4.697144,-74.140516)"
2019,Agosto,Filipinas,608,0,2,,2,"(6.171601,-75.427454)"
2019,Agosto,Finlandia,246,0,1,,1,"(10.445761,-75.516429)"
2019,Agosto,Finlandia,246,1,0,,1,"(3.541112,-76.384584)"
2019,Agosto,Finlandia,246,17,13,,30,"(4.697144,-74.140516)"
2019,Agosto,Finlandia,246,0,1,,1,"(4.815061,-75.736532)"
2019,Agosto,Finlandia,246,3,2,,5,"(6.171601,-75.427454)"
2019,Agosto,Finlandia,246,2,1,,3,"(7.128456,-73.183637)"
2019,Agosto,Francia,250,14,4,,18,"(10.445761,-75.516429)"
2019,Agosto,Francia,250,19,10,,29,"(10.886611,-74.776708)"
2019,Agosto,Francia,250,135,83,,218,"(3.541112,-76.384584)"
2019,Agosto,Francia,250,2444,1727,,4171,"(4.697144,-74.140516)"
2019,Agosto,Francia,250,10,10,,20,"(4.815061,-75.736532)"
2019,Agosto,Francia,250,176,116,,292,"(6.171601,-75.427454)"
2019,Agosto,Gabón,266,5,4,,9,"(4.697144,-74.140516)"
2019,Agosto,Ghana,288,0,2,,2,"(4.697144,-74.140516)"
2019,Agosto,Gibraltar/Territorio Británico de Ultramar,292,1,0,,1,"(4.697144,-74.140516)"
2019,Agosto,Granada,308,0,4,,4,"(3.541112,-76.384584)"
2019,Agosto,Granada,308,2,1,,3,"(4.697144,-74.140516)"
2019,Agosto,Grecia,300,30,19,,49,"(4.697144,-74.140516)"
2019,Agosto,Grecia,300,4,2,,6,"(6.171601,-75.427454)"
2019,Agosto,Groenlandia,304,0,1,,1,"(4.697144,-74.140516)"
2019,Agosto,Guatemala,320,2,10,,12,"(10.445761,-75.516429)"
2019,Agosto,Guatemala,320,8,12,,20,"(10.886611,-74.776708)"
2019,Agosto,Guatemala,320,41,56,,97,"(3.541112,-76.384584)"
2019,Agosto,Guatemala,320,611,684,,1295,"(4.697144,-74.140516)"
2019,Agosto,Guatemala,320,9,22,,31,"(4.815061,-75.736532)"
2019,Agosto,Guatemala,320,74,106,,180,"(6.171601,-75.427454)"
2019,Agosto,Guatemala,320,3,5,,8,"(7.128456,-73.183637)"
2019,Agosto,Guyana,328,1,2,,3,"(10.886611,-74.776708)"
2019,Agosto,Guyana,328,2,13,,15,"(3.541112,-76.384584)"
2019,Agosto,Guyana,328,3,7,,10,"(4.697144,-74.140516)"
2019,Agosto,Guyana,328,0,2,,2,"(4.815061,-75.736532)"
2019,Agosto,Guyana,328,1,3,,4,"(6.171601,-75.427454)"
2019,Agosto,Guyana,328,2,1,,3,"(7.128456,-73.183637)"
2019,Agosto,Guinea,324,1,3,,4,"(4.697144,-74.140516)"
2019,Agosto,Guinea Ecuatorial,226,0,1,,1,"(3.541112,-76.384584)"
2019,Agosto,Guinea Ecuatorial,226,1,3,,4,"(4.697144,-74.140516)"
2019,Agosto,Guadalupe/Territorio Francés,312,0,1,,1,"(3.541112,-76.384584)"
2019,Agosto,Guadalupe/Territorio Francés,312,1,1,,2,"(4.697144,-74.140516)"
2019,Agosto,Guadalupe/Territorio Francés,312,0,1,,1,"(4.815061,-75.736532)"
2019,Agosto,Guadalupe/Territorio Francés,312,1,0,,1,"(6.171601,-75.427454)"
2019,Agosto,Guam/Territorio no incorporado de Estados Unidos,316,1,0,,1,"(4.697144,-74.140516)"
2019,Agosto,Guayana Francesa/Departamento de Ultramar Francés,254,2,2,,4,"(10.886611,-74.776708)"
2019,Agosto,Guayana Francesa/Departamento de Ultramar Francés,254,0,1,,1,"(3.541112,-76.384584)"
2019,Agosto,Guayana Francesa/Departamento de Ultramar Francés,254,2,1,,3,"(4.697144,-74.140516)"
2019,Agosto,Haití,332,0,1,,1,"(10.886611,-74.776708)"
2019,Agosto,Haití,332,1,6,,7,"(4.697144,-74.140516)"
2019,Agosto,Haití,332,2,2,,4,"(6.171601,-75.427454)"
2019,Agosto,Honduras,340,0,11,,11,"(1.813928,-78.763924)"
2019,Agosto,Honduras,340,4,5,,9,"(10.445761,-75.516429)"
2019,Agosto,Honduras,340,3,16,,19,"(10.886611,-74.776708)"
2019,Agosto,Honduras,340,20,27,,47,"(3.541112,-76.384584)"
2019,Agosto,Honduras,340,130,208,,338,"(4.697144,-74.140516)"
2019,Agosto,Honduras,340,8,7,,15,"(4.815061,-75.736532)"
2019,Agosto,Honduras,340,29,63,,92,"(6.171601,-75.427454)"
2019,Agosto,Honduras,340,2,0,,2,"(7.128456,-73.183637)"
2019,Agosto,Hong Kong,344,1,1,,2,"(10.445761,-75.516429)"
2019,Agosto,Hong Kong,344,2,1,,3,"(3.541112,-76.384584)"
2019,Agosto,Hong Kong,344,24,17,,41,"(4.697144,-74.140516)"
2019,Agosto,Hong Kong,344,2,4,,6,"(6.171601,-75.427454)"
2019,Agosto,Hungría,348,0,1,,1,"(10.445761,-75.516429)"
2019,Agosto,Hungría,348,0,1,,1,"(10.886611,-74.776708)"
2019,Agosto,Hungría,348,13,17,,30,"(4.697144,-74.140516)"
2019,Agosto,Hungría,348,1,3,,4,"(6.171601,-75.427454)"
2019,Agosto,India,356,0,5,,5,"(3.541112,-76.384584)"
2019,Agosto,India,356,21,27,,48,"(4.697144,-74.140516)"
2019,Agosto,India,356,3,2,,5,"(6.171601,-75.427454)"
2019,Agosto,Indonesia,360,0,1,,1,"(4.452882,-75.766298)"
2019,Agosto,Indonesia,360,8,6,,14,"(4.697144,-74.140516)"
2019,Agosto,Indonesia,360,1,2,,3,"(6.171601,-75.427454)"
2019,Agosto,Iraq,368,0,2,,2,"(10.408582,-75.538003)"
2019,Agosto,Iraq,368,1,3,,4,"(4.697144,-74.140516)"
2019,Agosto,República de Irlanda,372,1,0,,1,"(10.445761,-75.516429)"
2019,Agosto,República de Irlanda,372,3,0,,3,"(3.541112,-76.384584)"
2019,Agosto,República de Irlanda,372,15,10,,25,"(4.697144,-74.140516)"
2019,Agosto,República de Irlanda,372,1,3,,4,"(6.171601,-75.427454)"
2019,Agosto,Islandia,352,5,2,,7,"(4.697144,-74.140516)"
2019,Agosto,Israel,376,7,3,,10,"(3.541112,-76.384584)"
2019,Agosto,Israel,376,125,69,,194,"(4.697144,-74.140516)"
2019,Agosto,Israel,376,12,10,,22,"(6.171601,-75.427454)"
2019,Agosto,Italia,380,18,8,,26,"(10.445761,-75.516429)"
2019,Agosto,Italia,380,6,13,,19,"(10.886611,-74.776708)"
2019,Agosto,Italia,380,0,2,,2,"(12.586067,-81.702563)"
2019,Agosto,Italia,380,92,54,,146,"(3.541112,-76.384584)"
2019,Agosto,Italia,380,687,372,,1059,"(4.697144,-74.140516)"
2019,Agosto,Italia,380,4,5,,9,"(4.815061,-75.736532)"
2019,Agosto,Italia,380,121,65,,186,"(6.171601,-75.427454)"
2019,Agosto,Italia,380,3,1,,4,"(7.128456,-73.183637)"
2019,Agosto,Jamaica,388,0,2,,2,"(10.445761,-75.516429)"
2019,Agosto,Jamaica,388,0,4,,4,"(10.886611,-74.776708)"
2019,Agosto,Jamaica,388,27,15,,42,"(3.541112,-76.384584)"
2019,Agosto,Jamaica,388,45,40,,85,"(4.697144,-74.140516)"
2019,Agosto,Jamaica,388,17,6,,23,"(4.815061,-75.736532)"
2019,Agosto,Jamaica,388,28,22,,50,"(6.171601,-75.427454)"
2019,Agosto,Jamaica,388,2,2,,4,"(7.128456,-73.183637)"
2019,Agosto,Islas Wallis y Futuna,876,1,0,,1,"(4.697144,-74.140516)"
2019,Agosto,Japón,392,0,1,,1,"(10.445761,-75.516429)"
2019,Agosto,Japón,392,2,1,,3,"(3.541112,-76.384584)"
2019,Agosto,Japón,392,93,96,,189,"(4.697144,-74.140516)"
2019,Agosto,Japón,392,1,0,,1,"(4.815061,-75.736532)"
2019,Agosto,Japón,392,26,16,,42,"(6.171601,-75.427454)"
2019,Agosto,Jordania,400,2,0,,2,"(4.697144,-74.140516)"
2019,Agosto,Kazajistán,398,6,6,,12,"(4.697144,-74.140516)"
2019,Agosto,Kenia,404,1,1,,2,"(3.541112,-76.384584)"
2019,Agosto,Kenia,404,9,7,,16,"(4.697144,-74.140516)"
2019,Agosto,Kuwait,414,8,9,,17,"(4.697144,-74.140516)"
2019,Agosto,Kuwait,414,1,1,,2,"(6.171601,-75.427454)"
2019,Agosto,Lituania,440,0,3,,3,"(4.697144,-74.140516)"
2019,Agosto,Líbano,422,0,1,,1,"(10.445761,-75.516429)"
2019,Agosto,Líbano,422,7,8,,15,"(10.886611,-74.776708)"
2019,Agosto,Líbano,422,0,1,,1,"(12.586067,-81.702563)"
2019,Agosto,Líbano,422,1,1,,2,"(3.541112,-76.384584)"
2019,Agosto,Líbano,422,12,9,,21,"(4.697144,-74.140516)"
2019,Agosto,Líbano,422,1,3,,4,"(4.815061,-75.736532)"
2019,Agosto,Liberia,430,2,0,,2,"(4.697144,-74.140516)"
2019,Agosto,Luxemburgo,442,2,0,,2,"(3.541112,-76.384584)"
2019,Agosto,Luxemburgo,442,14,12,,26,"(4.697144,-74.140516)"
2019,Agosto,Luxemburgo,442,3,1,,4,"(6.171601,-75.427454)"
2019,Agosto,Macao,446,1,0,,1,"(6.171601,-75.427454)"
2019,Agosto,Malasia,458,7,10,,17,"(4.697144,-74.140516)"
2019,Agosto,Malasia,458,1,0,,1,"(6.171601,-75.427454)"
2019,Agosto,Maldivas,462,0,1,,1,"(4.697144,-74.140516)"
2019,Agosto,Malí,466,2,2,,4,"(4.697144,-74.140516)"
2019,Agosto,Malta,470,0,1,,1,"(3.541112,-76.384584)"
2019,Agosto,Malta,470,33,23,,56,"(4.697144,-74.140516)"
2019,Agosto,Malta,470,5,0,,5,"(6.171601,-75.427454)"
2019,Agosto,Marruecos,504,12,10,,22,"(4.697144,-74.140516)"
2019,Agosto,Marruecos,504,2,0,,2,"(6.171601,-75.427454)"
2019,Agosto,Martinica/Departamento de Ultramar Francés,474,1,0,,1,"(3.541112,-76.384584)"
2019,Agosto,Martinica/Departamento de Ultramar Francés,474,0,1,,1,"(4.697144,-74.140516)"
2019,Agosto,Martinica/Departamento de Ultramar Francés,474,1,1,,2,"(7.128456,-73.183637)"
2019,Agosto,México,484,71,59,,130,"(10.445761,-75.516429)"
2019,Agosto,México,484,170,109,,279,"(10.886611,-74.776708)"
2019,Agosto,México,484,2,5,,7,"(12.586067,-81.702563)"
2019,Agosto,México,484,967,784,,1752,"(3.541112,-76.384584)"
2019,Agosto,México,484,16498,14529,,31028,"(4.697144,-74.140516)"
2019,Agosto,México,484,248,192,,440,"(4.815061,-75.736532)"
2019,Agosto,México,484,5276,3892,,9168,"(6.171601,-75.427454)"
2019,Agosto,México,484,141,86,,227,"(7.128456,-73.183637)"
2019,Agosto,Mónaco,492,3,0,,3,"(4.697144,-74.140516)"
2019,Agosto,Mongolia,496,1,0,,1,"(10.886611,-74.776708)"
2019,Agosto,Mongolia,496,0,1,,1,"(4.697144,-74.140516)"
2019,Agosto,Montenegro,499,1,0,,1,"(3.541112,-76.384584)"
2019,Agosto,Micronesia,583,1,0,,1,"(6.171601,-75.427454)"
2019,Agosto,Nauru,520,0,2,,2,"(4.697144,-74.140516)"
2019,Agosto,Nepal,524,1,1,,2,"(6.171601,-75.427454)"
2019,Agosto,Nicaragua,558,1,2,,3,"(10.445761,-75.516429)"
2019,Agosto,Nicaragua,558,1,1,,2,"(10.886611,-74.776708)"
2019,Agosto,Nicaragua,558,1,0,,1,"(12.586067,-81.702563)"
2019,Agosto,Nicaragua,558,3,9,,12,"(3.541112,-76.384584)"
2019,Agosto,Nicaragua,558,39,69,,108,"(4.697144,-74.140516)"
2019,Agosto,Nicaragua,558,3,1,,4,"(4.815061,-75.736532)"
2019,Agosto,Nicaragua,558,18,46,,64,"(6.171601,-75.427454)"
2019,Agosto,Nicaragua,558,3,3,,6,"(7.128456,-73.183637)"
2019,Agosto,Nigeria,566,1,0,,1,"(3.541112,-76.384584)"
2019,Agosto,Nigeria,566,2,7,,9,"(4.697144,-74.140516)"
2019,Agosto,Níger,562,0,1,,1,"(4.697144,-74.140516)"
2019,Agosto,Noruega,578,2,1,,3,"(10.445761,-75.516429)"
2019,Agosto,Noruega,578,2,2,,4,"(10.886611,-74.776708)"
2019,Agosto,Noruega,578,7,3,,10,"(3.541112,-76.384584)"
2019,Agosto,Noruega,578,43,28,,71,"(4.697144,-74.140516)"
2019,Agosto,Noruega,578,1,0,,1,"(4.815061,-75.736532)"
2019,Agosto,Noruega,578,0,2,,2,"(6.171601,-75.427454)"
2019,Agosto,Noruega,578,0,1,,1,"(7.128456,-73.183637)"
2019,Agosto,Nueva Caledonia/Territorio francés,540,0,2,,2,"(4.697144,-74.140516)"
2019,Agosto,Nueva Zelanda,554,57,48,,105,"(4.697144,-74.140516)"
2019,Agosto,Nueva Zelanda,554,2,0,,2,"(6.171601,-75.427454)"
2019,Agosto,Omán,512,4,9,,13,"(4.697144,-74.140516)"
2019,Agosto,Omán,512,0,1,,1,"(6.171601,-75.427454)"
2019,Agosto,Papúa Nueva Guinea,598,0,1,,1,"(4.697144,-74.140516)"
2019,Agosto,Papúa Nueva Guinea,598,0,1,,1,"(6.171601,-75.427454)"
2019,Agosto,Pakistán,586,2,0,,2,"(4.697144,-74.140516)"
2019,Agosto,Panamá,591,0,1,,1,"(1.813928,-78.763924)"
2019,Agosto,Panamá,591,22,87,,109,"(10.408582,-75.538003)"
2019,Agosto,Panamá,591,1512,1221,,2733,"(10.445761,-75.516429)"
2019,Agosto,Panamá,591,687,616,,1303,"(10.886611,-74.776708)"
2019,Agosto,Panamá,591,0,1,,1,"(10.971302,-74.765397)"
2019,Agosto,Panamá,591,4,31,,35,"(12.5744111,-81.703935)"
2019,Agosto,Panamá,591,68,72,,140,"(12.586067,-81.702563)"
2019,Agosto,Panamá,591,2857,2252,,5109,"(3.541112,-76.384584)"
2019,Agosto,Panamá,591,8070,8209,,16279,"(4.697144,-74.140516)"
2019,Agosto,Panamá,591,457,351,,808,"(4.815061,-75.736532)"
2019,Agosto,Panamá,591,2840,2470,,5310,"(6.171601,-75.427454)"
2019,Agosto,Panamá,591,0,2,,2,"(6.228046,-77.404104)"
2019,Agosto,Panamá,591,17,27,,44,"(7.102626,-77.762647)"
2019,Agosto,Panamá,591,171,154,,325,"(7.128456,-73.183637)"
2019,Agosto,Panamá,591,0,7,,7,"(8.066966,-76.735404)"
2019,Agosto,Panamá,591,27,72,,99,"(8.635765,-77.346578)"
2019,Agosto,Paraguay,600,4,4,,8,"(10.445761,-75.516429)"
2019,Agosto,Paraguay,600,5,7,,12,"(10.886611,-74.776708)"
2019,Agosto,Paraguay,600,20,39,,59,"(3.541112,-76.384584)"
2019,Agosto,Paraguay,600,87,180,,267,"(4.697144,-74.140516)"
2019,Agosto,Paraguay,600,11,15,,26,"(4.815061,-75.736532)"
2019,Agosto,Paraguay,600,23,79,,102,"(6.171601,-75.427454)"
2019,Agosto,Paraguay,600,0,1,,1,"(7.128456,-73.183637)"
2019,Agosto,Perú,604,4,9,,13,"(-0.193180,-74.784874)"
2019,Agosto,Perú,604,7,12,,19,"(-4.197703,-69.941278)"
2019,Agosto,Perú,604,136,186,,322,"(-4.223468,-69.945098)"
2019,Agosto,Perú,604,0,2,,2,"(0.25129,-76.875963)"
2019,Agosto,Perú,604,41,43,,84,"(0.814836,-77.662532)"
2019,Agosto,Perú,604,2,2,,4,"(1.813928,-78.763924)"
2019,Agosto,Perú,604,85,77,,162,"(10.445761,-75.516429)"
2019,Agosto,Perú,604,4,8,,12,"(10.886611,-74.776708)"
2019,Agosto,Perú,604,409,400,,809,"(3.541112,-76.384584)"
2019,Agosto,Perú,604,5536,5956,,11492,"(4.697144,-74.140516)"
2019,Agosto,Perú,604,9,6,,15,"(4.815061,-75.736532)"
2019,Agosto,Perú,604,923,896,,1819,"(6.171601,-75.427454)"
2019,Agosto,Perú,604,2,1,,3,"(7.128456,-73.183637)"
2019,Agosto,Polonia,616,0,1,,1,"(10.886611,-74.776708)"
2019,Agosto,Polonia,616,1,0,,1,"(3.541112,-76.384584)"
2019,Agosto,Polonia,616,20,17,,37,"(4.697144,-74.140516)"
2019,Agosto,Polonia,616,4,8,,12,"(6.171601,-75.427454)"
2019,Agosto,Portugal,620,1,0,,1,"(10.445761,-75.516429)"
2019,Agosto,Portugal,620,0,1,,1,"(10.886611,-74.776708)"
2019,Agosto,Portugal,620,7,7,,14,"(3.541112,-76.384584)"
2019,Agosto,Portugal,620,135,172,,307,"(4.697144,-74.140516)"
2019,Agosto,Portugal,620,3,1,,4,"(4.815061,-75.736532)"
2019,Agosto,Portugal,620,19,25,,44,"(6.171601,-75.427454)"
2019,Agosto,Polinesia Francesa/Colectividad de Ultramar Francesa,258,1,0,,1,"(6.171601,-75.427454)"
2019,Agosto,Puerto Rico/Territorio de Estados Unidos,630,0,1,,1,"(10.408582,-75.538003)"
2019,Agosto,Puerto Rico/Territorio de Estados Unidos,630,2,8,,10,"(10.445761,-75.516429)"
2019,Agosto,Puerto Rico/Territorio de Estados Unidos,630,6,6,,12,"(10.886611,-74.776708)"
2019,Agosto,Puerto Rico/Territorio de Estados Unidos,630,25,17,,42,"(3.541112,-76.384584)"
2019,Agosto,Puerto Rico/Territorio de Estados Unidos,630,492,432,,924,"(4.697144,-74.140516)"
2019,Agosto,Puerto Rico/Territorio de Estados Unidos,630,5,3,,8,"(4.815061,-75.736532)"
2019,Agosto,Puerto Rico/Territorio de Estados Unidos,630,43,50,,93,"(6.171601,-75.427454)"
2019,Agosto,Puerto Rico/Territorio de Estados Unidos,630,2,4,,6,"(7.128456,-73.183637)"
2019,Agosto,Qatar,634,4,1,,5,"(3.541112,-76.384584)"
2019,Agosto,Qatar,634,16,24,,40,"(4.697144,-74.140516)"
2019,Agosto,Qatar,634,9,8,,17,"(6.171601,-75.427454)"
2019,Agosto,Reino Unido de Gran Bretaña e Irlanda del Norte,826,5,4,,9,"(10.445761,-75.516429)"
2019,Agosto,Reino Unido de Gran Bretaña e Irlanda del Norte,826,2,1,,3,"(10.886611,-74.776708)"
2019,Agosto,Reino Unido de Gran Bretaña e Irlanda del Norte,826,199,120,,319,"(3.541112,-76.384584)"
2019,Agosto,Reino Unido de Gran Bretaña e Irlanda del Norte,826,1822,1277,,3099,"(4.697144,-74.140516)"
2019,Agosto,Reino Unido de Gran Bretaña e Irlanda del Norte,826,6,2,,8,"(4.815061,-75.736532)"
2019,Agosto,Reino Unido de Gran Bretaña e Irlanda del Norte,826,91,46,,137,"(6.171601,-75.427454)"
2019,Agosto,República CentroÁfricana,140,1,0,,1,"(12.586067,-81.702563)"
2019,Agosto,República CentroÁfricana,140,5,2,,7,"(4.697144,-74.140516)"
2019,Agosto,Federación de Rusia,643,2,1,,3,"(10.445761,-75.516429)"
2019,Agosto,Federación de Rusia,643,2,1,,3,"(3.541112,-76.384584)"
2019,Agosto,Federación de Rusia,643,109,112,,221,"(4.697144,-74.140516)"
2019,Agosto,Federación de Rusia,643,5,7,,12,"(6.171601,-75.427454)"
2019,Agosto,República Dominicana,214,14,11,,25,"(10.445761,-75.516429)"
2019,Agosto,República Dominicana,214,51,30,,81,"(10.886611,-74.776708)"
2019,Agosto,República Dominicana,214,3,5,,8,"(12.586067,-81.702563)"
2019,Agosto,República Dominicana,214,231,169,,400,"(3.541112,-76.384584)"
2019,Agosto,República Dominicana,214,4491,3858,,8349,"(4.697144,-74.140516)"
2019,Agosto,República Dominicana,214,67,48,,115,"(4.815061,-75.736532)"
2019,Agosto,República Dominicana,214,403,302,,705,"(6.171601,-75.427454)"
2019,Agosto,República Dominicana,214,48,25,,73,"(7.128456,-73.183637)"
2019,Agosto,República Democrática Popular de Corea,408,1,0,,1,"(3.541112,-76.384584)"
2019,Agosto,República Democrática Popular de Corea,408,1,1,,2,"(4.697144,-74.140516)"
2019,Agosto,Rumania,642,11,8,,19,"(4.697144,-74.140516)"
2019,Agosto,Rumania,642,1,0,,1,"(6.171601,-75.427454)"
2019,Agosto,Rwanda,646,1,0,,1,"(4.697144,-74.140516)"
2019,Agosto,San  Vicente y las Granadinas,670,0,1,,1,"(10.445761,-75.516429)"
2019,Agosto,San  Vicente y las Granadinas,670,0,1,,1,"(4.697144,-74.140516)"
2019,Agosto,Senegal,686,0,1,,1,"(4.697144,-74.140516)"
2019,Agosto,Serbia,688,1,4,,5,"(4.697144,-74.140516)"
2019,Agosto,Serbia,688,1,0,,1,"(6.171601,-75.427454)"
2019,Agosto,Singapur,702,0,1,,1,"(10.886611,-74.776708)"
2019,Agosto,Singapur,702,8,13,,21,"(4.697144,-74.140516)"
2019,Agosto,Singapur,702,1,1,,2,"(6.171601,-75.427454)"
2019,Agosto,Sri Lanka,144,0,2,,2,"(4.697144,-74.140516)"
2019,Agosto,Sudáfrica,710,4,0,,4,"(3.541112,-76.384584)"
2019,Agosto,Sudáfrica,710,9,4,,13,"(4.697144,-74.140516)"
2019,Agosto,Sudáfrica,710,1,1,,2,"(6.171601,-75.427454)"
2019,Agosto,Suecia,752,6,4,,10,"(10.445761,-75.516429)"
2019,Agosto,Suecia,752,3,3,,6,"(10.886611,-74.776708)"
2019,Agosto,Suecia,752,17,10,,27,"(3.541112,-76.384584)"
2019,Agosto,Suecia,752,89,72,,161,"(4.697144,-74.140516)"
2019,Agosto,Suecia,752,2,2,,4,"(4.815061,-75.736532)"
2019,Agosto,Suecia,752,20,17,,37,"(6.171601,-75.427454)"
2019,Agosto,Suecia,752,0,1,,1,"(7.128456,-73.183637)"
2019,Agosto,Suiza,756,8,4,,12,"(10.445761,-75.516429)"
2019,Agosto,Suiza,756,3,0,,3,"(10.886611,-74.776708)"
2019,Agosto,Suiza,756,66,30,,96,"(3.541112,-76.384584)"
2019,Agosto,Suiza,756,382,271,,653,"(4.697144,-74.140516)"
2019,Agosto,Suiza,756,3,1,,4,"(4.815061,-75.736532)"
2019,Agosto,Suiza,756,55,28,,83,"(6.171601,-75.427454)"
2019,Agosto,Surinam,740,1,1,,2,"(10.886611,-74.776708)"
2019,Agosto,Surinam,740,2,55,,57,"(3.541112,-76.384584)"
2019,Agosto,Surinam,740,3,6,,9,"(4.697144,-74.140516)"
2019,Agosto,Surinam,740,1,1,,2,"(6.171601,-75.427454)"
2019,Agosto,Taiwán,158,6,8,,14,"(4.697144,-74.140516)"
2019,Agosto,Taiwán,158,1,2,,3,"(6.171601,-75.427454)"
2019,Agosto,Tailandia,764,17,10,,27,"(4.697144,-74.140516)"
2019,Agosto,Tailandia,764,6,1,,7,"(6.171601,-75.427454)"
2019,Agosto,Tanzania,834,1,1,,2,"(4.697144,-74.140516)"
2019,Agosto,Tanzania,834,1,0,,1,"(6.171601,-75.427454)"
2019,Agosto,Trinidad y Tobago,780,3,4,,7,"(10.445761,-75.516429)"
2019,Agosto,Trinidad y Tobago,780,1,2,,3,"(10.886611,-74.776708)"
2019,Agosto,Trinidad y Tobago,780,7,21,,28,"(3.541112,-76.384584)"
2019,Agosto,Trinidad y Tobago,780,15,35,,50,"(4.697144,-74.140516)"
2019,Agosto,Trinidad y Tobago,780,1,5,,6,"(4.815061,-75.736532)"
2019,Agosto,Trinidad y Tobago,780,13,6,,19,"(6.171601,-75.427454)"
2019,Agosto,Trinidad y Tobago,780,1,11,,12,"(7.128456,-73.183637)"
2019,Agosto,Túnez,788,3,14,,17,"(4.697144,-74.140516)"
2019,Agosto,Turquía,792,1,2,,3,"(10.445761,-75.516429)"
2019,Agosto,Turquía,792,1,3,,4,"(10.886611,-74.776708)"
2019,Agosto,Turquía,792,2,0,,2,"(3.541112,-76.384584)"
2019,Agosto,Turquía,792,735,392,,1127,"(4.697144,-74.140516)"
2019,Agosto,Turquía,792,7,6,,13,"(6.171601,-75.427454)"
2019,Agosto,Turquía,792,0,3,,3,"(7.128456,-73.183637)"
2019,Agosto,Turkmenistán,795,4,2,,6,"(4.697144,-74.140516)"
2019,Agosto,Ucrania,804,1,0,,1,"(3.541112,-76.384584)"
2019,Agosto,Ucrania,804,1,2,,3,"(4.697144,-74.140516)"
2019,Agosto,Uganda,800,2,0,,2,"(4.697144,-74.140516)"
2019,Agosto,Uruguay,858,2,4,,6,"(10.445761,-75.516429)"
2019,Agosto,Uruguay,858,3,2,,5,"(10.886611,-74.776708)"
2019,Agosto,Uruguay,858,42,45,,87,"(3.541112,-76.384584)"
2019,Agosto,Uruguay,858,137,153,,290,"(4.697144,-74.140516)"
2019,Agosto,Uruguay,858,11,11,,22,"(4.815061,-75.736532)"
2019,Agosto,Uruguay,858,18,18,,36,"(6.171601,-75.427454)"
2019,Agosto,Uruguay,858,1,1,,2,"(7.128456,-73.183637)"
2019,Agosto,Uzbekistán,860,3,2,,5,"(4.697144,-74.140516)"
2019,Agosto,Venezuela,862,5,10,,15,"(10.445761,-75.516429)"
2019,Agosto,Venezuela,862,45,45,,90,"(10.886611,-74.776708)"
2019,Agosto,Venezuela,862,1075,1119,,2194,"(11.360009,-72.129330)"
2019,Agosto,Venezuela,862,592,403,,995,"(3.541112,-76.384584)"
2019,Agosto,Venezuela,862,2,2,,4,"(3.866713,-67.927521)"
2019,Agosto,Venezuela,862,708,691,,1399,"(4.697144,-74.140516)"
2019,Agosto,Venezuela,862,1,0,,1,"(4.815061,-75.736532)"
2019,Agosto,Venezuela,862,284,297,,581,"(6.171601,-75.427454)"
2019,Agosto,Venezuela,862,16,33,,49,"(6.185799,-67.483929)"
2019,Agosto,Venezuela,862,285,271,,556,"(7.088729,-70.740253)"
2019,Agosto,Venezuela,862,0,1,,1,"(7.128456,-73.183637)"
2019,Agosto,Venezuela,862,630,673,,1303,"(7.818934,-72.453226)"
2019,Agosto,Venezuela,862,0,1,,1,"(7.927209,-72.507910)"
2019,Agosto,Venezuela,862,89,138,,227,"(8.36068,-72.409396)"
2019,Agosto,Vietnam,704,6,1,,7,"(4.697144,-74.140516)"
2019,Agosto,Islas Vírgenes Estadounidenses/Territorio de Estados Unidos,850,1,0,,1,"(3.541112,-76.384584)"
2019,Agosto,Zambia,894,1,0,,1,"(4.697144,-74.140516)"
2019,Septiembre,Afganistán,4,0,1,,1,"(3.541112,-76.384584)"
2019,Septiembre,Afganistán,4,5,7,,12,"(4.697144,-74.140516)"
2019,Septiembre,Afganistán,4,0,1,,1,"(6.171601,-75.427454)"
2019,Septiembre,Albania,8,1,1,,2,"(4.697144,-74.140516)"
2019,Septiembre,Alemania,276,12,11,,23,"(10.445761,-75.516429)"
2019,Septiembre,Alemania,276,9,16,,25,"(10.886611,-74.776708)"
2019,Septiembre,Alemania,276,66,46,,112,"(3.541112,-76.384584)"
2019,Septiembre,Alemania,276,2763,2578,,5341,"(4.697144,-74.140516)"
2019,Septiembre,Alemania,276,5,1,,6,"(4.815061,-75.736532)"
2019,Septiembre,Alemania,276,104,95,,199,"(6.171601,-75.427454)"
2019,Septiembre,Alemania,276,1,2,,3,"(7.128456,-73.183637)"
2019,Septiembre,Andorra,20,1,1,,2,"(4.697144,-74.140516)"
2019,Septiembre,Angola,24,0,1,,1,"(10.886611,-74.776708)"
2019,Septiembre,Angola,24,1,2,,3,"(4.697144,-74.140516)"
2019,Septiembre,Antigua y Barbuda,28,1,1,,2,"(4.697144,-74.140516)"
2019,Septiembre,Antigua y Barbuda,28,0,1,,1,"(7.128456,-73.183637)"
2019,Septiembre,Países Bajos,528,157,106,,263,"(10.445761,-75.516429)"
2019,Septiembre,Países Bajos,528,18,10,,28,"(10.886611,-74.776708)"
2019,Septiembre,Países Bajos,528,75,40,,115,"(3.541112,-76.384584)"
2019,Septiembre,Países Bajos,528,944,821,,1765,"(4.697144,-74.140516)"
2019,Septiembre,Países Bajos,528,1,3,,4,"(4.815061,-75.736532)"
2019,Septiembre,Países Bajos,528,94,62,,156,"(6.171601,-75.427454)"
2019,Septiembre,Países Bajos,528,1,1,,2,"(7.128456,-73.183637)"
2019,Septiembre,Arabia Saudita,682,1,2,,3,"(3.541112,-76.384584)"
2019,Septiembre,Arabia Saudita,682,8,28,,36,"(4.697144,-74.140516)"
2019,Septiembre,Arabia Saudita,682,1,0,,1,"(4.815061,-75.736532)"
2019,Septiembre,Arabia Saudita,682,2,2,,4,"(6.171601,-75.427454)"
2019,Septiembre,Arabia Saudita,682,0,1,,1,"(7.128456,-73.183637)"
2019,Septiembre,Argelia,12,2,5,,7,"(4.697144,-74.140516)"
2019,Septiembre,Argentina,32,12,9,,21,"(0.814836,-77.662532)"
2019,Septiembre,Argentina,32,17,17,,34,"(10.445761,-75.516429)"
2019,Septiembre,Argentina,32,32,33,,65,"(10.886611,-74.776708)"
2019,Septiembre,Argentina,32,0,2,,2,"(12.586067,-81.702563)"
2019,Septiembre,Argentina,32,152,139,,291,"(3.541112,-76.384584)"
2019,Septiembre,Argentina,32,2429,2420,,4849,"(4.697144,-74.140516)"
2019,Septiembre,Argentina,32,21,29,,50,"(4.815061,-75.736532)"
2019,Septiembre,Argentina,32,145,164,,309,"(6.171601,-75.427454)"
2019,Septiembre,Argentina,32,3,0,,3,"(7.128456,-73.183637)"
2019,Septiembre,República de Armenia,51,0,2,,2,"(4.697144,-74.140516)"
2019,Septiembre,Aruba,533,2740,1588,,4328,"(10.408582,-75.538003)"
2019,Septiembre,Aruba,533,4,2,,6,"(10.445761,-75.516429)"
2019,Septiembre,Aruba,533,18,16,,34,"(10.886611,-74.776708)"
2019,Septiembre,Aruba,533,29,25,,54,"(11.528919,-72.919681)"
2019,Septiembre,Aruba,533,26,22,,48,"(3.541112,-76.384584)"
2019,Septiembre,Aruba,533,1393,1134,,2527,"(4.697144,-74.140516)"
2019,Septiembre,Aruba,533,22,19,,41,"(4.815061,-75.736532)"
2019,Septiembre,Aruba,533,2,2,,4,"(6.17134,-75.427194)"
2019,Septiembre,Aruba,533,49,34,,83,"(6.171601,-75.427454)"
2019,Septiembre,Aruba,533,24,40,,64,"(7.128456,-73.183637)"
2019,Septiembre,Australia,36,1,1,,2,"(10.445761,-75.516429)"
2019,Septiembre,Australia,36,9,8,,17,"(3.541112,-76.384584)"
2019,Septiembre,Australia,36,518,364,,882,"(4.697144,-74.140516)"
2019,Septiembre,Australia,36,13,7,,20,"(6.171601,-75.427454)"
2019,Septiembre,Australia,36,1,0,,1,"(7.128456,-73.183637)"
2019,Septiembre,Austria,40,4,1,,5,"(3.541112,-76.384584)"
2019,Septiembre,Austria,40,50,39,,89,"(4.697144,-74.140516)"
2019,Septiembre,Austria,40,1,0,,1,"(4.815061,-75.736532)"
2019,Septiembre,Austria,40,8,7,,15,"(6.171601,-75.427454)"
2019,Septiembre,Azerbaiyán,31,3,1,,4,"(4.697144,-74.140516)"
2019,Septiembre,Bahamas,44,0,1,,1,"(10.445761,-75.516429)"
2019,Septiembre,Bahamas,44,1,1,,2,"(10.886611,-74.776708)"
2019,Septiembre,Bahamas,44,13,6,,19,"(3.541112,-76.384584)"
2019,Septiembre,Bahamas,44,12,14,,26,"(4.697144,-74.140516)"
2019,Septiembre,Bahamas,44,5,2,,7,"(4.815061,-75.736532)"
2019,Septiembre,Bahamas,44,20,12,,32,"(6.171601,-75.427454)"
2019,Septiembre,Bahréin,48,0,1,,1,"(10.445761,-75.516429)"
2019,Septiembre,Bahréin,48,1,0,,1,"(10.886611,-74.776708)"
2019,Septiembre,Bahréin,48,2,0,,2,"(3.541112,-76.384584)"
2019,Septiembre,Bahréin,48,3,1,,4,"(4.697144,-74.140516)"
2019,Septiembre,Bahréin,48,3,1,,4,"(6.171601,-75.427454)"
2019,Septiembre,Bangladesh,50,0,1,,1,"(4.697144,-74.140516)"
2019,Septiembre,Barbados,52,0,3,,3,"(3.541112,-76.384584)"
2019,Septiembre,Barbados,52,7,4,,11,"(4.697144,-74.140516)"
2019,Septiembre,Barbados,52,0,3,,3,"(6.171601,-75.427454)"
2019,Septiembre,República de Belarús,112,1,0,,1,"(11.360009,-72.129330)"
2019,Septiembre,República de Belarús,112,1,0,,1,"(4.697144,-74.140516)"
2019,Septiembre,Bélgica,56,1,1,,2,"(10.445761,-75.516429)"
2019,Septiembre,Bélgica,56,11,4,,15,"(10.886611,-74.776708)"
2019,Septiembre,Bélgica,56,18,11,,29,"(3.541112,-76.384584)"
2019,Septiembre,Bélgica,56,128,97,,225,"(4.697144,-74.140516)"
2019,Septiembre,Bélgica,56,34,30,,64,"(6.171601,-75.427454)"
2019,Septiembre,Belice,84,0,2,,2,"(3.541112,-76.384584)"
2019,Septiembre,Belice,84,7,11,,18,"(4.697144,-74.140516)"
2019,Septiembre,Belice,84,0,1,,1,"(4.815061,-75.736532)"
2019,Septiembre,Belice,84,1,0,,1,"(6.171601,-75.427454)"
2019,Septiembre,Benín,204,1,0,,1,"(4.697144,-74.140516)"
2019,Septiembre,Bermudas/Territorio Británico de Ultramar,60,0,1,,1,"(4.697144,-74.140516)"
2019,Septiembre,Bermudas/Territorio Británico de Ultramar,60,0,1,,1,"(6.171601,-75.427454)"
2019,Septiembre,Bolivia,68,2,4,,6,"(0.814836,-77.662532)"
2019,Septiembre,Bolivia,68,1,1,,2,"(10.886611,-74.776708)"
2019,Septiembre,Bolivia,68,23,31,,54,"(3.541112,-76.384584)"
2019,Septiembre,Bolivia,68,411,673,,1084,"(4.697144,-74.140516)"
2019,Septiembre,Bolivia,68,5,7,,12,"(4.815061,-75.736532)"
2019,Septiembre,Bolivia,68,22,30,,52,"(6.171601,-75.427454)"
2019,Septiembre,Bolivia,68,0,1,,1,"(7.128456,-73.183637)"
2019,Septiembre,Bosnia y Herzegovina,70,0,1,,1,"(4.697144,-74.140516)"
2019,Septiembre,Brasil,76,129,235,,364,"(-4.197703,-69.941278)"
2019,Septiembre,Brasil,76,9,24,,33,"(-4.223468,-69.945098)"
2019,Septiembre,Brasil,76,0,3,,3,"(0.814836,-77.662532)"
2019,Septiembre,Brasil,76,0,1,,1,"(10.408582,-75.538003)"
2019,Septiembre,Brasil,76,15,10,,25,"(10.445761,-75.516429)"
2019,Septiembre,Brasil,76,6,18,,24,"(10.886611,-74.776708)"
2019,Septiembre,Brasil,76,149,179,,328,"(3.541112,-76.384584)"
2019,Septiembre,Brasil,76,3015,4110,,7125,"(4.697144,-74.140516)"
2019,Septiembre,Brasil,76,27,37,,64,"(4.815061,-75.736532)"
2019,Septiembre,Brasil,76,148,222,,370,"(6.171601,-75.427454)"
2019,Septiembre,Brasil,76,7,6,,13,"(7.128456,-73.183637)"
2019,Septiembre,Bulgaria,100,3,1,,4,"(4.697144,-74.140516)"
2019,Septiembre,Burundi,108,1,0,,1,"(4.697144,-74.140516)"
2019,Septiembre,Cabo Verde,132,0,1,,1,"(4.697144,-74.140516)"
2019,Septiembre,Islas Caimán/Territorio Británico de Ultramar,136,5,3,,8,"(12.586067,-81.702563)"
2019,Septiembre,Islas Caimán/Territorio Británico de Ultramar,136,1,2,,3,"(4.697144,-74.140516)"
2019,Septiembre,Islas Caimán/Territorio Británico de Ultramar,136,1,0,,1,"(6.171601,-75.427454)"
2019,Septiembre,Camboya,116,1,1,,2,"(4.697144,-74.140516)"
2019,Septiembre,Camerún,120,1,2,,3,"(6.171601,-75.427454)"
2019,Septiembre,Canadá,124,31,32,,63,"(10.445761,-75.516429)"
2019,Septiembre,Canadá,124,61,42,,103,"(10.886611,-74.776708)"
2019,Septiembre,Canadá,124,0,1,,1,"(12.586067,-81.702563)"
2019,Septiembre,Canadá,124,123,100,,223,"(3.541112,-76.384584)"
2019,Septiembre,Canadá,124,1,0,,1,"(4.452882,-75.766298)"
2019,Septiembre,Canadá,124,2792,2254,,5046,"(4.697144,-74.140516)"
2019,Septiembre,Canadá,124,22,20,,42,"(4.815061,-75.736532)"
2019,Septiembre,Canadá,124,268,279,,547,"(6.171601,-75.427454)"
2019,Septiembre,Canadá,124,12,13,,25,"(7.128456,-73.183637)"
2019,Septiembre,Chad,148,0,1,,1,"(4.697144,-74.140516)"
2019,Septiembre,España,724,0,3,,3,"(10.408582,-75.538003)"
2019,Septiembre,España,724,44,30,,74,"(10.445761,-75.516429)"
2019,Septiembre,España,724,71,46,,117,"(10.886611,-74.776708)"
2019,Septiembre,España,724,0,3,,3,"(12.586067,-81.702563)"
2019,Septiembre,España,724,3407,2327,,5734,"(3.541112,-76.384584)"
2019,Septiembre,España,724,19332,14243,,33575,"(4.697144,-74.140516)"
2019,Septiembre,España,724,86,51,,137,"(4.815061,-75.736532)"
2019,Septiembre,España,724,4489,3031,,7520,"(6.171601,-75.427454)"
2019,Septiembre,España,724,8,9,,17,"(7.128456,-73.183637)"
2019,Septiembre,Colombia,170,457,1120,,1577,"(4.697144,-74.140516)"
2019,Septiembre,República Del Congo,178,0,1,,1,"(4.697144,-74.140516)"
2019,Septiembre,República de Corea,410,2,2,,4,"(3.541112,-76.384584)"
2019,Septiembre,República de Corea,410,40,47,,87,"(4.697144,-74.140516)"
2019,Septiembre,República de Corea,410,1,3,,4,"(6.171601,-75.427454)"
2019,Septiembre,Costa de Marfil,384,1,2,,3,"(4.697144,-74.140516)"
2019,Septiembre,Costa de Marfil,384,0,1,,1,"(6.171601,-75.427454)"
2019,Septiembre,Costa Rica,188,15,20,,35,"(10.445761,-75.516429)"
2019,Septiembre,Costa Rica,188,17,21,,38,"(10.886611,-74.776708)"
2019,Septiembre,Costa Rica,188,3,26,,29,"(12.5744111,-81.703935)"
2019,Septiembre,Costa Rica,188,7,2,,9,"(12.586067,-81.702563)"
2019,Septiembre,Costa Rica,188,48,57,,105,"(3.541112,-76.384584)"
2019,Septiembre,Costa Rica,188,1073,1266,,2339,"(4.697144,-74.140516)"
2019,Septiembre,Costa Rica,188,21,11,,32,"(4.815061,-75.736532)"
2019,Septiembre,Costa Rica,188,118,104,,222,"(6.171601,-75.427454)"
2019,Septiembre,Costa Rica,188,3,3,,6,"(7.128456,-73.183637)"
2019,Septiembre,Croacia,191,0,1,,1,"(3.541112,-76.384584)"
2019,Septiembre,Croacia,191,14,11,,25,"(4.697144,-74.140516)"
2019,Septiembre,Croacia,191,2,1,,3,"(6.171601,-75.427454)"
2019,Septiembre,Cuba,192,7,10,,17,"(10.445761,-75.516429)"
2019,Septiembre,Cuba,192,26,12,,38,"(10.886611,-74.776708)"
2019,Septiembre,Cuba,192,0,1,,1,"(12.586067,-81.702563)"
2019,Septiembre,Cuba,192,50,54,,104,"(3.541112,-76.384584)"
2019,Septiembre,Cuba,192,1249,1075,,2324,"(4.697144,-74.140516)"
2019,Septiembre,Cuba,192,26,17,,43,"(4.815061,-75.736532)"
2019,Septiembre,Cuba,192,167,102,,269,"(6.171601,-75.427454)"
2019,Septiembre,Cuba,192,15,11,,26,"(7.128456,-73.183637)"
2019,Septiembre,Curazao,99999,1,1,,2,"(10.445761,-75.516429)"
2019,Septiembre,Curazao,99999,1,0,,1,"(10.886611,-74.776708)"
2019,Septiembre,Curazao,99999,6,2,,8,"(3.541112,-76.384584)"
2019,Septiembre,Curazao,99999,1339,1085,,2424,"(4.697144,-74.140516)"
2019,Septiembre,Curazao,99999,4,3,,7,"(4.815061,-75.736532)"
2019,Septiembre,Curazao,99999,12,8,,20,"(6.171601,-75.427454)"
2019,Septiembre,República Checa,203,0,2,,2,"(10.445761,-75.516429)"
2019,Septiembre,República Checa,203,21,16,,37,"(4.697144,-74.140516)"
2019,Septiembre,República Checa,203,1,4,,5,"(6.171601,-75.427454)"
2019,Septiembre,Chile,152,1,2,,3,"(0.25129,-76.875963)"
2019,Septiembre,Chile,152,76,69,,145,"(0.814836,-77.662532)"
2019,Septiembre,Chile,152,1,0,,1,"(1.813928,-78.763924)"
2019,Septiembre,Chile,152,22,17,,39,"(10.445761,-75.516429)"
2019,Septiembre,Chile,152,43,34,,77,"(10.886611,-74.776708)"
2019,Septiembre,Chile,152,451,296,,748,"(3.541112,-76.384584)"
2019,Septiembre,Chile,152,4924,4543,,9467,"(4.697144,-74.140516)"
2019,Septiembre,Chile,152,66,47,,113,"(4.815061,-75.736532)"
2019,Septiembre,Chile,152,186,145,,331,"(6.171601,-75.427454)"
2019,Septiembre,Chile,152,4,3,,7,"(7.128456,-73.183637)"
2019,Septiembre,China,156,2,2,,4,"(10.445761,-75.516429)"
2019,Septiembre,China,156,2,7,,9,"(10.886611,-74.776708)"
2019,Septiembre,China,156,7,14,,21,"(3.541112,-76.384584)"
2019,Septiembre,China,156,202,364,,566,"(4.697144,-74.140516)"
2019,Septiembre,China,156,1,0,,1,"(4.815061,-75.736532)"
2019,Septiembre,China,156,24,60,,84,"(6.171601,-75.427454)"
2019,Septiembre,Chipre,196,1,0,,1,"(3.541112,-76.384584)"
2019,Septiembre,Chipre,196,1,1,,2,"(4.697144,-74.140516)"
2019,Septiembre,Chipre,196,1,1,,2,"(6.171601,-75.427454)"
2019,Septiembre,Dinamarca,208,2,0,,2,"(10.445761,-75.516429)"
2019,Septiembre,Dinamarca,208,3,0,,3,"(10.886611,-74.776708)"
2019,Septiembre,Dinamarca,208,1,2,,3,"(3.541112,-76.384584)"
2019,Septiembre,Dinamarca,208,50,34,,84,"(4.697144,-74.140516)"
2019,Septiembre,Dinamarca,208,2,0,,2,"(4.815061,-75.736532)"
2019,Septiembre,Dinamarca,208,6,5,,11,"(6.171601,-75.427454)"
2019,Septiembre,Dinamarca,208,1,0,,1,"(7.128456,-73.183637)"
2019,Septiembre,Ecuador,218,2,0,,2,"(-0.193180,-74.784874)"
2019,Septiembre,Ecuador,218,540,819,,1359,"(0.25129,-76.875963)"
2019,Septiembre,Ecuador,218,19,25,,44,"(0.812436,-77.847006)"
2019,Septiembre,Ecuador,218,4360,5284,,9644,"(0.814836,-77.662532)"
2019,Septiembre,Ecuador,218,135,148,,283,"(1.813928,-78.763924)"
2019,Septiembre,Ecuador,218,0,10,,10,"(10.408582,-75.538003)"
2019,Septiembre,Ecuador,218,3,10,,13,"(10.445761,-75.516429)"
2019,Septiembre,Ecuador,218,8,23,,31,"(10.886611,-74.776708)"
2019,Septiembre,Ecuador,218,2,1,,3,"(12.586067,-81.702563)"
2019,Septiembre,Ecuador,218,304,381,,685,"(3.541112,-76.384584)"
2019,Septiembre,Ecuador,218,2853,4432,,7285,"(4.697144,-74.140516)"
2019,Septiembre,Ecuador,218,2,4,,6,"(4.815061,-75.736532)"
2019,Septiembre,Ecuador,218,17,85,,102,"(6.171601,-75.427454)"
2019,Septiembre,Ecuador,218,0,1,,1,"(7.128456,-73.183637)"
2019,Septiembre,Egipto,818,28,21,,49,"(4.697144,-74.140516)"
2019,Septiembre,Egipto,818,3,2,,5,"(6.171601,-75.427454)"
2019,Septiembre,El Salvador,222,0,1,,1,"(10.445761,-75.516429)"
2019,Septiembre,El Salvador,222,1,4,,5,"(10.886611,-74.776708)"
2019,Septiembre,El Salvador,222,7,11,,18,"(3.541112,-76.384584)"
2019,Septiembre,El Salvador,222,1050,1379,,2429,"(4.697144,-74.140516)"
2019,Septiembre,El Salvador,222,0,1,,1,"(4.815061,-75.736532)"
2019,Septiembre,El Salvador,222,23,23,,46,"(6.171601,-75.427454)"
2019,Septiembre,Emiratos Árabes,784,6,3,,9,"(10.445761,-75.516429)"
2019,Septiembre,Emiratos Árabes,784,4,2,,6,"(3.541112,-76.384584)"
2019,Septiembre,Emiratos Árabes,784,159,180,,339,"(4.697144,-74.140516)"
2019,Septiembre,Emiratos Árabes,784,3,2,,5,"(4.815061,-75.736532)"
2019,Septiembre,Emiratos Árabes,784,12,7,,19,"(6.171601,-75.427454)"
2019,Septiembre,Eslovaquia,703,2,0,,2,"(10.886611,-74.776708)"
2019,Septiembre,Eslovaquia,703,1,0,,1,"(4.697144,-74.140516)"
2019,Septiembre,Eslovaquia,703,1,0,,1,"(6.171601,-75.427454)"
2019,Septiembre,Eslovenia,705,2,1,,3,"(4.697144,-74.140516)"
2019,Septiembre,Estados Unidos de América,840,2789,2298,,5087,"(10.445761,-75.516429)"
2019,Septiembre,Estados Unidos de América,840,2611,2239,,4850,"(10.886611,-74.776708)"
2019,Septiembre,Estados Unidos de América,840,2,7,,9,"(11.117806,-74.232622)"
2019,Septiembre,Estados Unidos de América,840,32,27,,59,"(12.586067,-81.702563)"
2019,Septiembre,Estados Unidos de América,840,6615,4907,,11522,"(3.541112,-76.384584)"
2019,Septiembre,Estados Unidos de América,840,805,683,,1488,"(4.452882,-75.766298)"
2019,Septiembre,Estados Unidos de América,840,32493,28794,,61287,"(4.697144,-74.140516)"
2019,Septiembre,Estados Unidos de América,840,1217,854,,2071,"(4.815061,-75.736532)"
2019,Septiembre,Estados Unidos de América,840,9891,7761,,17652,"(6.171601,-75.427454)"
2019,Septiembre,Estados Unidos de América,840,234,157,,391,"(7.128456,-73.183637)"
2019,Septiembre,Estonia,233,2,1,,3,"(4.697144,-74.140516)"
2019,Septiembre,Islas Fiji,242,0,1,,1,"(4.697144,-74.140516)"
2019,Septiembre,Filipinas,608,1,0,,1,"(10.445761,-75.516429)"
2019,Septiembre,Filipinas,608,4,4,,8,"(4.697144,-74.140516)"
2019,Septiembre,Filipinas,608,0,1,,1,"(6.171601,-75.427454)"
2019,Septiembre,Finlandia,246,1,0,,1,"(10.445761,-75.516429)"
2019,Septiembre,Finlandia,246,1,1,,2,"(3.541112,-76.384584)"
2019,Septiembre,Finlandia,246,14,17,,31,"(4.697144,-74.140516)"
2019,Septiembre,Finlandia,246,2,3,,5,"(6.171601,-75.427454)"
2019,Septiembre,Francia,250,20,9,,29,"(10.445761,-75.516429)"
2019,Septiembre,Francia,250,15,9,,24,"(10.886611,-74.776708)"
2019,Septiembre,Francia,250,0,1,,1,"(12.586067,-81.702563)"
2019,Septiembre,Francia,250,148,99,,247,"(3.541112,-76.384584)"
2019,Septiembre,Francia,250,2784,2092,,4876,"(4.697144,-74.140516)"
2019,Septiembre,Francia,250,12,13,,25,"(4.815061,-75.736532)"
2019,Septiembre,Francia,250,197,99,,296,"(6.171601,-75.427454)"
2019,Septiembre,Francia,250,1,1,,2,"(7.128456,-73.183637)"
2019,Septiembre,Gabón,266,0,1,,1,"(4.697144,-74.140516)"
2019,Septiembre,Ghana,288,0,2,,2,"(4.697144,-74.140516)"
2019,Septiembre,Grecia,300,1,1,,2,"(10.445761,-75.516429)"
2019,Septiembre,Grecia,300,2,0,,2,"(10.886611,-74.776708)"
2019,Septiembre,Grecia,300,82,52,,134,"(4.697144,-74.140516)"
2019,Septiembre,Grecia,300,7,7,,14,"(6.171601,-75.427454)"
2019,Septiembre,Guatemala,320,0,3,,3,"(10.445761,-75.516429)"
2019,Septiembre,Guatemala,320,8,9,,17,"(10.886611,-74.776708)"
2019,Septiembre,Guatemala,320,33,54,,87,"(3.541112,-76.384584)"
2019,Septiembre,Guatemala,320,534,826,,1360,"(4.697144,-74.140516)"
2019,Septiembre,Guatemala,320,14,13,,27,"(4.815061,-75.736532)"
2019,Septiembre,Guatemala,320,69,81,,150,"(6.171601,-75.427454)"
2019,Septiembre,Guatemala,320,6,7,,13,"(7.128456,-73.183637)"
2019,Septiembre,Guyana,328,1,0,,1,"(10.445761,-75.516429)"
2019,Septiembre,Guyana,328,1,3,,4,"(10.886611,-74.776708)"
2019,Septiembre,Guyana,328,0,1,,1,"(3.541112,-76.384584)"
2019,Septiembre,Guyana,328,3,5,,8,"(4.697144,-74.140516)"
2019,Septiembre,Guyana,328,1,0,,1,"(4.815061,-75.736532)"
2019,Septiembre,Guyana,328,1,1,,2,"(6.171601,-75.427454)"
2019,Septiembre,Guinea Ecuatorial,226,1,0,,1,"(3.541112,-76.384584)"
2019,Septiembre,Guinea Ecuatorial,226,1,2,,3,"(4.697144,-74.140516)"
2019,Septiembre,Guinea Ecuatorial,226,1,1,,2,"(6.171601,-75.427454)"
2019,Septiembre,Guinea Bissau,624,0,2,,2,"(4.697144,-74.140516)"
2019,Septiembre,Guadalupe/Territorio Francés,312,0,1,,1,"(4.697144,-74.140516)"
2019,Septiembre,Guadalupe/Territorio Francés,312,2,0,,2,"(6.171601,-75.427454)"
2019,Septiembre,Guayana Francesa/Departamento de Ultramar Francés,254,2,0,,2,"(4.697144,-74.140516)"
2019,Septiembre,Haití,332,0,1,,1,"(3.541112,-76.384584)"
2019,Septiembre,Haití,332,0,9,,9,"(4.697144,-74.140516)"
2019,Septiembre,Haití,332,2,2,,4,"(6.171601,-75.427454)"
2019,Septiembre,Honduras,340,0,26,,26,"(10.408582,-75.538003)"
2019,Septiembre,Honduras,340,1,2,,3,"(10.445761,-75.516429)"
2019,Septiembre,Honduras,340,4,15,,19,"(10.886611,-74.776708)"
2019,Septiembre,Honduras,340,1,0,,1,"(12.586067,-81.702563)"
2019,Septiembre,Honduras,340,6,22,,28,"(3.541112,-76.384584)"
2019,Septiembre,Honduras,340,100,167,,267,"(4.697144,-74.140516)"
2019,Septiembre,Honduras,340,5,3,,8,"(4.815061,-75.736532)"
2019,Septiembre,Honduras,340,20,45,,65,"(6.171601,-75.427454)"
2019,Septiembre,Honduras,340,3,8,,11,"(7.128456,-73.183637)"
2019,Septiembre,Hong Kong,344,1,1,,2,"(10.886611,-74.776708)"
2019,Septiembre,Hong Kong,344,1,4,,5,"(3.541112,-76.384584)"
2019,Septiembre,Hong Kong,344,15,18,,33,"(4.697144,-74.140516)"
2019,Septiembre,Hong Kong,344,1,2,,3,"(6.171601,-75.427454)"
2019,Septiembre,Hungría,348,1,0,,1,"(3.541112,-76.384584)"
2019,Septiembre,Hungría,348,19,10,,29,"(4.697144,-74.140516)"
2019,Septiembre,Hungría,348,1,0,,1,"(6.171601,-75.427454)"
2019,Septiembre,India,356,2,0,,2,"(10.886611,-74.776708)"
2019,Septiembre,India,356,4,3,,7,"(3.541112,-76.384584)"
2019,Septiembre,India,356,68,46,,114,"(4.697144,-74.140516)"
2019,Septiembre,India,356,2,1,,3,"(4.815061,-75.736532)"
2019,Septiembre,India,356,15,6,,21,"(6.171601,-75.427454)"
2019,Septiembre,Indonesia,360,1,0,,1,"(3.541112,-76.384584)"
2019,Septiembre,Indonesia,360,4,6,,10,"(4.697144,-74.140516)"
2019,Septiembre,Indonesia,360,0,1,,1,"(6.171601,-75.427454)"
2019,Septiembre,Iraq,368,0,4,,4,"(4.697144,-74.140516)"
2019,Septiembre,Irán,364,3,1,,4,"(4.697144,-74.140516)"
2019,Septiembre,República de Irlanda,372,1,1,,2,"(10.445761,-75.516429)"
2019,Septiembre,República de Irlanda,372,1,1,,2,"(10.886611,-74.776708)"
2019,Septiembre,República de Irlanda,372,2,1,,3,"(3.541112,-76.384584)"
2019,Septiembre,República de Irlanda,372,26,20,,46,"(4.697144,-74.140516)"
2019,Septiembre,Islandia,352,1,1,,2,"(10.445761,-75.516429)"
2019,Septiembre,Islandia,352,2,0,,2,"(3.541112,-76.384584)"
2019,Septiembre,Islandia,352,1,2,,3,"(4.697144,-74.140516)"
2019,Septiembre,Islandia,352,0,1,,1,"(4.815061,-75.736532)"
2019,Septiembre,Islandia,352,5,3,,8,"(6.171601,-75.427454)"
2019,Septiembre,Israel,376,1,0,,1,"(10.445761,-75.516429)"
2019,Septiembre,Israel,376,4,0,,4,"(10.886611,-74.776708)"
2019,Septiembre,Israel,376,9,4,,13,"(3.541112,-76.384584)"
2019,Septiembre,Israel,376,226,143,,369,"(4.697144,-74.140516)"
2019,Septiembre,Israel,376,41,23,,64,"(6.171601,-75.427454)"
2019,Septiembre,Israel,376,1,0,,1,"(7.128456,-73.183637)"
2019,Septiembre,Italia,380,24,15,,39,"(10.445761,-75.516429)"
2019,Septiembre,Italia,380,19,12,,31,"(10.886611,-74.776708)"
2019,Septiembre,Italia,380,157,84,,241,"(3.541112,-76.384584)"
2019,Septiembre,Italia,380,0,1,,1,"(4.452882,-75.766298)"
2019,Septiembre,Italia,380,964,703,,1667,"(4.697144,-74.140516)"
2019,Septiembre,Italia,380,7,2,,9,"(4.815061,-75.736532)"
2019,Septiembre,Italia,380,194,121,,315,"(6.171601,-75.427454)"
2019,Septiembre,Italia,380,2,1,,3,"(7.128456,-73.183637)"
2019,Septiembre,Jamaica,388,1,0,,1,"(10.408582,-75.538003)"
2019,Septiembre,Jamaica,388,2,1,,3,"(10.445761,-75.516429)"
2019,Septiembre,Jamaica,388,3,2,,5,"(10.886611,-74.776708)"
2019,Septiembre,Jamaica,388,2,2,,4,"(12.586067,-81.702563)"
2019,Septiembre,Jamaica,388,10,6,,16,"(3.541112,-76.384584)"
2019,Septiembre,Jamaica,388,52,53,,105,"(4.697144,-74.140516)"
2019,Septiembre,Jamaica,388,0,3,,3,"(4.815061,-75.736532)"
2019,Septiembre,Jamaica,388,13,11,,24,"(6.171601,-75.427454)"
2019,Septiembre,Jamaica,388,2,1,,3,"(7.128456,-73.183637)"
2019,Septiembre,Japón,392,1,0,,1,"(10.445761,-75.516429)"
2019,Septiembre,Japón,392,2,0,,2,"(3.541112,-76.384584)"
2019,Septiembre,Japón,392,127,113,,240,"(4.697144,-74.140516)"
2019,Septiembre,Japón,392,1,0,,1,"(4.815061,-75.736532)"
2019,Septiembre,Japón,392,17,18,,35,"(6.171601,-75.427454)"
2019,Septiembre,Jordania,400,2,3,,5,"(4.697144,-74.140516)"
2019,Septiembre,Kazajistán,398,3,4,,7,"(4.697144,-74.140516)"
2019,Septiembre,Kazajistán,398,1,1,,2,"(6.171601,-75.427454)"
2019,Septiembre,Kenia,404,5,8,,13,"(4.697144,-74.140516)"
2019,Septiembre,Kenia,404,0,1,,1,"(6.171601,-75.427454)"
2019,Septiembre,Kuwait,414,1,0,,1,"(10.445761,-75.516429)"
2019,Septiembre,Kuwait,414,0,1,,1,"(3.541112,-76.384584)"
2019,Septiembre,Kuwait,414,0,3,,3,"(4.697144,-74.140516)"
2019,Septiembre,República Democrática Popular  Lao,418,1,0,,1,"(4.697144,-74.140516)"
2019,Septiembre,Letonia,428,1,0,,1,"(4.697144,-74.140516)"
2019,Septiembre,Lituania,440,0,1,,1,"(4.697144,-74.140516)"
2019,Septiembre,Líbano,422,3,3,,6,"(10.886611,-74.776708)"
2019,Septiembre,Líbano,422,15,12,,27,"(4.697144,-74.140516)"
2019,Septiembre,Liberia,430,0,1,,1,"(4.815061,-75.736532)"
2019,Septiembre,Liberia,430,1,0,,1,"(6.171601,-75.427454)"
2019,Septiembre,Luxemburgo,442,4,0,,4,"(10.445761,-75.516429)"
2019,Septiembre,Luxemburgo,442,1,2,,3,"(10.886611,-74.776708)"
2019,Septiembre,Luxemburgo,442,17,13,,30,"(4.697144,-74.140516)"
2019,Septiembre,Luxemburgo,442,3,0,,3,"(6.171601,-75.427454)"
2019,Septiembre,Macao,446,2,0,,2,"(4.697144,-74.140516)"
2019,Septiembre,Madagascar,450,1,0,,1,"(4.697144,-74.140516)"
2019,Septiembre,Malasia,458,0,9,,9,"(3.541112,-76.384584)"
2019,Septiembre,Malasia,458,0,8,,8,"(4.697144,-74.140516)"
2019,Septiembre,Malawi,454,0,1,,1,"(6.171601,-75.427454)"
2019,Septiembre,Malí,466,0,1,,1,"(4.697144,-74.140516)"
2019,Septiembre,Malta,470,3,1,,4,"(3.541112,-76.384584)"
2019,Septiembre,Malta,470,34,26,,60,"(4.697144,-74.140516)"
2019,Septiembre,Malta,470,4,4,,8,"(6.171601,-75.427454)"
2019,Septiembre,Marruecos,504,27,6,,33,"(4.697144,-74.140516)"
2019,Septiembre,Marruecos,504,3,4,,7,"(6.171601,-75.427454)"
2019,Septiembre,Islas Marshall,584,0,1,,1,"(4.697144,-74.140516)"
2019,Septiembre,Martinica/Departamento de Ultramar Francés,474,0,1,,1,"(4.697144,-74.140516)"
2019,Septiembre,Martinica/Departamento de Ultramar Francés,474,1,0,,1,"(6.171601,-75.427454)"
2019,Septiembre,México,484,0,1,,1,"(1.813928,-78.763924)"
2019,Septiembre,México,484,84,55,,139,"(10.445761,-75.516429)"
2019,Septiembre,México,484,74,62,,136,"(10.886611,-74.776708)"
2019,Septiembre,México,484,632,498,,1130,"(3.541112,-76.384584)"
2019,Septiembre,México,484,15851,14294,,30145,"(4.697144,-74.140516)"
2019,Septiembre,México,484,211,163,,374,"(4.815061,-75.736532)"
2019,Septiembre,México,484,5006,3775,,8781,"(6.171601,-75.427454)"
2019,Septiembre,México,484,100,89,,189,"(7.128456,-73.183637)"
2019,Septiembre,Mónaco,492,1,1,,2,"(4.697144,-74.140516)"
2019,Septiembre,Mongolia,496,0,1,,1,"(10.886611,-74.776708)"
2019,Septiembre,Mongolia,496,0,1,,1,"(4.697144,-74.140516)"
2019,Septiembre,Mozambique,508,0,1,,1,"(4.697144,-74.140516)"
2019,Septiembre,Myanmar,104,1,0,,1,"(4.697144,-74.140516)"
2019,Septiembre,Nepal,524,1,1,,2,"(4.697144,-74.140516)"
2019,Septiembre,Nicaragua,558,0,1,,1,"(10.445761,-75.516429)"
2019,Septiembre,Nicaragua,558,1,4,,5,"(10.886611,-74.776708)"
2019,Septiembre,Nicaragua,558,1,2,,3,"(12.586067,-81.702563)"
2019,Septiembre,Nicaragua,558,10,23,,33,"(3.541112,-76.384584)"
2019,Septiembre,Nicaragua,558,33,57,,90,"(4.697144,-74.140516)"
2019,Septiembre,Nicaragua,558,0,6,,6,"(4.815061,-75.736532)"
2019,Septiembre,Nicaragua,558,14,38,,52,"(6.171601,-75.427454)"
2019,Septiembre,Nicaragua,558,0,2,,2,"(7.128456,-73.183637)"
2019,Septiembre,Nigeria,566,1,1,,2,"(10.445761,-75.516429)"
2019,Septiembre,Nigeria,566,0,1,,1,"(3.541112,-76.384584)"
2019,Septiembre,Nigeria,566,0,3,,3,"(4.697144,-74.140516)"
2019,Septiembre,Níger,562,1,0,,1,"(4.697144,-74.140516)"
2019,Septiembre,Noruega,578,0,3,,3,"(10.445761,-75.516429)"
2019,Septiembre,Noruega,578,1,3,,4,"(3.541112,-76.384584)"
2019,Septiembre,Noruega,578,27,27,,54,"(4.697144,-74.140516)"
2019,Septiembre,Noruega,578,1,2,,3,"(6.171601,-75.427454)"
2019,Septiembre,Nueva Zelanda,554,35,25,,60,"(4.697144,-74.140516)"
2019,Septiembre,Nueva Zelanda,554,0,2,,2,"(6.171601,-75.427454)"
2019,Septiembre,Omán,512,0,1,,1,"(3.541112,-76.384584)"
2019,Septiembre,Omán,512,3,3,,6,"(4.697144,-74.140516)"
2019,Septiembre,Omán,512,1,1,,2,"(6.171601,-75.427454)"
2019,Septiembre,Papúa Nueva Guinea,598,0,1,,1,"(4.697144,-74.140516)"
2019,Septiembre,Pakistán,586,0,1,,1,"(4.697144,-74.140516)"
2019,Septiembre,Panamá,591,56,98,,154,"(10.408582,-75.538003)"
2019,Septiembre,Panamá,591,1150,959,,2109,"(10.445761,-75.516429)"
2019,Septiembre,Panamá,591,734,618,,1352,"(10.886611,-74.776708)"
2019,Septiembre,Panamá,591,0,3,,3,"(10.971302,-74.765397)"
2019,Septiembre,Panamá,591,0,1,,1,"(11.360009,-72.129330)"
2019,Septiembre,Panamá,591,3,20,,23,"(12.5744111,-81.703935)"
2019,Septiembre,Panamá,591,94,92,,186,"(12.586067,-81.702563)"
2019,Septiembre,Panamá,591,2421,1991,,4412,"(3.541112,-76.384584)"
2019,Septiembre,Panamá,591,7326,7811,,15139,"(4.697144,-74.140516)"
2019,Septiembre,Panamá,591,463,317,,780,"(4.815061,-75.736532)"
2019,Septiembre,Panamá,591,2439,2252,,4691,"(6.171601,-75.427454)"
2019,Septiembre,Panamá,591,0,1,,1,"(6.228046,-77.404104)"
2019,Septiembre,Panamá,591,6,15,,21,"(7.102626,-77.762647)"
2019,Septiembre,Panamá,591,240,190,,430,"(7.128456,-73.183637)"
2019,Septiembre,Panamá,591,16,55,,71,"(8.635765,-77.346578)"
2019,Septiembre,Paraguay,600,3,2,,5,"(10.445761,-75.516429)"
2019,Septiembre,Paraguay,600,1,3,,4,"(10.886611,-74.776708)"
2019,Septiembre,Paraguay,600,8,20,,28,"(3.541112,-76.384584)"
2019,Septiembre,Paraguay,600,124,227,,351,"(4.697144,-74.140516)"
2019,Septiembre,Paraguay,600,4,4,,8,"(4.815061,-75.736532)"
2019,Septiembre,Paraguay,600,18,33,,51,"(6.171601,-75.427454)"
2019,Septiembre,Perú,604,13,16,,29,"(-0.193180,-74.784874)"
2019,Septiembre,Perú,604,3,11,,14,"(-4.197703,-69.941278)"
2019,Septiembre,Perú,604,110,183,,293,"(-4.223468,-69.945098)"
2019,Septiembre,Perú,604,0,2,,2,"(0.25129,-76.875963)"
2019,Septiembre,Perú,604,57,65,,122,"(0.814836,-77.662532)"
2019,Septiembre,Perú,604,1,0,,1,"(1.813928,-78.763924)"
2019,Septiembre,Perú,604,114,92,,206,"(10.445761,-75.516429)"
2019,Septiembre,Perú,604,21,16,,37,"(10.886611,-74.776708)"
2019,Septiembre,Perú,604,1,0,,1,"(12.586067,-81.702563)"
2019,Septiembre,Perú,604,378,344,,722,"(3.541112,-76.384584)"
2019,Septiembre,Perú,604,5143,5862,,11005,"(4.697144,-74.140516)"
2019,Septiembre,Perú,604,14,9,,23,"(4.815061,-75.736532)"
2019,Septiembre,Perú,604,765,859,,1624,"(6.171601,-75.427454)"
2019,Septiembre,Perú,604,3,6,,9,"(7.128456,-73.183637)"
2019,Septiembre,Polonia,616,2,2,,4,"(10.445761,-75.516429)"
2019,Septiembre,Polonia,616,0,1,,1,"(10.886611,-74.776708)"
2019,Septiembre,Polonia,616,1,2,,3,"(3.541112,-76.384584)"
2019,Septiembre,Polonia,616,37,26,,63,"(4.697144,-74.140516)"
2019,Septiembre,Polonia,616,1,1,,2,"(6.171601,-75.427454)"
2019,Septiembre,Portugal,620,2,1,,3,"(10.445761,-75.516429)"
2019,Septiembre,Portugal,620,2,3,,5,"(10.886611,-74.776708)"
2019,Septiembre,Portugal,620,11,10,,21,"(3.541112,-76.384584)"
2019,Septiembre,Portugal,620,183,204,,387,"(4.697144,-74.140516)"
2019,Septiembre,Portugal,620,26,23,,49,"(6.171601,-75.427454)"
2019,Septiembre,Puerto Rico/Territorio de Estados Unidos,630,7,5,,12,"(10.445761,-75.516429)"
2019,Septiembre,Puerto Rico/Territorio de Estados Unidos,630,8,5,,13,"(10.886611,-74.776708)"
2019,Septiembre,Puerto Rico/Territorio de Estados Unidos,630,15,7,,22,"(3.541112,-76.384584)"
2019,Septiembre,Puerto Rico/Territorio de Estados Unidos,630,406,389,,795,"(4.697144,-74.140516)"
2019,Septiembre,Puerto Rico/Territorio de Estados Unidos,630,5,3,,8,"(4.815061,-75.736532)"
2019,Septiembre,Puerto Rico/Territorio de Estados Unidos,630,22,25,,47,"(6.171601,-75.427454)"
2019,Septiembre,Puerto Rico/Territorio de Estados Unidos,630,2,1,,3,"(7.128456,-73.183637)"
2019,Septiembre,Qatar,634,2,1,,3,"(3.541112,-76.384584)"
2019,Septiembre,Qatar,634,10,9,,19,"(4.697144,-74.140516)"
2019,Septiembre,Qatar,634,0,1,,1,"(4.815061,-75.736532)"
2019,Septiembre,Qatar,634,2,1,,3,"(6.171601,-75.427454)"
2019,Septiembre,Reino Unido de Gran Bretaña e Irlanda del Norte,826,6,3,,9,"(10.445761,-75.516429)"
2019,Septiembre,Reino Unido de Gran Bretaña e Irlanda del Norte,826,0,2,,2,"(10.886611,-74.776708)"
2019,Septiembre,Reino Unido de Gran Bretaña e Irlanda del Norte,826,116,89,,205,"(3.541112,-76.384584)"
2019,Septiembre,Reino Unido de Gran Bretaña e Irlanda del Norte,826,1909,1500,,3409,"(4.697144,-74.140516)"
2019,Septiembre,Reino Unido de Gran Bretaña e Irlanda del Norte,826,14,11,,25,"(4.815061,-75.736532)"
2019,Septiembre,Reino Unido de Gran Bretaña e Irlanda del Norte,826,53,34,,87,"(6.171601,-75.427454)"
2019,Septiembre,Reino Unido de Gran Bretaña e Irlanda del Norte,826,0,1,,1,"(7.128456,-73.183637)"
2019,Septiembre,República CentroÁfricana,140,0,2,,2,"(4.697144,-74.140516)"
2019,Septiembre,Federación de Rusia,643,2,3,,5,"(3.541112,-76.384584)"
2019,Septiembre,Federación de Rusia,643,157,196,,353,"(4.697144,-74.140516)"
2019,Septiembre,Federación de Rusia,643,5,7,,12,"(6.171601,-75.427454)"
2019,Septiembre,República Dominicana,214,9,18,,27,"(10.445761,-75.516429)"
2019,Septiembre,República Dominicana,214,46,39,,85,"(10.886611,-74.776708)"
2019,Septiembre,República Dominicana,214,135,110,,245,"(3.541112,-76.384584)"
2019,Septiembre,República Dominicana,214,3753,3360,,7113,"(4.697144,-74.140516)"
2019,Septiembre,República Dominicana,214,69,48,,117,"(4.815061,-75.736532)"
2019,Septiembre,República Dominicana,214,259,214,,473,"(6.171601,-75.427454)"
2019,Septiembre,República Dominicana,214,147,82,,229,"(7.128456,-73.183637)"
2019,Septiembre,Reunión,638,3,0,,3,"(4.697144,-74.140516)"
2019,Septiembre,Rumania,642,1,1,,2,"(10.886611,-74.776708)"
2019,Septiembre,Rumania,642,2,2,,4,"(3.541112,-76.384584)"
2019,Septiembre,Rumania,642,6,5,,11,"(4.697144,-74.140516)"
2019,Septiembre,Rumania,642,1,1,,2,"(6.171601,-75.427454)"
2019,Septiembre,Rwanda,646,0,1,,1,"(4.697144,-74.140516)"
2019,Septiembre,San  Vicente y las Granadinas,670,0,1,,1,"(10.886611,-74.776708)"
2019,Septiembre,San  Vicente y las Granadinas,670,0,1,,1,"(4.697144,-74.140516)"
2019,Septiembre,Santa Lucia,662,0,1,,1,"(4.697144,-74.140516)"
2019,Septiembre,Santo Tomé y Príncipe,678,0,1,,1,"(4.697144,-74.140516)"
2019,Septiembre,Senegal,686,2,4,,6,"(4.697144,-74.140516)"
2019,Septiembre,Serbia,688,1,4,,5,"(4.697144,-74.140516)"
2019,Septiembre,Serbia,688,0,1,,1,"(6.171601,-75.427454)"
2019,Septiembre,Singapur,702,5,2,,7,"(3.541112,-76.384584)"
2019,Septiembre,Singapur,702,10,11,,21,"(4.697144,-74.140516)"
2019,Septiembre,Singapur,702,3,3,,6,"(6.171601,-75.427454)"
2019,Septiembre,Sri Lanka,144,0,3,,3,"(4.697144,-74.140516)"
2019,Septiembre,Sudáfrica,710,2,1,,3,"(3.541112,-76.384584)"
2019,Septiembre,Sudáfrica,710,18,15,,33,"(4.697144,-74.140516)"
2019,Septiembre,Sudáfrica,710,1,2,,3,"(6.171601,-75.427454)"
2019,Septiembre,Suecia,752,1,2,,3,"(10.445761,-75.516429)"
2019,Septiembre,Suecia,752,1,0,,1,"(10.886611,-74.776708)"
2019,Septiembre,Suecia,752,19,14,,33,"(3.541112,-76.384584)"
2019,Septiembre,Suecia,752,48,57,,105,"(4.697144,-74.140516)"
2019,Septiembre,Suecia,752,9,10,,19,"(6.171601,-75.427454)"
2019,Septiembre,Suiza,756,6,4,,10,"(10.445761,-75.516429)"
2019,Septiembre,Suiza,756,2,1,,3,"(10.886611,-74.776708)"
2019,Septiembre,Suiza,756,29,17,,46,"(3.541112,-76.384584)"
2019,Septiembre,Suiza,756,212,151,,363,"(4.697144,-74.140516)"
2019,Septiembre,Suiza,756,42,22,,64,"(6.171601,-75.427454)"
2019,Septiembre,Surinam,740,0,1,,1,"(10.445761,-75.516429)"
2019,Septiembre,Surinam,740,0,2,,2,"(10.886611,-74.776708)"
2019,Septiembre,Surinam,740,5,4,,9,"(4.697144,-74.140516)"
2019,Septiembre,Surinam,740,2,0,,2,"(6.171601,-75.427454)"
2019,Septiembre,Taiwán,158,1,3,,4,"(4.697144,-74.140516)"
2019,Septiembre,Tailandia,764,28,19,,47,"(4.697144,-74.140516)"
2019,Septiembre,Tailandia,764,5,3,,8,"(6.171601,-75.427454)"
2019,Septiembre,Tanzania,834,1,1,,2,"(4.697144,-74.140516)"
2019,Septiembre,Trinidad y Tobago,780,0,11,,11,"(10.408582,-75.538003)"
2019,Septiembre,Trinidad y Tobago,780,0,3,,3,"(10.445761,-75.516429)"
2019,Septiembre,Trinidad y Tobago,780,6,7,,13,"(10.886611,-74.776708)"
2019,Septiembre,Trinidad y Tobago,780,1,15,,16,"(3.541112,-76.384584)"
2019,Septiembre,Trinidad y Tobago,780,18,28,,46,"(4.697144,-74.140516)"
2019,Septiembre,Trinidad y Tobago,780,0,12,,12,"(4.815061,-75.736532)"
2019,Septiembre,Trinidad y Tobago,780,4,8,,12,"(6.171601,-75.427454)"
2019,Septiembre,Trinidad y Tobago,780,2,3,,5,"(7.128456,-73.183637)"
2019,Septiembre,Turquía,792,2,3,,5,"(10.445761,-75.516429)"
2019,Septiembre,Turquía,792,2,1,,3,"(10.886611,-74.776708)"
2019,Septiembre,Turquía,792,20,4,,24,"(3.541112,-76.384584)"
2019,Septiembre,Turquía,792,1780,863,,2643,"(4.697144,-74.140516)"
2019,Septiembre,Turquía,792,52,27,,79,"(6.171601,-75.427454)"
2019,Septiembre,Turquía,792,0,1,,1,"(7.128456,-73.183637)"
2019,Septiembre,Turkmenistán,795,4,2,,6,"(4.697144,-74.140516)"
2019,Septiembre,Ucrania,804,2,5,,7,"(4.697144,-74.140516)"
2019,Septiembre,Ucrania,804,0,1,,1,"(7.128456,-73.183637)"
2019,Septiembre,Uganda,800,1,2,,3,"(4.697144,-74.140516)"
2019,Septiembre,Uganda,800,1,1,,2,"(6.171601,-75.427454)"
2019,Septiembre,Uruguay,858,4,4,,8,"(10.445761,-75.516429)"
2019,Septiembre,Uruguay,858,5,6,,11,"(10.886611,-74.776708)"
2019,Septiembre,Uruguay,858,18,20,,38,"(3.541112,-76.384584)"
2019,Septiembre,Uruguay,858,102,145,,247,"(4.697144,-74.140516)"
2019,Septiembre,Uruguay,858,0,2,,2,"(4.815061,-75.736532)"
2019,Septiembre,Uruguay,858,21,11,,32,"(6.171601,-75.427454)"
2019,Septiembre,Uruguay,858,1,0,,1,"(7.128456,-73.183637)"
2019,Septiembre,Uzbekistán,860,0,1,,1,"(4.697144,-74.140516)"
2019,Septiembre,Venezuela,862,2,3,,5,"(10.445761,-75.516429)"
2019,Septiembre,Venezuela,862,45,34,,79,"(10.886611,-74.776708)"
2019,Septiembre,Venezuela,862,986,1147,,2133,"(11.360009,-72.129330)"
2019,Septiembre,Venezuela,862,445,306,,751,"(3.541112,-76.384584)"
2019,Septiembre,Venezuela,862,1,4,,5,"(3.866713,-67.927521)"
2019,Septiembre,Venezuela,862,676,695,,1371,"(4.697144,-74.140516)"
2019,Septiembre,Venezuela,862,324,307,,631,"(6.171601,-75.427454)"
2019,Septiembre,Venezuela,862,15,29,,44,"(6.185799,-67.483929)"
2019,Septiembre,Venezuela,862,182,176,,358,"(7.088729,-70.740253)"
2019,Septiembre,Venezuela,862,2,3,,5,"(7.128456,-73.183637)"
2019,Septiembre,Venezuela,862,576,615,,1191,"(7.818934,-72.453226)"
2019,Septiembre,Venezuela,862,0,1,,1,"(7.927209,-72.507910)"
2019,Septiembre,Venezuela,862,62,85,,147,"(8.36068,-72.409396)"
2019,Septiembre,Vietnam,704,1,0,,1,"(3.541112,-76.384584)"
2019,Septiembre,Vietnam,704,3,4,,7,"(4.697144,-74.140516)"
2019,Septiembre,Vietnam,704,0,1,,1,"(6.171601,-75.427454)"
2019,Septiembre,Islas Vírgenes Británicas/Territorio Británico de Ultramar,92,0,1,,1,"(10.408582,-75.538003)"
2019,Septiembre,Islas Vírgenes Británicas/Territorio Británico de Ultramar,92,1,1,,2,"(10.886611,-74.776708)"
2019,Septiembre,Islas Vírgenes Británicas/Territorio Británico de Ultramar,92,1,0,,1,"(4.697144,-74.140516)"
2019,Septiembre,Islas Vírgenes Estadounidenses/Territorio de Estados Unidos,850,0,2,,2,"(10.445761,-75.516429)"
2019,Septiembre,Islas Vírgenes Estadounidenses/Territorio de Estados Unidos,850,0,1,,1,"(10.886611,-74.776708)"
2019,Septiembre,Islas Vírgenes Estadounidenses/Territorio de Estados Unidos,850,0,2,,2,"(4.697144,-74.140516)"
2019,Septiembre,Anguila/Territorio Británico de Ultramar,660,3,0,,3,"(4.697144,-74.140516)"
2019,Septiembre,Anguila/Territorio Británico de Ultramar,660,1,0,,1,"(6.171601,-75.427454)"
2019,Octubre,Afganistán,4,1,2,,3,"(4.697144,-74.140516)"
2019,Octubre,Albania,8,2,1,,3,"(4.697144,-74.140516)"
2019,Octubre,Alemania,276,1,0,,1,"(0.25129,-76.875963)"
2019,Octubre,Alemania,276,10,9,,19,"(10.445761,-75.516429)"
2019,Octubre,Alemania,276,8,6,,14,"(10.886611,-74.776708)"
2019,Octubre,Alemania,276,0,1,,1,"(12.586067,-81.702563)"
2019,Octubre,Alemania,276,33,29,,62,"(3.541112,-76.384584)"
2019,Octubre,Alemania,276,2369,2382,,4751,"(4.697144,-74.140516)"
2019,Octubre,Alemania,276,2,3,,5,"(4.815061,-75.736532)"
2019,Octubre,Alemania,276,90,100,,190,"(6.171601,-75.427454)"
2019,Octubre,Alemania,276,5,1,,6,"(7.102626,-77.762647)"
2019,Octubre,Andorra,20,2,6,,8,"(4.697144,-74.140516)"
2019,Octubre,Angola,24,2,3,,5,"(4.697144,-74.140516)"
2019,Octubre,Antigua y Barbuda,28,1,0,,1,"(11.247723,-74.213989)"
2019,Octubre,Antigua y Barbuda,28,2,2,,4,"(4.697144,-74.140516)"
2019,Octubre,Antigua y Barbuda,28,0,1,,1,"(4.815061,-75.736532)"
2019,Octubre,Antigua y Barbuda,28,0,1,,1,"(7.102626,-77.762647)"
2019,Octubre,Países Bajos,528,226,167,,393,"(10.445761,-75.516429)"
2019,Octubre,Países Bajos,528,25,14,,39,"(10.886611,-74.776708)"
2019,Octubre,Países Bajos,528,0,1,,1,"(11.117806,-74.232622)"
2019,Octubre,Países Bajos,528,64,35,,99,"(3.541112,-76.384584)"
2019,Octubre,Países Bajos,528,1015,933,,1948,"(4.697144,-74.140516)"
2019,Octubre,Países Bajos,528,6,1,,7,"(4.815061,-75.736532)"
2019,Octubre,Países Bajos,528,100,87,,187,"(6.171601,-75.427454)"
2019,Octubre,Países Bajos,528,1,0,,1,"(7.128456,-73.183637)"
2019,Octubre,Arabia Saudita,682,6,31,,37,"(4.697144,-74.140516)"
2019,Octubre,Arabia Saudita,682,1,1,,2,"(6.171601,-75.427454)"
2019,Octubre,Argelia,12,7,7,,14,"(4.697144,-74.140516)"
2019,Octubre,Argentina,32,0,1,,1,"(0.25129,-76.875963)"
2019,Octubre,Argentina,32,7,9,,16,"(0.814836,-77.662532)"
2019,Octubre,Argentina,32,22,15,,37,"(10.445761,-75.516429)"
2019,Octubre,Argentina,32,39,18,,57,"(10.886611,-74.776708)"
2019,Octubre,Argentina,32,147,110,,257,"(3.541112,-76.384584)"
2019,Octubre,Argentina,32,3289,3262,,6551,"(4.697144,-74.140516)"
2019,Octubre,Argentina,32,45,30,,75,"(4.815061,-75.736532)"
2019,Octubre,Argentina,32,232,175,,407,"(6.171601,-75.427454)"
2019,Octubre,Argentina,32,8,3,,11,"(7.128456,-73.183637)"
2019,Octubre,República de Armenia,51,1,3,,4,"(4.697144,-74.140516)"
2019,Octubre,Aruba,533,2660,1810,,4470,"(10.408582,-75.538003)"
2019,Octubre,Aruba,533,6,3,,9,"(10.445761,-75.516429)"
2019,Octubre,Aruba,533,18,22,,40,"(10.886611,-74.776708)"
2019,Octubre,Aruba,533,40,49,,89,"(11.528919,-72.919681)"
2019,Octubre,Aruba,533,25,27,,52,"(3.541112,-76.384584)"
2019,Octubre,Aruba,533,1433,1119,,2552,"(4.697144,-74.140516)"
2019,Octubre,Aruba,533,24,13,,37,"(4.815061,-75.736532)"
2019,Octubre,Aruba,533,2,2,,4,"(6.17134,-75.427194)"
2019,Octubre,Aruba,533,47,46,,93,"(6.171601,-75.427454)"
2019,Octubre,Aruba,533,19,44,,63,"(7.128456,-73.183637)"
2019,Octubre,Aruba,533,0,2,,2,"(8.066966,-76.735404)"
2019,Octubre,Australia,36,1,3,,4,"(10.886611,-74.776708)"
2019,Octubre,Australia,36,1,0,,1,"(12.586067,-81.702563)"
2019,Octubre,Australia,36,8,4,,12,"(3.541112,-76.384584)"
2019,Octubre,Australia,36,446,337,,783,"(4.697144,-74.140516)"
2019,Octubre,Australia,36,22,18,,40,"(6.171601,-75.427454)"
2019,Octubre,Austria,40,0,1,,1,"(10.445761,-75.516429)"
2019,Octubre,Austria,40,2,2,,4,"(3.541112,-76.384584)"
2019,Octubre,Austria,40,38,22,,60,"(4.697144,-74.140516)"
2019,Octubre,Austria,40,7,11,,18,"(6.171601,-75.427454)"
2019,Octubre,Austria,40,0,1,,1,"(7.128456,-73.183637)"
2019,Octubre,Bahamas,44,0,1,,1,"(10.408582,-75.538003)"
2019,Octubre,Bahamas,44,0,2,,2,"(10.445761,-75.516429)"
2019,Octubre,Bahamas,44,3,5,,8,"(10.886611,-74.776708)"
2019,Octubre,Bahamas,44,4,4,,8,"(3.541112,-76.384584)"
2019,Octubre,Bahamas,44,29,29,,58,"(4.697144,-74.140516)"
2019,Octubre,Bahamas,44,7,2,,9,"(4.815061,-75.736532)"
2019,Octubre,Bahamas,44,17,22,,39,"(6.171601,-75.427454)"
2019,Octubre,Bahréin,48,1,0,,1,"(10.886611,-74.776708)"
2019,Octubre,Bahréin,48,1,0,,1,"(3.541112,-76.384584)"
2019,Octubre,Bahréin,48,2,3,,5,"(4.697144,-74.140516)"
2019,Octubre,Barbados,52,4,2,,6,"(10.445761,-75.516429)"
2019,Octubre,Barbados,52,3,0,,3,"(10.886611,-74.776708)"
2019,Octubre,Barbados,52,14,1,,15,"(12.586067,-81.702563)"
2019,Octubre,Barbados,52,1,1,,2,"(3.541112,-76.384584)"
2019,Octubre,Barbados,52,5,3,,8,"(4.697144,-74.140516)"
2019,Octubre,Barbados,52,2,2,,4,"(4.815061,-75.736532)"
2019,Octubre,Barbados,52,2,1,,3,"(6.171601,-75.427454)"
2019,Octubre,República de Belarús,112,1,0,,1,"(11.360009,-72.129330)"
2019,Octubre,República de Belarús,112,1,4,,5,"(4.697144,-74.140516)"
2019,Octubre,Bélgica,56,1,0,,1,"(10.445761,-75.516429)"
2019,Octubre,Bélgica,56,7,1,,8,"(10.886611,-74.776708)"
2019,Octubre,Bélgica,56,11,7,,18,"(3.541112,-76.384584)"
2019,Octubre,Bélgica,56,96,76,,172,"(4.697144,-74.140516)"
2019,Octubre,Bélgica,56,36,24,,60,"(6.171601,-75.427454)"
2019,Octubre,Belice,84,0,1,,1,"(10.886611,-74.776708)"
2019,Octubre,Belice,84,2,1,,3,"(3.541112,-76.384584)"
2019,Octubre,Belice,84,11,16,,27,"(4.697144,-74.140516)"
2019,Octubre,Belice,84,0,2,,2,"(4.815061,-75.736532)"
2019,Octubre,Belice,84,0,4,,4,"(6.171601,-75.427454)"
2019,Octubre,Benín,204,2,0,,2,"(4.697144,-74.140516)"
2019,Octubre,Bermudas/Territorio Británico de Ultramar,60,1,0,,1,"(3.541112,-76.384584)"
2019,Octubre,Bermudas/Territorio Británico de Ultramar,60,2,0,,2,"(4.697144,-74.140516)"
2019,Octubre,Bolivia,68,1,3,,4,"(0.814836,-77.662532)"
2019,Octubre,Bolivia,68,0,2,,2,"(10.445761,-75.516429)"
2019,Octubre,Bolivia,68,19,34,,53,"(3.541112,-76.384584)"
2019,Octubre,Bolivia,68,309,472,,781,"(4.697144,-74.140516)"
2019,Octubre,Bolivia,68,3,9,,12,"(4.815061,-75.736532)"
2019,Octubre,Bolivia,68,26,53,,79,"(6.171601,-75.427454)"
2019,Octubre,Bolivia,68,1,0,,1,"(7.128456,-73.183637)"
2019,Octubre,Bosnia y Herzegovina,70,1,0,,1,"(3.541112,-76.384584)"
2019,Octubre,Bosnia y Herzegovina,70,2,0,,2,"(4.697144,-74.140516)"
2019,Octubre,Bosnia y Herzegovina,70,0,1,,1,"(6.171601,-75.427454)"
2019,Octubre,Brasil,76,100,205,,305,"(-4.197703,-69.941278)"
2019,Octubre,Brasil,76,17,29,,46,"(-4.223468,-69.945098)"
2019,Octubre,Brasil,76,0,3,,3,"(0.814836,-77.662532)"
2019,Octubre,Brasil,76,12,6,,18,"(10.445761,-75.516429)"
2019,Octubre,Brasil,76,11,13,,24,"(10.886611,-74.776708)"
2019,Octubre,Brasil,76,86,106,,192,"(3.541112,-76.384584)"
2019,Octubre,Brasil,76,3486,4433,,7919,"(4.697144,-74.140516)"
2019,Octubre,Brasil,76,24,39,,63,"(4.815061,-75.736532)"
2019,Octubre,Brasil,76,182,188,,370,"(6.171601,-75.427454)"
2019,Octubre,Brasil,76,2,5,,7,"(7.128456,-73.183637)"
2019,Octubre,Bulgaria,100,6,4,,10,"(4.697144,-74.140516)"
2019,Octubre,Islas Caimán/Territorio Británico de Ultramar,136,1,0,,1,"(10.445761,-75.516429)"
2019,Octubre,Islas Caimán/Territorio Británico de Ultramar,136,3,2,,5,"(12.586067,-81.702563)"
2019,Octubre,Islas Caimán/Territorio Británico de Ultramar,136,0,1,,1,"(3.541112,-76.384584)"
2019,Octubre,Islas Caimán/Territorio Británico de Ultramar,136,4,4,,8,"(4.697144,-74.140516)"
2019,Octubre,Islas Caimán/Territorio Británico de Ultramar,136,2,1,,3,"(6.171601,-75.427454)"
2019,Octubre,Camboya,116,1,1,,2,"(4.697144,-74.140516)"
2019,Octubre,Camboya,116,0,1,,1,"(6.171601,-75.427454)"
2019,Octubre,Camerún,120,0,1,,1,"(6.171601,-75.427454)"
2019,Octubre,Canadá,124,16,14,,30,"(10.445761,-75.516429)"
2019,Octubre,Canadá,124,44,30,,74,"(10.886611,-74.776708)"
2019,Octubre,Canadá,124,131,95,,226,"(3.541112,-76.384584)"
2019,Octubre,Canadá,124,0,1,,1,"(4.452882,-75.766298)"
2019,Octubre,Canadá,124,1800,1563,,3363,"(4.697144,-74.140516)"
2019,Octubre,Canadá,124,17,16,,33,"(4.815061,-75.736532)"
2019,Octubre,Canadá,124,209,175,,384,"(6.171601,-75.427454)"
2019,Octubre,Canadá,124,7,6,,13,"(7.128456,-73.183637)"
2019,Octubre,España,724,44,26,,70,"(10.445761,-75.516429)"
2019,Octubre,España,724,40,30,,70,"(10.886611,-74.776708)"
2019,Octubre,España,724,3461,2581,,6042,"(3.541112,-76.384584)"
2019,Octubre,España,724,20133,16023,,36156,"(4.697144,-74.140516)"
2019,Octubre,España,724,70,51,,121,"(4.815061,-75.736532)"
2019,Octubre,España,724,4275,3242,,7519,"(6.171601,-75.427454)"
2019,Octubre,España,724,3,5,,8,"(7.128456,-73.183637)"
2019,Octubre,Colombia,170,2,5,,7,"(10.445761,-75.516429)"
2019,Octubre,Colombia,170,454,1023,,1477,"(4.697144,-74.140516)"
2019,Octubre,República Del Congo,178,0,1,,1,"(4.697144,-74.140516)"
2019,Octubre,República de Corea,410,0,4,,4,"(10.445761,-75.516429)"
2019,Octubre,República de Corea,410,1,0,,1,"(3.541112,-76.384584)"
2019,Octubre,República de Corea,410,34,35,,69,"(4.697144,-74.140516)"
2019,Octubre,República de Corea,410,2,5,,7,"(6.171601,-75.427454)"
2019,Octubre,Costa de Marfil,384,2,3,,5,"(4.697144,-74.140516)"
2019,Octubre,Costa Rica,188,5,10,,15,"(10.445761,-75.516429)"
2019,Octubre,Costa Rica,188,27,34,,61,"(10.886611,-74.776708)"
2019,Octubre,Costa Rica,188,0,19,,19,"(10.971302,-74.765397)"
2019,Octubre,Costa Rica,188,1,9,,10,"(12.5744111,-81.703935)"
2019,Octubre,Costa Rica,188,3,2,,5,"(12.586067,-81.702563)"
2019,Octubre,Costa Rica,188,45,57,,102,"(3.541112,-76.384584)"
2019,Octubre,Costa Rica,188,1180,1340,,2520,"(4.697144,-74.140516)"
2019,Octubre,Costa Rica,188,21,20,,41,"(4.815061,-75.736532)"
2019,Octubre,Costa Rica,188,0,4,,4,"(6.17134,-75.427194)"
2019,Octubre,Costa Rica,188,136,113,,249,"(6.171601,-75.427454)"
2019,Octubre,Costa Rica,188,4,3,,7,"(7.128456,-73.183637)"
2019,Octubre,Croacia,191,5,3,,8,"(4.697144,-74.140516)"
2019,Octubre,Croacia,191,1,0,,1,"(6.171601,-75.427454)"
2019,Octubre,Cuba,192,9,8,,17,"(10.445761,-75.516429)"
2019,Octubre,Cuba,192,16,15,,31,"(10.886611,-74.776708)"
2019,Octubre,Cuba,192,36,28,,64,"(3.541112,-76.384584)"
2019,Octubre,Cuba,192,1541,1286,,2827,"(4.697144,-74.140516)"
2019,Octubre,Cuba,192,25,11,,36,"(4.815061,-75.736532)"
2019,Octubre,Cuba,192,123,94,,217,"(6.171601,-75.427454)"
2019,Octubre,Cuba,192,23,14,,37,"(7.128456,-73.183637)"
2019,Octubre,Curazao,99999,2,5,,7,"(10.408582,-75.538003)"
2019,Octubre,Curazao,99999,0,1,,1,"(10.445761,-75.516429)"
2019,Octubre,Curazao,99999,2,1,,3,"(10.886611,-74.776708)"
2019,Octubre,Curazao,99999,4,15,,19,"(3.541112,-76.384584)"
2019,Octubre,Curazao,99999,1270,1005,,2275,"(4.697144,-74.140516)"
2019,Octubre,Curazao,99999,5,3,,8,"(4.815061,-75.736532)"
2019,Octubre,Curazao,99999,8,8,,16,"(6.171601,-75.427454)"
2019,Octubre,Curazao,99999,0,1,,1,"(7.128456,-73.183637)"
2019,Octubre,República Checa,203,0,1,,1,"(10.445761,-75.516429)"
2019,Octubre,República Checa,203,0,3,,3,"(3.541112,-76.384584)"
2019,Octubre,República Checa,203,10,11,,21,"(4.697144,-74.140516)"
2019,Octubre,República Checa,203,0,1,,1,"(6.171601,-75.427454)"
2019,Octubre,Chile,152,0,1,,1,"(0.812436,-77.847006)"
2019,Octubre,Chile,152,39,51,,90,"(0.814836,-77.662532)"
2019,Octubre,Chile,152,18,12,,30,"(10.445761,-75.516429)"
2019,Octubre,Chile,152,39,29,,68,"(10.886611,-74.776708)"
2019,Octubre,Chile,152,3,5,,8,"(12.586067,-81.702563)"
2019,Octubre,Chile,152,371,197,,568,"(3.541112,-76.384584)"
2019,Octubre,Chile,152,4934,4385,,9319,"(4.697144,-74.140516)"
2019,Octubre,Chile,152,88,59,,147,"(4.815061,-75.736532)"
2019,Octubre,Chile,152,185,147,,332,"(6.171601,-75.427454)"
2019,Octubre,Chile,152,5,7,,12,"(7.128456,-73.183637)"
2019,Octubre,China,156,3,9,,12,"(10.445761,-75.516429)"
2019,Octubre,China,156,1,4,,5,"(10.886611,-74.776708)"
2019,Octubre,China,156,11,25,,36,"(3.541112,-76.384584)"
2019,Octubre,China,156,251,542,,793,"(4.697144,-74.140516)"
2019,Octubre,China,156,0,4,,4,"(4.815061,-75.736532)"
2019,Octubre,China,156,35,82,,117,"(6.171601,-75.427454)"
2019,Octubre,Chipre,196,1,0,,1,"(3.541112,-76.384584)"
2019,Octubre,Chipre,196,4,1,,5,"(4.697144,-74.140516)"
2019,Octubre,Chipre,196,1,0,,1,"(6.171601,-75.427454)"
2019,Octubre,Dinamarca,208,2,0,,2,"(10.445761,-75.516429)"
2019,Octubre,Dinamarca,208,1,0,,1,"(10.886611,-74.776708)"
2019,Octubre,Dinamarca,208,2,4,,6,"(3.541112,-76.384584)"
2019,Octubre,Dinamarca,208,25,23,,48,"(4.697144,-74.140516)"
2019,Octubre,Dinamarca,208,1,2,,3,"(6.171601,-75.427454)"
2019,Octubre,Dominica,212,0,2,,2,"(3.541112,-76.384584)"
2019,Octubre,Ecuador,218,436,694,,1130,"(0.25129,-76.875963)"
2019,Octubre,Ecuador,218,18,33,,51,"(0.812436,-77.847006)"
2019,Octubre,Ecuador,218,3421,4504,,7925,"(0.814836,-77.662532)"
2019,Octubre,Ecuador,218,85,117,,202,"(1.813928,-78.763924)"
2019,Octubre,Ecuador,218,2,2,,4,"(10.445761,-75.516429)"
2019,Octubre,Ecuador,218,2,2,,4,"(10.886611,-74.776708)"
2019,Octubre,Ecuador,218,323,409,,732,"(3.541112,-76.384584)"
2019,Octubre,Ecuador,218,2757,3916,,6673,"(4.697144,-74.140516)"
2019,Octubre,Ecuador,218,6,4,,10,"(4.815061,-75.736532)"
2019,Octubre,Ecuador,218,33,61,,94,"(6.171601,-75.427454)"
2019,Octubre,Ecuador,218,2,4,,6,"(7.128456,-73.183637)"
2019,Octubre,Egipto,818,1,0,,1,"(10.886611,-74.776708)"
2019,Octubre,Egipto,818,3,2,,5,"(3.541112,-76.384584)"
2019,Octubre,Egipto,818,63,37,,100,"(4.697144,-74.140516)"
2019,Octubre,Egipto,818,6,7,,13,"(6.171601,-75.427454)"
2019,Octubre,El Salvador,222,0,1,,1,"(10.445761,-75.516429)"
2019,Octubre,El Salvador,222,1,6,,7,"(10.886611,-74.776708)"
2019,Octubre,El Salvador,222,3,8,,11,"(3.541112,-76.384584)"
2019,Octubre,El Salvador,222,1162,1423,,2585,"(4.697144,-74.140516)"
2019,Octubre,El Salvador,222,3,2,,5,"(4.815061,-75.736532)"
2019,Octubre,El Salvador,222,9,16,,25,"(6.171601,-75.427454)"
2019,Octubre,Emiratos Árabes,784,1,2,,3,"(10.445761,-75.516429)"
2019,Octubre,Emiratos Árabes,784,3,7,,10,"(3.541112,-76.384584)"
2019,Octubre,Emiratos Árabes,784,118,146,,264,"(4.697144,-74.140516)"
2019,Octubre,Emiratos Árabes,784,18,14,,32,"(6.171601,-75.427454)"
2019,Octubre,Eritrea,232,2,0,,2,"(4.697144,-74.140516)"
2019,Octubre,Eslovaquia,703,1,0,,1,"(4.697144,-74.140516)"
2019,Octubre,Eslovaquia,703,0,1,,1,"(6.171601,-75.427454)"
2019,Octubre,Eslovenia,705,1,2,,3,"(4.697144,-74.140516)"
2019,Octubre,Estados Unidos de América,840,3355,2794,,6149,"(10.445761,-75.516429)"
2019,Octubre,Estados Unidos de América,840,2899,2231,,5130,"(10.886611,-74.776708)"
2019,Octubre,Estados Unidos de América,840,6,3,,9,"(11.117806,-74.232622)"
2019,Octubre,Estados Unidos de América,840,46,62,,108,"(12.586067,-81.702563)"
2019,Octubre,Estados Unidos de América,840,6498,4824,,11322,"(3.541112,-76.384584)"
2019,Octubre,Estados Unidos de América,840,984,752,,1736,"(4.452882,-75.766298)"
2019,Octubre,Estados Unidos de América,840,33548,29688,,63236,"(4.697144,-74.140516)"
2019,Octubre,Estados Unidos de América,840,1289,888,,2177,"(4.815061,-75.736532)"
2019,Octubre,Estados Unidos de América,840,3,2,,5,"(6.17134,-75.427194)"
2019,Octubre,Estados Unidos de América,840,10591,8381,,18972,"(6.171601,-75.427454)"
2019,Octubre,Estados Unidos de América,840,206,148,,354,"(7.128456,-73.183637)"
2019,Octubre,Estados Unidos de América,840,0,3,,3,"(7.927209,-72.507910)"
2019,Octubre,Estonia,233,0,2,,2,"(4.697144,-74.140516)"
2019,Octubre,Etiopia,231,0,1,,1,"(3.541112,-76.384584)"
2019,Octubre,Etiopia,231,2,3,,5,"(4.697144,-74.140516)"
2019,Octubre,Etiopia,231,1,0,,1,"(6.171601,-75.427454)"
2019,Octubre,Filipinas,608,0,1,,1,"(10.445761,-75.516429)"
2019,Octubre,Filipinas,608,6,3,,9,"(4.697144,-74.140516)"
2019,Octubre,Filipinas,608,0,1,,1,"(4.815061,-75.736532)"
2019,Octubre,Filipinas,608,2,2,,4,"(6.171601,-75.427454)"
2019,Octubre,Finlandia,246,1,2,,3,"(3.541112,-76.384584)"
2019,Octubre,Finlandia,246,11,8,,19,"(4.697144,-74.140516)"
2019,Octubre,Francia,250,21,14,,35,"(10.445761,-75.516429)"
2019,Octubre,Francia,250,5,2,,7,"(10.886611,-74.776708)"
2019,Octubre,Francia,250,96,80,,176,"(3.541112,-76.384584)"
2019,Octubre,Francia,250,2081,1783,,3864,"(4.697144,-74.140516)"
2019,Octubre,Francia,250,7,10,,17,"(4.815061,-75.736532)"
2019,Octubre,Francia,250,157,92,,249,"(6.171601,-75.427454)"
2019,Octubre,Francia,250,1,1,,2,"(7.128456,-73.183637)"
2019,Octubre,Georgia,268,0,1,,1,"(4.697144,-74.140516)"
2019,Octubre,Ghana,288,1,0,,1,"(4.697144,-74.140516)"
2019,Octubre,Granada,308,1,0,,1,"(4.697144,-74.140516)"
2019,Octubre,Grecia,300,0,5,,5,"(10.886611,-74.776708)"
2019,Octubre,Grecia,300,30,25,,55,"(4.697144,-74.140516)"
2019,Octubre,Grecia,300,6,5,,11,"(6.171601,-75.427454)"
2019,Octubre,Groenlandia,304,0,1,,1,"(4.697144,-74.140516)"
2019,Octubre,Guatemala,320,0,11,,11,"(10.408582,-75.538003)"
2019,Octubre,Guatemala,320,1,2,,3,"(10.445761,-75.516429)"
2019,Octubre,Guatemala,320,7,12,,19,"(10.886611,-74.776708)"
2019,Octubre,Guatemala,320,0,10,,10,"(12.586067,-81.702563)"
2019,Octubre,Guatemala,320,36,38,,74,"(3.541112,-76.384584)"
2019,Octubre,Guatemala,320,668,854,,1522,"(4.697144,-74.140516)"
2019,Octubre,Guatemala,320,18,17,,35,"(4.815061,-75.736532)"
2019,Octubre,Guatemala,320,86,83,,169,"(6.171601,-75.427454)"
2019,Octubre,Guatemala,320,4,4,,8,"(7.128456,-73.183637)"
2019,Octubre,Guatemala,320,0,2,,2,"(9.402978,-75.681599)"
2019,Octubre,Guyana,328,0,7,,7,"(10.408582,-75.538003)"
2019,Octubre,Guyana,328,0,1,,1,"(10.445761,-75.516429)"
2019,Octubre,Guyana,328,2,3,,5,"(10.886611,-74.776708)"
2019,Octubre,Guyana,328,0,1,,1,"(3.541112,-76.384584)"
2019,Octubre,Guyana,328,3,4,,7,"(4.697144,-74.140516)"
2019,Octubre,Guyana,328,0,2,,2,"(4.815061,-75.736532)"
2019,Octubre,Guyana,328,1,3,,4,"(6.171601,-75.427454)"
2019,Octubre,Guyana,328,0,1,,1,"(7.128456,-73.183637)"
2019,Octubre,Guinea Ecuatorial,226,1,0,,1,"(4.697144,-74.140516)"
2019,Octubre,Guadalupe/Territorio Francés,312,1,3,,4,"(3.541112,-76.384584)"
2019,Octubre,Guadalupe/Territorio Francés,312,0,5,,5,"(4.697144,-74.140516)"
2019,Octubre,Guayana Francesa/Departamento de Ultramar Francés,254,0,1,,1,"(4.697144,-74.140516)"
2019,Octubre,Haití,332,2,3,,5,"(4.697144,-74.140516)"
2019,Octubre,Honduras,340,0,31,,31,"(10.408582,-75.538003)"
2019,Octubre,Honduras,340,4,10,,14,"(10.445761,-75.516429)"
2019,Octubre,Honduras,340,7,4,,11,"(10.886611,-74.776708)"
2019,Octubre,Honduras,340,13,25,,38,"(3.541112,-76.384584)"
2019,Octubre,Honduras,340,111,169,,280,"(4.697144,-74.140516)"
2019,Octubre,Honduras,340,6,9,,15,"(4.815061,-75.736532)"
2019,Octubre,Honduras,340,17,36,,53,"(6.171601,-75.427454)"
2019,Octubre,Honduras,340,1,2,,3,"(7.128456,-73.183637)"
2019,Octubre,Hong Kong,344,17,33,,50,"(4.697144,-74.140516)"
2019,Octubre,Hong Kong,344,4,0,,4,"(6.171601,-75.427454)"
2019,Octubre,Hungría,348,0,1,,1,"(3.541112,-76.384584)"
2019,Octubre,Hungría,348,12,8,,20,"(4.697144,-74.140516)"
2019,Octubre,Hungría,348,0,1,,1,"(6.171601,-75.427454)"
2019,Octubre,India,356,1,0,,1,"(10.445761,-75.516429)"
2019,Octubre,India,356,1,0,,1,"(10.886611,-74.776708)"
2019,Octubre,India,356,2,1,,3,"(3.541112,-76.384584)"
2019,Octubre,India,356,61,27,,88,"(4.697144,-74.140516)"
2019,Octubre,India,356,9,14,,23,"(6.171601,-75.427454)"
2019,Octubre,Indonesia,360,1,0,,1,"(10.445761,-75.516429)"
2019,Octubre,Indonesia,360,3,2,,5,"(3.541112,-76.384584)"
2019,Octubre,Indonesia,360,4,7,,11,"(4.697144,-74.140516)"
2019,Octubre,Indonesia,360,4,0,,4,"(6.171601,-75.427454)"
2019,Octubre,Iraq,368,0,5,,5,"(10.408582,-75.538003)"
2019,Octubre,Iraq,368,0,6,,6,"(4.697144,-74.140516)"
2019,Octubre,Iraq,368,0,1,,1,"(6.171601,-75.427454)"
2019,Octubre,Irán,364,2,1,,3,"(3.541112,-76.384584)"
2019,Octubre,Irán,364,2,0,,2,"(4.697144,-74.140516)"
2019,Octubre,República de Irlanda,372,1,0,,1,"(10.445761,-75.516429)"
2019,Octubre,República de Irlanda,372,16,8,,24,"(4.697144,-74.140516)"
2019,Octubre,República de Irlanda,372,3,1,,4,"(6.171601,-75.427454)"
2019,Octubre,Islandia,352,5,2,,7,"(4.697144,-74.140516)"
2019,Octubre,Islandia,352,2,0,,2,"(6.171601,-75.427454)"
2019,Octubre,Israel,376,1,0,,1,"(10.445761,-75.516429)"
2019,Octubre,Israel,376,3,1,,4,"(10.886611,-74.776708)"
2019,Octubre,Israel,376,14,4,,18,"(3.541112,-76.384584)"
2019,Octubre,Israel,376,220,162,,382,"(4.697144,-74.140516)"
2019,Octubre,Israel,376,1,1,,2,"(4.815061,-75.736532)"
2019,Octubre,Israel,376,22,9,,31,"(6.171601,-75.427454)"
2019,Octubre,Italia,380,11,8,,19,"(10.445761,-75.516429)"
2019,Octubre,Italia,380,18,8,,26,"(10.886611,-74.776708)"
2019,Octubre,Italia,380,1,0,,1,"(12.586067,-81.702563)"
2019,Octubre,Italia,380,86,47,,133,"(3.541112,-76.384584)"
2019,Octubre,Italia,380,627,458,,1085,"(4.697144,-74.140516)"
2019,Octubre,Italia,380,3,4,,7,"(4.815061,-75.736532)"
2019,Octubre,Italia,380,142,104,,246,"(6.171601,-75.427454)"
2019,Octubre,Jamaica,388,0,1,,1,"(10.445761,-75.516429)"
2019,Octubre,Jamaica,388,1,2,,3,"(10.886611,-74.776708)"
2019,Octubre,Jamaica,388,1,0,,1,"(12.586067,-81.702563)"
2019,Octubre,Jamaica,388,15,14,,29,"(3.541112,-76.384584)"
2019,Octubre,Jamaica,388,33,46,,79,"(4.697144,-74.140516)"
2019,Octubre,Jamaica,388,8,5,,13,"(4.815061,-75.736532)"
2019,Octubre,Jamaica,388,27,26,,53,"(6.171601,-75.427454)"
2019,Octubre,Japón,392,1,0,,1,"(10.445761,-75.516429)"
2019,Octubre,Japón,392,2,3,,5,"(3.541112,-76.384584)"
2019,Octubre,Japón,392,110,123,,233,"(4.697144,-74.140516)"
2019,Octubre,Japón,392,1,0,,1,"(4.815061,-75.736532)"
2019,Octubre,Japón,392,28,23,,51,"(6.171601,-75.427454)"
2019,Octubre,Jordania,400,1,0,,1,"(3.541112,-76.384584)"
2019,Octubre,Jordania,400,1,3,,4,"(4.697144,-74.140516)"
2019,Octubre,Jordania,400,1,0,,1,"(6.171601,-75.427454)"
2019,Octubre,Kazajistán,398,1,4,,5,"(4.697144,-74.140516)"
2019,Octubre,Kenia,404,1,1,,2,"(3.541112,-76.384584)"
2019,Octubre,Kenia,404,2,2,,4,"(4.697144,-74.140516)"
2019,Octubre,Kuwait,414,1,0,,1,"(3.541112,-76.384584)"
2019,Octubre,Kuwait,414,1,1,,2,"(4.697144,-74.140516)"
2019,Octubre,República Democrática Popular  Lao,418,1,1,,2,"(4.697144,-74.140516)"
2019,Octubre,Letonia,428,0,1,,1,"(4.697144,-74.140516)"
2019,Octubre,Lituania,440,0,2,,2,"(4.697144,-74.140516)"
2019,Octubre,Líbano,422,9,7,,16,"(4.697144,-74.140516)"
2019,Octubre,Líbano,422,0,3,,3,"(6.171601,-75.427454)"
2019,Octubre,Liberia,430,1,1,,2,"(4.697144,-74.140516)"
2019,Octubre,Liberia,430,0,1,,1,"(6.171601,-75.427454)"
2019,Octubre,Luxemburgo,442,1,0,,1,"(3.541112,-76.384584)"
2019,Octubre,Luxemburgo,442,13,7,,20,"(4.697144,-74.140516)"
2019,Octubre,Luxemburgo,442,1,1,,2,"(6.171601,-75.427454)"
2019,Octubre,Macao,446,0,2,,2,"(4.697144,-74.140516)"
2019,Octubre,Macao,446,1,0,,1,"(6.171601,-75.427454)"
2019,Octubre,Malasia,458,0,1,,1,"(10.445761,-75.516429)"
2019,Octubre,Malasia,458,3,3,,6,"(4.697144,-74.140516)"
2019,Octubre,Malasia,458,1,0,,1,"(6.171601,-75.427454)"
2019,Octubre,Malta,470,1,1,,2,"(10.445761,-75.516429)"
2019,Octubre,Malta,470,1,0,,1,"(3.541112,-76.384584)"
2019,Octubre,Malta,470,32,25,,57,"(4.697144,-74.140516)"
2019,Octubre,Malta,470,2,2,,4,"(6.171601,-75.427454)"
2019,Octubre,Marruecos,504,4,2,,6,"(3.541112,-76.384584)"
2019,Octubre,Marruecos,504,8,6,,14,"(4.697144,-74.140516)"
2019,Octubre,Marruecos,504,5,5,,10,"(6.171601,-75.427454)"
2019,Octubre,Mauritania,478,0,2,,2,"(4.697144,-74.140516)"
2019,Octubre,Martinica/Departamento de Ultramar Francés,474,0,1,,1,"(4.697144,-74.140516)"
2019,Octubre,México,484,0,1,,1,"(10.408582,-75.538003)"
2019,Octubre,México,484,81,48,,129,"(10.445761,-75.516429)"
2019,Octubre,México,484,151,131,,282,"(10.886611,-74.776708)"
2019,Octubre,México,484,19,10,,29,"(12.586067,-81.702563)"
2019,Octubre,México,484,610,446,,1056,"(3.541112,-76.384584)"
2019,Octubre,México,484,19055,16838,,35894,"(4.697144,-74.140516)"
2019,Octubre,México,484,261,199,,460,"(4.815061,-75.736532)"
2019,Octubre,México,484,5964,4649,,10613,"(6.171601,-75.427454)"
2019,Octubre,México,484,138,92,,230,"(7.128456,-73.183637)"
2019,Octubre,Mónaco,492,2,0,,2,"(4.697144,-74.140516)"
2019,Octubre,Mongolia,496,1,3,,4,"(4.697144,-74.140516)"
2019,Octubre,Montenegro,499,1,0,,1,"(6.171601,-75.427454)"
2019,Octubre,Mozambique,508,0,1,,1,"(4.697144,-74.140516)"
2019,Octubre,Nepal,524,1,2,,3,"(4.697144,-74.140516)"
2019,Octubre,Nepal,524,1,0,,1,"(6.171601,-75.427454)"
2019,Octubre,Nicaragua,558,0,1,,1,"(10.445761,-75.516429)"
2019,Octubre,Nicaragua,558,1,3,,4,"(10.886611,-74.776708)"
2019,Octubre,Nicaragua,558,2,0,,2,"(12.586067,-81.702563)"
2019,Octubre,Nicaragua,558,11,20,,31,"(3.541112,-76.384584)"
2019,Octubre,Nicaragua,558,22,44,,66,"(4.697144,-74.140516)"
2019,Octubre,Nicaragua,558,2,8,,10,"(4.815061,-75.736532)"
2019,Octubre,Nicaragua,558,10,47,,57,"(6.171601,-75.427454)"
2019,Octubre,Nicaragua,558,0,2,,2,"(7.128456,-73.183637)"
2019,Octubre,Nigeria,566,0,1,,1,"(10.886611,-74.776708)"
2019,Octubre,Nigeria,566,0,2,,2,"(4.697144,-74.140516)"
2019,Octubre,Noruega,578,3,2,,5,"(10.445761,-75.516429)"
2019,Octubre,Noruega,578,1,2,,3,"(3.541112,-76.384584)"
2019,Octubre,Noruega,578,22,9,,31,"(4.697144,-74.140516)"
2019,Octubre,Noruega,578,2,0,,2,"(6.171601,-75.427454)"
2019,Octubre,Nueva Caledonia/Territorio francés,540,0,1,,1,"(4.697144,-74.140516)"
2019,Octubre,Nueva Zelanda,554,0,1,,1,"(10.886611,-74.776708)"
2019,Octubre,Nueva Zelanda,554,42,44,,86,"(4.697144,-74.140516)"
2019,Octubre,Omán,512,7,6,,13,"(4.697144,-74.140516)"
2019,Octubre,Omán,512,0,2,,2,"(6.171601,-75.427454)"
2019,Octubre,Pakistán,586,0,1,,1,"(10.886611,-74.776708)"
2019,Octubre,Panamá,591,120,145,,265,"(10.408582,-75.538003)"
2019,Octubre,Panamá,591,1304,1215,,2519,"(10.445761,-75.516429)"
2019,Octubre,Panamá,591,817,748,,1565,"(10.886611,-74.776708)"
2019,Octubre,Panamá,591,0,10,,10,"(10.971302,-74.765397)"
2019,Octubre,Panamá,591,0,2,,2,"(12.165168,-71.983761)"
2019,Octubre,Panamá,591,2,22,,24,"(12.5744111,-81.703935)"
2019,Octubre,Panamá,591,65,83,,148,"(12.586067,-81.702563)"
2019,Octubre,Panamá,591,2467,2052,,4519,"(3.541112,-76.384584)"
2019,Octubre,Panamá,591,7648,8330,,15978,"(4.697144,-74.140516)"
2019,Octubre,Panamá,591,311,222,,533,"(4.815061,-75.736532)"
2019,Octubre,Panamá,591,2565,2357,,4922,"(6.171601,-75.427454)"
2019,Octubre,Panamá,591,4,4,,8,"(6.228046,-77.404104)"
2019,Octubre,Panamá,591,19,36,,55,"(7.102626,-77.762647)"
2019,Octubre,Panamá,591,162,130,,292,"(7.128456,-73.183637)"
2019,Octubre,Panamá,591,0,7,,7,"(8.066966,-76.735404)"
2019,Octubre,Panamá,591,29,60,,89,"(8.635765,-77.346578)"
2019,Octubre,Paraguay,600,0,3,,3,"(10.445761,-75.516429)"
2019,Octubre,Paraguay,600,10,18,,28,"(10.886611,-74.776708)"
2019,Octubre,Paraguay,600,1,0,,1,"(12.586067,-81.702563)"
2019,Octubre,Paraguay,600,11,19,,30,"(3.541112,-76.384584)"
2019,Octubre,Paraguay,600,105,171,,276,"(4.697144,-74.140516)"
2019,Octubre,Paraguay,600,5,7,,12,"(4.815061,-75.736532)"
2019,Octubre,Paraguay,600,44,35,,79,"(6.171601,-75.427454)"
2019,Octubre,Perú,604,30,17,,47,"(-0.193180,-74.784874)"
2019,Octubre,Perú,604,1,0,,1,"(-4.197703,-69.941278)"
2019,Octubre,Perú,604,122,165,,287,"(-4.223468,-69.945098)"
2019,Octubre,Perú,604,1,4,,5,"(0.25129,-76.875963)"
2019,Octubre,Perú,604,55,63,,118,"(0.814836,-77.662532)"
2019,Octubre,Perú,604,2,2,,4,"(1.813928,-78.763924)"
2019,Octubre,Perú,604,127,133,,260,"(10.445761,-75.516429)"
2019,Octubre,Perú,604,16,15,,31,"(10.886611,-74.776708)"
2019,Octubre,Perú,604,0,1,,1,"(12.586067,-81.702563)"
2019,Octubre,Perú,604,338,370,,708,"(3.541112,-76.384584)"
2019,Octubre,Perú,604,6144,6539,,12683,"(4.697144,-74.140516)"
2019,Octubre,Perú,604,14,5,,19,"(4.815061,-75.736532)"
2019,Octubre,Perú,604,951,941,,1892,"(6.171601,-75.427454)"
2019,Octubre,Perú,604,6,4,,10,"(7.128456,-73.183637)"
2019,Octubre,Palestina,99999,2,0,,2,"(4.697144,-74.140516)"
2019,Octubre,Polonia,616,0,1,,1,"(10.445761,-75.516429)"
2019,Octubre,Polonia,616,1,0,,1,"(3.541112,-76.384584)"
2019,Octubre,Polonia,616,8,16,,24,"(4.697144,-74.140516)"
2019,Octubre,Polonia,616,3,4,,7,"(6.171601,-75.427454)"
2019,Octubre,Portugal,620,1,1,,2,"(10.886611,-74.776708)"
2019,Octubre,Portugal,620,4,9,,13,"(3.541112,-76.384584)"
2019,Octubre,Portugal,620,322,267,,589,"(4.697144,-74.140516)"
2019,Octubre,Portugal,620,28,13,,41,"(6.171601,-75.427454)"
2019,Octubre,Portugal,620,1,0,,1,"(7.128456,-73.183637)"
2019,Octubre,Puerto Rico/Territorio de Estados Unidos,630,8,3,,11,"(10.445761,-75.516429)"
2019,Octubre,Puerto Rico/Territorio de Estados Unidos,630,5,3,,8,"(10.886611,-74.776708)"
2019,Octubre,Puerto Rico/Territorio de Estados Unidos,630,1,0,,1,"(11.117806,-74.232622)"
2019,Octubre,Puerto Rico/Territorio de Estados Unidos,630,0,1,,1,"(12.586067,-81.702563)"
2019,Octubre,Puerto Rico/Territorio de Estados Unidos,630,24,18,,42,"(3.541112,-76.384584)"
2019,Octubre,Puerto Rico/Territorio de Estados Unidos,630,432,440,,872,"(4.697144,-74.140516)"
2019,Octubre,Puerto Rico/Territorio de Estados Unidos,630,4,1,,5,"(4.815061,-75.736532)"
2019,Octubre,Puerto Rico/Territorio de Estados Unidos,630,25,27,,52,"(6.171601,-75.427454)"
2019,Octubre,Puerto Rico/Territorio de Estados Unidos,630,2,1,,3,"(7.128456,-73.183637)"
2019,Octubre,Qatar,634,0,1,,1,"(3.541112,-76.384584)"
2019,Octubre,Qatar,634,7,13,,20,"(4.697144,-74.140516)"
2019,Octubre,Qatar,634,2,4,,6,"(6.171601,-75.427454)"
2019,Octubre,Reino Unido de Gran Bretaña e Irlanda del Norte,826,1,0,,1,"(10.445761,-75.516429)"
2019,Octubre,Reino Unido de Gran Bretaña e Irlanda del Norte,826,2,0,,2,"(10.886611,-74.776708)"
2019,Octubre,Reino Unido de Gran Bretaña e Irlanda del Norte,826,23,19,,42,"(3.541112,-76.384584)"
2019,Octubre,Reino Unido de Gran Bretaña e Irlanda del Norte,826,1585,1268,,2853,"(4.697144,-74.140516)"
2019,Octubre,Reino Unido de Gran Bretaña e Irlanda del Norte,826,1,1,,2,"(4.815061,-75.736532)"
2019,Octubre,Reino Unido de Gran Bretaña e Irlanda del Norte,826,19,15,,34,"(6.171601,-75.427454)"
2019,Octubre,Federación de Rusia,643,1,1,,2,"(3.541112,-76.384584)"
2019,Octubre,Federación de Rusia,643,46,66,,112,"(4.697144,-74.140516)"
2019,Octubre,Federación de Rusia,643,2,1,,3,"(4.815061,-75.736532)"
2019,Octubre,Federación de Rusia,643,5,0,,5,"(6.171601,-75.427454)"
2019,Octubre,República Dominicana,214,2,3,,5,"(10.408582,-75.538003)"
2019,Octubre,República Dominicana,214,21,21,,42,"(10.445761,-75.516429)"
2019,Octubre,República Dominicana,214,48,69,,117,"(10.886611,-74.776708)"
2019,Octubre,República Dominicana,214,6,298,,304,"(10.971302,-74.765397)"
2019,Octubre,República Dominicana,214,5,1,,6,"(11.117806,-74.232622)"
2019,Octubre,República Dominicana,214,135,88,,223,"(3.541112,-76.384584)"
2019,Octubre,República Dominicana,214,4278,3719,,7997,"(4.697144,-74.140516)"
2019,Octubre,República Dominicana,214,71,49,,120,"(4.815061,-75.736532)"
2019,Octubre,República Dominicana,214,361,302,,663,"(6.171601,-75.427454)"
2019,Octubre,República Dominicana,214,44,29,,73,"(7.128456,-73.183637)"
2019,Octubre,Reunión,638,1,0,,1,"(4.697144,-74.140516)"
2019,Octubre,República Democrática Popular de Corea,408,1,2,,3,"(4.697144,-74.140516)"
2019,Octubre,Rumania,642,7,7,,14,"(4.697144,-74.140516)"
2019,Octubre,Sahara Occidental/Desierto Sahara,732,0,1,,1,"(10.886611,-74.776708)"
2019,Octubre,Sahara Occidental/Desierto Sahara,732,1,0,,1,"(4.697144,-74.140516)"
2019,Octubre,San Pedro y Miquelón/territorio de Ultramar de La Unión Europea,666,0,1,,1,"(7.927209,-72.507910)"
2019,Octubre,San Marino,674,0,3,,3,"(7.927209,-72.507910)"
2019,Octubre,San  Vicente y las Granadinas,670,1,0,,1,"(4.697144,-74.140516)"
2019,Octubre,Senegal,686,3,0,,3,"(4.697144,-74.140516)"
2019,Octubre,Serbia,688,1,2,,3,"(4.697144,-74.140516)"
2019,Octubre,Serbia,688,0,1,,1,"(6.171601,-75.427454)"
2019,Octubre,Sierra Leona,694,1,0,,1,"(4.697144,-74.140516)"
2019,Octubre,Singapur,702,1,1,,2,"(10.445761,-75.516429)"
2019,Octubre,Singapur,702,1,2,,3,"(10.886611,-74.776708)"
2019,Octubre,Singapur,702,0,1,,1,"(3.541112,-76.384584)"
2019,Octubre,Singapur,702,24,21,,45,"(4.697144,-74.140516)"
2019,Octubre,Singapur,702,3,5,,8,"(6.171601,-75.427454)"
2019,Octubre,República Árabe Siria,760,1,0,,1,"(4.697144,-74.140516)"
2019,Octubre,Sri Lanka,144,1,0,,1,"(3.541112,-76.384584)"
2019,Octubre,Sri Lanka,144,3,1,,4,"(4.697144,-74.140516)"
2019,Octubre,Sudáfrica,710,24,9,,33,"(4.697144,-74.140516)"
2019,Octubre,Suecia,752,4,3,,7,"(10.445761,-75.516429)"
2019,Octubre,Suecia,752,0,1,,1,"(10.886611,-74.776708)"
2019,Octubre,Suecia,752,9,13,,22,"(3.541112,-76.384584)"
2019,Octubre,Suecia,752,66,57,,123,"(4.697144,-74.140516)"
2019,Octubre,Suecia,752,17,11,,28,"(6.171601,-75.427454)"
2019,Octubre,Suiza,756,5,3,,8,"(10.445761,-75.516429)"
2019,Octubre,Suiza,756,5,2,,7,"(10.886611,-74.776708)"
2019,Octubre,Suiza,756,0,1,,1,"(12.586067,-81.702563)"
2019,Octubre,Suiza,756,33,19,,52,"(3.541112,-76.384584)"
2019,Octubre,Suiza,756,259,162,,421,"(4.697144,-74.140516)"
2019,Octubre,Suiza,756,1,0,,1,"(4.815061,-75.736532)"
2019,Octubre,Suiza,756,43,21,,64,"(6.171601,-75.427454)"
2019,Octubre,Suiza,756,0,1,,1,"(7.128456,-73.183637)"
2019,Octubre,Surinam,740,1,2,,3,"(10.886611,-74.776708)"
2019,Octubre,Surinam,740,2,66,,68,"(3.541112,-76.384584)"
2019,Octubre,Surinam,740,5,8,,13,"(4.697144,-74.140516)"
2019,Octubre,Surinam,740,1,1,,2,"(6.171601,-75.427454)"
2019,Octubre,Taiwán,158,1,3,,4,"(4.697144,-74.140516)"
2019,Octubre,Tailandia,764,2,0,,2,"(3.541112,-76.384584)"
2019,Octubre,Tailandia,764,37,32,,69,"(4.697144,-74.140516)"
2019,Octubre,Tailandia,764,3,1,,4,"(6.171601,-75.427454)"
2019,Octubre,Tanzania,834,0,3,,3,"(4.697144,-74.140516)"
2019,Octubre,Tanzania,834,1,1,,2,"(6.171601,-75.427454)"
2019,Octubre,Togo,768,1,0,,1,"(4.697144,-74.140516)"
2019,Octubre,Trinidad y Tobago,780,0,1,,1,"(10.445761,-75.516429)"
2019,Octubre,Trinidad y Tobago,780,1,1,,2,"(10.886611,-74.776708)"
2019,Octubre,Trinidad y Tobago,780,2,5,,7,"(11.117806,-74.232622)"
2019,Octubre,Trinidad y Tobago,780,5,2,,7,"(12.586067,-81.702563)"
2019,Octubre,Trinidad y Tobago,780,7,36,,43,"(3.541112,-76.384584)"
2019,Octubre,Trinidad y Tobago,780,12,15,,27,"(4.697144,-74.140516)"
2019,Octubre,Trinidad y Tobago,780,2,5,,7,"(4.815061,-75.736532)"
2019,Octubre,Trinidad y Tobago,780,6,8,,14,"(6.171601,-75.427454)"
2019,Octubre,Trinidad y Tobago,780,2,9,,11,"(7.128456,-73.183637)"
2019,Octubre,Túnez,788,2,2,,4,"(4.697144,-74.140516)"
2019,Octubre,Turquía,792,0,1,,1,"(10.886611,-74.776708)"
2019,Octubre,Turquía,792,6,10,,16,"(3.541112,-76.384584)"
2019,Octubre,Turquía,792,1820,928,,2748,"(4.697144,-74.140516)"
2019,Octubre,Turquía,792,0,2,,2,"(4.815061,-75.736532)"
2019,Octubre,Turquía,792,30,25,,55,"(6.171601,-75.427454)"
2019,Octubre,Turquía,792,1,0,,1,"(7.128456,-73.183637)"
2019,Octubre,Ucrania,804,1,12,,13,"(4.697144,-74.140516)"
2019,Octubre,Uruguay,858,1,3,,4,"(10.445761,-75.516429)"
2019,Octubre,Uruguay,858,2,0,,2,"(10.886611,-74.776708)"
2019,Octubre,Uruguay,858,22,27,,49,"(3.541112,-76.384584)"
2019,Octubre,Uruguay,858,156,191,,347,"(4.697144,-74.140516)"
2019,Octubre,Uruguay,858,8,8,,16,"(4.815061,-75.736532)"
2019,Octubre,Uruguay,858,27,20,,47,"(6.171601,-75.427454)"
2019,Octubre,Uruguay,858,0,2,,2,"(7.128456,-73.183637)"
2019,Octubre,Venezuela,862,0,4,,4,"(10.408582,-75.538003)"
2019,Octubre,Venezuela,862,6,8,,14,"(10.445761,-75.516429)"
2019,Octubre,Venezuela,862,17,21,,38,"(10.886611,-74.776708)"
2019,Octubre,Venezuela,862,1,2,,3,"(11.117806,-74.232622)"
2019,Octubre,Venezuela,862,1210,1214,,2425,"(11.360009,-72.129330)"
2019,Octubre,Venezuela,862,257,220,,477,"(3.541112,-76.384584)"
2019,Octubre,Venezuela,862,2,0,,2,"(3.866713,-67.927521)"
2019,Octubre,Venezuela,862,684,765,,1449,"(4.697144,-74.140516)"
2019,Octubre,Venezuela,862,203,212,,415,"(6.171601,-75.427454)"
2019,Octubre,Venezuela,862,9,16,,25,"(6.185799,-67.483929)"
2019,Octubre,Venezuela,862,191,213,,404,"(7.088729,-70.740253)"
2019,Octubre,Venezuela,862,662,688,,1350,"(7.818934,-72.453226)"
2019,Octubre,Venezuela,862,64,79,,143,"(8.36068,-72.409396)"
2019,Octubre,Vietnam,704,5,8,,13,"(4.697144,-74.140516)"
2019,Octubre,Vietnam,704,1,1,,2,"(6.171601,-75.427454)"
2019,Octubre,Islas Vírgenes Británicas/Territorio Británico de Ultramar,92,0,1,,1,"(4.697144,-74.140516)"
2019,Octubre,Islas Vírgenes Estadounidenses/Territorio de Estados Unidos,850,0,1,,1,"(4.697144,-74.140516)"
2019,Octubre,República Árabe de Yemen,887,1,0,,1,"(4.697144,-74.140516)"
2019,Noviembre,Afganistán,4,0,1,,1,"(3.541112,-76.384584)"
2019,Noviembre,Afganistán,4,3,2,,5,"(4.697144,-74.140516)"
2019,Noviembre,Albania,8,0,2,,2,"(4.697144,-74.140516)"
2019,Noviembre,Alemania,276,0,1,,1,"(0.814836,-77.662532)"
2019,Noviembre,Alemania,276,10,7,,17,"(10.445761,-75.516429)"
2019,Noviembre,Alemania,276,6,4,,10,"(10.886611,-74.776708)"
2019,Noviembre,Alemania,276,27,29,,56,"(3.541112,-76.384584)"
2019,Noviembre,Alemania,276,1543,1519,,3062,"(4.697144,-74.140516)"
2019,Noviembre,Alemania,276,0,1,,1,"(4.815061,-75.736532)"
2019,Noviembre,Alemania,276,84,90,,174,"(6.171601,-75.427454)"
2019,Noviembre,Andorra,20,3,6,,9,"(4.697144,-74.140516)"
2019,Noviembre,Andorra,20,0,1,,1,"(6.171601,-75.427454)"
2019,Noviembre,Angola,24,0,2,,2,"(4.697144,-74.140516)"
2019,Noviembre,Antigua y Barbuda,28,26,27,,53,"(10.445761,-75.516429)"
2019,Noviembre,Antigua y Barbuda,28,1,3,,4,"(4.697144,-74.140516)"
2019,Noviembre,Países Bajos,528,225,147,,372,"(10.445761,-75.516429)"
2019,Noviembre,Países Bajos,528,8,9,,17,"(10.886611,-74.776708)"
2019,Noviembre,Países Bajos,528,53,32,,85,"(3.541112,-76.384584)"
2019,Noviembre,Países Bajos,528,1222,1196,,2418,"(4.697144,-74.140516)"
2019,Noviembre,Países Bajos,528,7,4,,11,"(4.815061,-75.736532)"
2019,Noviembre,Países Bajos,528,92,66,,158,"(6.171601,-75.427454)"
2019,Noviembre,Países Bajos,528,0,1,,1,"(7.128456,-73.183637)"
2019,Noviembre,Países Bajos,528,5,3,,8,"(7.927209,-72.507910)"
2019,Noviembre,Arabia Saudita,682,0,4,,4,"(3.541112,-76.384584)"
2019,Noviembre,Arabia Saudita,682,5,23,,28,"(4.697144,-74.140516)"
2019,Noviembre,Arabia Saudita,682,0,1,,1,"(4.815061,-75.736532)"
2019,Noviembre,Arabia Saudita,682,1,5,,6,"(6.171601,-75.427454)"
2019,Noviembre,Arabia Saudita,682,1,1,,2,"(7.128456,-73.183637)"
2019,Noviembre,Argelia,12,1,5,,6,"(4.697144,-74.140516)"
2019,Noviembre,Argelia,12,0,2,,2,"(6.171601,-75.427454)"
2019,Noviembre,Argentina,32,0,1,,1,"(0.25129,-76.875963)"
2019,Noviembre,Argentina,32,6,11,,17,"(0.814836,-77.662532)"
2019,Noviembre,Argentina,32,30,20,,50,"(10.445761,-75.516429)"
2019,Noviembre,Argentina,32,61,31,,92,"(10.886611,-74.776708)"
2019,Noviembre,Argentina,32,0,1,,1,"(12.586067,-81.702563)"
2019,Noviembre,Argentina,32,173,124,,297,"(3.541112,-76.384584)"
2019,Noviembre,Argentina,32,3031,2990,,6021,"(4.697144,-74.140516)"
2019,Noviembre,Argentina,32,23,12,,35,"(4.815061,-75.736532)"
2019,Noviembre,Argentina,32,175,187,,362,"(6.171601,-75.427454)"
2019,Noviembre,Argentina,32,5,7,,12,"(7.128456,-73.183637)"
2019,Noviembre,Aruba,533,3354,2353,,5707,"(10.408582,-75.538003)"
2019,Noviembre,Aruba,533,1,1,,2,"(10.445761,-75.516429)"
2019,Noviembre,Aruba,533,8,5,,13,"(10.886611,-74.776708)"
2019,Noviembre,Aruba,533,42,38,,80,"(11.528919,-72.919681)"
2019,Noviembre,Aruba,533,1,0,,1,"(12.586067,-81.702563)"
2019,Noviembre,Aruba,533,14,12,,26,"(3.541112,-76.384584)"
2019,Noviembre,Aruba,533,1787,1356,,3143,"(4.697144,-74.140516)"
2019,Noviembre,Aruba,533,9,4,,13,"(4.815061,-75.736532)"
2019,Noviembre,Aruba,533,0,1,,1,"(6.17134,-75.427194)"
2019,Noviembre,Aruba,533,30,24,,54,"(6.171601,-75.427454)"
2019,Noviembre,Aruba,533,5,18,,23,"(7.128456,-73.183637)"
2019,Noviembre,Australia,36,1,0,,1,"(10.886611,-74.776708)"
2019,Noviembre,Australia,36,10,9,,19,"(3.541112,-76.384584)"
2019,Noviembre,Australia,36,547,427,,974,"(4.697144,-74.140516)"
2019,Noviembre,Australia,36,1,0,,1,"(4.815061,-75.736532)"
2019,Noviembre,Australia,36,34,30,,64,"(6.171601,-75.427454)"
2019,Noviembre,Austria,40,2,2,,4,"(10.886611,-74.776708)"
2019,Noviembre,Austria,40,1,2,,3,"(3.541112,-76.384584)"
2019,Noviembre,Austria,40,28,28,,56,"(4.697144,-74.140516)"
2019,Noviembre,Austria,40,6,3,,9,"(6.171601,-75.427454)"
2019,Noviembre,Azerbaiyán,31,1,0,,1,"(4.697144,-74.140516)"
2019,Noviembre,Bahamas,44,2,0,,2,"(10.445761,-75.516429)"
2019,Noviembre,Bahamas,44,1,1,,2,"(10.886611,-74.776708)"
2019,Noviembre,Bahamas,44,10,4,,14,"(3.541112,-76.384584)"
2019,Noviembre,Bahamas,44,13,16,,29,"(4.697144,-74.140516)"
2019,Noviembre,Bahamas,44,2,1,,3,"(4.815061,-75.736532)"
2019,Noviembre,Bahamas,44,26,7,,33,"(6.171601,-75.427454)"
2019,Noviembre,Bahréin,48,1,0,,1,"(10.445761,-75.516429)"
2019,Noviembre,Bahréin,48,2,9,,11,"(4.697144,-74.140516)"
2019,Noviembre,Bahréin,48,2,2,,4,"(6.171601,-75.427454)"
2019,Noviembre,Barbados,52,2,3,,5,"(3.541112,-76.384584)"
2019,Noviembre,Barbados,52,4,4,,8,"(4.697144,-74.140516)"
2019,Noviembre,Barbados,52,2,2,,4,"(6.171601,-75.427454)"
2019,Noviembre,Barbados,52,1,0,,1,"(7.128456,-73.183637)"
2019,Noviembre,República de Belarús,112,0,1,,1,"(10.445761,-75.516429)"
2019,Noviembre,República de Belarús,112,1,0,,1,"(4.697144,-74.140516)"
2019,Noviembre,Bélgica,56,1,1,,2,"(10.445761,-75.516429)"
2019,Noviembre,Bélgica,56,1,0,,1,"(10.886611,-74.776708)"
2019,Noviembre,Bélgica,56,11,14,,25,"(3.541112,-76.384584)"
2019,Noviembre,Bélgica,56,80,53,,133,"(4.697144,-74.140516)"
2019,Noviembre,Bélgica,56,16,14,,30,"(6.171601,-75.427454)"
2019,Noviembre,Bélgica,56,1,0,,1,"(7.128456,-73.183637)"
2019,Noviembre,Belice,84,2,2,,4,"(10.886611,-74.776708)"
2019,Noviembre,Belice,84,1,0,,1,"(3.541112,-76.384584)"
2019,Noviembre,Belice,84,10,7,,17,"(4.697144,-74.140516)"
2019,Noviembre,Belice,84,1,0,,1,"(4.815061,-75.736532)"
2019,Noviembre,Belice,84,4,4,,8,"(6.171601,-75.427454)"
2019,Noviembre,Benín,204,1,1,,2,"(4.697144,-74.140516)"
2019,Noviembre,Bermudas/Territorio Británico de Ultramar,60,0,2,,2,"(6.171601,-75.427454)"
2019,Noviembre,Bolivia,68,0,1,,1,"(0.25129,-76.875963)"
2019,Noviembre,Bolivia,68,2,2,,4,"(0.814836,-77.662532)"
2019,Noviembre,Bolivia,68,2,4,,6,"(10.886611,-74.776708)"
2019,Noviembre,Bolivia,68,19,18,,37,"(3.541112,-76.384584)"
2019,Noviembre,Bolivia,68,301,377,,678,"(4.697144,-74.140516)"
2019,Noviembre,Bolivia,68,13,11,,24,"(4.815061,-75.736532)"
2019,Noviembre,Bolivia,68,13,26,,39,"(6.171601,-75.427454)"
2019,Noviembre,Bosnia y Herzegovina,70,1,0,,1,"(4.697144,-74.140516)"
2019,Noviembre,Brasil,76,153,211,,364,"(-4.197703,-69.941278)"
2019,Noviembre,Brasil,76,36,74,,110,"(-4.223468,-69.945098)"
2019,Noviembre,Brasil,76,0,4,,4,"(0.814836,-77.662532)"
2019,Noviembre,Brasil,76,16,14,,30,"(10.445761,-75.516429)"
2019,Noviembre,Brasil,76,11,16,,27,"(10.886611,-74.776708)"
2019,Noviembre,Brasil,76,0,1,,1,"(12.586067,-81.702563)"
2019,Noviembre,Brasil,76,158,153,,311,"(3.541112,-76.384584)"
2019,Noviembre,Brasil,76,3412,4152,,7564,"(4.697144,-74.140516)"
2019,Noviembre,Brasil,76,22,39,,61,"(4.815061,-75.736532)"
2019,Noviembre,Brasil,76,181,208,,389,"(6.171601,-75.427454)"
2019,Noviembre,Brasil,76,4,4,,8,"(7.128456,-73.183637)"
2019,Noviembre,Bulgaria,100,1,2,,3,"(4.697144,-74.140516)"
2019,Noviembre,Cabo Verde,132,1,0,,1,"(4.697144,-74.140516)"
2019,Noviembre,Islas Caimán/Territorio Británico de Ultramar,136,1,1,,2,"(10.408582,-75.538003)"
2019,Noviembre,Islas Caimán/Territorio Británico de Ultramar,136,1,1,,2,"(10.445761,-75.516429)"
2019,Noviembre,Islas Caimán/Territorio Británico de Ultramar,136,2,4,,6,"(12.586067,-81.702563)"
2019,Noviembre,Islas Caimán/Territorio Británico de Ultramar,136,2,0,,2,"(3.541112,-76.384584)"
2019,Noviembre,Islas Caimán/Territorio Británico de Ultramar,136,6,3,,9,"(4.697144,-74.140516)"
2019,Noviembre,Islas Caimán/Territorio Británico de Ultramar,136,2,0,,2,"(4.815061,-75.736532)"
2019,Noviembre,Camboya,116,3,2,,5,"(4.697144,-74.140516)"
2019,Noviembre,Canadá,124,27,19,,46,"(10.445761,-75.516429)"
2019,Noviembre,Canadá,124,42,28,,70,"(10.886611,-74.776708)"
2019,Noviembre,Canadá,124,1,1,,2,"(12.586067,-81.702563)"
2019,Noviembre,Canadá,124,134,84,,218,"(3.541112,-76.384584)"
2019,Noviembre,Canadá,124,1,0,,1,"(4.452882,-75.766298)"
2019,Noviembre,Canadá,124,1682,1434,,3116,"(4.697144,-74.140516)"
2019,Noviembre,Canadá,124,26,21,,47,"(4.815061,-75.736532)"
2019,Noviembre,Canadá,124,225,152,,377,"(6.171601,-75.427454)"
2019,Noviembre,Canadá,124,7,6,,13,"(7.128456,-73.183637)"
2019,Noviembre,España,724,0,1,,1,"(0.814836,-77.662532)"
2019,Noviembre,España,724,0,1,,1,"(1.813928,-78.763924)"
2019,Noviembre,España,724,21,21,,42,"(10.445761,-75.516429)"
2019,Noviembre,España,724,25,7,,32,"(10.886611,-74.776708)"
2019,Noviembre,España,724,3334,2409,,5743,"(3.541112,-76.384584)"
2019,Noviembre,España,724,1,0,,1,"(4.452882,-75.766298)"
2019,Noviembre,España,724,16221,13085,,29307,"(4.697144,-74.140516)"
2019,Noviembre,España,724,76,57,,133,"(4.815061,-75.736532)"
2019,Noviembre,España,724,3114,2481,,5596,"(6.171601,-75.427454)"
2019,Noviembre,España,724,3,3,,6,"(7.128456,-73.183637)"
2019,Noviembre,Colombia,170,324,833,,1157,"(4.697144,-74.140516)"
2019,Noviembre,República Del Congo,178,0,1,,1,"(10.886611,-74.776708)"
2019,Noviembre,República Del Congo,178,1,1,,2,"(4.697144,-74.140516)"
2019,Noviembre,República de Corea,410,1,0,,1,"(10.445761,-75.516429)"
2019,Noviembre,República de Corea,410,0,1,,1,"(3.541112,-76.384584)"
2019,Noviembre,República de Corea,410,33,46,,79,"(4.697144,-74.140516)"
2019,Noviembre,República de Corea,410,1,2,,3,"(6.171601,-75.427454)"
2019,Noviembre,Costa de Marfil,384,1,1,,2,"(4.697144,-74.140516)"
2019,Noviembre,Costa de Marfil,384,1,1,,2,"(6.171601,-75.427454)"
2019,Noviembre,Costa Rica,188,7,10,,17,"(10.445761,-75.516429)"
2019,Noviembre,Costa Rica,188,30,36,,66,"(10.886611,-74.776708)"
2019,Noviembre,Costa Rica,188,1,9,,10,"(12.5744111,-81.703935)"
2019,Noviembre,Costa Rica,188,10,12,,22,"(12.586067,-81.702563)"
2019,Noviembre,Costa Rica,188,42,40,,82,"(3.541112,-76.384584)"
2019,Noviembre,Costa Rica,188,1139,1387,,2526,"(4.697144,-74.140516)"
2019,Noviembre,Costa Rica,188,23,19,,42,"(4.815061,-75.736532)"
2019,Noviembre,Costa Rica,188,125,111,,236,"(6.171601,-75.427454)"
2019,Noviembre,Costa Rica,188,8,3,,11,"(7.128456,-73.183637)"
2019,Noviembre,Croacia,191,8,3,,11,"(4.697144,-74.140516)"
2019,Noviembre,Croacia,191,1,0,,1,"(6.171601,-75.427454)"
2019,Noviembre,Cuba,192,6,5,,11,"(10.445761,-75.516429)"
2019,Noviembre,Cuba,192,11,10,,21,"(10.886611,-74.776708)"
2019,Noviembre,Cuba,192,0,1,,1,"(12.586067,-81.702563)"
2019,Noviembre,Cuba,192,39,28,,67,"(3.541112,-76.384584)"
2019,Noviembre,Cuba,192,1331,1129,,2460,"(4.697144,-74.140516)"
2019,Noviembre,Cuba,192,13,9,,22,"(4.815061,-75.736532)"
2019,Noviembre,Cuba,192,100,94,,194,"(6.171601,-75.427454)"
2019,Noviembre,Cuba,192,4,8,,12,"(7.128456,-73.183637)"
2019,Noviembre,Curazao,99999,5,4,,9,"(10.445761,-75.516429)"
2019,Noviembre,Curazao,99999,1,0,,1,"(10.886611,-74.776708)"
2019,Noviembre,Curazao,99999,10,7,,17,"(3.541112,-76.384584)"
2019,Noviembre,Curazao,99999,1248,1006,,2254,"(4.697144,-74.140516)"
2019,Noviembre,Curazao,99999,6,3,,9,"(4.815061,-75.736532)"
2019,Noviembre,Curazao,99999,12,5,,17,"(6.171601,-75.427454)"
2019,Noviembre,Curazao,99999,2,7,,9,"(7.128456,-73.183637)"
2019,Noviembre,República Checa,203,0,1,,1,"(3.541112,-76.384584)"
2019,Noviembre,República Checa,203,5,5,,10,"(4.697144,-74.140516)"
2019,Noviembre,República Checa,203,1,0,,1,"(6.171601,-75.427454)"
2019,Noviembre,Chile,152,0,1,,1,"(0.25129,-76.875963)"
2019,Noviembre,Chile,152,72,63,,135,"(0.814836,-77.662532)"
2019,Noviembre,Chile,152,0,1,,1,"(1.813928,-78.763924)"
2019,Noviembre,Chile,152,17,17,,34,"(10.445761,-75.516429)"
2019,Noviembre,Chile,152,30,18,,48,"(10.886611,-74.776708)"
2019,Noviembre,Chile,152,2,1,,3,"(12.586067,-81.702563)"
2019,Noviembre,Chile,152,361,221,,582,"(3.541112,-76.384584)"
2019,Noviembre,Chile,152,4394,3957,,8352,"(4.697144,-74.140516)"
2019,Noviembre,Chile,152,60,39,,99,"(4.815061,-75.736532)"
2019,Noviembre,Chile,152,149,114,,263,"(6.171601,-75.427454)"
2019,Noviembre,Chile,152,6,3,,9,"(7.128456,-73.183637)"
2019,Noviembre,China,156,0,1,,1,"(10.445761,-75.516429)"
2019,Noviembre,China,156,0,2,,2,"(10.886611,-74.776708)"
2019,Noviembre,China,156,4,11,,15,"(3.541112,-76.384584)"
2019,Noviembre,China,156,142,318,,460,"(4.697144,-74.140516)"
2019,Noviembre,China,156,1,3,,4,"(4.815061,-75.736532)"
2019,Noviembre,China,156,13,35,,48,"(6.171601,-75.427454)"
2019,Noviembre,China,156,0,1,,1,"(7.128456,-73.183637)"
2019,Noviembre,Chipre,196,1,0,,1,"(4.697144,-74.140516)"
2019,Noviembre,Chipre,196,0,1,,1,"(6.171601,-75.427454)"
2019,Noviembre,Dinamarca,208,3,1,,4,"(3.541112,-76.384584)"
2019,Noviembre,Dinamarca,208,10,17,,27,"(4.697144,-74.140516)"
2019,Noviembre,Dinamarca,208,1,1,,2,"(6.171601,-75.427454)"
2019,Noviembre,República de Yibuti,262,1,0,,1,"(4.697144,-74.140516)"
2019,Noviembre,Dominica,212,1,1,,2,"(3.541112,-76.384584)"
2019,Noviembre,Ecuador,218,513,799,,1312,"(0.25129,-76.875963)"
2019,Noviembre,Ecuador,218,23,30,,53,"(0.812436,-77.847006)"
2019,Noviembre,Ecuador,218,4454,5411,,9865,"(0.814836,-77.662532)"
2019,Noviembre,Ecuador,218,135,130,,265,"(1.813928,-78.763924)"
2019,Noviembre,Ecuador,218,5,5,,10,"(10.445761,-75.516429)"
2019,Noviembre,Ecuador,218,10,21,,31,"(10.886611,-74.776708)"
2019,Noviembre,Ecuador,218,325,430,,755,"(3.541112,-76.384584)"
2019,Noviembre,Ecuador,218,3100,4727,,7827,"(4.697144,-74.140516)"
2019,Noviembre,Ecuador,218,2,6,,8,"(4.815061,-75.736532)"
2019,Noviembre,Ecuador,218,37,69,,106,"(6.171601,-75.427454)"
2019,Noviembre,Ecuador,218,1,4,,5,"(7.128456,-73.183637)"
2019,Noviembre,Egipto,818,0,1,,1,"(10.886611,-74.776708)"
2019,Noviembre,Egipto,818,26,25,,51,"(4.697144,-74.140516)"
2019,Noviembre,Egipto,818,1,0,,1,"(6.171601,-75.427454)"
2019,Noviembre,El Salvador,222,0,1,,1,"(0.814836,-77.662532)"
2019,Noviembre,El Salvador,222,2,0,,2,"(10.445761,-75.516429)"
2019,Noviembre,El Salvador,222,5,9,,14,"(10.886611,-74.776708)"
2019,Noviembre,El Salvador,222,4,10,,14,"(3.541112,-76.384584)"
2019,Noviembre,El Salvador,222,1128,1470,,2598,"(4.697144,-74.140516)"
2019,Noviembre,El Salvador,222,1,0,,1,"(4.815061,-75.736532)"
2019,Noviembre,El Salvador,222,8,27,,35,"(6.171601,-75.427454)"
2019,Noviembre,Emiratos Árabes,784,1,4,,5,"(10.445761,-75.516429)"
2019,Noviembre,Emiratos Árabes,784,1,0,,1,"(10.886611,-74.776708)"
2019,Noviembre,Emiratos Árabes,784,0,4,,4,"(3.541112,-76.384584)"
2019,Noviembre,Emiratos Árabes,784,112,264,,376,"(4.697144,-74.140516)"
2019,Noviembre,Emiratos Árabes,784,10,14,,24,"(6.171601,-75.427454)"
2019,Noviembre,Eritrea,232,0,1,,1,"(4.697144,-74.140516)"
2019,Noviembre,Eritrea,232,1,0,,1,"(6.171601,-75.427454)"
2019,Noviembre,Eslovaquia,703,4,1,,5,"(4.697144,-74.140516)"
2019,Noviembre,Eslovaquia,703,0,1,,1,"(6.171601,-75.427454)"
2019,Noviembre,Eslovenia,705,1,1,,2,"(4.697144,-74.140516)"
2019,Noviembre,Eslovenia,705,0,2,,2,"(6.171601,-75.427454)"
2019,Noviembre,Estados Unidos de América,840,1,1,,2,"(10.408582,-75.538003)"
2019,Noviembre,Estados Unidos de América,840,3977,3228,,7206,"(10.445761,-75.516429)"
2019,Noviembre,Estados Unidos de América,840,2792,2080,,4872,"(10.886611,-74.776708)"
2019,Noviembre,Estados Unidos de América,840,1,8,,9,"(11.117806,-74.232622)"
2019,Noviembre,Estados Unidos de América,840,36,21,,57,"(12.586067,-81.702563)"
2019,Noviembre,Estados Unidos de América,840,6496,4708,,11204,"(3.541112,-76.384584)"
2019,Noviembre,Estados Unidos de América,840,723,572,,1295,"(4.452882,-75.766298)"
2019,Noviembre,Estados Unidos de América,840,32167,27814,,59981,"(4.697144,-74.140516)"
2019,Noviembre,Estados Unidos de América,840,1181,719,,1900,"(4.815061,-75.736532)"
2019,Noviembre,Estados Unidos de América,840,10613,8321,,18936,"(6.171601,-75.427454)"
2019,Noviembre,Estados Unidos de América,840,241,171,,412,"(7.128456,-73.183637)"
2019,Noviembre,Estonia,233,0,1,,1,"(4.697144,-74.140516)"
2019,Noviembre,Estonia,233,0,2,,2,"(4.815061,-75.736532)"
2019,Noviembre,Estonia,233,1,5,,6,"(6.171601,-75.427454)"
2019,Noviembre,Etiopia,231,1,0,,1,"(3.541112,-76.384584)"
2019,Noviembre,Etiopia,231,1,2,,3,"(4.697144,-74.140516)"
2019,Noviembre,Filipinas,608,1,0,,1,"(3.541112,-76.384584)"
2019,Noviembre,Filipinas,608,5,7,,12,"(4.697144,-74.140516)"
2019,Noviembre,Filipinas,608,0,2,,2,"(6.171601,-75.427454)"
2019,Noviembre,Finlandia,246,1,0,,1,"(10.886611,-74.776708)"
2019,Noviembre,Finlandia,246,1,3,,4,"(3.541112,-76.384584)"
2019,Noviembre,Finlandia,246,3,5,,8,"(4.697144,-74.140516)"
2019,Noviembre,Finlandia,246,3,1,,4,"(6.171601,-75.427454)"
2019,Noviembre,Francia,250,8,9,,17,"(10.445761,-75.516429)"
2019,Noviembre,Francia,250,4,4,,8,"(10.886611,-74.776708)"
2019,Noviembre,Francia,250,0,1,,1,"(12.586067,-81.702563)"
2019,Noviembre,Francia,250,67,57,,124,"(3.541112,-76.384584)"
2019,Noviembre,Francia,250,1711,1441,,3152,"(4.697144,-74.140516)"
2019,Noviembre,Francia,250,23,19,,42,"(4.815061,-75.736532)"
2019,Noviembre,Francia,250,111,72,,183,"(6.171601,-75.427454)"
2019,Noviembre,Francia,250,0,1,,1,"(7.128456,-73.183637)"
2019,Noviembre,Gibraltar/Territorio Británico de Ultramar,292,0,1,,1,"(4.697144,-74.140516)"
2019,Noviembre,Granada,308,1,5,,6,"(4.697144,-74.140516)"
2019,Noviembre,Granada,308,0,1,,1,"(6.171601,-75.427454)"
2019,Noviembre,Grecia,300,15,12,,27,"(4.697144,-74.140516)"
2019,Noviembre,Grecia,300,4,2,,6,"(6.171601,-75.427454)"
2019,Noviembre,Guatemala,320,0,1,,1,"(1.813928,-78.763924)"
2019,Noviembre,Guatemala,320,5,3,,8,"(10.445761,-75.516429)"
2019,Noviembre,Guatemala,320,10,13,,23,"(10.886611,-74.776708)"
2019,Noviembre,Guatemala,320,0,2,,2,"(10.971302,-74.765397)"
2019,Noviembre,Guatemala,320,0,2,,2,"(12.586067,-81.702563)"
2019,Noviembre,Guatemala,320,35,43,,78,"(3.541112,-76.384584)"
2019,Noviembre,Guatemala,320,663,747,,1410,"(4.697144,-74.140516)"
2019,Noviembre,Guatemala,320,6,15,,21,"(4.815061,-75.736532)"
2019,Noviembre,Guatemala,320,69,86,,155,"(6.171601,-75.427454)"
2019,Noviembre,Guatemala,320,2,3,,5,"(7.128456,-73.183637)"
2019,Noviembre,Guyana,328,0,1,,1,"(10.445761,-75.516429)"
2019,Noviembre,Guyana,328,3,1,,4,"(10.886611,-74.776708)"
2019,Noviembre,Guyana,328,3,0,,3,"(3.541112,-76.384584)"
2019,Noviembre,Guyana,328,1,2,,3,"(4.697144,-74.140516)"
2019,Noviembre,Guyana,328,0,1,,1,"(4.815061,-75.736532)"
2019,Noviembre,Guyana,328,4,2,,6,"(6.171601,-75.427454)"
2019,Noviembre,Guyana,328,0,1,,1,"(7.128456,-73.183637)"
2019,Noviembre,Guinea,324,2,0,,2,"(4.697144,-74.140516)"
2019,Noviembre,Guinea Ecuatorial,226,1,0,,1,"(3.541112,-76.384584)"
2019,Noviembre,Guinea Ecuatorial,226,1,1,,2,"(4.697144,-74.140516)"
2019,Noviembre,Guadalupe/Territorio Francés,312,3,2,,5,"(4.697144,-74.140516)"
2019,Noviembre,Guadalupe/Territorio Francés,312,1,0,,1,"(6.171601,-75.427454)"
2019,Noviembre,Guayana Francesa/Departamento de Ultramar Francés,254,1,6,,7,"(4.697144,-74.140516)"
2019,Noviembre,Haití,332,1,3,,4,"(10.445761,-75.516429)"
2019,Noviembre,Haití,332,1,0,,1,"(10.886611,-74.776708)"
2019,Noviembre,Haití,332,0,1,,1,"(3.541112,-76.384584)"
2019,Noviembre,Haití,332,2,2,,4,"(4.697144,-74.140516)"
2019,Noviembre,Haití,332,1,0,,1,"(6.171601,-75.427454)"
2019,Noviembre,Honduras,340,1,4,,5,"(10.445761,-75.516429)"
2019,Noviembre,Honduras,340,3,6,,9,"(10.886611,-74.776708)"
2019,Noviembre,Honduras,340,0,2,,2,"(12.5744111,-81.703935)"
2019,Noviembre,Honduras,340,16,13,,29,"(3.541112,-76.384584)"
2019,Noviembre,Honduras,340,87,168,,255,"(4.697144,-74.140516)"
2019,Noviembre,Honduras,340,1,3,,4,"(4.815061,-75.736532)"
2019,Noviembre,Honduras,340,24,38,,62,"(6.171601,-75.427454)"
2019,Noviembre,Honduras,340,2,4,,6,"(7.128456,-73.183637)"
2019,Noviembre,Hong Kong,344,7,20,,27,"(4.697144,-74.140516)"
2019,Noviembre,Hong Kong,344,5,4,,9,"(6.171601,-75.427454)"
2019,Noviembre,Hungría,348,2,0,,2,"(10.445761,-75.516429)"
2019,Noviembre,Hungría,348,5,1,,6,"(3.541112,-76.384584)"
2019,Noviembre,Hungría,348,9,5,,14,"(4.697144,-74.140516)"
2019,Noviembre,Hungría,348,1,0,,1,"(4.815061,-75.736532)"
2019,Noviembre,Hungría,348,1,0,,1,"(6.171601,-75.427454)"
2019,Noviembre,India,356,1,2,,3,"(10.886611,-74.776708)"
2019,Noviembre,India,356,2,0,,2,"(3.541112,-76.384584)"
2019,Noviembre,India,356,36,38,,74,"(4.697144,-74.140516)"
2019,Noviembre,India,356,1,0,,1,"(4.815061,-75.736532)"
2019,Noviembre,India,356,14,11,,25,"(6.171601,-75.427454)"
2019,Noviembre,India,356,1,1,,2,"(7.128456,-73.183637)"
2019,Noviembre,Indonesia,360,10,8,,18,"(4.697144,-74.140516)"
2019,Noviembre,Indonesia,360,2,0,,2,"(6.171601,-75.427454)"
2019,Noviembre,Iraq,368,1,3,,4,"(4.697144,-74.140516)"
2019,Noviembre,Irán,364,1,1,,2,"(4.697144,-74.140516)"
2019,Noviembre,República de Irlanda,372,1,0,,1,"(3.541112,-76.384584)"
2019,Noviembre,República de Irlanda,372,10,10,,20,"(4.697144,-74.140516)"
2019,Noviembre,República de Irlanda,372,5,2,,7,"(6.171601,-75.427454)"
2019,Noviembre,Islandia,352,2,1,,3,"(4.697144,-74.140516)"
2019,Noviembre,Isla de Man,833,0,1,,1,"(4.697144,-74.140516)"
2019,Noviembre,Israel,376,5,2,,7,"(3.541112,-76.384584)"
2019,Noviembre,Israel,376,197,140,,337,"(4.697144,-74.140516)"
2019,Noviembre,Israel,376,0,1,,1,"(4.815061,-75.736532)"
2019,Noviembre,Israel,376,52,25,,77,"(6.171601,-75.427454)"
2019,Noviembre,Italia,380,7,5,,12,"(10.445761,-75.516429)"
2019,Noviembre,Italia,380,3,1,,4,"(10.886611,-74.776708)"
2019,Noviembre,Italia,380,1,1,,2,"(12.586067,-81.702563)"
2019,Noviembre,Italia,380,75,47,,122,"(3.541112,-76.384584)"
2019,Noviembre,Italia,380,504,385,,889,"(4.697144,-74.140516)"
2019,Noviembre,Italia,380,0,2,,2,"(4.815061,-75.736532)"
2019,Noviembre,Italia,380,108,77,,185,"(6.171601,-75.427454)"
2019,Noviembre,Islas Feroe/Región Autónoma de Dinamarca,234,1,0,,1,"(4.697144,-74.140516)"
2019,Noviembre,Jamaica,388,4,8,,12,"(10.445761,-75.516429)"
2019,Noviembre,Jamaica,388,2,4,,6,"(10.886611,-74.776708)"
2019,Noviembre,Jamaica,388,0,1,,1,"(11.247723,-74.213989)"
2019,Noviembre,Jamaica,388,0,2,,2,"(12.586067,-81.702563)"
2019,Noviembre,Jamaica,388,8,5,,13,"(3.541112,-76.384584)"
2019,Noviembre,Jamaica,388,23,42,,65,"(4.697144,-74.140516)"
2019,Noviembre,Jamaica,388,4,4,,8,"(4.815061,-75.736532)"
2019,Noviembre,Jamaica,388,36,17,,53,"(6.171601,-75.427454)"
2019,Noviembre,Japón,392,0,1,,1,"(10.886611,-74.776708)"
2019,Noviembre,Japón,392,1,0,,1,"(3.541112,-76.384584)"
2019,Noviembre,Japón,392,101,120,,221,"(4.697144,-74.140516)"
2019,Noviembre,Japón,392,2,0,,2,"(4.815061,-75.736532)"
2019,Noviembre,Japón,392,12,12,,24,"(6.171601,-75.427454)"
2019,Noviembre,Jordania,400,0,1,,1,"(4.697144,-74.140516)"
2019,Noviembre,Kazajistán,398,0,1,,1,"(3.541112,-76.384584)"
2019,Noviembre,Kenia,404,0,1,,1,"(10.445761,-75.516429)"
2019,Noviembre,Kenia,404,5,5,,10,"(4.697144,-74.140516)"
2019,Noviembre,Kenia,404,0,1,,1,"(6.171601,-75.427454)"
2019,Noviembre,Kenia,404,1,1,,2,"(7.128456,-73.183637)"
2019,Noviembre,Kuwait,414,4,4,,8,"(4.697144,-74.140516)"
2019,Noviembre,República Democrática Popular  Lao,418,0,2,,2,"(4.697144,-74.140516)"
2019,Noviembre,Líbano,422,2,1,,3,"(10.886611,-74.776708)"
2019,Noviembre,Líbano,422,1,0,,1,"(3.541112,-76.384584)"
2019,Noviembre,Líbano,422,3,4,,7,"(4.697144,-74.140516)"
2019,Noviembre,Luxemburgo,442,5,2,,7,"(4.697144,-74.140516)"
2019,Noviembre,Macao,446,0,1,,1,"(4.697144,-74.140516)"
2019,Noviembre,Macedonia,807,0,1,,1,"(4.697144,-74.140516)"
2019,Noviembre,Malasia,458,16,32,,48,"(4.697144,-74.140516)"
2019,Noviembre,Maldivas,462,1,2,,3,"(6.171601,-75.427454)"
2019,Noviembre,Malta,470,22,15,,37,"(4.697144,-74.140516)"
2019,Noviembre,Malta,470,4,3,,7,"(6.171601,-75.427454)"
2019,Noviembre,Marruecos,504,6,7,,13,"(4.697144,-74.140516)"
2019,Noviembre,Marruecos,504,4,0,,4,"(6.171601,-75.427454)"
2019,Noviembre,Islas Marshall,584,0,1,,1,"(4.697144,-74.140516)"
2019,Noviembre,Martinica/Departamento de Ultramar Francés,474,0,1,,1,"(4.697144,-74.140516)"
2019,Noviembre,México,484,0,2,,2,"(10.408582,-75.538003)"
2019,Noviembre,México,484,145,125,,270,"(10.445761,-75.516429)"
2019,Noviembre,México,484,98,85,,183,"(10.886611,-74.776708)"
2019,Noviembre,México,484,0,1,,1,"(12.586067,-81.702563)"
2019,Noviembre,México,484,347,305,,652,"(3.541112,-76.384584)"
2019,Noviembre,México,484,19152,16485,,35638,"(4.697144,-74.140516)"
2019,Noviembre,México,484,143,129,,272,"(4.815061,-75.736532)"
2019,Noviembre,México,484,5000,3932,,8934,"(6.171601,-75.427454)"
2019,Noviembre,México,484,71,54,,125,"(7.128456,-73.183637)"
2019,Noviembre,República de Moldavia,498,1,0,,1,"(4.697144,-74.140516)"
2019,Noviembre,Mozambique,508,0,1,,1,"(4.697144,-74.140516)"
2019,Noviembre,Myanmar,104,1,1,,2,"(4.697144,-74.140516)"
2019,Noviembre,Nepal,524,1,1,,2,"(4.697144,-74.140516)"
2019,Noviembre,Nicaragua,558,1,2,,3,"(10.886611,-74.776708)"
2019,Noviembre,Nicaragua,558,1,2,,3,"(12.5744111,-81.703935)"
2019,Noviembre,Nicaragua,558,2,1,,3,"(12.586067,-81.702563)"
2019,Noviembre,Nicaragua,558,8,19,,27,"(3.541112,-76.384584)"
2019,Noviembre,Nicaragua,558,38,54,,92,"(4.697144,-74.140516)"
2019,Noviembre,Nicaragua,558,6,5,,11,"(4.815061,-75.736532)"
2019,Noviembre,Nicaragua,558,18,39,,57,"(6.171601,-75.427454)"
2019,Noviembre,Nicaragua,558,0,2,,2,"(7.128456,-73.183637)"
2019,Noviembre,Nigeria,566,1,4,,5,"(4.697144,-74.140516)"
2019,Noviembre,Noruega,578,0,1,,1,"(10.445761,-75.516429)"
2019,Noviembre,Noruega,578,2,0,,2,"(10.886611,-74.776708)"
2019,Noviembre,Noruega,578,5,1,,6,"(3.541112,-76.384584)"
2019,Noviembre,Noruega,578,37,18,,55,"(4.697144,-74.140516)"
2019,Noviembre,Noruega,578,1,0,,1,"(4.815061,-75.736532)"
2019,Noviembre,Noruega,578,3,1,,4,"(6.171601,-75.427454)"
2019,Noviembre,Nueva Caledonia/Territorio francés,540,0,1,,1,"(4.697144,-74.140516)"
2019,Noviembre,Nueva Zelanda,554,58,25,,83,"(4.697144,-74.140516)"
2019,Noviembre,Nueva Zelanda,554,4,2,,6,"(6.171601,-75.427454)"
2019,Noviembre,Omán,512,1,3,,4,"(4.697144,-74.140516)"
2019,Noviembre,Panamá,591,277,257,,534,"(10.408582,-75.538003)"
2019,Noviembre,Panamá,591,1353,1079,,2432,"(10.445761,-75.516429)"
2019,Noviembre,Panamá,591,786,625,,1411,"(10.886611,-74.776708)"
2019,Noviembre,Panamá,591,1,1,,2,"(10.971302,-74.765397)"
2019,Noviembre,Panamá,591,5,31,,36,"(12.5744111,-81.703935)"
2019,Noviembre,Panamá,591,72,91,,163,"(12.586067,-81.702563)"
2019,Noviembre,Panamá,591,0,8,,8,"(13.3387613,-81.372937)"
2019,Noviembre,Panamá,591,2438,1922,,4360,"(3.541112,-76.384584)"
2019,Noviembre,Panamá,591,7860,8179,,16040,"(4.697144,-74.140516)"
2019,Noviembre,Panamá,591,371,264,,635,"(4.815061,-75.736532)"
2019,Noviembre,Panamá,591,0,6,,6,"(6.17134,-75.427194)"
2019,Noviembre,Panamá,591,2476,2250,,4726,"(6.171601,-75.427454)"
2019,Noviembre,Panamá,591,0,3,,3,"(6.228046,-77.404104)"
2019,Noviembre,Panamá,591,7,25,,32,"(7.102626,-77.762647)"
2019,Noviembre,Panamá,591,219,167,,386,"(7.128456,-73.183637)"
2019,Noviembre,Panamá,591,20,61,,81,"(8.635765,-77.346578)"
2019,Noviembre,Paraguay,600,2,1,,3,"(10.445761,-75.516429)"
2019,Noviembre,Paraguay,600,3,7,,10,"(10.886611,-74.776708)"
2019,Noviembre,Paraguay,600,33,29,,62,"(3.541112,-76.384584)"
2019,Noviembre,Paraguay,600,148,199,,347,"(4.697144,-74.140516)"
2019,Noviembre,Paraguay,600,3,5,,8,"(4.815061,-75.736532)"
2019,Noviembre,Paraguay,600,28,40,,68,"(6.171601,-75.427454)"
2019,Noviembre,Paraguay,600,2,3,,5,"(7.128456,-73.183637)"
2019,Noviembre,Perú,604,11,15,,26,"(-0.193180,-74.784874)"
2019,Noviembre,Perú,604,2,8,,10,"(-4.197703,-69.941278)"
2019,Noviembre,Perú,604,162,240,,402,"(-4.223468,-69.945098)"
2019,Noviembre,Perú,604,0,1,,1,"(0.25129,-76.875963)"
2019,Noviembre,Perú,604,104,120,,224,"(0.814836,-77.662532)"
2019,Noviembre,Perú,604,2,6,,8,"(1.813928,-78.763924)"
2019,Noviembre,Perú,604,119,107,,226,"(10.445761,-75.516429)"
2019,Noviembre,Perú,604,17,29,,46,"(10.886611,-74.776708)"
2019,Noviembre,Perú,604,1,1,,2,"(12.586067,-81.702563)"
2019,Noviembre,Perú,604,481,483,,964,"(3.541112,-76.384584)"
2019,Noviembre,Perú,604,6364,6674,,13038,"(4.697144,-74.140516)"
2019,Noviembre,Perú,604,11,10,,21,"(4.815061,-75.736532)"
2019,Noviembre,Perú,604,974,986,,1960,"(6.171601,-75.427454)"
2019,Noviembre,Perú,604,6,16,,22,"(7.128456,-73.183637)"
2019,Noviembre,Polonia,616,0,1,,1,"(10.886611,-74.776708)"
2019,Noviembre,Polonia,616,0,1,,1,"(3.541112,-76.384584)"
2019,Noviembre,Polonia,616,9,16,,25,"(4.697144,-74.140516)"
2019,Noviembre,Polonia,616,0,2,,2,"(6.171601,-75.427454)"
2019,Noviembre,Portugal,620,0,4,,4,"(10.445761,-75.516429)"
2019,Noviembre,Portugal,620,9,1,,10,"(3.541112,-76.384584)"
2019,Noviembre,Portugal,620,84,58,,142,"(4.697144,-74.140516)"
2019,Noviembre,Portugal,620,16,14,,30,"(6.171601,-75.427454)"
2019,Noviembre,Puerto Rico/Territorio de Estados Unidos,630,3,2,,5,"(10.445761,-75.516429)"
2019,Noviembre,Puerto Rico/Territorio de Estados Unidos,630,8,9,,17,"(10.886611,-74.776708)"
2019,Noviembre,Puerto Rico/Territorio de Estados Unidos,630,23,25,,48,"(3.541112,-76.384584)"
2019,Noviembre,Puerto Rico/Territorio de Estados Unidos,630,537,548,,1085,"(4.697144,-74.140516)"
2019,Noviembre,Puerto Rico/Territorio de Estados Unidos,630,6,4,,10,"(4.815061,-75.736532)"
2019,Noviembre,Puerto Rico/Territorio de Estados Unidos,630,49,31,,80,"(6.171601,-75.427454)"
2019,Noviembre,Puerto Rico/Territorio de Estados Unidos,630,3,0,,3,"(7.128456,-73.183637)"
2019,Noviembre,Qatar,634,4,9,,13,"(4.697144,-74.140516)"
2019,Noviembre,Qatar,634,3,3,,6,"(6.171601,-75.427454)"
2019,Noviembre,Reino Unido de Gran Bretaña e Irlanda del Norte,826,1,2,,3,"(10.886611,-74.776708)"
2019,Noviembre,Reino Unido de Gran Bretaña e Irlanda del Norte,826,16,4,,20,"(3.541112,-76.384584)"
2019,Noviembre,Reino Unido de Gran Bretaña e Irlanda del Norte,826,1290,1052,,2342,"(4.697144,-74.140516)"
2019,Noviembre,Reino Unido de Gran Bretaña e Irlanda del Norte,826,1,0,,1,"(4.815061,-75.736532)"
2019,Noviembre,Reino Unido de Gran Bretaña e Irlanda del Norte,826,14,15,,29,"(6.171601,-75.427454)"
2019,Noviembre,República CentroÁfricana,140,0,1,,1,"(4.697144,-74.140516)"
2019,Noviembre,Federación de Rusia,643,0,2,,2,"(10.886611,-74.776708)"
2019,Noviembre,Federación de Rusia,643,20,30,,50,"(4.697144,-74.140516)"
2019,Noviembre,Federación de Rusia,643,1,2,,3,"(6.171601,-75.427454)"
2019,Noviembre,República Dominicana,214,21,15,,36,"(10.445761,-75.516429)"
2019,Noviembre,República Dominicana,214,40,34,,74,"(10.886611,-74.776708)"
2019,Noviembre,República Dominicana,214,6,5,,11,"(11.117806,-74.232622)"
2019,Noviembre,República Dominicana,214,1,0,,1,"(11.247723,-74.213989)"
2019,Noviembre,República Dominicana,214,1,0,,1,"(12.586067,-81.702563)"
2019,Noviembre,República Dominicana,214,116,79,,195,"(3.541112,-76.384584)"
2019,Noviembre,República Dominicana,214,4253,3786,,8040,"(4.697144,-74.140516)"
2019,Noviembre,República Dominicana,214,77,49,,126,"(4.815061,-75.736532)"
2019,Noviembre,República Dominicana,214,291,249,,540,"(6.171601,-75.427454)"
2019,Noviembre,República Dominicana,214,64,48,,112,"(7.128456,-73.183637)"
2019,Noviembre,Reunión,638,1,0,,1,"(4.697144,-74.140516)"
2019,Noviembre,República Democrática Popular de Corea,408,1,0,,1,"(4.697144,-74.140516)"
2019,Noviembre,República Democrática Popular de Corea,408,1,0,,1,"(6.171601,-75.427454)"
2019,Noviembre,Rumania,642,3,6,,9,"(4.697144,-74.140516)"
2019,Noviembre,San Cristóbal y Nevis,659,0,1,,1,"(4.697144,-74.140516)"
2019,Noviembre,San  Vicente y las Granadinas,670,1,0,,1,"(10.445761,-75.516429)"
2019,Noviembre,San  Vicente y las Granadinas,670,0,1,,1,"(4.697144,-74.140516)"
2019,Noviembre,Santa Lucia,662,0,2,,2,"(4.697144,-74.140516)"
2019,Noviembre,Serbia,688,1,4,,5,"(4.697144,-74.140516)"
2019,Noviembre,Singapur,702,10,22,,32,"(4.697144,-74.140516)"
2019,Noviembre,Singapur,702,7,3,,10,"(6.171601,-75.427454)"
2019,Noviembre,Sudáfrica,710,3,1,,4,"(3.541112,-76.384584)"
2019,Noviembre,Sudáfrica,710,23,22,,45,"(4.697144,-74.140516)"
2019,Noviembre,Sudáfrica,710,0,1,,1,"(6.171601,-75.427454)"
2019,Noviembre,Suecia,752,1,1,,2,"(10.445761,-75.516429)"
2019,Noviembre,Suecia,752,9,10,,19,"(3.541112,-76.384584)"
2019,Noviembre,Suecia,752,53,35,,88,"(4.697144,-74.140516)"
2019,Noviembre,Suecia,752,1,1,,2,"(4.815061,-75.736532)"
2019,Noviembre,Suecia,752,12,5,,17,"(6.171601,-75.427454)"
2019,Noviembre,Suiza,756,3,2,,5,"(10.445761,-75.516429)"
2019,Noviembre,Suiza,756,4,1,,5,"(10.886611,-74.776708)"
2019,Noviembre,Suiza,756,38,21,,59,"(3.541112,-76.384584)"
2019,Noviembre,Suiza,756,193,133,,326,"(4.697144,-74.140516)"
2019,Noviembre,Suiza,756,3,2,,5,"(4.815061,-75.736532)"
2019,Noviembre,Suiza,756,32,18,,50,"(6.171601,-75.427454)"
2019,Noviembre,Surinam,740,1,0,,1,"(10.445761,-75.516429)"
2019,Noviembre,Surinam,740,0,2,,2,"(10.886611,-74.776708)"
2019,Noviembre,Surinam,740,1,142,,143,"(3.541112,-76.384584)"
2019,Noviembre,Surinam,740,7,7,,14,"(4.697144,-74.140516)"
2019,Noviembre,Surinam,740,0,1,,1,"(4.815061,-75.736532)"
2019,Noviembre,Surinam,740,3,5,,8,"(6.171601,-75.427454)"
2019,Noviembre,Surinam,740,1,4,,5,"(7.128456,-73.183637)"
2019,Noviembre,Taiwán,158,4,5,,9,"(4.697144,-74.140516)"
2019,Noviembre,Taiwán,158,1,0,,1,"(6.171601,-75.427454)"
2019,Noviembre,Tailandia,764,31,21,,52,"(4.697144,-74.140516)"
2019,Noviembre,Tailandia,764,5,3,,8,"(6.171601,-75.427454)"
2019,Noviembre,Tanzania,834,1,2,,3,"(4.697144,-74.140516)"
2019,Noviembre,Trinidad y Tobago,780,2,7,,9,"(10.445761,-75.516429)"
2019,Noviembre,Trinidad y Tobago,780,1,4,,5,"(10.886611,-74.776708)"
2019,Noviembre,Trinidad y Tobago,780,3,8,,11,"(3.541112,-76.384584)"
2019,Noviembre,Trinidad y Tobago,780,16,20,,36,"(4.697144,-74.140516)"
2019,Noviembre,Trinidad y Tobago,780,2,6,,8,"(4.815061,-75.736532)"
2019,Noviembre,Trinidad y Tobago,780,6,13,,19,"(6.171601,-75.427454)"
2019,Noviembre,Trinidad y Tobago,780,2,6,,8,"(7.128456,-73.183637)"
2019,Noviembre,Túnez,788,1,2,,3,"(4.697144,-74.140516)"
2019,Noviembre,Turquía,792,3,1,,4,"(3.541112,-76.384584)"
2019,Noviembre,Turquía,792,1241,726,,1967,"(4.697144,-74.140516)"
2019,Noviembre,Turquía,792,6,5,,11,"(6.171601,-75.427454)"
2019,Noviembre,Turquía,792,0,1,,1,"(7.128456,-73.183637)"
2019,Noviembre,Turkmenistán,795,2,0,,2,"(4.697144,-74.140516)"
2019,Noviembre,Ucrania,804,0,1,,1,"(6.171601,-75.427454)"
2019,Noviembre,Uganda,800,5,2,,7,"(4.697144,-74.140516)"
2019,Noviembre,Uruguay,858,0,1,,1,"(0.814836,-77.662532)"
2019,Noviembre,Uruguay,858,1,5,,6,"(10.445761,-75.516429)"
2019,Noviembre,Uruguay,858,3,1,,4,"(10.886611,-74.776708)"
2019,Noviembre,Uruguay,858,36,42,,78,"(3.541112,-76.384584)"
2019,Noviembre,Uruguay,858,88,161,,249,"(4.697144,-74.140516)"
2019,Noviembre,Uruguay,858,3,7,,10,"(4.815061,-75.736532)"
2019,Noviembre,Uruguay,858,58,62,,120,"(6.171601,-75.427454)"
2019,Noviembre,Uruguay,858,3,3,,6,"(7.128456,-73.183637)"
2019,Noviembre,Venezuela,862,9,3,,12,"(10.445761,-75.516429)"
2019,Noviembre,Venezuela,862,11,29,,40,"(10.886611,-74.776708)"
2019,Noviembre,Venezuela,862,0,6,,6,"(11.117806,-74.232622)"
2019,Noviembre,Venezuela,862,998,1185,,2183,"(11.360009,-72.129330)"
2019,Noviembre,Venezuela,862,0,2,,2,"(12.586067,-81.702563)"
2019,Noviembre,Venezuela,862,231,168,,399,"(3.541112,-76.384584)"
2019,Noviembre,Venezuela,862,3,3,,6,"(3.866713,-67.927521)"
2019,Noviembre,Venezuela,862,651,791,,1442,"(4.697144,-74.140516)"
2019,Noviembre,Venezuela,862,2,3,,5,"(4.815061,-75.736532)"
2019,Noviembre,Venezuela,862,134,150,,284,"(6.171601,-75.427454)"
2019,Noviembre,Venezuela,862,18,22,,40,"(6.185799,-67.483929)"
2019,Noviembre,Venezuela,862,240,256,,496,"(7.088729,-70.740253)"
2019,Noviembre,Venezuela,862,5,1,,6,"(7.128456,-73.183637)"
2019,Noviembre,Venezuela,862,739,701,,1440,"(7.818934,-72.453226)"
2019,Noviembre,Venezuela,862,0,1,,1,"(7.927209,-72.507910)"
2019,Noviembre,Venezuela,862,72,94,,166,"(8.36068,-72.409396)"
2019,Noviembre,Vietnam,704,0,1,,1,"(10.886611,-74.776708)"
2019,Noviembre,Vietnam,704,3,9,,12,"(4.697144,-74.140516)"
2019,Noviembre,Islas Vírgenes Estadounidenses/Territorio de Estados Unidos,850,1,0,,1,"(4.697144,-74.140516)"
2019,Noviembre,Islas Vírgenes Estadounidenses/Territorio de Estados Unidos,850,0,1,,1,"(6.171601,-75.427454)"
2019,Diciembre,Afganistán,4,2,4,,6,"(4.697144,-74.140516)"
2019,Diciembre,Albania,8,0,2,,2,"(10.971302,-74.765397)"
2019,Diciembre,Albania,8,0,2,,2,"(4.697144,-74.140516)"
2019,Diciembre,Alemania,276,0,1,,1,"(0.25129,-76.875963)"
2019,Diciembre,Alemania,276,16,6,,22,"(10.445761,-75.516429)"
2019,Diciembre,Alemania,276,15,6,,21,"(10.886611,-74.776708)"
2019,Diciembre,Alemania,276,69,48,,117,"(3.541112,-76.384584)"
2019,Diciembre,Alemania,276,2551,1967,,4518,"(4.697144,-74.140516)"
2019,Diciembre,Alemania,276,1,0,,1,"(4.815061,-75.736532)"
2019,Diciembre,Alemania,276,114,81,,195,"(6.171601,-75.427454)"
2019,Diciembre,Alemania,276,1,1,,2,"(7.128456,-73.183637)"
2019,Diciembre,Andorra,20,1,1,,2,"(4.697144,-74.140516)"
2019,Diciembre,Angola,24,0,1,,1,"(3.541112,-76.384584)"
2019,Diciembre,Angola,24,1,2,,3,"(4.697144,-74.140516)"
2019,Diciembre,Antigua y Barbuda,28,0,7,,7,"(4.697144,-74.140516)"
2019,Diciembre,Países Bajos,528,258,176,,434,"(10.445761,-75.516429)"
2019,Diciembre,Países Bajos,528,49,30,,79,"(10.886611,-74.776708)"
2019,Diciembre,Países Bajos,528,83,43,,126,"(3.541112,-76.384584)"
2019,Diciembre,Países Bajos,528,1486,1155,,2641,"(4.697144,-74.140516)"
2019,Diciembre,Países Bajos,528,13,8,,21,"(4.815061,-75.736532)"
2019,Diciembre,Países Bajos,528,108,66,,174,"(6.171601,-75.427454)"
2019,Diciembre,Países Bajos,528,2,2,,4,"(7.128456,-73.183637)"
2019,Diciembre,Países Bajos,528,2,3,,5,"(7.927209,-72.507910)"
2019,Diciembre,Arabia Saudita,682,0,1,,1,"(10.886611,-74.776708)"
2019,Diciembre,Arabia Saudita,682,1,0,,1,"(12.586067,-81.702563)"
2019,Diciembre,Arabia Saudita,682,1,2,,3,"(3.541112,-76.384584)"
2019,Diciembre,Arabia Saudita,682,1,18,,19,"(4.697144,-74.140516)"
2019,Diciembre,Arabia Saudita,682,0,1,,1,"(4.815061,-75.736532)"
2019,Diciembre,Arabia Saudita,682,0,1,,1,"(6.171601,-75.427454)"
2019,Diciembre,Argelia,12,1,0,,1,"(3.541112,-76.384584)"
2019,Diciembre,Argelia,12,0,8,,8,"(4.697144,-74.140516)"
2019,Diciembre,Argentina,32,8,19,,27,"(0.814836,-77.662532)"
2019,Diciembre,Argentina,32,24,29,,53,"(10.445761,-75.516429)"
2019,Diciembre,Argentina,32,43,15,,58,"(10.886611,-74.776708)"
2019,Diciembre,Argentina,32,3,5,,8,"(12.586067,-81.702563)"
2019,Diciembre,Argentina,32,134,79,,213,"(3.541112,-76.384584)"
2019,Diciembre,Argentina,32,4376,3617,,7993,"(4.697144,-74.140516)"
2019,Diciembre,Argentina,32,19,10,,29,"(4.815061,-75.736532)"
2019,Diciembre,Argentina,32,167,109,,276,"(6.171601,-75.427454)"
2019,Diciembre,Argentina,32,4,3,,7,"(7.128456,-73.183637)"
2019,Diciembre,Aruba,533,2836,1985,,4821,"(10.408582,-75.538003)"
2019,Diciembre,Aruba,533,10,10,,20,"(10.445761,-75.516429)"
2019,Diciembre,Aruba,533,106,65,,171,"(10.886611,-74.776708)"
2019,Diciembre,Aruba,533,1,4,,5,"(11.117806,-74.232622)"
2019,Diciembre,Aruba,533,1,0,,1,"(11.247723,-74.213989)"
2019,Diciembre,Aruba,533,47,24,,71,"(11.528919,-72.919681)"
2019,Diciembre,Aruba,533,31,18,,49,"(3.541112,-76.384584)"
2019,Diciembre,Aruba,533,2112,1670,,3782,"(4.697144,-74.140516)"
2019,Diciembre,Aruba,533,15,13,,28,"(4.815061,-75.736532)"
2019,Diciembre,Aruba,533,122,85,,207,"(6.171601,-75.427454)"
2019,Diciembre,Aruba,533,22,52,,74,"(7.128456,-73.183637)"
2019,Diciembre,Aruba,533,3,1,,4,"(7.927209,-72.507910)"
2019,Diciembre,Australia,36,0,1,,1,"(10.445761,-75.516429)"
2019,Diciembre,Australia,36,25,10,,35,"(3.541112,-76.384584)"
2019,Diciembre,Australia,36,604,401,,1005,"(4.697144,-74.140516)"
2019,Diciembre,Australia,36,65,37,,102,"(6.171601,-75.427454)"
2019,Diciembre,Austria,40,2,1,,3,"(10.445761,-75.516429)"
2019,Diciembre,Austria,40,1,0,,1,"(10.886611,-74.776708)"
2019,Diciembre,Austria,40,7,3,,10,"(3.541112,-76.384584)"
2019,Diciembre,Austria,40,55,39,,94,"(4.697144,-74.140516)"
2019,Diciembre,Austria,40,4,5,,9,"(6.171601,-75.427454)"
2019,Diciembre,Azerbaiyán,31,1,2,,3,"(4.697144,-74.140516)"
2019,Diciembre,Bahamas,44,1,0,,1,"(10.445761,-75.516429)"
2019,Diciembre,Bahamas,44,3,2,,5,"(10.886611,-74.776708)"
2019,Diciembre,Bahamas,44,21,10,,31,"(3.541112,-76.384584)"
2019,Diciembre,Bahamas,44,12,11,,23,"(4.697144,-74.140516)"
2019,Diciembre,Bahamas,44,5,4,,9,"(4.815061,-75.736532)"
2019,Diciembre,Bahamas,44,40,24,,64,"(6.171601,-75.427454)"
2019,Diciembre,Bahamas,44,3,2,,5,"(7.128456,-73.183637)"
2019,Diciembre,Bahréin,48,1,0,,1,"(10.445761,-75.516429)"
2019,Diciembre,Bahréin,48,1,0,,1,"(4.697144,-74.140516)"
2019,Diciembre,Bahréin,48,0,1,,1,"(6.171601,-75.427454)"
2019,Diciembre,Bangladesh,50,0,1,,1,"(4.815061,-75.736532)"
2019,Diciembre,Barbados,52,5,1,,6,"(3.541112,-76.384584)"
2019,Diciembre,Barbados,52,3,4,,7,"(4.697144,-74.140516)"
2019,Diciembre,Barbados,52,7,3,,10,"(6.171601,-75.427454)"
2019,Diciembre,República de Belarús,112,2,0,,2,"(4.697144,-74.140516)"
2019,Diciembre,Bélgica,56,4,0,,4,"(10.445761,-75.516429)"
2019,Diciembre,Bélgica,56,3,1,,4,"(10.886611,-74.776708)"
2019,Diciembre,Bélgica,56,2,0,,2,"(12.586067,-81.702563)"
2019,Diciembre,Bélgica,56,17,16,,33,"(3.541112,-76.384584)"
2019,Diciembre,Bélgica,56,93,75,,168,"(4.697144,-74.140516)"
2019,Diciembre,Bélgica,56,1,2,,3,"(4.815061,-75.736532)"
2019,Diciembre,Bélgica,56,46,26,,72,"(6.171601,-75.427454)"
2019,Diciembre,Belice,84,1,1,,2,"(3.541112,-76.384584)"
2019,Diciembre,Belice,84,12,14,,26,"(4.697144,-74.140516)"
2019,Diciembre,Belice,84,2,0,,2,"(4.815061,-75.736532)"
2019,Diciembre,Benín,204,2,1,,3,"(4.697144,-74.140516)"
2019,Diciembre,Bermudas/Territorio Británico de Ultramar,60,0,1,,1,"(4.697144,-74.140516)"
2019,Diciembre,Bermudas/Territorio Británico de Ultramar,60,1,1,,2,"(6.171601,-75.427454)"
2019,Diciembre,Bolivia,68,11,10,,21,"(0.814836,-77.662532)"
2019,Diciembre,Bolivia,68,1,1,,2,"(10.445761,-75.516429)"
2019,Diciembre,Bolivia,68,0,1,,1,"(10.886611,-74.776708)"
2019,Diciembre,Bolivia,68,1,2,,3,"(3.541112,-76.384584)"
2019,Diciembre,Bolivia,68,397,479,,876,"(4.697144,-74.140516)"
2019,Diciembre,Bolivia,68,1,4,,5,"(4.815061,-75.736532)"
2019,Diciembre,Bolivia,68,8,8,,16,"(6.171601,-75.427454)"
2019,Diciembre,Bolivia,68,1,0,,1,"(7.128456,-73.183637)"
2019,Diciembre,Brasil,76,172,186,,358,"(-4.197703,-69.941278)"
2019,Diciembre,Brasil,76,48,58,,106,"(-4.223468,-69.945098)"
2019,Diciembre,Brasil,76,0,1,,1,"(0.814836,-77.662532)"
2019,Diciembre,Brasil,76,12,13,,25,"(10.445761,-75.516429)"
2019,Diciembre,Brasil,76,21,19,,40,"(10.886611,-74.776708)"
2019,Diciembre,Brasil,76,1,1,,2,"(12.586067,-81.702563)"
2019,Diciembre,Brasil,76,83,80,,163,"(3.541112,-76.384584)"
2019,Diciembre,Brasil,76,4256,4228,,8484,"(4.697144,-74.140516)"
2019,Diciembre,Brasil,76,32,37,,69,"(4.815061,-75.736532)"
2019,Diciembre,Brasil,76,119,112,,231,"(6.171601,-75.427454)"
2019,Diciembre,Brasil,76,1,0,,1,"(7.128456,-73.183637)"
2019,Diciembre,Bulgaria,100,1,0,,1,"(3.541112,-76.384584)"
2019,Diciembre,Bulgaria,100,3,3,,6,"(4.697144,-74.140516)"
2019,Diciembre,Cabo Verde,132,0,1,,1,"(10.445761,-75.516429)"
2019,Diciembre,Cabo Verde,132,2,0,,2,"(4.697144,-74.140516)"
2019,Diciembre,Islas Caimán/Territorio Británico de Ultramar,136,1,0,,1,"(10.445761,-75.516429)"
2019,Diciembre,Islas Caimán/Territorio Británico de Ultramar,136,55,22,,77,"(12.586067,-81.702563)"
2019,Diciembre,Islas Caimán/Territorio Británico de Ultramar,136,5,4,,9,"(4.697144,-74.140516)"
2019,Diciembre,Islas Caimán/Territorio Británico de Ultramar,136,1,1,,2,"(6.171601,-75.427454)"
2019,Diciembre,Canadá,124,186,126,,312,"(10.445761,-75.516429)"
2019,Diciembre,Canadá,124,42,29,,71,"(10.886611,-74.776708)"
2019,Diciembre,Canadá,124,3,0,,3,"(12.586067,-81.702563)"
2019,Diciembre,Canadá,124,153,88,,241,"(3.541112,-76.384584)"
2019,Diciembre,Canadá,124,2707,2179,,4886,"(4.697144,-74.140516)"
2019,Diciembre,Canadá,124,22,15,,37,"(4.815061,-75.736532)"
2019,Diciembre,Canadá,124,316,210,,526,"(6.171601,-75.427454)"
2019,Diciembre,Canadá,124,18,14,,32,"(7.128456,-73.183637)"
2019,Diciembre,España,724,3,2,,5,"(0.814836,-77.662532)"
2019,Diciembre,España,724,27,24,,51,"(10.445761,-75.516429)"
2019,Diciembre,España,724,34,23,,57,"(10.886611,-74.776708)"
2019,Diciembre,España,724,3666,2616,,6282,"(3.541112,-76.384584)"
2019,Diciembre,España,724,19379,14608,,33988,"(4.697144,-74.140516)"
2019,Diciembre,España,724,54,46,,100,"(4.815061,-75.736532)"
2019,Diciembre,España,724,3595,2655,,6250,"(6.171601,-75.427454)"
2019,Diciembre,España,724,2,3,,5,"(7.128456,-73.183637)"
2019,Diciembre,Colombia,170,4,2,,6,"(10.445761,-75.516429)"
2019,Diciembre,Colombia,170,254,514,,768,"(4.697144,-74.140516)"
2019,Diciembre,República Del Congo,178,0,1,,1,"(4.697144,-74.140516)"
2019,Diciembre,República Democrática del Congo,180,1,0,,1,"(4.697144,-74.140516)"
2019,Diciembre,República de Corea,410,21,11,,32,"(4.697144,-74.140516)"
2019,Diciembre,República de Corea,410,5,3,,8,"(6.171601,-75.427454)"
2019,Diciembre,Islas Malvinas,238,0,1,,1,"(4.697144,-74.140516)"
2019,Diciembre,Costa de Marfil,384,1,1,,2,"(4.697144,-74.140516)"
2019,Diciembre,Costa Rica,188,11,15,,26,"(10.445761,-75.516429)"
2019,Diciembre,Costa Rica,188,24,23,,47,"(10.886611,-74.776708)"
2019,Diciembre,Costa Rica,188,2,19,,21,"(12.5744111,-81.703935)"
2019,Diciembre,Costa Rica,188,3,1,,4,"(12.586067,-81.702563)"
2019,Diciembre,Costa Rica,188,43,39,,82,"(3.541112,-76.384584)"
2019,Diciembre,Costa Rica,188,1357,1380,,2737,"(4.697144,-74.140516)"
2019,Diciembre,Costa Rica,188,18,11,,29,"(4.815061,-75.736532)"
2019,Diciembre,Costa Rica,188,113,96,,209,"(6.171601,-75.427454)"
2019,Diciembre,Costa Rica,188,6,1,,7,"(7.128456,-73.183637)"
2019,Diciembre,Croacia,191,1,2,,3,"(4.697144,-74.140516)"
2019,Diciembre,Croacia,191,2,0,,2,"(6.171601,-75.427454)"
2019,Diciembre,Cuba,192,8,4,,12,"(10.445761,-75.516429)"
2019,Diciembre,Cuba,192,22,17,,39,"(10.886611,-74.776708)"
2019,Diciembre,Cuba,192,2,1,,3,"(12.586067,-81.702563)"
2019,Diciembre,Cuba,192,64,39,,103,"(3.541112,-76.384584)"
2019,Diciembre,Cuba,192,1725,1362,,3087,"(4.697144,-74.140516)"
2019,Diciembre,Cuba,192,15,11,,26,"(4.815061,-75.736532)"
2019,Diciembre,Cuba,192,154,128,,282,"(6.171601,-75.427454)"
2019,Diciembre,Cuba,192,32,19,,51,"(7.128456,-73.183637)"
2019,Diciembre,Curazao,99999,7,2,,9,"(10.445761,-75.516429)"
2019,Diciembre,Curazao,99999,2,1,,3,"(10.886611,-74.776708)"
2019,Diciembre,Curazao,99999,6,3,,9,"(3.541112,-76.384584)"
2019,Diciembre,Curazao,99999,1538,1148,,2686,"(4.697144,-74.140516)"
2019,Diciembre,Curazao,99999,3,1,,4,"(4.815061,-75.736532)"
2019,Diciembre,Curazao,99999,8,8,,16,"(6.171601,-75.427454)"
2019,Diciembre,Curazao,99999,0,1,,1,"(7.128456,-73.183637)"
2019,Diciembre,República Checa,203,6,9,,15,"(4.697144,-74.140516)"
2019,Diciembre,República Checa,203,1,1,,2,"(6.171601,-75.427454)"
2019,Diciembre,Chile,152,1,0,,1,"(0.25129,-76.875963)"
2019,Diciembre,Chile,152,139,113,,252,"(0.814836,-77.662532)"
2019,Diciembre,Chile,152,1,0,,1,"(1.813928,-78.763924)"
2019,Diciembre,Chile,152,22,14,,36,"(10.445761,-75.516429)"
2019,Diciembre,Chile,152,67,37,,104,"(10.886611,-74.776708)"
2019,Diciembre,Chile,152,969,588,,1557,"(3.541112,-76.384584)"
2019,Diciembre,Chile,152,6971,5022,,11993,"(4.697144,-74.140516)"
2019,Diciembre,Chile,152,93,45,,138,"(4.815061,-75.736532)"
2019,Diciembre,Chile,152,238,141,,379,"(6.171601,-75.427454)"
2019,Diciembre,Chile,152,8,9,,17,"(7.128456,-73.183637)"
2019,Diciembre,China,156,1,0,,1,"(10.445761,-75.516429)"
2019,Diciembre,China,156,0,2,,2,"(10.886611,-74.776708)"
2019,Diciembre,China,156,4,5,,9,"(3.541112,-76.384584)"
2019,Diciembre,China,156,79,133,,212,"(4.697144,-74.140516)"
2019,Diciembre,China,156,0,2,,2,"(4.815061,-75.736532)"
2019,Diciembre,China,156,13,14,,27,"(6.171601,-75.427454)"
2019,Diciembre,Chipre,196,0,1,,1,"(3.541112,-76.384584)"
2019,Diciembre,Chipre,196,1,2,,3,"(4.697144,-74.140516)"
2019,Diciembre,Dinamarca,208,40,20,,60,"(4.697144,-74.140516)"
2019,Diciembre,Dinamarca,208,6,5,,11,"(6.171601,-75.427454)"
2019,Diciembre,Dominica,212,0,1,,1,"(4.697144,-74.140516)"
2019,Diciembre,Ecuador,218,2,0,,2,"(-0.193180,-74.784874)"
2019,Diciembre,Ecuador,218,989,1245,,2234,"(0.25129,-76.875963)"
2019,Diciembre,Ecuador,218,47,64,,111,"(0.812436,-77.847006)"
2019,Diciembre,Ecuador,218,8627,8430,,17057,"(0.814836,-77.662532)"
2019,Diciembre,Ecuador,218,191,160,,351,"(1.813928,-78.763924)"
2019,Diciembre,Ecuador,218,0,13,,13,"(10.408582,-75.538003)"
2019,Diciembre,Ecuador,218,4,2,,6,"(10.445761,-75.516429)"
2019,Diciembre,Ecuador,218,3,3,,6,"(10.886611,-74.776708)"
2019,Diciembre,Ecuador,218,445,406,,851,"(3.541112,-76.384584)"
2019,Diciembre,Ecuador,218,4172,4641,,8813,"(4.697144,-74.140516)"
2019,Diciembre,Ecuador,218,0,2,,2,"(4.815061,-75.736532)"
2019,Diciembre,Ecuador,218,18,34,,52,"(6.171601,-75.427454)"
2019,Diciembre,Ecuador,218,3,6,,9,"(7.128456,-73.183637)"
2019,Diciembre,Egipto,818,26,20,,46,"(4.697144,-74.140516)"
2019,Diciembre,Egipto,818,5,5,,10,"(6.171601,-75.427454)"
2019,Diciembre,El Salvador,222,6,1,,7,"(10.886611,-74.776708)"
2019,Diciembre,El Salvador,222,6,5,,11,"(3.541112,-76.384584)"
2019,Diciembre,El Salvador,222,1271,1368,,2639,"(4.697144,-74.140516)"
2019,Diciembre,El Salvador,222,1,0,,1,"(4.815061,-75.736532)"
2019,Diciembre,El Salvador,222,12,13,,25,"(6.171601,-75.427454)"
2019,Diciembre,Emiratos Árabes,784,2,1,,3,"(10.445761,-75.516429)"
2019,Diciembre,Emiratos Árabes,784,9,6,,15,"(3.541112,-76.384584)"
2019,Diciembre,Emiratos Árabes,784,191,185,,376,"(4.697144,-74.140516)"
2019,Diciembre,Emiratos Árabes,784,8,11,,19,"(6.171601,-75.427454)"
2019,Diciembre,Eritrea,232,0,1,,1,"(4.697144,-74.140516)"
2019,Diciembre,Eritrea,232,1,0,,1,"(6.171601,-75.427454)"
2019,Diciembre,Eslovaquia,703,2,3,,5,"(4.697144,-74.140516)"
2019,Diciembre,Eslovenia,705,2,3,,5,"(4.697144,-74.140516)"
2019,Diciembre,Estados Unidos de América,840,1,3,,4,"(0.814836,-77.662532)"
2019,Diciembre,Estados Unidos de América,840,1,8,,9,"(10.408582,-75.538003)"
2019,Diciembre,Estados Unidos de América,840,5345,4257,,9602,"(10.445761,-75.516429)"
2019,Diciembre,Estados Unidos de América,840,3413,2695,,6108,"(10.886611,-74.776708)"
2019,Diciembre,Estados Unidos de América,840,55,41,,96,"(12.586067,-81.702563)"
2019,Diciembre,Estados Unidos de América,840,7792,5825,,13617,"(3.541112,-76.384584)"
2019,Diciembre,Estados Unidos de América,840,1049,702,,1751,"(4.452882,-75.766298)"
2019,Diciembre,Estados Unidos de América,840,41813,33902,,75715,"(4.697144,-74.140516)"
2019,Diciembre,Estados Unidos de América,840,1374,881,,2255,"(4.815061,-75.736532)"
2019,Diciembre,Estados Unidos de América,840,0,7,,7,"(6.17134,-75.427194)"
2019,Diciembre,Estados Unidos de América,840,14802,11335,,26138,"(6.171601,-75.427454)"
2019,Diciembre,Estados Unidos de América,840,294,206,,500,"(7.128456,-73.183637)"
2019,Diciembre,Estonia,233,4,0,,4,"(4.697144,-74.140516)"
2019,Diciembre,Etiopia,231,1,2,,3,"(4.697144,-74.140516)"
2019,Diciembre,Etiopia,231,0,1,,1,"(6.171601,-75.427454)"
2019,Diciembre,Filipinas,608,6,5,,11,"(4.697144,-74.140516)"
2019,Diciembre,Finlandia,246,1,1,,2,"(10.886611,-74.776708)"
2019,Diciembre,Finlandia,246,1,0,,1,"(3.541112,-76.384584)"
2019,Diciembre,Finlandia,246,8,8,,16,"(4.697144,-74.140516)"
2019,Diciembre,Finlandia,246,1,0,,1,"(6.171601,-75.427454)"
2019,Diciembre,Francia,250,13,3,,16,"(10.445761,-75.516429)"
2019,Diciembre,Francia,250,13,11,,24,"(10.886611,-74.776708)"
2019,Diciembre,Francia,250,114,69,,183,"(3.541112,-76.384584)"
2019,Diciembre,Francia,250,2187,1604,,3791,"(4.697144,-74.140516)"
2019,Diciembre,Francia,250,20,16,,36,"(4.815061,-75.736532)"
2019,Diciembre,Francia,250,143,91,,234,"(6.171601,-75.427454)"
2019,Diciembre,Ghana,288,1,0,,1,"(4.697144,-74.140516)"
2019,Diciembre,Granada,308,1,0,,1,"(3.541112,-76.384584)"
2019,Diciembre,Grecia,300,0,1,,1,"(10.445761,-75.516429)"
2019,Diciembre,Grecia,300,9,10,,19,"(4.697144,-74.140516)"
2019,Diciembre,Grecia,300,5,7,,12,"(6.171601,-75.427454)"
2019,Diciembre,Guatemala,320,0,2,,2,"(10.445761,-75.516429)"
2019,Diciembre,Guatemala,320,9,17,,26,"(10.886611,-74.776708)"
2019,Diciembre,Guatemala,320,0,1,,1,"(12.586067,-81.702563)"
2019,Diciembre,Guatemala,320,20,21,,41,"(3.541112,-76.384584)"
2019,Diciembre,Guatemala,320,867,756,,1623,"(4.697144,-74.140516)"
2019,Diciembre,Guatemala,320,12,6,,18,"(4.815061,-75.736532)"
2019,Diciembre,Guatemala,320,50,48,,98,"(6.171601,-75.427454)"
2019,Diciembre,Guatemala,320,4,2,,6,"(7.128456,-73.183637)"
2019,Diciembre,Guyana,328,0,1,,1,"(10.445761,-75.516429)"
2019,Diciembre,Guyana,328,3,3,,6,"(10.886611,-74.776708)"
2019,Diciembre,Guyana,328,4,0,,4,"(12.586067,-81.702563)"
2019,Diciembre,Guyana,328,1,2,,3,"(3.541112,-76.384584)"
2019,Diciembre,Guyana,328,2,6,,8,"(4.697144,-74.140516)"
2019,Diciembre,Guyana,328,1,2,,3,"(6.171601,-75.427454)"
2019,Diciembre,Guinea Ecuatorial,226,0,1,,1,"(4.697144,-74.140516)"
2019,Diciembre,Guadalupe/Territorio Francés,312,0,1,,1,"(3.541112,-76.384584)"
2019,Diciembre,Guadalupe/Territorio Francés,312,2,2,,4,"(4.697144,-74.140516)"
2019,Diciembre,Guayana Francesa/Departamento de Ultramar Francés,254,1,0,,1,"(3.541112,-76.384584)"
2019,Diciembre,Guayana Francesa/Departamento de Ultramar Francés,254,0,1,,1,"(4.815061,-75.736532)"
2019,Diciembre,Haití,332,0,1,,1,"(10.886611,-74.776708)"
2019,Diciembre,Haití,332,0,1,,1,"(4.697144,-74.140516)"
2019,Diciembre,Haití,332,2,1,,3,"(6.171601,-75.427454)"
2019,Diciembre,Honduras,340,1,10,,11,"(10.408582,-75.538003)"
2019,Diciembre,Honduras,340,2,4,,6,"(10.445761,-75.516429)"
2019,Diciembre,Honduras,340,6,17,,23,"(10.886611,-74.776708)"
2019,Diciembre,Honduras,340,3,0,,3,"(12.586067,-81.702563)"
2019,Diciembre,Honduras,340,11,16,,27,"(3.541112,-76.384584)"
2019,Diciembre,Honduras,340,104,122,,226,"(4.697144,-74.140516)"
2019,Diciembre,Honduras,340,2,3,,5,"(4.815061,-75.736532)"
2019,Diciembre,Honduras,340,18,31,,49,"(6.171601,-75.427454)"
2019,Diciembre,Honduras,340,6,3,,9,"(7.128456,-73.183637)"
2019,Diciembre,Hong Kong,344,1,2,,3,"(3.541112,-76.384584)"
2019,Diciembre,Hong Kong,344,13,15,,28,"(4.697144,-74.140516)"
2019,Diciembre,Hong Kong,344,4,4,,8,"(6.171601,-75.427454)"
2019,Diciembre,Hungría,348,30,3,,33,"(3.541112,-76.384584)"
2019,Diciembre,Hungría,348,7,3,,10,"(4.697144,-74.140516)"
2019,Diciembre,Hungría,348,4,0,,4,"(4.815061,-75.736532)"
2019,Diciembre,India,356,1,0,,1,"(10.445761,-75.516429)"
2019,Diciembre,India,356,0,1,,1,"(10.886611,-74.776708)"
2019,Diciembre,India,356,5,4,,9,"(3.541112,-76.384584)"
2019,Diciembre,India,356,27,23,,50,"(4.697144,-74.140516)"
2019,Diciembre,India,356,10,5,,15,"(6.171601,-75.427454)"
2019,Diciembre,Indonesia,360,1,0,,1,"(3.541112,-76.384584)"
2019,Diciembre,Indonesia,360,5,1,,6,"(4.697144,-74.140516)"
2019,Diciembre,Indonesia,360,1,2,,3,"(6.171601,-75.427454)"
2019,Diciembre,Iraq,368,0,4,,4,"(10.408582,-75.538003)"
2019,Diciembre,Iraq,368,0,3,,3,"(4.697144,-74.140516)"
2019,Diciembre,Iraq,368,0,1,,1,"(6.171601,-75.427454)"
2019,Diciembre,Irán,364,1,0,,1,"(4.697144,-74.140516)"
2019,Diciembre,Irán,364,0,1,,1,"(6.171601,-75.427454)"
2019,Diciembre,República de Irlanda,372,1,0,,1,"(10.445761,-75.516429)"
2019,Diciembre,República de Irlanda,372,7,6,,13,"(4.697144,-74.140516)"
2019,Diciembre,República de Irlanda,372,1,2,,3,"(6.171601,-75.427454)"
2019,Diciembre,Islandia,352,3,1,,4,"(4.697144,-74.140516)"
2019,Diciembre,Islandia,352,2,0,,2,"(6.171601,-75.427454)"
2019,Diciembre,Israel,376,6,3,,9,"(3.541112,-76.384584)"
2019,Diciembre,Israel,376,153,99,,252,"(4.697144,-74.140516)"
2019,Diciembre,Israel,376,11,4,,15,"(6.171601,-75.427454)"
2019,Diciembre,Italia,380,25,14,,39,"(10.445761,-75.516429)"
2019,Diciembre,Italia,380,6,6,,12,"(10.886611,-74.776708)"
2019,Diciembre,Italia,380,90,59,,149,"(3.541112,-76.384584)"
2019,Diciembre,Italia,380,592,431,,1023,"(4.697144,-74.140516)"
2019,Diciembre,Italia,380,129,91,,220,"(6.171601,-75.427454)"
2019,Diciembre,Italia,380,1,0,,1,"(7.128456,-73.183637)"
2019,Diciembre,Jamaica,388,2,0,,2,"(10.445761,-75.516429)"
2019,Diciembre,Jamaica,388,4,5,,9,"(10.886611,-74.776708)"
2019,Diciembre,Jamaica,388,1,1,,2,"(12.586067,-81.702563)"
2019,Diciembre,Jamaica,388,18,16,,34,"(3.541112,-76.384584)"
2019,Diciembre,Jamaica,388,83,89,,172,"(4.697144,-74.140516)"
2019,Diciembre,Jamaica,388,4,2,,6,"(4.815061,-75.736532)"
2019,Diciembre,Jamaica,388,24,15,,39,"(6.171601,-75.427454)"
2019,Diciembre,Jamaica,388,7,5,,12,"(7.128456,-73.183637)"
2019,Diciembre,Japón,392,1,0,,1,"(10.886611,-74.776708)"
2019,Diciembre,Japón,392,4,2,,6,"(3.541112,-76.384584)"
2019,Diciembre,Japón,392,87,81,,168,"(4.697144,-74.140516)"
2019,Diciembre,Japón,392,24,18,,42,"(6.171601,-75.427454)"
2019,Diciembre,Jordania,400,1,0,,1,"(4.697144,-74.140516)"
2019,Diciembre,Jordania,400,2,0,,2,"(6.171601,-75.427454)"
2019,Diciembre,Kazajistán,398,3,3,,6,"(4.697144,-74.140516)"
2019,Diciembre,Kazajistán,398,1,1,,2,"(6.171601,-75.427454)"
2019,Diciembre,Kenia,404,1,3,,4,"(4.697144,-74.140516)"
2019,Diciembre,Kenia,404,3,0,,3,"(6.171601,-75.427454)"
2019,Diciembre,Kuwait,414,1,0,,1,"(3.541112,-76.384584)"
2019,Diciembre,Kuwait,414,1,7,,8,"(4.697144,-74.140516)"
2019,Diciembre,Kuwait,414,0,1,,1,"(6.171601,-75.427454)"
2019,Diciembre,Lituania,440,1,0,,1,"(4.697144,-74.140516)"
2019,Diciembre,Lituania,440,1,0,,1,"(6.171601,-75.427454)"
2019,Diciembre,Líbano,422,0,1,,1,"(10.886611,-74.776708)"
2019,Diciembre,Líbano,422,0,1,,1,"(12.586067,-81.702563)"
2019,Diciembre,Líbano,422,3,2,,5,"(4.697144,-74.140516)"
2019,Diciembre,Luxemburgo,442,15,3,,18,"(4.697144,-74.140516)"
2019,Diciembre,Luxemburgo,442,1,1,,2,"(6.171601,-75.427454)"
2019,Diciembre,Macao,446,1,0,,1,"(4.697144,-74.140516)"
2019,Diciembre,Madagascar,450,1,0,,1,"(3.541112,-76.384584)"
2019,Diciembre,Malasia,458,0,1,,1,"(3.541112,-76.384584)"
2019,Diciembre,Malasia,458,2,0,,2,"(4.697144,-74.140516)"
2019,Diciembre,Malasia,458,0,1,,1,"(6.171601,-75.427454)"
2019,Diciembre,Maldivas,462,6,3,,9,"(4.697144,-74.140516)"
2019,Diciembre,Maldivas,462,1,0,,1,"(6.171601,-75.427454)"
2019,Diciembre,Malta,470,2,1,,3,"(3.541112,-76.384584)"
2019,Diciembre,Malta,470,31,12,,43,"(4.697144,-74.140516)"
2019,Diciembre,Malta,470,0,1,,1,"(4.815061,-75.736532)"
2019,Diciembre,Malta,470,2,3,,5,"(6.171601,-75.427454)"
2019,Diciembre,Marruecos,504,16,7,,23,"(4.697144,-74.140516)"
2019,Diciembre,Marruecos,504,3,4,,7,"(6.171601,-75.427454)"
2019,Diciembre,Martinica/Departamento de Ultramar Francés,474,1,0,,1,"(4.697144,-74.140516)"
2019,Diciembre,México,484,356,286,,642,"(10.445761,-75.516429)"
2019,Diciembre,México,484,177,121,,298,"(10.886611,-74.776708)"
2019,Diciembre,México,484,14,14,,28,"(12.586067,-81.702563)"
2019,Diciembre,México,484,477,393,,870,"(3.541112,-76.384584)"
2019,Diciembre,México,484,22051,17903,,39954,"(4.697144,-74.140516)"
2019,Diciembre,México,484,130,117,,247,"(4.815061,-75.736532)"
2019,Diciembre,México,484,5759,4388,,10147,"(6.171601,-75.427454)"
2019,Diciembre,México,484,109,76,,185,"(7.128456,-73.183637)"
2019,Diciembre,México,484,1,3,,4,"(7.927209,-72.507910)"
2019,Diciembre,Mónaco,492,1,1,,2,"(4.697144,-74.140516)"
2019,Diciembre,Mónaco,492,1,0,,1,"(6.171601,-75.427454)"
2019,Diciembre,Mozambique,508,0,1,,1,"(10.445761,-75.516429)"
2019,Diciembre,Mozambique,508,0,2,,2,"(4.697144,-74.140516)"
2019,Diciembre,Nepal,524,0,3,,3,"(4.697144,-74.140516)"
2019,Diciembre,Nepal,524,1,0,,1,"(6.171601,-75.427454)"
2019,Diciembre,Nicaragua,558,0,2,,2,"(10.445761,-75.516429)"
2019,Diciembre,Nicaragua,558,1,6,,7,"(10.886611,-74.776708)"
2019,Diciembre,Nicaragua,558,11,11,,22,"(3.541112,-76.384584)"
2019,Diciembre,Nicaragua,558,52,46,,98,"(4.697144,-74.140516)"
2019,Diciembre,Nicaragua,558,2,2,,4,"(4.815061,-75.736532)"
2019,Diciembre,Nicaragua,558,8,23,,31,"(6.171601,-75.427454)"
2019,Diciembre,Nicaragua,558,0,2,,2,"(7.128456,-73.183637)"
2019,Diciembre,Nigeria,566,1,4,,5,"(4.697144,-74.140516)"
2019,Diciembre,Noruega,578,0,1,,1,"(10.408582,-75.538003)"
2019,Diciembre,Noruega,578,3,0,,3,"(10.445761,-75.516429)"
2019,Diciembre,Noruega,578,1,0,,1,"(10.886611,-74.776708)"
2019,Diciembre,Noruega,578,4,3,,7,"(3.541112,-76.384584)"
2019,Diciembre,Noruega,578,38,23,,61,"(4.697144,-74.140516)"
2019,Diciembre,Noruega,578,4,2,,6,"(6.171601,-75.427454)"
2019,Diciembre,Nueva Caledonia/Territorio francés,540,1,0,,1,"(6.171601,-75.427454)"
2019,Diciembre,Nueva Zelanda,554,0,1,,1,"(3.541112,-76.384584)"
2019,Diciembre,Nueva Zelanda,554,39,26,,65,"(4.697144,-74.140516)"
2019,Diciembre,Nueva Zelanda,554,1,2,,3,"(4.815061,-75.736532)"
2019,Diciembre,Nueva Zelanda,554,4,3,,7,"(6.171601,-75.427454)"
2019,Diciembre,Omán,512,2,4,,6,"(4.697144,-74.140516)"
2019,Diciembre,Omán,512,3,2,,5,"(6.171601,-75.427454)"
2019,Diciembre,Panamá,591,205,232,,437,"(10.408582,-75.538003)"
2019,Diciembre,Panamá,591,1663,1309,,2972,"(10.445761,-75.516429)"
2019,Diciembre,Panamá,591,746,615,,1361,"(10.886611,-74.776708)"
2019,Diciembre,Panamá,591,0,1,,1,"(10.971302,-74.765397)"
2019,Diciembre,Panamá,591,1,0,,1,"(11.360009,-72.129330)"
2019,Diciembre,Panamá,591,3,29,,32,"(12.5744111,-81.703935)"
2019,Diciembre,Panamá,591,116,89,,205,"(12.586067,-81.702563)"
2019,Diciembre,Panamá,591,2725,2020,,4745,"(3.541112,-76.384584)"
2019,Diciembre,Panamá,591,10006,9606,,19613,"(4.697144,-74.140516)"
2019,Diciembre,Panamá,591,415,271,,686,"(4.815061,-75.736532)"
2019,Diciembre,Panamá,591,2978,2467,,5445,"(6.171601,-75.427454)"
2019,Diciembre,Panamá,591,0,3,,3,"(6.228046,-77.404104)"
2019,Diciembre,Panamá,591,20,31,,51,"(7.102626,-77.762647)"
2019,Diciembre,Panamá,591,191,171,,362,"(7.128456,-73.183637)"
2019,Diciembre,Panamá,591,0,16,,16,"(8.066966,-76.735404)"
2019,Diciembre,Panamá,591,23,56,,79,"(8.635765,-77.346578)"
2019,Diciembre,Paraguay,600,1,2,,3,"(10.445761,-75.516429)"
2019,Diciembre,Paraguay,600,6,4,,10,"(10.886611,-74.776708)"
2019,Diciembre,Paraguay,600,12,11,,23,"(3.541112,-76.384584)"
2019,Diciembre,Paraguay,600,216,286,,502,"(4.697144,-74.140516)"
2019,Diciembre,Paraguay,600,5,1,,6,"(4.815061,-75.736532)"
2019,Diciembre,Paraguay,600,11,28,,39,"(6.171601,-75.427454)"
2019,Diciembre,Paraguay,600,0,4,,4,"(7.128456,-73.183637)"
2019,Diciembre,Perú,604,4,16,,20,"(-0.193180,-74.784874)"
2019,Diciembre,Perú,604,15,13,,28,"(-4.197703,-69.941278)"
2019,Diciembre,Perú,604,271,277,,548,"(-4.223468,-69.945098)"
2019,Diciembre,Perú,604,10,10,,20,"(0.25129,-76.875963)"
2019,Diciembre,Perú,604,180,242,,422,"(0.814836,-77.662532)"
2019,Diciembre,Perú,604,1,4,,5,"(1.813928,-78.763924)"
2019,Diciembre,Perú,604,214,146,,360,"(10.445761,-75.516429)"
2019,Diciembre,Perú,604,5,3,,8,"(10.886611,-74.776708)"
2019,Diciembre,Perú,604,4,1,,5,"(12.586067,-81.702563)"
2019,Diciembre,Perú,604,184,128,,312,"(3.541112,-76.384584)"
2019,Diciembre,Perú,604,8247,7598,,15845,"(4.697144,-74.140516)"
2019,Diciembre,Perú,604,2,5,,7,"(4.815061,-75.736532)"
2019,Diciembre,Perú,604,1026,806,,1832,"(6.171601,-75.427454)"
2019,Diciembre,Perú,604,2,1,,3,"(7.128456,-73.183637)"
2019,Diciembre,Polonia,616,0,1,,1,"(10.886611,-74.776708)"
2019,Diciembre,Polonia,616,13,16,,29,"(4.697144,-74.140516)"
2019,Diciembre,Portugal,620,3,0,,3,"(10.445761,-75.516429)"
2019,Diciembre,Portugal,620,3,1,,4,"(10.886611,-74.776708)"
2019,Diciembre,Portugal,620,15,5,,20,"(3.541112,-76.384584)"
2019,Diciembre,Portugal,620,72,77,,149,"(4.697144,-74.140516)"
2019,Diciembre,Portugal,620,1,0,,1,"(4.815061,-75.736532)"
2019,Diciembre,Portugal,620,33,27,,60,"(6.171601,-75.427454)"
2019,Diciembre,Polinesia Francesa/Colectividad de Ultramar Francesa,258,1,0,,1,"(4.697144,-74.140516)"
2019,Diciembre,Puerto Rico/Territorio de Estados Unidos,630,5,3,,8,"(10.445761,-75.516429)"
2019,Diciembre,Puerto Rico/Territorio de Estados Unidos,630,15,12,,27,"(10.886611,-74.776708)"
2019,Diciembre,Puerto Rico/Territorio de Estados Unidos,630,57,35,,92,"(3.541112,-76.384584)"
2019,Diciembre,Puerto Rico/Territorio de Estados Unidos,630,648,578,,1226,"(4.697144,-74.140516)"
2019,Diciembre,Puerto Rico/Territorio de Estados Unidos,630,10,4,,14,"(4.815061,-75.736532)"
2019,Diciembre,Puerto Rico/Territorio de Estados Unidos,630,73,57,,130,"(6.171601,-75.427454)"
2019,Diciembre,Puerto Rico/Territorio de Estados Unidos,630,10,5,,15,"(7.128456,-73.183637)"
2019,Diciembre,Qatar,634,0,1,,1,"(10.445761,-75.516429)"
2019,Diciembre,Qatar,634,1,0,,1,"(10.886611,-74.776708)"
2019,Diciembre,Qatar,634,6,12,,18,"(4.697144,-74.140516)"
2019,Diciembre,Qatar,634,4,4,,8,"(6.171601,-75.427454)"
2019,Diciembre,Reino Unido de Gran Bretaña e Irlanda del Norte,826,3,1,,4,"(10.445761,-75.516429)"
2019,Diciembre,Reino Unido de Gran Bretaña e Irlanda del Norte,826,2,3,,5,"(10.886611,-74.776708)"
2019,Diciembre,Reino Unido de Gran Bretaña e Irlanda del Norte,826,15,11,,26,"(3.541112,-76.384584)"
2019,Diciembre,Reino Unido de Gran Bretaña e Irlanda del Norte,826,1715,1281,,2996,"(4.697144,-74.140516)"
2019,Diciembre,Reino Unido de Gran Bretaña e Irlanda del Norte,826,33,13,,46,"(6.171601,-75.427454)"
2019,Diciembre,República CentroÁfricana,140,2,2,,4,"(4.697144,-74.140516)"
2019,Diciembre,Federación de Rusia,643,1,0,,1,"(10.445761,-75.516429)"
2019,Diciembre,Federación de Rusia,643,1,0,,1,"(10.886611,-74.776708)"
2019,Diciembre,Federación de Rusia,643,2,0,,2,"(3.541112,-76.384584)"
2019,Diciembre,Federación de Rusia,643,20,33,,53,"(4.697144,-74.140516)"
2019,Diciembre,Federación de Rusia,643,3,3,,6,"(6.171601,-75.427454)"
2019,Diciembre,República Dominicana,214,1,0,,1,"(10.408582,-75.538003)"
2019,Diciembre,República Dominicana,214,19,14,,33,"(10.445761,-75.516429)"
2019,Diciembre,República Dominicana,214,47,40,,87,"(10.886611,-74.776708)"
2019,Diciembre,República Dominicana,214,16,22,,38,"(11.117806,-74.232622)"
2019,Diciembre,República Dominicana,214,0,1,,1,"(11.247723,-74.213989)"
2019,Diciembre,República Dominicana,214,123,137,,260,"(3.541112,-76.384584)"
2019,Diciembre,República Dominicana,214,5559,4608,,10167,"(4.697144,-74.140516)"
2019,Diciembre,República Dominicana,214,50,27,,77,"(4.815061,-75.736532)"
2019,Diciembre,República Dominicana,214,548,401,,949,"(6.171601,-75.427454)"
2019,Diciembre,República Dominicana,214,40,25,,65,"(7.128456,-73.183637)"
2019,Diciembre,Reunión,638,0,1,,1,"(4.697144,-74.140516)"
2019,Diciembre,República Democrática Popular de Corea,408,0,1,,1,"(4.697144,-74.140516)"
2019,Diciembre,Rumania,642,1,2,,3,"(4.697144,-74.140516)"
2019,Diciembre,Rumania,642,1,0,,1,"(6.171601,-75.427454)"
2019,Diciembre,Rwanda,646,1,1,,2,"(4.697144,-74.140516)"
2019,Diciembre,San Pedro y Miquelón/territorio de Ultramar de La Unión Europea,666,1,0,,1,"(4.697144,-74.140516)"
2019,Diciembre,San Marino,674,1,0,,1,"(4.697144,-74.140516)"
2019,Diciembre,Santa Lucia,662,0,1,,1,"(10.886611,-74.776708)"
2019,Diciembre,Serbia,688,0,1,,1,"(4.697144,-74.140516)"
2019,Diciembre,Serbia,688,2,0,,2,"(6.171601,-75.427454)"
2019,Diciembre,Singapur,702,0,2,,2,"(10.886611,-74.776708)"
2019,Diciembre,Singapur,702,22,19,,41,"(4.697144,-74.140516)"
2019,Diciembre,Singapur,702,1,1,,2,"(4.815061,-75.736532)"
2019,Diciembre,Singapur,702,1,2,,3,"(6.171601,-75.427454)"
2019,Diciembre,Sri Lanka,144,2,2,,4,"(4.697144,-74.140516)"
2019,Diciembre,Sri Lanka,144,1,0,,1,"(6.171601,-75.427454)"
2019,Diciembre,Sudáfrica,710,1,0,,1,"(10.886611,-74.776708)"
2019,Diciembre,Sudáfrica,710,14,10,,24,"(4.697144,-74.140516)"
2019,Diciembre,Sudáfrica,710,0,2,,2,"(6.171601,-75.427454)"
2019,Diciembre,Sudán,736,0,1,,1,"(4.697144,-74.140516)"
2019,Diciembre,Suecia,752,4,2,,6,"(10.445761,-75.516429)"
2019,Diciembre,Suecia,752,3,3,,6,"(10.886611,-74.776708)"
2019,Diciembre,Suecia,752,25,12,,37,"(3.541112,-76.384584)"
2019,Diciembre,Suecia,752,65,53,,118,"(4.697144,-74.140516)"
2019,Diciembre,Suecia,752,1,0,,1,"(4.815061,-75.736532)"
2019,Diciembre,Suecia,752,25,10,,35,"(6.171601,-75.427454)"
2019,Diciembre,Suiza,756,6,7,,13,"(10.445761,-75.516429)"
2019,Diciembre,Suiza,756,6,4,,10,"(10.886611,-74.776708)"
2019,Diciembre,Suiza,756,46,26,,72,"(3.541112,-76.384584)"
2019,Diciembre,Suiza,756,258,181,,439,"(4.697144,-74.140516)"
2019,Diciembre,Suiza,756,2,0,,2,"(4.815061,-75.736532)"
2019,Diciembre,Suiza,756,62,31,,93,"(6.171601,-75.427454)"
2019,Diciembre,Surinam,740,5,1,,6,"(3.541112,-76.384584)"
2019,Diciembre,Surinam,740,5,3,,8,"(4.697144,-74.140516)"
2019,Diciembre,Taiwán,158,3,3,,6,"(4.697144,-74.140516)"
2019,Diciembre,Taiwán,158,0,1,,1,"(6.171601,-75.427454)"
2019,Diciembre,Tailandia,764,5,1,,6,"(3.541112,-76.384584)"
2019,Diciembre,Tailandia,764,42,37,,79,"(4.697144,-74.140516)"
2019,Diciembre,Tailandia,764,5,1,,6,"(6.171601,-75.427454)"
2019,Diciembre,Trinidad y Tobago,780,3,1,,4,"(10.445761,-75.516429)"
2019,Diciembre,Trinidad y Tobago,780,5,1,,6,"(3.541112,-76.384584)"
2019,Diciembre,Trinidad y Tobago,780,10,17,,27,"(4.697144,-74.140516)"
2019,Diciembre,Trinidad y Tobago,780,1,7,,8,"(4.815061,-75.736532)"
2019,Diciembre,Trinidad y Tobago,780,6,4,,10,"(6.171601,-75.427454)"
2019,Diciembre,Trinidad y Tobago,780,2,7,,9,"(7.128456,-73.183637)"
2019,Diciembre,Túnez,788,1,1,,2,"(4.697144,-74.140516)"
2019,Diciembre,Turquía,792,2,2,,4,"(10.445761,-75.516429)"
2019,Diciembre,Turquía,792,1,0,,1,"(12.586067,-81.702563)"
2019,Diciembre,Turquía,792,1,1,,2,"(3.541112,-76.384584)"
2019,Diciembre,Turquía,792,1272,879,,2151,"(4.697144,-74.140516)"
2019,Diciembre,Turquía,792,11,11,,22,"(6.171601,-75.427454)"
2019,Diciembre,Turkmenistán,795,2,2,,4,"(4.697144,-74.140516)"
2019,Diciembre,Ucrania,804,1,3,,4,"(4.697144,-74.140516)"
2019,Diciembre,Uruguay,858,2,4,,6,"(10.445761,-75.516429)"
2019,Diciembre,Uruguay,858,1,1,,2,"(10.886611,-74.776708)"
2019,Diciembre,Uruguay,858,22,14,,36,"(3.541112,-76.384584)"
2019,Diciembre,Uruguay,858,397,326,,723,"(4.697144,-74.140516)"
2019,Diciembre,Uruguay,858,8,4,,12,"(4.815061,-75.736532)"
2019,Diciembre,Uruguay,858,22,15,,37,"(6.171601,-75.427454)"
2019,Diciembre,Uruguay,858,1,1,,2,"(7.128456,-73.183637)"
2019,Diciembre,Venezuela,862,10,8,,18,"(10.445761,-75.516429)"
2019,Diciembre,Venezuela,862,14,12,,26,"(10.886611,-74.776708)"
2019,Diciembre,Venezuela,862,1206,1388,,2594,"(11.360009,-72.129330)"
2019,Diciembre,Venezuela,862,569,448,,1018,"(3.541112,-76.384584)"
2019,Diciembre,Venezuela,862,6,8,,14,"(3.866713,-67.927521)"
2019,Diciembre,Venezuela,862,914,999,,1913,"(4.697144,-74.140516)"
2019,Diciembre,Venezuela,862,312,250,,562,"(6.171601,-75.427454)"
2019,Diciembre,Venezuela,862,27,34,,61,"(6.185799,-67.483929)"
2019,Diciembre,Venezuela,862,307,359,,666,"(7.088729,-70.740253)"
2019,Diciembre,Venezuela,862,2,1,,3,"(7.128456,-73.183637)"
2019,Diciembre,Venezuela,862,1138,1281,,2419,"(7.818934,-72.453226)"
2019,Diciembre,Venezuela,862,4,2,,6,"(7.927209,-72.507910)"
2019,Diciembre,Venezuela,862,136,186,,322,"(8.36068,-72.409396)"
2019,Diciembre,Vietnam,704,0,1,,1,"(3.541112,-76.384584)"
2019,Diciembre,Vietnam,704,15,8,,23,"(4.697144,-74.140516)"
2019,Diciembre,Vietnam,704,1,3,,4,"(6.171601,-75.427454)"
2019,Diciembre,Islas Vírgenes Estadounidenses/Territorio de Estados Unidos,850,0,1,,1,"(10.886611,-74.776708)"
2019,Diciembre,Islas Turcas y Caicos/Territorio Británico de Ultramar,796,1,5,,6,"(10.445761,-75.516429)"
2019,Diciembre,Islas Turcas y Caicos/Territorio Británico de Ultramar,796,1,4,,5,"(4.697144,-74.140516)"
2020,Enero,Afganistán,4,0,11,,11,"(10.408582,-75.538003)"
2020,Enero,Afganistán,4,0,2,,2,"(3.541112,-76.384584)"
2020,Enero,Afganistán,4,0,7,,7,"(4.697144,-74.140516)"
2020,Enero,Albania,8,0,2,,2,"(10.408582,-75.538003)"
2020,Enero,Albania,8,1,0,,1,"(4.697144,-74.140516)"
2020,Enero,Alemania,276,0,1,,1,"(0.814836,-77.662532)"
2020,Enero,Alemania,276,0,2,,2,"(10.408582,-75.538003)"
2020,Enero,Alemania,276,15,10,,25,"(10.445761,-75.516429)"
2020,Enero,Alemania,276,23,10,,33,"(10.886611,-74.776708)"
2020,Enero,Alemania,276,73,44,,117,"(3.541112,-76.384584)"
2020,Enero,Alemania,276,2207,1900,,4107,"(4.697144,-74.140516)"
2020,Enero,Alemania,276,1,1,,2,"(4.815061,-75.736532)"
2020,Enero,Alemania,276,121,122,,243,"(6.171601,-75.427454)"
2020,Enero,Alemania,276,2,2,,4,"(7.128456,-73.183637)"
2020,Enero,Andorra,20,1,0,,1,"(4.697144,-74.140516)"
2020,Enero,Angola,24,0,1,,1,"(10.886611,-74.776708)"
2020,Enero,Angola,24,1,6,,7,"(4.697144,-74.140516)"
2020,Enero,Antigua y Barbuda,28,2,0,,2,"(3.541112,-76.384584)"
2020,Enero,Antigua y Barbuda,28,1,0,,1,"(6.171601,-75.427454)"
2020,Enero,Países Bajos,528,264,170,,434,"(10.445761,-75.516429)"
2020,Enero,Países Bajos,528,40,42,,82,"(10.886611,-74.776708)"
2020,Enero,Países Bajos,528,62,42,,104,"(3.541112,-76.384584)"
2020,Enero,Países Bajos,528,960,864,,1824,"(4.697144,-74.140516)"
2020,Enero,Países Bajos,528,3,4,,7,"(4.815061,-75.736532)"
2020,Enero,Países Bajos,528,126,95,,221,"(6.171601,-75.427454)"
2020,Enero,Países Bajos,528,1,1,,2,"(7.128456,-73.183637)"
2020,Enero,Arabia Saudita,682,0,1,,1,"(10.408582,-75.538003)"
2020,Enero,Arabia Saudita,682,0,2,,2,"(10.445761,-75.516429)"
2020,Enero,Arabia Saudita,682,0,5,,5,"(3.541112,-76.384584)"
2020,Enero,Arabia Saudita,682,16,60,,76,"(4.697144,-74.140516)"
2020,Enero,Arabia Saudita,682,7,8,,15,"(6.171601,-75.427454)"
2020,Enero,Arabia Saudita,682,0,1,,1,"(7.128456,-73.183637)"
2020,Enero,Argelia,12,2,5,,7,"(4.697144,-74.140516)"
2020,Enero,Argentina,32,0,3,,3,"(0.25129,-76.875963)"
2020,Enero,Argentina,32,0,1,,1,"(0.812436,-77.847006)"
2020,Enero,Argentina,32,29,44,,73,"(0.814836,-77.662532)"
2020,Enero,Argentina,32,44,31,,75,"(10.445761,-75.516429)"
2020,Enero,Argentina,32,41,30,,71,"(10.886611,-74.776708)"
2020,Enero,Argentina,32,1,2,,3,"(12.586067,-81.702563)"
2020,Enero,Argentina,32,163,141,,304,"(3.541112,-76.384584)"
2020,Enero,Argentina,32,4058,3708,,7767,"(4.697144,-74.140516)"
2020,Enero,Argentina,32,14,12,,26,"(4.815061,-75.736532)"
2020,Enero,Argentina,32,146,166,,312,"(6.171601,-75.427454)"
2020,Enero,Argentina,32,8,6,,14,"(7.128456,-73.183637)"
2020,Enero,República de Armenia,51,1,1,,2,"(4.697144,-74.140516)"
2020,Enero,Aruba,533,2516,2007,,4523,"(10.408582,-75.538003)"
2020,Enero,Aruba,533,3,3,,6,"(10.445761,-75.516429)"
2020,Enero,Aruba,533,152,88,,240,"(10.886611,-74.776708)"
2020,Enero,Aruba,533,55,48,,103,"(11.528919,-72.919681)"
2020,Enero,Aruba,533,31,18,,49,"(3.541112,-76.384584)"
2020,Enero,Aruba,533,1940,1725,,3665,"(4.697144,-74.140516)"
2020,Enero,Aruba,533,3,6,,9,"(4.815061,-75.736532)"
2020,Enero,Aruba,533,2,3,,5,"(6.17134,-75.427194)"
2020,Enero,Aruba,533,114,89,,203,"(6.171601,-75.427454)"
2020,Enero,Aruba,533,12,17,,29,"(7.128456,-73.183637)"
2020,Enero,Australia,36,4,3,,7,"(10.445761,-75.516429)"
2020,Enero,Australia,36,6,7,,13,"(10.886611,-74.776708)"
2020,Enero,Australia,36,64,38,,102,"(3.541112,-76.384584)"
2020,Enero,Australia,36,954,712,,1666,"(4.697144,-74.140516)"
2020,Enero,Australia,36,3,8,,11,"(4.815061,-75.736532)"
2020,Enero,Australia,36,138,111,,249,"(6.171601,-75.427454)"
2020,Enero,Australia,36,2,3,,5,"(7.128456,-73.183637)"
2020,Enero,Austria,40,3,0,,3,"(10.445761,-75.516429)"
2020,Enero,Austria,40,1,1,,2,"(10.886611,-74.776708)"
2020,Enero,Austria,40,2,1,,3,"(3.541112,-76.384584)"
2020,Enero,Austria,40,63,51,,114,"(4.697144,-74.140516)"
2020,Enero,Austria,40,6,7,,13,"(6.171601,-75.427454)"
2020,Enero,Azerbaiyán,31,6,6,,12,"(4.697144,-74.140516)"
2020,Enero,Bahamas,44,2,1,,3,"(10.445761,-75.516429)"
2020,Enero,Bahamas,44,2,2,,4,"(10.886611,-74.776708)"
2020,Enero,Bahamas,44,3,0,,3,"(12.586067,-81.702563)"
2020,Enero,Bahamas,44,13,18,,31,"(3.541112,-76.384584)"
2020,Enero,Bahamas,44,20,34,,54,"(4.697144,-74.140516)"
2020,Enero,Bahamas,44,4,2,,6,"(4.815061,-75.736532)"
2020,Enero,Bahamas,44,21,36,,57,"(6.171601,-75.427454)"
2020,Enero,Bahamas,44,1,0,,1,"(7.128456,-73.183637)"
2020,Enero,Bahréin,48,12,3,,15,"(4.697144,-74.140516)"
2020,Enero,Bahréin,48,0,1,,1,"(4.815061,-75.736532)"
2020,Enero,Bahréin,48,3,4,,7,"(6.171601,-75.427454)"
2020,Enero,Bangladesh,50,0,1,,1,"(4.697144,-74.140516)"
2020,Enero,Barbados,52,0,1,,1,"(10.445761,-75.516429)"
2020,Enero,Barbados,52,2,1,,3,"(10.886611,-74.776708)"
2020,Enero,Barbados,52,3,1,,4,"(3.541112,-76.384584)"
2020,Enero,Barbados,52,5,7,,12,"(4.697144,-74.140516)"
2020,Enero,Barbados,52,1,1,,2,"(4.815061,-75.736532)"
2020,Enero,Barbados,52,5,2,,7,"(6.171601,-75.427454)"
2020,Enero,República de Belarús,112,0,1,,1,"(7.818934,-72.453226)"
2020,Enero,Bélgica,56,6,0,,6,"(10.445761,-75.516429)"
2020,Enero,Bélgica,56,2,1,,3,"(10.886611,-74.776708)"
2020,Enero,Bélgica,56,28,15,,43,"(3.541112,-76.384584)"
2020,Enero,Bélgica,56,142,97,,239,"(4.697144,-74.140516)"
2020,Enero,Bélgica,56,5,2,,7,"(4.815061,-75.736532)"
2020,Enero,Bélgica,56,70,44,,114,"(6.171601,-75.427454)"
2020,Enero,Belice,84,0,3,,3,"(10.886611,-74.776708)"
2020,Enero,Belice,84,3,2,,5,"(3.541112,-76.384584)"
2020,Enero,Belice,84,7,10,,17,"(4.697144,-74.140516)"
2020,Enero,Belice,84,0,4,,4,"(6.171601,-75.427454)"
2020,Enero,Benín,204,2,0,,2,"(4.697144,-74.140516)"
2020,Enero,Benín,204,1,0,,1,"(6.171601,-75.427454)"
2020,Enero,Bermudas/Territorio Británico de Ultramar,60,1,1,,2,"(4.697144,-74.140516)"
2020,Enero,Bermudas/Territorio Británico de Ultramar,60,1,0,,1,"(4.815061,-75.736532)"
2020,Enero,Bermudas/Territorio Británico de Ultramar,60,1,1,,2,"(6.171601,-75.427454)"
2020,Enero,Bolivia,68,1,4,,5,"(0.25129,-76.875963)"
2020,Enero,Bolivia,68,15,42,,57,"(0.814836,-77.662532)"
2020,Enero,Bolivia,68,0,2,,2,"(10.886611,-74.776708)"
2020,Enero,Bolivia,68,2,7,,9,"(3.541112,-76.384584)"
2020,Enero,Bolivia,68,624,934,,1558,"(4.697144,-74.140516)"
2020,Enero,Bolivia,68,7,12,,19,"(4.815061,-75.736532)"
2020,Enero,Bolivia,68,10,16,,26,"(6.171601,-75.427454)"
2020,Enero,Bolivia,68,3,0,,3,"(7.128456,-73.183637)"
2020,Enero,Bosnia y Herzegovina,70,3,2,,5,"(4.697144,-74.140516)"
2020,Enero,Brasil,76,195,318,,513,"(-4.197703,-69.941278)"
2020,Enero,Brasil,76,37,40,,77,"(-4.223468,-69.945098)"
2020,Enero,Brasil,76,0,1,,1,"(0.25129,-76.875963)"
2020,Enero,Brasil,76,3,9,,12,"(0.814836,-77.662532)"
2020,Enero,Brasil,76,10,16,,26,"(10.445761,-75.516429)"
2020,Enero,Brasil,76,10,13,,23,"(10.886611,-74.776708)"
2020,Enero,Brasil,76,72,98,,170,"(3.541112,-76.384584)"
2020,Enero,Brasil,76,3668,4448,,8116,"(4.697144,-74.140516)"
2020,Enero,Brasil,76,19,33,,52,"(4.815061,-75.736532)"
2020,Enero,Brasil,76,96,146,,242,"(6.171601,-75.427454)"
2020,Enero,Brasil,76,6,6,,12,"(7.128456,-73.183637)"
2020,Enero,Brunei Darussalam,96,1,0,,1,"(4.697144,-74.140516)"
2020,Enero,Brunei Darussalam,96,0,1,,1,"(6.171601,-75.427454)"
2020,Enero,Bulgaria,100,1,4,,5,"(4.697144,-74.140516)"
2020,Enero,Islas Caimán/Territorio Británico de Ultramar,136,1,3,,4,"(10.445761,-75.516429)"
2020,Enero,Islas Caimán/Territorio Británico de Ultramar,136,1,1,,2,"(10.886611,-74.776708)"
2020,Enero,Islas Caimán/Territorio Británico de Ultramar,136,24,14,,38,"(12.586067,-81.702563)"
2020,Enero,Islas Caimán/Territorio Británico de Ultramar,136,0,3,,3,"(3.541112,-76.384584)"
2020,Enero,Islas Caimán/Territorio Británico de Ultramar,136,2,5,,7,"(4.697144,-74.140516)"
2020,Enero,Islas Caimán/Territorio Británico de Ultramar,136,2,0,,2,"(4.815061,-75.736532)"
2020,Enero,Islas Caimán/Territorio Británico de Ultramar,136,5,4,,9,"(6.171601,-75.427454)"
2020,Enero,Camboya,116,1,2,,3,"(4.697144,-74.140516)"
2020,Enero,Camboya,116,2,1,,3,"(6.171601,-75.427454)"
2020,Enero,Camerún,120,0,3,,3,"(4.697144,-74.140516)"
2020,Enero,Camerún,120,1,3,,4,"(6.171601,-75.427454)"
2020,Enero,Canadá,124,0,1,,1,"(0.814836,-77.662532)"
2020,Enero,Canadá,124,725,675,,1400,"(10.445761,-75.516429)"
2020,Enero,Canadá,124,66,49,,115,"(10.886611,-74.776708)"
2020,Enero,Canadá,124,26,24,,50,"(12.586067,-81.702563)"
2020,Enero,Canadá,124,288,265,,553,"(3.541112,-76.384584)"
2020,Enero,Canadá,124,2,2,,4,"(4.452882,-75.766298)"
2020,Enero,Canadá,124,4173,3812,,7985,"(4.697144,-74.140516)"
2020,Enero,Canadá,124,63,43,,106,"(4.815061,-75.736532)"
2020,Enero,Canadá,124,564,445,,1009,"(6.171601,-75.427454)"
2020,Enero,Canadá,124,47,38,,85,"(7.128456,-73.183637)"
2020,Enero,España,724,1,0,,1,"(0.814836,-77.662532)"
2020,Enero,España,724,14,15,,29,"(10.445761,-75.516429)"
2020,Enero,España,724,40,15,,55,"(10.886611,-74.776708)"
2020,Enero,España,724,3060,2109,,5169,"(3.541112,-76.384584)"
2020,Enero,España,724,15934,12047,,27981,"(4.697144,-74.140516)"
2020,Enero,España,724,70,45,,115,"(4.815061,-75.736532)"
2020,Enero,España,724,3114,2296,,5411,"(6.171601,-75.427454)"
2020,Enero,España,724,3,2,,5,"(7.128456,-73.183637)"
2020,Enero,Colombia,170,3,12,,15,"(10.445761,-75.516429)"
2020,Enero,Colombia,170,207,427,,635,"(4.697144,-74.140516)"
2020,Enero,República Del Congo,178,1,0,,1,"(6.171601,-75.427454)"
2020,Enero,República Democrática del Congo,180,1,2,,3,"(4.697144,-74.140516)"
2020,Enero,República de Corea,410,18,17,,35,"(4.697144,-74.140516)"
2020,Enero,República de Corea,410,2,5,,7,"(6.171601,-75.427454)"
2020,Enero,Costa de Marfil,384,0,1,,1,"(3.541112,-76.384584)"
2020,Enero,Costa de Marfil,384,2,4,,6,"(4.697144,-74.140516)"
2020,Enero,Costa de Marfil,384,1,8,,9,"(6.171601,-75.427454)"
2020,Enero,Costa Rica,188,23,18,,41,"(10.445761,-75.516429)"
2020,Enero,Costa Rica,188,46,35,,81,"(10.886611,-74.776708)"
2020,Enero,Costa Rica,188,2,17,,19,"(12.5744111,-81.703935)"
2020,Enero,Costa Rica,188,5,4,,9,"(12.586067,-81.702563)"
2020,Enero,Costa Rica,188,73,80,,153,"(3.541112,-76.384584)"
2020,Enero,Costa Rica,188,1728,1721,,3449,"(4.697144,-74.140516)"
2020,Enero,Costa Rica,188,35,32,,67,"(4.815061,-75.736532)"
2020,Enero,Costa Rica,188,211,192,,403,"(6.171601,-75.427454)"
2020,Enero,Costa Rica,188,15,8,,23,"(7.128456,-73.183637)"
2020,Enero,Croacia,191,3,1,,4,"(4.697144,-74.140516)"
2020,Enero,Cuba,192,15,19,,34,"(10.445761,-75.516429)"
2020,Enero,Cuba,192,37,36,,73,"(10.886611,-74.776708)"
2020,Enero,Cuba,192,89,81,,170,"(3.541112,-76.384584)"
2020,Enero,Cuba,192,1233,1088,,2321,"(4.697144,-74.140516)"
2020,Enero,Cuba,192,15,11,,26,"(4.815061,-75.736532)"
2020,Enero,Cuba,192,120,108,,228,"(6.171601,-75.427454)"
2020,Enero,Cuba,192,11,13,,24,"(7.128456,-73.183637)"
2020,Enero,Curazao,99999,1,2,,3,"(10.408582,-75.538003)"
2020,Enero,Curazao,99999,0,3,,3,"(10.445761,-75.516429)"
2020,Enero,Curazao,99999,2,7,,9,"(10.886611,-74.776708)"
2020,Enero,Curazao,99999,6,2,,8,"(3.541112,-76.384584)"
2020,Enero,Curazao,99999,1972,1574,,3546,"(4.697144,-74.140516)"
2020,Enero,Curazao,99999,20,14,,34,"(6.171601,-75.427454)"
2020,Enero,Curazao,99999,2,4,,6,"(7.128456,-73.183637)"
2020,Enero,República Checa,203,1,0,,1,"(3.541112,-76.384584)"
2020,Enero,República Checa,203,12,10,,22,"(4.697144,-74.140516)"
2020,Enero,Chile,152,2,1,,3,"(0.25129,-76.875963)"
2020,Enero,Chile,152,221,249,,470,"(0.814836,-77.662532)"
2020,Enero,Chile,152,0,1,,1,"(1.813928,-78.763924)"
2020,Enero,Chile,152,40,37,,77,"(10.445761,-75.516429)"
2020,Enero,Chile,152,94,60,,154,"(10.886611,-74.776708)"
2020,Enero,Chile,152,3,2,,5,"(12.586067,-81.702563)"
2020,Enero,Chile,152,1395,1016,,2411,"(3.541112,-76.384584)"
2020,Enero,Chile,152,8118,6792,,14910,"(4.697144,-74.140516)"
2020,Enero,Chile,152,113,81,,194,"(4.815061,-75.736532)"
2020,Enero,Chile,152,230,213,,443,"(6.171601,-75.427454)"
2020,Enero,Chile,152,15,15,,30,"(7.128456,-73.183637)"
2020,Enero,China,156,0,2,,2,"(10.445761,-75.516429)"
2020,Enero,China,156,1,0,,1,"(10.886611,-74.776708)"
2020,Enero,China,156,1,6,,7,"(3.541112,-76.384584)"
2020,Enero,China,156,61,86,,147,"(4.697144,-74.140516)"
2020,Enero,China,156,6,13,,19,"(6.171601,-75.427454)"
2020,Enero,Chipre,196,0,1,,1,"(3.541112,-76.384584)"
2020,Enero,Chipre,196,1,0,,1,"(4.697144,-74.140516)"
2020,Enero,Chipre,196,1,0,,1,"(4.815061,-75.736532)"
2020,Enero,Dinamarca,208,3,3,,6,"(10.445761,-75.516429)"
2020,Enero,Dinamarca,208,3,3,,6,"(3.541112,-76.384584)"
2020,Enero,Dinamarca,208,35,34,,69,"(4.697144,-74.140516)"
2020,Enero,Dinamarca,208,8,7,,15,"(6.171601,-75.427454)"
2020,Enero,Dominica,212,0,1,,1,"(10.886611,-74.776708)"
2020,Enero,Dominica,212,1,1,,2,"(3.541112,-76.384584)"
2020,Enero,Ecuador,218,1,4,,5,"(-0.193180,-74.784874)"
2020,Enero,Ecuador,218,1284,1713,,2997,"(0.25129,-76.875963)"
2020,Enero,Ecuador,218,40,47,,87,"(0.812436,-77.847006)"
2020,Enero,Ecuador,218,11782,12548,,24330,"(0.814836,-77.662532)"
2020,Enero,Ecuador,218,253,246,,499,"(1.813928,-78.763924)"
2020,Enero,Ecuador,218,5,4,,9,"(10.445761,-75.516429)"
2020,Enero,Ecuador,218,7,5,,12,"(10.886611,-74.776708)"
2020,Enero,Ecuador,218,482,540,,1022,"(3.541112,-76.384584)"
2020,Enero,Ecuador,218,3769,4744,,8513,"(4.697144,-74.140516)"
2020,Enero,Ecuador,218,0,1,,1,"(4.815061,-75.736532)"
2020,Enero,Ecuador,218,42,71,,113,"(6.171601,-75.427454)"
2020,Enero,Ecuador,218,3,2,,5,"(7.128456,-73.183637)"
2020,Enero,Egipto,818,0,1,,1,"(3.541112,-76.384584)"
2020,Enero,Egipto,818,28,18,,46,"(4.697144,-74.140516)"
2020,Enero,Egipto,818,1,0,,1,"(6.171601,-75.427454)"
2020,Enero,El Salvador,222,5,3,,8,"(10.445761,-75.516429)"
2020,Enero,El Salvador,222,1,1,,2,"(10.886611,-74.776708)"
2020,Enero,El Salvador,222,0,1,,1,"(12.586067,-81.702563)"
2020,Enero,El Salvador,222,8,10,,18,"(3.541112,-76.384584)"
2020,Enero,El Salvador,222,1132,1466,,2598,"(4.697144,-74.140516)"
2020,Enero,El Salvador,222,10,15,,25,"(6.171601,-75.427454)"
2020,Enero,Emiratos Árabes,784,0,2,,2,"(10.886611,-74.776708)"
2020,Enero,Emiratos Árabes,784,4,4,,8,"(3.541112,-76.384584)"
2020,Enero,Emiratos Árabes,784,129,369,,498,"(4.697144,-74.140516)"
2020,Enero,Emiratos Árabes,784,17,18,,35,"(6.171601,-75.427454)"
2020,Enero,Eslovaquia,703,0,1,,1,"(3.541112,-76.384584)"
2020,Enero,Eslovaquia,703,3,1,,4,"(4.697144,-74.140516)"
2020,Enero,Eslovenia,705,2,1,,3,"(4.697144,-74.140516)"
2020,Enero,Estados Unidos de América,840,4530,3674,,8204,"(10.445761,-75.516429)"
2020,Enero,Estados Unidos de América,840,3241,2483,,5724,"(10.886611,-74.776708)"
2020,Enero,Estados Unidos de América,840,2,4,,6,"(11.117806,-74.232622)"
2020,Enero,Estados Unidos de América,840,61,41,,102,"(12.586067,-81.702563)"
2020,Enero,Estados Unidos de América,840,7638,6030,,13668,"(3.541112,-76.384584)"
2020,Enero,Estados Unidos de América,840,1034,813,,1847,"(4.452882,-75.766298)"
2020,Enero,Estados Unidos de América,840,36198,31391,,67590,"(4.697144,-74.140516)"
2020,Enero,Estados Unidos de América,840,1310,1004,,2314,"(4.815061,-75.736532)"
2020,Enero,Estados Unidos de América,840,13330,11171,,24501,"(6.171601,-75.427454)"
2020,Enero,Estados Unidos de América,840,259,208,,467,"(7.128456,-73.183637)"
2020,Enero,Estonia,233,0,1,,1,"(10.886611,-74.776708)"
2020,Enero,Estonia,233,3,3,,6,"(4.697144,-74.140516)"
2020,Enero,Etiopia,231,1,0,,1,"(3.541112,-76.384584)"
2020,Enero,Etiopia,231,0,3,,3,"(4.697144,-74.140516)"
2020,Enero,Etiopia,231,0,5,,5,"(6.171601,-75.427454)"
2020,Enero,Filipinas,608,2,0,,2,"(3.541112,-76.384584)"
2020,Enero,Filipinas,608,8,8,,16,"(4.697144,-74.140516)"
2020,Enero,Finlandia,246,1,1,,2,"(10.445761,-75.516429)"
2020,Enero,Finlandia,246,1,0,,1,"(10.886611,-74.776708)"
2020,Enero,Finlandia,246,4,3,,7,"(3.541112,-76.384584)"
2020,Enero,Finlandia,246,18,19,,37,"(4.697144,-74.140516)"
2020,Enero,Finlandia,246,2,1,,3,"(6.171601,-75.427454)"
2020,Enero,Francia,250,14,10,,24,"(10.445761,-75.516429)"
2020,Enero,Francia,250,7,0,,7,"(10.886611,-74.776708)"
2020,Enero,Francia,250,126,76,,202,"(3.541112,-76.384584)"
2020,Enero,Francia,250,2145,1595,,3740,"(4.697144,-74.140516)"
2020,Enero,Francia,250,13,11,,24,"(4.815061,-75.736532)"
2020,Enero,Francia,250,189,124,,313,"(6.171601,-75.427454)"
2020,Enero,Francia,250,3,3,,6,"(7.128456,-73.183637)"
2020,Enero,Gabón,266,1,0,,1,"(4.697144,-74.140516)"
2020,Enero,Georgia,268,0,1,,1,"(3.541112,-76.384584)"
2020,Enero,Georgia,268,0,1,,1,"(4.697144,-74.140516)"
2020,Enero,Ghana,288,4,4,,8,"(4.697144,-74.140516)"
2020,Enero,Granada,308,1,0,,1,"(4.697144,-74.140516)"
2020,Enero,Grecia,300,1,0,,1,"(10.445761,-75.516429)"
2020,Enero,Grecia,300,15,2,,17,"(4.697144,-74.140516)"
2020,Enero,Grecia,300,1,1,,2,"(6.171601,-75.427454)"
2020,Enero,Guatemala,320,5,7,,12,"(10.445761,-75.516429)"
2020,Enero,Guatemala,320,16,20,,36,"(10.886611,-74.776708)"
2020,Enero,Guatemala,320,0,4,,4,"(12.586067,-81.702563)"
2020,Enero,Guatemala,320,29,50,,79,"(3.541112,-76.384584)"
2020,Enero,Guatemala,320,758,906,,1664,"(4.697144,-74.140516)"
2020,Enero,Guatemala,320,17,19,,36,"(4.815061,-75.736532)"
2020,Enero,Guatemala,320,89,113,,202,"(6.171601,-75.427454)"
2020,Enero,Guatemala,320,11,8,,19,"(7.128456,-73.183637)"
2020,Enero,Guatemala,320,0,4,,4,"(9.402978,-75.681599)"
2020,Enero,Guyana,328,0,1,,1,"(10.445761,-75.516429)"
2020,Enero,Guyana,328,2,8,,10,"(10.886611,-74.776708)"
2020,Enero,Guyana,328,1,3,,4,"(3.541112,-76.384584)"
2020,Enero,Guyana,328,3,5,,8,"(4.697144,-74.140516)"
2020,Enero,Guyana,328,3,4,,7,"(4.815061,-75.736532)"
2020,Enero,Guyana,328,1,3,,4,"(6.171601,-75.427454)"
2020,Enero,Guinea,324,0,1,,1,"(3.541112,-76.384584)"
2020,Enero,Guinea,324,0,1,,1,"(6.171601,-75.427454)"
2020,Enero,Guinea Ecuatorial,226,0,1,,1,"(3.541112,-76.384584)"
2020,Enero,Guinea Ecuatorial,226,3,2,,5,"(4.697144,-74.140516)"
2020,Enero,Guadalupe/Territorio Francés,312,2,0,,2,"(3.541112,-76.384584)"
2020,Enero,Guayana Francesa/Departamento de Ultramar Francés,254,1,0,,1,"(3.541112,-76.384584)"
2020,Enero,Guayana Francesa/Departamento de Ultramar Francés,254,4,3,,7,"(4.697144,-74.140516)"
2020,Enero,Guayana Francesa/Departamento de Ultramar Francés,254,0,3,,3,"(6.171601,-75.427454)"
2020,Enero,Haití,332,0,1,,1,"(10.445761,-75.516429)"
2020,Enero,Haití,332,1,3,,4,"(10.886611,-74.776708)"
2020,Enero,Haití,332,0,2,,2,"(3.541112,-76.384584)"
2020,Enero,Haití,332,4,1,,5,"(4.697144,-74.140516)"
2020,Enero,Haití,332,0,1,,1,"(6.171601,-75.427454)"
2020,Enero,Honduras,340,5,12,,17,"(10.445761,-75.516429)"
2020,Enero,Honduras,340,8,5,,13,"(10.886611,-74.776708)"
2020,Enero,Honduras,340,17,34,,51,"(3.541112,-76.384584)"
2020,Enero,Honduras,340,119,175,,294,"(4.697144,-74.140516)"
2020,Enero,Honduras,340,4,9,,13,"(4.815061,-75.736532)"
2020,Enero,Honduras,340,29,74,,103,"(6.171601,-75.427454)"
2020,Enero,Honduras,340,3,15,,18,"(7.128456,-73.183637)"
2020,Enero,Hong Kong,344,0,1,,1,"(10.886611,-74.776708)"
2020,Enero,Hong Kong,344,1,0,,1,"(3.541112,-76.384584)"
2020,Enero,Hong Kong,344,17,25,,42,"(4.697144,-74.140516)"
2020,Enero,Hong Kong,344,2,1,,3,"(6.171601,-75.427454)"
2020,Enero,Hong Kong,344,1,0,,1,"(7.128456,-73.183637)"
2020,Enero,Hungría,348,0,1,,1,"(10.445761,-75.516429)"
2020,Enero,Hungría,348,10,5,,15,"(3.541112,-76.384584)"
2020,Enero,Hungría,348,15,7,,22,"(4.697144,-74.140516)"
2020,Enero,India,356,0,3,,3,"(3.541112,-76.384584)"
2020,Enero,India,356,45,25,,70,"(4.697144,-74.140516)"
2020,Enero,India,356,10,7,,17,"(6.171601,-75.427454)"
2020,Enero,Indonesia,360,0,1,,1,"(3.541112,-76.384584)"
2020,Enero,Indonesia,360,7,6,,13,"(4.697144,-74.140516)"
2020,Enero,Indonesia,360,1,0,,1,"(6.171601,-75.427454)"
2020,Enero,Indonesia,360,0,1,,1,"(7.128456,-73.183637)"
2020,Enero,Iraq,368,0,4,,4,"(4.697144,-74.140516)"
2020,Enero,Iraq,368,0,1,,1,"(7.128456,-73.183637)"
2020,Enero,Irán,364,3,5,,8,"(4.697144,-74.140516)"
2020,Enero,República de Irlanda,372,0,1,,1,"(10.445761,-75.516429)"
2020,Enero,República de Irlanda,372,4,0,,4,"(3.541112,-76.384584)"
2020,Enero,República de Irlanda,372,33,23,,56,"(4.697144,-74.140516)"
2020,Enero,República de Irlanda,372,7,2,,9,"(6.171601,-75.427454)"
2020,Enero,Islandia,352,5,7,,12,"(4.697144,-74.140516)"
2020,Enero,Islandia,352,1,0,,1,"(6.171601,-75.427454)"
2020,Enero,Isla de Man,833,1,0,,1,"(6.171601,-75.427454)"
2020,Enero,Israel,376,1,0,,1,"(10.445761,-75.516429)"
2020,Enero,Israel,376,1,0,,1,"(10.886611,-74.776708)"
2020,Enero,Israel,376,14,4,,18,"(3.541112,-76.384584)"
2020,Enero,Israel,376,138,59,,197,"(4.697144,-74.140516)"
2020,Enero,Israel,376,3,0,,3,"(4.815061,-75.736532)"
2020,Enero,Israel,376,24,5,,29,"(6.171601,-75.427454)"
2020,Enero,Israel,376,1,0,,1,"(7.128456,-73.183637)"
2020,Enero,Italia,380,18,10,,28,"(10.445761,-75.516429)"
2020,Enero,Italia,380,11,10,,21,"(10.886611,-74.776708)"
2020,Enero,Italia,380,135,73,,208,"(3.541112,-76.384584)"
2020,Enero,Italia,380,779,490,,1269,"(4.697144,-74.140516)"
2020,Enero,Italia,380,7,4,,11,"(4.815061,-75.736532)"
2020,Enero,Italia,380,185,110,,295,"(6.171601,-75.427454)"
2020,Enero,Italia,380,1,0,,1,"(7.128456,-73.183637)"
2020,Enero,Jamaica,388,1,3,,4,"(10.445761,-75.516429)"
2020,Enero,Jamaica,388,0,8,,8,"(10.886611,-74.776708)"
2020,Enero,Jamaica,388,1,0,,1,"(12.586067,-81.702563)"
2020,Enero,Jamaica,388,12,9,,21,"(3.541112,-76.384584)"
2020,Enero,Jamaica,388,70,78,,148,"(4.697144,-74.140516)"
2020,Enero,Jamaica,388,9,9,,18,"(4.815061,-75.736532)"
2020,Enero,Jamaica,388,21,27,,48,"(6.171601,-75.427454)"
2020,Enero,Jamaica,388,5,8,,13,"(7.128456,-73.183637)"
2020,Enero,Japón,392,2,4,,6,"(3.541112,-76.384584)"
2020,Enero,Japón,392,50,69,,119,"(4.697144,-74.140516)"
2020,Enero,Japón,392,14,6,,20,"(6.171601,-75.427454)"
2020,Enero,Jordania,400,1,0,,1,"(3.541112,-76.384584)"
2020,Enero,Jordania,400,4,2,,6,"(4.697144,-74.140516)"
2020,Enero,Kazajistán,398,2,7,,9,"(4.697144,-74.140516)"
2020,Enero,Kenia,404,2,2,,4,"(10.445761,-75.516429)"
2020,Enero,Kenia,404,5,5,,10,"(4.697144,-74.140516)"
2020,Enero,Kenia,404,0,1,,1,"(6.171601,-75.427454)"
2020,Enero,Kuwait,414,1,0,,1,"(3.541112,-76.384584)"
2020,Enero,Kuwait,414,9,3,,12,"(4.697144,-74.140516)"
2020,Enero,Kuwait,414,0,2,,2,"(6.171601,-75.427454)"
2020,Enero,República Democrática Popular  Lao,418,1,3,,4,"(4.697144,-74.140516)"
2020,Enero,Letonia,428,0,1,,1,"(4.697144,-74.140516)"
2020,Enero,Lituania,440,0,1,,1,"(3.541112,-76.384584)"
2020,Enero,Lituania,440,1,2,,3,"(4.697144,-74.140516)"
2020,Enero,Líbano,422,2,6,,8,"(10.886611,-74.776708)"
2020,Enero,Líbano,422,1,7,,8,"(4.697144,-74.140516)"
2020,Enero,Líbano,422,1,1,,2,"(6.171601,-75.427454)"
2020,Enero,Líbano,422,0,1,,1,"(7.128456,-73.183637)"
2020,Enero,Liechtenstein,438,1,0,,1,"(4.697144,-74.140516)"
2020,Enero,Luxemburgo,442,2,0,,2,"(10.445761,-75.516429)"
2020,Enero,Luxemburgo,442,1,0,,1,"(3.541112,-76.384584)"
2020,Enero,Luxemburgo,442,16,17,,33,"(4.697144,-74.140516)"
2020,Enero,Luxemburgo,442,1,0,,1,"(4.815061,-75.736532)"
2020,Enero,Luxemburgo,442,2,2,,4,"(6.171601,-75.427454)"
2020,Enero,Malasia,458,5,7,,12,"(4.697144,-74.140516)"
2020,Enero,Malasia,458,0,1,,1,"(6.171601,-75.427454)"
2020,Enero,Malí,466,0,1,,1,"(4.697144,-74.140516)"
2020,Enero,Malta,470,0,1,,1,"(10.445761,-75.516429)"
2020,Enero,Malta,470,0,1,,1,"(3.541112,-76.384584)"
2020,Enero,Malta,470,54,32,,86,"(4.697144,-74.140516)"
2020,Enero,Malta,470,3,1,,4,"(6.171601,-75.427454)"
2020,Enero,Marruecos,504,5,3,,8,"(4.697144,-74.140516)"
2020,Enero,Marruecos,504,3,3,,6,"(6.171601,-75.427454)"
2020,Enero,Mauritania,478,0,1,,1,"(4.697144,-74.140516)"
2020,Enero,Martinica/Departamento de Ultramar Francés,474,1,0,,1,"(4.697144,-74.140516)"
2020,Enero,México,484,3,1,,4,"(0.814836,-77.662532)"
2020,Enero,México,484,365,267,,632,"(10.445761,-75.516429)"
2020,Enero,México,484,139,115,,254,"(10.886611,-74.776708)"
2020,Enero,México,484,4,5,,9,"(12.586067,-81.702563)"
2020,Enero,México,484,465,396,,861,"(3.541112,-76.384584)"
2020,Enero,México,484,20273,18003,,38276,"(4.697144,-74.140516)"
2020,Enero,México,484,118,84,,202,"(4.815061,-75.736532)"
2020,Enero,México,484,4838,3802,,8642,"(6.171601,-75.427454)"
2020,Enero,México,484,139,115,,254,"(7.128456,-73.183637)"
2020,Enero,República de Moldavia,498,0,1,,1,"(6.171601,-75.427454)"
2020,Enero,Mónaco,492,2,1,,3,"(4.697144,-74.140516)"
2020,Enero,Mongolia,496,1,2,,3,"(10.886611,-74.776708)"
2020,Enero,Mongolia,496,1,0,,1,"(4.697144,-74.140516)"
2020,Enero,Montenegro,499,1,0,,1,"(6.171601,-75.427454)"
2020,Enero,Micronesia,583,0,1,,1,"(10.445761,-75.516429)"
2020,Enero,Mozambique,508,5,4,,9,"(4.697144,-74.140516)"
2020,Enero,Myanmar,104,1,0,,1,"(4.697144,-74.140516)"
2020,Enero,Nauru,520,1,0,,1,"(4.697144,-74.140516)"
2020,Enero,Nicaragua,558,0,10,,10,"(10.408582,-75.538003)"
2020,Enero,Nicaragua,558,2,5,,7,"(10.445761,-75.516429)"
2020,Enero,Nicaragua,558,0,10,,10,"(10.886611,-74.776708)"
2020,Enero,Nicaragua,558,0,1,,1,"(12.5744111,-81.703935)"
2020,Enero,Nicaragua,558,1,3,,4,"(12.586067,-81.702563)"
2020,Enero,Nicaragua,558,9,33,,42,"(3.541112,-76.384584)"
2020,Enero,Nicaragua,558,49,103,,152,"(4.697144,-74.140516)"
2020,Enero,Nicaragua,558,3,6,,9,"(4.815061,-75.736532)"
2020,Enero,Nicaragua,558,24,58,,82,"(6.171601,-75.427454)"
2020,Enero,Nicaragua,558,3,4,,7,"(7.128456,-73.183637)"
2020,Enero,Nigeria,566,2,6,,8,"(4.697144,-74.140516)"
2020,Enero,Níger,562,1,0,,1,"(4.697144,-74.140516)"
2020,Enero,Noruega,578,2,0,,2,"(10.445761,-75.516429)"
2020,Enero,Noruega,578,1,0,,1,"(10.886611,-74.776708)"
2020,Enero,Noruega,578,6,4,,10,"(3.541112,-76.384584)"
2020,Enero,Noruega,578,54,40,,94,"(4.697144,-74.140516)"
2020,Enero,Noruega,578,8,7,,15,"(6.171601,-75.427454)"
2020,Enero,Noruega,578,1,3,,4,"(7.128456,-73.183637)"
2020,Enero,Nueva Zelanda,554,0,1,,1,"(10.886611,-74.776708)"
2020,Enero,Nueva Zelanda,554,0,2,,2,"(3.541112,-76.384584)"
2020,Enero,Nueva Zelanda,554,84,58,,142,"(4.697144,-74.140516)"
2020,Enero,Nueva Zelanda,554,8,3,,11,"(6.171601,-75.427454)"
2020,Enero,Omán,512,1,0,,1,"(10.886611,-74.776708)"
2020,Enero,Omán,512,0,1,,1,"(3.541112,-76.384584)"
2020,Enero,Omán,512,5,8,,13,"(4.697144,-74.140516)"
2020,Enero,Omán,512,0,1,,1,"(6.171601,-75.427454)"
2020,Enero,Papúa Nueva Guinea,598,0,1,,1,"(6.171601,-75.427454)"
2020,Enero,Pakistán,586,1,0,,1,"(6.171601,-75.427454)"
2020,Enero,Panamá,591,285,325,,610,"(10.408582,-75.538003)"
2020,Enero,Panamá,591,2028,1385,,3413,"(10.445761,-75.516429)"
2020,Enero,Panamá,591,911,642,,1553,"(10.886611,-74.776708)"
2020,Enero,Panamá,591,1,8,,9,"(12.5744111,-81.703935)"
2020,Enero,Panamá,591,124,129,,253,"(12.586067,-81.702563)"
2020,Enero,Panamá,591,2751,2147,,4898,"(3.541112,-76.384584)"
2020,Enero,Panamá,591,9256,9787,,19043,"(4.697144,-74.140516)"
2020,Enero,Panamá,591,435,294,,729,"(4.815061,-75.736532)"
2020,Enero,Panamá,591,2,6,,8,"(6.17134,-75.427194)"
2020,Enero,Panamá,591,3152,2851,,6003,"(6.171601,-75.427454)"
2020,Enero,Panamá,591,0,1,,1,"(6.228046,-77.404104)"
2020,Enero,Panamá,591,18,30,,48,"(7.102626,-77.762647)"
2020,Enero,Panamá,591,276,225,,501,"(7.128456,-73.183637)"
2020,Enero,Panamá,591,40,81,,121,"(8.635765,-77.346578)"
2020,Enero,Paraguay,600,0,1,,1,"(0.814836,-77.662532)"
2020,Enero,Paraguay,600,0,1,,1,"(10.445761,-75.516429)"
2020,Enero,Paraguay,600,3,5,,8,"(10.886611,-74.776708)"
2020,Enero,Paraguay,600,22,18,,40,"(3.541112,-76.384584)"
2020,Enero,Paraguay,600,219,415,,634,"(4.697144,-74.140516)"
2020,Enero,Paraguay,600,0,2,,2,"(4.815061,-75.736532)"
2020,Enero,Paraguay,600,44,45,,89,"(6.171601,-75.427454)"
2020,Enero,Paraguay,600,2,2,,4,"(7.128456,-73.183637)"
2020,Enero,Perú,604,6,22,,28,"(-0.193180,-74.784874)"
2020,Enero,Perú,604,4,8,,12,"(-4.197703,-69.941278)"
2020,Enero,Perú,604,232,274,,506,"(-4.223468,-69.945098)"
2020,Enero,Perú,604,4,2,,6,"(0.25129,-76.875963)"
2020,Enero,Perú,604,217,314,,531,"(0.814836,-77.662532)"
2020,Enero,Perú,604,0,3,,3,"(1.813928,-78.763924)"
2020,Enero,Perú,604,211,169,,380,"(10.445761,-75.516429)"
2020,Enero,Perú,604,13,5,,18,"(10.886611,-74.776708)"
2020,Enero,Perú,604,1,2,,3,"(12.586067,-81.702563)"
2020,Enero,Perú,604,144,152,,296,"(3.541112,-76.384584)"
2020,Enero,Perú,604,6947,7140,,14088,"(4.697144,-74.140516)"
2020,Enero,Perú,604,7,5,,12,"(4.815061,-75.736532)"
2020,Enero,Perú,604,991,883,,1874,"(6.171601,-75.427454)"
2020,Enero,Perú,604,7,1,,8,"(7.128456,-73.183637)"
2020,Enero,Polonia,616,0,1,,1,"(10.445761,-75.516429)"
2020,Enero,Polonia,616,1,0,,1,"(3.541112,-76.384584)"
2020,Enero,Polonia,616,8,17,,25,"(4.697144,-74.140516)"
2020,Enero,Polonia,616,2,0,,2,"(6.171601,-75.427454)"
2020,Enero,Portugal,620,1,0,,1,"(10.886611,-74.776708)"
2020,Enero,Portugal,620,8,10,,18,"(3.541112,-76.384584)"
2020,Enero,Portugal,620,87,86,,173,"(4.697144,-74.140516)"
2020,Enero,Portugal,620,1,1,,2,"(4.815061,-75.736532)"
2020,Enero,Portugal,620,29,27,,56,"(6.171601,-75.427454)"
2020,Enero,Puerto Rico/Territorio de Estados Unidos,630,10,9,,19,"(10.445761,-75.516429)"
2020,Enero,Puerto Rico/Territorio de Estados Unidos,630,14,16,,30,"(10.886611,-74.776708)"
2020,Enero,Puerto Rico/Territorio de Estados Unidos,630,0,2,,2,"(12.586067,-81.702563)"
2020,Enero,Puerto Rico/Territorio de Estados Unidos,630,38,22,,60,"(3.541112,-76.384584)"
2020,Enero,Puerto Rico/Territorio de Estados Unidos,630,544,559,,1103,"(4.697144,-74.140516)"
2020,Enero,Puerto Rico/Territorio de Estados Unidos,630,6,3,,9,"(4.815061,-75.736532)"
2020,Enero,Puerto Rico/Territorio de Estados Unidos,630,63,44,,107,"(6.171601,-75.427454)"
2020,Enero,Puerto Rico/Territorio de Estados Unidos,630,6,8,,14,"(7.128456,-73.183637)"
2020,Enero,Qatar,634,2,0,,2,"(3.541112,-76.384584)"
2020,Enero,Qatar,634,25,15,,40,"(4.697144,-74.140516)"
2020,Enero,Qatar,634,8,12,,20,"(6.171601,-75.427454)"
2020,Enero,Reino Unido de Gran Bretaña e Irlanda del Norte,826,5,5,,10,"(10.445761,-75.516429)"
2020,Enero,Reino Unido de Gran Bretaña e Irlanda del Norte,826,9,6,,15,"(10.886611,-74.776708)"
2020,Enero,Reino Unido de Gran Bretaña e Irlanda del Norte,826,123,116,,239,"(3.541112,-76.384584)"
2020,Enero,Reino Unido de Gran Bretaña e Irlanda del Norte,826,2218,1878,,4096,"(4.697144,-74.140516)"
2020,Enero,Reino Unido de Gran Bretaña e Irlanda del Norte,826,5,4,,9,"(4.815061,-75.736532)"
2020,Enero,Reino Unido de Gran Bretaña e Irlanda del Norte,826,151,108,,259,"(6.171601,-75.427454)"
2020,Enero,República CentroÁfricana,140,1,1,,2,"(4.697144,-74.140516)"
2020,Enero,Federación de Rusia,643,0,1,,1,"(10.445761,-75.516429)"
2020,Enero,Federación de Rusia,643,0,2,,2,"(10.886611,-74.776708)"
2020,Enero,Federación de Rusia,643,0,1,,1,"(3.541112,-76.384584)"
2020,Enero,Federación de Rusia,643,32,30,,62,"(4.697144,-74.140516)"
2020,Enero,Federación de Rusia,643,2,2,,4,"(6.171601,-75.427454)"
2020,Enero,República Dominicana,214,13,20,,33,"(10.445761,-75.516429)"
2020,Enero,República Dominicana,214,31,36,,67,"(10.886611,-74.776708)"
2020,Enero,República Dominicana,214,0,2,,2,"(11.117806,-74.232622)"
2020,Enero,República Dominicana,214,0,2,,2,"(12.586067,-81.702563)"
2020,Enero,República Dominicana,214,120,105,,225,"(3.541112,-76.384584)"
2020,Enero,República Dominicana,214,4469,4104,,8573,"(4.697144,-74.140516)"
2020,Enero,República Dominicana,214,28,30,,58,"(4.815061,-75.736532)"
2020,Enero,República Dominicana,214,496,416,,912,"(6.171601,-75.427454)"
2020,Enero,República Dominicana,214,54,57,,111,"(7.128456,-73.183637)"
2020,Enero,Reunión,638,2,0,,2,"(4.697144,-74.140516)"
2020,Enero,Rumania,642,6,4,,10,"(4.697144,-74.140516)"
2020,Enero,Rumania,642,3,0,,3,"(6.171601,-75.427454)"
2020,Enero,Rwanda,646,0,3,,3,"(4.697144,-74.140516)"
2020,Enero,San Pedro y Miquelón/territorio de Ultramar de La Unión Europea,666,1,0,,1,"(6.171601,-75.427454)"
2020,Enero,San  Vicente y las Granadinas,670,0,2,,2,"(10.408582,-75.538003)"
2020,Enero,San  Vicente y las Granadinas,670,0,1,,1,"(3.541112,-76.384584)"
2020,Enero,San  Vicente y las Granadinas,670,0,1,,1,"(4.697144,-74.140516)"
2020,Enero,Santa Elena/Territorio Británico de Ultramar,654,1,0,,1,"(10.445761,-75.516429)"
2020,Enero,Santa Elena/Territorio Británico de Ultramar,654,0,1,,1,"(12.586067,-81.702563)"
2020,Enero,Santa Elena/Territorio Británico de Ultramar,654,1,0,,1,"(4.697144,-74.140516)"
2020,Enero,Santa Lucia,662,1,0,,1,"(4.697144,-74.140516)"
2020,Enero,Senegal,686,1,3,,4,"(4.697144,-74.140516)"
2020,Enero,Serbia,688,0,1,,1,"(4.697144,-74.140516)"
2020,Enero,Singapur,702,1,1,,2,"(10.445761,-75.516429)"
2020,Enero,Singapur,702,0,1,,1,"(10.886611,-74.776708)"
2020,Enero,Singapur,702,0,2,,2,"(3.541112,-76.384584)"
2020,Enero,Singapur,702,21,17,,38,"(4.697144,-74.140516)"
2020,Enero,Singapur,702,1,0,,1,"(4.815061,-75.736532)"
2020,Enero,Singapur,702,4,3,,7,"(6.171601,-75.427454)"
2020,Enero,Somalia,706,0,1,,1,"(4.697144,-74.140516)"
2020,Enero,Sri Lanka,144,2,1,,3,"(4.697144,-74.140516)"
2020,Enero,Sudáfrica,710,0,1,,1,"(3.541112,-76.384584)"
2020,Enero,Sudáfrica,710,8,14,,22,"(4.697144,-74.140516)"
2020,Enero,Sudáfrica,710,1,2,,3,"(6.171601,-75.427454)"
2020,Enero,Sudán,736,0,1,,1,"(4.697144,-74.140516)"
2020,Enero,Suecia,752,0,1,,1,"(0.814836,-77.662532)"
2020,Enero,Suecia,752,5,7,,12,"(10.445761,-75.516429)"
2020,Enero,Suecia,752,3,5,,8,"(10.886611,-74.776708)"
2020,Enero,Suecia,752,22,23,,45,"(3.541112,-76.384584)"
2020,Enero,Suecia,752,163,149,,312,"(4.697144,-74.140516)"
2020,Enero,Suecia,752,6,4,,10,"(4.815061,-75.736532)"
2020,Enero,Suecia,752,38,31,,69,"(6.171601,-75.427454)"
2020,Enero,Suecia,752,1,0,,1,"(7.128456,-73.183637)"
2020,Enero,Suiza,756,9,5,,14,"(10.445761,-75.516429)"
2020,Enero,Suiza,756,1,1,,2,"(10.886611,-74.776708)"
2020,Enero,Suiza,756,0,1,,1,"(12.586067,-81.702563)"
2020,Enero,Suiza,756,104,43,,147,"(3.541112,-76.384584)"
2020,Enero,Suiza,756,487,305,,792,"(4.697144,-74.140516)"
2020,Enero,Suiza,756,3,4,,7,"(4.815061,-75.736532)"
2020,Enero,Suiza,756,75,42,,117,"(6.171601,-75.427454)"
2020,Enero,Suiza,756,0,1,,1,"(7.128456,-73.183637)"
2020,Enero,Surinam,740,0,6,,6,"(10.408582,-75.538003)"
2020,Enero,Surinam,740,0,3,,3,"(10.886611,-74.776708)"
2020,Enero,Surinam,740,3,109,,112,"(3.541112,-76.384584)"
2020,Enero,Surinam,740,4,8,,12,"(4.697144,-74.140516)"
2020,Enero,Surinam,740,2,1,,3,"(6.171601,-75.427454)"
2020,Enero,Taiwán,158,3,2,,5,"(4.697144,-74.140516)"
2020,Enero,Taiwán,158,0,2,,2,"(6.171601,-75.427454)"
2020,Enero,Tailandia,764,0,1,,1,"(10.445761,-75.516429)"
2020,Enero,Tailandia,764,1,1,,2,"(3.541112,-76.384584)"
2020,Enero,Tailandia,764,20,17,,37,"(4.697144,-74.140516)"
2020,Enero,Tailandia,764,5,2,,7,"(6.171601,-75.427454)"
2020,Enero,Tanzania,834,1,1,,2,"(4.697144,-74.140516)"
2020,Enero,Tanzania,834,1,1,,2,"(6.171601,-75.427454)"
2020,Enero,República Democrática de Timor Oriental,626,2,1,,3,"(4.697144,-74.140516)"
2020,Enero,Togo,768,0,1,,1,"(7.128456,-73.183637)"
2020,Enero,Trinidad y Tobago,780,1,3,,4,"(10.445761,-75.516429)"
2020,Enero,Trinidad y Tobago,780,2,5,,7,"(10.886611,-74.776708)"
2020,Enero,Trinidad y Tobago,780,1,1,,2,"(12.586067,-81.702563)"
2020,Enero,Trinidad y Tobago,780,4,25,,29,"(3.541112,-76.384584)"
2020,Enero,Trinidad y Tobago,780,14,32,,46,"(4.697144,-74.140516)"
2020,Enero,Trinidad y Tobago,780,1,9,,10,"(4.815061,-75.736532)"
2020,Enero,Trinidad y Tobago,780,7,3,,10,"(6.171601,-75.427454)"
2020,Enero,Trinidad y Tobago,780,2,1,,3,"(7.128456,-73.183637)"
2020,Enero,Túnez,788,0,3,,3,"(4.697144,-74.140516)"
2020,Enero,Turquía,792,0,1,,1,"(10.886611,-74.776708)"
2020,Enero,Turquía,792,2,1,,3,"(3.541112,-76.384584)"
2020,Enero,Turquía,792,630,482,,1112,"(4.697144,-74.140516)"
2020,Enero,Turquía,792,8,7,,15,"(6.171601,-75.427454)"
2020,Enero,Turquía,792,0,1,,1,"(7.128456,-73.183637)"
2020,Enero,Turkmenistán,795,1,3,,4,"(4.697144,-74.140516)"
2020,Enero,Ucrania,804,1,0,,1,"(3.541112,-76.384584)"
2020,Enero,Ucrania,804,0,2,,2,"(4.697144,-74.140516)"
2020,Enero,Ucrania,804,0,1,,1,"(6.171601,-75.427454)"
2020,Enero,Uganda,800,0,1,,1,"(4.697144,-74.140516)"
2020,Enero,Uruguay,858,4,2,,6,"(10.445761,-75.516429)"
2020,Enero,Uruguay,858,3,0,,3,"(10.886611,-74.776708)"
2020,Enero,Uruguay,858,16,18,,34,"(3.541112,-76.384584)"
2020,Enero,Uruguay,858,1,3,,4,"(4.452882,-75.766298)"
2020,Enero,Uruguay,858,332,380,,712,"(4.697144,-74.140516)"
2020,Enero,Uruguay,858,1,9,,10,"(4.815061,-75.736532)"
2020,Enero,Uruguay,858,12,18,,30,"(6.171601,-75.427454)"
2020,Enero,Uruguay,858,1,2,,3,"(7.128456,-73.183637)"
2020,Enero,Venezuela,862,8,6,,14,"(10.445761,-75.516429)"
2020,Enero,Venezuela,862,19,20,,39,"(10.886611,-74.776708)"
2020,Enero,Venezuela,862,1810,1626,,3436,"(11.360009,-72.129330)"
2020,Enero,Venezuela,862,307,214,,521,"(3.541112,-76.384584)"
2020,Enero,Venezuela,862,3,4,,7,"(3.866713,-67.927521)"
2020,Enero,Venezuela,862,806,792,,1598,"(4.697144,-74.140516)"
2020,Enero,Venezuela,862,6,11,,17,"(4.815061,-75.736532)"
2020,Enero,Venezuela,862,289,316,,605,"(6.171601,-75.427454)"
2020,Enero,Venezuela,862,15,19,,34,"(6.185799,-67.483929)"
2020,Enero,Venezuela,862,248,260,,508,"(7.088729,-70.740253)"
2020,Enero,Venezuela,862,2,1,,3,"(7.128456,-73.183637)"
2020,Enero,Venezuela,862,1343,1434,,2777,"(7.818934,-72.453226)"
2020,Enero,Venezuela,862,1,3,,4,"(7.927209,-72.507910)"
2020,Enero,Venezuela,862,128,148,,276,"(8.36068,-72.409396)"
2020,Enero,Vietnam,704,1,1,,2,"(3.541112,-76.384584)"
2020,Enero,Vietnam,704,2,3,,5,"(4.697144,-74.140516)"
2020,Enero,Vietnam,704,1,1,,2,"(6.171601,-75.427454)"
2020,Enero,Islas Vírgenes Británicas/Territorio Británico de Ultramar,92,0,1,,1,"(3.541112,-76.384584)"
2020,Enero,Islas Vírgenes Británicas/Territorio Británico de Ultramar,92,1,1,,2,"(4.697144,-74.140516)"
2020,Enero,Islas Vírgenes Británicas/Territorio Británico de Ultramar,92,0,4,,4,"(6.171601,-75.427454)"
2020,Enero,República Árabe de Yemen,887,1,0,,1,"(4.697144,-74.140516)"
2020,Enero,Zambia,894,0,1,,1,"(4.697144,-74.140516)"
2020,Febrero,Afganistán,4,5,5,,10,"(4.697144,-74.140516)"
2020,Febrero,Albania,8,1,0,,1,"(10.445761,-75.516429)"
2020,Febrero,Albania,8,1,1,,2,"(4.697144,-74.140516)"
2020,Febrero,Alemania,276,5,1,,6,"(10.445761,-75.516429)"
2020,Febrero,Alemania,276,8,2,,10,"(10.886611,-74.776708)"
2020,Febrero,Alemania,276,48,33,,81,"(3.541112,-76.384584)"
2020,Febrero,Alemania,276,1360,1272,,2632,"(4.697144,-74.140516)"
2020,Febrero,Alemania,276,1,0,,1,"(4.815061,-75.736532)"
2020,Febrero,Alemania,276,84,79,,163,"(6.171601,-75.427454)"
2020,Febrero,Alemania,276,0,2,,2,"(7.128456,-73.183637)"
2020,Febrero,Andorra,20,0,1,,1,"(10.445761,-75.516429)"
2020,Febrero,Andorra,20,1,1,,2,"(4.697144,-74.140516)"
2020,Febrero,Angola,24,2,4,,6,"(4.697144,-74.140516)"
2020,Febrero,Angola,24,0,1,,1,"(7.128456,-73.183637)"
2020,Febrero,Antigua y Barbuda,28,0,1,,1,"(3.541112,-76.384584)"
2020,Febrero,Antigua y Barbuda,28,2,0,,2,"(4.697144,-74.140516)"
2020,Febrero,Antigua y Barbuda,28,2,0,,2,"(4.815061,-75.736532)"
2020,Febrero,Antigua y Barbuda,28,1,0,,1,"(6.171601,-75.427454)"
2020,Febrero,Países Bajos,528,0,8,,8,"(10.408582,-75.538003)"
2020,Febrero,Países Bajos,528,143,95,,238,"(10.445761,-75.516429)"
2020,Febrero,Países Bajos,528,31,28,,59,"(10.886611,-74.776708)"
2020,Febrero,Países Bajos,528,46,22,,68,"(3.541112,-76.384584)"
2020,Febrero,Países Bajos,528,595,592,,1187,"(4.697144,-74.140516)"
2020,Febrero,Países Bajos,528,7,3,,10,"(4.815061,-75.736532)"
2020,Febrero,Países Bajos,528,84,59,,143,"(6.171601,-75.427454)"
2020,Febrero,Países Bajos,528,1,0,,1,"(7.128456,-73.183637)"
2020,Febrero,Arabia Saudita,682,4,4,,8,"(10.445761,-75.516429)"
2020,Febrero,Arabia Saudita,682,8,22,,30,"(4.697144,-74.140516)"
2020,Febrero,Arabia Saudita,682,2,4,,6,"(6.171601,-75.427454)"
2020,Febrero,Argelia,12,1,0,,1,"(0.814836,-77.662532)"
2020,Febrero,Argelia,12,1,0,,1,"(4.697144,-74.140516)"
2020,Febrero,Argentina,32,0,11,,11,"(0.25129,-76.875963)"
2020,Febrero,Argentina,32,0,1,,1,"(0.812436,-77.847006)"
2020,Febrero,Argentina,32,29,68,,97,"(0.814836,-77.662532)"
2020,Febrero,Argentina,32,1,1,,2,"(1.813928,-78.763924)"
2020,Febrero,Argentina,32,24,16,,40,"(10.445761,-75.516429)"
2020,Febrero,Argentina,32,37,36,,73,"(10.886611,-74.776708)"
2020,Febrero,Argentina,32,2,0,,2,"(12.586067,-81.702563)"
2020,Febrero,Argentina,32,192,177,,369,"(3.541112,-76.384584)"
2020,Febrero,Argentina,32,2974,2623,,5597,"(4.697144,-74.140516)"
2020,Febrero,Argentina,32,9,12,,21,"(4.815061,-75.736532)"
2020,Febrero,Argentina,32,185,224,,409,"(6.171601,-75.427454)"
2020,Febrero,Argentina,32,1,6,,7,"(7.128456,-73.183637)"
2020,Febrero,República de Armenia,51,0,1,,1,"(3.541112,-76.384584)"
2020,Febrero,República de Armenia,51,1,1,,2,"(4.697144,-74.140516)"
2020,Febrero,República de Armenia,51,0,1,,1,"(6.171601,-75.427454)"
2020,Febrero,Aruba,533,1989,1460,,3449,"(10.408582,-75.538003)"
2020,Febrero,Aruba,533,5,6,,11,"(10.445761,-75.516429)"
2020,Febrero,Aruba,533,106,68,,174,"(10.886611,-74.776708)"
2020,Febrero,Aruba,533,0,2,,2,"(11.247723,-74.213989)"
2020,Febrero,Aruba,533,12,23,,35,"(11.528919,-72.919681)"
2020,Febrero,Aruba,533,18,19,,37,"(3.541112,-76.384584)"
2020,Febrero,Aruba,533,956,778,,1734,"(4.697144,-74.140516)"
2020,Febrero,Aruba,533,12,8,,20,"(4.815061,-75.736532)"
2020,Febrero,Aruba,533,71,53,,124,"(6.171601,-75.427454)"
2020,Febrero,Aruba,533,6,4,,10,"(7.128456,-73.183637)"
2020,Febrero,Australia,36,1,2,,3,"(10.445761,-75.516429)"
2020,Febrero,Australia,36,2,1,,3,"(10.886611,-74.776708)"
2020,Febrero,Australia,36,14,15,,29,"(3.541112,-76.384584)"
2020,Febrero,Australia,36,592,447,,1039,"(4.697144,-74.140516)"
2020,Febrero,Australia,36,66,71,,137,"(6.171601,-75.427454)"
2020,Febrero,Australia,36,2,1,,3,"(7.128456,-73.183637)"
2020,Febrero,Austria,40,0,1,,1,"(10.445761,-75.516429)"
2020,Febrero,Austria,40,1,0,,1,"(10.886611,-74.776708)"
2020,Febrero,Austria,40,5,2,,7,"(3.541112,-76.384584)"
2020,Febrero,Austria,40,23,32,,55,"(4.697144,-74.140516)"
2020,Febrero,Austria,40,6,6,,12,"(6.171601,-75.427454)"
2020,Febrero,Bahamas,44,3,0,,3,"(10.445761,-75.516429)"
2020,Febrero,Bahamas,44,2,2,,4,"(10.886611,-74.776708)"
2020,Febrero,Bahamas,44,23,4,,27,"(3.541112,-76.384584)"
2020,Febrero,Bahamas,44,29,24,,53,"(4.697144,-74.140516)"
2020,Febrero,Bahamas,44,8,6,,14,"(4.815061,-75.736532)"
2020,Febrero,Bahamas,44,36,14,,50,"(6.171601,-75.427454)"
2020,Febrero,Bahréin,48,2,5,,7,"(4.697144,-74.140516)"
2020,Febrero,Bahréin,48,2,0,,2,"(7.128456,-73.183637)"
2020,Febrero,Bangladesh,50,0,1,,1,"(4.697144,-74.140516)"
2020,Febrero,Barbados,52,2,5,,7,"(3.541112,-76.384584)"
2020,Febrero,Barbados,52,4,3,,7,"(4.697144,-74.140516)"
2020,Febrero,Barbados,52,2,7,,9,"(4.815061,-75.736532)"
2020,Febrero,Barbados,52,1,2,,3,"(6.171601,-75.427454)"
2020,Febrero,República de Belarús,112,0,1,,1,"(11.360009,-72.129330)"
2020,Febrero,República de Belarús,112,0,1,,1,"(4.697144,-74.140516)"
2020,Febrero,Bélgica,56,0,1,,1,"(10.445761,-75.516429)"
2020,Febrero,Bélgica,56,2,1,,3,"(10.886611,-74.776708)"
2020,Febrero,Bélgica,56,13,18,,31,"(3.541112,-76.384584)"
2020,Febrero,Bélgica,56,66,46,,112,"(4.697144,-74.140516)"
2020,Febrero,Bélgica,56,0,1,,1,"(4.815061,-75.736532)"
2020,Febrero,Bélgica,56,25,14,,39,"(6.171601,-75.427454)"
2020,Febrero,Belice,84,0,1,,1,"(10.886611,-74.776708)"
2020,Febrero,Belice,84,3,0,,3,"(3.541112,-76.384584)"
2020,Febrero,Belice,84,6,6,,12,"(4.697144,-74.140516)"
2020,Febrero,Belice,84,0,2,,2,"(4.815061,-75.736532)"
2020,Febrero,Belice,84,1,0,,1,"(7.128456,-73.183637)"
2020,Febrero,Benín,204,1,0,,1,"(6.171601,-75.427454)"
2020,Febrero,Bermudas/Territorio Británico de Ultramar,60,0,1,,1,"(10.445761,-75.516429)"
2020,Febrero,Bermudas/Territorio Británico de Ultramar,60,0,3,,3,"(6.171601,-75.427454)"
2020,Febrero,Bolivia,68,2,14,,16,"(0.25129,-76.875963)"
2020,Febrero,Bolivia,68,12,42,,54,"(0.814836,-77.662532)"
2020,Febrero,Bolivia,68,0,2,,2,"(10.445761,-75.516429)"
2020,Febrero,Bolivia,68,0,2,,2,"(10.886611,-74.776708)"
2020,Febrero,Bolivia,68,3,12,,15,"(3.541112,-76.384584)"
2020,Febrero,Bolivia,68,505,813,,1318,"(4.697144,-74.140516)"
2020,Febrero,Bolivia,68,13,18,,31,"(4.815061,-75.736532)"
2020,Febrero,Bolivia,68,30,39,,69,"(6.171601,-75.427454)"
2020,Febrero,Bolivia,68,1,0,,1,"(7.128456,-73.183637)"
2020,Febrero,Bosnia y Herzegovina,70,4,7,,11,"(4.697144,-74.140516)"
2020,Febrero,Bosnia y Herzegovina,70,1,1,,2,"(6.171601,-75.427454)"
2020,Febrero,Brasil,76,185,298,,483,"(-4.197703,-69.941278)"
2020,Febrero,Brasil,76,46,67,,113,"(-4.223468,-69.945098)"
2020,Febrero,Brasil,76,1,1,,2,"(0.814836,-77.662532)"
2020,Febrero,Brasil,76,13,18,,31,"(10.445761,-75.516429)"
2020,Febrero,Brasil,76,12,29,,41,"(10.886611,-74.776708)"
2020,Febrero,Brasil,76,148,223,,371,"(3.541112,-76.384584)"
2020,Febrero,Brasil,76,2729,3672,,6401,"(4.697144,-74.140516)"
2020,Febrero,Brasil,76,49,100,,149,"(4.815061,-75.736532)"
2020,Febrero,Brasil,76,186,276,,462,"(6.171601,-75.427454)"
2020,Febrero,Brasil,76,7,5,,12,"(7.128456,-73.183637)"
2020,Febrero,Bulgaria,100,1,3,,4,"(4.697144,-74.140516)"
2020,Febrero,Bulgaria,100,0,1,,1,"(6.171601,-75.427454)"
2020,Febrero,Islas Caimán/Territorio Británico de Ultramar,136,0,1,,1,"(10.445761,-75.516429)"
2020,Febrero,Islas Caimán/Territorio Británico de Ultramar,136,0,1,,1,"(10.886611,-74.776708)"
2020,Febrero,Islas Caimán/Territorio Británico de Ultramar,136,5,0,,5,"(12.586067,-81.702563)"
2020,Febrero,Islas Caimán/Territorio Británico de Ultramar,136,0,1,,1,"(3.541112,-76.384584)"
2020,Febrero,Islas Caimán/Territorio Británico de Ultramar,136,3,2,,5,"(4.697144,-74.140516)"
2020,Febrero,Islas Caimán/Territorio Británico de Ultramar,136,1,0,,1,"(6.171601,-75.427454)"
2020,Febrero,Camboya,116,0,1,,1,"(4.697144,-74.140516)"
2020,Febrero,Camerún,120,3,2,,5,"(4.697144,-74.140516)"
2020,Febrero,Canadá,124,311,231,,542,"(10.445761,-75.516429)"
2020,Febrero,Canadá,124,17,18,,35,"(10.886611,-74.776708)"
2020,Febrero,Canadá,124,7,6,,13,"(12.586067,-81.702563)"
2020,Febrero,Canadá,124,138,112,,250,"(3.541112,-76.384584)"
2020,Febrero,Canadá,124,2,4,,6,"(4.452882,-75.766298)"
2020,Febrero,Canadá,124,2138,1856,,3994,"(4.697144,-74.140516)"
2020,Febrero,Canadá,124,36,18,,54,"(4.815061,-75.736532)"
2020,Febrero,Canadá,124,265,222,,487,"(6.171601,-75.427454)"
2020,Febrero,Canadá,124,11,6,,17,"(7.128456,-73.183637)"
2020,Febrero,España,724,0,1,,1,"(0.814836,-77.662532)"
2020,Febrero,España,724,23,13,,36,"(10.445761,-75.516429)"
2020,Febrero,España,724,10,11,,21,"(10.886611,-74.776708)"
2020,Febrero,España,724,2769,1854,,4623,"(3.541112,-76.384584)"
2020,Febrero,España,724,13707,11224,,24931,"(4.697144,-74.140516)"
2020,Febrero,España,724,48,41,,89,"(4.815061,-75.736532)"
2020,Febrero,España,724,2802,2293,,5095,"(6.171601,-75.427454)"
2020,Febrero,España,724,2,1,,3,"(7.128456,-73.183637)"
2020,Febrero,Colombia,170,2,10,,12,"(10.445761,-75.516429)"
2020,Febrero,Colombia,170,180,522,,702,"(4.697144,-74.140516)"
2020,Febrero,República de Corea,410,17,10,,27,"(4.697144,-74.140516)"
2020,Febrero,República de Corea,410,3,1,,4,"(6.171601,-75.427454)"
2020,Febrero,Costa de Marfil,384,2,0,,2,"(4.697144,-74.140516)"
2020,Febrero,Costa de Marfil,384,0,1,,1,"(6.171601,-75.427454)"
2020,Febrero,Costa Rica,188,0,2,,2,"(10.408582,-75.538003)"
2020,Febrero,Costa Rica,188,6,5,,11,"(10.445761,-75.516429)"
2020,Febrero,Costa Rica,188,20,18,,38,"(10.886611,-74.776708)"
2020,Febrero,Costa Rica,188,2,17,,19,"(12.5744111,-81.703935)"
2020,Febrero,Costa Rica,188,5,9,,14,"(12.586067,-81.702563)"
2020,Febrero,Costa Rica,188,78,71,,149,"(3.541112,-76.384584)"
2020,Febrero,Costa Rica,188,1044,1208,,2252,"(4.697144,-74.140516)"
2020,Febrero,Costa Rica,188,21,17,,38,"(4.815061,-75.736532)"
2020,Febrero,Costa Rica,188,3,6,,9,"(6.17134,-75.427194)"
2020,Febrero,Costa Rica,188,137,153,,290,"(6.171601,-75.427454)"
2020,Febrero,Costa Rica,188,8,4,,12,"(7.128456,-73.183637)"
2020,Febrero,Croacia,191,1,0,,1,"(10.445761,-75.516429)"
2020,Febrero,Croacia,191,6,5,,11,"(4.697144,-74.140516)"
2020,Febrero,Cuba,192,3,3,,6,"(10.445761,-75.516429)"
2020,Febrero,Cuba,192,11,13,,24,"(10.886611,-74.776708)"
2020,Febrero,Cuba,192,33,44,,77,"(3.541112,-76.384584)"
2020,Febrero,Cuba,192,946,813,,1759,"(4.697144,-74.140516)"
2020,Febrero,Cuba,192,11,10,,21,"(4.815061,-75.736532)"
2020,Febrero,Cuba,192,80,65,,145,"(6.171601,-75.427454)"
2020,Febrero,Cuba,192,5,2,,7,"(7.128456,-73.183637)"
2020,Febrero,Curazao,99999,2,2,,4,"(10.445761,-75.516429)"
2020,Febrero,Curazao,99999,22,6,,28,"(10.886611,-74.776708)"
2020,Febrero,Curazao,99999,0,1,,1,"(12.586067,-81.702563)"
2020,Febrero,Curazao,99999,6,3,,9,"(3.541112,-76.384584)"
2020,Febrero,Curazao,99999,1609,1240,,2849,"(4.697144,-74.140516)"
2020,Febrero,Curazao,99999,6,1,,7,"(6.171601,-75.427454)"
2020,Febrero,Curazao,99999,1,0,,1,"(7.128456,-73.183637)"
2020,Febrero,República Checa,203,1,0,,1,"(12.586067,-81.702563)"
2020,Febrero,República Checa,203,0,1,,1,"(3.541112,-76.384584)"
2020,Febrero,República Checa,203,6,8,,14,"(4.697144,-74.140516)"
2020,Febrero,República Checa,203,0,3,,3,"(6.171601,-75.427454)"
2020,Febrero,Chile,152,0,3,,3,"(0.25129,-76.875963)"
2020,Febrero,Chile,152,274,264,,538,"(0.814836,-77.662532)"
2020,Febrero,Chile,152,2,4,,6,"(1.813928,-78.763924)"
2020,Febrero,Chile,152,17,23,,40,"(10.445761,-75.516429)"
2020,Febrero,Chile,152,48,24,,72,"(10.886611,-74.776708)"
2020,Febrero,Chile,152,1338,768,,2106,"(3.541112,-76.384584)"
2020,Febrero,Chile,152,4567,3655,,8223,"(4.697144,-74.140516)"
2020,Febrero,Chile,152,53,28,,81,"(4.815061,-75.736532)"
2020,Febrero,Chile,152,215,149,,364,"(6.171601,-75.427454)"
2020,Febrero,Chile,152,13,12,,25,"(7.128456,-73.183637)"
2020,Febrero,China,156,0,2,,2,"(3.541112,-76.384584)"
2020,Febrero,China,156,9,33,,42,"(4.697144,-74.140516)"
2020,Febrero,China,156,1,0,,1,"(6.171601,-75.427454)"
2020,Febrero,Dinamarca,208,1,0,,1,"(10.445761,-75.516429)"
2020,Febrero,Dinamarca,208,1,0,,1,"(10.886611,-74.776708)"
2020,Febrero,Dinamarca,208,29,12,,41,"(4.697144,-74.140516)"
2020,Febrero,Dinamarca,208,5,2,,7,"(6.171601,-75.427454)"
2020,Febrero,Dominica,212,0,1,,1,"(3.541112,-76.384584)"
2020,Febrero,Ecuador,218,4,7,,11,"(-0.193180,-74.784874)"
2020,Febrero,Ecuador,218,586,1049,,1635,"(0.25129,-76.875963)"
2020,Febrero,Ecuador,218,24,39,,63,"(0.812436,-77.847006)"
2020,Febrero,Ecuador,218,5523,7207,,12731,"(0.814836,-77.662532)"
2020,Febrero,Ecuador,218,131,171,,302,"(1.813928,-78.763924)"
2020,Febrero,Ecuador,218,4,12,,16,"(10.445761,-75.516429)"
2020,Febrero,Ecuador,218,6,15,,21,"(10.886611,-74.776708)"
2020,Febrero,Ecuador,218,248,381,,629,"(3.541112,-76.384584)"
2020,Febrero,Ecuador,218,2592,4071,,6663,"(4.697144,-74.140516)"
2020,Febrero,Ecuador,218,2,5,,7,"(4.815061,-75.736532)"
2020,Febrero,Ecuador,218,46,82,,128,"(6.171601,-75.427454)"
2020,Febrero,Ecuador,218,1,3,,4,"(7.128456,-73.183637)"
2020,Febrero,Egipto,818,15,9,,24,"(4.697144,-74.140516)"
2020,Febrero,Egipto,818,5,2,,7,"(6.171601,-75.427454)"
2020,Febrero,El Salvador,222,1,0,,1,"(10.445761,-75.516429)"
2020,Febrero,El Salvador,222,2,0,,2,"(10.886611,-74.776708)"
2020,Febrero,El Salvador,222,8,9,,17,"(3.541112,-76.384584)"
2020,Febrero,El Salvador,222,863,1184,,2047,"(4.697144,-74.140516)"
2020,Febrero,El Salvador,222,1,0,,1,"(4.815061,-75.736532)"
2020,Febrero,El Salvador,222,14,20,,34,"(6.171601,-75.427454)"
2020,Febrero,Emiratos Árabes,784,0,1,,1,"(10.445761,-75.516429)"
2020,Febrero,Emiratos Árabes,784,4,6,,10,"(3.541112,-76.384584)"
2020,Febrero,Emiratos Árabes,784,108,210,,318,"(4.697144,-74.140516)"
2020,Febrero,Emiratos Árabes,784,15,11,,26,"(6.171601,-75.427454)"
2020,Febrero,Eritrea,232,1,0,,1,"(4.697144,-74.140516)"
2020,Febrero,Eslovaquia,703,2,3,,5,"(4.697144,-74.140516)"
2020,Febrero,Eslovenia,705,1,1,,2,"(4.697144,-74.140516)"
2020,Febrero,Estados Unidos de América,840,0,1,,1,"(10.408582,-75.538003)"
2020,Febrero,Estados Unidos de América,840,2585,2137,,4722,"(10.445761,-75.516429)"
2020,Febrero,Estados Unidos de América,840,2588,2068,,4656,"(10.886611,-74.776708)"
2020,Febrero,Estados Unidos de América,840,0,1,,1,"(10.971302,-74.765397)"
2020,Febrero,Estados Unidos de América,840,28,18,,46,"(12.586067,-81.702563)"
2020,Febrero,Estados Unidos de América,840,5375,4122,,9497,"(3.541112,-76.384584)"
2020,Febrero,Estados Unidos de América,840,780,654,,1434,"(4.452882,-75.766298)"
2020,Febrero,Estados Unidos de América,840,26604,24031,,50639,"(4.697144,-74.140516)"
2020,Febrero,Estados Unidos de América,840,993,689,,1682,"(4.815061,-75.736532)"
2020,Febrero,Estados Unidos de América,840,9510,7962,,17472,"(6.171601,-75.427454)"
2020,Febrero,Estados Unidos de América,840,131,112,,243,"(7.128456,-73.183637)"
2020,Febrero,Estonia,233,1,1,,2,"(4.697144,-74.140516)"
2020,Febrero,Etiopia,231,1,4,,5,"(4.697144,-74.140516)"
2020,Febrero,Etiopia,231,3,1,,4,"(6.171601,-75.427454)"
2020,Febrero,Filipinas,608,3,8,,11,"(4.697144,-74.140516)"
2020,Febrero,Finlandia,246,6,8,,14,"(4.697144,-74.140516)"
2020,Febrero,Finlandia,246,4,1,,5,"(6.171601,-75.427454)"
2020,Febrero,Francia,250,5,4,,9,"(10.445761,-75.516429)"
2020,Febrero,Francia,250,4,6,,10,"(10.886611,-74.776708)"
2020,Febrero,Francia,250,70,38,,108,"(3.541112,-76.384584)"
2020,Febrero,Francia,250,1265,1052,,2317,"(4.697144,-74.140516)"
2020,Febrero,Francia,250,6,8,,14,"(4.815061,-75.736532)"
2020,Febrero,Francia,250,112,61,,173,"(6.171601,-75.427454)"
2020,Febrero,Gabón,266,0,2,,2,"(6.171601,-75.427454)"
2020,Febrero,Georgia,268,0,1,,1,"(4.697144,-74.140516)"
2020,Febrero,Georgia,268,1,0,,1,"(6.171601,-75.427454)"
2020,Febrero,Ghana,288,2,1,,3,"(4.697144,-74.140516)"
2020,Febrero,Grecia,300,0,1,,1,"(10.445761,-75.516429)"
2020,Febrero,Grecia,300,1,0,,1,"(3.541112,-76.384584)"
2020,Febrero,Grecia,300,7,7,,14,"(4.697144,-74.140516)"
2020,Febrero,Grecia,300,2,1,,3,"(6.171601,-75.427454)"
2020,Febrero,Groenlandia,304,0,1,,1,"(4.697144,-74.140516)"
2020,Febrero,Guatemala,320,0,2,,2,"(1.813928,-78.763924)"
2020,Febrero,Guatemala,320,7,3,,10,"(10.445761,-75.516429)"
2020,Febrero,Guatemala,320,13,12,,25,"(10.886611,-74.776708)"
2020,Febrero,Guatemala,320,1,0,,1,"(12.586067,-81.702563)"
2020,Febrero,Guatemala,320,25,40,,65,"(3.541112,-76.384584)"
2020,Febrero,Guatemala,320,552,696,,1248,"(4.697144,-74.140516)"
2020,Febrero,Guatemala,320,8,16,,24,"(4.815061,-75.736532)"
2020,Febrero,Guatemala,320,79,66,,145,"(6.171601,-75.427454)"
2020,Febrero,Guatemala,320,9,6,,15,"(7.128456,-73.183637)"
2020,Febrero,Guyana,328,0,2,,2,"(10.445761,-75.516429)"
2020,Febrero,Guyana,328,1,5,,6,"(10.886611,-74.776708)"
2020,Febrero,Guyana,328,1,1,,2,"(3.541112,-76.384584)"
2020,Febrero,Guyana,328,2,6,,8,"(4.697144,-74.140516)"
2020,Febrero,Guyana,328,0,5,,5,"(6.171601,-75.427454)"
2020,Febrero,Guinea Ecuatorial,226,1,0,,1,"(3.541112,-76.384584)"
2020,Febrero,Guinea Ecuatorial,226,0,1,,1,"(4.697144,-74.140516)"
2020,Febrero,Guinea Ecuatorial,226,1,0,,1,"(6.171601,-75.427454)"
2020,Febrero,Guadalupe/Territorio Francés,312,0,1,,1,"(3.541112,-76.384584)"
2020,Febrero,Guadalupe/Territorio Francés,312,0,2,,2,"(4.697144,-74.140516)"
2020,Febrero,Guayana Francesa/Departamento de Ultramar Francés,254,4,0,,4,"(4.697144,-74.140516)"
2020,Febrero,Haití,332,0,2,,2,"(10.445761,-75.516429)"
2020,Febrero,Haití,332,0,1,,1,"(10.886611,-74.776708)"
2020,Febrero,Haití,332,1,1,,2,"(3.541112,-76.384584)"
2020,Febrero,Haití,332,1,6,,7,"(4.697144,-74.140516)"
2020,Febrero,Haití,332,0,3,,3,"(6.171601,-75.427454)"
2020,Febrero,Honduras,340,0,2,,2,"(10.408582,-75.538003)"
2020,Febrero,Honduras,340,1,24,,25,"(10.445761,-75.516429)"
2020,Febrero,Honduras,340,4,18,,22,"(10.886611,-74.776708)"
2020,Febrero,Honduras,340,0,2,,2,"(12.5744111,-81.703935)"
2020,Febrero,Honduras,340,14,20,,34,"(3.541112,-76.384584)"
2020,Febrero,Honduras,340,34,100,,134,"(4.697144,-74.140516)"
2020,Febrero,Honduras,340,5,5,,10,"(4.815061,-75.736532)"
2020,Febrero,Honduras,340,27,56,,83,"(6.171601,-75.427454)"
2020,Febrero,Honduras,340,2,2,,4,"(7.128456,-73.183637)"
2020,Febrero,Hong Kong,344,7,14,,21,"(4.697144,-74.140516)"
2020,Febrero,Hungría,348,1,6,,7,"(4.697144,-74.140516)"
2020,Febrero,Hungría,348,0,1,,1,"(6.171601,-75.427454)"
2020,Febrero,Hungría,348,0,1,,1,"(7.128456,-73.183637)"
2020,Febrero,India,356,0,1,,1,"(10.445761,-75.516429)"
2020,Febrero,India,356,1,1,,2,"(3.541112,-76.384584)"
2020,Febrero,India,356,31,31,,62,"(4.697144,-74.140516)"
2020,Febrero,India,356,1,0,,1,"(4.815061,-75.736532)"
2020,Febrero,India,356,4,5,,9,"(6.171601,-75.427454)"
2020,Febrero,India,356,0,1,,1,"(7.128456,-73.183637)"
2020,Febrero,Indonesia,360,6,4,,10,"(4.697144,-74.140516)"
2020,Febrero,Indonesia,360,0,1,,1,"(6.171601,-75.427454)"
2020,Febrero,Iraq,368,0,1,,1,"(4.697144,-74.140516)"
2020,Febrero,Iraq,368,0,1,,1,"(6.171601,-75.427454)"
2020,Febrero,República de Irlanda,372,1,0,,1,"(10.445761,-75.516429)"
2020,Febrero,República de Irlanda,372,2,0,,2,"(3.541112,-76.384584)"
2020,Febrero,República de Irlanda,372,6,8,,14,"(4.697144,-74.140516)"
2020,Febrero,República de Irlanda,372,2,0,,2,"(6.171601,-75.427454)"
2020,Febrero,Islandia,352,1,0,,1,"(0.814836,-77.662532)"
2020,Febrero,Islandia,352,1,0,,1,"(10.886611,-74.776708)"
2020,Febrero,Islandia,352,1,1,,2,"(4.697144,-74.140516)"
2020,Febrero,Israel,376,0,1,,1,"(10.445761,-75.516429)"
2020,Febrero,Israel,376,8,6,,14,"(3.541112,-76.384584)"
2020,Febrero,Israel,376,71,69,,140,"(4.697144,-74.140516)"
2020,Febrero,Israel,376,14,10,,24,"(6.171601,-75.427454)"
2020,Febrero,Italia,380,14,6,,20,"(10.445761,-75.516429)"
2020,Febrero,Italia,380,3,0,,3,"(10.886611,-74.776708)"
2020,Febrero,Italia,380,154,55,,209,"(3.541112,-76.384584)"
2020,Febrero,Italia,380,539,324,,863,"(4.697144,-74.140516)"
2020,Febrero,Italia,380,3,4,,7,"(4.815061,-75.736532)"
2020,Febrero,Italia,380,139,81,,220,"(6.171601,-75.427454)"
2020,Febrero,Jamaica,388,3,2,,5,"(10.408582,-75.538003)"
2020,Febrero,Jamaica,388,3,7,,10,"(10.445761,-75.516429)"
2020,Febrero,Jamaica,388,5,5,,10,"(10.886611,-74.776708)"
2020,Febrero,Jamaica,388,6,2,,8,"(3.541112,-76.384584)"
2020,Febrero,Jamaica,388,31,32,,63,"(4.697144,-74.140516)"
2020,Febrero,Jamaica,388,6,8,,14,"(4.815061,-75.736532)"
2020,Febrero,Jamaica,388,10,6,,16,"(6.171601,-75.427454)"
2020,Febrero,Jamaica,388,5,3,,8,"(7.128456,-73.183637)"
2020,Febrero,Japón,392,1,0,,1,"(3.541112,-76.384584)"
2020,Febrero,Japón,392,36,31,,67,"(4.697144,-74.140516)"
2020,Febrero,Japón,392,8,8,,16,"(6.171601,-75.427454)"
2020,Febrero,Jordania,400,1,0,,1,"(3.541112,-76.384584)"
2020,Febrero,Jordania,400,1,2,,3,"(4.697144,-74.140516)"
2020,Febrero,Kenia,404,5,5,,10,"(4.697144,-74.140516)"
2020,Febrero,Kenia,404,0,1,,1,"(6.171601,-75.427454)"
2020,Febrero,Kuwait,414,0,4,,4,"(4.697144,-74.140516)"
2020,Febrero,República Democrática Popular  Lao,418,0,1,,1,"(4.697144,-74.140516)"
2020,Febrero,Letonia,428,0,1,,1,"(10.445761,-75.516429)"
2020,Febrero,Letonia,428,1,0,,1,"(4.697144,-74.140516)"
2020,Febrero,Lituania,440,1,0,,1,"(10.886611,-74.776708)"
2020,Febrero,Lituania,440,2,3,,5,"(4.697144,-74.140516)"
2020,Febrero,Líbano,422,2,1,,3,"(10.886611,-74.776708)"
2020,Febrero,Líbano,422,1,0,,1,"(3.541112,-76.384584)"
2020,Febrero,Líbano,422,2,5,,7,"(4.697144,-74.140516)"
2020,Febrero,Luxemburgo,442,1,0,,1,"(10.445761,-75.516429)"
2020,Febrero,Luxemburgo,442,1,0,,1,"(3.541112,-76.384584)"
2020,Febrero,Luxemburgo,442,4,6,,10,"(4.697144,-74.140516)"
2020,Febrero,Luxemburgo,442,1,0,,1,"(6.171601,-75.427454)"
2020,Febrero,Malasia,458,6,2,,8,"(4.697144,-74.140516)"
2020,Febrero,Malasia,458,1,0,,1,"(6.171601,-75.427454)"
2020,Febrero,Malawi,454,0,1,,1,"(4.697144,-74.140516)"
2020,Febrero,Malta,470,0,2,,2,"(10.445761,-75.516429)"
2020,Febrero,Malta,470,31,45,,76,"(4.697144,-74.140516)"
2020,Febrero,Malta,470,0,1,,1,"(4.815061,-75.736532)"
2020,Febrero,Malta,470,5,5,,10,"(6.171601,-75.427454)"
2020,Febrero,Marruecos,504,8,1,,9,"(4.697144,-74.140516)"
2020,Febrero,Marruecos,504,3,1,,4,"(6.171601,-75.427454)"
2020,Febrero,Martinica/Departamento de Ultramar Francés,474,0,1,,1,"(4.815061,-75.736532)"
2020,Febrero,México,484,2,2,,4,"(0.814836,-77.662532)"
2020,Febrero,México,484,158,119,,277,"(10.445761,-75.516429)"
2020,Febrero,México,484,64,51,,115,"(10.886611,-74.776708)"
2020,Febrero,México,484,6,4,,10,"(12.586067,-81.702563)"
2020,Febrero,México,484,495,414,,909,"(3.541112,-76.384584)"
2020,Febrero,México,484,14117,12940,,27058,"(4.697144,-74.140516)"
2020,Febrero,México,484,120,84,,204,"(4.815061,-75.736532)"
2020,Febrero,México,484,3298,2751,,6050,"(6.171601,-75.427454)"
2020,Febrero,México,484,46,34,,80,"(7.128456,-73.183637)"
2020,Febrero,Mónaco,492,2,1,,3,"(4.697144,-74.140516)"
2020,Febrero,Micronesia,583,2,0,,2,"(4.697144,-74.140516)"
2020,Febrero,Mozambique,508,0,1,,1,"(4.697144,-74.140516)"
2020,Febrero,Myanmar,104,0,1,,1,"(4.697144,-74.140516)"
2020,Febrero,Nepal,524,1,0,,1,"(3.541112,-76.384584)"
2020,Febrero,Nicaragua,558,1,1,,2,"(10.445761,-75.516429)"
2020,Febrero,Nicaragua,558,1,5,,6,"(10.886611,-74.776708)"
2020,Febrero,Nicaragua,558,2,0,,2,"(12.586067,-81.702563)"
2020,Febrero,Nicaragua,558,2,13,,15,"(3.541112,-76.384584)"
2020,Febrero,Nicaragua,558,34,57,,91,"(4.697144,-74.140516)"
2020,Febrero,Nicaragua,558,0,2,,2,"(4.815061,-75.736532)"
2020,Febrero,Nicaragua,558,12,22,,34,"(6.171601,-75.427454)"
2020,Febrero,Nicaragua,558,0,3,,3,"(7.128456,-73.183637)"
2020,Febrero,Nigeria,566,1,0,,1,"(3.541112,-76.384584)"
2020,Febrero,Nigeria,566,0,8,,8,"(4.697144,-74.140516)"
2020,Febrero,Noruega,578,2,1,,3,"(10.445761,-75.516429)"
2020,Febrero,Noruega,578,0,1,,1,"(10.886611,-74.776708)"
2020,Febrero,Noruega,578,5,1,,6,"(3.541112,-76.384584)"
2020,Febrero,Noruega,578,21,19,,40,"(4.697144,-74.140516)"
2020,Febrero,Noruega,578,2,4,,6,"(6.171601,-75.427454)"
2020,Febrero,Nueva Zelanda,554,0,1,,1,"(10.445761,-75.516429)"
2020,Febrero,Nueva Zelanda,554,2,0,,2,"(3.541112,-76.384584)"
2020,Febrero,Nueva Zelanda,554,43,34,,77,"(4.697144,-74.140516)"
2020,Febrero,Nueva Zelanda,554,5,2,,7,"(6.171601,-75.427454)"
2020,Febrero,Omán,512,1,3,,4,"(4.697144,-74.140516)"
2020,Febrero,Omán,512,0,1,,1,"(6.171601,-75.427454)"
2020,Febrero,Pakistán,586,1,0,,1,"(4.697144,-74.140516)"
2020,Febrero,Panamá,591,500,435,,935,"(10.408582,-75.538003)"
2020,Febrero,Panamá,591,1274,1073,,2347,"(10.445761,-75.516429)"
2020,Febrero,Panamá,591,658,545,,1203,"(10.886611,-74.776708)"
2020,Febrero,Panamá,591,0,6,,6,"(10.971302,-74.765397)"
2020,Febrero,Panamá,591,1,10,,11,"(12.5744111,-81.703935)"
2020,Febrero,Panamá,591,61,64,,125,"(12.586067,-81.702563)"
2020,Febrero,Panamá,591,0,10,,10,"(13.3387613,-81.372937)"
2020,Febrero,Panamá,591,2288,1764,,4052,"(3.541112,-76.384584)"
2020,Febrero,Panamá,591,5873,6960,,12833,"(4.697144,-74.140516)"
2020,Febrero,Panamá,591,400,278,,678,"(4.815061,-75.736532)"
2020,Febrero,Panamá,591,0,2,,2,"(6.17134,-75.427194)"
2020,Febrero,Panamá,591,2402,2051,,4453,"(6.171601,-75.427454)"
2020,Febrero,Panamá,591,1,2,,3,"(6.228046,-77.404104)"
2020,Febrero,Panamá,591,12,17,,29,"(7.102626,-77.762647)"
2020,Febrero,Panamá,591,145,123,,268,"(7.128456,-73.183637)"
2020,Febrero,Panamá,591,0,8,,8,"(8.066966,-76.735404)"
2020,Febrero,Panamá,591,18,47,,65,"(8.635765,-77.346578)"
2020,Febrero,Paraguay,600,0,2,,2,"(0.814836,-77.662532)"
2020,Febrero,Paraguay,600,0,1,,1,"(10.445761,-75.516429)"
2020,Febrero,Paraguay,600,2,1,,3,"(10.886611,-74.776708)"
2020,Febrero,Paraguay,600,10,35,,45,"(3.541112,-76.384584)"
2020,Febrero,Paraguay,600,198,392,,590,"(4.697144,-74.140516)"
2020,Febrero,Paraguay,600,3,2,,5,"(4.815061,-75.736532)"
2020,Febrero,Paraguay,600,29,49,,78,"(6.171601,-75.427454)"
2020,Febrero,Paraguay,600,0,3,,3,"(7.128456,-73.183637)"
2020,Febrero,Perú,604,7,14,,21,"(-0.193180,-74.784874)"
2020,Febrero,Perú,604,3,13,,16,"(-4.197703,-69.941278)"
2020,Febrero,Perú,604,118,203,,321,"(-4.223468,-69.945098)"
2020,Febrero,Perú,604,1,2,,3,"(0.25129,-76.875963)"
2020,Febrero,Perú,604,158,216,,374,"(0.814836,-77.662532)"
2020,Febrero,Perú,604,0,5,,5,"(1.813928,-78.763924)"
2020,Febrero,Perú,604,1,1,,2,"(10.408582,-75.538003)"
2020,Febrero,Perú,604,58,57,,115,"(10.445761,-75.516429)"
2020,Febrero,Perú,604,7,10,,17,"(10.886611,-74.776708)"
2020,Febrero,Perú,604,250,237,,487,"(3.541112,-76.384584)"
2020,Febrero,Perú,604,4381,5059,,9440,"(4.697144,-74.140516)"
2020,Febrero,Perú,604,6,4,,10,"(4.815061,-75.736532)"
2020,Febrero,Perú,604,846,873,,1719,"(6.171601,-75.427454)"
2020,Febrero,Perú,604,3,7,,10,"(7.128456,-73.183637)"
2020,Febrero,Polonia,616,0,1,,1,"(10.445761,-75.516429)"
2020,Febrero,Polonia,616,11,20,,31,"(4.697144,-74.140516)"
2020,Febrero,Polonia,616,4,4,,8,"(6.171601,-75.427454)"
2020,Febrero,Portugal,620,1,0,,1,"(10.886611,-74.776708)"
2020,Febrero,Portugal,620,9,2,,11,"(3.541112,-76.384584)"
2020,Febrero,Portugal,620,39,71,,110,"(4.697144,-74.140516)"
2020,Febrero,Portugal,620,2,0,,2,"(4.815061,-75.736532)"
2020,Febrero,Portugal,620,19,14,,33,"(6.171601,-75.427454)"
2020,Febrero,Puerto Rico/Territorio de Estados Unidos,630,3,4,,7,"(10.445761,-75.516429)"
2020,Febrero,Puerto Rico/Territorio de Estados Unidos,630,7,12,,19,"(10.886611,-74.776708)"
2020,Febrero,Puerto Rico/Territorio de Estados Unidos,630,2,2,,4,"(12.586067,-81.702563)"
2020,Febrero,Puerto Rico/Territorio de Estados Unidos,630,21,14,,35,"(3.541112,-76.384584)"
2020,Febrero,Puerto Rico/Territorio de Estados Unidos,630,330,405,,735,"(4.697144,-74.140516)"
2020,Febrero,Puerto Rico/Territorio de Estados Unidos,630,8,1,,9,"(4.815061,-75.736532)"
2020,Febrero,Puerto Rico/Territorio de Estados Unidos,630,31,24,,55,"(6.171601,-75.427454)"
2020,Febrero,Puerto Rico/Territorio de Estados Unidos,630,3,1,,4,"(7.128456,-73.183637)"
2020,Febrero,Qatar,634,1,1,,2,"(3.541112,-76.384584)"
2020,Febrero,Qatar,634,5,9,,14,"(4.697144,-74.140516)"
2020,Febrero,Qatar,634,3,3,,6,"(6.171601,-75.427454)"
2020,Febrero,Reino Unido de Gran Bretaña e Irlanda del Norte,826,4,0,,4,"(10.445761,-75.516429)"
2020,Febrero,Reino Unido de Gran Bretaña e Irlanda del Norte,826,1,1,,2,"(10.886611,-74.776708)"
2020,Febrero,Reino Unido de Gran Bretaña e Irlanda del Norte,826,13,11,,24,"(3.541112,-76.384584)"
2020,Febrero,Reino Unido de Gran Bretaña e Irlanda del Norte,826,1305,981,,2286,"(4.697144,-74.140516)"
2020,Febrero,Reino Unido de Gran Bretaña e Irlanda del Norte,826,0,1,,1,"(4.815061,-75.736532)"
2020,Febrero,Reino Unido de Gran Bretaña e Irlanda del Norte,826,47,23,,70,"(6.171601,-75.427454)"
2020,Febrero,República CentroÁfricana,140,2,1,,3,"(4.697144,-74.140516)"
2020,Febrero,Federación de Rusia,643,0,1,,1,"(3.541112,-76.384584)"
2020,Febrero,Federación de Rusia,643,24,33,,57,"(4.697144,-74.140516)"
2020,Febrero,Federación de Rusia,643,1,2,,3,"(6.171601,-75.427454)"
2020,Febrero,República Dominicana,214,12,11,,23,"(10.445761,-75.516429)"
2020,Febrero,República Dominicana,214,25,6,,31,"(10.886611,-74.776708)"
2020,Febrero,República Dominicana,214,13,10,,23,"(11.117806,-74.232622)"
2020,Febrero,República Dominicana,214,102,59,,161,"(3.541112,-76.384584)"
2020,Febrero,República Dominicana,214,2508,2363,,4871,"(4.697144,-74.140516)"
2020,Febrero,República Dominicana,214,45,30,,75,"(4.815061,-75.736532)"
2020,Febrero,República Dominicana,214,3,2,,5,"(6.17134,-75.427194)"
2020,Febrero,República Dominicana,214,190,156,,346,"(6.171601,-75.427454)"
2020,Febrero,República Dominicana,214,38,30,,68,"(7.128456,-73.183637)"
2020,Febrero,Reunión,638,1,0,,1,"(4.697144,-74.140516)"
2020,Febrero,Rumania,642,3,2,,5,"(4.697144,-74.140516)"
2020,Febrero,Rumania,642,0,1,,1,"(6.171601,-75.427454)"
2020,Febrero,Rwanda,646,1,0,,1,"(4.697144,-74.140516)"
2020,Febrero,Senegal,686,0,1,,1,"(4.697144,-74.140516)"
2020,Febrero,Serbia,688,1,0,,1,"(4.697144,-74.140516)"
2020,Febrero,Serbia,688,0,2,,2,"(6.171601,-75.427454)"
2020,Febrero,Singapur,702,1,0,,1,"(3.541112,-76.384584)"
2020,Febrero,Singapur,702,9,10,,19,"(4.697144,-74.140516)"
2020,Febrero,Singapur,702,1,1,,2,"(6.171601,-75.427454)"
2020,Febrero,Sudáfrica,710,1,1,,2,"(10.886611,-74.776708)"
2020,Febrero,Sudáfrica,710,18,13,,31,"(4.697144,-74.140516)"
2020,Febrero,Suecia,752,3,1,,4,"(10.445761,-75.516429)"
2020,Febrero,Suecia,752,3,0,,3,"(10.886611,-74.776708)"
2020,Febrero,Suecia,752,13,13,,26,"(3.541112,-76.384584)"
2020,Febrero,Suecia,752,87,51,,138,"(4.697144,-74.140516)"
2020,Febrero,Suecia,752,7,1,,8,"(4.815061,-75.736532)"
2020,Febrero,Suecia,752,21,11,,32,"(6.171601,-75.427454)"
2020,Febrero,Suiza,756,5,3,,8,"(10.445761,-75.516429)"
2020,Febrero,Suiza,756,0,3,,3,"(10.886611,-74.776708)"
2020,Febrero,Suiza,756,61,19,,80,"(3.541112,-76.384584)"
2020,Febrero,Suiza,756,258,137,,395,"(4.697144,-74.140516)"
2020,Febrero,Suiza,756,2,2,,4,"(4.815061,-75.736532)"
2020,Febrero,Suiza,756,47,34,,81,"(6.171601,-75.427454)"
2020,Febrero,Suiza,756,1,0,,1,"(7.128456,-73.183637)"
2020,Febrero,Surinam,740,2,0,,2,"(10.886611,-74.776708)"
2020,Febrero,Surinam,740,0,95,,95,"(3.541112,-76.384584)"
2020,Febrero,Surinam,740,8,7,,15,"(4.697144,-74.140516)"
2020,Febrero,Surinam,740,3,4,,7,"(6.171601,-75.427454)"
2020,Febrero,Taiwán,158,1,6,,7,"(4.697144,-74.140516)"
2020,Febrero,República de Tayikistán,762,0,1,,1,"(4.697144,-74.140516)"
2020,Febrero,Tailandia,764,1,0,,1,"(3.541112,-76.384584)"
2020,Febrero,Tailandia,764,13,13,,26,"(4.697144,-74.140516)"
2020,Febrero,Tailandia,764,0,4,,4,"(6.171601,-75.427454)"
2020,Febrero,Trinidad y Tobago,780,1,0,,1,"(10.445761,-75.516429)"
2020,Febrero,Trinidad y Tobago,780,1,2,,3,"(10.886611,-74.776708)"
2020,Febrero,Trinidad y Tobago,780,4,19,,23,"(3.541112,-76.384584)"
2020,Febrero,Trinidad y Tobago,780,8,19,,27,"(4.697144,-74.140516)"
2020,Febrero,Trinidad y Tobago,780,1,2,,3,"(4.815061,-75.736532)"
2020,Febrero,Trinidad y Tobago,780,5,8,,13,"(6.171601,-75.427454)"
2020,Febrero,Trinidad y Tobago,780,2,1,,3,"(7.128456,-73.183637)"
2020,Febrero,Túnez,788,2,1,,3,"(4.697144,-74.140516)"
2020,Febrero,Turquía,792,0,1,,1,"(10.886611,-74.776708)"
2020,Febrero,Turquía,792,3,3,,6,"(3.541112,-76.384584)"
2020,Febrero,Turquía,792,384,290,,674,"(4.697144,-74.140516)"
2020,Febrero,Turquía,792,7,6,,13,"(6.171601,-75.427454)"
2020,Febrero,Ucrania,804,0,2,,2,"(4.697144,-74.140516)"
2020,Febrero,Ucrania,804,0,2,,2,"(6.171601,-75.427454)"
2020,Febrero,Uganda,800,0,5,,5,"(4.697144,-74.140516)"
2020,Febrero,Uruguay,858,0,2,,2,"(0.814836,-77.662532)"
2020,Febrero,Uruguay,858,4,3,,7,"(10.445761,-75.516429)"
2020,Febrero,Uruguay,858,5,3,,8,"(10.886611,-74.776708)"
2020,Febrero,Uruguay,858,19,28,,47,"(3.541112,-76.384584)"
2020,Febrero,Uruguay,858,260,305,,565,"(4.697144,-74.140516)"
2020,Febrero,Uruguay,858,3,9,,12,"(4.815061,-75.736532)"
2020,Febrero,Uruguay,858,12,18,,30,"(6.171601,-75.427454)"
2020,Febrero,Uruguay,858,2,1,,3,"(7.128456,-73.183637)"
2020,Febrero,Venezuela,862,7,7,,14,"(10.445761,-75.516429)"
2020,Febrero,Venezuela,862,10,7,,17,"(10.886611,-74.776708)"
2020,Febrero,Venezuela,862,1021,1053,,2074,"(11.360009,-72.129330)"
2020,Febrero,Venezuela,862,78,100,,178,"(3.541112,-76.384584)"
2020,Febrero,Venezuela,862,3,6,,9,"(3.866713,-67.927521)"
2020,Febrero,Venezuela,862,663,688,,1351,"(4.697144,-74.140516)"
2020,Febrero,Venezuela,862,4,1,,5,"(4.815061,-75.736532)"
2020,Febrero,Venezuela,862,114,120,,234,"(6.171601,-75.427454)"
2020,Febrero,Venezuela,862,13,18,,31,"(6.185799,-67.483929)"
2020,Febrero,Venezuela,862,165,208,,373,"(7.088729,-70.740253)"
2020,Febrero,Venezuela,862,4,5,,9,"(7.128456,-73.183637)"
2020,Febrero,Venezuela,862,915,1091,,2006,"(7.818934,-72.453226)"
2020,Febrero,Venezuela,862,10,17,,27,"(7.916725,-72.462544)"
2020,Febrero,Venezuela,862,0,2,,2,"(7.927209,-72.507910)"
2020,Febrero,Venezuela,862,65,111,,176,"(8.36068,-72.409396)"
2020,Febrero,Vietnam,704,2,8,,10,"(4.697144,-74.140516)"
2020,Febrero,Vietnam,704,1,2,,3,"(6.171601,-75.427454)"
2020,Febrero,Islas Vírgenes Británicas/Territorio Británico de Ultramar,92,0,1,,1,"(10.408582,-75.538003)"
2020,Febrero,Islas Vírgenes Británicas/Territorio Británico de Ultramar,92,2,0,,2,"(4.697144,-74.140516)"
2020,Febrero,Islas Vírgenes Estadounidenses/Territorio de Estados Unidos,850,1,0,,1,"(3.541112,-76.384584)"
2020,Marzo,Afganistán,4,1,4,,5,"(4.697144,-74.140516)"
2020,Marzo,Albania,8,1,5,,6,"(4.697144,-74.140516)"
2020,Marzo,Alemania,276,1,0,,1,"(0.25129,-76.875963)"
2020,Marzo,Alemania,276,8,8,,16,"(10.445761,-75.516429)"
2020,Marzo,Alemania,276,3,4,,7,"(10.886611,-74.776708)"
2020,Marzo,Alemania,276,16,13,,29,"(3.541112,-76.384584)"
2020,Marzo,Alemania,276,899,668,,1567,"(4.697144,-74.140516)"
2020,Marzo,Alemania,276,1,1,,2,"(4.815061,-75.736532)"
2020,Marzo,Alemania,276,30,33,,63,"(6.171601,-75.427454)"
2020,Marzo,Andorra,20,3,1,,4,"(3.541112,-76.384584)"
2020,Marzo,Angola,24,1,1,,2,"(4.697144,-74.140516)"
2020,Marzo,Antigua y Barbuda,28,1,0,,1,"(3.541112,-76.384584)"
2020,Marzo,Antigua y Barbuda,28,1,3,,4,"(4.697144,-74.140516)"
2020,Marzo,Países Bajos,528,98,50,,148,"(10.445761,-75.516429)"
2020,Marzo,Países Bajos,528,19,18,,37,"(10.886611,-74.776708)"
2020,Marzo,Países Bajos,528,24,10,,34,"(3.541112,-76.384584)"
2020,Marzo,Países Bajos,528,345,351,,696,"(4.697144,-74.140516)"
2020,Marzo,Países Bajos,528,5,0,,5,"(4.815061,-75.736532)"
2020,Marzo,Países Bajos,528,68,43,,111,"(6.171601,-75.427454)"
2020,Marzo,Países Bajos,528,1,3,,4,"(7.128456,-73.183637)"
2020,Marzo,Arabia Saudita,682,1,10,,11,"(4.697144,-74.140516)"
2020,Marzo,Arabia Saudita,682,0,2,,2,"(6.171601,-75.427454)"
2020,Marzo,Arabia Saudita,682,1,0,,1,"(7.128456,-73.183637)"
2020,Marzo,Argelia,12,0,3,,3,"(4.697144,-74.140516)"
2020,Marzo,Argelia,12,1,0,,1,"(6.171601,-75.427454)"
2020,Marzo,Argentina,32,11,21,,32,"(0.814836,-77.662532)"
2020,Marzo,Argentina,32,19,14,,33,"(10.445761,-75.516429)"
2020,Marzo,Argentina,32,49,30,,79,"(10.886611,-74.776708)"
2020,Marzo,Argentina,32,1,0,,1,"(12.586067,-81.702563)"
2020,Marzo,Argentina,32,105,79,,184,"(3.541112,-76.384584)"
2020,Marzo,Argentina,32,1902,1669,,3571,"(4.697144,-74.140516)"
2020,Marzo,Argentina,32,9,17,,26,"(4.815061,-75.736532)"
2020,Marzo,Argentina,32,156,202,,358,"(6.171601,-75.427454)"
2020,Marzo,Argentina,32,2,1,,3,"(7.128456,-73.183637)"
2020,Marzo,Aruba,533,558,360,,918,"(10.408582,-75.538003)"
2020,Marzo,Aruba,533,1,0,,1,"(10.445761,-75.516429)"
2020,Marzo,Aruba,533,83,55,,138,"(10.886611,-74.776708)"
2020,Marzo,Aruba,533,12,8,,20,"(3.541112,-76.384584)"
2020,Marzo,Aruba,533,492,408,,900,"(4.697144,-74.140516)"
2020,Marzo,Aruba,533,3,1,,4,"(4.815061,-75.736532)"
2020,Marzo,Aruba,533,60,46,,106,"(6.171601,-75.427454)"
2020,Marzo,Aruba,533,9,11,,20,"(7.128456,-73.183637)"
2020,Marzo,Australia,36,2,0,,2,"(10.886611,-74.776708)"
2020,Marzo,Australia,36,13,16,,29,"(3.541112,-76.384584)"
2020,Marzo,Australia,36,281,215,,496,"(4.697144,-74.140516)"
2020,Marzo,Australia,36,27,25,,52,"(6.171601,-75.427454)"
2020,Marzo,Australia,36,1,1,,2,"(7.128456,-73.183637)"
2020,Marzo,Austria,40,2,1,,3,"(10.445761,-75.516429)"
2020,Marzo,Austria,40,1,0,,1,"(10.886611,-74.776708)"
2020,Marzo,Austria,40,0,1,,1,"(3.541112,-76.384584)"
2020,Marzo,Austria,40,21,17,,38,"(4.697144,-74.140516)"
2020,Marzo,Austria,40,3,0,,3,"(6.171601,-75.427454)"
2020,Marzo,Bahamas,44,0,1,,1,"(10.445761,-75.516429)"
2020,Marzo,Bahamas,44,15,6,,21,"(3.541112,-76.384584)"
2020,Marzo,Bahamas,44,2,7,,9,"(4.697144,-74.140516)"
2020,Marzo,Bahamas,44,3,2,,5,"(4.815061,-75.736532)"
2020,Marzo,Bahamas,44,13,9,,22,"(6.171601,-75.427454)"
2020,Marzo,Bahréin,48,0,1,,1,"(4.697144,-74.140516)"
2020,Marzo,Barbados,52,2,0,,2,"(10.886611,-74.776708)"
2020,Marzo,Barbados,52,1,2,,3,"(4.697144,-74.140516)"
2020,Marzo,Barbados,52,1,0,,1,"(4.815061,-75.736532)"
2020,Marzo,Barbados,52,3,1,,4,"(6.171601,-75.427454)"
2020,Marzo,República de Belarús,112,0,1,,1,"(11.360009,-72.129330)"
2020,Marzo,República de Belarús,112,1,0,,1,"(4.697144,-74.140516)"
2020,Marzo,República de Belarús,112,0,1,,1,"(6.171601,-75.427454)"
2020,Marzo,Bélgica,56,5,1,,6,"(10.445761,-75.516429)"
2020,Marzo,Bélgica,56,5,3,,8,"(3.541112,-76.384584)"
2020,Marzo,Bélgica,56,51,26,,77,"(4.697144,-74.140516)"
2020,Marzo,Bélgica,56,15,14,,29,"(6.171601,-75.427454)"
2020,Marzo,Belice,84,1,1,,2,"(10.886611,-74.776708)"
2020,Marzo,Belice,84,1,0,,1,"(3.541112,-76.384584)"
2020,Marzo,Belice,84,3,4,,7,"(4.697144,-74.140516)"
2020,Marzo,Belice,84,1,1,,2,"(4.815061,-75.736532)"
2020,Marzo,Belice,84,1,0,,1,"(6.171601,-75.427454)"
2020,Marzo,Belice,84,1,0,,1,"(7.128456,-73.183637)"
2020,Marzo,Benín,204,1,0,,1,"(4.697144,-74.140516)"
2020,Marzo,Benín,204,1,0,,1,"(6.171601,-75.427454)"
2020,Marzo,Bermudas/Territorio Británico de Ultramar,60,1,2,,3,"(4.697144,-74.140516)"
2020,Marzo,Bolivia,68,5,17,,22,"(0.814836,-77.662532)"
2020,Marzo,Bolivia,68,1,1,,2,"(10.445761,-75.516429)"
2020,Marzo,Bolivia,68,1,0,,1,"(10.886611,-74.776708)"
2020,Marzo,Bolivia,68,0,1,,1,"(12.586067,-81.702563)"
2020,Marzo,Bolivia,68,4,14,,18,"(3.541112,-76.384584)"
2020,Marzo,Bolivia,68,221,346,,567,"(4.697144,-74.140516)"
2020,Marzo,Bolivia,68,6,8,,14,"(4.815061,-75.736532)"
2020,Marzo,Bolivia,68,17,13,,30,"(6.171601,-75.427454)"
2020,Marzo,Brasil,76,86,179,,265,"(-4.197703,-69.941278)"
2020,Marzo,Brasil,76,20,19,,39,"(-4.223468,-69.945098)"
2020,Marzo,Brasil,76,1,8,,9,"(0.814836,-77.662532)"
2020,Marzo,Brasil,76,2,5,,7,"(10.445761,-75.516429)"
2020,Marzo,Brasil,76,6,10,,16,"(10.886611,-74.776708)"
2020,Marzo,Brasil,76,0,1,,1,"(12.586067,-81.702563)"
2020,Marzo,Brasil,76,63,112,,175,"(3.541112,-76.384584)"
2020,Marzo,Brasil,76,3,1,,4,"(3.866713,-67.927521)"
2020,Marzo,Brasil,76,1418,1880,,3298,"(4.697144,-74.140516)"
2020,Marzo,Brasil,76,21,36,,57,"(4.815061,-75.736532)"
2020,Marzo,Brasil,76,97,127,,224,"(6.171601,-75.427454)"
2020,Marzo,Brasil,76,2,2,,4,"(7.128456,-73.183637)"
2020,Marzo,Bulgaria,100,0,1,,1,"(10.445761,-75.516429)"
2020,Marzo,Bulgaria,100,2,1,,3,"(4.697144,-74.140516)"
2020,Marzo,Cabo Verde,132,2,3,,5,"(4.697144,-74.140516)"
2020,Marzo,Islas Caimán/Territorio Británico de Ultramar,136,1,0,,1,"(10.445761,-75.516429)"
2020,Marzo,Islas Caimán/Territorio Británico de Ultramar,136,1,0,,1,"(10.886611,-74.776708)"
2020,Marzo,Islas Caimán/Territorio Británico de Ultramar,136,0,1,,1,"(12.586067,-81.702563)"
2020,Marzo,Islas Caimán/Territorio Británico de Ultramar,136,2,0,,2,"(3.541112,-76.384584)"
2020,Marzo,Islas Caimán/Territorio Británico de Ultramar,136,1,2,,3,"(4.697144,-74.140516)"
2020,Marzo,Islas Caimán/Territorio Británico de Ultramar,136,0,1,,1,"(6.171601,-75.427454)"
2020,Marzo,Camerún,120,0,1,,1,"(4.697144,-74.140516)"
2020,Marzo,Camerún,120,1,0,,1,"(6.171601,-75.427454)"
2020,Marzo,Canadá,124,273,197,,470,"(10.445761,-75.516429)"
2020,Marzo,Canadá,124,40,27,,67,"(10.886611,-74.776708)"
2020,Marzo,Canadá,124,11,4,,15,"(12.586067,-81.702563)"
2020,Marzo,Canadá,124,139,92,,231,"(3.541112,-76.384584)"
2020,Marzo,Canadá,124,1,1,,2,"(4.452882,-75.766298)"
2020,Marzo,Canadá,124,1684,1375,,3059,"(4.697144,-74.140516)"
2020,Marzo,Canadá,124,27,26,,53,"(4.815061,-75.736532)"
2020,Marzo,Canadá,124,242,173,,415,"(6.171601,-75.427454)"
2020,Marzo,Canadá,124,10,15,,25,"(7.128456,-73.183637)"
2020,Marzo,España,724,4,2,,6,"(10.445761,-75.516429)"
2020,Marzo,España,724,8,12,,20,"(10.886611,-74.776708)"
2020,Marzo,España,724,1244,824,,2068,"(3.541112,-76.384584)"
2020,Marzo,España,724,6771,4988,,11759,"(4.697144,-74.140516)"
2020,Marzo,España,724,19,19,,38,"(4.815061,-75.736532)"
2020,Marzo,España,724,1251,940,,2191,"(6.171601,-75.427454)"
2020,Marzo,España,724,2,1,,3,"(7.128456,-73.183637)"
2020,Marzo,Colombia,170,52,130,,182,"(4.697144,-74.140516)"
2020,Marzo,República Del Congo,178,0,1,,1,"(4.697144,-74.140516)"
2020,Marzo,República de Corea,410,4,3,,7,"(4.697144,-74.140516)"
2020,Marzo,República de Corea,410,2,0,,2,"(6.171601,-75.427454)"
2020,Marzo,Costa de Marfil,384,1,0,,1,"(3.541112,-76.384584)"
2020,Marzo,Costa de Marfil,384,0,1,,1,"(4.697144,-74.140516)"
2020,Marzo,Costa Rica,188,9,6,,15,"(10.445761,-75.516429)"
2020,Marzo,Costa Rica,188,13,17,,30,"(10.886611,-74.776708)"
2020,Marzo,Costa Rica,188,1,10,,11,"(12.5744111,-81.703935)"
2020,Marzo,Costa Rica,188,2,0,,2,"(12.586067,-81.702563)"
2020,Marzo,Costa Rica,188,42,34,,76,"(3.541112,-76.384584)"
2020,Marzo,Costa Rica,188,489,551,,1040,"(4.697144,-74.140516)"
2020,Marzo,Costa Rica,188,7,5,,12,"(4.815061,-75.736532)"
2020,Marzo,Costa Rica,188,89,79,,168,"(6.171601,-75.427454)"
2020,Marzo,Costa Rica,188,2,1,,3,"(7.128456,-73.183637)"
2020,Marzo,Cuba,192,2,1,,3,"(10.445761,-75.516429)"
2020,Marzo,Cuba,192,6,6,,12,"(10.886611,-74.776708)"
2020,Marzo,Cuba,192,39,28,,67,"(3.541112,-76.384584)"
2020,Marzo,Cuba,192,408,384,,792,"(4.697144,-74.140516)"
2020,Marzo,Cuba,192,3,3,,6,"(4.815061,-75.736532)"
2020,Marzo,Cuba,192,22,41,,63,"(6.171601,-75.427454)"
2020,Marzo,Cuba,192,1,3,,4,"(7.128456,-73.183637)"
2020,Marzo,Curazao,99999,13,6,,19,"(10.886611,-74.776708)"
2020,Marzo,Curazao,99999,6,2,,8,"(3.541112,-76.384584)"
2020,Marzo,Curazao,99999,543,475,,1018,"(4.697144,-74.140516)"
2020,Marzo,Curazao,99999,1,1,,2,"(4.815061,-75.736532)"
2020,Marzo,Curazao,99999,8,5,,13,"(6.171601,-75.427454)"
2020,Marzo,República Checa,203,5,3,,8,"(4.697144,-74.140516)"
2020,Marzo,Chile,152,147,150,,297,"(0.814836,-77.662532)"
2020,Marzo,Chile,152,0,3,,3,"(1.813928,-78.763924)"
2020,Marzo,Chile,152,17,11,,28,"(10.445761,-75.516429)"
2020,Marzo,Chile,152,60,53,,113,"(10.886611,-74.776708)"
2020,Marzo,Chile,152,2,1,,3,"(12.586067,-81.702563)"
2020,Marzo,Chile,152,780,474,,1254,"(3.541112,-76.384584)"
2020,Marzo,Chile,152,3018,2450,,5468,"(4.697144,-74.140516)"
2020,Marzo,Chile,152,85,65,,150,"(4.815061,-75.736532)"
2020,Marzo,Chile,152,159,123,,282,"(6.171601,-75.427454)"
2020,Marzo,Chile,152,4,4,,8,"(7.128456,-73.183637)"
2020,Marzo,China,156,0,1,,1,"(10.445761,-75.516429)"
2020,Marzo,China,156,1,0,,1,"(3.541112,-76.384584)"
2020,Marzo,China,156,27,29,,56,"(4.697144,-74.140516)"
2020,Marzo,China,156,4,7,,11,"(6.171601,-75.427454)"
2020,Marzo,Dinamarca,208,0,1,,1,"(3.541112,-76.384584)"
2020,Marzo,Dinamarca,208,10,4,,14,"(4.697144,-74.140516)"
2020,Marzo,Dinamarca,208,0,2,,2,"(6.171601,-75.427454)"
2020,Marzo,Ecuador,218,2,4,,6,"(-0.193180,-74.784874)"
2020,Marzo,Ecuador,218,193,437,,630,"(0.25129,-76.875963)"
2020,Marzo,Ecuador,218,5,6,,11,"(0.812436,-77.847006)"
2020,Marzo,Ecuador,218,1972,2817,,4789,"(0.814836,-77.662532)"
2020,Marzo,Ecuador,218,38,58,,96,"(1.813928,-78.763924)"
2020,Marzo,Ecuador,218,1,0,,1,"(10.445761,-75.516429)"
2020,Marzo,Ecuador,218,4,6,,10,"(10.886611,-74.776708)"
2020,Marzo,Ecuador,218,89,140,,229,"(3.541112,-76.384584)"
2020,Marzo,Ecuador,218,1103,1720,,2823,"(4.697144,-74.140516)"
2020,Marzo,Ecuador,218,1,2,,3,"(4.815061,-75.736532)"
2020,Marzo,Ecuador,218,17,34,,51,"(6.171601,-75.427454)"
2020,Marzo,Ecuador,218,3,3,,6,"(7.128456,-73.183637)"
2020,Marzo,Egipto,818,7,1,,8,"(4.697144,-74.140516)"
2020,Marzo,El Salvador,222,2,3,,5,"(10.886611,-74.776708)"
2020,Marzo,El Salvador,222,1,0,,1,"(12.586067,-81.702563)"
2020,Marzo,El Salvador,222,5,5,,10,"(3.541112,-76.384584)"
2020,Marzo,El Salvador,222,338,475,,813,"(4.697144,-74.140516)"
2020,Marzo,El Salvador,222,7,15,,22,"(6.171601,-75.427454)"
2020,Marzo,El Salvador,222,0,1,,1,"(7.128456,-73.183637)"
2020,Marzo,Emiratos Árabes,784,0,1,,1,"(10.886611,-74.776708)"
2020,Marzo,Emiratos Árabes,784,0,1,,1,"(3.541112,-76.384584)"
2020,Marzo,Emiratos Árabes,784,51,175,,226,"(4.697144,-74.140516)"
2020,Marzo,Emiratos Árabes,784,11,6,,17,"(6.171601,-75.427454)"
2020,Marzo,Eslovaquia,703,1,1,,2,"(4.697144,-74.140516)"
2020,Marzo,Eslovenia,705,1,0,,1,"(4.697144,-74.140516)"
2020,Marzo,Eslovenia,705,0,1,,1,"(6.171601,-75.427454)"
2020,Marzo,Estados Unidos de América,840,1527,1235,,2763,"(10.445761,-75.516429)"
2020,Marzo,Estados Unidos de América,840,1662,1238,,2900,"(10.886611,-74.776708)"
2020,Marzo,Estados Unidos de América,840,29,14,,43,"(12.586067,-81.702563)"
2020,Marzo,Estados Unidos de América,840,3810,2803,,6613,"(3.541112,-76.384584)"
2020,Marzo,Estados Unidos de América,840,543,463,,1006,"(4.452882,-75.766298)"
2020,Marzo,Estados Unidos de América,840,17021,14295,,31316,"(4.697144,-74.140516)"
2020,Marzo,Estados Unidos de América,840,770,518,,1288,"(4.815061,-75.736532)"
2020,Marzo,Estados Unidos de América,840,5757,4601,,10359,"(6.171601,-75.427454)"
2020,Marzo,Estados Unidos de América,840,129,79,,208,"(7.128456,-73.183637)"
2020,Marzo,Estonia,233,1,2,,3,"(4.697144,-74.140516)"
2020,Marzo,Etiopia,231,1,0,,1,"(4.697144,-74.140516)"
2020,Marzo,Filipinas,608,0,3,,3,"(4.697144,-74.140516)"
2020,Marzo,Finlandia,246,6,4,,10,"(4.697144,-74.140516)"
2020,Marzo,Finlandia,246,1,2,,3,"(6.171601,-75.427454)"
2020,Marzo,Francia,250,5,2,,7,"(10.445761,-75.516429)"
2020,Marzo,Francia,250,3,4,,7,"(10.886611,-74.776708)"
2020,Marzo,Francia,250,22,14,,36,"(3.541112,-76.384584)"
2020,Marzo,Francia,250,729,554,,1283,"(4.697144,-74.140516)"
2020,Marzo,Francia,250,5,4,,9,"(4.815061,-75.736532)"
2020,Marzo,Francia,250,61,33,,94,"(6.171601,-75.427454)"
2020,Marzo,Francia,250,1,1,,2,"(7.128456,-73.183637)"
2020,Marzo,Granada,308,0,1,,1,"(4.697144,-74.140516)"
2020,Marzo,Grecia,300,4,3,,7,"(4.697144,-74.140516)"
2020,Marzo,Guatemala,320,0,3,,3,"(1.813928,-78.763924)"
2020,Marzo,Guatemala,320,3,1,,4,"(10.445761,-75.516429)"
2020,Marzo,Guatemala,320,5,5,,10,"(10.886611,-74.776708)"
2020,Marzo,Guatemala,320,0,10,,10,"(12.586067,-81.702563)"
2020,Marzo,Guatemala,320,18,31,,49,"(3.541112,-76.384584)"
2020,Marzo,Guatemala,320,242,378,,620,"(4.697144,-74.140516)"
2020,Marzo,Guatemala,320,6,11,,17,"(4.815061,-75.736532)"
2020,Marzo,Guatemala,320,46,41,,87,"(6.171601,-75.427454)"
2020,Marzo,Guatemala,320,3,4,,7,"(7.128456,-73.183637)"
2020,Marzo,Guyana,328,1,3,,4,"(10.886611,-74.776708)"
2020,Marzo,Guyana,328,1,3,,4,"(4.697144,-74.140516)"
2020,Marzo,Guyana,328,0,1,,1,"(4.815061,-75.736532)"
2020,Marzo,Guadalupe/Territorio Francés,312,0,1,,1,"(10.886611,-74.776708)"
2020,Marzo,Guadalupe/Territorio Francés,312,0,1,,1,"(4.697144,-74.140516)"
2020,Marzo,Guayana Francesa/Departamento de Ultramar Francés,254,0,1,,1,"(4.697144,-74.140516)"
2020,Marzo,Guayana Francesa/Departamento de Ultramar Francés,254,0,1,,1,"(4.815061,-75.736532)"
2020,Marzo,Haití,332,0,4,,4,"(4.697144,-74.140516)"
2020,Marzo,Haití,332,1,1,,2,"(6.171601,-75.427454)"
2020,Marzo,Honduras,340,0,2,,2,"(10.445761,-75.516429)"
2020,Marzo,Honduras,340,2,8,,10,"(10.886611,-74.776708)"
2020,Marzo,Honduras,340,2,1,,3,"(12.5744111,-81.703935)"
2020,Marzo,Honduras,340,0,4,,4,"(12.586067,-81.702563)"
2020,Marzo,Honduras,340,4,9,,13,"(3.541112,-76.384584)"
2020,Marzo,Honduras,340,29,64,,93,"(4.697144,-74.140516)"
2020,Marzo,Honduras,340,1,0,,1,"(4.815061,-75.736532)"
2020,Marzo,Honduras,340,12,34,,46,"(6.171601,-75.427454)"
2020,Marzo,Honduras,340,4,4,,8,"(7.128456,-73.183637)"
2020,Marzo,Hong Kong,344,4,2,,6,"(4.697144,-74.140516)"
2020,Marzo,Hungría,348,3,2,,5,"(4.697144,-74.140516)"
2020,Marzo,Hungría,348,0,1,,1,"(6.171601,-75.427454)"
2020,Marzo,India,356,2,0,,2,"(3.541112,-76.384584)"
2020,Marzo,India,356,27,17,,44,"(4.697144,-74.140516)"
2020,Marzo,India,356,0,1,,1,"(4.815061,-75.736532)"
2020,Marzo,India,356,14,7,,21,"(6.171601,-75.427454)"
2020,Marzo,Indonesia,360,1,2,,3,"(4.697144,-74.140516)"
2020,Marzo,Iraq,368,0,1,,1,"(4.697144,-74.140516)"
2020,Marzo,Irán,364,0,1,,1,"(4.697144,-74.140516)"
2020,Marzo,República de Irlanda,372,1,2,,3,"(3.541112,-76.384584)"
2020,Marzo,República de Irlanda,372,10,4,,14,"(4.697144,-74.140516)"
2020,Marzo,República de Irlanda,372,2,1,,3,"(6.171601,-75.427454)"
2020,Marzo,República de Irlanda,372,1,0,,1,"(7.128456,-73.183637)"
2020,Marzo,Islandia,352,1,0,,1,"(10.886611,-74.776708)"
2020,Marzo,Islandia,352,3,1,,4,"(4.697144,-74.140516)"
2020,Marzo,Islandia,352,1,0,,1,"(6.171601,-75.427454)"
2020,Marzo,Israel,376,1,1,,2,"(3.541112,-76.384584)"
2020,Marzo,Israel,376,48,22,,70,"(4.697144,-74.140516)"
2020,Marzo,Israel,376,1,0,,1,"(4.815061,-75.736532)"
2020,Marzo,Israel,376,4,2,,6,"(6.171601,-75.427454)"
2020,Marzo,Italia,380,8,0,,8,"(10.445761,-75.516429)"
2020,Marzo,Italia,380,39,12,,51,"(3.541112,-76.384584)"
2020,Marzo,Italia,380,155,87,,242,"(4.697144,-74.140516)"
2020,Marzo,Italia,380,29,14,,43,"(6.171601,-75.427454)"
2020,Marzo,Jamaica,388,66,46,,112,"(10.408582,-75.538003)"
2020,Marzo,Jamaica,388,1,3,,4,"(10.445761,-75.516429)"
2020,Marzo,Jamaica,388,1,0,,1,"(10.886611,-74.776708)"
2020,Marzo,Jamaica,388,6,2,,8,"(3.541112,-76.384584)"
2020,Marzo,Jamaica,388,14,17,,31,"(4.697144,-74.140516)"
2020,Marzo,Jamaica,388,5,8,,13,"(6.171601,-75.427454)"
2020,Marzo,Jamaica,388,1,1,,2,"(7.128456,-73.183637)"
2020,Marzo,Japón,392,28,25,,53,"(4.697144,-74.140516)"
2020,Marzo,Japón,392,0,1,,1,"(4.815061,-75.736532)"
2020,Marzo,Japón,392,6,2,,8,"(6.171601,-75.427454)"
2020,Marzo,Kuwait,414,0,1,,1,"(4.697144,-74.140516)"
2020,Marzo,República Democrática Popular  Lao,418,0,1,,1,"(4.697144,-74.140516)"
2020,Marzo,Letonia,428,0,1,,1,"(4.697144,-74.140516)"
2020,Marzo,Lituania,440,1,1,,2,"(4.697144,-74.140516)"
2020,Marzo,Líbano,422,0,2,,2,"(10.886611,-74.776708)"
2020,Marzo,Líbano,422,1,1,,2,"(4.697144,-74.140516)"
2020,Marzo,Luxemburgo,442,1,0,,1,"(10.886611,-74.776708)"
2020,Marzo,Luxemburgo,442,4,3,,7,"(4.697144,-74.140516)"
2020,Marzo,Luxemburgo,442,1,0,,1,"(6.171601,-75.427454)"
2020,Marzo,Macedonia,807,1,1,,2,"(4.697144,-74.140516)"
2020,Marzo,Malasia,458,0,1,,1,"(6.171601,-75.427454)"
2020,Marzo,Malawi,454,0,1,,1,"(4.697144,-74.140516)"
2020,Marzo,Malta,470,18,14,,32,"(4.697144,-74.140516)"
2020,Marzo,Malta,470,1,1,,2,"(6.171601,-75.427454)"
2020,Marzo,Marruecos,504,1,0,,1,"(3.541112,-76.384584)"
2020,Marzo,Marruecos,504,1,1,,2,"(4.697144,-74.140516)"
2020,Marzo,Marruecos,504,2,3,,5,"(6.171601,-75.427454)"
2020,Marzo,Mauritania,478,0,2,,2,"(4.697144,-74.140516)"
2020,Marzo,Martinica/Departamento de Ultramar Francés,474,1,0,,1,"(4.697144,-74.140516)"
2020,Marzo,Martinica/Departamento de Ultramar Francés,474,1,0,,1,"(4.815061,-75.736532)"
2020,Marzo,México,484,72,56,,128,"(10.445761,-75.516429)"
2020,Marzo,México,484,35,26,,61,"(10.886611,-74.776708)"
2020,Marzo,México,484,295,254,,549,"(3.541112,-76.384584)"
2020,Marzo,México,484,6570,6233,,12803,"(4.697144,-74.140516)"
2020,Marzo,México,484,50,43,,93,"(4.815061,-75.736532)"
2020,Marzo,México,484,1854,1397,,3251,"(6.171601,-75.427454)"
2020,Marzo,México,484,59,41,,100,"(7.128456,-73.183637)"
2020,Marzo,Mónaco,492,1,2,,3,"(4.697144,-74.140516)"
2020,Marzo,Mozambique,508,0,1,,1,"(4.697144,-74.140516)"
2020,Marzo,Nicaragua,558,1,2,,3,"(10.886611,-74.776708)"
2020,Marzo,Nicaragua,558,5,11,,16,"(3.541112,-76.384584)"
2020,Marzo,Nicaragua,558,31,28,,59,"(4.697144,-74.140516)"
2020,Marzo,Nicaragua,558,1,0,,1,"(4.815061,-75.736532)"
2020,Marzo,Nicaragua,558,9,29,,38,"(6.171601,-75.427454)"
2020,Marzo,Nicaragua,558,0,1,,1,"(7.128456,-73.183637)"
2020,Marzo,Nigeria,566,1,3,,4,"(4.697144,-74.140516)"
2020,Marzo,Noruega,578,3,0,,3,"(10.886611,-74.776708)"
2020,Marzo,Noruega,578,3,0,,3,"(3.541112,-76.384584)"
2020,Marzo,Noruega,578,16,9,,25,"(4.697144,-74.140516)"
2020,Marzo,Noruega,578,2,2,,4,"(6.171601,-75.427454)"
2020,Marzo,Nueva Caledonia/Territorio francés,540,2,0,,2,"(4.697144,-74.140516)"
2020,Marzo,Nueva Zelanda,554,0,1,,1,"(12.586067,-81.702563)"
2020,Marzo,Nueva Zelanda,554,1,0,,1,"(3.541112,-76.384584)"
2020,Marzo,Nueva Zelanda,554,16,12,,28,"(4.697144,-74.140516)"
2020,Marzo,Nueva Zelanda,554,1,3,,4,"(6.171601,-75.427454)"
2020,Marzo,Nueva Zelanda,554,1,0,,1,"(7.128456,-73.183637)"
2020,Marzo,Omán,512,1,4,,5,"(4.697144,-74.140516)"
2020,Marzo,Pakistán,586,1,0,,1,"(4.697144,-74.140516)"
2020,Marzo,Panamá,591,53,43,,96,"(10.408582,-75.538003)"
2020,Marzo,Panamá,591,723,577,,1300,"(10.445761,-75.516429)"
2020,Marzo,Panamá,591,370,307,,677,"(10.886611,-74.776708)"
2020,Marzo,Panamá,591,2,20,,22,"(12.5744111,-81.703935)"
2020,Marzo,Panamá,591,20,46,,66,"(12.586067,-81.702563)"
2020,Marzo,Panamá,591,1335,988,,2323,"(3.541112,-76.384584)"
2020,Marzo,Panamá,591,2984,3361,,6346,"(4.697144,-74.140516)"
2020,Marzo,Panamá,591,192,102,,294,"(4.815061,-75.736532)"
2020,Marzo,Panamá,591,1422,1349,,2771,"(6.171601,-75.427454)"
2020,Marzo,Panamá,591,8,6,,14,"(7.102626,-77.762647)"
2020,Marzo,Panamá,591,61,61,,122,"(7.128456,-73.183637)"
2020,Marzo,Panamá,591,9,26,,35,"(8.635765,-77.346578)"
2020,Marzo,Paraguay,600,0,3,,3,"(10.445761,-75.516429)"
2020,Marzo,Paraguay,600,1,5,,6,"(10.886611,-74.776708)"
2020,Marzo,Paraguay,600,17,23,,40,"(3.541112,-76.384584)"
2020,Marzo,Paraguay,600,124,213,,337,"(4.697144,-74.140516)"
2020,Marzo,Paraguay,600,1,4,,5,"(4.815061,-75.736532)"
2020,Marzo,Paraguay,600,30,62,,92,"(6.171601,-75.427454)"
2020,Marzo,Paraguay,600,1,2,,3,"(7.128456,-73.183637)"
2020,Marzo,Perú,604,3,2,,5,"(-0.193180,-74.784874)"
2020,Marzo,Perú,604,6,15,,21,"(-4.197703,-69.941278)"
2020,Marzo,Perú,604,68,90,,158,"(-4.223468,-69.945098)"
2020,Marzo,Perú,604,1,1,,2,"(0.25129,-76.875963)"
2020,Marzo,Perú,604,72,98,,170,"(0.814836,-77.662532)"
2020,Marzo,Perú,604,0,1,,1,"(1.813928,-78.763924)"
2020,Marzo,Perú,604,26,27,,53,"(10.445761,-75.516429)"
2020,Marzo,Perú,604,5,4,,9,"(10.886611,-74.776708)"
2020,Marzo,Perú,604,89,120,,209,"(3.541112,-76.384584)"
2020,Marzo,Perú,604,2132,2458,,4590,"(4.697144,-74.140516)"
2020,Marzo,Perú,604,1,4,,5,"(4.815061,-75.736532)"
2020,Marzo,Perú,604,451,466,,917,"(6.171601,-75.427454)"
2020,Marzo,Perú,604,1,1,,2,"(7.128456,-73.183637)"
2020,Marzo,Polonia,616,0,1,,1,"(10.445761,-75.516429)"
2020,Marzo,Polonia,616,5,7,,12,"(4.697144,-74.140516)"
2020,Marzo,Polonia,616,1,1,,2,"(6.171601,-75.427454)"
2020,Marzo,Portugal,620,2,0,,2,"(10.445761,-75.516429)"
2020,Marzo,Portugal,620,5,5,,10,"(3.541112,-76.384584)"
2020,Marzo,Portugal,620,39,32,,71,"(4.697144,-74.140516)"
2020,Marzo,Portugal,620,10,6,,16,"(6.171601,-75.427454)"
2020,Marzo,Polinesia Francesa/Colectividad de Ultramar Francesa,258,2,1,,3,"(4.697144,-74.140516)"
2020,Marzo,Puerto Rico/Territorio de Estados Unidos,630,3,0,,3,"(10.445761,-75.516429)"
2020,Marzo,Puerto Rico/Territorio de Estados Unidos,630,7,4,,11,"(10.886611,-74.776708)"
2020,Marzo,Puerto Rico/Territorio de Estados Unidos,630,25,20,,45,"(3.541112,-76.384584)"
2020,Marzo,Puerto Rico/Territorio de Estados Unidos,630,269,281,,550,"(4.697144,-74.140516)"
2020,Marzo,Puerto Rico/Territorio de Estados Unidos,630,3,2,,5,"(4.815061,-75.736532)"
2020,Marzo,Puerto Rico/Territorio de Estados Unidos,630,31,23,,54,"(6.171601,-75.427454)"
2020,Marzo,Puerto Rico/Territorio de Estados Unidos,630,2,1,,3,"(7.128456,-73.183637)"
2020,Marzo,Qatar,634,1,0,,1,"(3.541112,-76.384584)"
2020,Marzo,Qatar,634,2,4,,6,"(4.697144,-74.140516)"
2020,Marzo,Qatar,634,2,4,,6,"(6.171601,-75.427454)"
2020,Marzo,Reino Unido de Gran Bretaña e Irlanda del Norte,826,0,1,,1,"(10.445761,-75.516429)"
2020,Marzo,Reino Unido de Gran Bretaña e Irlanda del Norte,826,12,7,,19,"(3.541112,-76.384584)"
2020,Marzo,Reino Unido de Gran Bretaña e Irlanda del Norte,826,812,620,,1432,"(4.697144,-74.140516)"
2020,Marzo,Reino Unido de Gran Bretaña e Irlanda del Norte,826,0,1,,1,"(4.815061,-75.736532)"
2020,Marzo,Reino Unido de Gran Bretaña e Irlanda del Norte,826,20,15,,35,"(6.171601,-75.427454)"
2020,Marzo,República CentroÁfricana,140,1,2,,3,"(4.697144,-74.140516)"
2020,Marzo,Federación de Rusia,643,1,0,,1,"(10.445761,-75.516429)"
2020,Marzo,Federación de Rusia,643,0,1,,1,"(3.541112,-76.384584)"
2020,Marzo,Federación de Rusia,643,19,35,,54,"(4.697144,-74.140516)"
2020,Marzo,República Dominicana,214,9,12,,21,"(10.445761,-75.516429)"
2020,Marzo,República Dominicana,214,10,9,,19,"(10.886611,-74.776708)"
2020,Marzo,República Dominicana,214,55,50,,105,"(3.541112,-76.384584)"
2020,Marzo,República Dominicana,214,1202,1180,,2382,"(4.697144,-74.140516)"
2020,Marzo,República Dominicana,214,33,22,,55,"(4.815061,-75.736532)"
2020,Marzo,República Dominicana,214,149,119,,268,"(6.171601,-75.427454)"
2020,Marzo,República Dominicana,214,12,11,,23,"(7.128456,-73.183637)"
2020,Marzo,Rumania,642,1,0,,1,"(3.541112,-76.384584)"
2020,Marzo,Rumania,642,3,1,,4,"(4.697144,-74.140516)"
2020,Marzo,Rwanda,646,2,0,,2,"(4.697144,-74.140516)"
2020,Marzo,San  Vicente y las Granadinas,670,1,3,,4,"(4.815061,-75.736532)"
2020,Marzo,Serbia,688,2,0,,2,"(6.171601,-75.427454)"
2020,Marzo,Singapur,702,2,3,,5,"(4.697144,-74.140516)"
2020,Marzo,Sudáfrica,710,10,11,,21,"(4.697144,-74.140516)"
2020,Marzo,Suecia,752,2,1,,3,"(10.445761,-75.516429)"
2020,Marzo,Suecia,752,2,0,,2,"(10.886611,-74.776708)"
2020,Marzo,Suecia,752,8,4,,12,"(3.541112,-76.384584)"
2020,Marzo,Suecia,752,54,34,,88,"(4.697144,-74.140516)"
2020,Marzo,Suecia,752,1,1,,2,"(4.815061,-75.736532)"
2020,Marzo,Suecia,752,10,4,,14,"(6.171601,-75.427454)"
2020,Marzo,Suiza,756,1,0,,1,"(10.445761,-75.516429)"
2020,Marzo,Suiza,756,1,2,,3,"(10.886611,-74.776708)"
2020,Marzo,Suiza,756,31,4,,35,"(3.541112,-76.384584)"
2020,Marzo,Suiza,756,159,77,,236,"(4.697144,-74.140516)"
2020,Marzo,Suiza,756,26,17,,43,"(6.171601,-75.427454)"
2020,Marzo,Suiza,756,1,0,,1,"(7.128456,-73.183637)"
2020,Marzo,Surinam,740,0,1,,1,"(10.445761,-75.516429)"
2020,Marzo,Surinam,740,0,1,,1,"(3.541112,-76.384584)"
2020,Marzo,Surinam,740,1,1,,2,"(4.697144,-74.140516)"
2020,Marzo,Surinam,740,0,1,,1,"(6.171601,-75.427454)"
2020,Marzo,Taiwán,158,0,1,,1,"(4.697144,-74.140516)"
2020,Marzo,Taiwán,158,1,0,,1,"(6.171601,-75.427454)"
2020,Marzo,Tailandia,764,1,1,,2,"(3.541112,-76.384584)"
2020,Marzo,Tailandia,764,4,5,,9,"(4.697144,-74.140516)"
2020,Marzo,Trinidad y Tobago,780,0,3,,3,"(10.445761,-75.516429)"
2020,Marzo,Trinidad y Tobago,780,1,4,,5,"(10.886611,-74.776708)"
2020,Marzo,Trinidad y Tobago,780,5,3,,8,"(3.541112,-76.384584)"
2020,Marzo,Trinidad y Tobago,780,6,5,,11,"(4.697144,-74.140516)"
2020,Marzo,Trinidad y Tobago,780,0,2,,2,"(4.815061,-75.736532)"
2020,Marzo,Trinidad y Tobago,780,1,10,,11,"(6.171601,-75.427454)"
2020,Marzo,Trinidad y Tobago,780,0,1,,1,"(7.128456,-73.183637)"
2020,Marzo,Turquía,792,1,0,,1,"(10.445761,-75.516429)"
2020,Marzo,Turquía,792,1,1,,2,"(3.541112,-76.384584)"
2020,Marzo,Turquía,792,313,173,,486,"(4.697144,-74.140516)"
2020,Marzo,Turquía,792,5,2,,7,"(6.171601,-75.427454)"
2020,Marzo,Turkmenistán,795,0,1,,1,"(3.541112,-76.384584)"
2020,Marzo,Turkmenistán,795,1,1,,2,"(4.697144,-74.140516)"
2020,Marzo,Ucrania,804,0,1,,1,"(4.697144,-74.140516)"
2020,Marzo,Uganda,800,1,1,,2,"(4.697144,-74.140516)"
2020,Marzo,Uruguay,858,0,1,,1,"(0.814836,-77.662532)"
2020,Marzo,Uruguay,858,0,4,,4,"(10.445761,-75.516429)"
2020,Marzo,Uruguay,858,1,3,,4,"(10.886611,-74.776708)"
2020,Marzo,Uruguay,858,7,15,,22,"(3.541112,-76.384584)"
2020,Marzo,Uruguay,858,184,211,,395,"(4.697144,-74.140516)"
2020,Marzo,Uruguay,858,8,11,,19,"(4.815061,-75.736532)"
2020,Marzo,Uruguay,858,6,20,,26,"(6.171601,-75.427454)"
2020,Marzo,Uruguay,858,1,1,,2,"(7.128456,-73.183637)"
2020,Marzo,Venezuela,862,5,0,,5,"(10.445761,-75.516429)"
2020,Marzo,Venezuela,862,7,10,,17,"(10.886611,-74.776708)"
2020,Marzo,Venezuela,862,384,488,,872,"(11.360009,-72.129330)"
2020,Marzo,Venezuela,862,26,20,,46,"(3.541112,-76.384584)"
2020,Marzo,Venezuela,862,279,343,,622,"(4.697144,-74.140516)"
2020,Marzo,Venezuela,862,1,2,,3,"(4.815061,-75.736532)"
2020,Marzo,Venezuela,862,60,67,,127,"(6.171601,-75.427454)"
2020,Marzo,Venezuela,862,6,7,,13,"(6.185799,-67.483929)"
2020,Marzo,Venezuela,862,46,69,,115,"(7.088729,-70.740253)"
2020,Marzo,Venezuela,862,2,2,,4,"(7.128456,-73.183637)"
2020,Marzo,Venezuela,862,311,351,,662,"(7.818934,-72.453226)"
2020,Marzo,Venezuela,862,44,51,,95,"(7.916725,-72.462544)"
2020,Marzo,Venezuela,862,28,35,,63,"(8.36068,-72.409396)"
2020,Marzo,Vietnam,704,0,1,,1,"(4.697144,-74.140516)"
2020,Abril,Alemania,276,0,1,,1,"(3.541112,-76.384584)"
2020,Abril,Alemania,276,50,27,,77,"(4.697144,-74.140516)"
2020,Abril,Países Bajos,528,50,72,,122,"(4.697144,-74.140516)"
2020,Abril,Países Bajos,528,0,1,,1,"(6.171601,-75.427454)"
2020,Abril,Argentina,32,28,54,,82,"(4.697144,-74.140516)"
2020,Abril,Aruba,533,2,3,,5,"(4.697144,-74.140516)"
2020,Abril,Australia,36,1,0,,1,"(3.541112,-76.384584)"
2020,Abril,Australia,36,23,13,,36,"(4.697144,-74.140516)"
2020,Abril,Bélgica,56,16,5,,21,"(4.697144,-74.140516)"
2020,Abril,Bermudas/Territorio Británico de Ultramar,60,1,0,,1,"(4.697144,-74.140516)"
2020,Abril,Bolivia,68,0,11,,11,"(4.697144,-74.140516)"
2020,Abril,Brasil,76,22,54,,76,"(4.697144,-74.140516)"
2020,Abril,Canadá,124,228,159,,387,"(4.697144,-74.140516)"
2020,Abril,Canadá,124,1,3,,4,"(6.171601,-75.427454)"
2020,Abril,Chad,148,3,0,,3,"(4.697144,-74.140516)"
2020,Abril,España,724,0,63,,63,"(10.886611,-74.776708)"
2020,Abril,España,724,3,140,,143,"(4.697144,-74.140516)"
2020,Abril,Costa Rica,188,12,10,,22,"(4.697144,-74.140516)"
2020,Abril,Croacia,191,1,0,,1,"(4.697144,-74.140516)"
2020,Abril,Cuba,192,4,3,,7,"(4.697144,-74.140516)"
2020,Abril,Curazao,99999,2,9,,11,"(4.697144,-74.140516)"
2020,Abril,Chile,152,61,52,,113,"(4.697144,-74.140516)"
2020,Abril,Dinamarca,208,2,1,,3,"(4.697144,-74.140516)"
2020,Abril,Ecuador,218,2,15,,17,"(0.814836,-77.662532)"
2020,Abril,Ecuador,218,0,13,,13,"(10.408582,-75.538003)"
2020,Abril,Ecuador,218,13,109,,122,"(4.697144,-74.140516)"
2020,Abril,Ecuador,218,0,10,,10,"(6.171601,-75.427454)"
2020,Abril,Emiratos Árabes,784,0,1,,1,"(4.697144,-74.140516)"
2020,Abril,Estados Unidos de América,840,60,25,,85,"(10.445761,-75.516429)"
2020,Abril,Estados Unidos de América,840,1,14,,15,"(10.886611,-74.776708)"
2020,Abril,Estados Unidos de América,840,178,96,,274,"(3.541112,-76.384584)"
2020,Abril,Estados Unidos de América,840,214,477,,691,"(4.697144,-74.140516)"
2020,Abril,Estados Unidos de América,840,114,171,,285,"(6.171601,-75.427454)"
2020,Abril,Francia,250,4,4,,8,"(4.697144,-74.140516)"
2020,Abril,Guatemala,320,2,2,,4,"(4.697144,-74.140516)"
2020,Abril,Honduras,340,5,10,,15,"(4.697144,-74.140516)"
2020,Abril,República de Irlanda,372,1,1,,2,"(4.697144,-74.140516)"
2020,Abril,Italia,380,1,0,,1,"(3.541112,-76.384584)"
2020,Abril,Italia,380,27,9,,36,"(4.697144,-74.140516)"
2020,Abril,México,484,23,14,,37,"(4.697144,-74.140516)"
2020,Abril,México,484,13,6,,19,"(6.171601,-75.427454)"
2020,Abril,Noruega,578,3,1,,4,"(4.697144,-74.140516)"
2020,Abril,Omán,512,2,0,,2,"(4.697144,-74.140516)"
2020,Abril,Panamá,591,6,71,,77,"(4.697144,-74.140516)"
2020,Abril,Paraguay,600,1,31,,32,"(4.697144,-74.140516)"
2020,Abril,Perú,604,2,23,,25,"(-4.197703,-69.941278)"
2020,Abril,Perú,604,17,41,,58,"(4.697144,-74.140516)"
2020,Abril,Perú,604,13,14,,27,"(6.171601,-75.427454)"
2020,Abril,Puerto Rico/Territorio de Estados Unidos,630,0,8,,8,"(4.697144,-74.140516)"
2020,Abril,Reino Unido de Gran Bretaña e Irlanda del Norte,826,1,0,,1,"(4.697144,-74.140516)"
2020,Abril,República Dominicana,214,1,0,,1,"(10.886611,-74.776708)"
2020,Abril,República Dominicana,214,10,11,,21,"(4.697144,-74.140516)"
2020,Abril,República Dominicana,214,1,6,,7,"(6.171601,-75.427454)"
2020,Abril,Suecia,752,27,19,,46,"(4.697144,-74.140516)"
2020,Abril,Suiza,756,15,6,,21,"(4.697144,-74.140516)"
2020,Abril,Surinam,740,0,6,,6,"(4.697144,-74.140516)"
2020,Abril,Uruguay,858,0,2,,2,"(4.697144,-74.140516)"
2020,Abril,Venezuela,862,1,0,,1,"(10.445761,-75.516429)"
2020,Abril,Venezuela,862,0,43,,43,"(11.360009,-72.129330)"
2020,Abril,Venezuela,862,4,37,,41,"(4.697144,-74.140516)"
2020,Abril,Venezuela,862,2,0,,2,"(6.185799,-67.483929)"
2020,Mayo,Afganistán,4,0,2,,2,"(4.697144,-74.140516)"
2020,Mayo,Alemania,276,76,70,,146,"(4.697144,-74.140516)"
2020,Mayo,Países Bajos,528,1,0,,1,"(10.886611,-74.776708)"
2020,Mayo,Países Bajos,528,109,77,,186,"(4.697144,-74.140516)"
2020,Mayo,Países Bajos,528,13,6,,19,"(6.171601,-75.427454)"
2020,Mayo,Argelia,12,1,0,,1,"(4.697144,-74.140516)"
2020,Mayo,Argentina,32,103,158,,261,"(4.697144,-74.140516)"
2020,Mayo,Aruba,533,15,5,,20,"(10.886611,-74.776708)"
2020,Mayo,Aruba,533,25,14,,39,"(3.541112,-76.384584)"
2020,Mayo,Aruba,533,11,7,,18,"(4.697144,-74.140516)"
2020,Mayo,Aruba,533,6,3,,9,"(6.171601,-75.427454)"
2020,Mayo,Aruba,533,3,0,,3,"(7.128456,-73.183637)"
2020,Mayo,Australia,36,3,1,,4,"(4.697144,-74.140516)"
2020,Mayo,Australia,36,1,0,,1,"(6.171601,-75.427454)"
2020,Mayo,Austria,40,2,1,,3,"(4.697144,-74.140516)"
2020,Mayo,Barbados,52,0,4,,4,"(4.697144,-74.140516)"
2020,Mayo,Bélgica,56,0,27,,27,"(4.697144,-74.140516)"
2020,Mayo,Bolivia,68,7,28,,35,"(4.697144,-74.140516)"
2020,Mayo,Brasil,76,18,52,,70,"(4.697144,-74.140516)"
2020,Mayo,Canadá,124,1,0,,1,"(10.445761,-75.516429)"
2020,Mayo,Canadá,124,0,6,,6,"(10.886611,-74.776708)"
2020,Mayo,Canadá,124,0,3,,3,"(3.541112,-76.384584)"
2020,Mayo,Canadá,124,117,79,,196,"(4.697144,-74.140516)"
2020,Mayo,Canadá,124,0,1,,1,"(6.171601,-75.427454)"
2020,Mayo,España,724,1,0,,1,"(10.445761,-75.516429)"
2020,Mayo,España,724,0,64,,64,"(10.886611,-74.776708)"
2020,Mayo,España,724,434,486,,920,"(4.697144,-74.140516)"
2020,Mayo,Costa Rica,188,36,25,,61,"(4.697144,-74.140516)"
2020,Mayo,Cuba,192,8,5,,13,"(4.697144,-74.140516)"
2020,Mayo,Curazao,99999,26,9,,35,"(10.886611,-74.776708)"
2020,Mayo,Curazao,99999,27,38,,65,"(4.697144,-74.140516)"
2020,Mayo,Chile,152,73,123,,196,"(4.697144,-74.140516)"
2020,Mayo,Ecuador,218,8,5,,13,"(0.814836,-77.662532)"
2020,Mayo,Ecuador,218,0,2,,2,"(3.541112,-76.384584)"
2020,Mayo,Ecuador,218,42,167,,209,"(4.697144,-74.140516)"
2020,Mayo,Ecuador,218,0,18,,18,"(6.171601,-75.427454)"
2020,Mayo,El Salvador,222,0,4,,4,"(10.886611,-74.776708)"
2020,Mayo,El Salvador,222,12,15,,27,"(4.697144,-74.140516)"
2020,Mayo,El Salvador,222,0,5,,5,"(6.171601,-75.427454)"
2020,Mayo,Eslovenia,705,0,2,,2,"(4.697144,-74.140516)"
2020,Mayo,Estados Unidos de América,840,112,68,,180,"(10.445761,-75.516429)"
2020,Mayo,Estados Unidos de América,840,3,36,,39,"(10.886611,-74.776708)"
2020,Mayo,Estados Unidos de América,840,211,163,,374,"(3.541112,-76.384584)"
2020,Mayo,Estados Unidos de América,840,506,871,,1377,"(4.697144,-74.140516)"
2020,Mayo,Estados Unidos de América,840,312,315,,627,"(6.171601,-75.427454)"
2020,Mayo,Estados Unidos de América,840,1,0,,1,"(7.927209,-72.507910)"
2020,Mayo,Francia,250,68,37,,105,"(4.697144,-74.140516)"
2020,Mayo,Guatemala,320,3,2,,5,"(4.697144,-74.140516)"
2020,Mayo,Guayana Francesa/Departamento de Ultramar Francés,254,0,6,,6,"(4.697144,-74.140516)"
2020,Mayo,Hong Kong,344,1,0,,1,"(6.171601,-75.427454)"
2020,Mayo,Iraq,368,0,1,,1,"(10.408582,-75.538003)"
2020,Mayo,República de Irlanda,372,1,0,,1,"(4.697144,-74.140516)"
2020,Mayo,Italia,380,1,0,,1,"(10.445761,-75.516429)"
2020,Mayo,Italia,380,47,12,,59,"(4.697144,-74.140516)"
2020,Mayo,Jamaica,388,5,7,,12,"(4.697144,-74.140516)"
2020,Mayo,México,484,78,70,,148,"(4.697144,-74.140516)"
2020,Mayo,Mayotte/Colectividad Territorial Francesa,175,1,0,,1,"(4.697144,-74.140516)"
2020,Mayo,Noruega,578,0,1,,1,"(4.697144,-74.140516)"
2020,Mayo,Nueva Zelanda,554,2,0,,2,"(4.697144,-74.140516)"
2020,Mayo,Omán,512,2,0,,2,"(4.697144,-74.140516)"
2020,Mayo,Panamá,591,0,19,,19,"(10.408582,-75.538003)"
2020,Mayo,Panamá,591,1,17,,18,"(12.5744111,-81.703935)"
2020,Mayo,Panamá,591,0,139,,139,"(4.697144,-74.140516)"
2020,Mayo,Paraguay,600,6,54,,60,"(4.697144,-74.140516)"
2020,Mayo,Perú,604,0,2,,2,"(3.541112,-76.384584)"
2020,Mayo,Perú,604,10,99,,109,"(4.697144,-74.140516)"
2020,Mayo,Perú,604,3,10,,13,"(6.171601,-75.427454)"
2020,Mayo,Portugal,620,1,2,,3,"(4.697144,-74.140516)"
2020,Mayo,Puerto Rico/Territorio de Estados Unidos,630,0,11,,11,"(4.697144,-74.140516)"
2020,Mayo,Reino Unido de Gran Bretaña e Irlanda del Norte,826,16,5,,21,"(10.445761,-75.516429)"
2020,Mayo,Reino Unido de Gran Bretaña e Irlanda del Norte,826,95,44,,139,"(4.697144,-74.140516)"
2020,Mayo,República Dominicana,214,0,3,,3,"(10.445761,-75.516429)"
2020,Mayo,República Dominicana,214,3,8,,11,"(4.697144,-74.140516)"
2020,Mayo,República Dominicana,214,1,0,,1,"(6.171601,-75.427454)"
2020,Mayo,Suecia,752,2,1,,3,"(4.697144,-74.140516)"
2020,Mayo,Turquía,792,47,27,,74,"(4.697144,-74.140516)"
2020,Mayo,Uruguay,858,0,8,,8,"(4.697144,-74.140516)"
2020,Mayo,Venezuela,862,0,57,,57,"(11.360009,-72.129330)"
2020,Mayo,Venezuela,862,0,87,,87,"(4.697144,-74.140516)"
2020,Mayo,Islas Vírgenes Británicas/Territorio Británico de Ultramar,92,0,4,,4,"(4.697144,-74.140516)"
2020,Junio,Alemania,276,1,0,,1,"(3.541112,-76.384584)"
2020,Junio,Alemania,276,119,90,,209,"(4.697144,-74.140516)"
2020,Junio,Alemania,276,1,7,,8,"(6.171601,-75.427454)"
2020,Junio,Países Bajos,528,1,4,,5,"(3.541112,-76.384584)"
2020,Junio,Países Bajos,528,93,73,,166,"(4.697144,-74.140516)"
2020,Junio,Países Bajos,528,3,4,,7,"(6.171601,-75.427454)"
2020,Junio,Argentina,32,133,135,,268,"(4.697144,-74.140516)"
2020,Junio,Argentina,32,5,6,,11,"(6.171601,-75.427454)"
2020,Junio,Aruba,533,0,2,,2,"(10.886611,-74.776708)"
2020,Junio,Aruba,533,14,1,,15,"(4.697144,-74.140516)"
2020,Junio,Australia,36,0,2,,2,"(10.445761,-75.516429)"
2020,Junio,Australia,36,7,7,,14,"(4.697144,-74.140516)"
2020,Junio,Australia,36,4,0,,4,"(6.171601,-75.427454)"
2020,Junio,Austria,40,40,21,,61,"(4.697144,-74.140516)"
2020,Junio,Barbados,52,0,4,,4,"(3.541112,-76.384584)"
2020,Junio,Bélgica,56,42,40,,82,"(4.697144,-74.140516)"
2020,Junio,Bolivia,68,7,29,,36,"(4.697144,-74.140516)"
2020,Junio,Brasil,76,0,1,,1,"(-4.197703,-69.941278)"
2020,Junio,Brasil,76,1,0,,1,"(-4.223468,-69.945098)"
2020,Junio,Brasil,76,43,59,,102,"(4.697144,-74.140516)"
2020,Junio,Brasil,76,2,4,,6,"(6.171601,-75.427454)"
2020,Junio,Canadá,124,3,5,,8,"(10.445761,-75.516429)"
2020,Junio,Canadá,124,0,6,,6,"(10.886611,-74.776708)"
2020,Junio,Canadá,124,2,0,,2,"(3.541112,-76.384584)"
2020,Junio,Canadá,124,243,191,,434,"(4.697144,-74.140516)"
2020,Junio,Canadá,124,2,2,,4,"(6.171601,-75.427454)"
2020,Junio,España,724,0,60,,60,"(10.886611,-74.776708)"
2020,Junio,España,724,2,1,,3,"(3.541112,-76.384584)"
2020,Junio,España,724,640,374,,1014,"(4.697144,-74.140516)"
2020,Junio,República de Corea,410,0,1,,1,"(10.408582,-75.538003)"
2020,Junio,República de Corea,410,1,18,,19,"(4.697144,-74.140516)"
2020,Junio,Costa Rica,188,1,2,,3,"(10.886611,-74.776708)"
2020,Junio,Costa Rica,188,2,15,,17,"(12.5744111,-81.703935)"
2020,Junio,Costa Rica,188,1,9,,10,"(4.697144,-74.140516)"
2020,Junio,Costa Rica,188,0,3,,3,"(6.171601,-75.427454)"
2020,Junio,Cuba,192,0,8,,8,"(4.697144,-74.140516)"
2020,Junio,Curazao,99999,37,28,,65,"(4.697144,-74.140516)"
2020,Junio,Curazao,99999,1,0,,1,"(6.171601,-75.427454)"
2020,Junio,República Checa,203,0,1,,1,"(4.697144,-74.140516)"
2020,Junio,Chile,152,134,94,,228,"(4.697144,-74.140516)"
2020,Junio,China,156,0,1,,1,"(6.171601,-75.427454)"
2020,Junio,Dinamarca,208,2,1,,3,"(4.697144,-74.140516)"
2020,Junio,Ecuador,218,22,20,,42,"(0.814836,-77.662532)"
2020,Junio,Ecuador,218,55,157,,212,"(4.697144,-74.140516)"
2020,Junio,Ecuador,218,0,12,,12,"(6.171601,-75.427454)"
2020,Junio,Emiratos Árabes,784,1,0,,1,"(4.697144,-74.140516)"
2020,Junio,Estados Unidos de América,840,375,248,,623,"(10.445761,-75.516429)"
2020,Junio,Estados Unidos de América,840,10,35,,45,"(10.886611,-74.776708)"
2020,Junio,Estados Unidos de América,840,616,417,,1033,"(3.541112,-76.384584)"
2020,Junio,Estados Unidos de América,840,852,910,,1762,"(4.697144,-74.140516)"
2020,Junio,Estados Unidos de América,840,566,499,,1066,"(6.171601,-75.427454)"
2020,Junio,Estonia,233,1,0,,1,"(4.697144,-74.140516)"
2020,Junio,Finlandia,246,1,0,,1,"(4.697144,-74.140516)"
2020,Junio,Francia,250,88,53,,141,"(4.697144,-74.140516)"
2020,Junio,Guatemala,320,0,2,,2,"(10.445761,-75.516429)"
2020,Junio,Guatemala,320,12,10,,22,"(4.697144,-74.140516)"
2020,Junio,Honduras,340,0,8,,8,"(10.408582,-75.538003)"
2020,Junio,Honduras,340,1,10,,11,"(4.697144,-74.140516)"
2020,Junio,Israel,376,4,3,,7,"(4.697144,-74.140516)"
2020,Junio,Italia,380,96,61,,157,"(4.697144,-74.140516)"
2020,Junio,Jamaica,388,0,1,,1,"(10.445761,-75.516429)"
2020,Junio,Japón,392,2,2,,4,"(3.541112,-76.384584)"
2020,Junio,México,484,3,3,,6,"(3.541112,-76.384584)"
2020,Junio,México,484,120,147,,267,"(4.697144,-74.140516)"
2020,Junio,México,484,0,1,,1,"(6.171601,-75.427454)"
2020,Junio,Nicaragua,558,3,3,,6,"(4.697144,-74.140516)"
2020,Junio,Noruega,578,1,2,,3,"(4.697144,-74.140516)"
2020,Junio,Nueva Zelanda,554,2,0,,2,"(3.541112,-76.384584)"
2020,Junio,Nueva Zelanda,554,2,0,,2,"(4.697144,-74.140516)"
2020,Junio,Panamá,591,2,22,,24,"(10.408582,-75.538003)"
2020,Junio,Panamá,591,1,7,,8,"(12.5744111,-81.703935)"
2020,Junio,Panamá,591,0,7,,7,"(13.3387613,-81.372937)"
2020,Junio,Panamá,591,106,166,,272,"(4.697144,-74.140516)"
2020,Junio,Panamá,591,0,6,,6,"(6.171601,-75.427454)"
2020,Junio,Paraguay,600,3,53,,56,"(4.697144,-74.140516)"
2020,Junio,Perú,604,2,6,,8,"(-4.197703,-69.941278)"
2020,Junio,Perú,604,72,149,,221,"(4.697144,-74.140516)"
2020,Junio,Portugal,620,0,1,,1,"(4.697144,-74.140516)"
2020,Junio,Puerto Rico/Territorio de Estados Unidos,630,0,8,,8,"(4.697144,-74.140516)"
2020,Junio,Reino Unido de Gran Bretaña e Irlanda del Norte,826,1,0,,1,"(10.445761,-75.516429)"
2020,Junio,Reino Unido de Gran Bretaña e Irlanda del Norte,826,0,2,,2,"(3.541112,-76.384584)"
2020,Junio,Reino Unido de Gran Bretaña e Irlanda del Norte,826,90,61,,151,"(4.697144,-74.140516)"
2020,Junio,República Dominicana,214,24,28,,52,"(4.697144,-74.140516)"
2020,Junio,Singapur,702,1,0,,1,"(3.541112,-76.384584)"
2020,Junio,Singapur,702,2,1,,3,"(4.697144,-74.140516)"
2020,Junio,Suecia,752,2,2,,4,"(4.697144,-74.140516)"
2020,Junio,Suiza,756,8,7,,15,"(4.697144,-74.140516)"
2020,Junio,Uruguay,858,9,29,,38,"(4.697144,-74.140516)"
2020,Junio,Venezuela,862,0,72,,72,"(11.360009,-72.129330)"
2020,Junio,Venezuela,862,3,111,,114,"(4.697144,-74.140516)"
2020,Junio,Islas Turcas y Caicos/Territorio Británico de Ultramar,796,0,3,,3,"(7.128456,-73.183637)"
2020,Julio,Alemania,276,0,2,,2,"(10.445761,-75.516429)"
2020,Julio,Alemania,276,65,46,,111,"(4.697144,-74.140516)"
2020,Julio,Países Bajos,528,0,1,,1,"(10.408582,-75.538003)"
2020,Julio,Países Bajos,528,8,6,,14,"(10.445761,-75.516429)"
2020,Julio,Países Bajos,528,0,5,,5,"(10.886611,-74.776708)"
2020,Julio,Países Bajos,528,71,86,,157,"(4.697144,-74.140516)"
2020,Julio,Argentina,32,44,62,,106,"(4.697144,-74.140516)"
2020,Julio,Aruba,533,0,1,,1,"(11.247723,-74.213989)"
2020,Julio,Aruba,533,1,0,,1,"(4.697144,-74.140516)"
2020,Julio,Australia,36,0,1,,1,"(10.445761,-75.516429)"
2020,Julio,Australia,36,0,2,,2,"(4.697144,-74.140516)"
2020,Julio,Australia,36,1,0,,1,"(6.171601,-75.427454)"
2020,Julio,Austria,40,2,0,,2,"(4.697144,-74.140516)"
2020,Julio,Bahamas,44,1,0,,1,"(4.697144,-74.140516)"
2020,Julio,Barbados,52,0,1,,1,"(10.408582,-75.538003)"
2020,Julio,Bélgica,56,0,1,,1,"(10.445761,-75.516429)"
2020,Julio,Bélgica,56,6,4,,10,"(4.697144,-74.140516)"
2020,Julio,Bermudas/Territorio Británico de Ultramar,60,0,2,,2,"(4.697144,-74.140516)"
2020,Julio,Bolivia,68,4,8,,12,"(4.697144,-74.140516)"
2020,Julio,Bolivia,68,5,4,,9,"(6.171601,-75.427454)"
2020,Julio,Brasil,76,1,6,,7,"(-4.197703,-69.941278)"
2020,Julio,Brasil,76,1,2,,3,"(3.541112,-76.384584)"
2020,Julio,Brasil,76,30,49,,79,"(4.697144,-74.140516)"
2020,Julio,Brasil,76,4,7,,11,"(6.171601,-75.427454)"
2020,Julio,Islas Caimán/Territorio Británico de Ultramar,136,2,2,,4,"(12.5744111,-81.703935)"
2020,Julio,Canadá,124,3,2,,5,"(10.445761,-75.516429)"
2020,Julio,Canadá,124,4,1,,5,"(3.541112,-76.384584)"
2020,Julio,Canadá,124,16,16,,32,"(4.697144,-74.140516)"
2020,Julio,Canadá,124,2,2,,4,"(6.171601,-75.427454)"
2020,Julio,España,724,1,69,,70,"(10.886611,-74.776708)"
2020,Julio,España,724,789,566,,1355,"(4.697144,-74.140516)"
2020,Julio,República de Corea,410,4,2,,6,"(4.697144,-74.140516)"
2020,Julio,Costa de Marfil,384,1,1,,2,"(4.697144,-74.140516)"
2020,Julio,Costa Rica,188,0,2,,2,"(10.886611,-74.776708)"
2020,Julio,Costa Rica,188,2,24,,26,"(12.5744111,-81.703935)"
2020,Julio,Costa Rica,188,0,3,,3,"(12.586067,-81.702563)"
2020,Julio,Costa Rica,188,0,1,,1,"(3.541112,-76.384584)"
2020,Julio,Costa Rica,188,24,21,,45,"(4.697144,-74.140516)"
2020,Julio,Costa Rica,188,0,2,,2,"(6.171601,-75.427454)"
2020,Julio,Croacia,191,1,2,,3,"(4.697144,-74.140516)"
2020,Julio,Curazao,99999,3,3,,6,"(10.886611,-74.776708)"
2020,Julio,Curazao,99999,0,22,,22,"(4.697144,-74.140516)"
2020,Julio,República Checa,203,0,1,,1,"(4.697144,-74.140516)"
2020,Julio,Chile,152,70,64,,134,"(4.697144,-74.140516)"
2020,Julio,Chile,152,0,4,,4,"(6.171601,-75.427454)"
2020,Julio,China,156,2,7,,9,"(4.697144,-74.140516)"
2020,Julio,Dinamarca,208,1,2,,3,"(4.697144,-74.140516)"
2020,Julio,Ecuador,218,56,74,,130,"(0.814836,-77.662532)"
2020,Julio,Ecuador,218,45,136,,181,"(4.697144,-74.140516)"
2020,Julio,Ecuador,218,3,8,,11,"(6.171601,-75.427454)"
2020,Julio,Ecuador,218,0,5,,5,"(7.128456,-73.183637)"
2020,Julio,Egipto,818,1,1,,2,"(4.697144,-74.140516)"
2020,Julio,El Salvador,222,8,26,,34,"(4.697144,-74.140516)"
2020,Julio,Estados Unidos de América,840,150,112,,262,"(10.445761,-75.516429)"
2020,Julio,Estados Unidos de América,840,11,18,,29,"(10.886611,-74.776708)"
2020,Julio,Estados Unidos de América,840,348,249,,597,"(3.541112,-76.384584)"
2020,Julio,Estados Unidos de América,840,827,952,,1779,"(4.697144,-74.140516)"
2020,Julio,Estados Unidos de América,840,271,325,,596,"(6.171601,-75.427454)"
2020,Julio,Estados Unidos de América,840,3,2,,5,"(7.128456,-73.183637)"
2020,Julio,Estonia,233,0,1,,1,"(10.445761,-75.516429)"
2020,Julio,Filipinas,608,1,0,,1,"(4.697144,-74.140516)"
2020,Julio,Francia,250,6,2,,8,"(10.445761,-75.516429)"
2020,Julio,Francia,250,1,0,,1,"(11.117806,-74.232622)"
2020,Julio,Francia,250,173,123,,296,"(4.697144,-74.140516)"
2020,Julio,Grecia,300,2,3,,5,"(4.697144,-74.140516)"
2020,Julio,Guatemala,320,9,8,,17,"(4.697144,-74.140516)"
2020,Julio,Guyana,328,0,3,,3,"(4.697144,-74.140516)"
2020,Julio,Honduras,340,1,5,,6,"(10.886611,-74.776708)"
2020,Julio,Israel,376,3,4,,7,"(4.697144,-74.140516)"
2020,Julio,Italia,380,8,7,,15,"(10.445761,-75.516429)"
2020,Julio,Italia,380,50,22,,72,"(4.697144,-74.140516)"
2020,Julio,Japón,392,0,1,,1,"(3.541112,-76.384584)"
2020,Julio,Japón,392,10,9,,19,"(4.697144,-74.140516)"
2020,Julio,Kuwait,414,0,1,,1,"(4.697144,-74.140516)"
2020,Julio,Kuwait,414,1,1,,2,"(6.171601,-75.427454)"
2020,Julio,Líbano,422,1,0,,1,"(4.697144,-74.140516)"
2020,Julio,Luxemburgo,442,1,0,,1,"(4.697144,-74.140516)"
2020,Julio,México,484,0,2,,2,"(10.886611,-74.776708)"
2020,Julio,México,484,1,1,,2,"(3.541112,-76.384584)"
2020,Julio,México,484,84,83,,167,"(4.697144,-74.140516)"
2020,Julio,México,484,2,11,,13,"(6.171601,-75.427454)"
2020,Julio,Noruega,578,2,2,,4,"(4.697144,-74.140516)"
2020,Julio,Panamá,591,0,10,,10,"(10.408582,-75.538003)"
2020,Julio,Panamá,591,1,12,,13,"(10.971302,-74.765397)"
2020,Julio,Panamá,591,0,5,,5,"(11.117806,-74.232622)"
2020,Julio,Panamá,591,1,19,,20,"(12.5744111,-81.703935)"
2020,Julio,Panamá,591,0,3,,3,"(3.541112,-76.384584)"
2020,Julio,Panamá,591,101,227,,328,"(4.697144,-74.140516)"
2020,Julio,Panamá,591,0,5,,5,"(6.171601,-75.427454)"
2020,Julio,Paraguay,600,3,43,,46,"(4.697144,-74.140516)"
2020,Julio,Perú,604,1,13,,14,"(-4.197703,-69.941278)"
2020,Julio,Perú,604,27,111,,138,"(4.697144,-74.140516)"
2020,Julio,Polonia,616,1,0,,1,"(4.697144,-74.140516)"
2020,Julio,Portugal,620,2,1,,3,"(4.697144,-74.140516)"
2020,Julio,Puerto Rico/Territorio de Estados Unidos,630,1,0,,1,"(10.445761,-75.516429)"
2020,Julio,Puerto Rico/Territorio de Estados Unidos,630,1,0,,1,"(6.171601,-75.427454)"
2020,Julio,Reino Unido de Gran Bretaña e Irlanda del Norte,826,0,2,,2,"(3.541112,-76.384584)"
2020,Julio,Reino Unido de Gran Bretaña e Irlanda del Norte,826,60,62,,122,"(4.697144,-74.140516)"
2020,Julio,República CentroÁfricana,140,1,0,,1,"(4.697144,-74.140516)"
2020,Julio,Federación de Rusia,643,1,0,,1,"(4.697144,-74.140516)"
2020,Julio,República Dominicana,214,1,2,,3,"(10.445761,-75.516429)"
2020,Julio,República Dominicana,214,1,11,,12,"(10.886611,-74.776708)"
2020,Julio,República Dominicana,214,9,15,,24,"(4.697144,-74.140516)"
2020,Julio,República Dominicana,214,0,4,,4,"(6.171601,-75.427454)"
2020,Julio,Sahara Occidental/Desierto Sahara,732,0,1,,1,"(4.697144,-74.140516)"
2020,Julio,Suecia,752,0,1,,1,"(10.445761,-75.516429)"
2020,Julio,Suecia,752,5,4,,9,"(4.697144,-74.140516)"
2020,Julio,Suiza,756,46,36,,82,"(4.697144,-74.140516)"
2020,Julio,Surinam,740,5,2,,7,"(4.697144,-74.140516)"
2020,Julio,Turquía,792,1,0,,1,"(4.697144,-74.140516)"
2020,Julio,Uruguay,858,0,12,,12,"(4.697144,-74.140516)"
2020,Julio,Venezuela,862,0,4,,4,"(10.886611,-74.776708)"
2020,Julio,Venezuela,862,0,121,,121,"(11.360009,-72.129330)"
2020,Julio,Venezuela,862,0,52,,52,"(4.697144,-74.140516)"
2020,Julio,Vietnam,704,0,1,,1,"(6.171601,-75.427454)"
2020,Agosto,Alemania,276,9,7,,16,"(10.445761,-75.516429)"
2020,Agosto,Alemania,276,71,44,,115,"(4.697144,-74.140516)"
2020,Agosto,Países Bajos,528,21,7,,28,"(10.445761,-75.516429)"
2020,Agosto,Países Bajos,528,117,129,,246,"(4.697144,-74.140516)"
2020,Agosto,Argelia,12,0,3,,3,"(4.697144,-74.140516)"
2020,Agosto,Argentina,32,39,51,,90,"(4.697144,-74.140516)"
2020,Agosto,República de Armenia,51,1,0,,1,"(6.171601,-75.427454)"
2020,Agosto,Aruba,533,7,22,,29,"(4.697144,-74.140516)"
2020,Agosto,Aruba,533,0,1,,1,"(6.171601,-75.427454)"
2020,Agosto,Aruba,533,2,6,,8,"(7.128456,-73.183637)"
2020,Agosto,Australia,36,0,1,,1,"(3.541112,-76.384584)"
2020,Agosto,Australia,36,4,2,,6,"(4.697144,-74.140516)"
2020,Agosto,Australia,36,1,1,,2,"(6.171601,-75.427454)"
2020,Agosto,Austria,40,1,1,,2,"(10.445761,-75.516429)"
2020,Agosto,Austria,40,0,2,,2,"(4.697144,-74.140516)"
2020,Agosto,Bahamas,44,0,14,,14,"(10.886611,-74.776708)"
2020,Agosto,Bahamas,44,6,7,,13,"(4.697144,-74.140516)"
2020,Agosto,Barbados,52,0,8,,8,"(10.408582,-75.538003)"
2020,Agosto,Barbados,52,0,11,,11,"(4.697144,-74.140516)"
2020,Agosto,Bélgica,56,38,41,,79,"(4.697144,-74.140516)"
2020,Agosto,Bolivia,68,0,2,,2,"(10.445761,-75.516429)"
2020,Agosto,Bolivia,68,6,22,,28,"(4.697144,-74.140516)"
2020,Agosto,Brasil,76,5,5,,10,"(-4.197703,-69.941278)"
2020,Agosto,Brasil,76,1,10,,11,"(10.408582,-75.538003)"
2020,Agosto,Brasil,76,14,23,,37,"(4.697144,-74.140516)"
2020,Agosto,Burkina Faso,854,0,1,,1,"(4.697144,-74.140516)"
2020,Agosto,Canadá,124,5,2,,7,"(3.541112,-76.384584)"
2020,Agosto,Canadá,124,17,24,,41,"(4.697144,-74.140516)"
2020,Agosto,Canadá,124,0,1,,1,"(6.171601,-75.427454)"
2020,Agosto,España,724,0,3,,3,"(10.408582,-75.538003)"
2020,Agosto,España,724,2,2,,4,"(10.445761,-75.516429)"
2020,Agosto,España,724,1,60,,61,"(10.886611,-74.776708)"
2020,Agosto,España,724,424,283,,707,"(4.697144,-74.140516)"
2020,Agosto,República de Corea,410,3,9,,12,"(4.697144,-74.140516)"
2020,Agosto,República de Corea,410,0,1,,1,"(6.171601,-75.427454)"
2020,Agosto,Costa Rica,188,21,38,,59,"(4.697144,-74.140516)"
2020,Agosto,Costa Rica,188,0,2,,2,"(6.171601,-75.427454)"
2020,Agosto,Croacia,191,1,0,,1,"(10.445761,-75.516429)"
2020,Agosto,Croacia,191,5,0,,5,"(4.697144,-74.140516)"
2020,Agosto,Cuba,192,7,4,,11,"(4.697144,-74.140516)"
2020,Agosto,Curazao,99999,1,11,,12,"(10.971302,-74.765397)"
2020,Agosto,Curazao,99999,5,23,,28,"(4.697144,-74.140516)"
2020,Agosto,República Checa,203,1,0,,1,"(4.697144,-74.140516)"
2020,Agosto,Chile,152,0,13,,13,"(4.697144,-74.140516)"
2020,Agosto,Dinamarca,208,1,0,,1,"(10.445761,-75.516429)"
2020,Agosto,Dinamarca,208,2,5,,7,"(4.697144,-74.140516)"
2020,Agosto,Ecuador,218,53,72,,125,"(0.814836,-77.662532)"
2020,Agosto,Ecuador,218,0,4,,4,"(1.813928,-78.763924)"
2020,Agosto,Ecuador,218,0,1,,1,"(10.408582,-75.538003)"
2020,Agosto,Ecuador,218,0,3,,3,"(10.886611,-74.776708)"
2020,Agosto,Ecuador,218,0,6,,6,"(3.541112,-76.384584)"
2020,Agosto,Ecuador,218,3,122,,125,"(4.697144,-74.140516)"
2020,Agosto,Egipto,818,0,1,,1,"(4.697144,-74.140516)"
2020,Agosto,El Salvador,222,5,23,,28,"(4.697144,-74.140516)"
2020,Agosto,El Salvador,222,0,2,,2,"(6.171601,-75.427454)"
2020,Agosto,Emiratos Árabes,784,1,1,,2,"(4.697144,-74.140516)"
2020,Agosto,Estados Unidos de América,840,82,89,,171,"(10.445761,-75.516429)"
2020,Agosto,Estados Unidos de América,840,20,46,,66,"(10.886611,-74.776708)"
2020,Agosto,Estados Unidos de América,840,0,2,,2,"(11.117806,-74.232622)"
2020,Agosto,Estados Unidos de América,840,0,1,,1,"(11.247723,-74.213989)"
2020,Agosto,Estados Unidos de América,840,222,153,,375,"(3.541112,-76.384584)"
2020,Agosto,Estados Unidos de América,840,1042,1166,,2208,"(4.697144,-74.140516)"
2020,Agosto,Estados Unidos de América,840,221,326,,547,"(6.171601,-75.427454)"
2020,Agosto,Finlandia,246,0,1,,1,"(4.697144,-74.140516)"
2020,Agosto,Francia,250,4,2,,6,"(10.445761,-75.516429)"
2020,Agosto,Francia,250,229,176,,405,"(4.697144,-74.140516)"
2020,Agosto,Georgia,268,0,1,,1,"(4.697144,-74.140516)"
2020,Agosto,Guatemala,320,0,2,,2,"(1.813928,-78.763924)"
2020,Agosto,Guatemala,320,0,2,,2,"(4.697144,-74.140516)"
2020,Agosto,Guinea Ecuatorial,226,0,1,,1,"(4.697144,-74.140516)"
2020,Agosto,Guinea Bissau,624,1,0,,1,"(4.697144,-74.140516)"
2020,Agosto,Haití,332,0,6,,6,"(4.697144,-74.140516)"
2020,Agosto,Honduras,340,0,3,,3,"(10.445761,-75.516429)"
2020,Agosto,Honduras,340,0,3,,3,"(10.886611,-74.776708)"
2020,Agosto,Honduras,340,1,0,,1,"(4.697144,-74.140516)"
2020,Agosto,Hungría,348,1,0,,1,"(4.697144,-74.140516)"
2020,Agosto,República de Irlanda,372,0,2,,2,"(4.697144,-74.140516)"
2020,Agosto,Islandia,352,1,1,,2,"(4.697144,-74.140516)"
2020,Agosto,Israel,376,1,1,,2,"(3.541112,-76.384584)"
2020,Agosto,Israel,376,3,3,,6,"(4.697144,-74.140516)"
2020,Agosto,Italia,380,10,5,,15,"(10.445761,-75.516429)"
2020,Agosto,Italia,380,35,11,,46,"(4.697144,-74.140516)"
2020,Agosto,Italia,380,1,0,,1,"(6.171601,-75.427454)"
2020,Agosto,Jamaica,388,2,8,,10,"(10.886611,-74.776708)"
2020,Agosto,Jamaica,388,3,3,,6,"(6.171601,-75.427454)"
2020,Agosto,Japón,392,1,0,,1,"(3.541112,-76.384584)"
2020,Agosto,Japón,392,1,0,,1,"(4.697144,-74.140516)"
2020,Agosto,Kenia,404,1,0,,1,"(4.697144,-74.140516)"
2020,Agosto,Lituania,440,1,1,,2,"(4.697144,-74.140516)"
2020,Agosto,Líbano,422,2,4,,6,"(10.445761,-75.516429)"
2020,Agosto,Líbano,422,0,3,,3,"(4.697144,-74.140516)"
2020,Agosto,Luxemburgo,442,1,1,,2,"(4.697144,-74.140516)"
2020,Agosto,Malta,470,0,1,,1,"(4.697144,-74.140516)"
2020,Agosto,México,484,3,1,,4,"(3.541112,-76.384584)"
2020,Agosto,México,484,117,128,,245,"(4.697144,-74.140516)"
2020,Agosto,México,484,1,2,,3,"(6.171601,-75.427454)"
2020,Agosto,Mónaco,492,0,1,,1,"(4.697144,-74.140516)"
2020,Agosto,Noruega,578,8,3,,11,"(4.697144,-74.140516)"
2020,Agosto,Panamá,591,3,17,,20,"(10.408582,-75.538003)"
2020,Agosto,Panamá,591,3,4,,7,"(10.886611,-74.776708)"
2020,Agosto,Panamá,591,0,6,,6,"(12.165168,-71.983761)"
2020,Agosto,Panamá,591,1,7,,8,"(12.5744111,-81.703935)"
2020,Agosto,Panamá,591,0,15,,15,"(13.3387613,-81.372937)"
2020,Agosto,Panamá,591,0,2,,2,"(3.893038,-77.067921)"
2020,Agosto,Panamá,591,16,204,,220,"(4.697144,-74.140516)"
2020,Agosto,Panamá,591,0,1,,1,"(4.815061,-75.736532)"
2020,Agosto,Panamá,591,0,2,,2,"(6.171601,-75.427454)"
2020,Agosto,Paraguay,600,2,46,,48,"(4.697144,-74.140516)"
2020,Agosto,Perú,604,0,7,,7,"(-4.197703,-69.941278)"
2020,Agosto,Perú,604,0,3,,3,"(-4.223468,-69.945098)"
2020,Agosto,Perú,604,43,115,,158,"(4.697144,-74.140516)"
2020,Agosto,Polonia,616,1,0,,1,"(10.445761,-75.516429)"
2020,Agosto,Polonia,616,1,0,,1,"(4.697144,-74.140516)"
2020,Agosto,Portugal,620,3,2,,5,"(4.697144,-74.140516)"
2020,Agosto,Polinesia Francesa/Colectividad de Ultramar Francesa,258,0,2,,2,"(10.408582,-75.538003)"
2020,Agosto,Puerto Rico/Territorio de Estados Unidos,630,1,0,,1,"(4.697144,-74.140516)"
2020,Agosto,Reino Unido de Gran Bretaña e Irlanda del Norte,826,18,11,,29,"(4.697144,-74.140516)"
2020,Agosto,Reino Unido de Gran Bretaña e Irlanda del Norte,826,1,0,,1,"(6.171601,-75.427454)"
2020,Agosto,República Dominicana,214,1,7,,8,"(10.886611,-74.776708)"
2020,Agosto,República Dominicana,214,24,34,,58,"(4.697144,-74.140516)"
2020,Agosto,República Dominicana,214,2,1,,3,"(6.171601,-75.427454)"
2020,Agosto,Rumania,642,1,2,,3,"(4.697144,-74.140516)"
2020,Agosto,Sudáfrica,710,2,2,,4,"(4.697144,-74.140516)"
2020,Agosto,Suecia,752,8,5,,13,"(4.697144,-74.140516)"
2020,Agosto,Suiza,756,26,13,,39,"(4.697144,-74.140516)"
2020,Agosto,Surinam,740,3,3,,6,"(4.697144,-74.140516)"
2020,Agosto,Tailandia,764,1,0,,1,"(10.445761,-75.516429)"
2020,Agosto,Turquía,792,1,0,,1,"(10.445761,-75.516429)"
2020,Agosto,Ucrania,804,0,1,,1,"(4.697144,-74.140516)"
2020,Agosto,Uruguay,858,0,12,,12,"(4.697144,-74.140516)"
2020,Agosto,Venezuela,862,0,4,,4,"(10.886611,-74.776708)"
2020,Agosto,Venezuela,862,0,125,,125,"(11.360009,-72.129330)"
2020,Agosto,Venezuela,862,0,76,,76,"(4.697144,-74.140516)"
2020,Agosto,Islas Vírgenes Británicas/Territorio Británico de Ultramar,92,0,1,,1,"(10.408582,-75.538003)"
2020,Septiembre,Alemania,276,20,11,,31,"(10.445761,-75.516429)"
2020,Septiembre,Alemania,276,0,1,,1,"(3.541112,-76.384584)"
2020,Septiembre,Alemania,276,95,64,,159,"(4.697144,-74.140516)"
2020,Septiembre,Alemania,276,3,1,,4,"(6.171601,-75.427454)"
2020,Septiembre,Antigua y Barbuda,28,1,0,,1,"(4.697144,-74.140516)"
2020,Septiembre,Países Bajos,528,9,7,,16,"(10.445761,-75.516429)"
2020,Septiembre,Países Bajos,528,3,4,,7,"(3.541112,-76.384584)"
2020,Septiembre,Países Bajos,528,179,176,,355,"(4.697144,-74.140516)"
2020,Septiembre,Países Bajos,528,1,0,,1,"(6.171601,-75.427454)"
2020,Septiembre,Arabia Saudita,682,1,1,,2,"(3.541112,-76.384584)"
2020,Septiembre,Arabia Saudita,682,0,7,,7,"(4.697144,-74.140516)"
2020,Septiembre,Argelia,12,0,1,,1,"(4.697144,-74.140516)"
2020,Septiembre,Argentina,32,54,71,,125,"(4.697144,-74.140516)"
2020,Septiembre,Argentina,32,1,6,,7,"(6.171601,-75.427454)"
2020,Septiembre,República de Armenia,51,1,0,,1,"(10.445761,-75.516429)"
2020,Septiembre,Aruba,533,0,4,,4,"(10.886611,-74.776708)"
2020,Septiembre,Aruba,533,37,28,,65,"(4.697144,-74.140516)"
2020,Septiembre,Aruba,533,2,13,,15,"(7.128456,-73.183637)"
2020,Septiembre,Australia,36,1,0,,1,"(4.697144,-74.140516)"
2020,Septiembre,Austria,40,4,4,,8,"(4.697144,-74.140516)"
2020,Septiembre,Azerbaiyán,31,0,1,,1,"(4.697144,-74.140516)"
2020,Septiembre,Bahréin,48,0,1,,1,"(10.445761,-75.516429)"
2020,Septiembre,Barbados,52,2,1,,3,"(3.541112,-76.384584)"
2020,Septiembre,Bélgica,56,2,2,,4,"(10.445761,-75.516429)"
2020,Septiembre,Bélgica,56,18,17,,35,"(4.697144,-74.140516)"
2020,Septiembre,Bolivia,68,2,13,,15,"(4.697144,-74.140516)"
2020,Septiembre,Bolivia,68,1,0,,1,"(6.171601,-75.427454)"
2020,Septiembre,Bosnia y Herzegovina,70,1,0,,1,"(4.697144,-74.140516)"
2020,Septiembre,Brasil,76,18,27,,45,"(-4.197703,-69.941278)"
2020,Septiembre,Brasil,76,0,3,,3,"(10.445761,-75.516429)"
2020,Septiembre,Brasil,76,6,37,,43,"(3.541112,-76.384584)"
2020,Septiembre,Brasil,76,57,72,,129,"(4.697144,-74.140516)"
2020,Septiembre,Brasil,76,0,1,,1,"(6.171601,-75.427454)"
2020,Septiembre,Bulgaria,100,1,0,,1,"(4.697144,-74.140516)"
2020,Septiembre,Canadá,124,2,6,,8,"(10.445761,-75.516429)"
2020,Septiembre,Canadá,124,10,3,,13,"(3.541112,-76.384584)"
2020,Septiembre,Canadá,124,110,77,,187,"(4.697144,-74.140516)"
2020,Septiembre,Canadá,124,3,6,,9,"(6.171601,-75.427454)"
2020,Septiembre,España,724,0,5,,5,"(10.408582,-75.538003)"
2020,Septiembre,España,724,6,4,,10,"(10.445761,-75.516429)"
2020,Septiembre,España,724,0,65,,65,"(10.886611,-74.776708)"
2020,Septiembre,España,724,1,1,,2,"(3.541112,-76.384584)"
2020,Septiembre,España,724,1205,886,,2091,"(4.697144,-74.140516)"
2020,Septiembre,España,724,1,1,,2,"(6.171601,-75.427454)"
2020,Septiembre,República de Corea,410,0,3,,3,"(4.697144,-74.140516)"
2020,Septiembre,Costa Rica,188,3,16,,19,"(4.697144,-74.140516)"
2020,Septiembre,Croacia,191,1,4,,5,"(4.697144,-74.140516)"
2020,Septiembre,Cuba,192,2,3,,5,"(4.697144,-74.140516)"
2020,Septiembre,Curazao,99999,2,3,,5,"(10.886611,-74.776708)"
2020,Septiembre,Curazao,99999,8,38,,46,"(4.697144,-74.140516)"
2020,Septiembre,República Checa,203,1,5,,6,"(4.697144,-74.140516)"
2020,Septiembre,Chile,152,1,0,,1,"(3.541112,-76.384584)"
2020,Septiembre,Chile,152,5,23,,28,"(4.697144,-74.140516)"
2020,Septiembre,China,156,2,4,,6,"(4.697144,-74.140516)"
2020,Septiembre,Chipre,196,2,0,,2,"(4.697144,-74.140516)"
2020,Septiembre,Dinamarca,208,1,1,,2,"(10.445761,-75.516429)"
2020,Septiembre,Dinamarca,208,6,2,,8,"(4.697144,-74.140516)"
2020,Septiembre,Ecuador,218,47,53,,100,"(0.814836,-77.662532)"
2020,Septiembre,Ecuador,218,0,23,,23,"(10.408582,-75.538003)"
2020,Septiembre,Ecuador,218,2,35,,37,"(10.886611,-74.776708)"
2020,Septiembre,Ecuador,218,1,1,,2,"(3.541112,-76.384584)"
2020,Septiembre,Ecuador,218,6,120,,126,"(4.697144,-74.140516)"
2020,Septiembre,Ecuador,218,5,17,,22,"(6.171601,-75.427454)"
2020,Septiembre,Ecuador,218,5,7,,12,"(7.128456,-73.183637)"
2020,Septiembre,Egipto,818,0,139,,139,"(4.697144,-74.140516)"
2020,Septiembre,El Salvador,222,0,24,,24,"(4.697144,-74.140516)"
2020,Septiembre,Emiratos Árabes,784,1,3,,4,"(3.541112,-76.384584)"
2020,Septiembre,Emiratos Árabes,784,9,18,,27,"(4.697144,-74.140516)"
2020,Septiembre,Emiratos Árabes,784,0,2,,2,"(6.171601,-75.427454)"
2020,Septiembre,Eslovaquia,703,2,0,,2,"(4.697144,-74.140516)"
2020,Septiembre,Eslovenia,705,1,1,,2,"(4.697144,-74.140516)"
2020,Septiembre,Estados Unidos de América,840,0,6,,6,"(10.408582,-75.538003)"
2020,Septiembre,Estados Unidos de América,840,838,644,,1482,"(10.445761,-75.516429)"
2020,Septiembre,Estados Unidos de América,840,46,83,,129,"(10.886611,-74.776708)"
2020,Septiembre,Estados Unidos de América,840,0,1,,1,"(10.971302,-74.765397)"
2020,Septiembre,Estados Unidos de América,840,1153,706,,1860,"(3.541112,-76.384584)"
2020,Septiembre,Estados Unidos de América,840,2127,1982,,4109,"(4.697144,-74.140516)"
2020,Septiembre,Estados Unidos de América,840,1702,1428,,3130,"(6.171601,-75.427454)"
2020,Septiembre,Estados Unidos de América,840,1,1,,2,"(7.128456,-73.183637)"
2020,Septiembre,Estados Unidos de América,840,6,13,,19,"(7.927209,-72.507910)"
2020,Septiembre,Filipinas,608,0,1,,1,"(4.697144,-74.140516)"
2020,Septiembre,Finlandia,246,3,3,,6,"(4.697144,-74.140516)"
2020,Septiembre,Francia,250,3,1,,4,"(10.445761,-75.516429)"
2020,Septiembre,Francia,250,2,2,,4,"(3.541112,-76.384584)"
2020,Septiembre,Francia,250,287,255,,542,"(4.697144,-74.140516)"
2020,Septiembre,Francia,250,0,4,,4,"(6.171601,-75.427454)"
2020,Septiembre,Grecia,300,0,1,,1,"(10.445761,-75.516429)"
2020,Septiembre,Grecia,300,2,3,,5,"(4.697144,-74.140516)"
2020,Septiembre,Guatemala,320,2,4,,6,"(4.697144,-74.140516)"
2020,Septiembre,Guyana,328,1,5,,6,"(6.171601,-75.427454)"
2020,Septiembre,Guinea Ecuatorial,226,0,1,,1,"(4.697144,-74.140516)"
2020,Septiembre,Honduras,340,0,2,,2,"(10.445761,-75.516429)"
2020,Septiembre,Honduras,340,0,6,,6,"(10.886611,-74.776708)"
2020,Septiembre,Honduras,340,0,1,,1,"(4.697144,-74.140516)"
2020,Septiembre,Hong Kong,344,1,3,,4,"(4.697144,-74.140516)"
2020,Septiembre,Hungría,348,4,2,,6,"(4.697144,-74.140516)"
2020,Septiembre,Iraq,368,0,1,,1,"(10.408582,-75.538003)"
2020,Septiembre,Iraq,368,1,0,,1,"(4.697144,-74.140516)"
2020,Septiembre,Israel,376,6,2,,8,"(4.697144,-74.140516)"
2020,Septiembre,Italia,380,1,0,,1,"(10.445761,-75.516429)"
2020,Septiembre,Italia,380,69,18,,87,"(4.697144,-74.140516)"
2020,Septiembre,Jamaica,388,2,7,,9,"(10.445761,-75.516429)"
2020,Septiembre,Jamaica,388,2,5,,7,"(10.886611,-74.776708)"
2020,Septiembre,Jamaica,388,2,2,,4,"(4.697144,-74.140516)"
2020,Septiembre,Jamaica,388,3,6,,9,"(6.171601,-75.427454)"
2020,Septiembre,Japón,392,2,1,,3,"(4.697144,-74.140516)"
2020,Septiembre,Kenia,404,1,0,,1,"(4.697144,-74.140516)"
2020,Septiembre,Líbano,422,4,7,,11,"(10.445761,-75.516429)"
2020,Septiembre,Líbano,422,2,4,,6,"(4.697144,-74.140516)"
2020,Septiembre,Luxemburgo,442,1,0,,1,"(10.445761,-75.516429)"
2020,Septiembre,Luxemburgo,442,1,1,,2,"(4.697144,-74.140516)"
2020,Septiembre,Malí,466,0,1,,1,"(6.171601,-75.427454)"
2020,Septiembre,Malta,470,1,0,,1,"(4.697144,-74.140516)"
2020,Septiembre,Mauritania,478,0,1,,1,"(4.697144,-74.140516)"
2020,Septiembre,México,484,9,13,,22,"(10.445761,-75.516429)"
2020,Septiembre,México,484,0,1,,1,"(10.886611,-74.776708)"
2020,Septiembre,México,484,4,3,,7,"(3.541112,-76.384584)"
2020,Septiembre,México,484,91,89,,180,"(4.697144,-74.140516)"
2020,Septiembre,México,484,3,0,,3,"(4.815061,-75.736532)"
2020,Septiembre,México,484,11,22,,33,"(6.171601,-75.427454)"
2020,Septiembre,Nicaragua,558,0,1,,1,"(6.171601,-75.427454)"
2020,Septiembre,Nigeria,566,0,1,,1,"(4.697144,-74.140516)"
2020,Septiembre,Noruega,578,2,3,,5,"(4.697144,-74.140516)"
2020,Septiembre,Nueva Zelanda,554,1,2,,3,"(4.697144,-74.140516)"
2020,Septiembre,Omán,512,0,1,,1,"(4.697144,-74.140516)"
2020,Septiembre,Panamá,591,1,28,,29,"(10.408582,-75.538003)"
2020,Septiembre,Panamá,591,0,2,,2,"(10.445761,-75.516429)"
2020,Septiembre,Panamá,591,2,18,,20,"(10.886611,-74.776708)"
2020,Septiembre,Panamá,591,0,6,,6,"(12.165168,-71.983761)"
2020,Septiembre,Panamá,591,2,15,,17,"(12.5744111,-81.703935)"
2020,Septiembre,Panamá,591,5,5,,10,"(3.541112,-76.384584)"
2020,Septiembre,Panamá,591,55,238,,293,"(4.697144,-74.140516)"
2020,Septiembre,Panamá,591,4,33,,37,"(6.171601,-75.427454)"
2020,Septiembre,Paraguay,600,1,0,,1,"(10.886611,-74.776708)"
2020,Septiembre,Paraguay,600,8,73,,81,"(4.697144,-74.140516)"
2020,Septiembre,Perú,604,0,3,,3,"(-4.223468,-69.945098)"
2020,Septiembre,Perú,604,6,125,,131,"(4.697144,-74.140516)"
2020,Septiembre,Perú,604,7,13,,20,"(6.171601,-75.427454)"
2020,Septiembre,Polonia,616,1,6,,7,"(4.697144,-74.140516)"
2020,Septiembre,Portugal,620,2,1,,3,"(10.445761,-75.516429)"
2020,Septiembre,Portugal,620,4,11,,15,"(4.697144,-74.140516)"
2020,Septiembre,Puerto Rico/Territorio de Estados Unidos,630,0,1,,1,"(10.408582,-75.538003)"
2020,Septiembre,Puerto Rico/Territorio de Estados Unidos,630,1,2,,3,"(10.445761,-75.516429)"
2020,Septiembre,Puerto Rico/Territorio de Estados Unidos,630,0,2,,2,"(3.541112,-76.384584)"
2020,Septiembre,Puerto Rico/Territorio de Estados Unidos,630,3,2,,5,"(4.697144,-74.140516)"
2020,Septiembre,Puerto Rico/Territorio de Estados Unidos,630,4,3,,7,"(6.171601,-75.427454)"
2020,Septiembre,Qatar,634,0,1,,1,"(4.697144,-74.140516)"
2020,Septiembre,Reino Unido de Gran Bretaña e Irlanda del Norte,826,2,2,,4,"(10.445761,-75.516429)"
2020,Septiembre,Reino Unido de Gran Bretaña e Irlanda del Norte,826,2,3,,5,"(3.541112,-76.384584)"
2020,Septiembre,Reino Unido de Gran Bretaña e Irlanda del Norte,826,129,120,,249,"(4.697144,-74.140516)"
2020,Septiembre,Reino Unido de Gran Bretaña e Irlanda del Norte,826,1,0,,1,"(6.171601,-75.427454)"
2020,Septiembre,Federación de Rusia,643,1,4,,5,"(4.697144,-74.140516)"
2020,Septiembre,República Dominicana,214,3,3,,6,"(10.445761,-75.516429)"
2020,Septiembre,República Dominicana,214,3,2,,5,"(10.886611,-74.776708)"
2020,Septiembre,República Dominicana,214,3,3,,6,"(11.117806,-74.232622)"
2020,Septiembre,República Dominicana,214,1,2,,3,"(3.541112,-76.384584)"
2020,Septiembre,República Dominicana,214,5,14,,19,"(4.697144,-74.140516)"
2020,Septiembre,República Dominicana,214,10,25,,35,"(6.171601,-75.427454)"
2020,Septiembre,República Dominicana,214,0,1,,1,"(7.128456,-73.183637)"
2020,Septiembre,Serbia,688,1,0,,1,"(4.697144,-74.140516)"
2020,Septiembre,Sudáfrica,710,0,1,,1,"(4.697144,-74.140516)"
2020,Septiembre,Suecia,752,2,4,,6,"(10.445761,-75.516429)"
2020,Septiembre,Suecia,752,15,4,,19,"(4.697144,-74.140516)"
2020,Septiembre,Suiza,756,3,1,,4,"(10.445761,-75.516429)"
2020,Septiembre,Suiza,756,36,14,,50,"(4.697144,-74.140516)"
2020,Septiembre,Surinam,740,3,10,,13,"(4.697144,-74.140516)"
2020,Septiembre,Taiwán,158,1,1,,2,"(4.697144,-74.140516)"
2020,Septiembre,Tailandia,764,2,0,,2,"(4.697144,-74.140516)"
2020,Septiembre,Trinidad y Tobago,780,0,12,,12,"(4.697144,-74.140516)"
2020,Septiembre,Turquía,792,1,0,,1,"(10.445761,-75.516429)"
2020,Septiembre,Turquía,792,1,2,,3,"(4.697144,-74.140516)"
2020,Septiembre,Turquía,792,1,0,,1,"(6.171601,-75.427454)"
2020,Septiembre,Uruguay,858,0,22,,22,"(4.697144,-74.140516)"
2020,Septiembre,Venezuela,862,0,1,,1,"(10.445761,-75.516429)"
2020,Septiembre,Venezuela,862,0,206,,206,"(11.360009,-72.129330)"
2020,Septiembre,Venezuela,862,0,53,,53,"(4.697144,-74.140516)"
2020,Septiembre,Venezuela,862,2,35,,37,"(6.171601,-75.427454)"
2020,Septiembre,Venezuela,862,0,8,,8,"(7.818934,-72.453226)"
2020,Septiembre,Desconocido,99999,1,0,,1,"(10.445761,-75.516429)"
2020,Octubre,Afganistán,4,0,1,,1,"(3.541112,-76.384584)"
2020,Octubre,Afganistán,4,1,6,,7,"(4.697144,-74.140516)"
2020,Octubre,Albania,8,2,1,,3,"(4.697144,-74.140516)"
2020,Octubre,Alemania,276,27,9,,36,"(10.445761,-75.516429)"
2020,Octubre,Alemania,276,10,1,,11,"(3.541112,-76.384584)"
2020,Octubre,Alemania,276,166,119,,285,"(4.697144,-74.140516)"
2020,Octubre,Alemania,276,17,11,,28,"(6.171601,-75.427454)"
2020,Octubre,Angola,24,1,1,,2,"(4.697144,-74.140516)"
2020,Octubre,Antigua y Barbuda,28,1,0,,1,"(6.171601,-75.427454)"
2020,Octubre,Países Bajos,528,60,18,,78,"(10.445761,-75.516429)"
2020,Octubre,Países Bajos,528,11,8,,19,"(10.886611,-74.776708)"
2020,Octubre,Países Bajos,528,3,1,,4,"(3.541112,-76.384584)"
2020,Octubre,Países Bajos,528,228,207,,435,"(4.697144,-74.140516)"
2020,Octubre,Países Bajos,528,7,7,,14,"(6.171601,-75.427454)"
2020,Octubre,Arabia Saudita,682,0,2,,2,"(10.445761,-75.516429)"
2020,Octubre,Arabia Saudita,682,1,9,,10,"(4.697144,-74.140516)"
2020,Octubre,Arabia Saudita,682,0,1,,1,"(6.171601,-75.427454)"
2020,Octubre,Argentina,32,1,0,,1,"(-0.193180,-74.784874)"
2020,Octubre,Argentina,32,1,3,,4,"(10.445761,-75.516429)"
2020,Octubre,Argentina,32,10,6,,16,"(3.541112,-76.384584)"
2020,Octubre,Argentina,32,58,97,,155,"(4.697144,-74.140516)"
2020,Octubre,Argentina,32,5,9,,14,"(6.171601,-75.427454)"
2020,Octubre,República de Armenia,51,0,1,,1,"(3.541112,-76.384584)"
2020,Octubre,Aruba,533,2,0,,2,"(10.886611,-74.776708)"
2020,Octubre,Aruba,533,1,0,,1,"(3.541112,-76.384584)"
2020,Octubre,Aruba,533,4,26,,30,"(4.697144,-74.140516)"
2020,Octubre,Aruba,533,1,1,,2,"(6.171601,-75.427454)"
2020,Octubre,Aruba,533,4,26,,30,"(7.128456,-73.183637)"
2020,Octubre,Australia,36,8,3,,11,"(4.697144,-74.140516)"
2020,Octubre,Australia,36,1,5,,6,"(6.171601,-75.427454)"
2020,Octubre,Austria,40,1,1,,2,"(10.445761,-75.516429)"
2020,Octubre,Austria,40,13,12,,25,"(4.697144,-74.140516)"
2020,Octubre,Austria,40,1,0,,1,"(6.171601,-75.427454)"
2020,Octubre,Azerbaiyán,31,0,1,,1,"(4.697144,-74.140516)"
2020,Octubre,Bahamas,44,0,1,,1,"(10.445761,-75.516429)"
2020,Octubre,Bahamas,44,0,1,,1,"(3.541112,-76.384584)"
2020,Octubre,Bahamas,44,1,1,,2,"(4.697144,-74.140516)"
2020,Octubre,Bahamas,44,2,1,,3,"(6.171601,-75.427454)"
2020,Octubre,Bahréin,48,3,0,,3,"(10.445761,-75.516429)"
2020,Octubre,Bahréin,48,3,2,,5,"(4.697144,-74.140516)"
2020,Octubre,Barbados,52,1,0,,1,"(4.697144,-74.140516)"
2020,Octubre,Barbados,52,4,1,,5,"(6.171601,-75.427454)"
2020,Octubre,Bélgica,56,0,1,,1,"(10.445761,-75.516429)"
2020,Octubre,Bélgica,56,1,1,,2,"(3.541112,-76.384584)"
2020,Octubre,Bélgica,56,15,14,,29,"(4.697144,-74.140516)"
2020,Octubre,Bélgica,56,1,1,,2,"(6.171601,-75.427454)"
2020,Octubre,Belice,84,0,1,,1,"(6.171601,-75.427454)"
2020,Octubre,Bermudas/Territorio Británico de Ultramar,60,1,0,,1,"(3.541112,-76.384584)"
2020,Octubre,Bolivia,68,0,1,,1,"(-0.193180,-74.784874)"
2020,Octubre,Bolivia,68,86,215,,301,"(4.697144,-74.140516)"
2020,Octubre,Bolivia,68,2,7,,9,"(6.171601,-75.427454)"
2020,Octubre,Brasil,76,53,65,,118,"(-4.197703,-69.941278)"
2020,Octubre,Brasil,76,7,5,,12,"(10.445761,-75.516429)"
2020,Octubre,Brasil,76,43,77,,120,"(3.541112,-76.384584)"
2020,Octubre,Brasil,76,404,555,,959,"(4.697144,-74.140516)"
2020,Octubre,Brasil,76,2,34,,36,"(4.815061,-75.736532)"
2020,Octubre,Brasil,76,42,39,,81,"(6.171601,-75.427454)"
2020,Octubre,Bulgaria,100,1,0,,1,"(3.541112,-76.384584)"
2020,Octubre,Burkina Faso,854,0,1,,1,"(4.697144,-74.140516)"
2020,Octubre,Islas Caimán/Territorio Británico de Ultramar,136,1,0,,1,"(3.541112,-76.384584)"
2020,Octubre,Canadá,124,6,8,,14,"(10.445761,-75.516429)"
2020,Octubre,Canadá,124,3,5,,8,"(10.886611,-74.776708)"
2020,Octubre,Canadá,124,37,22,,59,"(3.541112,-76.384584)"
2020,Octubre,Canadá,124,221,148,,369,"(4.697144,-74.140516)"
2020,Octubre,Canadá,124,64,57,,121,"(6.171601,-75.427454)"
2020,Octubre,España,724,6,7,,13,"(10.445761,-75.516429)"
2020,Octubre,España,724,4,68,,72,"(10.886611,-74.776708)"
2020,Octubre,España,724,18,18,,36,"(3.541112,-76.384584)"
2020,Octubre,España,724,1415,974,,2389,"(4.697144,-74.140516)"
2020,Octubre,España,724,114,70,,184,"(6.171601,-75.427454)"
2020,Octubre,Norfolk,574,1,0,,1,"(3.541112,-76.384584)"
2020,Octubre,Colombia,170,24,52,,76,"(4.697144,-74.140516)"
2020,Octubre,República de Corea,410,5,2,,7,"(4.697144,-74.140516)"
2020,Octubre,República de Corea,410,1,0,,1,"(6.171601,-75.427454)"
2020,Octubre,Costa de Marfil,384,0,1,,1,"(4.697144,-74.140516)"
2020,Octubre,Costa Rica,188,2,15,,17,"(12.5744111,-81.703935)"
2020,Octubre,Costa Rica,188,5,1,,6,"(3.541112,-76.384584)"
2020,Octubre,Costa Rica,188,12,39,,51,"(4.697144,-74.140516)"
2020,Octubre,Costa Rica,188,6,10,,16,"(6.171601,-75.427454)"
2020,Octubre,Croacia,191,1,1,,2,"(10.445761,-75.516429)"
2020,Octubre,Croacia,191,0,1,,1,"(3.541112,-76.384584)"
2020,Octubre,Croacia,191,6,2,,8,"(4.697144,-74.140516)"
2020,Octubre,Croacia,191,1,0,,1,"(6.171601,-75.427454)"
2020,Octubre,Cuba,192,1,0,,1,"(3.541112,-76.384584)"
2020,Octubre,Cuba,192,1,9,,10,"(4.697144,-74.140516)"
2020,Octubre,Cuba,192,10,8,,18,"(6.171601,-75.427454)"
2020,Octubre,Curazao,99999,0,1,,1,"(10.445761,-75.516429)"
2020,Octubre,Curazao,99999,3,10,,13,"(10.886611,-74.776708)"
2020,Octubre,Curazao,99999,1,0,,1,"(3.541112,-76.384584)"
2020,Octubre,Curazao,99999,8,29,,37,"(4.697144,-74.140516)"
2020,Octubre,Curazao,99999,2,2,,4,"(6.171601,-75.427454)"
2020,Octubre,República Checa,203,1,1,,2,"(10.445761,-75.516429)"
2020,Octubre,República Checa,203,0,2,,2,"(4.697144,-74.140516)"
2020,Octubre,Chile,152,13,5,,18,"(10.445761,-75.516429)"
2020,Octubre,Chile,152,0,45,,45,"(10.886611,-74.776708)"
2020,Octubre,Chile,152,300,209,,509,"(3.541112,-76.384584)"
2020,Octubre,Chile,152,492,336,,828,"(4.697144,-74.140516)"
2020,Octubre,Chile,152,42,21,,63,"(6.171601,-75.427454)"
2020,Octubre,China,156,2,3,,5,"(10.445761,-75.516429)"
2020,Octubre,China,156,8,13,,21,"(4.697144,-74.140516)"
2020,Octubre,Dinamarca,208,4,0,,4,"(10.445761,-75.516429)"
2020,Octubre,Dinamarca,208,6,4,,10,"(4.697144,-74.140516)"
2020,Octubre,Dinamarca,208,3,1,,4,"(6.171601,-75.427454)"
2020,Octubre,Dominica,212,1,1,,2,"(4.697144,-74.140516)"
2020,Octubre,Ecuador,218,25,30,,55,"(0.814836,-77.662532)"
2020,Octubre,Ecuador,218,0,2,,2,"(1.813928,-78.763924)"
2020,Octubre,Ecuador,218,3,1,,4,"(10.445761,-75.516429)"
2020,Octubre,Ecuador,218,0,3,,3,"(3.541112,-76.384584)"
2020,Octubre,Ecuador,218,0,1,,1,"(3.893038,-77.067921)"
2020,Octubre,Ecuador,218,780,1226,,2006,"(4.697144,-74.140516)"
2020,Octubre,Ecuador,218,10,14,,24,"(6.171601,-75.427454)"
2020,Octubre,Ecuador,218,1,4,,5,"(7.128456,-73.183637)"
2020,Octubre,Egipto,818,4,18,,22,"(4.697144,-74.140516)"
2020,Octubre,Egipto,818,0,1,,1,"(6.171601,-75.427454)"
2020,Octubre,El Salvador,222,38,104,,142,"(4.697144,-74.140516)"
2020,Octubre,El Salvador,222,2,11,,13,"(6.171601,-75.427454)"
2020,Octubre,Emiratos Árabes,784,2,2,,4,"(10.445761,-75.516429)"
2020,Octubre,Emiratos Árabes,784,0,1,,1,"(10.886611,-74.776708)"
2020,Octubre,Emiratos Árabes,784,1,0,,1,"(3.541112,-76.384584)"
2020,Octubre,Emiratos Árabes,784,25,184,,209,"(4.697144,-74.140516)"
2020,Octubre,Emiratos Árabes,784,4,4,,8,"(6.171601,-75.427454)"
2020,Octubre,Estados Unidos de América,840,0,4,,4,"(10.408582,-75.538003)"
2020,Octubre,Estados Unidos de América,840,1532,1359,,2891,"(10.445761,-75.516429)"
2020,Octubre,Estados Unidos de América,840,1358,952,,2310,"(10.886611,-74.776708)"
2020,Octubre,Estados Unidos de América,840,3,6,,9,"(11.117806,-74.232622)"
2020,Octubre,Estados Unidos de América,840,0,5,,5,"(12.586067,-81.702563)"
2020,Octubre,Estados Unidos de América,840,3306,2456,,5762,"(3.541112,-76.384584)"
2020,Octubre,Estados Unidos de América,840,594,450,,1044,"(4.452882,-75.766298)"
2020,Octubre,Estados Unidos de América,840,11356,9322,,20678,"(4.697144,-74.140516)"
2020,Octubre,Estados Unidos de América,840,0,4,,4,"(4.815061,-75.736532)"
2020,Octubre,Estados Unidos de América,840,7074,5764,,12839,"(6.171601,-75.427454)"
2020,Octubre,Etiopia,231,0,4,,4,"(4.697144,-74.140516)"
2020,Octubre,Filipinas,608,1,0,,1,"(4.697144,-74.140516)"
2020,Octubre,Finlandia,246,5,11,,16,"(4.697144,-74.140516)"
2020,Octubre,Finlandia,246,0,1,,1,"(6.171601,-75.427454)"
2020,Octubre,Francia,250,7,5,,12,"(10.445761,-75.516429)"
2020,Octubre,Francia,250,1,2,,3,"(3.541112,-76.384584)"
2020,Octubre,Francia,250,205,184,,389,"(4.697144,-74.140516)"
2020,Octubre,Francia,250,9,3,,12,"(6.171601,-75.427454)"
2020,Octubre,Georgia,268,1,0,,1,"(3.541112,-76.384584)"
2020,Octubre,Georgia,268,2,3,,5,"(4.697144,-74.140516)"
2020,Octubre,Ghana,288,0,2,,2,"(4.697144,-74.140516)"
2020,Octubre,Gibraltar/Territorio Británico de Ultramar,292,0,1,,1,"(4.697144,-74.140516)"
2020,Octubre,Grecia,300,1,4,,5,"(4.697144,-74.140516)"
2020,Octubre,Guatemala,320,0,4,,4,"(10.445761,-75.516429)"
2020,Octubre,Guatemala,320,2,8,,10,"(12.586067,-81.702563)"
2020,Octubre,Guatemala,320,1,1,,2,"(3.541112,-76.384584)"
2020,Octubre,Guatemala,320,111,141,,252,"(4.697144,-74.140516)"
2020,Octubre,Guatemala,320,18,12,,30,"(6.171601,-75.427454)"
2020,Octubre,Guyana,328,1,9,,10,"(10.408582,-75.538003)"
2020,Octubre,Guinea Ecuatorial,226,0,1,,1,"(4.697144,-74.140516)"
2020,Octubre,Haití,332,0,1,,1,"(4.697144,-74.140516)"
2020,Octubre,Haití,332,0,2,,2,"(6.171601,-75.427454)"
2020,Octubre,Honduras,340,0,1,,1,"(10.445761,-75.516429)"
2020,Octubre,Honduras,340,1,6,,7,"(10.886611,-74.776708)"
2020,Octubre,Honduras,340,2,2,,4,"(3.541112,-76.384584)"
2020,Octubre,Honduras,340,3,20,,23,"(4.697144,-74.140516)"
2020,Octubre,Honduras,340,4,5,,9,"(6.171601,-75.427454)"
2020,Octubre,Hong Kong,344,1,0,,1,"(4.697144,-74.140516)"
2020,Octubre,Hong Kong,344,1,0,,1,"(6.171601,-75.427454)"
2020,Octubre,Hungría,348,0,1,,1,"(10.445761,-75.516429)"
2020,Octubre,Hungría,348,6,4,,10,"(4.697144,-74.140516)"
2020,Octubre,Hungría,348,1,1,,2,"(6.171601,-75.427454)"
2020,Octubre,India,356,4,2,,6,"(4.697144,-74.140516)"
2020,Octubre,Indonesia,360,0,1,,1,"(10.445761,-75.516429)"
2020,Octubre,Indonesia,360,0,1,,1,"(4.697144,-74.140516)"
2020,Octubre,Iraq,368,0,1,,1,"(4.697144,-74.140516)"
2020,Octubre,República de Irlanda,372,1,0,,1,"(4.697144,-74.140516)"
2020,Octubre,Islandia,352,0,1,,1,"(10.445761,-75.516429)"
2020,Octubre,Islandia,352,1,1,,2,"(4.697144,-74.140516)"
2020,Octubre,Israel,376,0,1,,1,"(10.445761,-75.516429)"
2020,Octubre,Israel,376,1,1,,2,"(3.541112,-76.384584)"
2020,Octubre,Israel,376,6,6,,12,"(4.697144,-74.140516)"
2020,Octubre,Israel,376,0,1,,1,"(6.171601,-75.427454)"
2020,Octubre,Italia,380,8,5,,13,"(10.445761,-75.516429)"
2020,Octubre,Italia,380,8,2,,10,"(3.541112,-76.384584)"
2020,Octubre,Italia,380,111,42,,153,"(4.697144,-74.140516)"
2020,Octubre,Italia,380,10,5,,15,"(6.171601,-75.427454)"
2020,Octubre,Jamaica,388,4,2,,6,"(4.697144,-74.140516)"
2020,Octubre,Jamaica,388,14,16,,30,"(6.171601,-75.427454)"
2020,Octubre,Japón,392,13,12,,25,"(4.697144,-74.140516)"
2020,Octubre,Japón,392,3,2,,5,"(6.171601,-75.427454)"
2020,Octubre,Kazajistán,398,0,4,,4,"(4.697144,-74.140516)"
2020,Octubre,Kuwait,414,0,1,,1,"(4.697144,-74.140516)"
2020,Octubre,Lituania,440,0,1,,1,"(4.697144,-74.140516)"
2020,Octubre,Líbano,422,2,1,,3,"(4.697144,-74.140516)"
2020,Octubre,Luxemburgo,442,1,0,,1,"(4.697144,-74.140516)"
2020,Octubre,Macao,446,0,1,,1,"(4.697144,-74.140516)"
2020,Octubre,Madagascar,450,0,1,,1,"(6.171601,-75.427454)"
2020,Octubre,Malí,466,1,0,,1,"(4.697144,-74.140516)"
2020,Octubre,Malta,470,1,0,,1,"(3.541112,-76.384584)"
2020,Octubre,Malta,470,1,1,,2,"(4.697144,-74.140516)"
2020,Octubre,Mauritania,478,0,4,,4,"(4.697144,-74.140516)"
2020,Octubre,México,484,23,13,,36,"(10.445761,-75.516429)"
2020,Octubre,México,484,0,2,,2,"(10.886611,-74.776708)"
2020,Octubre,México,484,86,66,,152,"(3.541112,-76.384584)"
2020,Octubre,México,484,3504,3006,,6510,"(4.697144,-74.140516)"
2020,Octubre,México,484,856,592,,1448,"(6.171601,-75.427454)"
2020,Octubre,República de Moldavia,498,1,0,,1,"(4.697144,-74.140516)"
2020,Octubre,Mozambique,508,0,1,,1,"(10.445761,-75.516429)"
2020,Octubre,Nicaragua,558,2,5,,7,"(4.697144,-74.140516)"
2020,Octubre,Nicaragua,558,5,13,,18,"(6.171601,-75.427454)"
2020,Octubre,Nigeria,566,1,1,,2,"(4.697144,-74.140516)"
2020,Octubre,Noruega,578,2,0,,2,"(10.445761,-75.516429)"
2020,Octubre,Noruega,578,3,1,,4,"(3.541112,-76.384584)"
2020,Octubre,Noruega,578,7,9,,16,"(4.697144,-74.140516)"
2020,Octubre,Noruega,578,2,0,,2,"(6.171601,-75.427454)"
2020,Octubre,Nueva Zelanda,554,2,0,,2,"(4.697144,-74.140516)"
2020,Octubre,Omán,512,0,1,,1,"(10.445761,-75.516429)"
2020,Octubre,Omán,512,0,2,,2,"(4.697144,-74.140516)"
2020,Octubre,Omán,512,0,1,,1,"(6.171601,-75.427454)"
2020,Octubre,Panamá,591,0,3,,3,"(1.813928,-78.763924)"
2020,Octubre,Panamá,591,0,9,,9,"(10.408582,-75.538003)"
2020,Octubre,Panamá,591,404,298,,702,"(10.445761,-75.516429)"
2020,Octubre,Panamá,591,3,35,,38,"(10.886611,-74.776708)"
2020,Octubre,Panamá,591,1,24,,25,"(12.5744111,-81.703935)"
2020,Octubre,Panamá,591,0,3,,3,"(12.586067,-81.702563)"
2020,Octubre,Panamá,591,544,420,,964,"(3.541112,-76.384584)"
2020,Octubre,Panamá,591,0,4,,4,"(3.893038,-77.067921)"
2020,Octubre,Panamá,591,673,908,,1581,"(4.697144,-74.140516)"
2020,Octubre,Panamá,591,0,2,,2,"(4.815061,-75.736532)"
2020,Octubre,Panamá,591,426,345,,771,"(6.171601,-75.427454)"
2020,Octubre,Panamá,591,0,5,,5,"(6.228046,-77.404104)"
2020,Octubre,Panamá,591,1,5,,6,"(7.128456,-73.183637)"
2020,Octubre,Panamá,591,0,7,,7,"(8.066966,-76.735404)"
2020,Octubre,Paraguay,600,1,41,,42,"(4.697144,-74.140516)"
2020,Octubre,Paraguay,600,3,35,,38,"(6.171601,-75.427454)"
2020,Octubre,Perú,604,0,2,,2,"(-4.197703,-69.941278)"
2020,Octubre,Perú,604,2,3,,5,"(-4.223468,-69.945098)"
2020,Octubre,Perú,604,2,0,,2,"(10.445761,-75.516429)"
2020,Octubre,Perú,604,1,2,,3,"(3.541112,-76.384584)"
2020,Octubre,Perú,604,466,654,,1120,"(4.697144,-74.140516)"
2020,Octubre,Perú,604,16,23,,39,"(6.171601,-75.427454)"
2020,Octubre,Polonia,616,8,5,,13,"(4.697144,-74.140516)"
2020,Octubre,Portugal,620,1,0,,1,"(10.445761,-75.516429)"
2020,Octubre,Portugal,620,33,60,,93,"(4.697144,-74.140516)"
2020,Octubre,Portugal,620,1,1,,2,"(6.171601,-75.427454)"
2020,Octubre,Puerto Rico/Territorio de Estados Unidos,630,2,0,,2,"(10.445761,-75.516429)"
2020,Octubre,Puerto Rico/Territorio de Estados Unidos,630,1,1,,2,"(10.886611,-74.776708)"
2020,Octubre,Puerto Rico/Territorio de Estados Unidos,630,5,4,,9,"(3.541112,-76.384584)"
2020,Octubre,Puerto Rico/Territorio de Estados Unidos,630,8,10,,18,"(4.697144,-74.140516)"
2020,Octubre,Puerto Rico/Territorio de Estados Unidos,630,4,5,,9,"(6.171601,-75.427454)"
2020,Octubre,Qatar,634,4,3,,7,"(4.697144,-74.140516)"
2020,Octubre,Reino Unido de Gran Bretaña e Irlanda del Norte,826,1,2,,3,"(10.445761,-75.516429)"
2020,Octubre,Reino Unido de Gran Bretaña e Irlanda del Norte,826,1,0,,1,"(10.886611,-74.776708)"
2020,Octubre,Reino Unido de Gran Bretaña e Irlanda del Norte,826,18,10,,28,"(3.541112,-76.384584)"
2020,Octubre,Reino Unido de Gran Bretaña e Irlanda del Norte,826,111,79,,190,"(4.697144,-74.140516)"
2020,Octubre,Reino Unido de Gran Bretaña e Irlanda del Norte,826,12,8,,20,"(6.171601,-75.427454)"
2020,Octubre,Federación de Rusia,643,3,5,,8,"(4.697144,-74.140516)"
2020,Octubre,República Dominicana,214,4,9,,13,"(10.445761,-75.516429)"
2020,Octubre,República Dominicana,214,9,14,,23,"(10.886611,-74.776708)"
2020,Octubre,República Dominicana,214,15,18,,33,"(11.117806,-74.232622)"
2020,Octubre,República Dominicana,214,3,1,,4,"(3.541112,-76.384584)"
2020,Octubre,República Dominicana,214,645,639,,1284,"(4.697144,-74.140516)"
2020,Octubre,República Dominicana,214,15,22,,37,"(6.171601,-75.427454)"
2020,Octubre,Rumania,642,1,0,,1,"(10.445761,-75.516429)"
2020,Octubre,Rumania,642,2,1,,3,"(4.697144,-74.140516)"
2020,Octubre,Rumania,642,1,0,,1,"(6.171601,-75.427454)"
2020,Octubre,Santa Lucia,662,2,1,,3,"(6.171601,-75.427454)"
2020,Octubre,Serbia,688,0,1,,1,"(4.697144,-74.140516)"
2020,Octubre,Singapur,702,6,5,,11,"(4.697144,-74.140516)"
2020,Octubre,Sudáfrica,710,1,3,,4,"(4.697144,-74.140516)"
2020,Octubre,Sudán,736,0,1,,1,"(4.697144,-74.140516)"
2020,Octubre,Suecia,752,2,1,,3,"(10.445761,-75.516429)"
2020,Octubre,Suecia,752,4,6,,10,"(3.541112,-76.384584)"
2020,Octubre,Suecia,752,25,20,,45,"(4.697144,-74.140516)"
2020,Octubre,Suecia,752,1,4,,5,"(6.171601,-75.427454)"
2020,Octubre,Suiza,756,4,7,,11,"(10.445761,-75.516429)"
2020,Octubre,Suiza,756,1,1,,2,"(3.541112,-76.384584)"
2020,Octubre,Suiza,756,50,25,,75,"(4.697144,-74.140516)"
2020,Octubre,Suiza,756,2,4,,6,"(6.171601,-75.427454)"
2020,Octubre,Surinam,740,0,1,,1,"(4.697144,-74.140516)"
2020,Octubre,Surinam,740,0,1,,1,"(6.171601,-75.427454)"
2020,Octubre,Taiwán,158,3,3,,6,"(4.697144,-74.140516)"
2020,Octubre,Tailandia,764,1,1,,2,"(4.697144,-74.140516)"
2020,Octubre,Tailandia,764,1,0,,1,"(6.171601,-75.427454)"
2020,Octubre,Tanzania,834,0,1,,1,"(4.697144,-74.140516)"
2020,Octubre,Trinidad y Tobago,780,1,14,,15,"(10.971302,-74.765397)"
2020,Octubre,Turquía,792,1,0,,1,"(10.445761,-75.516429)"
2020,Octubre,Turquía,792,1,0,,1,"(10.886611,-74.776708)"
2020,Octubre,Turquía,792,1,0,,1,"(3.541112,-76.384584)"
2020,Octubre,Turquía,792,14,26,,40,"(4.697144,-74.140516)"
2020,Octubre,Turquía,792,2,1,,3,"(6.171601,-75.427454)"
2020,Octubre,Ucrania,804,0,2,,2,"(4.697144,-74.140516)"
2020,Octubre,Uruguay,858,1,1,,2,"(10.445761,-75.516429)"
2020,Octubre,Uruguay,858,2,37,,39,"(10.886611,-74.776708)"
2020,Octubre,Uruguay,858,5,8,,13,"(3.541112,-76.384584)"
2020,Octubre,Uruguay,858,5,25,,30,"(4.697144,-74.140516)"
2020,Octubre,Uruguay,858,3,3,,6,"(6.171601,-75.427454)"
2020,Octubre,Uzbekistán,860,1,1,,2,"(4.697144,-74.140516)"
2020,Octubre,Venezuela,862,0,159,,159,"(11.360009,-72.129330)"
2020,Octubre,Venezuela,862,6,90,,96,"(4.697144,-74.140516)"
2020,Octubre,Venezuela,862,0,7,,7,"(7.818934,-72.453226)"
2020,Octubre,Islas Vírgenes Estadounidenses/Territorio de Estados Unidos,850,0,1,,1,"(4.697144,-74.140516)"
2020,Octubre,Islas Turcas y Caicos/Territorio Británico de Ultramar,796,2,4,,6,"(10.886611,-74.776708)"
2020,Octubre,Islas Turcas y Caicos/Territorio Británico de Ultramar,796,1,0,,1,"(6.171601,-75.427454)"
2020,Octubre,Desconocido,99999,3,0,,3,"(4.697144,-74.140516)"
2020,Noviembre,Afganistán,4,1,3,,4,"(4.697144,-74.140516)"
2020,Noviembre,Albania,8,1,1,,2,"(4.697144,-74.140516)"
2020,Noviembre,Alemania,276,14,4,,18,"(10.445761,-75.516429)"
2020,Noviembre,Alemania,276,5,1,,6,"(10.886611,-74.776708)"
2020,Noviembre,Alemania,276,12,6,,18,"(3.541112,-76.384584)"
2020,Noviembre,Alemania,276,118,72,,190,"(4.697144,-74.140516)"
2020,Noviembre,Alemania,276,8,13,,21,"(6.171601,-75.427454)"
2020,Noviembre,Alemania,276,2,0,,2,"(7.128456,-73.183637)"
2020,Noviembre,Angola,24,0,1,,1,"(4.697144,-74.140516)"
2020,Noviembre,Antigua y Barbuda,28,0,1,,1,"(4.697144,-74.140516)"
2020,Noviembre,Países Bajos,528,45,26,,71,"(10.445761,-75.516429)"
2020,Noviembre,Países Bajos,528,0,6,,6,"(10.886611,-74.776708)"
2020,Noviembre,Países Bajos,528,6,3,,9,"(3.541112,-76.384584)"
2020,Noviembre,Países Bajos,528,181,236,,417,"(4.697144,-74.140516)"
2020,Noviembre,Países Bajos,528,22,2,,24,"(6.171601,-75.427454)"
2020,Noviembre,Países Bajos,528,0,1,,1,"(7.128456,-73.183637)"
2020,Noviembre,Arabia Saudita,682,2,12,,14,"(4.697144,-74.140516)"
2020,Noviembre,Argelia,12,0,1,,1,"(4.697144,-74.140516)"
2020,Noviembre,Argentina,32,3,1,,4,"(10.445761,-75.516429)"
2020,Noviembre,Argentina,32,1,1,,2,"(10.886611,-74.776708)"
2020,Noviembre,Argentina,32,8,30,,38,"(3.541112,-76.384584)"
2020,Noviembre,Argentina,32,135,182,,317,"(4.697144,-74.140516)"
2020,Noviembre,Argentina,32,0,3,,3,"(4.815061,-75.736532)"
2020,Noviembre,Argentina,32,5,3,,8,"(6.171601,-75.427454)"
2020,Noviembre,Argentina,32,1,0,,1,"(7.128456,-73.183637)"
2020,Noviembre,Aruba,533,1,2,,3,"(10.886611,-74.776708)"
2020,Noviembre,Aruba,533,2,0,,2,"(3.541112,-76.384584)"
2020,Noviembre,Aruba,533,7,12,,19,"(4.697144,-74.140516)"
2020,Noviembre,Aruba,533,2,1,,3,"(6.171601,-75.427454)"
2020,Noviembre,Aruba,533,2,8,,10,"(7.128456,-73.183637)"
2020,Noviembre,Australia,36,1,0,,1,"(3.541112,-76.384584)"
2020,Noviembre,Australia,36,11,10,,21,"(4.697144,-74.140516)"
2020,Noviembre,Australia,36,1,0,,1,"(6.171601,-75.427454)"
2020,Noviembre,Austria,40,1,0,,1,"(10.445761,-75.516429)"
2020,Noviembre,Austria,40,2,0,,2,"(3.541112,-76.384584)"
2020,Noviembre,Austria,40,11,9,,20,"(4.697144,-74.140516)"
2020,Noviembre,Azerbaiyán,31,1,2,,3,"(4.697144,-74.140516)"
2020,Noviembre,Azerbaiyán,31,0,1,,1,"(6.171601,-75.427454)"
2020,Noviembre,Bahamas,44,1,15,,16,"(10.886611,-74.776708)"
2020,Noviembre,Bahamas,44,4,8,,12,"(4.697144,-74.140516)"
2020,Noviembre,Bahamas,44,0,2,,2,"(6.171601,-75.427454)"
2020,Noviembre,Bahréin,48,1,3,,4,"(4.697144,-74.140516)"
2020,Noviembre,Barbados,52,0,3,,3,"(10.886611,-74.776708)"
2020,Noviembre,Barbados,52,1,3,,4,"(4.697144,-74.140516)"
2020,Noviembre,República de Belarús,112,0,1,,1,"(4.697144,-74.140516)"
2020,Noviembre,Bélgica,56,1,0,,1,"(10.445761,-75.516429)"
2020,Noviembre,Bélgica,56,3,0,,3,"(3.541112,-76.384584)"
2020,Noviembre,Bélgica,56,15,13,,28,"(4.697144,-74.140516)"
2020,Noviembre,Bélgica,56,3,0,,3,"(6.171601,-75.427454)"
2020,Noviembre,Belice,84,2,6,,8,"(4.697144,-74.140516)"
2020,Noviembre,Bermudas/Territorio Británico de Ultramar,60,1,0,,1,"(4.697144,-74.140516)"
2020,Noviembre,Bolivia,68,2,5,,7,"(3.541112,-76.384584)"
2020,Noviembre,Bolivia,68,164,303,,467,"(4.697144,-74.140516)"
2020,Noviembre,Bolivia,68,6,13,,19,"(6.171601,-75.427454)"
2020,Noviembre,Bolivia,68,4,15,,19,"(8.825239,-75.824034)"
2020,Noviembre,Bosnia y Herzegovina,70,1,0,,1,"(4.697144,-74.140516)"
2020,Noviembre,Botsuana,72,1,0,,1,"(4.697144,-74.140516)"
2020,Noviembre,Brasil,76,23,41,,64,"(-4.197703,-69.941278)"
2020,Noviembre,Brasil,76,8,13,,21,"(10.445761,-75.516429)"
2020,Noviembre,Brasil,76,12,9,,21,"(10.886611,-74.776708)"
2020,Noviembre,Brasil,76,51,57,,108,"(3.541112,-76.384584)"
2020,Noviembre,Brasil,76,686,935,,1621,"(4.697144,-74.140516)"
2020,Noviembre,Brasil,76,29,35,,64,"(4.815061,-75.736532)"
2020,Noviembre,Brasil,76,68,85,,153,"(6.171601,-75.427454)"
2020,Noviembre,Bulgaria,100,1,0,,1,"(4.697144,-74.140516)"
2020,Noviembre,Burkina Faso,854,0,1,,1,"(4.697144,-74.140516)"
2020,Noviembre,Camboya,116,0,1,,1,"(4.697144,-74.140516)"
2020,Noviembre,Camboya,116,0,1,,1,"(6.171601,-75.427454)"
2020,Noviembre,Camerún,120,0,1,,1,"(4.697144,-74.140516)"
2020,Noviembre,Canadá,124,3,6,,9,"(10.445761,-75.516429)"
2020,Noviembre,Canadá,124,12,10,,22,"(10.886611,-74.776708)"
2020,Noviembre,Canadá,124,42,18,,60,"(3.541112,-76.384584)"
2020,Noviembre,Canadá,124,505,361,,866,"(4.697144,-74.140516)"
2020,Noviembre,Canadá,124,5,5,,10,"(4.815061,-75.736532)"
2020,Noviembre,Canadá,124,72,61,,133,"(6.171601,-75.427454)"
2020,Noviembre,España,724,8,4,,12,"(10.445761,-75.516429)"
2020,Noviembre,España,724,4,52,,56,"(10.886611,-74.776708)"
2020,Noviembre,España,724,29,21,,50,"(3.541112,-76.384584)"
2020,Noviembre,España,724,1299,926,,2225,"(4.697144,-74.140516)"
2020,Noviembre,España,724,4,3,,7,"(4.815061,-75.736532)"
2020,Noviembre,España,724,122,87,,209,"(6.171601,-75.427454)"
2020,Noviembre,Colombia,170,35,90,,125,"(4.697144,-74.140516)"
2020,Noviembre,República Del Congo,178,0,1,,1,"(4.697144,-74.140516)"
2020,Noviembre,República Democrática del Congo,180,2,0,,2,"(4.697144,-74.140516)"
2020,Noviembre,República de Corea,410,0,1,,1,"(3.541112,-76.384584)"
2020,Noviembre,República de Corea,410,8,5,,13,"(4.697144,-74.140516)"
2020,Noviembre,República de Corea,410,0,3,,3,"(6.171601,-75.427454)"
2020,Noviembre,Costa de Marfil,384,0,2,,2,"(6.171601,-75.427454)"
2020,Noviembre,Costa Rica,188,0,3,,3,"(10.445761,-75.516429)"
2020,Noviembre,Costa Rica,188,5,6,,11,"(10.886611,-74.776708)"
2020,Noviembre,Costa Rica,188,2,16,,18,"(12.5744111,-81.703935)"
2020,Noviembre,Costa Rica,188,3,5,,8,"(12.586067,-81.702563)"
2020,Noviembre,Costa Rica,188,32,19,,51,"(3.541112,-76.384584)"
2020,Noviembre,Costa Rica,188,245,308,,553,"(4.697144,-74.140516)"
2020,Noviembre,Costa Rica,188,6,10,,16,"(4.815061,-75.736532)"
2020,Noviembre,Costa Rica,188,1,6,,7,"(6.17134,-75.427194)"
2020,Noviembre,Costa Rica,188,81,54,,135,"(6.171601,-75.427454)"
2020,Noviembre,Costa Rica,188,1,0,,1,"(7.128456,-73.183637)"
2020,Noviembre,Croacia,191,2,3,,5,"(10.445761,-75.516429)"
2020,Noviembre,Croacia,191,1,0,,1,"(3.541112,-76.384584)"
2020,Noviembre,Croacia,191,7,5,,12,"(4.697144,-74.140516)"
2020,Noviembre,Cuba,192,4,2,,6,"(3.541112,-76.384584)"
2020,Noviembre,Cuba,192,43,29,,72,"(4.697144,-74.140516)"
2020,Noviembre,Cuba,192,1,0,,1,"(4.815061,-75.736532)"
2020,Noviembre,Cuba,192,1,5,,6,"(6.171601,-75.427454)"
2020,Noviembre,Curazao,99999,10,39,,49,"(4.697144,-74.140516)"
2020,Noviembre,Curazao,99999,0,7,,7,"(6.171601,-75.427454)"
2020,Noviembre,Curazao,99999,2,3,,5,"(7.128456,-73.183637)"
2020,Noviembre,República Checa,203,1,0,,1,"(10.445761,-75.516429)"
2020,Noviembre,República Checa,203,0,2,,2,"(4.697144,-74.140516)"
2020,Noviembre,República Checa,203,1,0,,1,"(6.171601,-75.427454)"
2020,Noviembre,Chile,152,21,15,,36,"(10.445761,-75.516429)"
2020,Noviembre,Chile,152,33,33,,66,"(10.886611,-74.776708)"
2020,Noviembre,Chile,152,368,214,,582,"(3.541112,-76.384584)"
2020,Noviembre,Chile,152,857,629,,1486,"(4.697144,-74.140516)"
2020,Noviembre,Chile,152,55,38,,93,"(4.815061,-75.736532)"
2020,Noviembre,Chile,152,76,48,,125,"(6.171601,-75.427454)"
2020,Noviembre,Chile,152,12,2,,14,"(7.128456,-73.183637)"
2020,Noviembre,China,156,7,8,,15,"(4.697144,-74.140516)"
2020,Noviembre,China,156,0,1,,1,"(6.171601,-75.427454)"
2020,Noviembre,Dinamarca,208,1,0,,1,"(10.445761,-75.516429)"
2020,Noviembre,Dinamarca,208,1,0,,1,"(10.886611,-74.776708)"
2020,Noviembre,Dinamarca,208,1,0,,1,"(3.541112,-76.384584)"
2020,Noviembre,Dinamarca,208,8,2,,10,"(4.697144,-74.140516)"
2020,Noviembre,Dinamarca,208,2,0,,2,"(6.171601,-75.427454)"
2020,Noviembre,Dinamarca,208,1,0,,1,"(7.128456,-73.183637)"
2020,Noviembre,Dominica,212,1,1,,2,"(4.697144,-74.140516)"
2020,Noviembre,Ecuador,218,26,40,,66,"(0.814836,-77.662532)"
2020,Noviembre,Ecuador,218,0,2,,2,"(1.813928,-78.763924)"
2020,Noviembre,Ecuador,218,0,13,,13,"(10.408582,-75.538003)"
2020,Noviembre,Ecuador,218,1,0,,1,"(10.445761,-75.516429)"
2020,Noviembre,Ecuador,218,2,53,,55,"(10.886611,-74.776708)"
2020,Noviembre,Ecuador,218,19,33,,52,"(3.541112,-76.384584)"
2020,Noviembre,Ecuador,218,782,1229,,2011,"(4.697144,-74.140516)"
2020,Noviembre,Ecuador,218,4,4,,8,"(4.815061,-75.736532)"
2020,Noviembre,Ecuador,218,24,24,,48,"(6.171601,-75.427454)"
2020,Noviembre,Ecuador,218,4,8,,12,"(7.128456,-73.183637)"
2020,Noviembre,Egipto,818,12,5,,17,"(4.697144,-74.140516)"
2020,Noviembre,Egipto,818,0,1,,1,"(6.171601,-75.427454)"
2020,Noviembre,El Salvador,222,6,1,,7,"(3.541112,-76.384584)"
2020,Noviembre,El Salvador,222,113,167,,280,"(4.697144,-74.140516)"
2020,Noviembre,El Salvador,222,9,8,,17,"(6.171601,-75.427454)"
2020,Noviembre,Emiratos Árabes,784,6,1,,7,"(10.445761,-75.516429)"
2020,Noviembre,Emiratos Árabes,784,2,0,,2,"(3.541112,-76.384584)"
2020,Noviembre,Emiratos Árabes,784,68,138,,206,"(4.697144,-74.140516)"
2020,Noviembre,Emiratos Árabes,784,0,2,,2,"(4.815061,-75.736532)"
2020,Noviembre,Emiratos Árabes,784,10,12,,22,"(6.171601,-75.427454)"
2020,Noviembre,Eslovaquia,703,1,1,,2,"(4.697144,-74.140516)"
2020,Noviembre,Eslovenia,705,0,1,,1,"(3.541112,-76.384584)"
2020,Noviembre,Eslovenia,705,1,0,,1,"(4.697144,-74.140516)"
2020,Noviembre,Estados Unidos de América,840,0,1,,1,"(10.408582,-75.538003)"
2020,Noviembre,Estados Unidos de América,840,1430,1193,,2624,"(10.445761,-75.516429)"
2020,Noviembre,Estados Unidos de América,840,1872,1502,,3374,"(10.886611,-74.776708)"
2020,Noviembre,Estados Unidos de América,840,4334,3007,,7341,"(3.541112,-76.384584)"
2020,Noviembre,Estados Unidos de América,840,797,591,,1388,"(4.452882,-75.766298)"
2020,Noviembre,Estados Unidos de América,840,15741,13188,,28929,"(4.697144,-74.140516)"
2020,Noviembre,Estados Unidos de América,840,357,195,,552,"(4.815061,-75.736532)"
2020,Noviembre,Estados Unidos de América,840,7965,6421,,14386,"(6.171601,-75.427454)"
2020,Noviembre,Estados Unidos de América,840,356,361,,717,"(7.128456,-73.183637)"
2020,Noviembre,Etiopia,231,0,4,,4,"(4.697144,-74.140516)"
2020,Noviembre,Filipinas,608,0,1,,1,"(10.445761,-75.516429)"
2020,Noviembre,Filipinas,608,1,0,,1,"(4.697144,-74.140516)"
2020,Noviembre,Filipinas,608,1,0,,1,"(6.171601,-75.427454)"
2020,Noviembre,Finlandia,246,2,2,,4,"(10.445761,-75.516429)"
2020,Noviembre,Finlandia,246,1,1,,2,"(3.541112,-76.384584)"
2020,Noviembre,Finlandia,246,4,4,,8,"(4.697144,-74.140516)"
2020,Noviembre,Francia,250,3,3,,6,"(10.445761,-75.516429)"
2020,Noviembre,Francia,250,1,0,,1,"(10.886611,-74.776708)"
2020,Noviembre,Francia,250,2,0,,2,"(3.541112,-76.384584)"
2020,Noviembre,Francia,250,110,77,,187,"(4.697144,-74.140516)"
2020,Noviembre,Francia,250,1,0,,1,"(4.815061,-75.736532)"
2020,Noviembre,Francia,250,3,4,,7,"(6.171601,-75.427454)"
2020,Noviembre,Georgia,268,1,1,,2,"(4.697144,-74.140516)"
2020,Noviembre,Georgia,268,1,0,,1,"(6.171601,-75.427454)"
2020,Noviembre,Ghana,288,0,4,,4,"(4.697144,-74.140516)"
2020,Noviembre,Gibraltar/Territorio Británico de Ultramar,292,1,0,,1,"(4.697144,-74.140516)"
2020,Noviembre,Granada,308,0,1,,1,"(4.697144,-74.140516)"
2020,Noviembre,Groenlandia,304,0,1,,1,"(4.697144,-74.140516)"
2020,Noviembre,Guatemala,320,0,1,,1,"(1.813928,-78.763924)"
2020,Noviembre,Guatemala,320,0,3,,3,"(10.445761,-75.516429)"
2020,Noviembre,Guatemala,320,4,10,,14,"(10.886611,-74.776708)"
2020,Noviembre,Guatemala,320,27,36,,63,"(3.541112,-76.384584)"
2020,Noviembre,Guatemala,320,162,278,,440,"(4.697144,-74.140516)"
2020,Noviembre,Guatemala,320,3,9,,12,"(4.815061,-75.736532)"
2020,Noviembre,Guatemala,320,55,58,,113,"(6.171601,-75.427454)"
2020,Noviembre,Guatemala,320,2,1,,3,"(7.128456,-73.183637)"
2020,Noviembre,Guyana,328,2,0,,2,"(10.886611,-74.776708)"
2020,Noviembre,Guyana,328,0,5,,5,"(4.697144,-74.140516)"
2020,Noviembre,Guyana,328,0,1,,1,"(6.171601,-75.427454)"
2020,Noviembre,Guinea Ecuatorial,226,1,1,,2,"(3.541112,-76.384584)"
2020,Noviembre,Guinea Ecuatorial,226,0,1,,1,"(4.697144,-74.140516)"
2020,Noviembre,Guinea Bissau,624,0,1,,1,"(4.697144,-74.140516)"
2020,Noviembre,Guadalupe/Territorio Francés,312,1,0,,1,"(4.697144,-74.140516)"
2020,Noviembre,Guayana Francesa/Departamento de Ultramar Francés,254,0,2,,2,"(4.697144,-74.140516)"
2020,Noviembre,Haití,332,0,1,,1,"(3.541112,-76.384584)"
2020,Noviembre,Haití,332,1,2,,3,"(4.697144,-74.140516)"
2020,Noviembre,Haití,332,1,0,,1,"(6.171601,-75.427454)"
2020,Noviembre,Honduras,340,0,1,,1,"(10.886611,-74.776708)"
2020,Noviembre,Honduras,340,0,4,,4,"(3.541112,-76.384584)"
2020,Noviembre,Honduras,340,43,126,,169,"(4.697144,-74.140516)"
2020,Noviembre,Honduras,340,9,21,,30,"(6.171601,-75.427454)"
2020,Noviembre,Hong Kong,344,2,0,,2,"(4.697144,-74.140516)"
2020,Noviembre,Hungría,348,4,10,,14,"(4.697144,-74.140516)"
2020,Noviembre,India,356,1,0,,1,"(6.171601,-75.427454)"
2020,Noviembre,Indonesia,360,2,1,,3,"(4.697144,-74.140516)"
2020,Noviembre,Iraq,368,1,4,,5,"(4.697144,-74.140516)"
2020,Noviembre,República de Irlanda,372,1,0,,1,"(10.445761,-75.516429)"
2020,Noviembre,República de Irlanda,372,5,2,,7,"(4.697144,-74.140516)"
2020,Noviembre,República de Irlanda,372,1,0,,1,"(4.815061,-75.736532)"
2020,Noviembre,Israel,376,2,0,,2,"(3.541112,-76.384584)"
2020,Noviembre,Israel,376,30,16,,46,"(4.697144,-74.140516)"
2020,Noviembre,Israel,376,7,0,,7,"(6.171601,-75.427454)"
2020,Noviembre,Italia,380,5,4,,9,"(10.445761,-75.516429)"
2020,Noviembre,Italia,380,1,0,,1,"(10.886611,-74.776708)"
2020,Noviembre,Italia,380,4,1,,5,"(3.541112,-76.384584)"
2020,Noviembre,Italia,380,72,31,,103,"(4.697144,-74.140516)"
2020,Noviembre,Italia,380,8,4,,12,"(6.171601,-75.427454)"
2020,Noviembre,Jamaica,388,0,2,,2,"(10.408582,-75.538003)"
2020,Noviembre,Jamaica,388,0,1,,1,"(10.445761,-75.516429)"
2020,Noviembre,Jamaica,388,0,1,,1,"(10.886611,-74.776708)"
2020,Noviembre,Jamaica,388,1,0,,1,"(3.541112,-76.384584)"
2020,Noviembre,Jamaica,388,5,16,,21,"(4.697144,-74.140516)"
2020,Noviembre,Jamaica,388,4,2,,6,"(6.17134,-75.427194)"
2020,Noviembre,Jamaica,388,7,9,,16,"(6.171601,-75.427454)"
2020,Noviembre,Japón,392,21,14,,35,"(4.697144,-74.140516)"
2020,Noviembre,Japón,392,4,3,,7,"(6.171601,-75.427454)"
2020,Noviembre,Kazajistán,398,0,2,,2,"(4.697144,-74.140516)"
2020,Noviembre,Kenia,404,1,5,,6,"(4.697144,-74.140516)"
2020,Noviembre,Kuwait,414,1,0,,1,"(4.697144,-74.140516)"
2020,Noviembre,Lituania,440,2,0,,2,"(4.697144,-74.140516)"
2020,Noviembre,Líbano,422,10,8,,18,"(4.697144,-74.140516)"
2020,Noviembre,Luxemburgo,442,1,4,,5,"(4.697144,-74.140516)"
2020,Noviembre,Luxemburgo,442,1,1,,2,"(6.171601,-75.427454)"
2020,Noviembre,Malasia,458,1,0,,1,"(4.697144,-74.140516)"
2020,Noviembre,Maldivas,462,0,1,,1,"(4.697144,-74.140516)"
2020,Noviembre,Malí,466,2,2,,4,"(4.697144,-74.140516)"
2020,Noviembre,Malta,470,9,7,,16,"(4.697144,-74.140516)"
2020,Noviembre,Malta,470,0,1,,1,"(6.171601,-75.427454)"
2020,Noviembre,Mauricio,480,0,1,,1,"(4.697144,-74.140516)"
2020,Noviembre,Martinica/Departamento de Ultramar Francés,474,0,1,,1,"(4.697144,-74.140516)"
2020,Noviembre,México,484,45,30,,75,"(10.445761,-75.516429)"
2020,Noviembre,México,484,31,28,,59,"(10.886611,-74.776708)"
2020,Noviembre,México,484,400,331,,731,"(3.541112,-76.384584)"
2020,Noviembre,México,484,4313,3885,,8198,"(4.697144,-74.140516)"
2020,Noviembre,México,484,50,31,,81,"(4.815061,-75.736532)"
2020,Noviembre,México,484,4,4,,8,"(6.17134,-75.427194)"
2020,Noviembre,México,484,1450,1131,,2581,"(6.171601,-75.427454)"
2020,Noviembre,México,484,19,15,,34,"(7.128456,-73.183637)"
2020,Noviembre,Mozambique,508,0,1,,1,"(4.697144,-74.140516)"
2020,Noviembre,Nicaragua,558,15,33,,48,"(4.697144,-74.140516)"
2020,Noviembre,Nicaragua,558,0,1,,1,"(6.171601,-75.427454)"
2020,Noviembre,Noruega,578,3,0,,3,"(10.445761,-75.516429)"
2020,Noviembre,Noruega,578,2,0,,2,"(3.541112,-76.384584)"
2020,Noviembre,Noruega,578,17,8,,25,"(4.697144,-74.140516)"
2020,Noviembre,Noruega,578,1,0,,1,"(6.171601,-75.427454)"
2020,Noviembre,Nueva Zelanda,554,1,0,,1,"(3.541112,-76.384584)"
2020,Noviembre,Nueva Zelanda,554,2,0,,2,"(4.697144,-74.140516)"
2020,Noviembre,Omán,512,0,2,,2,"(4.697144,-74.140516)"
2020,Noviembre,Panamá,591,0,3,,3,"(1.813928,-78.763924)"
2020,Noviembre,Panamá,591,0,17,,17,"(10.408582,-75.538003)"
2020,Noviembre,Panamá,591,561,431,,992,"(10.445761,-75.516429)"
2020,Noviembre,Panamá,591,232,193,,425,"(10.886611,-74.776708)"
2020,Noviembre,Panamá,591,0,2,,2,"(10.971302,-74.765397)"
2020,Noviembre,Panamá,591,2,21,,23,"(12.5744111,-81.703935)"
2020,Noviembre,Panamá,591,0,6,,6,"(12.586067,-81.702563)"
2020,Noviembre,Panamá,591,1013,812,,1826,"(3.541112,-76.384584)"
2020,Noviembre,Panamá,591,2057,2407,,4464,"(4.697144,-74.140516)"
2020,Noviembre,Panamá,591,187,110,,297,"(4.815061,-75.736532)"
2020,Noviembre,Panamá,591,806,715,,1521,"(6.171601,-75.427454)"
2020,Noviembre,Panamá,591,29,29,,58,"(7.128456,-73.183637)"
2020,Noviembre,Panamá,591,0,7,,7,"(8.066966,-76.735404)"
2020,Noviembre,Paraguay,600,1,0,,1,"(10.445761,-75.516429)"
2020,Noviembre,Paraguay,600,0,1,,1,"(10.886611,-74.776708)"
2020,Noviembre,Paraguay,600,4,8,,12,"(3.541112,-76.384584)"
2020,Noviembre,Paraguay,600,21,75,,96,"(4.697144,-74.140516)"
2020,Noviembre,Paraguay,600,6,6,,12,"(4.815061,-75.736532)"
2020,Noviembre,Paraguay,600,10,10,,20,"(6.171601,-75.427454)"
2020,Noviembre,Paraguay,600,1,3,,4,"(7.128456,-73.183637)"
2020,Noviembre,Perú,604,1,1,,2,"(-0.193180,-74.784874)"
2020,Noviembre,Perú,604,5,3,,8,"(-4.197703,-69.941278)"
2020,Noviembre,Perú,604,5,3,,8,"(10.445761,-75.516429)"
2020,Noviembre,Perú,604,2,3,,5,"(10.886611,-74.776708)"
2020,Noviembre,Perú,604,49,43,,92,"(3.541112,-76.384584)"
2020,Noviembre,Perú,604,792,1158,,1950,"(4.697144,-74.140516)"
2020,Noviembre,Perú,604,6,8,,14,"(4.815061,-75.736532)"
2020,Noviembre,Perú,604,96,92,,188,"(6.171601,-75.427454)"
2020,Noviembre,Perú,604,1,3,,4,"(7.128456,-73.183637)"
2020,Noviembre,Polonia,616,1,0,,1,"(10.445761,-75.516429)"
2020,Noviembre,Polonia,616,8,21,,29,"(4.697144,-74.140516)"
2020,Noviembre,Portugal,620,0,1,,1,"(10.445761,-75.516429)"
2020,Noviembre,Portugal,620,2,2,,4,"(3.541112,-76.384584)"
2020,Noviembre,Portugal,620,14,11,,25,"(4.697144,-74.140516)"
2020,Noviembre,Puerto Rico/Territorio de Estados Unidos,630,1,0,,1,"(10.445761,-75.516429)"
2020,Noviembre,Puerto Rico/Territorio de Estados Unidos,630,2,0,,2,"(10.886611,-74.776708)"
2020,Noviembre,Puerto Rico/Territorio de Estados Unidos,630,17,6,,23,"(3.541112,-76.384584)"
2020,Noviembre,Puerto Rico/Territorio de Estados Unidos,630,36,39,,75,"(4.697144,-74.140516)"
2020,Noviembre,Puerto Rico/Territorio de Estados Unidos,630,36,23,,59,"(6.171601,-75.427454)"
2020,Noviembre,Puerto Rico/Territorio de Estados Unidos,630,0,1,,1,"(7.128456,-73.183637)"
2020,Noviembre,Qatar,634,4,1,,5,"(4.697144,-74.140516)"
2020,Noviembre,Qatar,634,1,2,,3,"(6.171601,-75.427454)"
2020,Noviembre,Reino Unido de Gran Bretaña e Irlanda del Norte,826,2,3,,5,"(10.445761,-75.516429)"
2020,Noviembre,Reino Unido de Gran Bretaña e Irlanda del Norte,826,10,4,,14,"(3.541112,-76.384584)"
2020,Noviembre,Reino Unido de Gran Bretaña e Irlanda del Norte,826,223,164,,387,"(4.697144,-74.140516)"
2020,Noviembre,Reino Unido de Gran Bretaña e Irlanda del Norte,826,0,1,,1,"(4.815061,-75.736532)"
2020,Noviembre,Reino Unido de Gran Bretaña e Irlanda del Norte,826,21,10,,31,"(6.171601,-75.427454)"
2020,Noviembre,República CentroÁfricana,140,1,1,,2,"(4.697144,-74.140516)"
2020,Noviembre,República CentroÁfricana,140,1,0,,1,"(4.815061,-75.736532)"
2020,Noviembre,Federación de Rusia,643,0,1,,1,"(3.541112,-76.384584)"
2020,Noviembre,Federación de Rusia,643,4,7,,11,"(4.697144,-74.140516)"
2020,Noviembre,República Dominicana,214,0,9,,9,"(10.408582,-75.538003)"
2020,Noviembre,República Dominicana,214,9,11,,20,"(10.445761,-75.516429)"
2020,Noviembre,República Dominicana,214,17,32,,49,"(10.886611,-74.776708)"
2020,Noviembre,República Dominicana,214,14,16,,30,"(11.117806,-74.232622)"
2020,Noviembre,República Dominicana,214,57,46,,103,"(3.541112,-76.384584)"
2020,Noviembre,República Dominicana,214,1312,1190,,2502,"(4.697144,-74.140516)"
2020,Noviembre,República Dominicana,214,2,2,,4,"(4.815061,-75.736532)"
2020,Noviembre,República Dominicana,214,171,119,,290,"(6.171601,-75.427454)"
2020,Noviembre,República Dominicana,214,2,1,,3,"(7.128456,-73.183637)"
2020,Noviembre,Reunión,638,0,1,,1,"(4.697144,-74.140516)"
2020,Noviembre,Rumania,642,5,1,,6,"(4.697144,-74.140516)"
2020,Noviembre,Serbia,688,6,10,,16,"(4.697144,-74.140516)"
2020,Noviembre,Sierra Leona,694,1,0,,1,"(4.697144,-74.140516)"
2020,Noviembre,Singapur,702,1,0,,1,"(4.697144,-74.140516)"
2020,Noviembre,Sudáfrica,710,0,1,,1,"(6.171601,-75.427454)"
2020,Noviembre,Suecia,752,2,1,,3,"(10.445761,-75.516429)"
2020,Noviembre,Suecia,752,1,1,,2,"(10.886611,-74.776708)"
2020,Noviembre,Suecia,752,5,1,,6,"(3.541112,-76.384584)"
2020,Noviembre,Suecia,752,28,30,,58,"(4.697144,-74.140516)"
2020,Noviembre,Suecia,752,4,1,,5,"(6.171601,-75.427454)"
2020,Noviembre,Suecia,752,0,1,,1,"(7.128456,-73.183637)"
2020,Noviembre,Suiza,756,6,3,,9,"(10.445761,-75.516429)"
2020,Noviembre,Suiza,756,3,5,,8,"(3.541112,-76.384584)"
2020,Noviembre,Suiza,756,39,37,,76,"(4.697144,-74.140516)"
2020,Noviembre,Suiza,756,7,2,,9,"(6.171601,-75.427454)"
2020,Noviembre,Surinam,740,0,1,,1,"(10.408582,-75.538003)"
2020,Noviembre,Taiwán,158,1,1,,2,"(3.541112,-76.384584)"
2020,Noviembre,Taiwán,158,1,4,,5,"(4.697144,-74.140516)"
2020,Noviembre,Tailandia,764,1,1,,2,"(4.697144,-74.140516)"
2020,Noviembre,Tanzania,834,0,1,,1,"(4.697144,-74.140516)"
2020,Noviembre,Trinidad y Tobago,780,0,1,,1,"(4.697144,-74.140516)"
2020,Noviembre,Trinidad y Tobago,780,0,1,,1,"(6.171601,-75.427454)"
2020,Noviembre,Turquía,792,136,114,,250,"(4.697144,-74.140516)"
2020,Noviembre,Turquía,792,3,1,,4,"(6.171601,-75.427454)"
2020,Noviembre,Ucrania,804,0,1,,1,"(10.445761,-75.516429)"
2020,Noviembre,Ucrania,804,1,12,,13,"(4.697144,-74.140516)"
2020,Noviembre,Uganda,800,2,1,,3,"(4.697144,-74.140516)"
2020,Noviembre,Uruguay,858,2,2,,4,"(10.445761,-75.516429)"
2020,Noviembre,Uruguay,858,3,5,,8,"(10.886611,-74.776708)"
2020,Noviembre,Uruguay,858,6,7,,13,"(3.541112,-76.384584)"
2020,Noviembre,Uruguay,858,23,47,,70,"(4.697144,-74.140516)"
2020,Noviembre,Uruguay,858,4,5,,9,"(4.815061,-75.736532)"
2020,Noviembre,Uruguay,858,23,44,,67,"(6.171601,-75.427454)"
2020,Noviembre,Venezuela,862,0,5,,5,"(10.886611,-74.776708)"
2020,Noviembre,Venezuela,862,1,169,,170,"(11.360009,-72.129330)"
2020,Noviembre,Venezuela,862,5,12,,17,"(3.541112,-76.384584)"
2020,Noviembre,Venezuela,862,31,122,,153,"(4.697144,-74.140516)"
2020,Noviembre,Venezuela,862,6,1,,7,"(6.171601,-75.427454)"
2020,Noviembre,Venezuela,862,0,1,,1,"(6.185799,-67.483929)"
2020,Noviembre,Venezuela,862,0,4,,4,"(7.818934,-72.453226)"
2020,Noviembre,Venezuela,862,1,3,,4,"(7.916725,-72.462544)"
2020,Noviembre,Vietnam,704,0,1,,1,"(6.171601,-75.427454)"
2020,Noviembre,Islas Vírgenes Estadounidenses/Territorio de Estados Unidos,850,0,1,,1,"(3.541112,-76.384584)"
2020,Noviembre,Islas Vírgenes Estadounidenses/Territorio de Estados Unidos,850,0,1,,1,"(4.697144,-74.140516)"
2020,Noviembre,Islas Vírgenes Estadounidenses/Territorio de Estados Unidos,850,1,0,,1,"(6.171601,-75.427454)"
2020,Noviembre,Anguila/Territorio Británico de Ultramar,660,1,0,,1,"(6.171601,-75.427454)"
2020,Noviembre,Islas Turcas y Caicos/Territorio Británico de Ultramar,796,1,1,,2,"(4.697144,-74.140516)"
2020,Noviembre,Desconocido,99999,1,0,,1,"(10.445761,-75.516429)"
2020,Diciembre,Afganistán,4,1,3,,4,"(4.697144,-74.140516)"
2020,Diciembre,Albania,8,1,0,,1,"(4.697144,-74.140516)"
2020,Diciembre,Alemania,276,15,7,,22,"(10.445761,-75.516429)"
2020,Diciembre,Alemania,276,3,1,,4,"(10.886611,-74.776708)"
2020,Diciembre,Alemania,276,11,11,,22,"(3.541112,-76.384584)"
2020,Diciembre,Alemania,276,313,173,,486,"(4.697144,-74.140516)"
2020,Diciembre,Alemania,276,1,0,,1,"(4.815061,-75.736532)"
2020,Diciembre,Alemania,276,23,16,,39,"(6.171601,-75.427454)"
2020,Diciembre,Andorra,20,1,0,,1,"(4.697144,-74.140516)"
2020,Diciembre,Angola,24,0,1,,1,"(4.697144,-74.140516)"
2020,Diciembre,Antigua y Barbuda,28,0,1,,1,"(4.697144,-74.140516)"
2020,Diciembre,Antigua y Barbuda,28,0,9,,9,"(7.927209,-72.507910)"
2020,Diciembre,Países Bajos,528,54,41,,95,"(10.445761,-75.516429)"
2020,Diciembre,Países Bajos,528,2,3,,5,"(10.886611,-74.776708)"
2020,Diciembre,Países Bajos,528,12,4,,16,"(3.541112,-76.384584)"
2020,Diciembre,Países Bajos,528,268,253,,521,"(4.697144,-74.140516)"
2020,Diciembre,Países Bajos,528,1,0,,1,"(4.815061,-75.736532)"
2020,Diciembre,Países Bajos,528,31,11,,42,"(6.171601,-75.427454)"
2020,Diciembre,Países Bajos,528,2,1,,3,"(7.128456,-73.183637)"
2020,Diciembre,Países Bajos,528,0,6,,6,"(7.927209,-72.507910)"
2020,Diciembre,Arabia Saudita,682,1,0,,1,"(10.445761,-75.516429)"
2020,Diciembre,Arabia Saudita,682,3,2,,5,"(3.541112,-76.384584)"
2020,Diciembre,Arabia Saudita,682,1,12,,13,"(4.697144,-74.140516)"
2020,Diciembre,Arabia Saudita,682,1,1,,2,"(6.171601,-75.427454)"
2020,Diciembre,Argentina,32,9,4,,13,"(10.445761,-75.516429)"
2020,Diciembre,Argentina,32,4,1,,5,"(10.886611,-74.776708)"
2020,Diciembre,Argentina,32,23,12,,35,"(3.541112,-76.384584)"
2020,Diciembre,Argentina,32,660,456,,1116,"(4.697144,-74.140516)"
2020,Diciembre,Argentina,32,2,3,,5,"(4.815061,-75.736532)"
2020,Diciembre,Argentina,32,20,12,,32,"(6.171601,-75.427454)"
2020,Diciembre,Aruba,533,0,6,,6,"(10.408582,-75.538003)"
2020,Diciembre,Aruba,533,0,1,,1,"(10.445761,-75.516429)"
2020,Diciembre,Aruba,533,3,4,,7,"(10.886611,-74.776708)"
2020,Diciembre,Aruba,533,1,2,,3,"(11.528919,-72.919681)"
2020,Diciembre,Aruba,533,11,10,,21,"(3.541112,-76.384584)"
2020,Diciembre,Aruba,533,946,757,,1703,"(4.697144,-74.140516)"
2020,Diciembre,Aruba,533,28,24,,52,"(6.171601,-75.427454)"
2020,Diciembre,Aruba,533,4,15,,19,"(7.128456,-73.183637)"
2020,Diciembre,Australia,36,2,1,,3,"(3.541112,-76.384584)"
2020,Diciembre,Australia,36,11,4,,15,"(4.697144,-74.140516)"
2020,Diciembre,Australia,36,1,0,,1,"(6.171601,-75.427454)"
2020,Diciembre,Austria,40,2,0,,2,"(10.445761,-75.516429)"
2020,Diciembre,Austria,40,0,1,,1,"(3.541112,-76.384584)"
2020,Diciembre,Austria,40,17,14,,31,"(4.697144,-74.140516)"
2020,Diciembre,Austria,40,2,2,,4,"(6.171601,-75.427454)"
2020,Diciembre,Bahamas,44,0,3,,3,"(10.408582,-75.538003)"
2020,Diciembre,Bahamas,44,3,6,,9,"(10.886611,-74.776708)"
2020,Diciembre,Bahamas,44,2,0,,2,"(3.541112,-76.384584)"
2020,Diciembre,Bahamas,44,17,22,,39,"(4.697144,-74.140516)"
2020,Diciembre,Bahamas,44,1,0,,1,"(4.815061,-75.736532)"
2020,Diciembre,Bahamas,44,7,1,,8,"(6.171601,-75.427454)"
2020,Diciembre,Bangladesh,50,0,1,,1,"(4.697144,-74.140516)"
2020,Diciembre,Barbados,52,1,1,,2,"(4.697144,-74.140516)"
2020,Diciembre,República de Belarús,112,0,1,,1,"(4.697144,-74.140516)"
2020,Diciembre,Bélgica,56,1,3,,4,"(10.445761,-75.516429)"
2020,Diciembre,Bélgica,56,0,1,,1,"(10.886611,-74.776708)"
2020,Diciembre,Bélgica,56,2,2,,4,"(3.541112,-76.384584)"
2020,Diciembre,Bélgica,56,26,14,,40,"(4.697144,-74.140516)"
2020,Diciembre,Bélgica,56,9,5,,14,"(6.171601,-75.427454)"
2020,Diciembre,Belice,84,1,0,,1,"(3.541112,-76.384584)"
2020,Diciembre,Belice,84,5,2,,7,"(4.697144,-74.140516)"
2020,Diciembre,Bermudas/Territorio Británico de Ultramar,60,4,8,,12,"(4.697144,-74.140516)"
2020,Diciembre,Bolivia,68,1,0,,1,"(3.541112,-76.384584)"
2020,Diciembre,Bolivia,68,236,272,,508,"(4.697144,-74.140516)"
2020,Diciembre,Bolivia,68,2,4,,6,"(6.171601,-75.427454)"
2020,Diciembre,Brasil,76,23,30,,53,"(-4.197703,-69.941278)"
2020,Diciembre,Brasil,76,1,6,,7,"(10.408582,-75.538003)"
2020,Diciembre,Brasil,76,10,16,,26,"(10.445761,-75.516429)"
2020,Diciembre,Brasil,76,9,7,,16,"(10.886611,-74.776708)"
2020,Diciembre,Brasil,76,122,96,,218,"(3.541112,-76.384584)"
2020,Diciembre,Brasil,76,1018,1073,,2091,"(4.697144,-74.140516)"
2020,Diciembre,Brasil,76,24,16,,40,"(4.815061,-75.736532)"
2020,Diciembre,Brasil,76,80,117,,197,"(6.171601,-75.427454)"
2020,Diciembre,Bulgaria,100,0,1,,1,"(4.697144,-74.140516)"
2020,Diciembre,Burkina Faso,854,0,1,,1,"(4.697144,-74.140516)"
2020,Diciembre,Islas Caimán/Territorio Británico de Ultramar,136,1,0,,1,"(10.445761,-75.516429)"
2020,Diciembre,Islas Caimán/Territorio Británico de Ultramar,136,2,0,,2,"(4.697144,-74.140516)"
2020,Diciembre,Antártida,10,1,0,,1,"(4.697144,-74.140516)"
2020,Diciembre,Camerún,120,0,1,,1,"(6.171601,-75.427454)"
2020,Diciembre,Canadá,124,8,3,,11,"(10.445761,-75.516429)"
2020,Diciembre,Canadá,124,13,9,,22,"(10.886611,-74.776708)"
2020,Diciembre,Canadá,124,54,43,,97,"(3.541112,-76.384584)"
2020,Diciembre,Canadá,124,677,568,,1245,"(4.697144,-74.140516)"
2020,Diciembre,Canadá,124,7,3,,10,"(4.815061,-75.736532)"
2020,Diciembre,Canadá,124,100,81,,181,"(6.171601,-75.427454)"
2020,Diciembre,Canadá,124,1,0,,1,"(7.128456,-73.183637)"
2020,Diciembre,España,724,8,7,,15,"(10.445761,-75.516429)"
2020,Diciembre,España,724,6,39,,45,"(10.886611,-74.776708)"
2020,Diciembre,España,724,120,69,,189,"(3.541112,-76.384584)"
2020,Diciembre,España,724,1628,1262,,2890,"(4.697144,-74.140516)"
2020,Diciembre,España,724,4,1,,5,"(4.815061,-75.736532)"
2020,Diciembre,España,724,223,158,,381,"(6.171601,-75.427454)"
2020,Diciembre,Colombia,170,11,51,,62,"(4.697144,-74.140516)"
2020,Diciembre,República Democrática del Congo,180,1,0,,1,"(4.697144,-74.140516)"
2020,Diciembre,República de Corea,410,2,4,,6,"(4.697144,-74.140516)"
2020,Diciembre,Costa de Marfil,384,0,1,,1,"(4.697144,-74.140516)"
2020,Diciembre,Costa Rica,188,3,5,,8,"(10.445761,-75.516429)"
2020,Diciembre,Costa Rica,188,11,14,,25,"(10.886611,-74.776708)"
2020,Diciembre,Costa Rica,188,1,8,,9,"(12.5744111,-81.703935)"
2020,Diciembre,Costa Rica,188,1,1,,2,"(12.586067,-81.702563)"
2020,Diciembre,Costa Rica,188,32,19,,51,"(3.541112,-76.384584)"
2020,Diciembre,Costa Rica,188,533,460,,993,"(4.697144,-74.140516)"
2020,Diciembre,Costa Rica,188,7,4,,11,"(4.815061,-75.736532)"
2020,Diciembre,Costa Rica,188,83,60,,143,"(6.171601,-75.427454)"
2020,Diciembre,Costa Rica,188,2,2,,4,"(7.128456,-73.183637)"
2020,Diciembre,Croacia,191,0,1,,1,"(10.445761,-75.516429)"
2020,Diciembre,Croacia,191,4,2,,6,"(4.697144,-74.140516)"
2020,Diciembre,Croacia,191,1,0,,1,"(6.171601,-75.427454)"
2020,Diciembre,Cuba,192,1,0,,1,"(10.408582,-75.538003)"
2020,Diciembre,Cuba,192,2,1,,3,"(10.445761,-75.516429)"
2020,Diciembre,Cuba,192,1,3,,4,"(10.886611,-74.776708)"
2020,Diciembre,Cuba,192,10,10,,20,"(3.541112,-76.384584)"
2020,Diciembre,Cuba,192,258,241,,499,"(4.697144,-74.140516)"
2020,Diciembre,Cuba,192,1,0,,1,"(4.815061,-75.736532)"
2020,Diciembre,Cuba,192,16,16,,32,"(6.171601,-75.427454)"
2020,Diciembre,Curazao,99999,0,1,,1,"(11.247723,-74.213989)"
2020,Diciembre,Curazao,99999,7,42,,49,"(4.697144,-74.140516)"
2020,Diciembre,Curazao,99999,0,1,,1,"(6.171601,-75.427454)"
2020,Diciembre,Curazao,99999,1,1,,2,"(7.128456,-73.183637)"
2020,Diciembre,República Checa,203,3,7,,10,"(4.697144,-74.140516)"
2020,Diciembre,Chile,152,32,8,,40,"(10.445761,-75.516429)"
2020,Diciembre,Chile,152,36,84,,120,"(10.886611,-74.776708)"
2020,Diciembre,Chile,152,838,512,,1350,"(3.541112,-76.384584)"
2020,Diciembre,Chile,152,3840,2549,,6389,"(4.697144,-74.140516)"
2020,Diciembre,Chile,152,79,47,,126,"(4.815061,-75.736532)"
2020,Diciembre,Chile,152,125,74,,199,"(6.171601,-75.427454)"
2020,Diciembre,Chile,152,4,2,,6,"(7.128456,-73.183637)"
2020,Diciembre,China,156,1,6,,7,"(4.697144,-74.140516)"
2020,Diciembre,Chipre,196,1,1,,2,"(4.697144,-74.140516)"
2020,Diciembre,Dinamarca,208,1,0,,1,"(10.445761,-75.516429)"
2020,Diciembre,Dinamarca,208,18,9,,27,"(4.697144,-74.140516)"
2020,Diciembre,Dinamarca,208,3,3,,6,"(6.171601,-75.427454)"
2020,Diciembre,República de Yibuti,262,1,0,,1,"(4.697144,-74.140516)"
2020,Diciembre,Dominica,212,3,2,,5,"(4.697144,-74.140516)"
2020,Diciembre,Ecuador,218,12,15,,27,"(0.814836,-77.662532)"
2020,Diciembre,Ecuador,218,4,1,,5,"(10.445761,-75.516429)"
2020,Diciembre,Ecuador,218,2,4,,6,"(10.886611,-74.776708)"
2020,Diciembre,Ecuador,218,12,16,,28,"(3.541112,-76.384584)"
2020,Diciembre,Ecuador,218,0,1,,1,"(3.893038,-77.067921)"
2020,Diciembre,Ecuador,218,1445,1570,,3015,"(4.697144,-74.140516)"
2020,Diciembre,Ecuador,218,4,4,,8,"(4.815061,-75.736532)"
2020,Diciembre,Ecuador,218,24,46,,70,"(6.171601,-75.427454)"
2020,Diciembre,Ecuador,218,1,5,,6,"(7.128456,-73.183637)"
2020,Diciembre,Egipto,818,1,0,,1,"(10.445761,-75.516429)"
2020,Diciembre,Egipto,818,10,8,,18,"(4.697144,-74.140516)"
2020,Diciembre,Egipto,818,1,0,,1,"(6.171601,-75.427454)"
2020,Diciembre,El Salvador,222,1,0,,1,"(10.886611,-74.776708)"
2020,Diciembre,El Salvador,222,5,4,,9,"(3.541112,-76.384584)"
2020,Diciembre,El Salvador,222,160,186,,346,"(4.697144,-74.140516)"
2020,Diciembre,El Salvador,222,8,9,,17,"(6.171601,-75.427454)"
2020,Diciembre,Emiratos Árabes,784,20,15,,35,"(10.445761,-75.516429)"
2020,Diciembre,Emiratos Árabes,784,1,0,,1,"(10.886611,-74.776708)"
2020,Diciembre,Emiratos Árabes,784,5,2,,7,"(3.541112,-76.384584)"
2020,Diciembre,Emiratos Árabes,784,98,392,,490,"(4.697144,-74.140516)"
2020,Diciembre,Emiratos Árabes,784,1,0,,1,"(4.815061,-75.736532)"
2020,Diciembre,Emiratos Árabes,784,12,7,,19,"(6.171601,-75.427454)"
2020,Diciembre,Eslovaquia,703,1,3,,4,"(4.697144,-74.140516)"
2020,Diciembre,Estados Unidos de América,840,0,42,,42,"(10.408582,-75.538003)"
2020,Diciembre,Estados Unidos de América,840,1707,1393,,3100,"(10.445761,-75.516429)"
2020,Diciembre,Estados Unidos de América,840,2839,2311,,5151,"(10.886611,-74.776708)"
2020,Diciembre,Estados Unidos de América,840,3,6,,9,"(12.586067,-81.702563)"
2020,Diciembre,Estados Unidos de América,840,5366,3741,,9107,"(3.541112,-76.384584)"
2020,Diciembre,Estados Unidos de América,840,931,648,,1579,"(4.452882,-75.766298)"
2020,Diciembre,Estados Unidos de América,840,24411,19640,,44051,"(4.697144,-74.140516)"
2020,Diciembre,Estados Unidos de América,840,657,380,,1037,"(4.815061,-75.736532)"
2020,Diciembre,Estados Unidos de América,840,9857,7621,,17480,"(6.171601,-75.427454)"
2020,Diciembre,Estados Unidos de América,840,736,574,,1310,"(7.128456,-73.183637)"
2020,Diciembre,Estonia,233,1,2,,3,"(4.697144,-74.140516)"
2020,Diciembre,Etiopia,231,0,2,,2,"(4.697144,-74.140516)"
2020,Diciembre,Finlandia,246,9,8,,17,"(4.697144,-74.140516)"
2020,Diciembre,Francia,250,13,3,,16,"(10.445761,-75.516429)"
2020,Diciembre,Francia,250,1,0,,1,"(10.886611,-74.776708)"
2020,Diciembre,Francia,250,10,8,,18,"(3.541112,-76.384584)"
2020,Diciembre,Francia,250,278,184,,462,"(4.697144,-74.140516)"
2020,Diciembre,Francia,250,5,3,,8,"(4.815061,-75.736532)"
2020,Diciembre,Francia,250,20,13,,33,"(6.171601,-75.427454)"
2020,Diciembre,Gabón,266,3,2,,5,"(4.697144,-74.140516)"
2020,Diciembre,Georgia,268,2,2,,4,"(4.697144,-74.140516)"
2020,Diciembre,Georgia,268,2,0,,2,"(6.171601,-75.427454)"
2020,Diciembre,Ghana,288,0,1,,1,"(4.697144,-74.140516)"
2020,Diciembre,Grecia,300,1,0,,1,"(4.697144,-74.140516)"
2020,Diciembre,Guatemala,320,4,2,,6,"(10.445761,-75.516429)"
2020,Diciembre,Guatemala,320,14,10,,24,"(10.886611,-74.776708)"
2020,Diciembre,Guatemala,320,2,4,,6,"(12.586067,-81.702563)"
2020,Diciembre,Guatemala,320,14,19,,33,"(3.541112,-76.384584)"
2020,Diciembre,Guatemala,320,243,260,,503,"(4.697144,-74.140516)"
2020,Diciembre,Guatemala,320,13,8,,21,"(4.815061,-75.736532)"
2020,Diciembre,Guatemala,320,56,34,,90,"(6.171601,-75.427454)"
2020,Diciembre,Guatemala,320,1,1,,2,"(7.128456,-73.183637)"
2020,Diciembre,Guyana,328,1,3,,4,"(10.886611,-74.776708)"
2020,Diciembre,Guyana,328,1,0,,1,"(4.697144,-74.140516)"
2020,Diciembre,Guyana,328,2,0,,2,"(6.171601,-75.427454)"
2020,Diciembre,Guinea,324,0,1,,1,"(4.697144,-74.140516)"
2020,Diciembre,Guinea Ecuatorial,226,0,2,,2,"(4.697144,-74.140516)"
2020,Diciembre,Guadalupe/Territorio Francés,312,1,1,,2,"(4.697144,-74.140516)"
2020,Diciembre,Haití,332,5,4,,9,"(10.886611,-74.776708)"
2020,Diciembre,Haití,332,0,2,,2,"(4.697144,-74.140516)"
2020,Diciembre,Honduras,340,0,8,,8,"(10.408582,-75.538003)"
2020,Diciembre,Honduras,340,0,1,,1,"(10.445761,-75.516429)"
2020,Diciembre,Honduras,340,1,1,,2,"(10.886611,-74.776708)"
2020,Diciembre,Honduras,340,0,1,,1,"(12.5744111,-81.703935)"
2020,Diciembre,Honduras,340,2,5,,7,"(3.541112,-76.384584)"
2020,Diciembre,Honduras,340,28,47,,75,"(4.697144,-74.140516)"
2020,Diciembre,Honduras,340,7,10,,17,"(6.171601,-75.427454)"
2020,Diciembre,Hong Kong,344,1,0,,1,"(4.697144,-74.140516)"
2020,Diciembre,Hungría,348,1,0,,1,"(10.445761,-75.516429)"
2020,Diciembre,Hungría,348,1,2,,3,"(4.697144,-74.140516)"
2020,Diciembre,Hungría,348,1,0,,1,"(6.171601,-75.427454)"
2020,Diciembre,India,356,1,1,,2,"(4.697144,-74.140516)"
2020,Diciembre,Indonesia,360,2,4,,6,"(4.697144,-74.140516)"
2020,Diciembre,Iraq,368,0,5,,5,"(10.408582,-75.538003)"
2020,Diciembre,Iraq,368,0,1,,1,"(4.697144,-74.140516)"
2020,Diciembre,Irán,364,1,0,,1,"(4.697144,-74.140516)"
2020,Diciembre,Irán,364,3,1,,4,"(6.171601,-75.427454)"
2020,Diciembre,República de Irlanda,372,5,3,,8,"(4.697144,-74.140516)"
2020,Diciembre,República de Irlanda,372,0,1,,1,"(6.171601,-75.427454)"
2020,Diciembre,Islandia,352,0,1,,1,"(4.697144,-74.140516)"
2020,Diciembre,Israel,376,0,1,,1,"(10.445761,-75.516429)"
2020,Diciembre,Israel,376,1,1,,2,"(10.886611,-74.776708)"
2020,Diciembre,Israel,376,0,3,,3,"(3.541112,-76.384584)"
2020,Diciembre,Israel,376,16,15,,31,"(4.697144,-74.140516)"
2020,Diciembre,Israel,376,5,1,,6,"(6.171601,-75.427454)"
2020,Diciembre,Italia,380,12,2,,14,"(10.445761,-75.516429)"
2020,Diciembre,Italia,380,1,1,,2,"(10.886611,-74.776708)"
2020,Diciembre,Italia,380,8,5,,13,"(3.541112,-76.384584)"
2020,Diciembre,Italia,380,143,66,,209,"(4.697144,-74.140516)"
2020,Diciembre,Italia,380,7,2,,9,"(6.171601,-75.427454)"
2020,Diciembre,Jamaica,388,1,3,,4,"(10.886611,-74.776708)"
2020,Diciembre,Jamaica,388,1,0,,1,"(4.452882,-75.766298)"
2020,Diciembre,Jamaica,388,9,9,,18,"(4.697144,-74.140516)"
2020,Diciembre,Jamaica,388,8,7,,15,"(6.171601,-75.427454)"
2020,Diciembre,Japón,392,10,6,,16,"(4.697144,-74.140516)"
2020,Diciembre,Japón,392,2,0,,2,"(6.171601,-75.427454)"
2020,Diciembre,Lituania,440,0,1,,1,"(4.697144,-74.140516)"
2020,Diciembre,Líbano,422,0,4,,4,"(10.408582,-75.538003)"
2020,Diciembre,Líbano,422,9,13,,22,"(4.697144,-74.140516)"
2020,Diciembre,Líbano,422,1,0,,1,"(6.171601,-75.427454)"
2020,Diciembre,Liberia,430,0,1,,1,"(4.697144,-74.140516)"
2020,Diciembre,Luxemburgo,442,3,2,,5,"(4.697144,-74.140516)"
2020,Diciembre,Luxemburgo,442,0,1,,1,"(6.171601,-75.427454)"
2020,Diciembre,Malasia,458,1,2,,3,"(4.697144,-74.140516)"
2020,Diciembre,Maldivas,462,1,0,,1,"(4.697144,-74.140516)"
2020,Diciembre,Malí,466,0,1,,1,"(4.697144,-74.140516)"
2020,Diciembre,Malta,470,6,11,,17,"(4.697144,-74.140516)"
2020,Diciembre,Marruecos,504,0,1,,1,"(4.697144,-74.140516)"
2020,Diciembre,Mauritania,478,0,2,,2,"(4.697144,-74.140516)"
2020,Diciembre,México,484,0,1,,1,"(10.408582,-75.538003)"
2020,Diciembre,México,484,61,22,,83,"(10.445761,-75.516429)"
2020,Diciembre,México,484,56,56,,112,"(10.886611,-74.776708)"
2020,Diciembre,México,484,446,369,,815,"(3.541112,-76.384584)"
2020,Diciembre,México,484,6711,5619,,12330,"(4.697144,-74.140516)"
2020,Diciembre,México,484,67,50,,117,"(4.815061,-75.736532)"
2020,Diciembre,México,484,2,6,,8,"(6.17134,-75.427194)"
2020,Diciembre,México,484,1858,1359,,3217,"(6.171601,-75.427454)"
2020,Diciembre,México,484,35,29,,64,"(7.128456,-73.183637)"
2020,Diciembre,Mozambique,508,0,2,,2,"(4.697144,-74.140516)"
2020,Diciembre,Nicaragua,558,22,32,,54,"(4.697144,-74.140516)"
2020,Diciembre,Nicaragua,558,1,2,,3,"(6.171601,-75.427454)"
2020,Diciembre,Nigeria,566,1,1,,2,"(4.697144,-74.140516)"
2020,Diciembre,Noruega,578,0,1,,1,"(10.445761,-75.516429)"
2020,Diciembre,Noruega,578,1,0,,1,"(3.541112,-76.384584)"
2020,Diciembre,Noruega,578,11,9,,20,"(4.697144,-74.140516)"
2020,Diciembre,Noruega,578,0,2,,2,"(4.815061,-75.736532)"
2020,Diciembre,Nueva Caledonia/Territorio francés,540,0,2,,2,"(4.697144,-74.140516)"
2020,Diciembre,Nueva Zelanda,554,0,2,,2,"(4.697144,-74.140516)"
2020,Diciembre,Nueva Zelanda,554,1,0,,1,"(6.171601,-75.427454)"
2020,Diciembre,Omán,512,0,2,,2,"(3.541112,-76.384584)"
2020,Diciembre,Omán,512,4,4,,8,"(4.697144,-74.140516)"
2020,Diciembre,Panamá,591,1,13,,14,"(10.408582,-75.538003)"
2020,Diciembre,Panamá,591,518,425,,943,"(10.445761,-75.516429)"
2020,Diciembre,Panamá,591,220,158,,378,"(10.886611,-74.776708)"
2020,Diciembre,Panamá,591,3,3,,6,"(11.117806,-74.232622)"
2020,Diciembre,Panamá,591,1,8,,9,"(12.5744111,-81.703935)"
2020,Diciembre,Panamá,591,0,9,,9,"(12.586067,-81.702563)"
2020,Diciembre,Panamá,591,1079,742,,1821,"(3.541112,-76.384584)"
2020,Diciembre,Panamá,591,2209,2132,,4341,"(4.697144,-74.140516)"
2020,Diciembre,Panamá,591,147,80,,227,"(4.815061,-75.736532)"
2020,Diciembre,Panamá,591,925,742,,1667,"(6.171601,-75.427454)"
2020,Diciembre,Panamá,591,32,18,,50,"(7.128456,-73.183637)"
2020,Diciembre,Paraguay,600,5,2,,7,"(3.541112,-76.384584)"
2020,Diciembre,Paraguay,600,87,137,,224,"(4.697144,-74.140516)"
2020,Diciembre,Paraguay,600,6,2,,8,"(6.171601,-75.427454)"
2020,Diciembre,Paraguay,600,0,1,,1,"(7.128456,-73.183637)"
2020,Diciembre,Perú,604,7,5,,12,"(-4.197703,-69.941278)"
2020,Diciembre,Perú,604,11,8,,19,"(10.445761,-75.516429)"
2020,Diciembre,Perú,604,4,2,,6,"(10.886611,-74.776708)"
2020,Diciembre,Perú,604,79,70,,149,"(3.541112,-76.384584)"
2020,Diciembre,Perú,604,1313,1358,,2671,"(4.697144,-74.140516)"
2020,Diciembre,Perú,604,3,0,,3,"(4.815061,-75.736532)"
2020,Diciembre,Perú,604,158,133,,291,"(6.171601,-75.427454)"
2020,Diciembre,Perú,604,3,2,,5,"(7.128456,-73.183637)"
2020,Diciembre,Polonia,616,9,7,,16,"(4.697144,-74.140516)"
2020,Diciembre,Portugal,620,0,1,,1,"(10.445761,-75.516429)"
2020,Diciembre,Portugal,620,1,1,,2,"(3.541112,-76.384584)"
2020,Diciembre,Portugal,620,23,18,,41,"(4.697144,-74.140516)"
2020,Diciembre,Portugal,620,4,0,,4,"(6.171601,-75.427454)"
2020,Diciembre,Puerto Rico/Territorio de Estados Unidos,630,4,3,,7,"(10.445761,-75.516429)"
2020,Diciembre,Puerto Rico/Territorio de Estados Unidos,630,4,4,,8,"(10.886611,-74.776708)"
2020,Diciembre,Puerto Rico/Territorio de Estados Unidos,630,9,13,,22,"(3.541112,-76.384584)"
2020,Diciembre,Puerto Rico/Territorio de Estados Unidos,630,194,163,,357,"(4.697144,-74.140516)"
2020,Diciembre,Puerto Rico/Territorio de Estados Unidos,630,5,0,,5,"(4.815061,-75.736532)"
2020,Diciembre,Puerto Rico/Territorio de Estados Unidos,630,25,18,,43,"(6.171601,-75.427454)"
2020,Diciembre,Qatar,634,2,5,,7,"(4.697144,-74.140516)"
2020,Diciembre,Qatar,634,1,0,,1,"(6.171601,-75.427454)"
2020,Diciembre,Reino Unido de Gran Bretaña e Irlanda del Norte,826,6,6,,12,"(10.445761,-75.516429)"
2020,Diciembre,Reino Unido de Gran Bretaña e Irlanda del Norte,826,1,2,,3,"(10.886611,-74.776708)"
2020,Diciembre,Reino Unido de Gran Bretaña e Irlanda del Norte,826,23,12,,35,"(3.541112,-76.384584)"
2020,Diciembre,Reino Unido de Gran Bretaña e Irlanda del Norte,826,285,204,,489,"(4.697144,-74.140516)"
2020,Diciembre,Reino Unido de Gran Bretaña e Irlanda del Norte,826,8,3,,11,"(4.815061,-75.736532)"
2020,Diciembre,Reino Unido de Gran Bretaña e Irlanda del Norte,826,34,13,,47,"(6.171601,-75.427454)"
2020,Diciembre,Federación de Rusia,643,1,4,,5,"(4.697144,-74.140516)"
2020,Diciembre,Federación de Rusia,643,1,1,,2,"(6.171601,-75.427454)"
2020,Diciembre,República Dominicana,214,11,12,,23,"(10.445761,-75.516429)"
2020,Diciembre,República Dominicana,214,35,34,,69,"(10.886611,-74.776708)"
2020,Diciembre,República Dominicana,214,13,11,,24,"(11.117806,-74.232622)"
2020,Diciembre,República Dominicana,214,118,89,,207,"(3.541112,-76.384584)"
2020,Diciembre,República Dominicana,214,2830,2437,,5267,"(4.697144,-74.140516)"
2020,Diciembre,República Dominicana,214,12,8,,20,"(4.815061,-75.736532)"
2020,Diciembre,República Dominicana,214,305,210,,515,"(6.171601,-75.427454)"
2020,Diciembre,Reunión,638,1,0,,1,"(4.697144,-74.140516)"
2020,Diciembre,Rumania,642,2,1,,3,"(4.697144,-74.140516)"
2020,Diciembre,Rumania,642,1,0,,1,"(6.171601,-75.427454)"
2020,Diciembre,Serbia,688,2,2,,4,"(4.697144,-74.140516)"
2020,Diciembre,Singapur,702,2,2,,4,"(10.445761,-75.516429)"
2020,Diciembre,Singapur,702,1,1,,2,"(4.697144,-74.140516)"
2020,Diciembre,Sudáfrica,710,1,0,,1,"(4.697144,-74.140516)"
2020,Diciembre,Sudáfrica,710,0,2,,2,"(6.171601,-75.427454)"
2020,Diciembre,Suecia,752,1,1,,2,"(10.445761,-75.516429)"
2020,Diciembre,Suecia,752,0,1,,1,"(10.886611,-74.776708)"
2020,Diciembre,Suecia,752,3,0,,3,"(3.541112,-76.384584)"
2020,Diciembre,Suecia,752,26,23,,49,"(4.697144,-74.140516)"
2020,Diciembre,Suecia,752,1,0,,1,"(4.815061,-75.736532)"
2020,Diciembre,Suecia,752,8,2,,10,"(6.171601,-75.427454)"
2020,Diciembre,Suiza,756,7,1,,8,"(10.445761,-75.516429)"
2020,Diciembre,Suiza,756,1,0,,1,"(10.886611,-74.776708)"
2020,Diciembre,Suiza,756,7,9,,16,"(3.541112,-76.384584)"
2020,Diciembre,Suiza,756,86,43,,129,"(4.697144,-74.140516)"
2020,Diciembre,Suiza,756,0,1,,1,"(4.815061,-75.736532)"
2020,Diciembre,Suiza,756,14,12,,26,"(6.171601,-75.427454)"
2020,Diciembre,Surinam,740,3,2,,5,"(4.697144,-74.140516)"
2020,Diciembre,Surinam,740,0,1,,1,"(6.171601,-75.427454)"
2020,Diciembre,Taiwán,158,1,3,,4,"(4.697144,-74.140516)"
2020,Diciembre,Tailandia,764,3,2,,5,"(4.697144,-74.140516)"
2020,Diciembre,Tanzania,834,2,0,,2,"(4.697144,-74.140516)"
2020,Diciembre,Tanzania,834,0,1,,1,"(6.171601,-75.427454)"
2020,Diciembre,Trinidad y Tobago,780,1,1,,2,"(4.697144,-74.140516)"
2020,Diciembre,Turquía,792,1,0,,1,"(3.541112,-76.384584)"
2020,Diciembre,Turquía,792,204,180,,384,"(4.697144,-74.140516)"
2020,Diciembre,Turquía,792,0,2,,2,"(4.815061,-75.736532)"
2020,Diciembre,Turquía,792,3,2,,5,"(6.171601,-75.427454)"
2020,Diciembre,Ucrania,804,0,1,,1,"(10.445761,-75.516429)"
2020,Diciembre,Ucrania,804,3,6,,9,"(4.697144,-74.140516)"
2020,Diciembre,Uganda,800,1,1,,2,"(4.697144,-74.140516)"
2020,Diciembre,Uruguay,858,1,0,,1,"(10.445761,-75.516429)"
2020,Diciembre,Uruguay,858,3,4,,7,"(3.541112,-76.384584)"
2020,Diciembre,Uruguay,858,49,59,,108,"(4.697144,-74.140516)"
2020,Diciembre,Uruguay,858,3,6,,9,"(4.815061,-75.736532)"
2020,Diciembre,Uruguay,858,12,1,,13,"(6.171601,-75.427454)"
2020,Diciembre,Venezuela,862,1,0,,1,"(10.445761,-75.516429)"
2020,Diciembre,Venezuela,862,2,2,,4,"(10.886611,-74.776708)"
2020,Diciembre,Venezuela,862,0,5,,5,"(10.971302,-74.765397)"
2020,Diciembre,Venezuela,862,0,124,,124,"(11.360009,-72.129330)"
2020,Diciembre,Venezuela,862,2,1,,3,"(3.541112,-76.384584)"
2020,Diciembre,Venezuela,862,45,134,,179,"(4.697144,-74.140516)"
2020,Diciembre,Venezuela,862,7,2,,9,"(6.171601,-75.427454)"
2020,Diciembre,Venezuela,862,0,1,,1,"(6.185799,-67.483929)"
2020,Diciembre,Vietnam,704,0,3,,3,"(4.697144,-74.140516)"
2020,Diciembre,Islas Vírgenes Británicas/Territorio Británico de Ultramar,92,2,0,,2,"(4.697144,-74.140516)"
2020,Diciembre,Islas Turcas y Caicos/Territorio Británico de Ultramar,796,1,0,,1,"(10.886611,-74.776708)"
2020,Diciembre,Islas Turcas y Caicos/Territorio Británico de Ultramar,796,1,4,,5,"(7.128456,-73.183637)"
2021,Enero,Afganistán,4,2,12,,14,"(4.697144,-74.140516)"
2021,Enero,Albania,8,1,0,,1,"(4.697144,-74.140516)"
2021,Enero,Albania,8,0,1,,1,"(6.171601,-75.427454)"
2021,Enero,Alemania,276,13,12,,25,"(10.445761,-75.516429)"
2021,Enero,Alemania,276,0,4,,4,"(10.886611,-74.776708)"
2021,Enero,Alemania,276,15,11,,26,"(3.541112,-76.384584)"
2021,Enero,Alemania,276,680,571,,1251,"(4.697144,-74.140516)"
2021,Enero,Alemania,276,43,34,,77,"(6.171601,-75.427454)"
2021,Enero,Andorra,20,0,1,,1,"(10.886611,-74.776708)"
2021,Enero,Andorra,20,3,0,,3,"(4.697144,-74.140516)"
2021,Enero,Andorra,20,0,1,,1,"(6.171601,-75.427454)"
2021,Enero,Angola,24,2,8,,10,"(4.697144,-74.140516)"
2021,Enero,Países Bajos,528,66,37,,103,"(10.445761,-75.516429)"
2021,Enero,Países Bajos,528,3,1,,4,"(10.886611,-74.776708)"
2021,Enero,Países Bajos,528,26,13,,39,"(3.541112,-76.384584)"
2021,Enero,Países Bajos,528,342,367,,709,"(4.697144,-74.140516)"
2021,Enero,Países Bajos,528,1,1,,2,"(4.815061,-75.736532)"
2021,Enero,Países Bajos,528,38,19,,57,"(6.171601,-75.427454)"
2021,Enero,Países Bajos,528,4,8,,12,"(7.128456,-73.183637)"
2021,Enero,Arabia Saudita,682,0,1,,1,"(10.445761,-75.516429)"
2021,Enero,Arabia Saudita,682,2,2,,4,"(3.541112,-76.384584)"
2021,Enero,Arabia Saudita,682,21,60,,81,"(4.697144,-74.140516)"
2021,Enero,Arabia Saudita,682,0,5,,5,"(6.171601,-75.427454)"
2021,Enero,Argelia,12,0,2,,2,"(4.697144,-74.140516)"
2021,Enero,Argentina,32,37,21,,58,"(10.445761,-75.516429)"
2021,Enero,Argentina,32,28,15,,43,"(10.886611,-74.776708)"
2021,Enero,Argentina,32,62,47,,109,"(3.541112,-76.384584)"
2021,Enero,Argentina,32,1339,1053,,2392,"(4.697144,-74.140516)"
2021,Enero,Argentina,32,6,6,,12,"(4.815061,-75.736532)"
2021,Enero,Argentina,32,34,20,,54,"(6.171601,-75.427454)"
2021,Enero,Argentina,32,0,2,,2,"(7.128456,-73.183637)"
2021,Enero,República de Armenia,51,0,1,,1,"(10.886611,-74.776708)"
2021,Enero,República de Armenia,51,2,2,,4,"(4.697144,-74.140516)"
2021,Enero,Aruba,533,5,4,,9,"(10.445761,-75.516429)"
2021,Enero,Aruba,533,2,2,,4,"(10.886611,-74.776708)"
2021,Enero,Aruba,533,0,3,,3,"(11.247723,-74.213989)"
2021,Enero,Aruba,533,10,15,,25,"(3.541112,-76.384584)"
2021,Enero,Aruba,533,971,774,,1745,"(4.697144,-74.140516)"
2021,Enero,Aruba,533,2,0,,2,"(4.815061,-75.736532)"
2021,Enero,Aruba,533,23,17,,40,"(6.171601,-75.427454)"
2021,Enero,Aruba,533,3,17,,20,"(7.128456,-73.183637)"
2021,Enero,Australia,36,1,0,,1,"(10.886611,-74.776708)"
2021,Enero,Australia,36,1,4,,5,"(3.541112,-76.384584)"
2021,Enero,Australia,36,14,15,,29,"(4.697144,-74.140516)"
2021,Enero,Austria,40,1,0,,1,"(10.445761,-75.516429)"
2021,Enero,Austria,40,1,0,,1,"(10.886611,-74.776708)"
2021,Enero,Austria,40,35,27,,62,"(4.697144,-74.140516)"
2021,Enero,Austria,40,4,2,,6,"(6.171601,-75.427454)"
2021,Enero,Azerbaiyán,31,2,3,,5,"(4.697144,-74.140516)"
2021,Enero,Bahamas,44,0,1,,1,"(10.445761,-75.516429)"
2021,Enero,Bahamas,44,1,0,,1,"(11.117806,-74.232622)"
2021,Enero,Bahamas,44,11,10,,21,"(3.541112,-76.384584)"
2021,Enero,Bahamas,44,20,29,,49,"(4.697144,-74.140516)"
2021,Enero,Bahamas,44,1,13,,14,"(6.171601,-75.427454)"
2021,Enero,Bahréin,48,5,11,,16,"(4.697144,-74.140516)"
2021,Enero,Bangladesh,50,1,0,,1,"(4.697144,-74.140516)"
2021,Enero,Barbados,52,1,0,,1,"(10.886611,-74.776708)"
2021,Enero,Barbados,52,1,3,,4,"(4.697144,-74.140516)"
2021,Enero,Bélgica,56,6,1,,7,"(10.445761,-75.516429)"
2021,Enero,Bélgica,56,1,3,,4,"(10.886611,-74.776708)"
2021,Enero,Bélgica,56,6,1,,7,"(3.541112,-76.384584)"
2021,Enero,Bélgica,56,104,72,,176,"(4.697144,-74.140516)"
2021,Enero,Bélgica,56,16,15,,31,"(6.171601,-75.427454)"
2021,Enero,Belice,84,1,5,,6,"(4.697144,-74.140516)"
2021,Enero,Benín,204,0,1,,1,"(4.697144,-74.140516)"
2021,Enero,Bermudas/Territorio Británico de Ultramar,60,1,0,,1,"(4.697144,-74.140516)"
2021,Enero,Bermudas/Territorio Británico de Ultramar,60,3,3,,6,"(6.171601,-75.427454)"
2021,Enero,Bolivia,68,1,2,,3,"(10.445761,-75.516429)"
2021,Enero,Bolivia,68,7,8,,15,"(3.541112,-76.384584)"
2021,Enero,Bolivia,68,260,513,,773,"(4.697144,-74.140516)"
2021,Enero,Bolivia,68,1,0,,1,"(4.815061,-75.736532)"
2021,Enero,Bolivia,68,11,14,,25,"(6.171601,-75.427454)"
2021,Enero,Bosnia y Herzegovina,70,1,2,,3,"(4.697144,-74.140516)"
2021,Enero,Botsuana,72,0,1,,1,"(4.697144,-74.140516)"
2021,Enero,Brasil,76,22,43,,65,"(-4.197703,-69.941278)"
2021,Enero,Brasil,76,27,30,,57,"(10.445761,-75.516429)"
2021,Enero,Brasil,76,17,16,,33,"(10.886611,-74.776708)"
2021,Enero,Brasil,76,88,114,,202,"(3.541112,-76.384584)"
2021,Enero,Brasil,76,1287,1669,,2956,"(4.697144,-74.140516)"
2021,Enero,Brasil,76,18,41,,59,"(4.815061,-75.736532)"
2021,Enero,Brasil,76,79,90,,169,"(6.171601,-75.427454)"
2021,Enero,Brasil,76,4,3,,7,"(7.128456,-73.183637)"
2021,Enero,Bulgaria,100,2,1,,3,"(4.697144,-74.140516)"
2021,Enero,Burkina Faso,854,0,3,,3,"(4.697144,-74.140516)"
2021,Enero,Cabo Verde,132,1,0,,1,"(4.697144,-74.140516)"
2021,Enero,Islas Caimán/Territorio Británico de Ultramar,136,0,1,,1,"(4.697144,-74.140516)"
2021,Enero,Islas Caimán/Territorio Británico de Ultramar,136,0,1,,1,"(6.171601,-75.427454)"
2021,Enero,Camerún,120,0,2,,2,"(4.697144,-74.140516)"
2021,Enero,Camerún,120,4,3,,7,"(6.171601,-75.427454)"
2021,Enero,Canadá,124,18,19,,37,"(10.445761,-75.516429)"
2021,Enero,Canadá,124,30,23,,53,"(10.886611,-74.776708)"
2021,Enero,Canadá,124,84,77,,161,"(3.541112,-76.384584)"
2021,Enero,Canadá,124,1204,1134,,2338,"(4.697144,-74.140516)"
2021,Enero,Canadá,124,11,9,,20,"(4.815061,-75.736532)"
2021,Enero,Canadá,124,201,193,,394,"(6.171601,-75.427454)"
2021,Enero,Canadá,124,7,11,,18,"(7.128456,-73.183637)"
2021,Enero,España,724,14,15,,29,"(10.445761,-75.516429)"
2021,Enero,España,724,2,1,,3,"(10.886611,-74.776708)"
2021,Enero,España,724,169,94,,263,"(3.541112,-76.384584)"
2021,Enero,España,724,3763,2918,,6681,"(4.697144,-74.140516)"
2021,Enero,España,724,0,1,,1,"(4.815061,-75.736532)"
2021,Enero,España,724,545,396,,941,"(6.171601,-75.427454)"
2021,Enero,Colombia,170,16,55,,71,"(4.697144,-74.140516)"
2021,Enero,República Del Congo,178,1,1,,2,"(4.697144,-74.140516)"
2021,Enero,República Democrática del Congo,180,2,3,,5,"(4.697144,-74.140516)"
2021,Enero,República de Corea,410,6,5,,11,"(4.697144,-74.140516)"
2021,Enero,Costa de Marfil,384,4,8,,12,"(4.697144,-74.140516)"
2021,Enero,Costa de Marfil,384,2,1,,3,"(6.171601,-75.427454)"
2021,Enero,Costa Rica,188,8,6,,14,"(10.445761,-75.516429)"
2021,Enero,Costa Rica,188,25,18,,43,"(10.886611,-74.776708)"
2021,Enero,Costa Rica,188,1,16,,17,"(12.5744111,-81.703935)"
2021,Enero,Costa Rica,188,73,70,,143,"(3.541112,-76.384584)"
2021,Enero,Costa Rica,188,698,686,,1384,"(4.697144,-74.140516)"
2021,Enero,Costa Rica,188,17,19,,36,"(4.815061,-75.736532)"
2021,Enero,Costa Rica,188,102,85,,187,"(6.171601,-75.427454)"
2021,Enero,Costa Rica,188,4,4,,8,"(7.128456,-73.183637)"
2021,Enero,Croacia,191,0,1,,1,"(3.541112,-76.384584)"
2021,Enero,Croacia,191,3,5,,8,"(4.697144,-74.140516)"
2021,Enero,Croacia,191,0,2,,2,"(6.171601,-75.427454)"
2021,Enero,Cuba,192,2,0,,2,"(10.445761,-75.516429)"
2021,Enero,Cuba,192,8,9,,17,"(3.541112,-76.384584)"
2021,Enero,Cuba,192,456,456,,912,"(4.697144,-74.140516)"
2021,Enero,Cuba,192,1,2,,3,"(4.815061,-75.736532)"
2021,Enero,Cuba,192,2,2,,4,"(6.171601,-75.427454)"
2021,Enero,Curazao,99999,2,1,,3,"(10.886611,-74.776708)"
2021,Enero,Curazao,99999,157,157,,314,"(4.697144,-74.140516)"
2021,Enero,Curazao,99999,3,2,,5,"(6.171601,-75.427454)"
2021,Enero,República Checa,203,0,1,,1,"(10.445761,-75.516429)"
2021,Enero,República Checa,203,0,1,,1,"(3.541112,-76.384584)"
2021,Enero,República Checa,203,9,14,,23,"(4.697144,-74.140516)"
2021,Enero,República Checa,203,2,1,,3,"(6.171601,-75.427454)"
2021,Enero,Chile,152,48,32,,80,"(10.445761,-75.516429)"
2021,Enero,Chile,152,75,53,,128,"(10.886611,-74.776708)"
2021,Enero,Chile,152,1338,1052,,2390,"(3.541112,-76.384584)"
2021,Enero,Chile,152,4746,3735,,8481,"(4.697144,-74.140516)"
2021,Enero,Chile,152,154,130,,284,"(4.815061,-75.736532)"
2021,Enero,Chile,152,126,96,,222,"(6.171601,-75.427454)"
2021,Enero,Chile,152,2,10,,12,"(7.128456,-73.183637)"
2021,Enero,China,156,0,1,,1,"(10.445761,-75.516429)"
2021,Enero,China,156,2,3,,5,"(4.697144,-74.140516)"
2021,Enero,Dinamarca,208,2,0,,2,"(10.445761,-75.516429)"
2021,Enero,Dinamarca,208,1,0,,1,"(3.541112,-76.384584)"
2021,Enero,Dinamarca,208,21,17,,38,"(4.697144,-74.140516)"
2021,Enero,Dinamarca,208,0,1,,1,"(6.171601,-75.427454)"
2021,Enero,Dominica,212,0,1,,1,"(10.408582,-75.538003)"
2021,Enero,Dominica,212,1,2,,3,"(4.697144,-74.140516)"
2021,Enero,Ecuador,218,1,3,,4,"(0.25129,-76.875963)"
2021,Enero,Ecuador,218,25,22,,47,"(0.814836,-77.662532)"
2021,Enero,Ecuador,218,4,6,,10,"(10.445761,-75.516429)"
2021,Enero,Ecuador,218,6,2,,8,"(10.886611,-74.776708)"
2021,Enero,Ecuador,218,15,26,,41,"(3.541112,-76.384584)"
2021,Enero,Ecuador,218,1565,1894,,3459,"(4.697144,-74.140516)"
2021,Enero,Ecuador,218,2,7,,9,"(4.815061,-75.736532)"
2021,Enero,Ecuador,218,38,32,,70,"(6.171601,-75.427454)"
2021,Enero,Ecuador,218,3,1,,4,"(7.128456,-73.183637)"
2021,Enero,Egipto,818,1,0,,1,"(3.541112,-76.384584)"
2021,Enero,Egipto,818,13,20,,33,"(4.697144,-74.140516)"
2021,Enero,Egipto,818,1,1,,2,"(6.171601,-75.427454)"
2021,Enero,El Salvador,222,0,9,,9,"(10.408582,-75.538003)"
2021,Enero,El Salvador,222,1,1,,2,"(10.886611,-74.776708)"
2021,Enero,El Salvador,222,0,4,,4,"(3.541112,-76.384584)"
2021,Enero,El Salvador,222,172,305,,477,"(4.697144,-74.140516)"
2021,Enero,El Salvador,222,19,11,,30,"(6.171601,-75.427454)"
2021,Enero,Emiratos Árabes,784,9,10,,19,"(10.445761,-75.516429)"
2021,Enero,Emiratos Árabes,784,1,1,,2,"(10.886611,-74.776708)"
2021,Enero,Emiratos Árabes,784,5,3,,8,"(3.541112,-76.384584)"
2021,Enero,Emiratos Árabes,784,155,601,,756,"(4.697144,-74.140516)"
2021,Enero,Emiratos Árabes,784,3,7,,10,"(6.171601,-75.427454)"
2021,Enero,Emiratos Árabes,784,0,1,,1,"(7.128456,-73.183637)"
2021,Enero,Eslovaquia,703,2,2,,4,"(4.697144,-74.140516)"
2021,Enero,Eslovenia,705,1,0,,1,"(3.541112,-76.384584)"
2021,Enero,Eslovenia,705,1,4,,5,"(4.697144,-74.140516)"
2021,Enero,Estados Unidos de América,840,2107,1808,,3915,"(10.445761,-75.516429)"
2021,Enero,Estados Unidos de América,840,2628,2244,,4872,"(10.886611,-74.776708)"
2021,Enero,Estados Unidos de América,840,5505,4386,,9891,"(3.541112,-76.384584)"
2021,Enero,Estados Unidos de América,840,740,699,,1439,"(4.452882,-75.766298)"
2021,Enero,Estados Unidos de América,840,22671,19890,,42561,"(4.697144,-74.140516)"
2021,Enero,Estados Unidos de América,840,933,738,,1671,"(4.815061,-75.736532)"
2021,Enero,Estados Unidos de América,840,9647,8264,,17911,"(6.171601,-75.427454)"
2021,Enero,Estados Unidos de América,840,737,587,,1324,"(7.128456,-73.183637)"
2021,Enero,Estonia,233,3,3,,6,"(4.697144,-74.140516)"
2021,Enero,Etiopia,231,1,7,,8,"(4.697144,-74.140516)"
2021,Enero,Filipinas,608,1,1,,2,"(4.697144,-74.140516)"
2021,Enero,Finlandia,246,1,0,,1,"(3.541112,-76.384584)"
2021,Enero,Finlandia,246,8,11,,19,"(4.697144,-74.140516)"
2021,Enero,Finlandia,246,2,0,,2,"(4.815061,-75.736532)"
2021,Enero,Francia,250,9,4,,13,"(10.445761,-75.516429)"
2021,Enero,Francia,250,6,9,,15,"(10.886611,-74.776708)"
2021,Enero,Francia,250,19,8,,27,"(3.541112,-76.384584)"
2021,Enero,Francia,250,1158,744,,1902,"(4.697144,-74.140516)"
2021,Enero,Francia,250,1,1,,2,"(4.815061,-75.736532)"
2021,Enero,Francia,250,89,70,,159,"(6.171601,-75.427454)"
2021,Enero,Francia,250,0,1,,1,"(7.128456,-73.183637)"
2021,Enero,Gabón,266,1,1,,2,"(4.697144,-74.140516)"
2021,Enero,Georgia,268,1,1,,2,"(4.452882,-75.766298)"
2021,Enero,Georgia,268,2,1,,3,"(4.697144,-74.140516)"
2021,Enero,Georgia,268,1,1,,2,"(6.171601,-75.427454)"
2021,Enero,Ghana,288,4,5,,9,"(4.697144,-74.140516)"
2021,Enero,Ghana,288,1,0,,1,"(6.171601,-75.427454)"
2021,Enero,Gibraltar/Territorio Británico de Ultramar,292,1,0,,1,"(4.697144,-74.140516)"
2021,Enero,Gibraltar/Territorio Británico de Ultramar,292,1,0,,1,"(6.171601,-75.427454)"
2021,Enero,Granada,308,1,1,,2,"(4.697144,-74.140516)"
2021,Enero,Grecia,300,2,1,,3,"(4.697144,-74.140516)"
2021,Enero,Guatemala,320,5,6,,11,"(10.445761,-75.516429)"
2021,Enero,Guatemala,320,9,12,,21,"(10.886611,-74.776708)"
2021,Enero,Guatemala,320,31,39,,70,"(3.541112,-76.384584)"
2021,Enero,Guatemala,320,268,425,,693,"(4.697144,-74.140516)"
2021,Enero,Guatemala,320,5,10,,15,"(4.815061,-75.736532)"
2021,Enero,Guatemala,320,89,95,,184,"(6.171601,-75.427454)"
2021,Enero,Guatemala,320,2,3,,5,"(7.128456,-73.183637)"
2021,Enero,Guyana,328,2,4,,6,"(10.886611,-74.776708)"
2021,Enero,Guyana,328,0,2,,2,"(3.541112,-76.384584)"
2021,Enero,Guyana,328,4,11,,15,"(4.697144,-74.140516)"
2021,Enero,Guyana,328,1,2,,3,"(4.815061,-75.736532)"
2021,Enero,Guyana,328,0,3,,3,"(6.171601,-75.427454)"
2021,Enero,Guyana,328,2,0,,2,"(7.128456,-73.183637)"
2021,Enero,Guinea,324,2,3,,5,"(4.697144,-74.140516)"
2021,Enero,Guinea Ecuatorial,226,0,1,,1,"(4.697144,-74.140516)"
2021,Enero,Guinea Bissau,624,1,0,,1,"(4.697144,-74.140516)"
2021,Enero,Guadalupe/Territorio Francés,312,0,1,,1,"(4.697144,-74.140516)"
2021,Enero,Guayana Francesa/Departamento de Ultramar Francés,254,0,1,,1,"(4.697144,-74.140516)"
2021,Enero,Guayana Francesa/Departamento de Ultramar Francés,254,0,1,,1,"(7.128456,-73.183637)"
2021,Enero,Haití,332,0,1,,1,"(10.445761,-75.516429)"
2021,Enero,Haití,332,0,2,,2,"(10.886611,-74.776708)"
2021,Enero,Haití,332,3,9,,12,"(4.697144,-74.140516)"
2021,Enero,Honduras,340,0,1,,1,"(10.445761,-75.516429)"
2021,Enero,Honduras,340,0,1,,1,"(10.886611,-74.776708)"
2021,Enero,Honduras,340,0,1,,1,"(12.5744111,-81.703935)"
2021,Enero,Honduras,340,6,12,,18,"(3.541112,-76.384584)"
2021,Enero,Honduras,340,63,118,,181,"(4.697144,-74.140516)"
2021,Enero,Honduras,340,18,33,,51,"(6.171601,-75.427454)"
2021,Enero,Honduras,340,1,1,,2,"(7.128456,-73.183637)"
2021,Enero,Hong Kong,344,3,2,,5,"(4.697144,-74.140516)"
2021,Enero,Hungría,348,0,1,,1,"(10.886611,-74.776708)"
2021,Enero,Hungría,348,11,9,,20,"(4.697144,-74.140516)"
2021,Enero,Hungría,348,0,1,,1,"(6.171601,-75.427454)"
2021,Enero,India,356,7,8,,15,"(4.697144,-74.140516)"
2021,Enero,Indonesia,360,1,2,,3,"(4.697144,-74.140516)"
2021,Enero,Iraq,368,1,4,,5,"(4.697144,-74.140516)"
2021,Enero,Iraq,368,1,1,,2,"(6.171601,-75.427454)"
2021,Enero,República de Irlanda,372,1,0,,1,"(10.445761,-75.516429)"
2021,Enero,República de Irlanda,372,19,15,,34,"(4.697144,-74.140516)"
2021,Enero,República de Irlanda,372,1,2,,3,"(6.171601,-75.427454)"
2021,Enero,Islandia,352,2,0,,2,"(4.697144,-74.140516)"
2021,Enero,Israel,376,1,1,,2,"(3.541112,-76.384584)"
2021,Enero,Israel,376,31,13,,44,"(4.697144,-74.140516)"
2021,Enero,Israel,376,4,1,,5,"(6.171601,-75.427454)"
2021,Enero,Italia,380,17,5,,22,"(10.445761,-75.516429)"
2021,Enero,Italia,380,4,1,,5,"(10.886611,-74.776708)"
2021,Enero,Italia,380,26,12,,38,"(3.541112,-76.384584)"
2021,Enero,Italia,380,272,160,,432,"(4.697144,-74.140516)"
2021,Enero,Italia,380,1,1,,2,"(4.815061,-75.736532)"
2021,Enero,Italia,380,36,27,,63,"(6.171601,-75.427454)"
2021,Enero,Jamaica,388,0,7,,7,"(10.408582,-75.538003)"
2021,Enero,Jamaica,388,0,2,,2,"(10.445761,-75.516429)"
2021,Enero,Jamaica,388,4,4,,8,"(10.886611,-74.776708)"
2021,Enero,Jamaica,388,8,7,,15,"(3.541112,-76.384584)"
2021,Enero,Jamaica,388,15,19,,34,"(4.697144,-74.140516)"
2021,Enero,Jamaica,388,1,1,,2,"(4.815061,-75.736532)"
2021,Enero,Jamaica,388,6,12,,18,"(6.171601,-75.427454)"
2021,Enero,Japón,392,0,2,,2,"(3.541112,-76.384584)"
2021,Enero,Japón,392,11,10,,21,"(4.697144,-74.140516)"
2021,Enero,Japón,392,1,2,,3,"(6.171601,-75.427454)"
2021,Enero,Jordania,400,6,5,,11,"(4.697144,-74.140516)"
2021,Enero,Kazajistán,398,0,2,,2,"(4.697144,-74.140516)"
2021,Enero,Kazajistán,398,0,2,,2,"(6.171601,-75.427454)"
2021,Enero,Kenia,404,2,2,,4,"(10.445761,-75.516429)"
2021,Enero,Kenia,404,3,4,,7,"(4.697144,-74.140516)"
2021,Enero,Kuwait,414,0,1,,1,"(4.697144,-74.140516)"
2021,Enero,Lituania,440,0,1,,1,"(4.697144,-74.140516)"
2021,Enero,Líbano,422,7,8,,15,"(4.697144,-74.140516)"
2021,Enero,Líbano,422,0,4,,4,"(6.171601,-75.427454)"
2021,Enero,Liechtenstein,438,1,0,,1,"(6.171601,-75.427454)"
2021,Enero,Luxemburgo,442,1,1,,2,"(10.445761,-75.516429)"
2021,Enero,Luxemburgo,442,2,1,,3,"(3.541112,-76.384584)"
2021,Enero,Luxemburgo,442,21,7,,28,"(4.697144,-74.140516)"
2021,Enero,Luxemburgo,442,2,2,,4,"(6.171601,-75.427454)"
2021,Enero,Macao,446,0,1,,1,"(6.171601,-75.427454)"
2021,Enero,Macedonia,807,1,0,,1,"(4.697144,-74.140516)"
2021,Enero,Malasia,458,5,3,,8,"(4.697144,-74.140516)"
2021,Enero,Maldivas,462,0,1,,1,"(4.697144,-74.140516)"
2021,Enero,Malí,466,1,2,,3,"(4.697144,-74.140516)"
2021,Enero,Malta,470,21,31,,52,"(4.697144,-74.140516)"
2021,Enero,Malta,470,2,0,,2,"(6.171601,-75.427454)"
2021,Enero,Marruecos,504,4,1,,5,"(4.697144,-74.140516)"
2021,Enero,Marruecos,504,1,3,,4,"(6.171601,-75.427454)"
2021,Enero,Mauritania,478,0,8,,8,"(4.697144,-74.140516)"
2021,Enero,México,484,0,1,,1,"(10.408582,-75.538003)"
2021,Enero,México,484,75,58,,133,"(10.445761,-75.516429)"
2021,Enero,México,484,128,78,,206,"(10.886611,-74.776708)"
2021,Enero,México,484,4,3,,7,"(12.586067,-81.702563)"
2021,Enero,México,484,556,495,,1051,"(3.541112,-76.384584)"
2021,Enero,México,484,7414,6799,,14213,"(4.697144,-74.140516)"
2021,Enero,México,484,63,43,,106,"(4.815061,-75.736532)"
2021,Enero,México,484,2308,1771,,4079,"(6.171601,-75.427454)"
2021,Enero,México,484,69,57,,126,"(7.128456,-73.183637)"
2021,Enero,República de Moldavia,498,0,2,,2,"(4.697144,-74.140516)"
2021,Enero,Montenegro,499,0,1,,1,"(4.697144,-74.140516)"
2021,Enero,Mozambique,508,2,3,,5,"(4.697144,-74.140516)"
2021,Enero,Mozambique,508,1,1,,2,"(6.171601,-75.427454)"
2021,Enero,Nepal,524,0,1,,1,"(4.697144,-74.140516)"
2021,Enero,Nicaragua,558,0,2,,2,"(3.541112,-76.384584)"
2021,Enero,Nicaragua,558,20,52,,72,"(4.697144,-74.140516)"
2021,Enero,Nicaragua,558,1,2,,3,"(6.171601,-75.427454)"
2021,Enero,Nigeria,566,1,5,,6,"(4.697144,-74.140516)"
2021,Enero,Noruega,578,1,1,,2,"(10.445761,-75.516429)"
2021,Enero,Noruega,578,0,1,,1,"(3.541112,-76.384584)"
2021,Enero,Noruega,578,23,16,,39,"(4.697144,-74.140516)"
2021,Enero,Noruega,578,4,6,,10,"(6.171601,-75.427454)"
2021,Enero,Nueva Zelanda,554,0,1,,1,"(10.445761,-75.516429)"
2021,Enero,Nueva Zelanda,554,0,1,,1,"(10.886611,-74.776708)"
2021,Enero,Nueva Zelanda,554,1,0,,1,"(4.452882,-75.766298)"
2021,Enero,Nueva Zelanda,554,3,0,,3,"(4.697144,-74.140516)"
2021,Enero,Omán,512,0,1,,1,"(10.445761,-75.516429)"
2021,Enero,Omán,512,0,1,,1,"(3.541112,-76.384584)"
2021,Enero,Omán,512,1,5,,6,"(4.697144,-74.140516)"
2021,Enero,Omán,512,0,1,,1,"(6.171601,-75.427454)"
2021,Enero,Pakistán,586,2,1,,3,"(4.697144,-74.140516)"
2021,Enero,Panamá,591,7,20,,27,"(10.408582,-75.538003)"
2021,Enero,Panamá,591,909,550,,1459,"(10.445761,-75.516429)"
2021,Enero,Panamá,591,431,266,,697,"(10.886611,-74.776708)"
2021,Enero,Panamá,591,0,4,,4,"(10.971302,-74.765397)"
2021,Enero,Panamá,591,0,1,,1,"(11.360009,-72.129330)"
2021,Enero,Panamá,591,3,17,,20,"(12.5744111,-81.703935)"
2021,Enero,Panamá,591,1190,930,,2120,"(3.541112,-76.384584)"
2021,Enero,Panamá,591,1926,2213,,4139,"(4.697144,-74.140516)"
2021,Enero,Panamá,591,216,141,,357,"(4.815061,-75.736532)"
2021,Enero,Panamá,591,992,848,,1840,"(6.171601,-75.427454)"
2021,Enero,Panamá,591,0,6,,6,"(7.102626,-77.762647)"
2021,Enero,Panamá,591,55,40,,95,"(7.128456,-73.183637)"
2021,Enero,Paraguay,600,0,3,,3,"(10.445761,-75.516429)"
2021,Enero,Paraguay,600,8,18,,26,"(3.541112,-76.384584)"
2021,Enero,Paraguay,600,109,233,,342,"(4.697144,-74.140516)"
2021,Enero,Paraguay,600,1,3,,4,"(4.815061,-75.736532)"
2021,Enero,Paraguay,600,10,16,,26,"(6.171601,-75.427454)"
2021,Enero,Perú,604,4,2,,6,"(-4.197703,-69.941278)"
2021,Enero,Perú,604,1,0,,1,"(0.814836,-77.662532)"
2021,Enero,Perú,604,45,29,,74,"(10.445761,-75.516429)"
2021,Enero,Perú,604,12,8,,20,"(10.886611,-74.776708)"
2021,Enero,Perú,604,143,141,,284,"(3.541112,-76.384584)"
2021,Enero,Perú,604,1158,1385,,2543,"(4.697144,-74.140516)"
2021,Enero,Perú,604,2,6,,8,"(4.815061,-75.736532)"
2021,Enero,Perú,604,234,223,,457,"(6.171601,-75.427454)"
2021,Enero,Perú,604,5,4,,9,"(7.128456,-73.183637)"
2021,Enero,Polonia,616,0,2,,2,"(10.445761,-75.516429)"
2021,Enero,Polonia,616,0,1,,1,"(3.541112,-76.384584)"
2021,Enero,Polonia,616,9,29,,38,"(4.697144,-74.140516)"
2021,Enero,Polonia,616,0,1,,1,"(6.171601,-75.427454)"
2021,Enero,Portugal,620,2,0,,2,"(10.886611,-74.776708)"
2021,Enero,Portugal,620,1,0,,1,"(3.541112,-76.384584)"
2021,Enero,Portugal,620,47,69,,116,"(4.697144,-74.140516)"
2021,Enero,Portugal,620,10,7,,17,"(6.171601,-75.427454)"
2021,Enero,Polinesia Francesa/Colectividad de Ultramar Francesa,258,2,1,,3,"(4.697144,-74.140516)"
2021,Enero,Puerto Rico/Territorio de Estados Unidos,630,6,4,,10,"(10.445761,-75.516429)"
2021,Enero,Puerto Rico/Territorio de Estados Unidos,630,13,12,,25,"(10.886611,-74.776708)"
2021,Enero,Puerto Rico/Territorio de Estados Unidos,630,41,17,,58,"(3.541112,-76.384584)"
2021,Enero,Puerto Rico/Territorio de Estados Unidos,630,170,169,,340,"(4.697144,-74.140516)"
2021,Enero,Puerto Rico/Territorio de Estados Unidos,630,2,2,,4,"(4.815061,-75.736532)"
2021,Enero,Puerto Rico/Territorio de Estados Unidos,630,43,20,,63,"(6.171601,-75.427454)"
2021,Enero,Puerto Rico/Territorio de Estados Unidos,630,5,4,,9,"(7.128456,-73.183637)"
2021,Enero,Qatar,634,6,8,,14,"(4.697144,-74.140516)"
2021,Enero,Reino Unido de Gran Bretaña e Irlanda del Norte,826,10,4,,14,"(10.445761,-75.516429)"
2021,Enero,Reino Unido de Gran Bretaña e Irlanda del Norte,826,27,17,,44,"(3.541112,-76.384584)"
2021,Enero,Reino Unido de Gran Bretaña e Irlanda del Norte,826,250,218,,468,"(4.697144,-74.140516)"
2021,Enero,Reino Unido de Gran Bretaña e Irlanda del Norte,826,1,0,,1,"(4.815061,-75.736532)"
2021,Enero,Reino Unido de Gran Bretaña e Irlanda del Norte,826,21,25,,46,"(6.171601,-75.427454)"
2021,Enero,República CentroÁfricana,140,0,1,,1,"(4.697144,-74.140516)"
2021,Enero,Federación de Rusia,643,8,12,,20,"(4.697144,-74.140516)"
2021,Enero,República Dominicana,214,15,22,,37,"(10.445761,-75.516429)"
2021,Enero,República Dominicana,214,29,30,,59,"(10.886611,-74.776708)"
2021,Enero,República Dominicana,214,5,8,,13,"(11.117806,-74.232622)"
2021,Enero,República Dominicana,214,97,86,,183,"(3.541112,-76.384584)"
2021,Enero,República Dominicana,214,2640,2367,,5007,"(4.697144,-74.140516)"
2021,Enero,República Dominicana,214,12,14,,26,"(4.815061,-75.736532)"
2021,Enero,República Dominicana,214,297,226,,523,"(6.171601,-75.427454)"
2021,Enero,República Dominicana,214,4,3,,7,"(7.128456,-73.183637)"
2021,Enero,Rumania,642,6,4,,10,"(4.697144,-74.140516)"
2021,Enero,Rwanda,646,0,2,,2,"(4.697144,-74.140516)"
2021,Enero,San  Vicente y las Granadinas,670,0,1,,1,"(4.697144,-74.140516)"
2021,Enero,Santa Elena/Territorio Británico de Ultramar,654,1,0,,1,"(0.814836,-77.662532)"
2021,Enero,Santo Tomé y Príncipe,678,0,1,,1,"(4.697144,-74.140516)"
2021,Enero,Senegal,686,0,2,,2,"(4.697144,-74.140516)"
2021,Enero,Senegal,686,2,1,,3,"(6.171601,-75.427454)"
2021,Enero,Serbia,688,1,1,,2,"(4.697144,-74.140516)"
2021,Enero,Sierra Leona,694,0,1,,1,"(4.697144,-74.140516)"
2021,Enero,Singapur,702,0,1,,1,"(10.445761,-75.516429)"
2021,Enero,Singapur,702,7,3,,10,"(4.697144,-74.140516)"
2021,Enero,República Árabe Siria,760,0,1,,1,"(4.697144,-74.140516)"
2021,Enero,Sudáfrica,710,5,3,,8,"(4.697144,-74.140516)"
2021,Enero,Sudán,736,1,0,,1,"(4.697144,-74.140516)"
2021,Enero,Suecia,752,2,2,,4,"(10.445761,-75.516429)"
2021,Enero,Suecia,752,2,1,,3,"(10.886611,-74.776708)"
2021,Enero,Suecia,752,4,10,,14,"(3.541112,-76.384584)"
2021,Enero,Suecia,752,53,43,,96,"(4.697144,-74.140516)"
2021,Enero,Suecia,752,7,9,,16,"(6.171601,-75.427454)"
2021,Enero,Suiza,756,8,5,,13,"(10.445761,-75.516429)"
2021,Enero,Suiza,756,4,2,,6,"(10.886611,-74.776708)"
2021,Enero,Suiza,756,19,6,,25,"(3.541112,-76.384584)"
2021,Enero,Suiza,756,209,149,,358,"(4.697144,-74.140516)"
2021,Enero,Suiza,756,1,0,,1,"(4.815061,-75.736532)"
2021,Enero,Suiza,756,47,30,,77,"(6.171601,-75.427454)"
2021,Enero,Surinam,740,1,0,,1,"(3.541112,-76.384584)"
2021,Enero,Surinam,740,2,2,,4,"(6.171601,-75.427454)"
2021,Enero,Taiwán,158,0,2,,2,"(4.697144,-74.140516)"
2021,Enero,República de Tayikistán,762,0,2,,2,"(4.697144,-74.140516)"
2021,Enero,Tailandia,764,1,2,,3,"(4.697144,-74.140516)"
2021,Enero,Tanzania,834,0,2,,2,"(4.697144,-74.140516)"
2021,Enero,Trinidad y Tobago,780,0,2,,2,"(10.445761,-75.516429)"
2021,Enero,Túnez,788,1,0,,1,"(4.697144,-74.140516)"
2021,Enero,Turquía,792,1,1,,2,"(10.445761,-75.516429)"
2021,Enero,Turquía,792,1,0,,1,"(3.541112,-76.384584)"
2021,Enero,Turquía,792,192,171,,363,"(4.697144,-74.140516)"
2021,Enero,Turquía,792,4,3,,7,"(6.171601,-75.427454)"
2021,Enero,Tuvalu,798,0,1,,1,"(4.697144,-74.140516)"
2021,Enero,Ucrania,804,1,0,,1,"(3.541112,-76.384584)"
2021,Enero,Ucrania,804,5,20,,25,"(4.697144,-74.140516)"
2021,Enero,Uganda,800,0,3,,3,"(10.445761,-75.516429)"
2021,Enero,Uganda,800,1,10,,11,"(4.697144,-74.140516)"
2021,Enero,Uruguay,858,2,1,,3,"(10.445761,-75.516429)"
2021,Enero,Uruguay,858,7,6,,13,"(3.541112,-76.384584)"
2021,Enero,Uruguay,858,35,57,,92,"(4.697144,-74.140516)"
2021,Enero,Uruguay,858,3,2,,5,"(4.815061,-75.736532)"
2021,Enero,Uruguay,858,1,2,,3,"(6.171601,-75.427454)"
2021,Enero,Uzbekistán,860,0,1,,1,"(10.886611,-74.776708)"
2021,Enero,Venezuela,862,1,1,,2,"(10.445761,-75.516429)"
2021,Enero,Venezuela,862,0,1,,1,"(10.886611,-74.776708)"
2021,Enero,Venezuela,862,2,137,,139,"(11.360009,-72.129330)"
2021,Enero,Venezuela,862,2,0,,2,"(3.541112,-76.384584)"
2021,Enero,Venezuela,862,32,89,,121,"(4.697144,-74.140516)"
2021,Enero,Venezuela,862,5,4,,9,"(6.171601,-75.427454)"
2021,Enero,Venezuela,862,1,0,,1,"(6.185799,-67.483929)"
2021,Enero,Venezuela,862,0,36,,36,"(7.818934,-72.453226)"
2021,Enero,Islas Vírgenes Estadounidenses/Territorio de Estados Unidos,850,0,1,,1,"(4.697144,-74.140516)"
2021,Enero,Islas Vírgenes Estadounidenses/Territorio de Estados Unidos,850,0,2,,2,"(6.171601,-75.427454)"
2021,Enero,Zambia,894,1,4,,5,"(4.697144,-74.140516)"
2021,Enero,Islas Turcas y Caicos/Territorio Británico de Ultramar,796,1,0,,1,"(4.697144,-74.140516)"
2021,Enero,Islas Turcas y Caicos/Territorio Británico de Ultramar,796,1,2,,3,"(6.171601,-75.427454)"
2021,Enero,Desconocido,99999,1,0,,1,"(4.697144,-74.140516)"
2021,Febrero,Afganistán,4,1,5,,6,"(4.697144,-74.140516)"
2021,Febrero,Alemania,276,3,2,,5,"(10.445761,-75.516429)"
2021,Febrero,Alemania,276,0,1,,1,"(10.886611,-74.776708)"
2021,Febrero,Alemania,276,6,3,,9,"(3.541112,-76.384584)"
2021,Febrero,Alemania,276,315,201,,516,"(4.697144,-74.140516)"
2021,Febrero,Alemania,276,21,19,,40,"(6.171601,-75.427454)"
2021,Febrero,Andorra,20,2,1,,3,"(4.697144,-74.140516)"
2021,Febrero,Angola,24,1,1,,2,"(4.697144,-74.140516)"
2021,Febrero,Antigua y Barbuda,28,1,2,,3,"(4.697144,-74.140516)"
2021,Febrero,Países Bajos,528,5,2,,7,"(10.445761,-75.516429)"
2021,Febrero,Países Bajos,528,10,5,,15,"(10.886611,-74.776708)"
2021,Febrero,Países Bajos,528,5,7,,12,"(3.541112,-76.384584)"
2021,Febrero,Países Bajos,528,105,128,,233,"(4.697144,-74.140516)"
2021,Febrero,Países Bajos,528,1,1,,2,"(4.815061,-75.736532)"
2021,Febrero,Países Bajos,528,15,5,,20,"(6.171601,-75.427454)"
2021,Febrero,Arabia Saudita,682,5,25,,30,"(4.697144,-74.140516)"
2021,Febrero,Argelia,12,1,1,,2,"(4.697144,-74.140516)"
2021,Febrero,Argentina,32,19,7,,26,"(10.445761,-75.516429)"
2021,Febrero,Argentina,32,6,5,,11,"(10.886611,-74.776708)"
2021,Febrero,Argentina,32,52,35,,87,"(3.541112,-76.384584)"
2021,Febrero,Argentina,32,1216,935,,2151,"(4.697144,-74.140516)"
2021,Febrero,Argentina,32,17,12,,29,"(4.815061,-75.736532)"
2021,Febrero,Argentina,32,45,24,,69,"(6.171601,-75.427454)"
2021,Febrero,Argentina,32,1,1,,2,"(7.128456,-73.183637)"
2021,Febrero,República de Armenia,51,1,0,,1,"(4.697144,-74.140516)"
2021,Febrero,Aruba,533,0,3,,3,"(10.408582,-75.538003)"
2021,Febrero,Aruba,533,3,5,,8,"(10.886611,-74.776708)"
2021,Febrero,Aruba,533,0,2,,2,"(11.247723,-74.213989)"
2021,Febrero,Aruba,533,13,17,,30,"(3.541112,-76.384584)"
2021,Febrero,Aruba,533,577,509,,1086,"(4.697144,-74.140516)"
2021,Febrero,Aruba,533,12,11,,23,"(6.171601,-75.427454)"
2021,Febrero,Aruba,533,5,16,,21,"(7.128456,-73.183637)"
2021,Febrero,Australia,36,17,5,,22,"(4.697144,-74.140516)"
2021,Febrero,Australia,36,1,0,,1,"(6.171601,-75.427454)"
2021,Febrero,Austria,40,2,0,,2,"(10.445761,-75.516429)"
2021,Febrero,Austria,40,2,0,,2,"(3.541112,-76.384584)"
2021,Febrero,Austria,40,35,26,,61,"(4.697144,-74.140516)"
2021,Febrero,Austria,40,1,0,,1,"(6.171601,-75.427454)"
2021,Febrero,Bahamas,44,3,5,,8,"(3.541112,-76.384584)"
2021,Febrero,Bahamas,44,6,9,,15,"(4.697144,-74.140516)"
2021,Febrero,Bahamas,44,1,0,,1,"(6.171601,-75.427454)"
2021,Febrero,Bahréin,48,5,1,,6,"(4.697144,-74.140516)"
2021,Febrero,Bangladesh,50,0,3,,3,"(4.697144,-74.140516)"
2021,Febrero,Barbados,52,0,1,,1,"(3.541112,-76.384584)"
2021,Febrero,Barbados,52,3,4,,7,"(4.697144,-74.140516)"
2021,Febrero,Barbados,52,1,0,,1,"(6.171601,-75.427454)"
2021,Febrero,Bélgica,56,1,1,,2,"(3.541112,-76.384584)"
2021,Febrero,Bélgica,56,40,24,,64,"(4.697144,-74.140516)"
2021,Febrero,Bélgica,56,4,7,,11,"(6.171601,-75.427454)"
2021,Febrero,Belice,84,1,0,,1,"(3.541112,-76.384584)"
2021,Febrero,Belice,84,0,5,,5,"(4.697144,-74.140516)"
2021,Febrero,Bermudas/Territorio Británico de Ultramar,60,1,0,,1,"(3.541112,-76.384584)"
2021,Febrero,Bolivia,68,3,1,,4,"(10.445761,-75.516429)"
2021,Febrero,Bolivia,68,1,0,,1,"(10.886611,-74.776708)"
2021,Febrero,Bolivia,68,12,11,,23,"(3.541112,-76.384584)"
2021,Febrero,Bolivia,68,237,499,,736,"(4.697144,-74.140516)"
2021,Febrero,Bolivia,68,7,13,,20,"(4.815061,-75.736532)"
2021,Febrero,Bolivia,68,7,17,,24,"(6.171601,-75.427454)"
2021,Febrero,Botsuana,72,1,0,,1,"(4.697144,-74.140516)"
2021,Febrero,Brasil,76,2,0,,2,"(-4.197703,-69.941278)"
2021,Febrero,Brasil,76,4,6,,10,"(10.445761,-75.516429)"
2021,Febrero,Brasil,76,4,7,,11,"(10.886611,-74.776708)"
2021,Febrero,Brasil,76,33,73,,106,"(3.541112,-76.384584)"
2021,Febrero,Brasil,76,208,290,,498,"(4.697144,-74.140516)"
2021,Febrero,Brasil,76,32,66,,98,"(4.815061,-75.736532)"
2021,Febrero,Brasil,76,49,71,,120,"(6.171601,-75.427454)"
2021,Febrero,Brasil,76,1,2,,3,"(7.128456,-73.183637)"
2021,Febrero,Bulgaria,100,0,1,,1,"(4.697144,-74.140516)"
2021,Febrero,Burkina Faso,854,0,1,,1,"(4.697144,-74.140516)"
2021,Febrero,Camboya,116,1,0,,1,"(4.697144,-74.140516)"
2021,Febrero,Camerún,120,0,1,,1,"(4.697144,-74.140516)"
2021,Febrero,Camerún,120,1,3,,4,"(6.171601,-75.427454)"
2021,Febrero,Canadá,124,3,6,,9,"(10.445761,-75.516429)"
2021,Febrero,Canadá,124,10,5,,15,"(10.886611,-74.776708)"
2021,Febrero,Canadá,124,67,66,,133,"(3.541112,-76.384584)"
2021,Febrero,Canadá,124,833,785,,1618,"(4.697144,-74.140516)"
2021,Febrero,Canadá,124,2,9,,11,"(4.815061,-75.736532)"
2021,Febrero,Canadá,124,124,89,,213,"(6.171601,-75.427454)"
2021,Febrero,Canadá,124,1,0,,1,"(7.128456,-73.183637)"
2021,Febrero,España,724,2,5,,7,"(10.445761,-75.516429)"
2021,Febrero,España,724,1,33,,34,"(10.886611,-74.776708)"
2021,Febrero,España,724,23,12,,35,"(3.541112,-76.384584)"
2021,Febrero,España,724,2721,1951,,4672,"(4.697144,-74.140516)"
2021,Febrero,España,724,4,4,,8,"(4.815061,-75.736532)"
2021,Febrero,España,724,207,154,,361,"(6.171601,-75.427454)"
2021,Febrero,Colombia,170,16,39,,55,"(4.697144,-74.140516)"
2021,Febrero,República Del Congo,178,1,0,,1,"(4.697144,-74.140516)"
2021,Febrero,República de Corea,410,0,1,,1,"(3.541112,-76.384584)"
2021,Febrero,República de Corea,410,12,6,,18,"(4.697144,-74.140516)"
2021,Febrero,República de Corea,410,0,1,,1,"(6.171601,-75.427454)"
2021,Febrero,República de Corea,410,0,3,,3,"(7.128456,-73.183637)"
2021,Febrero,Costa de Marfil,384,0,2,,2,"(4.697144,-74.140516)"
2021,Febrero,Costa Rica,188,5,2,,7,"(10.445761,-75.516429)"
2021,Febrero,Costa Rica,188,10,5,,15,"(10.886611,-74.776708)"
2021,Febrero,Costa Rica,188,5,47,,52,"(12.5744111,-81.703935)"
2021,Febrero,Costa Rica,188,45,51,,96,"(3.541112,-76.384584)"
2021,Febrero,Costa Rica,188,385,441,,826,"(4.697144,-74.140516)"
2021,Febrero,Costa Rica,188,15,6,,21,"(4.815061,-75.736532)"
2021,Febrero,Costa Rica,188,80,67,,147,"(6.171601,-75.427454)"
2021,Febrero,Costa Rica,188,2,0,,2,"(7.128456,-73.183637)"
2021,Febrero,Croacia,191,0,5,,5,"(4.697144,-74.140516)"
2021,Febrero,Cuba,192,2,4,,6,"(3.541112,-76.384584)"
2021,Febrero,Cuba,192,72,82,,154,"(4.697144,-74.140516)"
2021,Febrero,Cuba,192,1,1,,2,"(6.171601,-75.427454)"
2021,Febrero,Curazao,99999,0,1,,1,"(10.408582,-75.538003)"
2021,Febrero,Curazao,99999,33,29,,62,"(10.886611,-74.776708)"
2021,Febrero,Curazao,99999,5,0,,5,"(3.541112,-76.384584)"
2021,Febrero,Curazao,99999,59,63,,122,"(4.697144,-74.140516)"
2021,Febrero,Curazao,99999,0,1,,1,"(6.171601,-75.427454)"
2021,Febrero,República Checa,203,1,0,,1,"(10.445761,-75.516429)"
2021,Febrero,República Checa,203,7,7,,14,"(4.697144,-74.140516)"
2021,Febrero,Chile,152,18,12,,30,"(10.445761,-75.516429)"
2021,Febrero,Chile,152,55,25,,80,"(10.886611,-74.776708)"
2021,Febrero,Chile,152,1092,764,,1856,"(3.541112,-76.384584)"
2021,Febrero,Chile,152,4097,3049,,7146,"(4.697144,-74.140516)"
2021,Febrero,Chile,152,171,142,,313,"(4.815061,-75.736532)"
2021,Febrero,Chile,152,92,82,,174,"(6.171601,-75.427454)"
2021,Febrero,Chile,152,6,3,,9,"(7.128456,-73.183637)"
2021,Febrero,China,156,6,5,,11,"(4.697144,-74.140516)"
2021,Febrero,China,156,0,1,,1,"(6.171601,-75.427454)"
2021,Febrero,Chipre,196,0,1,,1,"(4.697144,-74.140516)"
2021,Febrero,Dinamarca,208,13,3,,16,"(4.697144,-74.140516)"
2021,Febrero,Dinamarca,208,2,0,,2,"(6.171601,-75.427454)"
2021,Febrero,Dominica,212,2,5,,7,"(4.697144,-74.140516)"
2021,Febrero,Dominica,212,0,1,,1,"(6.171601,-75.427454)"
2021,Febrero,Ecuador,218,19,24,,43,"(0.814836,-77.662532)"
2021,Febrero,Ecuador,218,0,3,,3,"(10.445761,-75.516429)"
2021,Febrero,Ecuador,218,2,0,,2,"(10.886611,-74.776708)"
2021,Febrero,Ecuador,218,23,31,,54,"(3.541112,-76.384584)"
2021,Febrero,Ecuador,218,939,1509,,2448,"(4.697144,-74.140516)"
2021,Febrero,Ecuador,218,3,6,,9,"(4.815061,-75.736532)"
2021,Febrero,Ecuador,218,39,61,,100,"(6.171601,-75.427454)"
2021,Febrero,Ecuador,218,1,5,,6,"(7.128456,-73.183637)"
2021,Febrero,Egipto,818,0,1,,1,"(10.445761,-75.516429)"
2021,Febrero,Egipto,818,16,14,,30,"(4.697144,-74.140516)"
2021,Febrero,Egipto,818,1,0,,1,"(6.171601,-75.427454)"
2021,Febrero,El Salvador,222,2,11,,13,"(3.541112,-76.384584)"
2021,Febrero,El Salvador,222,105,153,,258,"(4.697144,-74.140516)"
2021,Febrero,El Salvador,222,12,13,,25,"(6.171601,-75.427454)"
2021,Febrero,Emiratos Árabes,784,2,1,,3,"(10.445761,-75.516429)"
2021,Febrero,Emiratos Árabes,784,4,0,,4,"(3.541112,-76.384584)"
2021,Febrero,Emiratos Árabes,784,99,316,,415,"(4.697144,-74.140516)"
2021,Febrero,Emiratos Árabes,784,14,1,,15,"(6.171601,-75.427454)"
2021,Febrero,Eslovaquia,703,1,2,,3,"(4.697144,-74.140516)"
2021,Febrero,Eslovenia,705,1,1,,2,"(4.697144,-74.140516)"
2021,Febrero,Estados Unidos de América,840,970,827,,1797,"(10.445761,-75.516429)"
2021,Febrero,Estados Unidos de América,840,1573,1290,,2863,"(10.886611,-74.776708)"
2021,Febrero,Estados Unidos de América,840,3,5,,8,"(11.117806,-74.232622)"
2021,Febrero,Estados Unidos de América,840,6,5,,11,"(12.586067,-81.702563)"
2021,Febrero,Estados Unidos de América,840,2933,2223,,5156,"(3.541112,-76.384584)"
2021,Febrero,Estados Unidos de América,840,504,420,,924,"(4.452882,-75.766298)"
2021,Febrero,Estados Unidos de América,840,12021,11162,,23184,"(4.697144,-74.140516)"
2021,Febrero,Estados Unidos de América,840,705,518,,1223,"(4.815061,-75.736532)"
2021,Febrero,Estados Unidos de América,840,5520,4500,,10020,"(6.171601,-75.427454)"
2021,Febrero,Estados Unidos de América,840,330,281,,611,"(7.128456,-73.183637)"
2021,Febrero,Estonia,233,1,0,,1,"(4.697144,-74.140516)"
2021,Febrero,Estonia,233,1,0,,1,"(6.171601,-75.427454)"
2021,Febrero,Etiopia,231,1,3,,4,"(4.697144,-74.140516)"
2021,Febrero,Filipinas,608,1,0,,1,"(4.697144,-74.140516)"
2021,Febrero,Filipinas,608,0,1,,1,"(6.171601,-75.427454)"
2021,Febrero,Finlandia,246,9,2,,11,"(4.697144,-74.140516)"
2021,Febrero,Finlandia,246,1,0,,1,"(6.171601,-75.427454)"
2021,Febrero,Francia,250,1,0,,1,"(10.886611,-74.776708)"
2021,Febrero,Francia,250,10,9,,19,"(3.541112,-76.384584)"
2021,Febrero,Francia,250,349,249,,598,"(4.697144,-74.140516)"
2021,Febrero,Francia,250,1,2,,3,"(4.815061,-75.736532)"
2021,Febrero,Francia,250,16,12,,28,"(6.171601,-75.427454)"
2021,Febrero,Gabón,266,0,1,,1,"(4.697144,-74.140516)"
2021,Febrero,Georgia,268,6,0,,6,"(4.697144,-74.140516)"
2021,Febrero,Ghana,288,1,5,,6,"(4.697144,-74.140516)"
2021,Febrero,Granada,308,1,27,,28,"(3.541112,-76.384584)"
2021,Febrero,Grecia,300,0,1,,1,"(3.541112,-76.384584)"
2021,Febrero,Grecia,300,1,0,,1,"(4.697144,-74.140516)"
2021,Febrero,Guatemala,320,2,3,,5,"(10.445761,-75.516429)"
2021,Febrero,Guatemala,320,7,8,,15,"(10.886611,-74.776708)"
2021,Febrero,Guatemala,320,0,4,,4,"(12.586067,-81.702563)"
2021,Febrero,Guatemala,320,18,45,,63,"(3.541112,-76.384584)"
2021,Febrero,Guatemala,320,187,279,,466,"(4.697144,-74.140516)"
2021,Febrero,Guatemala,320,12,16,,28,"(4.815061,-75.736532)"
2021,Febrero,Guatemala,320,55,61,,116,"(6.171601,-75.427454)"
2021,Febrero,Guatemala,320,1,0,,1,"(7.128456,-73.183637)"
2021,Febrero,Guyana,328,1,0,,1,"(10.886611,-74.776708)"
2021,Febrero,Guyana,328,2,0,,2,"(3.541112,-76.384584)"
2021,Febrero,Guyana,328,0,7,,7,"(4.697144,-74.140516)"
2021,Febrero,Guyana,328,2,4,,6,"(6.171601,-75.427454)"
2021,Febrero,Guinea,324,0,2,,2,"(4.697144,-74.140516)"
2021,Febrero,Guinea Ecuatorial,226,0,3,,3,"(4.697144,-74.140516)"
2021,Febrero,Haití,332,0,1,,1,"(10.886611,-74.776708)"
2021,Febrero,Haití,332,2,6,,8,"(4.697144,-74.140516)"
2021,Febrero,Haití,332,3,1,,4,"(6.171601,-75.427454)"
2021,Febrero,Honduras,340,0,1,,1,"(10.445761,-75.516429)"
2021,Febrero,Honduras,340,0,11,,11,"(10.886611,-74.776708)"
2021,Febrero,Honduras,340,3,23,,26,"(3.541112,-76.384584)"
2021,Febrero,Honduras,340,39,85,,124,"(4.697144,-74.140516)"
2021,Febrero,Honduras,340,14,28,,42,"(6.171601,-75.427454)"
2021,Febrero,Honduras,340,0,2,,2,"(7.128456,-73.183637)"
2021,Febrero,Hong Kong,344,2,1,,3,"(4.697144,-74.140516)"
2021,Febrero,Hungría,348,3,5,,8,"(4.697144,-74.140516)"
2021,Febrero,Hungría,348,1,0,,1,"(6.171601,-75.427454)"
2021,Febrero,India,356,5,4,,9,"(4.697144,-74.140516)"
2021,Febrero,India,356,2,2,,4,"(6.171601,-75.427454)"
2021,Febrero,Indonesia,360,5,4,,9,"(4.697144,-74.140516)"
2021,Febrero,Iraq,368,0,2,,2,"(4.697144,-74.140516)"
2021,Febrero,República de Irlanda,372,8,2,,10,"(4.697144,-74.140516)"
2021,Febrero,República de Irlanda,372,1,0,,1,"(6.171601,-75.427454)"
2021,Febrero,Islandia,352,0,1,,1,"(3.541112,-76.384584)"
2021,Febrero,Islandia,352,1,0,,1,"(4.697144,-74.140516)"
2021,Febrero,Israel,376,4,4,,8,"(4.697144,-74.140516)"
2021,Febrero,Italia,380,12,3,,15,"(10.445761,-75.516429)"
2021,Febrero,Italia,380,18,4,,22,"(3.541112,-76.384584)"
2021,Febrero,Italia,380,267,180,,447,"(4.697144,-74.140516)"
2021,Febrero,Italia,380,0,1,,1,"(4.815061,-75.736532)"
2021,Febrero,Italia,380,30,11,,41,"(6.171601,-75.427454)"
2021,Febrero,Jamaica,388,0,3,,3,"(10.445761,-75.516429)"
2021,Febrero,Jamaica,388,2,3,,5,"(10.886611,-74.776708)"
2021,Febrero,Jamaica,388,8,13,,21,"(3.541112,-76.384584)"
2021,Febrero,Jamaica,388,11,18,,29,"(4.697144,-74.140516)"
2021,Febrero,Jamaica,388,1,0,,1,"(4.815061,-75.736532)"
2021,Febrero,Jamaica,388,8,4,,12,"(6.171601,-75.427454)"
2021,Febrero,Japón,392,0,1,,1,"(3.541112,-76.384584)"
2021,Febrero,Japón,392,4,1,,5,"(4.697144,-74.140516)"
2021,Febrero,Japón,392,1,0,,1,"(6.171601,-75.427454)"
2021,Febrero,Jordania,400,1,2,,3,"(4.697144,-74.140516)"
2021,Febrero,Jordania,400,1,0,,1,"(7.128456,-73.183637)"
2021,Febrero,Kazajistán,398,0,3,,3,"(4.697144,-74.140516)"
2021,Febrero,Kenia,404,0,1,,1,"(4.697144,-74.140516)"
2021,Febrero,Kenia,404,0,1,,1,"(6.171601,-75.427454)"
2021,Febrero,Kuwait,414,0,2,,2,"(4.697144,-74.140516)"
2021,Febrero,República de Kosovo,901,0,3,,3,"(4.697144,-74.140516)"
2021,Febrero,Lituania,440,1,4,,5,"(4.697144,-74.140516)"
2021,Febrero,Líbano,422,1,0,,1,"(3.541112,-76.384584)"
2021,Febrero,Líbano,422,6,8,,14,"(4.697144,-74.140516)"
2021,Febrero,Liechtenstein,438,0,1,,1,"(4.697144,-74.140516)"
2021,Febrero,Luxemburgo,442,6,3,,9,"(4.697144,-74.140516)"
2021,Febrero,Madagascar,450,0,1,,1,"(4.697144,-74.140516)"
2021,Febrero,Malasia,458,2,2,,4,"(4.697144,-74.140516)"
2021,Febrero,Malawi,454,0,1,,1,"(4.697144,-74.140516)"
2021,Febrero,Maldivas,462,1,0,,1,"(4.697144,-74.140516)"
2021,Febrero,Maldivas,462,1,0,,1,"(6.171601,-75.427454)"
2021,Febrero,Malí,466,1,3,,4,"(4.697144,-74.140516)"
2021,Febrero,Malta,470,31,26,,57,"(4.697144,-74.140516)"
2021,Febrero,Marruecos,504,4,0,,4,"(4.697144,-74.140516)"
2021,Febrero,Marruecos,504,1,0,,1,"(6.171601,-75.427454)"
2021,Febrero,Mauritania,478,1,2,,3,"(4.697144,-74.140516)"
2021,Febrero,México,484,44,29,,73,"(10.445761,-75.516429)"
2021,Febrero,México,484,46,30,,76,"(10.886611,-74.776708)"
2021,Febrero,México,484,456,456,,912,"(3.541112,-76.384584)"
2021,Febrero,México,484,4672,4423,,9095,"(4.697144,-74.140516)"
2021,Febrero,México,484,45,38,,83,"(4.815061,-75.736532)"
2021,Febrero,México,484,1796,1352,,3148,"(6.171601,-75.427454)"
2021,Febrero,México,484,21,14,,35,"(7.128456,-73.183637)"
2021,Febrero,Mozambique,508,2,2,,4,"(4.697144,-74.140516)"
2021,Febrero,Nepal,524,1,0,,1,"(4.697144,-74.140516)"
2021,Febrero,Nicaragua,558,0,1,,1,"(12.5744111,-81.703935)"
2021,Febrero,Nicaragua,558,1,0,,1,"(3.541112,-76.384584)"
2021,Febrero,Nicaragua,558,17,83,,100,"(4.697144,-74.140516)"
2021,Febrero,Nicaragua,558,2,6,,8,"(6.171601,-75.427454)"
2021,Febrero,Nigeria,566,1,2,,3,"(4.697144,-74.140516)"
2021,Febrero,Nigeria,566,0,1,,1,"(6.171601,-75.427454)"
2021,Febrero,Noruega,578,0,1,,1,"(10.445761,-75.516429)"
2021,Febrero,Noruega,578,6,3,,9,"(4.697144,-74.140516)"
2021,Febrero,Noruega,578,1,1,,2,"(6.171601,-75.427454)"
2021,Febrero,Nueva Zelanda,554,4,0,,4,"(4.697144,-74.140516)"
2021,Febrero,Nueva Zelanda,554,3,0,,3,"(6.171601,-75.427454)"
2021,Febrero,Omán,512,6,4,,10,"(4.697144,-74.140516)"
2021,Febrero,Omán,512,0,1,,1,"(4.815061,-75.736532)"
2021,Febrero,Omán,512,1,0,,1,"(6.171601,-75.427454)"
2021,Febrero,Pakistán,586,1,0,,1,"(4.697144,-74.140516)"
2021,Febrero,Panamá,591,6,29,,35,"(10.408582,-75.538003)"
2021,Febrero,Panamá,591,669,459,,1128,"(10.445761,-75.516429)"
2021,Febrero,Panamá,591,205,166,,371,"(10.886611,-74.776708)"
2021,Febrero,Panamá,591,0,4,,4,"(11.360009,-72.129330)"
2021,Febrero,Panamá,591,3,16,,19,"(12.5744111,-81.703935)"
2021,Febrero,Panamá,591,1103,903,,2006,"(3.541112,-76.384584)"
2021,Febrero,Panamá,591,1536,1818,,3354,"(4.697144,-74.140516)"
2021,Febrero,Panamá,591,163,78,,241,"(4.815061,-75.736532)"
2021,Febrero,Panamá,591,0,2,,2,"(6.17134,-75.427194)"
2021,Febrero,Panamá,591,848,727,,1575,"(6.171601,-75.427454)"
2021,Febrero,Panamá,591,1,7,,8,"(6.228046,-77.404104)"
2021,Febrero,Panamá,591,0,6,,6,"(7.102626,-77.762647)"
2021,Febrero,Panamá,591,25,25,,50,"(7.128456,-73.183637)"
2021,Febrero,Paraguay,600,0,2,,2,"(10.445761,-75.516429)"
2021,Febrero,Paraguay,600,4,16,,20,"(3.541112,-76.384584)"
2021,Febrero,Paraguay,600,89,145,,234,"(4.697144,-74.140516)"
2021,Febrero,Paraguay,600,1,2,,3,"(4.815061,-75.736532)"
2021,Febrero,Paraguay,600,11,16,,27,"(6.171601,-75.427454)"
2021,Febrero,Perú,604,0,3,,3,"(-4.197703,-69.941278)"
2021,Febrero,Perú,604,3,3,,6,"(10.445761,-75.516429)"
2021,Febrero,Perú,604,17,13,,30,"(3.541112,-76.384584)"
2021,Febrero,Perú,604,567,736,,1303,"(4.697144,-74.140516)"
2021,Febrero,Perú,604,2,7,,9,"(4.815061,-75.736532)"
2021,Febrero,Perú,604,114,111,,225,"(6.171601,-75.427454)"
2021,Febrero,Perú,604,2,2,,4,"(7.128456,-73.183637)"
2021,Febrero,Polonia,616,6,11,,17,"(4.697144,-74.140516)"
2021,Febrero,Portugal,620,0,2,,2,"(3.541112,-76.384584)"
2021,Febrero,Portugal,620,29,44,,73,"(4.697144,-74.140516)"
2021,Febrero,Portugal,620,5,0,,5,"(6.171601,-75.427454)"
2021,Febrero,Puerto Rico/Territorio de Estados Unidos,630,0,5,,5,"(10.408582,-75.538003)"
2021,Febrero,Puerto Rico/Territorio de Estados Unidos,630,1,1,,2,"(10.445761,-75.516429)"
2021,Febrero,Puerto Rico/Territorio de Estados Unidos,630,0,1,,1,"(10.886611,-74.776708)"
2021,Febrero,Puerto Rico/Territorio de Estados Unidos,630,10,2,,12,"(3.541112,-76.384584)"
2021,Febrero,Puerto Rico/Territorio de Estados Unidos,630,66,46,,112,"(4.697144,-74.140516)"
2021,Febrero,Puerto Rico/Territorio de Estados Unidos,630,1,0,,1,"(4.815061,-75.736532)"
2021,Febrero,Puerto Rico/Territorio de Estados Unidos,630,17,14,,31,"(6.171601,-75.427454)"
2021,Febrero,Puerto Rico/Territorio de Estados Unidos,630,1,0,,1,"(7.128456,-73.183637)"
2021,Febrero,Qatar,634,4,10,,14,"(4.697144,-74.140516)"
2021,Febrero,Reino Unido de Gran Bretaña e Irlanda del Norte,826,5,3,,8,"(3.541112,-76.384584)"
2021,Febrero,Reino Unido de Gran Bretaña e Irlanda del Norte,826,146,118,,264,"(4.697144,-74.140516)"
2021,Febrero,Reino Unido de Gran Bretaña e Irlanda del Norte,826,0,1,,1,"(4.815061,-75.736532)"
2021,Febrero,Reino Unido de Gran Bretaña e Irlanda del Norte,826,17,12,,29,"(6.171601,-75.427454)"
2021,Febrero,República CentroÁfricana,140,2,1,,3,"(4.697144,-74.140516)"
2021,Febrero,Federación de Rusia,643,5,12,,17,"(4.697144,-74.140516)"
2021,Febrero,República Dominicana,214,5,9,,14,"(10.445761,-75.516429)"
2021,Febrero,República Dominicana,214,12,12,,24,"(10.886611,-74.776708)"
2021,Febrero,República Dominicana,214,5,7,,12,"(11.117806,-74.232622)"
2021,Febrero,República Dominicana,214,75,52,,127,"(3.541112,-76.384584)"
2021,Febrero,República Dominicana,214,1636,1562,,3198,"(4.697144,-74.140516)"
2021,Febrero,República Dominicana,214,3,7,,10,"(4.815061,-75.736532)"
2021,Febrero,República Dominicana,214,5,3,,8,"(6.17134,-75.427194)"
2021,Febrero,República Dominicana,214,224,176,,400,"(6.171601,-75.427454)"
2021,Febrero,República Dominicana,214,0,1,,1,"(7.128456,-73.183637)"
2021,Febrero,Reunión,638,0,1,,1,"(4.697144,-74.140516)"
2021,Febrero,Rumania,642,3,4,,7,"(4.697144,-74.140516)"
2021,Febrero,Senegal,686,0,1,,1,"(4.697144,-74.140516)"
2021,Febrero,Senegal,686,2,1,,3,"(6.171601,-75.427454)"
2021,Febrero,Serbia,688,2,4,,6,"(4.697144,-74.140516)"
2021,Febrero,Sierra Leona,694,1,1,,2,"(4.697144,-74.140516)"
2021,Febrero,Singapur,702,3,3,,6,"(4.697144,-74.140516)"
2021,Febrero,Somalia,706,0,1,,1,"(4.697144,-74.140516)"
2021,Febrero,Sudáfrica,710,3,4,,7,"(4.697144,-74.140516)"
2021,Febrero,Sudáfrica,710,1,0,,1,"(6.171601,-75.427454)"
2021,Febrero,Sudán,736,1,1,,2,"(4.697144,-74.140516)"
2021,Febrero,Suecia,752,3,5,,8,"(3.541112,-76.384584)"
2021,Febrero,Suecia,752,37,32,,69,"(4.697144,-74.140516)"
2021,Febrero,Suecia,752,3,0,,3,"(4.815061,-75.736532)"
2021,Febrero,Suecia,752,5,0,,5,"(6.171601,-75.427454)"
2021,Febrero,Suiza,756,1,0,,1,"(10.445761,-75.516429)"
2021,Febrero,Suiza,756,1,0,,1,"(10.886611,-74.776708)"
2021,Febrero,Suiza,756,7,3,,10,"(3.541112,-76.384584)"
2021,Febrero,Suiza,756,150,87,,237,"(4.697144,-74.140516)"
2021,Febrero,Suiza,756,1,0,,1,"(4.815061,-75.736532)"
2021,Febrero,Suiza,756,14,5,,19,"(6.171601,-75.427454)"
2021,Febrero,Surinam,740,0,1,,1,"(10.408582,-75.538003)"
2021,Febrero,Surinam,740,1,2,,3,"(4.697144,-74.140516)"
2021,Febrero,Tailandia,764,2,1,,3,"(4.697144,-74.140516)"
2021,Febrero,Territorio Británico del Océano Índico/Territorios Británicos de Ultramar,86,0,1,,1,"(4.697144,-74.140516)"
2021,Febrero,Tanzania,834,0,1,,1,"(4.697144,-74.140516)"
2021,Febrero,Trinidad y Tobago,780,1,1,,2,"(4.697144,-74.140516)"
2021,Febrero,Turquía,792,1,0,,1,"(3.541112,-76.384584)"
2021,Febrero,Turquía,792,173,115,,288,"(4.697144,-74.140516)"
2021,Febrero,Turquía,792,0,1,,1,"(6.171601,-75.427454)"
2021,Febrero,Ucrania,804,4,9,,13,"(4.697144,-74.140516)"
2021,Febrero,Uganda,800,1,1,,2,"(4.697144,-74.140516)"
2021,Febrero,Uruguay,858,1,0,,1,"(10.445761,-75.516429)"
2021,Febrero,Uruguay,858,3,11,,14,"(3.541112,-76.384584)"
2021,Febrero,Uruguay,858,34,37,,71,"(4.697144,-74.140516)"
2021,Febrero,Uruguay,858,5,9,,14,"(4.815061,-75.736532)"
2021,Febrero,Uruguay,858,8,4,,12,"(6.171601,-75.427454)"
2021,Febrero,Uzbekistán,860,0,1,,1,"(4.697144,-74.140516)"
2021,Febrero,Venezuela,862,1,3,,4,"(10.886611,-74.776708)"
2021,Febrero,Venezuela,862,0,164,,164,"(11.360009,-72.129330)"
2021,Febrero,Venezuela,862,4,5,,9,"(3.541112,-76.384584)"
2021,Febrero,Venezuela,862,61,127,,188,"(4.697144,-74.140516)"
2021,Febrero,Venezuela,862,1,1,,2,"(4.815061,-75.736532)"
2021,Febrero,Venezuela,862,8,22,,30,"(6.171601,-75.427454)"
2021,Febrero,Venezuela,862,0,1,,1,"(6.185799,-67.483929)"
2021,Febrero,Venezuela,862,0,1,,1,"(7.088729,-70.740253)"
2021,Febrero,Venezuela,862,0,2,,2,"(7.128456,-73.183637)"
2021,Febrero,Venezuela,862,4,4,,8,"(7.818934,-72.453226)"
2021,Febrero,Islas Vírgenes Británicas/Territorio Británico de Ultramar,92,0,1,,1,"(4.697144,-74.140516)"
2021,Febrero,Islas Vírgenes Estadounidenses/Territorio de Estados Unidos,850,1,0,,1,"(3.541112,-76.384584)"
2021,Febrero,Islas Vírgenes Estadounidenses/Territorio de Estados Unidos,850,1,0,,1,"(6.171601,-75.427454)"
2021,Febrero,República Árabe de Yemen,887,1,1,,2,"(4.697144,-74.140516)"
2021,Febrero,Islas Turcas y Caicos/Territorio Británico de Ultramar,796,4,1,,5,"(4.697144,-74.140516)"
2021,Febrero,Islas Turcas y Caicos/Territorio Británico de Ultramar,796,1,0,,1,"(6.171601,-75.427454)"
2021,Febrero,Desconocido,99999,2,3,,5,"(4.697144,-74.140516)"
2021,Febrero,Desconocido,99999,11,10,,21,"(6.171601,-75.427454)"
2021,Marzo,Afganistán,4,0,3,,3,"(4.697144,-74.140516)"
2021,Marzo,Albania,8,3,0,,3,"(4.697144,-74.140516)"
2021,Marzo,Alemania,276,5,3,,8,"(10.445761,-75.516429)"
2021,Marzo,Alemania,276,2,0,,2,"(10.886611,-74.776708)"
2021,Marzo,Alemania,276,15,11,,26,"(3.541112,-76.384584)"
2021,Marzo,Alemania,276,526,308,,834,"(4.697144,-74.140516)"
2021,Marzo,Alemania,276,0,2,,2,"(4.815061,-75.736532)"
2021,Marzo,Alemania,276,16,19,,35,"(6.171601,-75.427454)"
2021,Marzo,Andorra,20,0,1,,1,"(3.541112,-76.384584)"
2021,Marzo,Andorra,20,3,0,,3,"(4.697144,-74.140516)"
2021,Marzo,Angola,24,0,1,,1,"(4.697144,-74.140516)"
2021,Marzo,Antigua y Barbuda,28,1,0,,1,"(4.697144,-74.140516)"
2021,Marzo,Países Bajos,528,16,8,,24,"(10.445761,-75.516429)"
2021,Marzo,Países Bajos,528,20,16,,36,"(10.886611,-74.776708)"
2021,Marzo,Países Bajos,528,7,4,,11,"(3.541112,-76.384584)"
2021,Marzo,Países Bajos,528,146,126,,272,"(4.697144,-74.140516)"
2021,Marzo,Países Bajos,528,4,2,,6,"(4.815061,-75.736532)"
2021,Marzo,Países Bajos,528,11,4,,15,"(6.171601,-75.427454)"
2021,Marzo,Países Bajos,528,0,1,,1,"(7.128456,-73.183637)"
2021,Marzo,Arabia Saudita,682,5,22,,27,"(4.697144,-74.140516)"
2021,Marzo,Argelia,12,1,3,,4,"(4.697144,-74.140516)"
2021,Marzo,Argentina,32,23,7,,30,"(10.445761,-75.516429)"
2021,Marzo,Argentina,32,25,11,,36,"(10.886611,-74.776708)"
2021,Marzo,Argentina,32,25,24,,49,"(3.541112,-76.384584)"
2021,Marzo,Argentina,32,1065,877,,1942,"(4.697144,-74.140516)"
2021,Marzo,Argentina,32,12,7,,19,"(4.815061,-75.736532)"
2021,Marzo,Argentina,32,41,31,,72,"(6.171601,-75.427454)"
2021,Marzo,Argentina,32,1,3,,4,"(7.128456,-73.183637)"
2021,Marzo,Aruba,533,6,7,,13,"(10.886611,-74.776708)"
2021,Marzo,Aruba,533,0,10,,10,"(11.247723,-74.213989)"
2021,Marzo,Aruba,533,34,35,,69,"(3.541112,-76.384584)"
2021,Marzo,Aruba,533,789,595,,1384,"(4.697144,-74.140516)"
2021,Marzo,Aruba,533,38,33,,71,"(6.171601,-75.427454)"
2021,Marzo,Aruba,533,3,8,,11,"(7.128456,-73.183637)"
2021,Marzo,Australia,36,0,1,,1,"(3.541112,-76.384584)"
2021,Marzo,Australia,36,9,15,,24,"(4.697144,-74.140516)"
2021,Marzo,Australia,36,2,0,,2,"(6.171601,-75.427454)"
2021,Marzo,Austria,40,2,0,,2,"(10.445761,-75.516429)"
2021,Marzo,Austria,40,2,0,,2,"(3.541112,-76.384584)"
2021,Marzo,Austria,40,27,18,,45,"(4.697144,-74.140516)"
2021,Marzo,Austria,40,1,0,,1,"(6.171601,-75.427454)"
2021,Marzo,Azerbaiyán,31,1,1,,2,"(4.697144,-74.140516)"
2021,Marzo,Bahamas,44,3,3,,6,"(10.445761,-75.516429)"
2021,Marzo,Bahamas,44,1,17,,18,"(10.886611,-74.776708)"
2021,Marzo,Bahamas,44,9,2,,11,"(3.541112,-76.384584)"
2021,Marzo,Bahamas,44,14,19,,33,"(4.697144,-74.140516)"
2021,Marzo,Bahamas,44,23,12,,35,"(6.171601,-75.427454)"
2021,Marzo,Bahréin,48,1,1,,2,"(10.445761,-75.516429)"
2021,Marzo,Bahréin,48,0,1,,1,"(3.541112,-76.384584)"
2021,Marzo,Bahréin,48,2,7,,9,"(4.697144,-74.140516)"
2021,Marzo,Bahréin,48,1,0,,1,"(6.171601,-75.427454)"
2021,Marzo,Barbados,52,0,2,,2,"(4.697144,-74.140516)"
2021,Marzo,Barbados,52,0,1,,1,"(6.171601,-75.427454)"
2021,Marzo,Bélgica,56,0,1,,1,"(10.445761,-75.516429)"
2021,Marzo,Bélgica,56,0,1,,1,"(10.886611,-74.776708)"
2021,Marzo,Bélgica,56,2,0,,2,"(3.541112,-76.384584)"
2021,Marzo,Bélgica,56,40,16,,56,"(4.697144,-74.140516)"
2021,Marzo,Bélgica,56,2,3,,5,"(6.171601,-75.427454)"
2021,Marzo,Belice,84,1,0,,1,"(3.541112,-76.384584)"
2021,Marzo,Belice,84,1,5,,6,"(4.697144,-74.140516)"
2021,Marzo,Belice,84,9,5,,14,"(6.171601,-75.427454)"
2021,Marzo,Benín,204,1,0,,1,"(4.697144,-74.140516)"
2021,Marzo,Bermudas/Territorio Británico de Ultramar,60,0,1,,1,"(4.697144,-74.140516)"
2021,Marzo,Bermudas/Territorio Británico de Ultramar,60,1,0,,1,"(6.171601,-75.427454)"
2021,Marzo,Bolivia,68,3,10,,13,"(10.445761,-75.516429)"
2021,Marzo,Bolivia,68,1,0,,1,"(10.886611,-74.776708)"
2021,Marzo,Bolivia,68,5,29,,34,"(3.541112,-76.384584)"
2021,Marzo,Bolivia,68,104,181,,285,"(4.697144,-74.140516)"
2021,Marzo,Bolivia,68,23,25,,48,"(4.815061,-75.736532)"
2021,Marzo,Bolivia,68,13,24,,37,"(6.171601,-75.427454)"
2021,Marzo,Bolivia,68,1,2,,3,"(7.128456,-73.183637)"
2021,Marzo,Bosnia y Herzegovina,70,0,1,,1,"(4.697144,-74.140516)"
2021,Marzo,Brasil,76,7,6,,13,"(-4.197703,-69.941278)"
2021,Marzo,Brasil,76,7,22,,29,"(10.445761,-75.516429)"
2021,Marzo,Brasil,76,7,4,,11,"(10.886611,-74.776708)"
2021,Marzo,Brasil,76,59,99,,158,"(3.541112,-76.384584)"
2021,Marzo,Brasil,76,209,279,,488,"(4.697144,-74.140516)"
2021,Marzo,Brasil,76,62,113,,175,"(4.815061,-75.736532)"
2021,Marzo,Brasil,76,39,52,,91,"(6.171601,-75.427454)"
2021,Marzo,Brasil,76,3,5,,8,"(7.128456,-73.183637)"
2021,Marzo,Bulgaria,100,6,9,,15,"(4.697144,-74.140516)"
2021,Marzo,Burkina Faso,854,0,1,,1,"(10.886611,-74.776708)"
2021,Marzo,Bután,64,0,1,,1,"(4.697144,-74.140516)"
2021,Marzo,Islas Caimán/Territorio Británico de Ultramar,136,1,1,,2,"(4.697144,-74.140516)"
2021,Marzo,Islas Caimán/Territorio Británico de Ultramar,136,2,1,,3,"(6.171601,-75.427454)"
2021,Marzo,Camerún,120,0,2,,2,"(4.697144,-74.140516)"
2021,Marzo,Canadá,124,6,8,,14,"(10.445761,-75.516429)"
2021,Marzo,Canadá,124,4,2,,6,"(10.886611,-74.776708)"
2021,Marzo,Canadá,124,34,29,,63,"(3.541112,-76.384584)"
2021,Marzo,Canadá,124,0,1,,1,"(4.452882,-75.766298)"
2021,Marzo,Canadá,124,130,145,,275,"(4.697144,-74.140516)"
2021,Marzo,Canadá,124,4,5,,9,"(4.815061,-75.736532)"
2021,Marzo,Canadá,124,48,51,,99,"(6.171601,-75.427454)"
2021,Marzo,Canadá,124,2,0,,2,"(7.128456,-73.183637)"
2021,Marzo,España,724,7,2,,9,"(10.445761,-75.516429)"
2021,Marzo,España,724,3,48,,51,"(10.886611,-74.776708)"
2021,Marzo,España,724,37,18,,55,"(3.541112,-76.384584)"
2021,Marzo,España,724,3174,2119,,5293,"(4.697144,-74.140516)"
2021,Marzo,España,724,2,2,,4,"(4.815061,-75.736532)"
2021,Marzo,España,724,210,129,,339,"(6.171601,-75.427454)"
2021,Marzo,Norfolk,574,1,0,,1,"(4.697144,-74.140516)"
2021,Marzo,Colombia,170,1,1,,2,"(10.445761,-75.516429)"
2021,Marzo,Colombia,170,27,52,,79,"(4.697144,-74.140516)"
2021,Marzo,República Democrática del Congo,180,0,1,,1,"(4.697144,-74.140516)"
2021,Marzo,República de Corea,410,0,1,,1,"(3.541112,-76.384584)"
2021,Marzo,República de Corea,410,7,2,,9,"(4.697144,-74.140516)"
2021,Marzo,Costa de Marfil,384,0,2,,2,"(4.697144,-74.140516)"
2021,Marzo,Costa Rica,188,6,4,,10,"(10.445761,-75.516429)"
2021,Marzo,Costa Rica,188,10,12,,22,"(10.886611,-74.776708)"
2021,Marzo,Costa Rica,188,1,9,,10,"(12.5744111,-81.703935)"
2021,Marzo,Costa Rica,188,41,40,,81,"(3.541112,-76.384584)"
2021,Marzo,Costa Rica,188,594,572,,1166,"(4.697144,-74.140516)"
2021,Marzo,Costa Rica,188,7,10,,17,"(4.815061,-75.736532)"
2021,Marzo,Costa Rica,188,98,81,,179,"(6.171601,-75.427454)"
2021,Marzo,Costa Rica,188,6,2,,8,"(7.128456,-73.183637)"
2021,Marzo,Croacia,191,0,2,,2,"(3.541112,-76.384584)"
2021,Marzo,Croacia,191,5,2,,7,"(4.697144,-74.140516)"
2021,Marzo,Cuba,192,3,1,,4,"(3.541112,-76.384584)"
2021,Marzo,Cuba,192,48,89,,137,"(4.697144,-74.140516)"
2021,Marzo,Cuba,192,3,2,,5,"(6.171601,-75.427454)"
2021,Marzo,Curazao,99999,1,0,,1,"(10.445761,-75.516429)"
2021,Marzo,Curazao,99999,47,40,,87,"(10.886611,-74.776708)"
2021,Marzo,Curazao,99999,95,97,,192,"(4.697144,-74.140516)"
2021,Marzo,Curazao,99999,5,3,,8,"(6.171601,-75.427454)"
2021,Marzo,República Checa,203,5,2,,7,"(4.697144,-74.140516)"
2021,Marzo,República Checa,203,1,2,,3,"(6.171601,-75.427454)"
2021,Marzo,Chile,152,22,9,,31,"(10.445761,-75.516429)"
2021,Marzo,Chile,152,27,27,,54,"(10.886611,-74.776708)"
2021,Marzo,Chile,152,1103,809,,1912,"(3.541112,-76.384584)"
2021,Marzo,Chile,152,4164,3261,,7425,"(4.697144,-74.140516)"
2021,Marzo,Chile,152,140,116,,256,"(4.815061,-75.736532)"
2021,Marzo,Chile,152,82,48,,130,"(6.171601,-75.427454)"
2021,Marzo,Chile,152,6,6,,12,"(7.128456,-73.183637)"
2021,Marzo,China,156,14,18,,32,"(4.697144,-74.140516)"
2021,Marzo,China,156,0,2,,2,"(6.171601,-75.427454)"
2021,Marzo,Chipre,196,0,1,,1,"(4.697144,-74.140516)"
2021,Marzo,Dinamarca,208,0,1,,1,"(3.541112,-76.384584)"
2021,Marzo,Dinamarca,208,13,12,,25,"(4.697144,-74.140516)"
2021,Marzo,Dinamarca,208,2,1,,3,"(6.171601,-75.427454)"
2021,Marzo,Dominica,212,1,0,,1,"(10.445761,-75.516429)"
2021,Marzo,Dominica,212,2,1,,3,"(4.697144,-74.140516)"
2021,Marzo,Ecuador,218,15,21,,36,"(0.814836,-77.662532)"
2021,Marzo,Ecuador,218,1,6,,7,"(10.445761,-75.516429)"
2021,Marzo,Ecuador,218,4,4,,8,"(10.886611,-74.776708)"
2021,Marzo,Ecuador,218,28,40,,68,"(3.541112,-76.384584)"
2021,Marzo,Ecuador,218,1285,1698,,2983,"(4.697144,-74.140516)"
2021,Marzo,Ecuador,218,8,6,,14,"(4.815061,-75.736532)"
2021,Marzo,Ecuador,218,43,59,,102,"(6.171601,-75.427454)"
2021,Marzo,Ecuador,218,0,5,,5,"(7.128456,-73.183637)"
2021,Marzo,Egipto,818,36,28,,64,"(4.697144,-74.140516)"
2021,Marzo,El Salvador,222,1,0,,1,"(10.445761,-75.516429)"
2021,Marzo,El Salvador,222,5,8,,13,"(3.541112,-76.384584)"
2021,Marzo,El Salvador,222,93,148,,241,"(4.697144,-74.140516)"
2021,Marzo,El Salvador,222,27,39,,66,"(6.171601,-75.427454)"
2021,Marzo,Emiratos Árabes,784,4,5,,9,"(10.445761,-75.516429)"
2021,Marzo,Emiratos Árabes,784,1,1,,2,"(3.541112,-76.384584)"
2021,Marzo,Emiratos Árabes,784,105,454,,559,"(4.697144,-74.140516)"
2021,Marzo,Emiratos Árabes,784,1,0,,1,"(4.815061,-75.736532)"
2021,Marzo,Emiratos Árabes,784,13,9,,22,"(6.171601,-75.427454)"
2021,Marzo,Eslovaquia,703,0,2,,2,"(4.697144,-74.140516)"
2021,Marzo,Eslovenia,705,1,0,,1,"(10.445761,-75.516429)"
2021,Marzo,Eslovenia,705,1,0,,1,"(4.697144,-74.140516)"
2021,Marzo,Estados Unidos de América,840,2362,2040,,4403,"(10.445761,-75.516429)"
2021,Marzo,Estados Unidos de América,840,2606,2116,,4722,"(10.886611,-74.776708)"
2021,Marzo,Estados Unidos de América,840,3,3,,6,"(11.117806,-74.232622)"
2021,Marzo,Estados Unidos de América,840,5118,3836,,8954,"(3.541112,-76.384584)"
2021,Marzo,Estados Unidos de América,840,824,665,,1489,"(4.452882,-75.766298)"
2021,Marzo,Estados Unidos de América,840,22890,19713,,42604,"(4.697144,-74.140516)"
2021,Marzo,Estados Unidos de América,840,980,668,,1648,"(4.815061,-75.736532)"
2021,Marzo,Estados Unidos de América,840,0,2,,2,"(6.17134,-75.427194)"
2021,Marzo,Estados Unidos de América,840,10180,8197,,18377,"(6.171601,-75.427454)"
2021,Marzo,Estados Unidos de América,840,720,650,,1370,"(7.128456,-73.183637)"
2021,Marzo,Estonia,233,1,1,,2,"(4.697144,-74.140516)"
2021,Marzo,Etiopia,231,1,2,,3,"(4.697144,-74.140516)"
2021,Marzo,Finlandia,246,1,0,,1,"(3.541112,-76.384584)"
2021,Marzo,Finlandia,246,6,8,,14,"(4.697144,-74.140516)"
2021,Marzo,Finlandia,246,1,0,,1,"(6.171601,-75.427454)"
2021,Marzo,Francia,250,2,0,,2,"(10.445761,-75.516429)"
2021,Marzo,Francia,250,7,9,,16,"(3.541112,-76.384584)"
2021,Marzo,Francia,250,326,298,,624,"(4.697144,-74.140516)"
2021,Marzo,Francia,250,1,1,,2,"(4.815061,-75.736532)"
2021,Marzo,Francia,250,11,6,,17,"(6.171601,-75.427454)"
2021,Marzo,Georgia,268,1,1,,2,"(3.541112,-76.384584)"
2021,Marzo,Georgia,268,6,5,,11,"(4.697144,-74.140516)"
2021,Marzo,Georgia,268,1,0,,1,"(6.171601,-75.427454)"
2021,Marzo,Ghana,288,0,1,,1,"(3.541112,-76.384584)"
2021,Marzo,Ghana,288,1,7,,8,"(4.697144,-74.140516)"
2021,Marzo,Grecia,300,3,1,,4,"(4.697144,-74.140516)"
2021,Marzo,Guatemala,320,0,3,,3,"(1.813928,-78.763924)"
2021,Marzo,Guatemala,320,2,1,,3,"(10.445761,-75.516429)"
2021,Marzo,Guatemala,320,7,8,,15,"(10.886611,-74.776708)"
2021,Marzo,Guatemala,320,47,64,,111,"(3.541112,-76.384584)"
2021,Marzo,Guatemala,320,175,221,,396,"(4.697144,-74.140516)"
2021,Marzo,Guatemala,320,11,12,,23,"(4.815061,-75.736532)"
2021,Marzo,Guatemala,320,94,95,,189,"(6.171601,-75.427454)"
2021,Marzo,Guatemala,320,2,4,,6,"(7.128456,-73.183637)"
2021,Marzo,Guyana,328,0,1,,1,"(10.445761,-75.516429)"
2021,Marzo,Guyana,328,3,8,,11,"(10.886611,-74.776708)"
2021,Marzo,Guyana,328,1,0,,1,"(3.541112,-76.384584)"
2021,Marzo,Guyana,328,2,19,,21,"(4.697144,-74.140516)"
2021,Marzo,Guyana,328,0,2,,2,"(4.815061,-75.736532)"
2021,Marzo,Guyana,328,1,4,,5,"(6.171601,-75.427454)"
2021,Marzo,Guinea Ecuatorial,226,6,6,,12,"(4.697144,-74.140516)"
2021,Marzo,Guadalupe/Territorio Francés,312,1,0,,1,"(4.697144,-74.140516)"
2021,Marzo,Guayana Francesa/Departamento de Ultramar Francés,254,0,1,,1,"(4.697144,-74.140516)"
2021,Marzo,Haití,332,1,1,,2,"(10.886611,-74.776708)"
2021,Marzo,Haití,332,1,6,,7,"(4.697144,-74.140516)"
2021,Marzo,Honduras,340,0,8,,8,"(10.408582,-75.538003)"
2021,Marzo,Honduras,340,1,1,,2,"(10.886611,-74.776708)"
2021,Marzo,Honduras,340,4,14,,18,"(3.541112,-76.384584)"
2021,Marzo,Honduras,340,31,69,,100,"(4.697144,-74.140516)"
2021,Marzo,Honduras,340,14,24,,38,"(6.171601,-75.427454)"
2021,Marzo,Honduras,340,1,3,,4,"(7.128456,-73.183637)"
2021,Marzo,Hong Kong,344,0,2,,2,"(4.697144,-74.140516)"
2021,Marzo,Hungría,348,7,1,,8,"(4.697144,-74.140516)"
2021,Marzo,India,356,4,5,,9,"(4.697144,-74.140516)"
2021,Marzo,India,356,1,1,,2,"(6.171601,-75.427454)"
2021,Marzo,Indonesia,360,0,2,,2,"(4.697144,-74.140516)"
2021,Marzo,Iraq,368,1,3,,4,"(4.697144,-74.140516)"
2021,Marzo,Irán,364,0,1,,1,"(4.697144,-74.140516)"
2021,Marzo,República de Irlanda,372,6,3,,9,"(4.697144,-74.140516)"
2021,Marzo,República de Irlanda,372,1,1,,2,"(6.171601,-75.427454)"
2021,Marzo,Islandia,352,3,0,,3,"(4.697144,-74.140516)"
2021,Marzo,Israel,376,27,20,,47,"(4.697144,-74.140516)"
2021,Marzo,Israel,376,1,1,,2,"(6.171601,-75.427454)"
2021,Marzo,Italia,380,7,5,,12,"(10.445761,-75.516429)"
2021,Marzo,Italia,380,0,1,,1,"(10.886611,-74.776708)"
2021,Marzo,Italia,380,30,7,,37,"(3.541112,-76.384584)"
2021,Marzo,Italia,380,250,147,,397,"(4.697144,-74.140516)"
2021,Marzo,Italia,380,0,1,,1,"(4.815061,-75.736532)"
2021,Marzo,Italia,380,26,14,,40,"(6.171601,-75.427454)"
2021,Marzo,Jamaica,388,3,4,,7,"(10.445761,-75.516429)"
2021,Marzo,Jamaica,388,0,2,,2,"(10.886611,-74.776708)"
2021,Marzo,Jamaica,388,1,1,,2,"(3.541112,-76.384584)"
2021,Marzo,Jamaica,388,19,20,,39,"(4.697144,-74.140516)"
2021,Marzo,Jamaica,388,10,6,,16,"(6.171601,-75.427454)"
2021,Marzo,Japón,392,2,0,,2,"(3.541112,-76.384584)"
2021,Marzo,Japón,392,6,2,,8,"(4.697144,-74.140516)"
2021,Marzo,Japón,392,1,0,,1,"(4.815061,-75.736532)"
2021,Marzo,Japón,392,1,0,,1,"(6.171601,-75.427454)"
2021,Marzo,Jordania,400,0,1,,1,"(4.697144,-74.140516)"
2021,Marzo,Kenia,404,2,2,,4,"(4.697144,-74.140516)"
2021,Marzo,República de Kosovo,901,2,0,,2,"(4.697144,-74.140516)"
2021,Marzo,Letonia,428,1,0,,1,"(4.697144,-74.140516)"
2021,Marzo,Lituania,440,0,3,,3,"(4.697144,-74.140516)"
2021,Marzo,Líbano,422,0,1,,1,"(10.886611,-74.776708)"
2021,Marzo,Líbano,422,1,0,,1,"(3.541112,-76.384584)"
2021,Marzo,Líbano,422,2,7,,9,"(4.697144,-74.140516)"
2021,Marzo,Luxemburgo,442,1,0,,1,"(3.541112,-76.384584)"
2021,Marzo,Luxemburgo,442,3,2,,5,"(4.697144,-74.140516)"
2021,Marzo,Luxemburgo,442,1,0,,1,"(4.815061,-75.736532)"
2021,Marzo,Luxemburgo,442,1,0,,1,"(6.171601,-75.427454)"
2021,Marzo,Maldivas,462,0,4,,4,"(4.697144,-74.140516)"
2021,Marzo,Malta,470,24,23,,47,"(4.697144,-74.140516)"
2021,Marzo,Marruecos,504,6,2,,8,"(4.697144,-74.140516)"
2021,Marzo,Mauritania,478,0,3,,3,"(4.697144,-74.140516)"
2021,Marzo,México,484,73,45,,118,"(10.445761,-75.516429)"
2021,Marzo,México,484,85,54,,139,"(10.886611,-74.776708)"
2021,Marzo,México,484,0,7,,7,"(12.586067,-81.702563)"
2021,Marzo,México,484,763,597,,1360,"(3.541112,-76.384584)"
2021,Marzo,México,484,6882,6107,,12989,"(4.697144,-74.140516)"
2021,Marzo,México,484,108,69,,177,"(4.815061,-75.736532)"
2021,Marzo,México,484,2710,2129,,4840,"(6.171601,-75.427454)"
2021,Marzo,México,484,0,3,,3,"(6.228046,-77.404104)"
2021,Marzo,México,484,37,30,,67,"(7.128456,-73.183637)"
2021,Marzo,México,484,0,1,,1,"(8.635765,-77.346578)"
2021,Marzo,República de Moldavia,498,2,0,,2,"(4.697144,-74.140516)"
2021,Marzo,Mónaco,492,0,1,,1,"(6.171601,-75.427454)"
2021,Marzo,Mozambique,508,1,2,,3,"(4.697144,-74.140516)"
2021,Marzo,Nicaragua,558,0,1,,1,"(3.541112,-76.384584)"
2021,Marzo,Nicaragua,558,13,40,,53,"(4.697144,-74.140516)"
2021,Marzo,Nicaragua,558,4,12,,16,"(6.171601,-75.427454)"
2021,Marzo,Nicaragua,558,1,2,,3,"(7.128456,-73.183637)"
2021,Marzo,Nigeria,566,1,4,,5,"(4.697144,-74.140516)"
2021,Marzo,Noruega,578,6,15,,21,"(4.697144,-74.140516)"
2021,Marzo,Noruega,578,1,0,,1,"(6.171601,-75.427454)"
2021,Marzo,Nueva Caledonia/Territorio francés,540,0,1,,1,"(4.697144,-74.140516)"
2021,Marzo,Nueva Zelanda,554,1,1,,2,"(10.886611,-74.776708)"
2021,Marzo,Nueva Zelanda,554,0,1,,1,"(3.541112,-76.384584)"
2021,Marzo,Nueva Zelanda,554,0,1,,1,"(4.697144,-74.140516)"
2021,Marzo,Nueva Zelanda,554,1,0,,1,"(7.128456,-73.183637)"
2021,Marzo,Omán,512,4,3,,7,"(4.697144,-74.140516)"
2021,Marzo,Pakistán,586,1,1,,2,"(4.697144,-74.140516)"
2021,Marzo,Panamá,591,14,81,,95,"(10.408582,-75.538003)"
2021,Marzo,Panamá,591,755,590,,1345,"(10.445761,-75.516429)"
2021,Marzo,Panamá,591,282,231,,513,"(10.886611,-74.776708)"
2021,Marzo,Panamá,591,0,5,,5,"(10.971302,-74.765397)"
2021,Marzo,Panamá,591,1,3,,4,"(11.117806,-74.232622)"
2021,Marzo,Panamá,591,0,1,,1,"(11.360009,-72.129330)"
2021,Marzo,Panamá,591,1,10,,11,"(12.5744111,-81.703935)"
2021,Marzo,Panamá,591,1532,1127,,2659,"(3.541112,-76.384584)"
2021,Marzo,Panamá,591,1989,2212,,4201,"(4.697144,-74.140516)"
2021,Marzo,Panamá,591,157,123,,280,"(4.815061,-75.736532)"
2021,Marzo,Panamá,591,1152,1038,,2190,"(6.171601,-75.427454)"
2021,Marzo,Panamá,591,10,21,,31,"(7.102626,-77.762647)"
2021,Marzo,Panamá,591,46,47,,93,"(7.128456,-73.183637)"
2021,Marzo,Panamá,591,0,6,,7,"(8.066966,-76.735404)"
2021,Marzo,Panamá,591,8,9,,17,"(8.635765,-77.346578)"
2021,Marzo,Paraguay,600,0,2,,2,"(10.445761,-75.516429)"
2021,Marzo,Paraguay,600,2,5,,7,"(10.886611,-74.776708)"
2021,Marzo,Paraguay,600,5,22,,27,"(3.541112,-76.384584)"
2021,Marzo,Paraguay,600,39,103,,142,"(4.697144,-74.140516)"
2021,Marzo,Paraguay,600,3,7,,10,"(4.815061,-75.736532)"
2021,Marzo,Paraguay,600,9,56,,65,"(6.171601,-75.427454)"
2021,Marzo,Paraguay,600,2,0,,2,"(7.128456,-73.183637)"
2021,Marzo,Perú,604,0,1,,1,"(-0.193180,-74.784874)"
2021,Marzo,Perú,604,3,5,,8,"(-4.197703,-69.941278)"
2021,Marzo,Perú,604,6,4,,10,"(10.445761,-75.516429)"
2021,Marzo,Perú,604,0,1,,1,"(10.886611,-74.776708)"
2021,Marzo,Perú,604,21,22,,43,"(3.541112,-76.384584)"
2021,Marzo,Perú,604,1015,1224,,2239,"(4.697144,-74.140516)"
2021,Marzo,Perú,604,17,13,,30,"(4.815061,-75.736532)"
2021,Marzo,Perú,604,223,250,,473,"(6.171601,-75.427454)"
2021,Marzo,Perú,604,1,2,,3,"(7.128456,-73.183637)"
2021,Marzo,Polonia,616,0,2,,2,"(10.445761,-75.516429)"
2021,Marzo,Polonia,616,5,8,,13,"(4.697144,-74.140516)"
2021,Marzo,Portugal,620,26,37,,63,"(4.697144,-74.140516)"
2021,Marzo,Portugal,620,3,2,,5,"(6.171601,-75.427454)"
2021,Marzo,Puerto Rico/Territorio de Estados Unidos,630,4,0,,4,"(10.445761,-75.516429)"
2021,Marzo,Puerto Rico/Territorio de Estados Unidos,630,4,2,,6,"(10.886611,-74.776708)"
2021,Marzo,Puerto Rico/Territorio de Estados Unidos,630,0,1,,1,"(12.5744111,-81.703935)"
2021,Marzo,Puerto Rico/Territorio de Estados Unidos,630,9,11,,20,"(3.541112,-76.384584)"
2021,Marzo,Puerto Rico/Territorio de Estados Unidos,630,71,77,,148,"(4.697144,-74.140516)"
2021,Marzo,Puerto Rico/Territorio de Estados Unidos,630,2,6,,8,"(4.815061,-75.736532)"
2021,Marzo,Puerto Rico/Territorio de Estados Unidos,630,45,25,,70,"(6.171601,-75.427454)"
2021,Marzo,Puerto Rico/Territorio de Estados Unidos,630,1,2,,3,"(7.128456,-73.183637)"
2021,Marzo,Qatar,634,0,4,,4,"(4.697144,-74.140516)"
2021,Marzo,Reino Unido de Gran Bretaña e Irlanda del Norte,826,0,1,,1,"(10.886611,-74.776708)"
2021,Marzo,Reino Unido de Gran Bretaña e Irlanda del Norte,826,2,3,,5,"(3.541112,-76.384584)"
2021,Marzo,Reino Unido de Gran Bretaña e Irlanda del Norte,826,57,34,,91,"(4.697144,-74.140516)"
2021,Marzo,Reino Unido de Gran Bretaña e Irlanda del Norte,826,6,4,,10,"(6.171601,-75.427454)"
2021,Marzo,República CentroÁfricana,140,0,1,,1,"(4.697144,-74.140516)"
2021,Marzo,Federación de Rusia,643,1,1,,2,"(3.541112,-76.384584)"
2021,Marzo,Federación de Rusia,643,5,9,,14,"(4.697144,-74.140516)"
2021,Marzo,Federación de Rusia,643,1,0,,1,"(7.128456,-73.183637)"
2021,Marzo,República Dominicana,214,12,11,,23,"(10.445761,-75.516429)"
2021,Marzo,República Dominicana,214,28,31,,59,"(10.886611,-74.776708)"
2021,Marzo,República Dominicana,214,0,2,,2,"(10.971302,-74.765397)"
2021,Marzo,República Dominicana,214,16,21,,37,"(11.117806,-74.232622)"
2021,Marzo,República Dominicana,214,209,184,,393,"(3.541112,-76.384584)"
2021,Marzo,República Dominicana,214,2751,2432,,5183,"(4.697144,-74.140516)"
2021,Marzo,República Dominicana,214,7,9,,16,"(4.815061,-75.736532)"
2021,Marzo,República Dominicana,214,637,462,,1099,"(6.171601,-75.427454)"
2021,Marzo,República Dominicana,214,16,14,,30,"(7.128456,-73.183637)"
2021,Marzo,República Democrática Popular de Corea,408,2,0,,2,"(4.697144,-74.140516)"
2021,Marzo,Rumania,642,1,0,,1,"(3.541112,-76.384584)"
2021,Marzo,Rumania,642,4,2,,6,"(4.697144,-74.140516)"
2021,Marzo,Santa Lucia,662,0,1,,1,"(4.697144,-74.140516)"
2021,Marzo,Senegal,686,1,0,,1,"(4.697144,-74.140516)"
2021,Marzo,Serbia,688,1,0,,1,"(4.697144,-74.140516)"
2021,Marzo,Islas Svalbard,744,1,0,,1,"(6.171601,-75.427454)"
2021,Marzo,Sierra Leona,694,1,0,,1,"(4.697144,-74.140516)"
2021,Marzo,Singapur,702,2,2,,4,"(4.697144,-74.140516)"
2021,Marzo,Somalia,706,1,0,,1,"(4.697144,-74.140516)"
2021,Marzo,Sri Lanka,144,0,1,,1,"(6.171601,-75.427454)"
2021,Marzo,Sudáfrica,710,8,2,,10,"(4.697144,-74.140516)"
2021,Marzo,Sudán,736,0,1,,1,"(4.697144,-74.140516)"
2021,Marzo,Suecia,752,1,0,,1,"(10.445761,-75.516429)"
2021,Marzo,Suecia,752,4,6,,10,"(3.541112,-76.384584)"
2021,Marzo,Suecia,752,28,25,,53,"(4.697144,-74.140516)"
2021,Marzo,Suecia,752,4,2,,6,"(6.171601,-75.427454)"
2021,Marzo,Suecia,752,2,0,,2,"(7.128456,-73.183637)"
2021,Marzo,Suiza,756,6,4,,10,"(10.445761,-75.516429)"
2021,Marzo,Suiza,756,0,1,,1,"(10.886611,-74.776708)"
2021,Marzo,Suiza,756,7,5,,12,"(3.541112,-76.384584)"
2021,Marzo,Suiza,756,135,71,,206,"(4.697144,-74.140516)"
2021,Marzo,Suiza,756,0,1,,1,"(4.815061,-75.736532)"
2021,Marzo,Suiza,756,13,5,,18,"(6.171601,-75.427454)"
2021,Marzo,Surinam,740,0,8,,8,"(10.408582,-75.538003)"
2021,Marzo,Suazilandia,748,1,0,,1,"(4.697144,-74.140516)"
2021,Marzo,Taiwán,158,0,3,,3,"(4.697144,-74.140516)"
2021,Marzo,Tailandia,764,2,2,,4,"(4.697144,-74.140516)"
2021,Marzo,Trinidad y Tobago,780,0,2,,2,"(4.697144,-74.140516)"
2021,Marzo,Túnez,788,10,17,,27,"(4.697144,-74.140516)"
2021,Marzo,Turquía,792,0,1,,1,"(10.445761,-75.516429)"
2021,Marzo,Turquía,792,4,0,,4,"(3.541112,-76.384584)"
2021,Marzo,Turquía,792,376,313,,689,"(4.697144,-74.140516)"
2021,Marzo,Turquía,792,3,3,,6,"(6.171601,-75.427454)"
2021,Marzo,Turquía,792,0,1,,1,"(7.128456,-73.183637)"
2021,Marzo,Turkmenistán,795,1,0,,1,"(4.697144,-74.140516)"
2021,Marzo,Ucrania,804,3,0,,3,"(3.541112,-76.384584)"
2021,Marzo,Ucrania,804,2,7,,9,"(4.697144,-74.140516)"
2021,Marzo,Uganda,800,1,0,,1,"(4.697144,-74.140516)"
2021,Marzo,Uruguay,858,4,1,,5,"(10.445761,-75.516429)"
2021,Marzo,Uruguay,858,5,6,,11,"(3.541112,-76.384584)"
2021,Marzo,Uruguay,858,23,40,,63,"(4.697144,-74.140516)"
2021,Marzo,Uruguay,858,7,13,,20,"(4.815061,-75.736532)"
2021,Marzo,Uruguay,858,5,1,,6,"(6.171601,-75.427454)"
2021,Marzo,Uzbekistán,860,0,1,,1,"(4.697144,-74.140516)"
2021,Marzo,Venezuela,862,0,2,,2,"(10.445761,-75.516429)"
2021,Marzo,Venezuela,862,3,35,,38,"(10.886611,-74.776708)"
2021,Marzo,Venezuela,862,1,184,,185,"(11.360009,-72.129330)"
2021,Marzo,Venezuela,862,7,3,,10,"(3.541112,-76.384584)"
2021,Marzo,Venezuela,862,70,140,,210,"(4.697144,-74.140516)"
2021,Marzo,Venezuela,862,1,1,,2,"(4.815061,-75.736532)"
2021,Marzo,Venezuela,862,22,18,,40,"(6.171601,-75.427454)"
2021,Marzo,Venezuela,862,2,1,,3,"(7.128456,-73.183637)"
2021,Marzo,Venezuela,862,3,14,,17,"(7.818934,-72.453226)"
2021,Marzo,Islas Vírgenes Británicas/Territorio Británico de Ultramar,92,1,2,,3,"(4.697144,-74.140516)"
2021,Marzo,Islas Vírgenes Británicas/Territorio Británico de Ultramar,92,1,0,,1,"(6.171601,-75.427454)"
2021,Marzo,Islas Vírgenes Estadounidenses/Territorio de Estados Unidos,850,0,1,,1,"(10.886611,-74.776708)"
2021,Marzo,Islas Vírgenes Estadounidenses/Territorio de Estados Unidos,850,0,2,,2,"(4.697144,-74.140516)"
2021,Marzo,Islas Vírgenes Estadounidenses/Territorio de Estados Unidos,850,0,1,,1,"(6.171601,-75.427454)"
2021,Marzo,Zambia,894,0,1,,1,"(4.697144,-74.140516)"
2021,Marzo,Islas Turcas y Caicos/Territorio Británico de Ultramar,796,6,3,,9,"(4.697144,-74.140516)"
2021,Marzo,Islas Turcas y Caicos/Territorio Británico de Ultramar,796,4,4,,8,"(6.171601,-75.427454)"
2021,Marzo,Islas Turcas y Caicos/Territorio Británico de Ultramar,796,1,4,,5,"(7.128456,-73.183637)"
2021,Marzo,Desconocido,99999,3,0,,3,"(4.697144,-74.140516)"
2021,Abril,Afganistán,4,1,9,,10,"(4.697144,-74.140516)"
2021,Abril,Albania,8,2,1,,3,"(4.697144,-74.140516)"
2021,Abril,Alemania,276,10,3,,13,"(10.445761,-75.516429)"
2021,Abril,Alemania,276,2,2,,4,"(10.886611,-74.776708)"
2021,Abril,Alemania,276,18,19,,37,"(3.541112,-76.384584)"
2021,Abril,Alemania,276,534,356,,890,"(4.697144,-74.140516)"
2021,Abril,Alemania,276,2,1,,3,"(4.815061,-75.736532)"
2021,Abril,Alemania,276,36,25,,61,"(6.171601,-75.427454)"
2021,Abril,Andorra,20,1,0,,1,"(4.697144,-74.140516)"
2021,Abril,Angola,24,3,8,,11,"(4.697144,-74.140516)"
2021,Abril,Antigua y Barbuda,28,0,2,,2,"(4.697144,-74.140516)"
2021,Abril,Países Bajos,528,29,15,,44,"(10.445761,-75.516429)"
2021,Abril,Países Bajos,528,19,12,,31,"(10.886611,-74.776708)"
2021,Abril,Países Bajos,528,9,4,,13,"(3.541112,-76.384584)"
2021,Abril,Países Bajos,528,198,143,,341,"(4.697144,-74.140516)"
2021,Abril,Países Bajos,528,1,0,,1,"(4.815061,-75.736532)"
2021,Abril,Países Bajos,528,13,13,,26,"(6.171601,-75.427454)"
2021,Abril,Países Bajos,528,3,6,,9,"(7.128456,-73.183637)"
2021,Abril,Arabia Saudita,682,9,28,,37,"(4.697144,-74.140516)"
2021,Abril,Argelia,12,0,1,,1,"(4.697144,-74.140516)"
2021,Abril,Argentina,32,10,5,,15,"(10.445761,-75.516429)"
2021,Abril,Argentina,32,3,36,,39,"(10.886611,-74.776708)"
2021,Abril,Argentina,32,20,16,,36,"(3.541112,-76.384584)"
2021,Abril,Argentina,32,682,597,,1279,"(4.697144,-74.140516)"
2021,Abril,Argentina,32,5,11,,16,"(4.815061,-75.736532)"
2021,Abril,Argentina,32,18,8,,26,"(6.171601,-75.427454)"
2021,Abril,Argentina,32,2,0,,2,"(7.128456,-73.183637)"
2021,Abril,República de Armenia,51,0,1,,1,"(3.541112,-76.384584)"
2021,Abril,República de Armenia,51,1,0,,1,"(4.697144,-74.140516)"
2021,Abril,Aruba,533,1,2,,3,"(10.445761,-75.516429)"
2021,Abril,Aruba,533,1,2,,3,"(10.886611,-74.776708)"
2021,Abril,Aruba,533,0,2,,2,"(11.247723,-74.213989)"
2021,Abril,Aruba,533,28,10,,38,"(3.541112,-76.384584)"
2021,Abril,Aruba,533,871,707,,1578,"(4.697144,-74.140516)"
2021,Abril,Aruba,533,32,24,,56,"(6.171601,-75.427454)"
2021,Abril,Aruba,533,2,8,,10,"(7.128456,-73.183637)"
2021,Abril,Australia,36,1,1,,2,"(3.541112,-76.384584)"
2021,Abril,Australia,36,9,4,,13,"(4.697144,-74.140516)"
2021,Abril,Austria,40,2,1,,3,"(10.445761,-75.516429)"
2021,Abril,Austria,40,22,15,,37,"(4.697144,-74.140516)"
2021,Abril,Austria,40,4,2,,6,"(6.171601,-75.427454)"
2021,Abril,Azerbaiyán,31,2,1,,3,"(4.697144,-74.140516)"
2021,Abril,Bahamas,44,2,3,,5,"(10.445761,-75.516429)"
2021,Abril,Bahamas,44,24,11,,35,"(3.541112,-76.384584)"
2021,Abril,Bahamas,44,11,17,,28,"(4.697144,-74.140516)"
2021,Abril,Bahamas,44,9,28,,37,"(6.171601,-75.427454)"
2021,Abril,Bahréin,48,3,10,,13,"(4.697144,-74.140516)"
2021,Abril,Barbados,52,0,2,,2,"(3.541112,-76.384584)"
2021,Abril,Barbados,52,0,1,,1,"(4.697144,-74.140516)"
2021,Abril,Barbados,52,0,1,,1,"(6.171601,-75.427454)"
2021,Abril,Bélgica,56,0,1,,1,"(10.445761,-75.516429)"
2021,Abril,Bélgica,56,3,1,,4,"(3.541112,-76.384584)"
2021,Abril,Bélgica,56,46,26,,72,"(4.697144,-74.140516)"
2021,Abril,Bélgica,56,9,6,,15,"(6.171601,-75.427454)"
2021,Abril,Belice,84,1,0,,1,"(3.541112,-76.384584)"
2021,Abril,Belice,84,5,2,,7,"(4.697144,-74.140516)"
2021,Abril,Bermudas/Territorio Británico de Ultramar,60,0,1,,1,"(6.171601,-75.427454)"
2021,Abril,Bolivia,68,2,8,,10,"(10.445761,-75.516429)"
2021,Abril,Bolivia,68,1,35,,36,"(10.886611,-74.776708)"
2021,Abril,Bolivia,68,18,35,,53,"(3.541112,-76.384584)"
2021,Abril,Bolivia,68,86,217,,303,"(4.697144,-74.140516)"
2021,Abril,Bolivia,68,15,18,,33,"(4.815061,-75.736532)"
2021,Abril,Bolivia,68,10,30,,40,"(6.171601,-75.427454)"
2021,Abril,Bolivia,68,1,0,,1,"(7.128456,-73.183637)"
2021,Abril,Botsuana,72,0,1,,1,"(4.697144,-74.140516)"
2021,Abril,Brasil,76,7,8,,15,"(-4.197703,-69.941278)"
2021,Abril,Brasil,76,2,9,,11,"(10.445761,-75.516429)"
2021,Abril,Brasil,76,1,8,,9,"(10.886611,-74.776708)"
2021,Abril,Brasil,76,67,151,,218,"(3.541112,-76.384584)"
2021,Abril,Brasil,76,88,225,,313,"(4.697144,-74.140516)"
2021,Abril,Brasil,76,51,90,,141,"(4.815061,-75.736532)"
2021,Abril,Brasil,76,30,33,,63,"(6.171601,-75.427454)"
2021,Abril,Brasil,76,0,2,,2,"(7.128456,-73.183637)"
2021,Abril,Bulgaria,100,9,2,,11,"(4.697144,-74.140516)"
2021,Abril,Burkina Faso,854,0,1,,1,"(4.697144,-74.140516)"
2021,Abril,Cabo Verde,132,0,1,,1,"(4.697144,-74.140516)"
2021,Abril,Islas Caimán/Territorio Británico de Ultramar,136,0,1,,1,"(4.697144,-74.140516)"
2021,Abril,Camerún,120,0,1,,1,"(4.697144,-74.140516)"
2021,Abril,Canadá,124,7,10,,17,"(10.445761,-75.516429)"
2021,Abril,Canadá,124,10,9,,19,"(10.886611,-74.776708)"
2021,Abril,Canadá,124,42,46,,88,"(3.541112,-76.384584)"
2021,Abril,Canadá,124,212,215,,427,"(4.697144,-74.140516)"
2021,Abril,Canadá,124,10,11,,21,"(4.815061,-75.736532)"
2021,Abril,Canadá,124,80,95,,175,"(6.171601,-75.427454)"
2021,Abril,Canadá,124,4,4,,8,"(7.128456,-73.183637)"
2021,Abril,España,724,14,12,,26,"(10.445761,-75.516429)"
2021,Abril,España,724,5,23,,28,"(10.886611,-74.776708)"
2021,Abril,España,724,62,35,,97,"(3.541112,-76.384584)"
2021,Abril,España,724,3392,2490,,5882,"(4.697144,-74.140516)"
2021,Abril,España,724,3,10,,13,"(4.815061,-75.736532)"
2021,Abril,España,724,249,120,,369,"(6.171601,-75.427454)"
2021,Abril,España,724,1,1,,2,"(7.128456,-73.183637)"
2021,Abril,Colombia,170,0,1,,1,"(10.445761,-75.516429)"
2021,Abril,Colombia,170,30,50,,80,"(4.697144,-74.140516)"
2021,Abril,República de Corea,410,1,0,,1,"(10.445761,-75.516429)"
2021,Abril,República de Corea,410,6,2,,8,"(4.697144,-74.140516)"
2021,Abril,Islas Malvinas,238,1,0,,1,"(4.697144,-74.140516)"
2021,Abril,Costa de Marfil,384,1,0,,1,"(10.886611,-74.776708)"
2021,Abril,Costa de Marfil,384,0,2,,2,"(4.697144,-74.140516)"
2021,Abril,Costa Rica,188,0,2,,2,"(1.813928,-78.763924)"
2021,Abril,Costa Rica,188,4,1,,5,"(10.445761,-75.516429)"
2021,Abril,Costa Rica,188,11,6,,17,"(10.886611,-74.776708)"
2021,Abril,Costa Rica,188,6,52,,58,"(12.5744111,-81.703935)"
2021,Abril,Costa Rica,188,57,55,,112,"(3.541112,-76.384584)"
2021,Abril,Costa Rica,188,427,481,,908,"(4.697144,-74.140516)"
2021,Abril,Costa Rica,188,14,6,,20,"(4.815061,-75.736532)"
2021,Abril,Costa Rica,188,79,78,,157,"(6.171601,-75.427454)"
2021,Abril,Costa Rica,188,0,1,,1,"(7.128456,-73.183637)"
2021,Abril,Croacia,191,1,0,,1,"(10.445761,-75.516429)"
2021,Abril,Croacia,191,8,12,,20,"(4.697144,-74.140516)"
2021,Abril,Cuba,192,0,2,,2,"(3.541112,-76.384584)"
2021,Abril,Cuba,192,82,82,,164,"(4.697144,-74.140516)"
2021,Abril,Curazao,99999,0,1,,1,"(10.445761,-75.516429)"
2021,Abril,Curazao,99999,35,15,,50,"(10.886611,-74.776708)"
2021,Abril,Curazao,99999,96,149,,245,"(4.697144,-74.140516)"
2021,Abril,República Checa,203,7,7,,14,"(4.697144,-74.140516)"
2021,Abril,Chile,152,7,4,,11,"(10.445761,-75.516429)"
2021,Abril,Chile,152,4,1,,5,"(10.886611,-74.776708)"
2021,Abril,Chile,152,122,89,,211,"(3.541112,-76.384584)"
2021,Abril,Chile,152,673,541,,1214,"(4.697144,-74.140516)"
2021,Abril,Chile,152,23,21,,44,"(4.815061,-75.736532)"
2021,Abril,Chile,152,20,19,,39,"(6.171601,-75.427454)"
2021,Abril,Chile,152,0,1,,1,"(7.128456,-73.183637)"
2021,Abril,China,156,3,7,,10,"(4.697144,-74.140516)"
2021,Abril,Chipre,196,4,9,,13,"(4.697144,-74.140516)"
2021,Abril,Dinamarca,208,0,1,,1,"(10.445761,-75.516429)"
2021,Abril,Dinamarca,208,19,9,,28,"(4.697144,-74.140516)"
2021,Abril,Dinamarca,208,0,2,,2,"(6.171601,-75.427454)"
2021,Abril,Dominica,212,1,0,,1,"(10.445761,-75.516429)"
2021,Abril,Dominica,212,0,6,,6,"(3.541112,-76.384584)"
2021,Abril,Dominica,212,2,1,,3,"(4.697144,-74.140516)"
2021,Abril,Dominica,212,1,0,,1,"(6.171601,-75.427454)"
2021,Abril,Ecuador,218,17,13,,30,"(0.814836,-77.662532)"
2021,Abril,Ecuador,218,3,5,,8,"(10.445761,-75.516429)"
2021,Abril,Ecuador,218,2,1,,3,"(10.886611,-74.776708)"
2021,Abril,Ecuador,218,21,32,,53,"(3.541112,-76.384584)"
2021,Abril,Ecuador,218,1010,1372,,2382,"(4.697144,-74.140516)"
2021,Abril,Ecuador,218,4,5,,9,"(4.815061,-75.736532)"
2021,Abril,Ecuador,218,24,41,,65,"(6.171601,-75.427454)"
2021,Abril,Ecuador,218,2,1,,3,"(7.128456,-73.183637)"
2021,Abril,Egipto,818,0,1,,1,"(10.408582,-75.538003)"
2021,Abril,Egipto,818,1,0,,1,"(3.541112,-76.384584)"
2021,Abril,Egipto,818,25,156,,181,"(4.697144,-74.140516)"
2021,Abril,El Salvador,222,0,1,,1,"(10.886611,-74.776708)"
2021,Abril,El Salvador,222,6,14,,20,"(3.541112,-76.384584)"
2021,Abril,El Salvador,222,118,167,,285,"(4.697144,-74.140516)"
2021,Abril,El Salvador,222,20,20,,40,"(6.171601,-75.427454)"
2021,Abril,El Salvador,222,0,1,,1,"(7.128456,-73.183637)"
2021,Abril,Emiratos Árabes,784,1,2,,3,"(10.445761,-75.516429)"
2021,Abril,Emiratos Árabes,784,1,0,,1,"(10.886611,-74.776708)"
2021,Abril,Emiratos Árabes,784,0,1,,1,"(3.541112,-76.384584)"
2021,Abril,Emiratos Árabes,784,113,279,,392,"(4.697144,-74.140516)"
2021,Abril,Emiratos Árabes,784,3,5,,8,"(6.171601,-75.427454)"
2021,Abril,Eslovaquia,703,0,2,,2,"(4.697144,-74.140516)"
2021,Abril,Eslovaquia,703,0,1,,1,"(6.171601,-75.427454)"
2021,Abril,Eslovaquia,703,0,1,,1,"(7.128456,-73.183637)"
2021,Abril,Estados Unidos de América,840,3214,2792,,6006,"(10.445761,-75.516429)"
2021,Abril,Estados Unidos de América,840,3505,2862,,6367,"(10.886611,-74.776708)"
2021,Abril,Estados Unidos de América,840,5,6,,11,"(11.117806,-74.232622)"
2021,Abril,Estados Unidos de América,840,5397,3952,,9349,"(3.541112,-76.384584)"
2021,Abril,Estados Unidos de América,840,913,713,,1626,"(4.452882,-75.766298)"
2021,Abril,Estados Unidos de América,840,25389,22257,,47646,"(4.697144,-74.140516)"
2021,Abril,Estados Unidos de América,840,985,703,,1688,"(4.815061,-75.736532)"
2021,Abril,Estados Unidos de América,840,1,3,,4,"(6.17134,-75.427194)"
2021,Abril,Estados Unidos de América,840,11640,9659,,21299,"(6.171601,-75.427454)"
2021,Abril,Estados Unidos de América,840,725,691,,1416,"(7.128456,-73.183637)"
2021,Abril,Estonia,233,2,0,,2,"(4.697144,-74.140516)"
2021,Abril,Etiopia,231,0,5,,5,"(4.697144,-74.140516)"
2021,Abril,Filipinas,608,0,1,,1,"(4.697144,-74.140516)"
2021,Abril,Finlandia,246,10,10,,20,"(4.697144,-74.140516)"
2021,Abril,Francia,250,1,1,,2,"(10.445761,-75.516429)"
2021,Abril,Francia,250,1,1,,2,"(10.886611,-74.776708)"
2021,Abril,Francia,250,10,9,,19,"(3.541112,-76.384584)"
2021,Abril,Francia,250,338,243,,581,"(4.697144,-74.140516)"
2021,Abril,Francia,250,2,2,,4,"(4.815061,-75.736532)"
2021,Abril,Francia,250,15,5,,20,"(6.171601,-75.427454)"
2021,Abril,Gabón,266,0,1,,1,"(6.171601,-75.427454)"
2021,Abril,Georgia,268,0,1,,1,"(3.541112,-76.384584)"
2021,Abril,Georgia,268,1,3,,4,"(4.697144,-74.140516)"
2021,Abril,Georgia,268,2,2,,4,"(6.171601,-75.427454)"
2021,Abril,Ghana,288,0,2,,2,"(4.697144,-74.140516)"
2021,Abril,Granada,308,0,3,,3,"(4.697144,-74.140516)"
2021,Abril,Granada,308,0,2,,2,"(6.171601,-75.427454)"
2021,Abril,Grecia,300,1,0,,1,"(3.541112,-76.384584)"
2021,Abril,Grecia,300,7,4,,11,"(4.697144,-74.140516)"
2021,Abril,Guatemala,320,0,7,,7,"(1.813928,-78.763924)"
2021,Abril,Guatemala,320,4,2,,6,"(10.445761,-75.516429)"
2021,Abril,Guatemala,320,4,7,,11,"(10.886611,-74.776708)"
2021,Abril,Guatemala,320,0,1,,1,"(12.5744111,-81.703935)"
2021,Abril,Guatemala,320,0,6,,6,"(12.586067,-81.702563)"
2021,Abril,Guatemala,320,37,51,,88,"(3.541112,-76.384584)"
2021,Abril,Guatemala,320,165,338,,503,"(4.697144,-74.140516)"
2021,Abril,Guatemala,320,12,28,,40,"(4.815061,-75.736532)"
2021,Abril,Guatemala,320,66,81,,147,"(6.171601,-75.427454)"
2021,Abril,Guatemala,320,3,3,,6,"(7.128456,-73.183637)"
2021,Abril,Guyana,328,1,1,,2,"(10.886611,-74.776708)"
2021,Abril,Guyana,328,1,0,,1,"(3.541112,-76.384584)"
2021,Abril,Guyana,328,6,9,,15,"(4.697144,-74.140516)"
2021,Abril,Guyana,328,0,1,,1,"(4.815061,-75.736532)"
2021,Abril,Guyana,328,3,3,,6,"(6.171601,-75.427454)"
2021,Abril,Guinea,324,2,2,,4,"(4.697144,-74.140516)"
2021,Abril,Guinea Ecuatorial,226,3,3,,6,"(4.697144,-74.140516)"
2021,Abril,Guinea Bissau,624,1,0,,1,"(4.697144,-74.140516)"
2021,Abril,Guayana Francesa/Departamento de Ultramar Francés,254,1,1,,2,"(4.697144,-74.140516)"
2021,Abril,Haití,332,0,2,,2,"(10.886611,-74.776708)"
2021,Abril,Haití,332,1,4,,5,"(4.697144,-74.140516)"
2021,Abril,Haití,332,0,2,,2,"(6.171601,-75.427454)"
2021,Abril,Honduras,340,0,7,,7,"(10.408582,-75.538003)"
2021,Abril,Honduras,340,0,3,,3,"(10.886611,-74.776708)"
2021,Abril,Honduras,340,6,19,,25,"(3.541112,-76.384584)"
2021,Abril,Honduras,340,32,71,,103,"(4.697144,-74.140516)"
2021,Abril,Honduras,340,18,17,,35,"(6.171601,-75.427454)"
2021,Abril,Honduras,340,0,3,,3,"(7.128456,-73.183637)"
2021,Abril,Hong Kong,344,2,0,,2,"(3.541112,-76.384584)"
2021,Abril,Hungría,348,1,0,,1,"(3.541112,-76.384584)"
2021,Abril,Hungría,348,0,7,,7,"(4.697144,-74.140516)"
2021,Abril,Hungría,348,0,1,,1,"(6.171601,-75.427454)"
2021,Abril,India,356,5,6,,11,"(4.697144,-74.140516)"
2021,Abril,Indonesia,360,0,3,,3,"(4.697144,-74.140516)"
2021,Abril,Iraq,368,0,9,,9,"(4.697144,-74.140516)"
2021,Abril,Iraq,368,0,1,,1,"(6.171601,-75.427454)"
2021,Abril,Irán,364,2,0,,2,"(4.697144,-74.140516)"
2021,Abril,República de Irlanda,372,0,2,,2,"(4.697144,-74.140516)"
2021,Abril,Islandia,352,1,0,,1,"(10.445761,-75.516429)"
2021,Abril,Islandia,352,0,1,,1,"(4.697144,-74.140516)"
2021,Abril,Israel,376,0,1,,1,"(10.445761,-75.516429)"
2021,Abril,Israel,376,2,0,,2,"(3.541112,-76.384584)"
2021,Abril,Israel,376,37,23,,60,"(4.697144,-74.140516)"
2021,Abril,Israel,376,1,0,,1,"(6.171601,-75.427454)"
2021,Abril,Israel,376,1,0,,1,"(7.128456,-73.183637)"
2021,Abril,Italia,380,11,3,,14,"(10.445761,-75.516429)"
2021,Abril,Italia,380,2,0,,2,"(10.886611,-74.776708)"
2021,Abril,Italia,380,28,15,,43,"(3.541112,-76.384584)"
2021,Abril,Italia,380,279,161,,440,"(4.697144,-74.140516)"
2021,Abril,Italia,380,2,0,,2,"(4.815061,-75.736532)"
2021,Abril,Italia,380,27,8,,35,"(6.171601,-75.427454)"
2021,Abril,Jamaica,388,1,4,,5,"(10.445761,-75.516429)"
2021,Abril,Jamaica,388,0,3,,3,"(10.886611,-74.776708)"
2021,Abril,Jamaica,388,0,1,,1,"(3.541112,-76.384584)"
2021,Abril,Jamaica,388,1,6,,7,"(4.697144,-74.140516)"
2021,Abril,Jamaica,388,4,4,,8,"(6.171601,-75.427454)"
2021,Abril,Japón,392,0,1,,1,"(10.445761,-75.516429)"
2021,Abril,Japón,392,1,2,,3,"(3.541112,-76.384584)"
2021,Abril,Japón,392,8,7,,15,"(4.697144,-74.140516)"
2021,Abril,Japón,392,1,4,,5,"(6.171601,-75.427454)"
2021,Abril,Jordania,400,2,1,,3,"(4.697144,-74.140516)"
2021,Abril,Kazajistán,398,1,3,,4,"(4.697144,-74.140516)"
2021,Abril,Kenia,404,1,3,,4,"(4.697144,-74.140516)"
2021,Abril,Lituania,440,1,1,,2,"(4.697144,-74.140516)"
2021,Abril,Líbano,422,0,2,,2,"(10.886611,-74.776708)"
2021,Abril,Líbano,422,14,9,,23,"(4.697144,-74.140516)"
2021,Abril,Luxemburgo,442,1,0,,1,"(3.541112,-76.384584)"
2021,Abril,Luxemburgo,442,7,3,,10,"(4.697144,-74.140516)"
2021,Abril,Macao,446,1,0,,1,"(4.697144,-74.140516)"
2021,Abril,Malawi,454,1,0,,1,"(4.697144,-74.140516)"
2021,Abril,Maldivas,462,3,3,,6,"(4.697144,-74.140516)"
2021,Abril,Malí,466,2,3,,5,"(4.697144,-74.140516)"
2021,Abril,Malta,470,25,18,,43,"(4.697144,-74.140516)"
2021,Abril,Mauritania,478,0,1,,1,"(4.697144,-74.140516)"
2021,Abril,México,484,41,15,,56,"(10.445761,-75.516429)"
2021,Abril,México,484,45,27,,72,"(10.886611,-74.776708)"
2021,Abril,México,484,564,463,,1027,"(3.541112,-76.384584)"
2021,Abril,México,484,6783,6002,,12785,"(4.697144,-74.140516)"
2021,Abril,México,484,55,37,,92,"(4.815061,-75.736532)"
2021,Abril,México,484,2521,1957,,4478,"(6.171601,-75.427454)"
2021,Abril,México,484,16,16,,32,"(7.128456,-73.183637)"
2021,Abril,Montenegro,499,3,2,,5,"(4.697144,-74.140516)"
2021,Abril,Mozambique,508,1,1,,2,"(4.697144,-74.140516)"
2021,Abril,Nepal,524,1,2,,3,"(4.697144,-74.140516)"
2021,Abril,Nicaragua,558,0,5,,5,"(3.541112,-76.384584)"
2021,Abril,Nicaragua,558,18,38,,56,"(4.697144,-74.140516)"
2021,Abril,Nicaragua,558,6,20,,26,"(6.171601,-75.427454)"
2021,Abril,Nigeria,566,1,4,,5,"(4.697144,-74.140516)"
2021,Abril,Noruega,578,6,9,,15,"(4.697144,-74.140516)"
2021,Abril,Nueva Zelanda,554,1,1,,2,"(4.697144,-74.140516)"
2021,Abril,Omán,512,0,3,,3,"(4.697144,-74.140516)"
2021,Abril,Pakistán,586,2,0,,2,"(4.697144,-74.140516)"
2021,Abril,Panamá,591,8,28,,36,"(10.408582,-75.538003)"
2021,Abril,Panamá,591,561,317,,878,"(10.445761,-75.516429)"
2021,Abril,Panamá,591,144,123,,267,"(10.886611,-74.776708)"
2021,Abril,Panamá,591,0,2,,2,"(10.971302,-74.765397)"
2021,Abril,Panamá,591,0,2,,2,"(11.360009,-72.129330)"
2021,Abril,Panamá,591,0,16,,16,"(12.5744111,-81.703935)"
2021,Abril,Panamá,591,770,614,,1384,"(3.541112,-76.384584)"
2021,Abril,Panamá,591,1172,1440,,2612,"(4.697144,-74.140516)"
2021,Abril,Panamá,591,114,74,,188,"(4.815061,-75.736532)"
2021,Abril,Panamá,591,551,504,,1055,"(6.171601,-75.427454)"
2021,Abril,Panamá,591,0,6,,6,"(6.228046,-77.404104)"
2021,Abril,Panamá,591,0,2,,2,"(7.102626,-77.762647)"
2021,Abril,Panamá,591,23,15,,38,"(7.128456,-73.183637)"
2021,Abril,Panamá,591,5,8,,13,"(8.635765,-77.346578)"
2021,Abril,Paraguay,600,1,2,,3,"(10.445761,-75.516429)"
2021,Abril,Paraguay,600,0,3,,3,"(10.886611,-74.776708)"
2021,Abril,Paraguay,600,2,10,,12,"(3.541112,-76.384584)"
2021,Abril,Paraguay,600,33,97,,130,"(4.697144,-74.140516)"
2021,Abril,Paraguay,600,3,4,,7,"(4.815061,-75.736532)"
2021,Abril,Paraguay,600,12,54,,66,"(6.171601,-75.427454)"
2021,Abril,Paraguay,600,0,1,,1,"(7.128456,-73.183637)"
2021,Abril,Perú,604,2,2,,4,"(-4.197703,-69.941278)"
2021,Abril,Perú,604,1,0,,1,"(-4.223468,-69.945098)"
2021,Abril,Perú,604,0,1,,1,"(0.814836,-77.662532)"
2021,Abril,Perú,604,2,4,,6,"(10.445761,-75.516429)"
2021,Abril,Perú,604,16,26,,42,"(3.541112,-76.384584)"
2021,Abril,Perú,604,847,1350,,2197,"(4.697144,-74.140516)"
2021,Abril,Perú,604,12,16,,28,"(4.815061,-75.736532)"
2021,Abril,Perú,604,295,331,,626,"(6.171601,-75.427454)"
2021,Abril,Perú,604,0,2,,2,"(7.128456,-73.183637)"
2021,Abril,Polonia,616,13,22,,35,"(4.697144,-74.140516)"
2021,Abril,Portugal,620,1,2,,3,"(3.541112,-76.384584)"
2021,Abril,Portugal,620,35,44,,79,"(4.697144,-74.140516)"
2021,Abril,Portugal,620,6,2,,8,"(6.171601,-75.427454)"
2021,Abril,Puerto Rico/Territorio de Estados Unidos,630,4,1,,5,"(10.445761,-75.516429)"
2021,Abril,Puerto Rico/Territorio de Estados Unidos,630,0,3,,3,"(10.886611,-74.776708)"
2021,Abril,Puerto Rico/Territorio de Estados Unidos,630,22,15,,37,"(3.541112,-76.384584)"
2021,Abril,Puerto Rico/Territorio de Estados Unidos,630,1,0,,1,"(4.452882,-75.766298)"
2021,Abril,Puerto Rico/Territorio de Estados Unidos,630,68,42,,110,"(4.697144,-74.140516)"
2021,Abril,Puerto Rico/Territorio de Estados Unidos,630,0,2,,2,"(4.815061,-75.736532)"
2021,Abril,Puerto Rico/Territorio de Estados Unidos,630,28,39,,67,"(6.171601,-75.427454)"
2021,Abril,Qatar,634,1,1,,2,"(3.541112,-76.384584)"
2021,Abril,Qatar,634,5,11,,16,"(4.697144,-74.140516)"
2021,Abril,Reino Unido de Gran Bretaña e Irlanda del Norte,826,0,1,,1,"(10.886611,-74.776708)"
2021,Abril,Reino Unido de Gran Bretaña e Irlanda del Norte,826,10,6,,16,"(3.541112,-76.384584)"
2021,Abril,Reino Unido de Gran Bretaña e Irlanda del Norte,826,65,48,,113,"(4.697144,-74.140516)"
2021,Abril,Reino Unido de Gran Bretaña e Irlanda del Norte,826,4,1,,5,"(6.171601,-75.427454)"
2021,Abril,República CentroÁfricana,140,0,1,,1,"(4.697144,-74.140516)"
2021,Abril,Federación de Rusia,643,2,19,,21,"(4.697144,-74.140516)"
2021,Abril,República Dominicana,214,9,10,,19,"(10.445761,-75.516429)"
2021,Abril,República Dominicana,214,17,34,,51,"(10.886611,-74.776708)"
2021,Abril,República Dominicana,214,211,177,,388,"(3.541112,-76.384584)"
2021,Abril,República Dominicana,214,2324,1980,,4304,"(4.697144,-74.140516)"
2021,Abril,República Dominicana,214,6,5,,11,"(4.815061,-75.736532)"
2021,Abril,República Dominicana,214,508,319,,827,"(6.171601,-75.427454)"
2021,Abril,República Dominicana,214,4,3,,7,"(7.128456,-73.183637)"
2021,Abril,Rumania,642,2,3,,5,"(4.697144,-74.140516)"
2021,Abril,Rwanda,646,0,5,,5,"(4.697144,-74.140516)"
2021,Abril,Serbia,688,2,0,,2,"(3.541112,-76.384584)"
2021,Abril,Serbia,688,5,2,,7,"(4.697144,-74.140516)"
2021,Abril,Singapur,702,2,2,,4,"(4.697144,-74.140516)"
2021,Abril,Sri Lanka,144,0,1,,1,"(4.697144,-74.140516)"
2021,Abril,Sudáfrica,710,8,8,,16,"(4.697144,-74.140516)"
2021,Abril,Sudán,736,0,2,,2,"(4.697144,-74.140516)"
2021,Abril,Suecia,752,2,2,,4,"(10.445761,-75.516429)"
2021,Abril,Suecia,752,2,1,,3,"(10.886611,-74.776708)"
2021,Abril,Suecia,752,7,6,,13,"(3.541112,-76.384584)"
2021,Abril,Suecia,752,40,21,,61,"(4.697144,-74.140516)"
2021,Abril,Suecia,752,0,1,,1,"(4.815061,-75.736532)"
2021,Abril,Suecia,752,4,0,,4,"(6.171601,-75.427454)"
2021,Abril,Suiza,756,1,2,,3,"(10.445761,-75.516429)"
2021,Abril,Suiza,756,2,0,,2,"(10.886611,-74.776708)"
2021,Abril,Suiza,756,10,4,,14,"(3.541112,-76.384584)"
2021,Abril,Suiza,756,195,98,,293,"(4.697144,-74.140516)"
2021,Abril,Suiza,756,2,0,,2,"(4.815061,-75.736532)"
2021,Abril,Suiza,756,14,7,,21,"(6.171601,-75.427454)"
2021,Abril,Surinam,740,1,0,,1,"(3.541112,-76.384584)"
2021,Abril,Surinam,740,7,11,,18,"(4.697144,-74.140516)"
2021,Abril,Suazilandia,748,0,21,,21,"(4.697144,-74.140516)"
2021,Abril,Taiwán,158,0,6,,6,"(4.697144,-74.140516)"
2021,Abril,Tailandia,764,1,1,,2,"(4.697144,-74.140516)"
2021,Abril,Túnez,788,1,2,,3,"(4.697144,-74.140516)"
2021,Abril,Turquía,792,0,1,,1,"(10.445761,-75.516429)"
2021,Abril,Turquía,792,1,0,,1,"(3.541112,-76.384584)"
2021,Abril,Turquía,792,353,263,,616,"(4.697144,-74.140516)"
2021,Abril,Turquía,792,2,3,,5,"(6.171601,-75.427454)"
2021,Abril,Ucrania,804,2,14,,16,"(4.697144,-74.140516)"
2021,Abril,Ucrania,804,1,0,,1,"(6.171601,-75.427454)"
2021,Abril,Uganda,800,0,1,,1,"(4.697144,-74.140516)"
2021,Abril,Uruguay,858,7,12,,19,"(3.541112,-76.384584)"
2021,Abril,Uruguay,858,28,65,,93,"(4.697144,-74.140516)"
2021,Abril,Uruguay,858,5,8,,13,"(4.815061,-75.736532)"
2021,Abril,Uruguay,858,4,5,,9,"(6.171601,-75.427454)"
2021,Abril,Venezuela,862,4,0,,4,"(10.445761,-75.516429)"
2021,Abril,Venezuela,862,1,1,,2,"(10.886611,-74.776708)"
2021,Abril,Venezuela,862,0,1,,1,"(10.971302,-74.765397)"
2021,Abril,Venezuela,862,0,170,,170,"(11.360009,-72.129330)"
2021,Abril,Venezuela,862,8,8,,16,"(3.541112,-76.384584)"
2021,Abril,Venezuela,862,53,192,,245,"(4.697144,-74.140516)"
2021,Abril,Venezuela,862,0,1,,1,"(4.815061,-75.736532)"
2021,Abril,Venezuela,862,17,23,,40,"(6.171601,-75.427454)"
2021,Abril,Venezuela,862,1,0,,1,"(7.088729,-70.740253)"
2021,Abril,Venezuela,862,4,9,,13,"(7.818934,-72.453226)"
2021,Abril,Venezuela,862,1,4,,5,"(7.927209,-72.507910)"
2021,Abril,Vietnam,704,0,1,,1,"(4.697144,-74.140516)"
2021,Abril,Islas Vírgenes Británicas/Territorio Británico de Ultramar,92,0,2,,2,"(4.697144,-74.140516)"
2021,Abril,Islas Vírgenes Británicas/Territorio Británico de Ultramar,92,0,1,,1,"(6.171601,-75.427454)"
2021,Abril,Islas Vírgenes Estadounidenses/Territorio de Estados Unidos,850,1,1,,2,"(4.697144,-74.140516)"
2021,Abril,Islas Vírgenes Estadounidenses/Territorio de Estados Unidos,850,0,1,,1,"(6.171601,-75.427454)"
2021,Abril,Zambia,894,2,0,,2,"(4.697144,-74.140516)"
2021,Abril,Islas Turcas y Caicos/Territorio Británico de Ultramar,796,2,3,,5,"(10.445761,-75.516429)"
2021,Abril,Islas Turcas y Caicos/Territorio Británico de Ultramar,796,4,4,,8,"(4.697144,-74.140516)"
2021,Mayo,Afganistán,4,0,4,,4,"(4.697144,-74.140516)"
2021,Mayo,Albania,8,1,2,,3,"(4.697144,-74.140516)"
2021,Mayo,Alemania,276,3,6,,9,"(10.445761,-75.516429)"
2021,Mayo,Alemania,276,7,6,,13,"(10.886611,-74.776708)"
2021,Mayo,Alemania,276,24,9,,33,"(3.541112,-76.384584)"
2021,Mayo,Alemania,276,492,285,,777,"(4.697144,-74.140516)"
2021,Mayo,Alemania,276,1,0,,1,"(4.815061,-75.736532)"
2021,Mayo,Alemania,276,18,12,,30,"(6.171601,-75.427454)"
2021,Mayo,Andorra,20,1,0,,1,"(3.541112,-76.384584)"
2021,Mayo,Andorra,20,3,0,,3,"(4.697144,-74.140516)"
2021,Mayo,Angola,24,0,5,,5,"(4.697144,-74.140516)"
2021,Mayo,Antigua y Barbuda,28,1,0,,1,"(10.886611,-74.776708)"
2021,Mayo,Antigua y Barbuda,28,0,2,,2,"(4.697144,-74.140516)"
2021,Mayo,Países Bajos,528,0,1,,1,"(10.408582,-75.538003)"
2021,Mayo,Países Bajos,528,28,14,,42,"(10.445761,-75.516429)"
2021,Mayo,Países Bajos,528,13,10,,23,"(10.886611,-74.776708)"
2021,Mayo,Países Bajos,528,16,4,,20,"(3.541112,-76.384584)"
2021,Mayo,Países Bajos,528,210,177,,387,"(4.697144,-74.140516)"
2021,Mayo,Países Bajos,528,3,1,,4,"(4.815061,-75.736532)"
2021,Mayo,Países Bajos,528,15,8,,23,"(6.171601,-75.427454)"
2021,Mayo,Países Bajos,528,2,4,,6,"(7.128456,-73.183637)"
2021,Mayo,Arabia Saudita,682,6,26,,32,"(4.697144,-74.140516)"
2021,Mayo,Argelia,12,1,3,,4,"(4.697144,-74.140516)"
2021,Mayo,Argentina,32,6,6,,12,"(10.445761,-75.516429)"
2021,Mayo,Argentina,32,6,4,,10,"(10.886611,-74.776708)"
2021,Mayo,Argentina,32,18,10,,28,"(3.541112,-76.384584)"
2021,Mayo,Argentina,32,569,481,,1050,"(4.697144,-74.140516)"
2021,Mayo,Argentina,32,5,6,,11,"(4.815061,-75.736532)"
2021,Mayo,Argentina,32,13,48,,61,"(6.171601,-75.427454)"
2021,Mayo,República de Armenia,51,0,3,,3,"(4.697144,-74.140516)"
2021,Mayo,Aruba,533,2,5,,7,"(11.117806,-74.232622)"
2021,Mayo,Aruba,533,29,16,,45,"(3.541112,-76.384584)"
2021,Mayo,Aruba,533,882,629,,1511,"(4.697144,-74.140516)"
2021,Mayo,Aruba,533,43,39,,82,"(6.171601,-75.427454)"
2021,Mayo,Aruba,533,2,14,,16,"(7.128456,-73.183637)"
2021,Mayo,Australia,36,0,1,,1,"(3.541112,-76.384584)"
2021,Mayo,Australia,36,4,7,,11,"(4.697144,-74.140516)"
2021,Mayo,Australia,36,2,0,,2,"(6.171601,-75.427454)"
2021,Mayo,Austria,40,1,0,,1,"(10.445761,-75.516429)"
2021,Mayo,Austria,40,26,14,,40,"(4.697144,-74.140516)"
2021,Mayo,Austria,40,2,1,,3,"(6.171601,-75.427454)"
2021,Mayo,Azerbaiyán,31,2,1,,3,"(4.697144,-74.140516)"
2021,Mayo,Bahamas,44,4,12,,16,"(10.886611,-74.776708)"
2021,Mayo,Bahamas,44,15,35,,50,"(3.541112,-76.384584)"
2021,Mayo,Bahamas,44,13,19,,32,"(4.697144,-74.140516)"
2021,Mayo,Bahamas,44,1,6,,7,"(6.171601,-75.427454)"
2021,Mayo,Bahréin,48,10,3,,13,"(4.697144,-74.140516)"
2021,Mayo,Barbados,52,2,8,,10,"(4.697144,-74.140516)"
2021,Mayo,República de Belarús,112,0,2,,2,"(4.697144,-74.140516)"
2021,Mayo,Bélgica,56,1,1,,2,"(10.445761,-75.516429)"
2021,Mayo,Bélgica,56,1,0,,1,"(10.886611,-74.776708)"
2021,Mayo,Bélgica,56,0,2,,2,"(3.541112,-76.384584)"
2021,Mayo,Bélgica,56,51,28,,79,"(4.697144,-74.140516)"
2021,Mayo,Bélgica,56,7,5,,12,"(6.171601,-75.427454)"
2021,Mayo,Belice,84,3,4,,7,"(4.697144,-74.140516)"
2021,Mayo,Belice,84,1,1,,2,"(6.171601,-75.427454)"
2021,Mayo,Benín,204,1,0,,1,"(4.697144,-74.140516)"
2021,Mayo,Bermudas/Territorio Británico de Ultramar,60,2,3,,5,"(6.171601,-75.427454)"
2021,Mayo,Bolivia,68,0,3,,3,"(10.445761,-75.516429)"
2021,Mayo,Bolivia,68,0,4,,4,"(10.886611,-74.776708)"
2021,Mayo,Bolivia,68,14,51,,65,"(3.541112,-76.384584)"
2021,Mayo,Bolivia,68,84,176,,260,"(4.697144,-74.140516)"
2021,Mayo,Bolivia,68,8,14,,22,"(4.815061,-75.736532)"
2021,Mayo,Bolivia,68,15,23,,38,"(6.171601,-75.427454)"
2021,Mayo,Brasil,76,23,31,,54,"(-4.197703,-69.941278)"
2021,Mayo,Brasil,76,3,9,,12,"(10.445761,-75.516429)"
2021,Mayo,Brasil,76,7,37,,44,"(10.886611,-74.776708)"
2021,Mayo,Brasil,76,29,53,,82,"(3.541112,-76.384584)"
2021,Mayo,Brasil,76,117,255,,372,"(4.697144,-74.140516)"
2021,Mayo,Brasil,76,49,80,,129,"(4.815061,-75.736532)"
2021,Mayo,Brasil,76,44,50,,94,"(6.171601,-75.427454)"
2021,Mayo,Bulgaria,100,5,2,,7,"(4.697144,-74.140516)"
2021,Mayo,Burkina Faso,854,0,1,,1,"(10.886611,-74.776708)"
2021,Mayo,Burkina Faso,854,0,3,,3,"(4.697144,-74.140516)"
2021,Mayo,Cabo Verde,132,2,2,,4,"(4.697144,-74.140516)"
2021,Mayo,Islas Caimán/Territorio Británico de Ultramar,136,1,0,,1,"(10.886611,-74.776708)"
2021,Mayo,Islas Caimán/Territorio Británico de Ultramar,136,1,1,,2,"(4.697144,-74.140516)"
2021,Mayo,Camerún,120,1,0,,1,"(4.697144,-74.140516)"
2021,Mayo,Canadá,124,12,8,,20,"(10.445761,-75.516429)"
2021,Mayo,Canadá,124,12,18,,30,"(10.886611,-74.776708)"
2021,Mayo,Canadá,124,74,46,,120,"(3.541112,-76.384584)"
2021,Mayo,Canadá,124,664,604,,1268,"(4.697144,-74.140516)"
2021,Mayo,Canadá,124,7,7,,14,"(4.815061,-75.736532)"
2021,Mayo,Canadá,124,102,105,,207,"(6.171601,-75.427454)"
2021,Mayo,Canadá,124,1,2,,3,"(7.128456,-73.183637)"
2021,Mayo,España,724,11,10,,21,"(10.445761,-75.516429)"
2021,Mayo,España,724,3,22,,25,"(10.886611,-74.776708)"
2021,Mayo,España,724,43,35,,78,"(3.541112,-76.384584)"
2021,Mayo,España,724,3599,2469,,6068,"(4.697144,-74.140516)"
2021,Mayo,España,724,4,2,,6,"(4.815061,-75.736532)"
2021,Mayo,España,724,145,95,,240,"(6.171601,-75.427454)"
2021,Mayo,España,724,0,1,,1,"(7.128456,-73.183637)"
2021,Mayo,Colombia,170,1,0,,1,"(10.445761,-75.516429)"
2021,Mayo,Colombia,170,32,58,,90,"(4.697144,-74.140516)"
2021,Mayo,República Del Congo,178,0,1,,1,"(4.697144,-74.140516)"
2021,Mayo,República de Corea,410,4,3,,7,"(4.697144,-74.140516)"
2021,Mayo,República de Corea,410,0,1,,1,"(6.171601,-75.427454)"
2021,Mayo,Costa de Marfil,384,1,2,,3,"(4.697144,-74.140516)"
2021,Mayo,Costa de Marfil,384,0,2,,2,"(6.171601,-75.427454)"
2021,Mayo,Costa Rica,188,2,3,,5,"(10.445761,-75.516429)"
2021,Mayo,Costa Rica,188,4,9,,13,"(10.886611,-74.776708)"
2021,Mayo,Costa Rica,188,7,63,,70,"(12.5744111,-81.703935)"
2021,Mayo,Costa Rica,188,30,28,,58,"(3.541112,-76.384584)"
2021,Mayo,Costa Rica,188,314,407,,721,"(4.697144,-74.140516)"
2021,Mayo,Costa Rica,188,10,11,,21,"(4.815061,-75.736532)"
2021,Mayo,Costa Rica,188,71,57,,128,"(6.171601,-75.427454)"
2021,Mayo,Croacia,191,8,10,,18,"(4.697144,-74.140516)"
2021,Mayo,Cuba,192,0,20,,20,"(10.886611,-74.776708)"
2021,Mayo,Cuba,192,1,0,,1,"(3.541112,-76.384584)"
2021,Mayo,Cuba,192,54,68,,122,"(4.697144,-74.140516)"
2021,Mayo,Curazao,99999,24,24,,48,"(10.886611,-74.776708)"
2021,Mayo,Curazao,99999,3,4,,7,"(3.541112,-76.384584)"
2021,Mayo,Curazao,99999,142,155,,297,"(4.697144,-74.140516)"
2021,Mayo,Curazao,99999,2,2,,4,"(6.171601,-75.427454)"
2021,Mayo,República Checa,203,2,2,,4,"(4.697144,-74.140516)"
2021,Mayo,República Checa,203,1,0,,1,"(6.171601,-75.427454)"
2021,Mayo,Chile,152,4,2,,6,"(10.445761,-75.516429)"
2021,Mayo,Chile,152,75,37,,112,"(3.541112,-76.384584)"
2021,Mayo,Chile,152,393,270,,663,"(4.697144,-74.140516)"
2021,Mayo,Chile,152,22,16,,38,"(4.815061,-75.736532)"
2021,Mayo,Chile,152,37,60,,97,"(6.171601,-75.427454)"
2021,Mayo,China,156,4,12,,16,"(4.697144,-74.140516)"
2021,Mayo,Chipre,196,4,6,,10,"(4.697144,-74.140516)"
2021,Mayo,Dinamarca,208,1,0,,1,"(3.541112,-76.384584)"
2021,Mayo,Dinamarca,208,16,6,,22,"(4.697144,-74.140516)"
2021,Mayo,Dinamarca,208,5,1,,6,"(6.171601,-75.427454)"
2021,Mayo,Dominica,212,5,6,,11,"(4.697144,-74.140516)"
2021,Mayo,Dominica,212,0,1,,1,"(6.171601,-75.427454)"
2021,Mayo,Ecuador,218,7,6,,13,"(0.814836,-77.662532)"
2021,Mayo,Ecuador,218,0,1,,1,"(10.408582,-75.538003)"
2021,Mayo,Ecuador,218,0,1,,1,"(10.445761,-75.516429)"
2021,Mayo,Ecuador,218,5,76,,81,"(10.886611,-74.776708)"
2021,Mayo,Ecuador,218,32,41,,73,"(3.541112,-76.384584)"
2021,Mayo,Ecuador,218,969,1565,,2534,"(4.697144,-74.140516)"
2021,Mayo,Ecuador,218,3,8,,11,"(4.815061,-75.736532)"
2021,Mayo,Ecuador,218,39,53,,92,"(6.171601,-75.427454)"
2021,Mayo,Ecuador,218,1,4,,5,"(7.128456,-73.183637)"
2021,Mayo,Egipto,818,21,31,,52,"(4.697144,-74.140516)"
2021,Mayo,El Salvador,222,0,1,,1,"(10.445761,-75.516429)"
2021,Mayo,El Salvador,222,0,1,,1,"(10.886611,-74.776708)"
2021,Mayo,El Salvador,222,8,12,,20,"(3.541112,-76.384584)"
2021,Mayo,El Salvador,222,127,197,,324,"(4.697144,-74.140516)"
2021,Mayo,El Salvador,222,12,16,,28,"(6.171601,-75.427454)"
2021,Mayo,Emiratos Árabes,784,1,0,,1,"(10.445761,-75.516429)"
2021,Mayo,Emiratos Árabes,784,4,0,,4,"(3.541112,-76.384584)"
2021,Mayo,Emiratos Árabes,784,141,325,,466,"(4.697144,-74.140516)"
2021,Mayo,Emiratos Árabes,784,1,0,,1,"(4.815061,-75.736532)"
2021,Mayo,Emiratos Árabes,784,2,9,,11,"(6.171601,-75.427454)"
2021,Mayo,Eslovaquia,703,0,2,,2,"(4.697144,-74.140516)"
2021,Mayo,Eslovenia,705,4,3,,7,"(4.697144,-74.140516)"
2021,Mayo,Estados Unidos de América,840,6912,6228,,13141,"(10.445761,-75.516429)"
2021,Mayo,Estados Unidos de América,840,5282,4645,,9927,"(10.886611,-74.776708)"
2021,Mayo,Estados Unidos de América,840,22,28,,50,"(11.117806,-74.232622)"
2021,Mayo,Estados Unidos de América,840,6731,5026,,11758,"(3.541112,-76.384584)"
2021,Mayo,Estados Unidos de América,840,1245,1013,,2258,"(4.452882,-75.766298)"
2021,Mayo,Estados Unidos de América,840,44484,38961,,83445,"(4.697144,-74.140516)"
2021,Mayo,Estados Unidos de América,840,1816,1332,,3148,"(4.815061,-75.736532)"
2021,Mayo,Estados Unidos de América,840,22137,18459,,40596,"(6.171601,-75.427454)"
2021,Mayo,Estados Unidos de América,840,1048,950,,1998,"(7.128456,-73.183637)"
2021,Mayo,Estonia,233,3,0,,3,"(4.697144,-74.140516)"
2021,Mayo,Etiopia,231,0,5,,5,"(4.697144,-74.140516)"
2021,Mayo,Filipinas,608,1,4,,5,"(4.697144,-74.140516)"
2021,Mayo,Finlandia,246,7,11,,18,"(4.697144,-74.140516)"
2021,Mayo,Finlandia,246,1,0,,1,"(6.171601,-75.427454)"
2021,Mayo,Francia,250,1,1,,2,"(10.408582,-75.538003)"
2021,Mayo,Francia,250,4,1,,5,"(10.445761,-75.516429)"
2021,Mayo,Francia,250,1,0,,1,"(10.886611,-74.776708)"
2021,Mayo,Francia,250,12,5,,17,"(3.541112,-76.384584)"
2021,Mayo,Francia,250,406,309,,715,"(4.697144,-74.140516)"
2021,Mayo,Francia,250,2,1,,3,"(4.815061,-75.736532)"
2021,Mayo,Francia,250,9,16,,25,"(6.171601,-75.427454)"
2021,Mayo,Gabón,266,0,1,,1,"(4.697144,-74.140516)"
2021,Mayo,Georgia,268,1,0,,1,"(10.445761,-75.516429)"
2021,Mayo,Georgia,268,1,0,,1,"(3.541112,-76.384584)"
2021,Mayo,Georgia,268,2,2,,4,"(4.697144,-74.140516)"
2021,Mayo,Georgia,268,1,0,,1,"(6.171601,-75.427454)"
2021,Mayo,Ghana,288,1,3,,4,"(4.697144,-74.140516)"
2021,Mayo,Granada,308,1,14,,15,"(3.541112,-76.384584)"
2021,Mayo,Grecia,300,0,1,,1,"(3.541112,-76.384584)"
2021,Mayo,Grecia,300,6,5,,11,"(4.697144,-74.140516)"
2021,Mayo,Guatemala,320,1,2,,3,"(10.445761,-75.516429)"
2021,Mayo,Guatemala,320,14,6,,20,"(10.886611,-74.776708)"
2021,Mayo,Guatemala,320,39,36,,75,"(3.541112,-76.384584)"
2021,Mayo,Guatemala,320,186,284,,470,"(4.697144,-74.140516)"
2021,Mayo,Guatemala,320,11,20,,31,"(4.815061,-75.736532)"
2021,Mayo,Guatemala,320,73,96,,169,"(6.171601,-75.427454)"
2021,Mayo,Guyana,328,1,0,,1,"(10.886611,-74.776708)"
2021,Mayo,Guyana,328,2,0,,2,"(3.541112,-76.384584)"
2021,Mayo,Guyana,328,4,5,,9,"(4.697144,-74.140516)"
2021,Mayo,Guyana,328,1,6,,7,"(6.171601,-75.427454)"
2021,Mayo,Guinea,324,0,1,,1,"(4.697144,-74.140516)"
2021,Mayo,Guinea Ecuatorial,226,5,4,,9,"(4.697144,-74.140516)"
2021,Mayo,Haití,332,1,3,,4,"(4.697144,-74.140516)"
2021,Mayo,Haití,332,0,1,,1,"(6.171601,-75.427454)"
2021,Mayo,Honduras,340,0,8,,8,"(10.408582,-75.538003)"
2021,Mayo,Honduras,340,1,1,,2,"(10.445761,-75.516429)"
2021,Mayo,Honduras,340,1,6,,7,"(10.886611,-74.776708)"
2021,Mayo,Honduras,340,4,5,,9,"(3.541112,-76.384584)"
2021,Mayo,Honduras,340,52,83,,135,"(4.697144,-74.140516)"
2021,Mayo,Honduras,340,8,30,,38,"(6.171601,-75.427454)"
2021,Mayo,Hong Kong,344,1,0,,1,"(4.697144,-74.140516)"
2021,Mayo,Hungría,348,1,0,,1,"(10.886611,-74.776708)"
2021,Mayo,Hungría,348,4,6,,10,"(4.697144,-74.140516)"
2021,Mayo,India,356,2,1,,3,"(4.697144,-74.140516)"
2021,Mayo,Indonesia,360,2,1,,3,"(10.445761,-75.516429)"
2021,Mayo,Indonesia,360,2,4,,6,"(4.697144,-74.140516)"
2021,Mayo,Iraq,368,0,4,,4,"(4.697144,-74.140516)"
2021,Mayo,República de Irlanda,372,1,0,,1,"(10.445761,-75.516429)"
2021,Mayo,República de Irlanda,372,1,1,,2,"(4.697144,-74.140516)"
2021,Mayo,República de Irlanda,372,0,2,,2,"(6.171601,-75.427454)"
2021,Mayo,Islandia,352,0,1,,1,"(4.697144,-74.140516)"
2021,Mayo,Islandia,352,0,1,,1,"(6.171601,-75.427454)"
2021,Mayo,Israel,376,1,0,,1,"(3.541112,-76.384584)"
2021,Mayo,Israel,376,35,21,,56,"(4.697144,-74.140516)"
2021,Mayo,Israel,376,0,1,,1,"(6.171601,-75.427454)"
2021,Mayo,Italia,380,5,2,,7,"(10.445761,-75.516429)"
2021,Mayo,Italia,380,2,1,,3,"(10.886611,-74.776708)"
2021,Mayo,Italia,380,29,8,,37,"(3.541112,-76.384584)"
2021,Mayo,Italia,380,360,220,,580,"(4.697144,-74.140516)"
2021,Mayo,Italia,380,1,0,,1,"(4.815061,-75.736532)"
2021,Mayo,Italia,380,27,17,,44,"(6.171601,-75.427454)"
2021,Mayo,Jamaica,388,0,3,,3,"(10.445761,-75.516429)"
2021,Mayo,Jamaica,388,2,0,,2,"(3.541112,-76.384584)"
2021,Mayo,Jamaica,388,0,4,,4,"(4.697144,-74.140516)"
2021,Mayo,Japón,392,8,4,,12,"(4.697144,-74.140516)"
2021,Mayo,Japón,392,0,1,,1,"(6.171601,-75.427454)"
2021,Mayo,Jordania,400,0,4,,4,"(4.697144,-74.140516)"
2021,Mayo,Kazajistán,398,1,0,,1,"(6.171601,-75.427454)"
2021,Mayo,Kenia,404,1,3,,4,"(4.697144,-74.140516)"
2021,Mayo,Kuwait,414,1,1,,2,"(4.697144,-74.140516)"
2021,Mayo,Líbano,422,4,1,,5,"(10.886611,-74.776708)"
2021,Mayo,Líbano,422,25,18,,43,"(4.697144,-74.140516)"
2021,Mayo,Liechtenstein,438,0,1,,1,"(3.541112,-76.384584)"
2021,Mayo,Luxemburgo,442,9,2,,11,"(4.697144,-74.140516)"
2021,Mayo,Luxemburgo,442,1,0,,1,"(6.171601,-75.427454)"
2021,Mayo,Macedonia,807,1,0,,1,"(4.697144,-74.140516)"
2021,Mayo,Malasia,458,3,3,,6,"(4.697144,-74.140516)"
2021,Mayo,Malawi,454,1,0,,1,"(4.697144,-74.140516)"
2021,Mayo,Maldivas,462,0,1,,1,"(10.445761,-75.516429)"
2021,Mayo,Maldivas,462,1,2,,3,"(4.697144,-74.140516)"
2021,Mayo,Malí,466,2,0,,2,"(4.697144,-74.140516)"
2021,Mayo,Malta,470,41,33,,74,"(4.697144,-74.140516)"
2021,Mayo,Mauritania,478,0,6,,6,"(4.697144,-74.140516)"
2021,Mayo,Martinica/Departamento de Ultramar Francés,474,0,1,,1,"(10.408582,-75.538003)"
2021,Mayo,México,484,42,27,,69,"(10.445761,-75.516429)"
2021,Mayo,México,484,39,23,,62,"(10.886611,-74.776708)"
2021,Mayo,México,484,0,10,,10,"(12.586067,-81.702563)"
2021,Mayo,México,484,691,516,,1207,"(3.541112,-76.384584)"
2021,Mayo,México,484,7613,6933,,14546,"(4.697144,-74.140516)"
2021,Mayo,México,484,88,66,,154,"(4.815061,-75.736532)"
2021,Mayo,México,484,0,2,,2,"(6.17134,-75.427194)"
2021,Mayo,México,484,3153,2430,,5583,"(6.171601,-75.427454)"
2021,Mayo,Mónaco,492,1,0,,1,"(6.171601,-75.427454)"
2021,Mayo,Montenegro,499,4,1,,5,"(4.697144,-74.140516)"
2021,Mayo,Mozambique,508,1,2,,3,"(4.697144,-74.140516)"
2021,Mayo,Nicaragua,558,5,2,,7,"(12.5744111,-81.703935)"
2021,Mayo,Nicaragua,558,1,1,,2,"(3.541112,-76.384584)"
2021,Mayo,Nicaragua,558,22,48,,70,"(4.697144,-74.140516)"
2021,Mayo,Nicaragua,558,4,11,,15,"(6.171601,-75.427454)"
2021,Mayo,Nigeria,566,1,2,,3,"(4.697144,-74.140516)"
2021,Mayo,Noruega,578,0,1,,1,"(3.541112,-76.384584)"
2021,Mayo,Noruega,578,7,6,,13,"(4.697144,-74.140516)"
2021,Mayo,Nueva Zelanda,554,1,0,,1,"(3.541112,-76.384584)"
2021,Mayo,Nueva Zelanda,554,3,2,,5,"(4.697144,-74.140516)"
2021,Mayo,Omán,512,2,3,,5,"(4.697144,-74.140516)"
2021,Mayo,Panamá,591,3,17,,20,"(10.408582,-75.538003)"
2021,Mayo,Panamá,591,485,350,,835,"(10.445761,-75.516429)"
2021,Mayo,Panamá,591,143,145,,288,"(10.886611,-74.776708)"
2021,Mayo,Panamá,591,0,1,,1,"(10.971302,-74.765397)"
2021,Mayo,Panamá,591,0,2,,2,"(11.360009,-72.129330)"
2021,Mayo,Panamá,591,1,8,,9,"(12.5744111,-81.703935)"
2021,Mayo,Panamá,591,0,8,,8,"(12.586067,-81.702563)"
2021,Mayo,Panamá,591,534,379,,913,"(3.541112,-76.384584)"
2021,Mayo,Panamá,591,1374,1666,,3040,"(4.697144,-74.140516)"
2021,Mayo,Panamá,591,163,107,,270,"(4.815061,-75.736532)"
2021,Mayo,Panamá,591,511,453,,964,"(6.171601,-75.427454)"
2021,Mayo,Panamá,591,0,1,,1,"(7.102626,-77.762647)"
2021,Mayo,Panamá,591,9,12,,21,"(8.635765,-77.346578)"
2021,Mayo,Paraguay,600,11,40,,51,"(3.541112,-76.384584)"
2021,Mayo,Paraguay,600,29,213,,242,"(4.697144,-74.140516)"
2021,Mayo,Paraguay,600,1,0,,1,"(4.815061,-75.736532)"
2021,Mayo,Paraguay,600,2,2,,4,"(6.171601,-75.427454)"
2021,Mayo,Perú,604,2,2,,4,"(-4.197703,-69.941278)"
2021,Mayo,Perú,604,3,1,,4,"(10.445761,-75.516429)"
2021,Mayo,Perú,604,7,2,,9,"(10.886611,-74.776708)"
2021,Mayo,Perú,604,14,64,,78,"(3.541112,-76.384584)"
2021,Mayo,Perú,604,1147,1461,,2608,"(4.697144,-74.140516)"
2021,Mayo,Perú,604,20,23,,43,"(4.815061,-75.736532)"
2021,Mayo,Perú,604,303,309,,612,"(6.171601,-75.427454)"
2021,Mayo,Polonia,616,0,1,,1,"(10.445761,-75.516429)"
2021,Mayo,Polonia,616,20,35,,55,"(4.697144,-74.140516)"
2021,Mayo,Portugal,620,1,1,,2,"(10.445761,-75.516429)"
2021,Mayo,Portugal,620,35,55,,90,"(4.697144,-74.140516)"
2021,Mayo,Portugal,620,3,2,,5,"(6.171601,-75.427454)"
2021,Mayo,Polinesia Francesa/Colectividad de Ultramar Francesa,258,1,0,,1,"(3.541112,-76.384584)"
2021,Mayo,Puerto Rico/Territorio de Estados Unidos,630,1,5,,6,"(10.445761,-75.516429)"
2021,Mayo,Puerto Rico/Territorio de Estados Unidos,630,8,6,,14,"(10.886611,-74.776708)"
2021,Mayo,Puerto Rico/Territorio de Estados Unidos,630,15,13,,28,"(3.541112,-76.384584)"
2021,Mayo,Puerto Rico/Territorio de Estados Unidos,630,1,1,,2,"(4.452882,-75.766298)"
2021,Mayo,Puerto Rico/Territorio de Estados Unidos,630,48,58,,106,"(4.697144,-74.140516)"
2021,Mayo,Puerto Rico/Territorio de Estados Unidos,630,3,1,,4,"(4.815061,-75.736532)"
2021,Mayo,Puerto Rico/Territorio de Estados Unidos,630,36,33,,69,"(6.171601,-75.427454)"
2021,Mayo,Qatar,634,7,6,,13,"(4.697144,-74.140516)"
2021,Mayo,Qatar,634,1,0,,1,"(6.171601,-75.427454)"
2021,Mayo,Reino Unido de Gran Bretaña e Irlanda del Norte,826,3,0,,3,"(3.541112,-76.384584)"
2021,Mayo,Reino Unido de Gran Bretaña e Irlanda del Norte,826,66,65,,131,"(4.697144,-74.140516)"
2021,Mayo,Reino Unido de Gran Bretaña e Irlanda del Norte,826,4,5,,9,"(6.171601,-75.427454)"
2021,Mayo,Federación de Rusia,643,0,1,,1,"(10.886611,-74.776708)"
2021,Mayo,Federación de Rusia,643,6,15,,21,"(4.697144,-74.140516)"
2021,Mayo,República Dominicana,214,4,10,,14,"(10.445761,-75.516429)"
2021,Mayo,República Dominicana,214,20,26,,46,"(10.886611,-74.776708)"
2021,Mayo,República Dominicana,214,4,10,,14,"(11.117806,-74.232622)"
2021,Mayo,República Dominicana,214,200,152,,352,"(3.541112,-76.384584)"
2021,Mayo,República Dominicana,214,2569,2073,,4642,"(4.697144,-74.140516)"
2021,Mayo,República Dominicana,214,14,18,,32,"(4.815061,-75.736532)"
2021,Mayo,República Dominicana,214,738,517,,1255,"(6.171601,-75.427454)"
2021,Mayo,Reunión,638,1,0,,1,"(10.886611,-74.776708)"
2021,Mayo,Rumania,642,8,5,,13,"(4.697144,-74.140516)"
2021,Mayo,San Pedro y Miquelón/territorio de Ultramar de La Unión Europea,666,1,0,,1,"(4.697144,-74.140516)"
2021,Mayo,Senegal,686,0,1,,1,"(4.697144,-74.140516)"
2021,Mayo,Serbia,688,3,0,,3,"(4.697144,-74.140516)"
2021,Mayo,Singapur,702,0,1,,1,"(4.697144,-74.140516)"
2021,Mayo,Somalia,706,0,1,,1,"(4.697144,-74.140516)"
2021,Mayo,Sri Lanka,144,2,0,,2,"(4.697144,-74.140516)"
2021,Mayo,Sudáfrica,710,8,0,,8,"(4.697144,-74.140516)"
2021,Mayo,Suecia,752,6,3,,9,"(3.541112,-76.384584)"
2021,Mayo,Suecia,752,27,19,,46,"(4.697144,-74.140516)"
2021,Mayo,Suecia,752,1,2,,3,"(4.815061,-75.736532)"
2021,Mayo,Suecia,752,7,3,,10,"(6.171601,-75.427454)"
2021,Mayo,Suiza,756,2,1,,3,"(10.445761,-75.516429)"
2021,Mayo,Suiza,756,4,0,,4,"(10.886611,-74.776708)"
2021,Mayo,Suiza,756,10,2,,12,"(3.541112,-76.384584)"
2021,Mayo,Suiza,756,174,104,,278,"(4.697144,-74.140516)"
2021,Mayo,Suiza,756,0,2,,2,"(4.815061,-75.736532)"
2021,Mayo,Suiza,756,9,2,,11,"(6.171601,-75.427454)"
2021,Mayo,Surinam,740,1,3,,4,"(4.697144,-74.140516)"
2021,Mayo,Surinam,740,0,2,,2,"(6.171601,-75.427454)"
2021,Mayo,Tailandia,764,1,3,,4,"(4.697144,-74.140516)"
2021,Mayo,Tanzania,834,1,1,,2,"(4.697144,-74.140516)"
2021,Mayo,Trinidad y Tobago,780,0,1,,1,"(3.541112,-76.384584)"
2021,Mayo,Túnez,788,0,1,,1,"(4.697144,-74.140516)"
2021,Mayo,Turquía,792,2,0,,2,"(10.445761,-75.516429)"
2021,Mayo,Turquía,792,4,2,,6,"(10.886611,-74.776708)"
2021,Mayo,Turquía,792,0,1,,1,"(3.541112,-76.384584)"
2021,Mayo,Turquía,792,383,293,,676,"(4.697144,-74.140516)"
2021,Mayo,Turquía,792,2,0,,2,"(6.171601,-75.427454)"
2021,Mayo,Ucrania,804,7,13,,20,"(4.697144,-74.140516)"
2021,Mayo,Uganda,800,0,1,,1,"(4.697144,-74.140516)"
2021,Mayo,Uruguay,858,0,10,,10,"(10.445761,-75.516429)"
2021,Mayo,Uruguay,858,1,0,,1,"(10.886611,-74.776708)"
2021,Mayo,Uruguay,858,8,11,,19,"(3.541112,-76.384584)"
2021,Mayo,Uruguay,858,16,38,,54,"(4.697144,-74.140516)"
2021,Mayo,Uruguay,858,2,5,,7,"(4.815061,-75.736532)"
2021,Mayo,Uruguay,858,4,11,,15,"(6.171601,-75.427454)"
2021,Mayo,Uzbekistán,860,2,5,,7,"(4.697144,-74.140516)"
2021,Mayo,Venezuela,862,0,128,,128,"(11.360009,-72.129330)"
2021,Mayo,Venezuela,862,13,47,,60,"(3.541112,-76.384584)"
2021,Mayo,Venezuela,862,88,218,,306,"(4.697144,-74.140516)"
2021,Mayo,Venezuela,862,28,36,,64,"(6.171601,-75.427454)"
2021,Mayo,Venezuela,862,1,37,,38,"(7.818934,-72.453226)"
2021,Mayo,Islas Vírgenes Británicas/Territorio Británico de Ultramar,92,1,0,,1,"(4.697144,-74.140516)"
2021,Mayo,Islas Vírgenes Británicas/Territorio Británico de Ultramar,92,1,0,,1,"(6.171601,-75.427454)"
2021,Mayo,Islas Vírgenes Estadounidenses/Territorio de Estados Unidos,850,2,0,,2,"(3.541112,-76.384584)"
2021,Mayo,Islas Vírgenes Estadounidenses/Territorio de Estados Unidos,850,2,1,,3,"(4.697144,-74.140516)"
2021,Mayo,Zambia,894,0,1,,1,"(4.697144,-74.140516)"
2021,Mayo,Zimbabue,716,0,1,,1,"(4.697144,-74.140516)"
2021,Mayo,Islas Turcas y Caicos/Territorio Británico de Ultramar,796,1,2,,3,"(10.445761,-75.516429)"
2021,Mayo,Islas Turcas y Caicos/Territorio Británico de Ultramar,796,6,11,,17,"(10.886611,-74.776708)"
2021,Mayo,Islas Turcas y Caicos/Territorio Británico de Ultramar,796,1,0,,1,"(4.697144,-74.140516)"
2021,Mayo,Islas Turcas y Caicos/Territorio Británico de Ultramar,796,0,1,,1,"(6.171601,-75.427454)"
2021,Mayo,Desconocido,99999,5,1,,6,"(4.697144,-74.140516)"
2021,Mayo,Desconocido,99999,2,1,,3,"(6.171601,-75.427454)"
2021,Junio,Afganistán,4,0,8,,8,"(4.697144,-74.140516)"
2021,Junio,Alemania,276,13,8,,21,"(10.445761,-75.516429)"
2021,Junio,Alemania,276,3,2,,5,"(10.886611,-74.776708)"
2021,Junio,Alemania,276,19,12,,31,"(3.541112,-76.384584)"
2021,Junio,Alemania,276,620,372,,992,"(4.697144,-74.140516)"
2021,Junio,Alemania,276,2,1,,3,"(4.815061,-75.736532)"
2021,Junio,Alemania,276,34,21,,55,"(6.171601,-75.427454)"
2021,Junio,Alemania,276,0,1,,1,"(7.128456,-73.183637)"
2021,Junio,Andorra,20,3,3,,6,"(4.697144,-74.140516)"
2021,Junio,Andorra,20,1,1,,2,"(6.171601,-75.427454)"
2021,Junio,Angola,24,0,8,,8,"(4.697144,-74.140516)"
2021,Junio,Antigua y Barbuda,28,1,0,,1,"(3.541112,-76.384584)"
2021,Junio,Antigua y Barbuda,28,1,2,,3,"(4.697144,-74.140516)"
2021,Junio,Antigua y Barbuda,28,0,1,,1,"(4.815061,-75.736532)"
2021,Junio,Países Bajos,528,0,2,,2,"(10.408582,-75.538003)"
2021,Junio,Países Bajos,528,88,49,,137,"(10.445761,-75.516429)"
2021,Junio,Países Bajos,528,14,10,,24,"(10.886611,-74.776708)"
2021,Junio,Países Bajos,528,18,6,,24,"(3.541112,-76.384584)"
2021,Junio,Países Bajos,528,455,362,,817,"(4.697144,-74.140516)"
2021,Junio,Países Bajos,528,3,0,,3,"(4.815061,-75.736532)"
2021,Junio,Países Bajos,528,29,21,,50,"(6.171601,-75.427454)"
2021,Junio,Países Bajos,528,1,0,,1,"(7.128456,-73.183637)"
2021,Junio,Arabia Saudita,682,0,1,,1,"(3.541112,-76.384584)"
2021,Junio,Arabia Saudita,682,7,28,,35,"(4.697144,-74.140516)"
2021,Junio,Arabia Saudita,682,1,0,,1,"(6.171601,-75.427454)"
2021,Junio,Argelia,12,0,2,,2,"(4.697144,-74.140516)"
2021,Junio,Argentina,32,2,1,,3,"(10.445761,-75.516429)"
2021,Junio,Argentina,32,5,2,,7,"(10.886611,-74.776708)"
2021,Junio,Argentina,32,9,8,,17,"(3.541112,-76.384584)"
2021,Junio,Argentina,32,346,334,,680,"(4.697144,-74.140516)"
2021,Junio,Argentina,32,1,0,,1,"(4.815061,-75.736532)"
2021,Junio,Argentina,32,7,7,,14,"(6.171601,-75.427454)"
2021,Junio,República de Armenia,51,2,1,,3,"(4.697144,-74.140516)"
2021,Junio,Aruba,533,0,1,,1,"(10.408582,-75.538003)"
2021,Junio,Aruba,533,8,9,,17,"(10.886611,-74.776708)"
2021,Junio,Aruba,533,42,21,,63,"(3.541112,-76.384584)"
2021,Junio,Aruba,533,1287,1003,,2290,"(4.697144,-74.140516)"
2021,Junio,Aruba,533,79,63,,142,"(6.171601,-75.427454)"
2021,Junio,Aruba,533,9,14,,23,"(7.128456,-73.183637)"
2021,Junio,Australia,36,3,2,,5,"(3.541112,-76.384584)"
2021,Junio,Australia,36,11,10,,21,"(4.697144,-74.140516)"
2021,Junio,Australia,36,2,3,,5,"(6.171601,-75.427454)"
2021,Junio,Austria,40,1,2,,3,"(3.541112,-76.384584)"
2021,Junio,Austria,40,27,26,,53,"(4.697144,-74.140516)"
2021,Junio,Austria,40,0,1,,1,"(4.815061,-75.736532)"
2021,Junio,Austria,40,3,0,,3,"(6.171601,-75.427454)"
2021,Junio,Azerbaiyán,31,3,2,,5,"(4.697144,-74.140516)"
2021,Junio,Bahamas,44,0,1,,1,"(10.445761,-75.516429)"
2021,Junio,Bahamas,44,0,1,,1,"(10.886611,-74.776708)"
2021,Junio,Bahamas,44,45,33,,78,"(3.541112,-76.384584)"
2021,Junio,Bahamas,44,43,48,,91,"(4.697144,-74.140516)"
2021,Junio,Bahamas,44,31,19,,50,"(6.171601,-75.427454)"
2021,Junio,Bahamas,44,0,1,,1,"(7.128456,-73.183637)"
2021,Junio,Bahréin,48,1,6,,7,"(4.697144,-74.140516)"
2021,Junio,Bangladesh,50,3,2,,5,"(4.697144,-74.140516)"
2021,Junio,Barbados,52,3,0,,3,"(4.697144,-74.140516)"
2021,Junio,Barbados,52,2,5,,7,"(6.171601,-75.427454)"
2021,Junio,República de Belarús,112,1,1,,2,"(4.697144,-74.140516)"
2021,Junio,Bélgica,56,2,0,,2,"(10.445761,-75.516429)"
2021,Junio,Bélgica,56,0,1,,1,"(10.886611,-74.776708)"
2021,Junio,Bélgica,56,4,1,,5,"(3.541112,-76.384584)"
2021,Junio,Bélgica,56,48,24,,72,"(4.697144,-74.140516)"
2021,Junio,Bélgica,56,0,1,,1,"(4.815061,-75.736532)"
2021,Junio,Bélgica,56,11,9,,20,"(6.171601,-75.427454)"
2021,Junio,Belice,84,0,1,,1,"(10.445761,-75.516429)"
2021,Junio,Belice,84,1,0,,1,"(10.886611,-74.776708)"
2021,Junio,Belice,84,1,0,,1,"(3.541112,-76.384584)"
2021,Junio,Belice,84,6,12,,18,"(4.697144,-74.140516)"
2021,Junio,Belice,84,6,0,,6,"(6.171601,-75.427454)"
2021,Junio,Benín,204,0,1,,1,"(4.697144,-74.140516)"
2021,Junio,Bermudas/Territorio Británico de Ultramar,60,8,4,,12,"(10.886611,-74.776708)"
2021,Junio,Bermudas/Territorio Británico de Ultramar,60,0,2,,2,"(4.697144,-74.140516)"
2021,Junio,Bolivia,68,1,2,,3,"(10.445761,-75.516429)"
2021,Junio,Bolivia,68,1,7,,8,"(3.541112,-76.384584)"
2021,Junio,Bolivia,68,205,346,,551,"(4.697144,-74.140516)"
2021,Junio,Bolivia,68,3,7,,10,"(4.815061,-75.736532)"
2021,Junio,Bolivia,68,4,14,,18,"(6.171601,-75.427454)"
2021,Junio,Bolivia,68,1,0,,1,"(7.128456,-73.183637)"
2021,Junio,Bosnia y Herzegovina,70,22,8,,30,"(4.697144,-74.140516)"
2021,Junio,Botsuana,72,1,0,,1,"(4.697144,-74.140516)"
2021,Junio,Brasil,76,40,58,,98,"(-4.197703,-69.941278)"
2021,Junio,Brasil,76,10,17,,27,"(10.445761,-75.516429)"
2021,Junio,Brasil,76,13,77,,90,"(10.886611,-74.776708)"
2021,Junio,Brasil,76,57,122,,179,"(3.541112,-76.384584)"
2021,Junio,Brasil,76,203,320,,523,"(4.697144,-74.140516)"
2021,Junio,Brasil,76,39,94,,133,"(4.815061,-75.736532)"
2021,Junio,Brasil,76,73,108,,181,"(6.171601,-75.427454)"
2021,Junio,Brasil,76,4,5,,9,"(7.128456,-73.183637)"
2021,Junio,Bulgaria,100,1,1,,2,"(4.697144,-74.140516)"
2021,Junio,Burkina Faso,854,0,1,,1,"(4.697144,-74.140516)"
2021,Junio,Islas Caimán/Territorio Británico de Ultramar,136,0,2,,2,"(3.541112,-76.384584)"
2021,Junio,Islas Caimán/Territorio Británico de Ultramar,136,2,1,,3,"(4.697144,-74.140516)"
2021,Junio,Camerún,120,1,2,,3,"(4.697144,-74.140516)"
2021,Junio,Camerún,120,2,1,,3,"(6.171601,-75.427454)"
2021,Junio,Canadá,124,6,14,,20,"(10.445761,-75.516429)"
2021,Junio,Canadá,124,13,16,,29,"(10.886611,-74.776708)"
2021,Junio,Canadá,124,54,44,,98,"(3.541112,-76.384584)"
2021,Junio,Canadá,124,536,488,,1024,"(4.697144,-74.140516)"
2021,Junio,Canadá,124,18,3,,21,"(4.815061,-75.736532)"
2021,Junio,Canadá,124,89,77,,166,"(6.171601,-75.427454)"
2021,Junio,Canadá,124,5,2,,7,"(7.128456,-73.183637)"
2021,Junio,España,724,36,32,,68,"(10.445761,-75.516429)"
2021,Junio,España,724,3,11,,14,"(10.886611,-74.776708)"
2021,Junio,España,724,130,80,,210,"(3.541112,-76.384584)"
2021,Junio,España,724,6079,4342,,10421,"(4.697144,-74.140516)"
2021,Junio,España,724,5,4,,9,"(4.815061,-75.736532)"
2021,Junio,España,724,485,339,,824,"(6.171601,-75.427454)"
2021,Junio,Colombia,170,34,58,,92,"(4.697144,-74.140516)"
2021,Junio,República de Corea,410,4,7,,11,"(4.697144,-74.140516)"
2021,Junio,República de Corea,410,2,1,,3,"(6.171601,-75.427454)"
2021,Junio,Costa de Marfil,384,2,5,,7,"(4.697144,-74.140516)"
2021,Junio,Costa de Marfil,384,0,1,,1,"(6.171601,-75.427454)"
2021,Junio,Costa Rica,188,3,2,,5,"(10.445761,-75.516429)"
2021,Junio,Costa Rica,188,10,8,,18,"(10.886611,-74.776708)"
2021,Junio,Costa Rica,188,2,16,,18,"(12.5744111,-81.703935)"
2021,Junio,Costa Rica,188,8,4,,12,"(12.586067,-81.702563)"
2021,Junio,Costa Rica,188,34,30,,64,"(3.541112,-76.384584)"
2021,Junio,Costa Rica,188,646,694,,1340,"(4.697144,-74.140516)"
2021,Junio,Costa Rica,188,10,13,,23,"(4.815061,-75.736532)"
2021,Junio,Costa Rica,188,98,59,,157,"(6.171601,-75.427454)"
2021,Junio,Costa Rica,188,1,2,,3,"(7.128456,-73.183637)"
2021,Junio,Croacia,191,0,1,,1,"(10.445761,-75.516429)"
2021,Junio,Croacia,191,1,0,,1,"(10.886611,-74.776708)"
2021,Junio,Croacia,191,41,19,,60,"(4.697144,-74.140516)"
2021,Junio,Croacia,191,1,5,,6,"(6.171601,-75.427454)"
2021,Junio,Cuba,192,0,20,,20,"(10.886611,-74.776708)"
2021,Junio,Cuba,192,50,59,,109,"(4.697144,-74.140516)"
2021,Junio,Curazao,99999,28,19,,47,"(10.886611,-74.776708)"
2021,Junio,Curazao,99999,21,19,,40,"(3.541112,-76.384584)"
2021,Junio,Curazao,99999,312,273,,585,"(4.697144,-74.140516)"
2021,Junio,Curazao,99999,21,12,,33,"(6.171601,-75.427454)"
2021,Junio,Curazao,99999,0,1,,1,"(7.128456,-73.183637)"
2021,Junio,República Checa,203,6,4,,10,"(4.697144,-74.140516)"
2021,Junio,Chile,152,4,4,,8,"(10.445761,-75.516429)"
2021,Junio,Chile,152,6,4,,10,"(10.886611,-74.776708)"
2021,Junio,Chile,152,89,54,,143,"(3.541112,-76.384584)"
2021,Junio,Chile,152,774,560,,1334,"(4.697144,-74.140516)"
2021,Junio,Chile,152,20,7,,27,"(4.815061,-75.736532)"
2021,Junio,Chile,152,15,12,,27,"(6.171601,-75.427454)"
2021,Junio,China,156,0,1,,1,"(10.445761,-75.516429)"
2021,Junio,China,156,4,1,,5,"(4.697144,-74.140516)"
2021,Junio,Chipre,196,0,1,,1,"(10.886611,-74.776708)"
2021,Junio,Chipre,196,7,2,,9,"(4.697144,-74.140516)"
2021,Junio,Dinamarca,208,1,3,,4,"(10.445761,-75.516429)"
2021,Junio,Dinamarca,208,1,1,,2,"(3.541112,-76.384584)"
2021,Junio,Dinamarca,208,28,15,,43,"(4.697144,-74.140516)"
2021,Junio,Dinamarca,208,2,0,,2,"(6.171601,-75.427454)"
2021,Junio,República de Yibuti,262,2,0,,2,"(4.697144,-74.140516)"
2021,Junio,Dominica,212,0,1,,1,"(10.886611,-74.776708)"
2021,Junio,Dominica,212,1,0,,1,"(4.697144,-74.140516)"
2021,Junio,Ecuador,218,1,0,,1,"(0.25129,-76.875963)"
2021,Junio,Ecuador,218,33,30,,63,"(0.814836,-77.662532)"
2021,Junio,Ecuador,218,2,0,,2,"(10.445761,-75.516429)"
2021,Junio,Ecuador,218,3,5,,8,"(10.886611,-74.776708)"
2021,Junio,Ecuador,218,33,53,,86,"(3.541112,-76.384584)"
2021,Junio,Ecuador,218,1543,2115,,3658,"(4.697144,-74.140516)"
2021,Junio,Ecuador,218,8,10,,18,"(4.815061,-75.736532)"
2021,Junio,Ecuador,218,25,66,,91,"(6.171601,-75.427454)"
2021,Junio,Ecuador,218,1,1,,2,"(7.128456,-73.183637)"
2021,Junio,Egipto,818,54,43,,97,"(4.697144,-74.140516)"
2021,Junio,El Salvador,222,1,1,,2,"(10.445761,-75.516429)"
2021,Junio,El Salvador,222,3,6,,9,"(10.886611,-74.776708)"
2021,Junio,El Salvador,222,15,23,,38,"(3.541112,-76.384584)"
2021,Junio,El Salvador,222,170,232,,402,"(4.697144,-74.140516)"
2021,Junio,El Salvador,222,0,1,,1,"(4.815061,-75.736532)"
2021,Junio,El Salvador,222,27,36,,63,"(6.171601,-75.427454)"
2021,Junio,El Salvador,222,0,4,,4,"(7.128456,-73.183637)"
2021,Junio,Emiratos Árabes,784,6,2,,8,"(10.445761,-75.516429)"
2021,Junio,Emiratos Árabes,784,1,0,,1,"(10.886611,-74.776708)"
2021,Junio,Emiratos Árabes,784,7,6,,13,"(3.541112,-76.384584)"
2021,Junio,Emiratos Árabes,784,127,203,,330,"(4.697144,-74.140516)"
2021,Junio,Emiratos Árabes,784,7,6,,13,"(6.171601,-75.427454)"
2021,Junio,Eslovaquia,703,1,0,,1,"(3.541112,-76.384584)"
2021,Junio,Eslovaquia,703,3,1,,4,"(4.697144,-74.140516)"
2021,Junio,Eslovenia,705,2,2,,4,"(4.697144,-74.140516)"
2021,Junio,Estados Unidos de América,840,5125,4346,,9471,"(10.445761,-75.516429)"
2021,Junio,Estados Unidos de América,840,6447,5158,,11605,"(10.886611,-74.776708)"
2021,Junio,Estados Unidos de América,840,8,15,,23,"(11.117806,-74.232622)"
2021,Junio,Estados Unidos de América,840,0,1,,1,"(12.586067,-81.702563)"
2021,Junio,Estados Unidos de América,840,11082,8674,,19756,"(3.541112,-76.384584)"
2021,Junio,Estados Unidos de América,840,1350,1025,,2375,"(4.452882,-75.766298)"
2021,Junio,Estados Unidos de América,840,56396,47582,,103978,"(4.697144,-74.140516)"
2021,Junio,Estados Unidos de América,840,2338,1688,,4026,"(4.815061,-75.736532)"
2021,Junio,Estados Unidos de América,840,26954,22078,,49035,"(6.171601,-75.427454)"
2021,Junio,Estados Unidos de América,840,1363,1074,,2437,"(7.128456,-73.183637)"
2021,Junio,Estonia,233,3,2,,5,"(4.697144,-74.140516)"
2021,Junio,Etiopia,231,0,2,,2,"(4.697144,-74.140516)"
2021,Junio,Finlandia,246,11,11,,22,"(4.697144,-74.140516)"
2021,Junio,Francia,250,6,2,,8,"(10.445761,-75.516429)"
2021,Junio,Francia,250,0,1,,1,"(10.886611,-74.776708)"
2021,Junio,Francia,250,7,7,,14,"(3.541112,-76.384584)"
2021,Junio,Francia,250,548,340,,888,"(4.697144,-74.140516)"
2021,Junio,Francia,250,5,2,,7,"(4.815061,-75.736532)"
2021,Junio,Francia,250,14,6,,20,"(6.171601,-75.427454)"
2021,Junio,Georgia,268,2,0,,2,"(10.886611,-74.776708)"
2021,Junio,Georgia,268,1,0,,1,"(3.541112,-76.384584)"
2021,Junio,Georgia,268,2,3,,5,"(4.697144,-74.140516)"
2021,Junio,Georgia,268,5,2,,7,"(6.171601,-75.427454)"
2021,Junio,Ghana,288,0,1,,1,"(4.697144,-74.140516)"
2021,Junio,Gibraltar/Territorio Británico de Ultramar,292,0,1,,1,"(4.697144,-74.140516)"
2021,Junio,Granada,308,0,3,,3,"(4.697144,-74.140516)"
2021,Junio,Grecia,300,15,12,,27,"(4.697144,-74.140516)"
2021,Junio,Grecia,300,1,2,,3,"(6.171601,-75.427454)"
2021,Junio,Guatemala,320,3,6,,9,"(10.445761,-75.516429)"
2021,Junio,Guatemala,320,10,11,,21,"(10.886611,-74.776708)"
2021,Junio,Guatemala,320,0,6,,6,"(12.586067,-81.702563)"
2021,Junio,Guatemala,320,49,91,,140,"(3.541112,-76.384584)"
2021,Junio,Guatemala,320,305,355,,660,"(4.697144,-74.140516)"
2021,Junio,Guatemala,320,11,17,,28,"(4.815061,-75.736532)"
2021,Junio,Guatemala,320,113,106,,219,"(6.171601,-75.427454)"
2021,Junio,Guatemala,320,2,4,,6,"(7.128456,-73.183637)"
2021,Junio,Guyana,328,1,1,,2,"(10.886611,-74.776708)"
2021,Junio,Guyana,328,4,15,,19,"(4.697144,-74.140516)"
2021,Junio,Guyana,328,2,3,,5,"(6.171601,-75.427454)"
2021,Junio,Guinea,324,1,1,,2,"(4.697144,-74.140516)"
2021,Junio,Guinea Ecuatorial,226,1,0,,1,"(3.541112,-76.384584)"
2021,Junio,Guinea Ecuatorial,226,1,4,,5,"(4.697144,-74.140516)"
2021,Junio,Guayana Francesa/Departamento de Ultramar Francés,254,0,1,,1,"(3.541112,-76.384584)"
2021,Junio,Guayana Francesa/Departamento de Ultramar Francés,254,0,2,,2,"(4.697144,-74.140516)"
2021,Junio,Haití,332,0,1,,1,"(10.445761,-75.516429)"
2021,Junio,Haití,332,0,3,,3,"(10.886611,-74.776708)"
2021,Junio,Haití,332,0,3,,3,"(3.541112,-76.384584)"
2021,Junio,Haití,332,0,4,,4,"(4.697144,-74.140516)"
2021,Junio,Honduras,340,5,11,,16,"(10.445761,-75.516429)"
2021,Junio,Honduras,340,3,3,,6,"(10.886611,-74.776708)"
2021,Junio,Honduras,340,0,3,,3,"(12.5744111,-81.703935)"
2021,Junio,Honduras,340,14,17,,31,"(3.541112,-76.384584)"
2021,Junio,Honduras,340,40,91,,131,"(4.697144,-74.140516)"
2021,Junio,Honduras,340,46,49,,95,"(6.171601,-75.427454)"
2021,Junio,Honduras,340,2,2,,4,"(7.128456,-73.183637)"
2021,Junio,Hong Kong,344,4,5,,9,"(4.697144,-74.140516)"
2021,Junio,Hungría,348,10,17,,27,"(4.697144,-74.140516)"
2021,Junio,Hungría,348,1,0,,1,"(6.171601,-75.427454)"
2021,Junio,India,356,2,2,,4,"(4.697144,-74.140516)"
2021,Junio,Indonesia,360,0,1,,1,"(3.541112,-76.384584)"
2021,Junio,Indonesia,360,1,2,,3,"(4.697144,-74.140516)"
2021,Junio,Iraq,368,1,7,,8,"(4.697144,-74.140516)"
2021,Junio,Iraq,368,0,1,,1,"(6.171601,-75.427454)"
2021,Junio,Irán,364,1,0,,1,"(4.697144,-74.140516)"
2021,Junio,República de Irlanda,372,3,1,,4,"(4.697144,-74.140516)"
2021,Junio,Islandia,352,1,0,,1,"(10.445761,-75.516429)"
2021,Junio,Islandia,352,4,4,,8,"(4.697144,-74.140516)"
2021,Junio,Isla de Man,833,0,1,,1,"(4.697144,-74.140516)"
2021,Junio,Israel,376,2,0,,2,"(10.445761,-75.516429)"
2021,Junio,Israel,376,0,1,,1,"(10.886611,-74.776708)"
2021,Junio,Israel,376,0,1,,1,"(3.541112,-76.384584)"
2021,Junio,Israel,376,46,38,,84,"(4.697144,-74.140516)"
2021,Junio,Israel,376,2,0,,2,"(6.171601,-75.427454)"
2021,Junio,Italia,380,38,12,,50,"(10.445761,-75.516429)"
2021,Junio,Italia,380,5,2,,7,"(10.886611,-74.776708)"
2021,Junio,Italia,380,31,19,,50,"(3.541112,-76.384584)"
2021,Junio,Italia,380,464,263,,727,"(4.697144,-74.140516)"
2021,Junio,Italia,380,2,0,,2,"(4.815061,-75.736532)"
2021,Junio,Italia,380,35,23,,58,"(6.171601,-75.427454)"
2021,Junio,Islas Feroe/Región Autónoma de Dinamarca,234,0,1,,1,"(4.697144,-74.140516)"
2021,Junio,Jamaica,388,0,1,,1,"(10.408582,-75.538003)"
2021,Junio,Jamaica,388,0,2,,2,"(10.445761,-75.516429)"
2021,Junio,Jamaica,388,1,1,,2,"(10.886611,-74.776708)"
2021,Junio,Jamaica,388,4,5,,9,"(4.697144,-74.140516)"
2021,Junio,Japón,392,16,4,,20,"(4.697144,-74.140516)"
2021,Junio,Japón,392,1,0,,1,"(4.815061,-75.736532)"
2021,Junio,Jordania,400,4,3,,7,"(4.697144,-74.140516)"
2021,Junio,Kazajistán,398,0,2,,2,"(4.697144,-74.140516)"
2021,Junio,Kenia,404,0,1,,1,"(10.445761,-75.516429)"
2021,Junio,Kenia,404,5,7,,12,"(4.697144,-74.140516)"
2021,Junio,Kenia,404,0,1,,1,"(6.171601,-75.427454)"
2021,Junio,Kiribati,296,1,0,,1,"(4.697144,-74.140516)"
2021,Junio,República Democrática Popular  Lao,418,2,2,,4,"(4.697144,-74.140516)"
2021,Junio,Letonia,428,1,3,,4,"(4.697144,-74.140516)"
2021,Junio,Lituania,440,1,3,,4,"(4.697144,-74.140516)"
2021,Junio,Líbano,422,1,2,,3,"(10.445761,-75.516429)"
2021,Junio,Líbano,422,3,6,,9,"(10.886611,-74.776708)"
2021,Junio,Líbano,422,2,2,,4,"(3.541112,-76.384584)"
2021,Junio,Líbano,422,32,41,,73,"(4.697144,-74.140516)"
2021,Junio,Líbano,422,0,1,,1,"(7.128456,-73.183637)"
2021,Junio,Luxemburgo,442,1,0,,1,"(3.541112,-76.384584)"
2021,Junio,Luxemburgo,442,7,2,,9,"(4.697144,-74.140516)"
2021,Junio,Macao,446,0,1,,1,"(4.697144,-74.140516)"
2021,Junio,Malasia,458,1,0,,1,"(4.697144,-74.140516)"
2021,Junio,Malawi,454,1,0,,1,"(4.697144,-74.140516)"
2021,Junio,Maldivas,462,1,2,,3,"(4.697144,-74.140516)"
2021,Junio,Malí,466,1,2,,3,"(4.697144,-74.140516)"
2021,Junio,Malta,470,30,25,,55,"(4.697144,-74.140516)"
2021,Junio,Malta,470,0,1,,1,"(6.171601,-75.427454)"
2021,Junio,Marruecos,504,3,2,,5,"(4.697144,-74.140516)"
2021,Junio,Islas Marshall,584,1,0,,1,"(6.171601,-75.427454)"
2021,Junio,Mauritania,478,1,3,,4,"(4.697144,-74.140516)"
2021,Junio,México,484,70,52,,122,"(10.445761,-75.516429)"
2021,Junio,México,484,115,94,,209,"(10.886611,-74.776708)"
2021,Junio,México,484,0,5,,5,"(12.586067,-81.702563)"
2021,Junio,México,484,893,742,,1635,"(3.541112,-76.384584)"
2021,Junio,México,484,11091,9560,,20651,"(4.697144,-74.140516)"
2021,Junio,México,484,169,130,,299,"(4.815061,-75.736532)"
2021,Junio,México,484,4,4,,8,"(6.17134,-75.427194)"
2021,Junio,México,484,4900,3724,,8624,"(6.171601,-75.427454)"
2021,Junio,México,484,139,80,,219,"(7.128456,-73.183637)"
2021,Junio,República de Moldavia,498,1,2,,3,"(4.697144,-74.140516)"
2021,Junio,Mónaco,492,12,2,,14,"(4.697144,-74.140516)"
2021,Junio,Mongolia,496,0,1,,1,"(10.886611,-74.776708)"
2021,Junio,Montenegro,499,2,2,,4,"(3.541112,-76.384584)"
2021,Junio,Montenegro,499,5,5,,10,"(4.697144,-74.140516)"
2021,Junio,Montenegro,499,0,1,,1,"(6.171601,-75.427454)"
2021,Junio,Mozambique,508,0,1,,1,"(3.541112,-76.384584)"
2021,Junio,Namibia,516,0,1,,1,"(4.697144,-74.140516)"
2021,Junio,Nicaragua,558,4,3,,7,"(3.541112,-76.384584)"
2021,Junio,Nicaragua,558,24,44,,68,"(4.697144,-74.140516)"
2021,Junio,Nicaragua,558,8,18,,26,"(6.171601,-75.427454)"
2021,Junio,Nigeria,566,1,2,,3,"(4.697144,-74.140516)"
2021,Junio,Desconocido,99999,1,0,,1,"(10.886611,-74.776708)"
2021,Junio,Noruega,578,0,3,,3,"(3.541112,-76.384584)"
2021,Junio,Noruega,578,6,6,,12,"(4.697144,-74.140516)"
2021,Junio,Noruega,578,2,1,,3,"(6.171601,-75.427454)"
2021,Junio,Nueva Zelanda,554,5,5,,10,"(4.697144,-74.140516)"
2021,Junio,Omán,512,0,3,,3,"(4.697144,-74.140516)"
2021,Junio,Omán,512,0,1,,1,"(6.171601,-75.427454)"
2021,Junio,Panamá,591,0,17,,17,"(10.408582,-75.538003)"
2021,Junio,Panamá,591,514,380,,894,"(10.445761,-75.516429)"
2021,Junio,Panamá,591,287,240,,527,"(10.886611,-74.776708)"
2021,Junio,Panamá,591,0,1,,1,"(10.971302,-74.765397)"
2021,Junio,Panamá,591,2,15,,17,"(12.5744111,-81.703935)"
2021,Junio,Panamá,591,867,678,,1545,"(3.541112,-76.384584)"
2021,Junio,Panamá,591,1761,1983,,3744,"(4.697144,-74.140516)"
2021,Junio,Panamá,591,234,150,,384,"(4.815061,-75.736532)"
2021,Junio,Panamá,591,747,599,,1346,"(6.171601,-75.427454)"
2021,Junio,Panamá,591,1,3,,4,"(6.228046,-77.404104)"
2021,Junio,Panamá,591,48,43,,91,"(7.128456,-73.183637)"
2021,Junio,Paraguay,600,0,1,,1,"(10.445761,-75.516429)"
2021,Junio,Paraguay,600,1,0,,1,"(10.886611,-74.776708)"
2021,Junio,Paraguay,600,7,17,,24,"(3.541112,-76.384584)"
2021,Junio,Paraguay,600,51,95,,146,"(4.697144,-74.140516)"
2021,Junio,Paraguay,600,1,7,,8,"(4.815061,-75.736532)"
2021,Junio,Paraguay,600,2,11,,13,"(6.171601,-75.427454)"
2021,Junio,Paraguay,600,2,0,,2,"(7.128456,-73.183637)"
2021,Junio,Perú,604,5,3,,8,"(-4.197703,-69.941278)"
2021,Junio,Perú,604,2,6,,8,"(-4.223468,-69.945098)"
2021,Junio,Perú,604,3,4,,7,"(10.445761,-75.516429)"
2021,Junio,Perú,604,5,58,,63,"(10.886611,-74.776708)"
2021,Junio,Perú,604,27,33,,60,"(3.541112,-76.384584)"
2021,Junio,Perú,604,1703,1969,,3672,"(4.697144,-74.140516)"
2021,Junio,Perú,604,11,11,,22,"(4.815061,-75.736532)"
2021,Junio,Perú,604,316,357,,673,"(6.171601,-75.427454)"
2021,Junio,Perú,604,5,1,,6,"(7.128456,-73.183637)"
2021,Junio,Polonia,616,1,1,,2,"(10.445761,-75.516429)"
2021,Junio,Polonia,616,1,0,,1,"(3.541112,-76.384584)"
2021,Junio,Polonia,616,14,19,,33,"(4.697144,-74.140516)"
2021,Junio,Polonia,616,0,2,,2,"(6.171601,-75.427454)"
2021,Junio,Portugal,620,2,2,,4,"(10.445761,-75.516429)"
2021,Junio,Portugal,620,0,1,,1,"(3.541112,-76.384584)"
2021,Junio,Portugal,620,55,72,,127,"(4.697144,-74.140516)"
2021,Junio,Portugal,620,3,4,,7,"(6.171601,-75.427454)"
2021,Junio,Puerto Rico/Territorio de Estados Unidos,630,3,4,,7,"(10.445761,-75.516429)"
2021,Junio,Puerto Rico/Territorio de Estados Unidos,630,9,5,,14,"(10.886611,-74.776708)"
2021,Junio,Puerto Rico/Territorio de Estados Unidos,630,39,34,,73,"(3.541112,-76.384584)"
2021,Junio,Puerto Rico/Territorio de Estados Unidos,630,275,239,,514,"(4.697144,-74.140516)"
2021,Junio,Puerto Rico/Territorio de Estados Unidos,630,0,1,,1,"(4.815061,-75.736532)"
2021,Junio,Puerto Rico/Territorio de Estados Unidos,630,57,38,,95,"(6.171601,-75.427454)"
2021,Junio,Puerto Rico/Territorio de Estados Unidos,630,0,1,,1,"(7.128456,-73.183637)"
2021,Junio,Qatar,634,6,18,,24,"(4.697144,-74.140516)"
2021,Junio,Qatar,634,2,3,,5,"(6.171601,-75.427454)"
2021,Junio,Reino Unido de Gran Bretaña e Irlanda del Norte,826,0,1,,1,"(10.445761,-75.516429)"
2021,Junio,Reino Unido de Gran Bretaña e Irlanda del Norte,826,9,7,,16,"(3.541112,-76.384584)"
2021,Junio,Reino Unido de Gran Bretaña e Irlanda del Norte,826,59,42,,101,"(4.697144,-74.140516)"
2021,Junio,Reino Unido de Gran Bretaña e Irlanda del Norte,826,8,3,,11,"(6.171601,-75.427454)"
2021,Junio,Federación de Rusia,643,3,1,,4,"(10.445761,-75.516429)"
2021,Junio,Federación de Rusia,643,0,1,,1,"(10.886611,-74.776708)"
2021,Junio,Federación de Rusia,643,38,42,,80,"(4.697144,-74.140516)"
2021,Junio,Federación de Rusia,643,1,0,,1,"(6.171601,-75.427454)"
2021,Junio,República Dominicana,214,17,23,,40,"(10.445761,-75.516429)"
2021,Junio,República Dominicana,214,60,44,,104,"(10.886611,-74.776708)"
2021,Junio,República Dominicana,214,7,15,,22,"(11.117806,-74.232622)"
2021,Junio,República Dominicana,214,329,243,,572,"(3.541112,-76.384584)"
2021,Junio,República Dominicana,214,3741,3040,,6781,"(4.697144,-74.140516)"
2021,Junio,República Dominicana,214,27,24,,51,"(4.815061,-75.736532)"
2021,Junio,República Dominicana,214,843,608,,1451,"(6.171601,-75.427454)"
2021,Junio,República Dominicana,214,37,25,,62,"(7.128456,-73.183637)"
2021,Junio,Rumania,642,3,4,,7,"(4.697144,-74.140516)"
2021,Junio,Rumania,642,0,1,,1,"(6.171601,-75.427454)"
2021,Junio,Rwanda,646,0,1,,1,"(4.697144,-74.140516)"
2021,Junio,San  Vicente y las Granadinas,670,0,1,,1,"(4.697144,-74.140516)"
2021,Junio,Santa Lucia,662,1,1,,2,"(4.697144,-74.140516)"
2021,Junio,Senegal,686,0,1,,1,"(4.697144,-74.140516)"
2021,Junio,Serbia,688,10,8,,18,"(4.697144,-74.140516)"
2021,Junio,Singapur,702,0,1,,1,"(4.697144,-74.140516)"
2021,Junio,Sudáfrica,710,7,2,,9,"(4.697144,-74.140516)"
2021,Junio,Sudáfrica,710,0,1,,1,"(6.171601,-75.427454)"
2021,Junio,Sudán,736,0,1,,1,"(10.445761,-75.516429)"
2021,Junio,Suecia,752,3,3,,6,"(3.541112,-76.384584)"
2021,Junio,Suecia,752,43,38,,81,"(4.697144,-74.140516)"
2021,Junio,Suecia,752,0,6,,6,"(6.171601,-75.427454)"
2021,Junio,Suiza,756,11,5,,16,"(10.445761,-75.516429)"
2021,Junio,Suiza,756,1,0,,1,"(10.886611,-74.776708)"
2021,Junio,Suiza,756,8,7,,15,"(3.541112,-76.384584)"
2021,Junio,Suiza,756,146,93,,239,"(4.697144,-74.140516)"
2021,Junio,Suiza,756,1,3,,4,"(4.815061,-75.736532)"
2021,Junio,Suiza,756,13,9,,22,"(6.171601,-75.427454)"
2021,Junio,Surinam,740,0,1,,1,"(10.886611,-74.776708)"
2021,Junio,Surinam,740,2,5,,7,"(4.697144,-74.140516)"
2021,Junio,Suazilandia,748,1,0,,1,"(3.541112,-76.384584)"
2021,Junio,Suazilandia,748,1,0,,1,"(4.697144,-74.140516)"
2021,Junio,Tailandia,764,3,1,,4,"(4.697144,-74.140516)"
2021,Junio,Tanzania,834,1,2,,3,"(4.697144,-74.140516)"
2021,Junio,Trinidad y Tobago,780,1,0,,1,"(3.541112,-76.384584)"
2021,Junio,Túnez,788,3,4,,7,"(4.697144,-74.140516)"
2021,Junio,Turquía,792,3,3,,6,"(10.445761,-75.516429)"
2021,Junio,Turquía,792,1,3,,4,"(10.886611,-74.776708)"
2021,Junio,Turquía,792,770,559,,1329,"(4.697144,-74.140516)"
2021,Junio,Turquía,792,7,11,,18,"(6.171601,-75.427454)"
2021,Junio,Turkmenistán,795,1,1,,2,"(4.697144,-74.140516)"
2021,Junio,Ucrania,804,1,1,,2,"(10.445761,-75.516429)"
2021,Junio,Ucrania,804,1,0,,1,"(3.541112,-76.384584)"
2021,Junio,Ucrania,804,13,19,,32,"(4.697144,-74.140516)"
2021,Junio,Ucrania,804,1,0,,1,"(6.171601,-75.427454)"
2021,Junio,Uruguay,858,1,1,,2,"(10.445761,-75.516429)"
2021,Junio,Uruguay,858,0,1,,1,"(10.886611,-74.776708)"
2021,Junio,Uruguay,858,10,16,,26,"(3.541112,-76.384584)"
2021,Junio,Uruguay,858,9,26,,35,"(4.697144,-74.140516)"
2021,Junio,Uruguay,858,2,6,,8,"(4.815061,-75.736532)"
2021,Junio,Uruguay,858,0,6,,6,"(6.171601,-75.427454)"
2021,Junio,Venezuela,862,3,0,,3,"(10.445761,-75.516429)"
2021,Junio,Venezuela,862,9,14,,23,"(10.886611,-74.776708)"
2021,Junio,Venezuela,862,30,204,,234,"(11.360009,-72.129330)"
2021,Junio,Venezuela,862,12,10,,22,"(3.541112,-76.384584)"
2021,Junio,Venezuela,862,111,196,,307,"(4.697144,-74.140516)"
2021,Junio,Venezuela,862,22,25,,47,"(6.171601,-75.427454)"
2021,Junio,Venezuela,862,2,3,,5,"(6.185799,-67.483929)"
2021,Junio,Venezuela,862,2,2,,4,"(7.088729,-70.740253)"
2021,Junio,Venezuela,862,13,22,,35,"(7.818934,-72.453226)"
2021,Junio,Venezuela,862,1,2,,3,"(7.916725,-72.462544)"
2021,Junio,Venezuela,862,2,2,,4,"(8.36068,-72.409396)"
2021,Junio,Islas Vírgenes Británicas/Territorio Británico de Ultramar,92,1,2,,3,"(4.697144,-74.140516)"
2021,Junio,Islas Vírgenes Británicas/Territorio Británico de Ultramar,92,1,0,,1,"(6.171601,-75.427454)"
2021,Junio,Islas Vírgenes Estadounidenses/Territorio de Estados Unidos,850,3,6,,9,"(3.541112,-76.384584)"
2021,Junio,Islas Vírgenes Estadounidenses/Territorio de Estados Unidos,850,0,1,,1,"(4.697144,-74.140516)"
2021,Junio,Zambia,894,2,0,,2,"(4.697144,-74.140516)"
2021,Junio,Islas Turcas y Caicos/Territorio Británico de Ultramar,796,2,0,,2,"(4.697144,-74.140516)"
2021,Junio,Islas Turcas y Caicos/Territorio Británico de Ultramar,796,1,0,,1,"(6.171601,-75.427454)"
2021,Junio,Desconocido,99999,1,1,,2,"(4.697144,-74.140516)"
2021,Julio,Afganistán,4,1,4,,5,"(4.697144,-74.140516)"
2021,Julio,Albania,8,4,6,,10,"(4.697144,-74.140516)"
2021,Julio,Alemania,276,42,31,,73,"(10.445761,-75.516429)"
2021,Julio,Alemania,276,1,3,,4,"(10.886611,-74.776708)"
2021,Julio,Alemania,276,33,33,,66,"(3.541112,-76.384584)"
2021,Julio,Alemania,276,1132,707,,1839,"(4.697144,-74.140516)"
2021,Julio,Alemania,276,4,1,,5,"(4.815061,-75.736532)"
2021,Julio,Alemania,276,55,29,,84,"(6.171601,-75.427454)"
2021,Julio,Andorra,20,3,4,,7,"(4.697144,-74.140516)"
2021,Julio,Angola,24,2,1,,3,"(4.697144,-74.140516)"
2021,Julio,Antigua y Barbuda,28,3,3,,6,"(4.697144,-74.140516)"
2021,Julio,Antigua y Barbuda,28,3,0,,3,"(6.171601,-75.427454)"
2021,Julio,Países Bajos,528,115,63,,178,"(10.445761,-75.516429)"
2021,Julio,Países Bajos,528,9,6,,15,"(10.886611,-74.776708)"
2021,Julio,Países Bajos,528,22,19,,41,"(3.541112,-76.384584)"
2021,Julio,Países Bajos,528,523,420,,943,"(4.697144,-74.140516)"
2021,Julio,Países Bajos,528,1,0,,1,"(4.815061,-75.736532)"
2021,Julio,Países Bajos,528,50,17,,67,"(6.171601,-75.427454)"
2021,Julio,Países Bajos,528,1,0,,1,"(7.128456,-73.183637)"
2021,Julio,Arabia Saudita,682,2,3,,5,"(10.445761,-75.516429)"
2021,Julio,Arabia Saudita,682,0,1,,1,"(3.541112,-76.384584)"
2021,Julio,Arabia Saudita,682,11,42,,53,"(4.697144,-74.140516)"
2021,Julio,Arabia Saudita,682,1,1,,2,"(4.815061,-75.736532)"
2021,Julio,Arabia Saudita,682,0,1,,1,"(6.171601,-75.427454)"
2021,Julio,Argelia,12,0,1,,1,"(4.697144,-74.140516)"
2021,Julio,Argentina,32,2,1,,3,"(3.541112,-76.384584)"
2021,Julio,Argentina,32,141,126,,267,"(4.697144,-74.140516)"
2021,Julio,Argentina,32,4,6,,10,"(6.171601,-75.427454)"
2021,Julio,Argentina,32,1,0,,1,"(7.128456,-73.183637)"
2021,Julio,Aruba,533,33,19,,52,"(10.886611,-74.776708)"
2021,Julio,Aruba,533,1,5,,6,"(11.117806,-74.232622)"
2021,Julio,Aruba,533,0,2,,2,"(11.360009,-72.129330)"
2021,Julio,Aruba,533,32,25,,57,"(3.541112,-76.384584)"
2021,Julio,Aruba,533,1406,1081,,2487,"(4.697144,-74.140516)"
2021,Julio,Aruba,533,68,38,,106,"(6.171601,-75.427454)"
2021,Julio,Aruba,533,3,12,,15,"(7.128456,-73.183637)"
2021,Julio,Australia,36,2,2,,4,"(3.541112,-76.384584)"
2021,Julio,Australia,36,11,6,,17,"(4.697144,-74.140516)"
2021,Julio,Australia,36,1,1,,2,"(6.171601,-75.427454)"
2021,Julio,Austria,40,1,2,,3,"(10.445761,-75.516429)"
2021,Julio,Austria,40,76,66,,142,"(4.697144,-74.140516)"
2021,Julio,Austria,40,2,1,,3,"(6.171601,-75.427454)"
2021,Julio,Azerbaiyán,31,0,3,,3,"(4.697144,-74.140516)"
2021,Julio,Bahamas,44,2,3,,5,"(10.886611,-74.776708)"
2021,Julio,Bahamas,44,28,9,,37,"(3.541112,-76.384584)"
2021,Julio,Bahamas,44,50,40,,90,"(4.697144,-74.140516)"
2021,Julio,Bahamas,44,0,1,,1,"(4.815061,-75.736532)"
2021,Julio,Bahamas,44,30,39,,69,"(6.171601,-75.427454)"
2021,Julio,Bahréin,48,1,6,,7,"(4.697144,-74.140516)"
2021,Julio,Barbados,52,2,5,,7,"(3.541112,-76.384584)"
2021,Julio,Barbados,52,1,3,,4,"(4.697144,-74.140516)"
2021,Julio,Barbados,52,0,2,,2,"(6.171601,-75.427454)"
2021,Julio,República de Belarús,112,0,1,,1,"(4.697144,-74.140516)"
2021,Julio,Bélgica,56,3,1,,4,"(10.445761,-75.516429)"
2021,Julio,Bélgica,56,5,6,,11,"(3.541112,-76.384584)"
2021,Julio,Bélgica,56,76,43,,119,"(4.697144,-74.140516)"
2021,Julio,Bélgica,56,2,2,,4,"(4.815061,-75.736532)"
2021,Julio,Bélgica,56,22,9,,31,"(6.171601,-75.427454)"
2021,Julio,Belice,84,0,1,,1,"(10.886611,-74.776708)"
2021,Julio,Belice,84,2,1,,3,"(3.541112,-76.384584)"
2021,Julio,Belice,84,10,15,,25,"(4.697144,-74.140516)"
2021,Julio,Belice,84,3,3,,6,"(6.171601,-75.427454)"
2021,Julio,Bermudas/Territorio Británico de Ultramar,60,2,2,,4,"(10.886611,-74.776708)"
2021,Julio,Bermudas/Territorio Británico de Ultramar,60,0,1,,1,"(4.697144,-74.140516)"
2021,Julio,Bermudas/Territorio Británico de Ultramar,60,3,0,,3,"(6.171601,-75.427454)"
2021,Julio,Bolivia,68,3,2,,5,"(3.541112,-76.384584)"
2021,Julio,Bolivia,68,245,343,,588,"(4.697144,-74.140516)"
2021,Julio,Bolivia,68,2,4,,6,"(4.815061,-75.736532)"
2021,Julio,Bolivia,68,5,13,,18,"(6.171601,-75.427454)"
2021,Julio,Bosnia y Herzegovina,70,2,2,,4,"(4.697144,-74.140516)"
2021,Julio,Brasil,76,36,53,,89,"(-4.197703,-69.941278)"
2021,Julio,Brasil,76,16,30,,46,"(10.445761,-75.516429)"
2021,Julio,Brasil,76,16,17,,33,"(10.886611,-74.776708)"
2021,Julio,Brasil,76,99,153,,252,"(3.541112,-76.384584)"
2021,Julio,Brasil,76,1,1,,2,"(3.866713,-67.927521)"
2021,Julio,Brasil,76,984,1210,,2194,"(4.697144,-74.140516)"
2021,Julio,Brasil,76,48,110,,158,"(4.815061,-75.736532)"
2021,Julio,Brasil,76,110,149,,259,"(6.171601,-75.427454)"
2021,Julio,Brasil,76,1,4,,5,"(7.128456,-73.183637)"
2021,Julio,Bulgaria,100,1,2,,3,"(4.697144,-74.140516)"
2021,Julio,Cabo Verde,132,1,0,,1,"(3.541112,-76.384584)"
2021,Julio,Islas Caimán/Territorio Británico de Ultramar,136,0,2,,2,"(3.541112,-76.384584)"
2021,Julio,Islas Caimán/Territorio Británico de Ultramar,136,0,1,,1,"(4.697144,-74.140516)"
2021,Julio,Islas Caimán/Territorio Británico de Ultramar,136,1,0,,1,"(6.171601,-75.427454)"
2021,Julio,Camboya,116,1,1,,2,"(4.697144,-74.140516)"
2021,Julio,Camerún,120,4,4,,8,"(4.697144,-74.140516)"
2021,Julio,Canadá,124,18,11,,29,"(10.445761,-75.516429)"
2021,Julio,Canadá,124,24,25,,49,"(10.886611,-74.776708)"
2021,Julio,Canadá,124,97,54,,151,"(3.541112,-76.384584)"
2021,Julio,Canadá,124,992,748,,1740,"(4.697144,-74.140516)"
2021,Julio,Canadá,124,30,18,,48,"(4.815061,-75.736532)"
2021,Julio,Canadá,124,162,141,,303,"(6.171601,-75.427454)"
2021,Julio,Canadá,124,10,7,,17,"(7.128456,-73.183637)"
2021,Julio,España,724,50,51,,101,"(10.445761,-75.516429)"
2021,Julio,España,724,4,9,,13,"(10.886611,-74.776708)"
2021,Julio,España,724,1477,907,,2384,"(3.541112,-76.384584)"
2021,Julio,España,724,10930,7697,,18627,"(4.697144,-74.140516)"
2021,Julio,España,724,16,15,,31,"(4.815061,-75.736532)"
2021,Julio,España,724,1036,562,,1598,"(6.171601,-75.427454)"
2021,Julio,Colombia,170,2,5,,7,"(10.445761,-75.516429)"
2021,Julio,Colombia,170,36,82,,118,"(4.697144,-74.140516)"
2021,Julio,República de Corea,410,1,1,,2,"(3.541112,-76.384584)"
2021,Julio,República de Corea,410,8,5,,13,"(4.697144,-74.140516)"
2021,Julio,Costa de Marfil,384,0,3,,3,"(4.697144,-74.140516)"
2021,Julio,Costa de Marfil,384,0,1,,1,"(6.171601,-75.427454)"
2021,Julio,Costa Rica,188,2,4,,6,"(10.445761,-75.516429)"
2021,Julio,Costa Rica,188,14,19,,33,"(10.886611,-74.776708)"
2021,Julio,Costa Rica,188,3,22,,25,"(12.5744111,-81.703935)"
2021,Julio,Costa Rica,188,5,1,,6,"(12.586067,-81.702563)"
2021,Julio,Costa Rica,188,51,56,,107,"(3.541112,-76.384584)"
2021,Julio,Costa Rica,188,837,826,,1664,"(4.697144,-74.140516)"
2021,Julio,Costa Rica,188,15,14,,29,"(4.815061,-75.736532)"
2021,Julio,Costa Rica,188,123,98,,221,"(6.171601,-75.427454)"
2021,Julio,Costa Rica,188,0,1,,1,"(7.128456,-73.183637)"
2021,Julio,Croacia,191,0,2,,2,"(10.445761,-75.516429)"
2021,Julio,Croacia,191,5,1,,6,"(3.541112,-76.384584)"
2021,Julio,Croacia,191,30,21,,51,"(4.697144,-74.140516)"
2021,Julio,Croacia,191,2,1,,3,"(6.171601,-75.427454)"
2021,Julio,Cuba,192,0,30,,30,"(10.886611,-74.776708)"
2021,Julio,Cuba,192,1,1,,2,"(3.541112,-76.384584)"
2021,Julio,Cuba,192,45,60,,105,"(4.697144,-74.140516)"
2021,Julio,Curazao,99999,41,37,,78,"(10.886611,-74.776708)"
2021,Julio,Curazao,99999,21,9,,30,"(3.541112,-76.384584)"
2021,Julio,Curazao,99999,230,204,,434,"(4.697144,-74.140516)"
2021,Julio,Curazao,99999,34,16,,50,"(6.171601,-75.427454)"
2021,Julio,Curazao,99999,4,1,,5,"(7.128456,-73.183637)"
2021,Julio,República Checa,203,1,0,,1,"(10.445761,-75.516429)"
2021,Julio,República Checa,203,0,1,,1,"(10.886611,-74.776708)"
2021,Julio,República Checa,203,5,5,,10,"(4.697144,-74.140516)"
2021,Julio,Chile,152,5,4,,9,"(10.445761,-75.516429)"
2021,Julio,Chile,152,5,5,,10,"(10.886611,-74.776708)"
2021,Julio,Chile,152,284,174,,458,"(3.541112,-76.384584)"
2021,Julio,Chile,152,1030,754,,1784,"(4.697144,-74.140516)"
2021,Julio,Chile,152,1,1,,2,"(4.815061,-75.736532)"
2021,Julio,Chile,152,11,12,,23,"(6.171601,-75.427454)"
2021,Julio,Chile,152,0,1,,1,"(7.128456,-73.183637)"
2021,Julio,China,156,4,6,,10,"(4.697144,-74.140516)"
2021,Julio,Chipre,196,0,1,,1,"(3.541112,-76.384584)"
2021,Julio,Chipre,196,1,4,,5,"(4.697144,-74.140516)"
2021,Julio,Chipre,196,1,0,,1,"(6.171601,-75.427454)"
2021,Julio,Dinamarca,208,2,2,,4,"(10.445761,-75.516429)"
2021,Julio,Dinamarca,208,2,2,,4,"(3.541112,-76.384584)"
2021,Julio,Dinamarca,208,21,13,,34,"(4.697144,-74.140516)"
2021,Julio,Dinamarca,208,1,3,,4,"(6.171601,-75.427454)"
2021,Julio,Dominica,212,2,1,,3,"(3.541112,-76.384584)"
2021,Julio,Dominica,212,14,4,,18,"(4.697144,-74.140516)"
2021,Julio,Ecuador,218,31,40,,71,"(0.814836,-77.662532)"
2021,Julio,Ecuador,218,0,4,,4,"(1.813928,-78.763924)"
2021,Julio,Ecuador,218,1,6,,7,"(10.445761,-75.516429)"
2021,Julio,Ecuador,218,11,12,,23,"(10.886611,-74.776708)"
2021,Julio,Ecuador,218,43,47,,90,"(3.541112,-76.384584)"
2021,Julio,Ecuador,218,1744,2315,,4059,"(4.697144,-74.140516)"
2021,Julio,Ecuador,218,8,6,,14,"(4.815061,-75.736532)"
2021,Julio,Ecuador,218,61,93,,154,"(6.171601,-75.427454)"
2021,Julio,Ecuador,218,3,0,,3,"(7.128456,-73.183637)"
2021,Julio,Egipto,818,34,32,,66,"(4.697144,-74.140516)"
2021,Julio,El Salvador,222,8,7,,15,"(10.445761,-75.516429)"
2021,Julio,El Salvador,222,8,3,,11,"(10.886611,-74.776708)"
2021,Julio,El Salvador,222,12,33,,45,"(3.541112,-76.384584)"
2021,Julio,El Salvador,222,217,281,,498,"(4.697144,-74.140516)"
2021,Julio,El Salvador,222,39,36,,75,"(6.171601,-75.427454)"
2021,Julio,El Salvador,222,0,3,,3,"(7.128456,-73.183637)"
2021,Julio,Emiratos Árabes,784,4,2,,6,"(10.445761,-75.516429)"
2021,Julio,Emiratos Árabes,784,2,1,,3,"(3.541112,-76.384584)"
2021,Julio,Emiratos Árabes,784,176,187,,363,"(4.697144,-74.140516)"
2021,Julio,Emiratos Árabes,784,10,6,,16,"(6.171601,-75.427454)"
2021,Julio,Eslovaquia,703,0,3,,3,"(4.697144,-74.140516)"
2021,Julio,Eslovenia,705,4,1,,5,"(4.697144,-74.140516)"
2021,Julio,Eslovenia,705,1,0,,1,"(6.171601,-75.427454)"
2021,Julio,Estados Unidos de América,840,3884,2977,,6861,"(10.445761,-75.516429)"
2021,Julio,Estados Unidos de América,840,5743,4560,,10303,"(10.886611,-74.776708)"
2021,Julio,Estados Unidos de América,840,8,4,,12,"(11.117806,-74.232622)"
2021,Julio,Estados Unidos de América,840,5,3,,8,"(12.586067,-81.702563)"
2021,Julio,Estados Unidos de América,840,12521,9255,,21776,"(3.541112,-76.384584)"
2021,Julio,Estados Unidos de América,840,1203,909,,2112,"(4.452882,-75.766298)"
2021,Julio,Estados Unidos de América,840,50251,41964,,92215,"(4.697144,-74.140516)"
2021,Julio,Estados Unidos de América,840,2009,1387,,3396,"(4.815061,-75.736532)"
2021,Julio,Estados Unidos de América,840,19937,15946,,35883,"(6.171601,-75.427454)"
2021,Julio,Estados Unidos de América,840,1095,876,,1971,"(7.128456,-73.183637)"
2021,Julio,Estados Unidos de América,840,0,1,,1,"(7.927209,-72.507910)"
2021,Julio,Estonia,233,1,0,,1,"(3.541112,-76.384584)"
2021,Julio,Estonia,233,2,2,,4,"(4.697144,-74.140516)"
2021,Julio,Etiopia,231,1,4,,5,"(4.697144,-74.140516)"
2021,Julio,Filipinas,608,5,3,,8,"(4.697144,-74.140516)"
2021,Julio,Finlandia,246,2,0,,2,"(10.445761,-75.516429)"
2021,Julio,Finlandia,246,1,0,,1,"(3.541112,-76.384584)"
2021,Julio,Finlandia,246,11,8,,19,"(4.697144,-74.140516)"
2021,Julio,Finlandia,246,1,2,,3,"(6.171601,-75.427454)"
2021,Julio,Francia,250,12,5,,17,"(10.445761,-75.516429)"
2021,Julio,Francia,250,1,2,,3,"(10.886611,-74.776708)"
2021,Julio,Francia,250,29,7,,36,"(3.541112,-76.384584)"
2021,Julio,Francia,250,893,633,,1526,"(4.697144,-74.140516)"
2021,Julio,Francia,250,6,3,,9,"(4.815061,-75.736532)"
2021,Julio,Francia,250,35,33,,68,"(6.171601,-75.427454)"
2021,Julio,Georgia,268,1,2,,3,"(3.541112,-76.384584)"
2021,Julio,Georgia,268,1,0,,1,"(4.452882,-75.766298)"
2021,Julio,Georgia,268,2,3,,5,"(4.697144,-74.140516)"
2021,Julio,Ghana,288,2,4,,6,"(4.697144,-74.140516)"
2021,Julio,Granada,308,0,7,,7,"(3.541112,-76.384584)"
2021,Julio,Granada,308,0,1,,1,"(4.697144,-74.140516)"
2021,Julio,Granada,308,0,2,,2,"(6.171601,-75.427454)"
2021,Julio,Grecia,300,1,0,,1,"(10.445761,-75.516429)"
2021,Julio,Grecia,300,9,11,,20,"(4.697144,-74.140516)"
2021,Julio,Guatemala,320,0,2,,2,"(1.813928,-78.763924)"
2021,Julio,Guatemala,320,0,1,,1,"(10.408582,-75.538003)"
2021,Julio,Guatemala,320,1,1,,2,"(10.445761,-75.516429)"
2021,Julio,Guatemala,320,13,8,,21,"(10.886611,-74.776708)"
2021,Julio,Guatemala,320,2,4,,6,"(12.586067,-81.702563)"
2021,Julio,Guatemala,320,43,54,,97,"(3.541112,-76.384584)"
2021,Julio,Guatemala,320,239,364,,603,"(4.697144,-74.140516)"
2021,Julio,Guatemala,320,8,14,,22,"(4.815061,-75.736532)"
2021,Julio,Guatemala,320,79,90,,169,"(6.171601,-75.427454)"
2021,Julio,Guatemala,320,1,9,,10,"(7.128456,-73.183637)"
2021,Julio,Guyana,328,0,2,,2,"(10.445761,-75.516429)"
2021,Julio,Guyana,328,1,1,,2,"(10.886611,-74.776708)"
2021,Julio,Guyana,328,1,2,,3,"(3.541112,-76.384584)"
2021,Julio,Guyana,328,1,15,,16,"(4.697144,-74.140516)"
2021,Julio,Guyana,328,2,2,,4,"(4.815061,-75.736532)"
2021,Julio,Guyana,328,2,0,,2,"(6.171601,-75.427454)"
2021,Julio,Guinea Ecuatorial,226,2,2,,4,"(4.697144,-74.140516)"
2021,Julio,Guinea Bissau,624,1,0,,1,"(3.541112,-76.384584)"
2021,Julio,Guadalupe/Territorio Francés,312,1,2,,3,"(4.697144,-74.140516)"
2021,Julio,Guayana Francesa/Departamento de Ultramar Francés,254,0,3,,3,"(4.697144,-74.140516)"
2021,Julio,Haití,332,0,8,,8,"(4.697144,-74.140516)"
2021,Julio,Honduras,340,0,7,,7,"(10.408582,-75.538003)"
2021,Julio,Honduras,340,6,10,,16,"(10.445761,-75.516429)"
2021,Julio,Honduras,340,8,14,,22,"(10.886611,-74.776708)"
2021,Julio,Honduras,340,0,1,,1,"(12.5744111,-81.703935)"
2021,Julio,Honduras,340,8,22,,30,"(3.541112,-76.384584)"
2021,Julio,Honduras,340,77,116,,193,"(4.697144,-74.140516)"
2021,Julio,Honduras,340,22,55,,77,"(6.171601,-75.427454)"
2021,Julio,Honduras,340,2,5,,7,"(7.128456,-73.183637)"
2021,Julio,Hong Kong,344,1,1,,2,"(10.445761,-75.516429)"
2021,Julio,Hong Kong,344,1,1,,2,"(4.697144,-74.140516)"
2021,Julio,Hungría,348,1,0,,1,"(3.541112,-76.384584)"
2021,Julio,Hungría,348,6,6,,12,"(4.697144,-74.140516)"
2021,Julio,Hungría,348,1,0,,1,"(6.171601,-75.427454)"
2021,Julio,India,356,3,2,,5,"(4.697144,-74.140516)"
2021,Julio,Indonesia,360,0,1,,1,"(4.697144,-74.140516)"
2021,Julio,Iraq,368,0,1,,1,"(10.886611,-74.776708)"
2021,Julio,Iraq,368,0,5,,5,"(4.697144,-74.140516)"
2021,Julio,Irán,364,0,2,,2,"(4.697144,-74.140516)"
2021,Julio,República de Irlanda,372,1,2,,3,"(4.697144,-74.140516)"
2021,Julio,República de Irlanda,372,3,0,,3,"(6.171601,-75.427454)"
2021,Julio,República de Irlanda,372,0,1,,1,"(7.128456,-73.183637)"
2021,Julio,Islandia,352,5,8,,13,"(4.697144,-74.140516)"
2021,Julio,Israel,376,1,1,,2,"(10.445761,-75.516429)"
2021,Julio,Israel,376,0,1,,1,"(10.886611,-74.776708)"
2021,Julio,Israel,376,3,2,,5,"(3.541112,-76.384584)"
2021,Julio,Israel,376,37,31,,68,"(4.697144,-74.140516)"
2021,Julio,Israel,376,2,0,,2,"(6.171601,-75.427454)"
2021,Julio,Italia,380,36,15,,51,"(10.445761,-75.516429)"
2021,Julio,Italia,380,2,1,,3,"(10.886611,-74.776708)"
2021,Julio,Italia,380,77,39,,116,"(3.541112,-76.384584)"
2021,Julio,Italia,380,484,321,,805,"(4.697144,-74.140516)"
2021,Julio,Italia,380,38,36,,74,"(6.171601,-75.427454)"
2021,Julio,Jamaica,388,0,1,,1,"(10.445761,-75.516429)"
2021,Julio,Jamaica,388,3,7,,10,"(10.886611,-74.776708)"
2021,Julio,Jamaica,388,0,1,,1,"(4.697144,-74.140516)"
2021,Julio,Jamaica,388,0,1,,1,"(6.171601,-75.427454)"
2021,Julio,Japón,392,0,2,,2,"(3.541112,-76.384584)"
2021,Julio,Japón,392,16,42,,58,"(4.697144,-74.140516)"
2021,Julio,Japón,392,1,1,,2,"(4.815061,-75.736532)"
2021,Julio,Japón,392,3,1,,4,"(6.171601,-75.427454)"
2021,Julio,Jordania,400,8,5,,13,"(4.697144,-74.140516)"
2021,Julio,Kazajistán,398,2,2,,4,"(4.697144,-74.140516)"
2021,Julio,Kenia,404,0,1,,1,"(10.445761,-75.516429)"
2021,Julio,Kenia,404,10,7,,17,"(4.697144,-74.140516)"
2021,Julio,Kirguistán,417,0,1,,1,"(4.697144,-74.140516)"
2021,Julio,Kuwait,414,1,0,,1,"(10.886611,-74.776708)"
2021,Julio,Letonia,428,0,2,,2,"(4.697144,-74.140516)"
2021,Julio,Letonia,428,0,1,,1,"(6.171601,-75.427454)"
2021,Julio,Lituania,440,6,4,,10,"(4.697144,-74.140516)"
2021,Julio,Líbano,422,5,4,,9,"(10.886611,-74.776708)"
2021,Julio,Líbano,422,23,39,,62,"(4.697144,-74.140516)"
2021,Julio,Luxemburgo,442,2,1,,3,"(10.445761,-75.516429)"
2021,Julio,Luxemburgo,442,0,1,,1,"(3.541112,-76.384584)"
2021,Julio,Luxemburgo,442,15,5,,20,"(4.697144,-74.140516)"
2021,Julio,Luxemburgo,442,0,1,,1,"(4.815061,-75.736532)"
2021,Julio,Luxemburgo,442,0,1,,1,"(6.171601,-75.427454)"
2021,Julio,Macedonia,807,2,1,,3,"(4.697144,-74.140516)"
2021,Julio,Malasia,458,2,2,,4,"(4.697144,-74.140516)"
2021,Julio,Maldivas,462,2,1,,3,"(4.697144,-74.140516)"
2021,Julio,Malí,466,2,3,,5,"(4.697144,-74.140516)"
2021,Julio,Malta,470,35,24,,59,"(4.697144,-74.140516)"
2021,Julio,Malta,470,0,1,,1,"(6.171601,-75.427454)"
2021,Julio,Marruecos,504,2,1,,3,"(4.697144,-74.140516)"
2021,Julio,Mauritania,478,0,4,,4,"(4.697144,-74.140516)"
2021,Julio,Mauritania,478,1,0,,1,"(6.171601,-75.427454)"
2021,Julio,Martinica/Departamento de Ultramar Francés,474,2,1,,3,"(4.697144,-74.140516)"
2021,Julio,México,484,108,71,,179,"(10.445761,-75.516429)"
2021,Julio,México,484,247,172,,419,"(10.886611,-74.776708)"
2021,Julio,México,484,0,1,,1,"(10.971302,-74.765397)"
2021,Julio,México,484,1794,1377,,3171,"(3.541112,-76.384584)"
2021,Julio,México,484,12037,10270,,22307,"(4.697144,-74.140516)"
2021,Julio,México,484,85,64,,149,"(4.815061,-75.736532)"
2021,Julio,México,484,5420,4375,,9795,"(6.171601,-75.427454)"
2021,Julio,México,484,69,57,,126,"(7.128456,-73.183637)"
2021,Julio,Montenegro,499,0,2,,2,"(3.541112,-76.384584)"
2021,Julio,Montenegro,499,4,14,,18,"(4.697144,-74.140516)"
2021,Julio,Mozambique,508,2,2,,4,"(4.697144,-74.140516)"
2021,Julio,Myanmar,104,1,0,,1,"(6.171601,-75.427454)"
2021,Julio,Namibia,516,1,3,,4,"(4.697144,-74.140516)"
2021,Julio,Nicaragua,558,0,1,,1,"(10.445761,-75.516429)"
2021,Julio,Nicaragua,558,1,2,,3,"(10.886611,-74.776708)"
2021,Julio,Nicaragua,558,6,7,,13,"(3.541112,-76.384584)"
2021,Julio,Nicaragua,558,21,73,,94,"(4.697144,-74.140516)"
2021,Julio,Nicaragua,558,9,23,,32,"(6.171601,-75.427454)"
2021,Julio,Nigeria,566,2,8,,10,"(4.697144,-74.140516)"
2021,Julio,Noruega,578,1,3,,4,"(3.541112,-76.384584)"
2021,Julio,Noruega,578,37,22,,59,"(4.697144,-74.140516)"
2021,Julio,Noruega,578,3,4,,7,"(6.171601,-75.427454)"
2021,Julio,Omán,512,0,6,,6,"(4.697144,-74.140516)"
2021,Julio,Omán,512,0,2,,2,"(6.171601,-75.427454)"
2021,Julio,Papúa Nueva Guinea,598,1,0,,1,"(4.697144,-74.140516)"
2021,Julio,Pakistán,586,0,1,,1,"(10.445761,-75.516429)"
2021,Julio,Pakistán,586,0,1,,1,"(4.697144,-74.140516)"
2021,Julio,Panamá,591,10,28,,38,"(10.408582,-75.538003)"
2021,Julio,Panamá,591,657,456,,1113,"(10.445761,-75.516429)"
2021,Julio,Panamá,591,357,333,,690,"(10.886611,-74.776708)"
2021,Julio,Panamá,591,0,11,,11,"(10.971302,-74.765397)"
2021,Julio,Panamá,591,2,5,,7,"(12.5744111,-81.703935)"
2021,Julio,Panamá,591,3,10,,13,"(12.586067,-81.702563)"
2021,Julio,Panamá,591,1221,886,,2107,"(3.541112,-76.384584)"
2021,Julio,Panamá,591,2057,2311,,4368,"(4.697144,-74.140516)"
2021,Julio,Panamá,591,198,137,,335,"(4.815061,-75.736532)"
2021,Julio,Panamá,591,928,775,,1703,"(6.171601,-75.427454)"
2021,Julio,Panamá,591,0,12,,12,"(6.228046,-77.404104)"
2021,Julio,Panamá,591,0,1,,1,"(7.102626,-77.762647)"
2021,Julio,Panamá,591,33,32,,65,"(7.128456,-73.183637)"
2021,Julio,Paraguay,600,13,41,,54,"(10.886611,-74.776708)"
2021,Julio,Paraguay,600,8,23,,31,"(3.541112,-76.384584)"
2021,Julio,Paraguay,600,64,123,,187,"(4.697144,-74.140516)"
2021,Julio,Paraguay,600,2,2,,4,"(4.815061,-75.736532)"
2021,Julio,Paraguay,600,15,13,,28,"(6.171601,-75.427454)"
2021,Julio,Paraguay,600,1,1,,2,"(7.128456,-73.183637)"
2021,Julio,Perú,604,11,12,,23,"(-4.197703,-69.941278)"
2021,Julio,Perú,604,0,1,,1,"(0.814836,-77.662532)"
2021,Julio,Perú,604,3,7,,10,"(10.445761,-75.516429)"
2021,Julio,Perú,604,13,10,,23,"(10.886611,-74.776708)"
2021,Julio,Perú,604,58,36,,94,"(3.541112,-76.384584)"
2021,Julio,Perú,604,2026,2262,,4288,"(4.697144,-74.140516)"
2021,Julio,Perú,604,15,14,,29,"(4.815061,-75.736532)"
2021,Julio,Perú,604,473,478,,951,"(6.171601,-75.427454)"
2021,Julio,Perú,604,8,11,,19,"(7.128456,-73.183637)"
2021,Julio,Polonia,616,0,1,,1,"(10.445761,-75.516429)"
2021,Julio,Polonia,616,14,34,,48,"(4.697144,-74.140516)"
2021,Julio,Polonia,616,1,2,,3,"(6.171601,-75.427454)"
2021,Julio,Portugal,620,1,9,,10,"(10.445761,-75.516429)"
2021,Julio,Portugal,620,0,2,,2,"(3.541112,-76.384584)"
2021,Julio,Portugal,620,57,88,,145,"(4.697144,-74.140516)"
2021,Julio,Portugal,620,5,11,,16,"(6.171601,-75.427454)"
2021,Julio,Polinesia Francesa/Colectividad de Ultramar Francesa,258,1,0,,1,"(3.541112,-76.384584)"
2021,Julio,Polinesia Francesa/Colectividad de Ultramar Francesa,258,1,1,,2,"(4.697144,-74.140516)"
2021,Julio,Puerto Rico/Territorio de Estados Unidos,630,3,3,,6,"(10.445761,-75.516429)"
2021,Julio,Puerto Rico/Territorio de Estados Unidos,630,8,10,,18,"(10.886611,-74.776708)"
2021,Julio,Puerto Rico/Territorio de Estados Unidos,630,65,45,,110,"(3.541112,-76.384584)"
2021,Julio,Puerto Rico/Territorio de Estados Unidos,630,241,204,,445,"(4.697144,-74.140516)"
2021,Julio,Puerto Rico/Territorio de Estados Unidos,630,16,7,,23,"(4.815061,-75.736532)"
2021,Julio,Puerto Rico/Territorio de Estados Unidos,630,59,38,,97,"(6.171601,-75.427454)"
2021,Julio,Puerto Rico/Territorio de Estados Unidos,630,2,2,,4,"(7.128456,-73.183637)"
2021,Julio,Qatar,634,0,1,,1,"(10.445761,-75.516429)"
2021,Julio,Qatar,634,0,1,,1,"(10.886611,-74.776708)"
2021,Julio,Qatar,634,9,15,,24,"(4.697144,-74.140516)"
2021,Julio,Qatar,634,0,1,,1,"(6.171601,-75.427454)"
2021,Julio,Reino Unido de Gran Bretaña e Irlanda del Norte,826,0,1,,1,"(10.445761,-75.516429)"
2021,Julio,Reino Unido de Gran Bretaña e Irlanda del Norte,826,3,2,,5,"(3.541112,-76.384584)"
2021,Julio,Reino Unido de Gran Bretaña e Irlanda del Norte,826,47,33,,80,"(4.697144,-74.140516)"
2021,Julio,Reino Unido de Gran Bretaña e Irlanda del Norte,826,1,0,,1,"(4.815061,-75.736532)"
2021,Julio,Reino Unido de Gran Bretaña e Irlanda del Norte,826,8,4,,12,"(6.171601,-75.427454)"
2021,Julio,Federación de Rusia,643,1,3,,4,"(10.445761,-75.516429)"
2021,Julio,Federación de Rusia,643,9,31,,40,"(4.697144,-74.140516)"
2021,Julio,Federación de Rusia,643,1,0,,1,"(6.171601,-75.427454)"
2021,Julio,República Dominicana,214,19,22,,41,"(10.445761,-75.516429)"
2021,Julio,República Dominicana,214,73,63,,136,"(10.886611,-74.776708)"
2021,Julio,República Dominicana,214,314,236,,550,"(3.541112,-76.384584)"
2021,Julio,República Dominicana,214,4005,3391,,7396,"(4.697144,-74.140516)"
2021,Julio,República Dominicana,214,30,24,,54,"(4.815061,-75.736532)"
2021,Julio,República Dominicana,214,2326,1779,,4105,"(6.171601,-75.427454)"
2021,Julio,República Dominicana,214,22,9,,31,"(7.128456,-73.183637)"
2021,Julio,Reunión,638,0,1,,1,"(4.697144,-74.140516)"
2021,Julio,Rumania,642,15,14,,29,"(4.697144,-74.140516)"
2021,Julio,Rwanda,646,3,0,,3,"(4.697144,-74.140516)"
2021,Julio,Sahara Occidental/Desierto Sahara,732,1,0,,1,"(4.697144,-74.140516)"
2021,Julio,San  Vicente y las Granadinas,670,0,1,,1,"(4.697144,-74.140516)"
2021,Julio,Santo Tomé y Príncipe,678,0,1,,1,"(4.697144,-74.140516)"
2021,Julio,Senegal,686,1,0,,1,"(3.541112,-76.384584)"
2021,Julio,Senegal,686,1,1,,2,"(6.171601,-75.427454)"
2021,Julio,Serbia,688,4,6,,10,"(4.697144,-74.140516)"
2021,Julio,Singapur,702,1,1,,2,"(4.697144,-74.140516)"
2021,Julio,Sri Lanka,144,1,0,,1,"(4.697144,-74.140516)"
2021,Julio,Sudáfrica,710,1,0,,1,"(3.541112,-76.384584)"
2021,Julio,Sudáfrica,710,5,2,,7,"(4.697144,-74.140516)"
2021,Julio,Suecia,752,2,2,,4,"(10.445761,-75.516429)"
2021,Julio,Suecia,752,14,7,,21,"(3.541112,-76.384584)"
2021,Julio,Suecia,752,76,51,,127,"(4.697144,-74.140516)"
2021,Julio,Suecia,752,1,0,,1,"(4.815061,-75.736532)"
2021,Julio,Suecia,752,8,9,,17,"(6.171601,-75.427454)"
2021,Julio,Suiza,756,20,19,,39,"(10.445761,-75.516429)"
2021,Julio,Suiza,756,1,1,,2,"(10.886611,-74.776708)"
2021,Julio,Suiza,756,47,24,,71,"(3.541112,-76.384584)"
2021,Julio,Suiza,756,390,225,,615,"(4.697144,-74.140516)"
2021,Julio,Suiza,756,52,33,,85,"(6.171601,-75.427454)"
2021,Julio,Surinam,740,0,2,,2,"(4.697144,-74.140516)"
2021,Julio,Surinam,740,2,1,,3,"(6.171601,-75.427454)"
2021,Julio,Taiwán,158,0,1,,1,"(4.697144,-74.140516)"
2021,Julio,República de Tayikistán,762,0,1,,1,"(4.697144,-74.140516)"
2021,Julio,Tailandia,764,1,0,,1,"(10.886611,-74.776708)"
2021,Julio,Tailandia,764,6,6,,12,"(4.697144,-74.140516)"
2021,Julio,Tanzania,834,1,1,,2,"(4.697144,-74.140516)"
2021,Julio,Trinidad y Tobago,780,0,1,,1,"(10.886611,-74.776708)"
2021,Julio,Trinidad y Tobago,780,1,12,,13,"(10.971302,-74.765397)"
2021,Julio,Trinidad y Tobago,780,0,1,,1,"(3.541112,-76.384584)"
2021,Julio,Trinidad y Tobago,780,1,0,,1,"(6.171601,-75.427454)"
2021,Julio,Turquía,792,1,0,,1,"(10.886611,-74.776708)"
2021,Julio,Turquía,792,2,3,,5,"(3.541112,-76.384584)"
2021,Julio,Turquía,792,531,428,,959,"(4.697144,-74.140516)"
2021,Julio,Turquía,792,8,7,,15,"(6.171601,-75.427454)"
2021,Julio,Turkmenistán,795,0,3,,3,"(4.697144,-74.140516)"
2021,Julio,Ucrania,804,2,1,,3,"(3.541112,-76.384584)"
2021,Julio,Ucrania,804,15,14,,29,"(4.697144,-74.140516)"
2021,Julio,Ucrania,804,1,0,,1,"(6.171601,-75.427454)"
2021,Julio,Uruguay,858,3,0,,3,"(10.445761,-75.516429)"
2021,Julio,Uruguay,858,1,0,,1,"(10.886611,-74.776708)"
2021,Julio,Uruguay,858,9,9,,18,"(3.541112,-76.384584)"
2021,Julio,Uruguay,858,29,35,,64,"(4.697144,-74.140516)"
2021,Julio,Uruguay,858,9,10,,19,"(4.815061,-75.736532)"
2021,Julio,Uruguay,858,3,5,,8,"(6.171601,-75.427454)"
2021,Julio,Uruguay,858,3,0,,3,"(7.128456,-73.183637)"
2021,Julio,Uzbekistán,860,0,4,,4,"(4.697144,-74.140516)"
2021,Julio,Venezuela,862,3,2,,5,"(10.445761,-75.516429)"
2021,Julio,Venezuela,862,16,8,,24,"(10.886611,-74.776708)"
2021,Julio,Venezuela,862,38,216,,254,"(11.360009,-72.129330)"
2021,Julio,Venezuela,862,12,11,,23,"(3.541112,-76.384584)"
2021,Julio,Venezuela,862,0,1,,1,"(3.866713,-67.927521)"
2021,Julio,Venezuela,862,88,176,,264,"(4.697144,-74.140516)"
2021,Julio,Venezuela,862,26,30,,56,"(6.171601,-75.427454)"
2021,Julio,Venezuela,862,0,2,,2,"(6.185799,-67.483929)"
2021,Julio,Venezuela,862,1,1,,2,"(7.088729,-70.740253)"
2021,Julio,Venezuela,862,2,3,,5,"(7.128456,-73.183637)"
2021,Julio,Venezuela,862,34,57,,91,"(7.818934,-72.453226)"
2021,Julio,Venezuela,862,2,5,,7,"(7.916725,-72.462544)"
2021,Julio,Venezuela,862,1,1,,2,"(8.36068,-72.409396)"
2021,Julio,Islas Vírgenes Estadounidenses/Territorio de Estados Unidos,850,1,1,,2,"(3.541112,-76.384584)"
2021,Julio,Islas Vírgenes Estadounidenses/Territorio de Estados Unidos,850,0,1,,1,"(4.697144,-74.140516)"
2021,Julio,Zambia,894,1,1,,2,"(4.697144,-74.140516)"
2021,Julio,Islas Turcas y Caicos/Territorio Británico de Ultramar,796,3,1,,4,"(10.445761,-75.516429)"
2021,Julio,Islas Turcas y Caicos/Territorio Británico de Ultramar,796,1,4,,5,"(10.886611,-74.776708)"
2021,Julio,Islas Turcas y Caicos/Territorio Británico de Ultramar,796,3,0,,3,"(3.541112,-76.384584)"
2021,Julio,Islas Turcas y Caicos/Territorio Británico de Ultramar,796,3,0,,3,"(4.697144,-74.140516)"
2021,Julio,Islas Turcas y Caicos/Territorio Británico de Ultramar,796,1,1,,2,"(4.815061,-75.736532)"
2021,Julio,Desconocido,99999,0,2,,2,"(10.445761,-75.516429)"
2021,Julio,Desconocido,99999,1,0,,1,"(10.886611,-74.776708)"
2021,Julio,Desconocido,99999,1,0,,1,"(3.541112,-76.384584)"
2021,Julio,Desconocido,99999,1,0,,1,"(6.171601,-75.427454)"
2021,Agosto,Albania,8,1,0,,1,"(3.541112,-76.384584)"
2021,Agosto,Albania,8,2,1,,3,"(4.697144,-74.140516)"
2021,Agosto,Alemania,276,55,19,,74,"(10.445761,-75.516429)"
2021,Agosto,Alemania,276,7,2,,9,"(10.886611,-74.776708)"
2021,Agosto,Alemania,276,47,26,,73,"(3.541112,-76.384584)"
2021,Agosto,Alemania,276,1455,939,,2394,"(4.697144,-74.140516)"
2021,Agosto,Alemania,276,1,3,,4,"(4.815061,-75.736532)"
2021,Agosto,Alemania,276,66,34,,100,"(6.171601,-75.427454)"
2021,Agosto,Andorra,20,4,5,,9,"(4.697144,-74.140516)"
2021,Agosto,Andorra,20,0,1,,1,"(6.171601,-75.427454)"
2021,Agosto,Angola,24,0,4,,4,"(4.697144,-74.140516)"
2021,Agosto,Antigua y Barbuda,28,3,5,,8,"(10.886611,-74.776708)"
2021,Agosto,Antigua y Barbuda,28,2,4,,6,"(4.697144,-74.140516)"
2021,Agosto,Países Bajos,528,141,62,,203,"(10.445761,-75.516429)"
2021,Agosto,Países Bajos,528,19,14,,33,"(10.886611,-74.776708)"
2021,Agosto,Países Bajos,528,42,27,,69,"(3.541112,-76.384584)"
2021,Agosto,Países Bajos,528,794,532,,1326,"(4.697144,-74.140516)"
2021,Agosto,Países Bajos,528,1,0,,1,"(4.815061,-75.736532)"
2021,Agosto,Países Bajos,528,1,4,,5,"(6.17134,-75.427194)"
2021,Agosto,Países Bajos,528,53,27,,80,"(6.171601,-75.427454)"
2021,Agosto,Países Bajos,528,1,1,,2,"(7.128456,-73.183637)"
2021,Agosto,Arabia Saudita,682,0,1,,1,"(10.445761,-75.516429)"
2021,Agosto,Arabia Saudita,682,1,1,,2,"(3.541112,-76.384584)"
2021,Agosto,Arabia Saudita,682,29,52,,81,"(4.697144,-74.140516)"
2021,Agosto,Arabia Saudita,682,2,3,,5,"(6.171601,-75.427454)"
2021,Agosto,Argelia,12,0,2,,2,"(4.697144,-74.140516)"
2021,Agosto,Argentina,32,2,1,,3,"(10.445761,-75.516429)"
2021,Agosto,Argentina,32,6,1,,7,"(10.886611,-74.776708)"
2021,Agosto,Argentina,32,5,2,,7,"(3.541112,-76.384584)"
2021,Agosto,Argentina,32,392,284,,676,"(4.697144,-74.140516)"
2021,Agosto,Argentina,32,3,3,,6,"(6.171601,-75.427454)"
2021,Agosto,República de Armenia,51,1,0,,1,"(10.445761,-75.516429)"
2021,Agosto,Aruba,533,2,3,,5,"(10.445761,-75.516429)"
2021,Agosto,Aruba,533,26,20,,46,"(10.886611,-74.776708)"
2021,Agosto,Aruba,533,48,28,,76,"(3.541112,-76.384584)"
2021,Agosto,Aruba,533,1523,1102,,2625,"(4.697144,-74.140516)"
2021,Agosto,Aruba,533,28,22,,50,"(6.171601,-75.427454)"
2021,Agosto,Aruba,533,24,69,,93,"(7.128456,-73.183637)"
2021,Agosto,Australia,36,0,1,,1,"(3.541112,-76.384584)"
2021,Agosto,Australia,36,6,3,,9,"(4.697144,-74.140516)"
2021,Agosto,Australia,36,2,1,,3,"(6.171601,-75.427454)"
2021,Agosto,Austria,40,5,8,,13,"(10.445761,-75.516429)"
2021,Agosto,Austria,40,2,1,,3,"(3.541112,-76.384584)"
2021,Agosto,Austria,40,97,65,,162,"(4.697144,-74.140516)"
2021,Agosto,Austria,40,8,7,,15,"(6.171601,-75.427454)"
2021,Agosto,Azerbaiyán,31,1,0,,1,"(4.697144,-74.140516)"
2021,Agosto,Bahamas,44,1,3,,4,"(10.445761,-75.516429)"
2021,Agosto,Bahamas,44,7,4,,11,"(10.886611,-74.776708)"
2021,Agosto,Bahamas,44,29,21,,50,"(3.541112,-76.384584)"
2021,Agosto,Bahamas,44,28,35,,63,"(4.697144,-74.140516)"
2021,Agosto,Bahamas,44,35,62,,97,"(6.171601,-75.427454)"
2021,Agosto,Bahréin,48,1,1,,2,"(10.445761,-75.516429)"
2021,Agosto,Bahréin,48,0,1,,1,"(11.360009,-72.129330)"
2021,Agosto,Bahréin,48,1,3,,4,"(3.541112,-76.384584)"
2021,Agosto,Bahréin,48,5,10,,15,"(4.697144,-74.140516)"
2021,Agosto,Bangladesh,50,0,2,,2,"(4.697144,-74.140516)"
2021,Agosto,Barbados,52,6,2,,8,"(4.697144,-74.140516)"
2021,Agosto,República de Belarús,112,1,0,,1,"(4.697144,-74.140516)"
2021,Agosto,Bélgica,56,6,4,,10,"(10.445761,-75.516429)"
2021,Agosto,Bélgica,56,6,5,,11,"(3.541112,-76.384584)"
2021,Agosto,Bélgica,56,130,81,,211,"(4.697144,-74.140516)"
2021,Agosto,Bélgica,56,8,5,,13,"(4.815061,-75.736532)"
2021,Agosto,Bélgica,56,43,28,,71,"(6.171601,-75.427454)"
2021,Agosto,Belice,84,0,6,,6,"(3.541112,-76.384584)"
2021,Agosto,Belice,84,4,6,,10,"(4.697144,-74.140516)"
2021,Agosto,Belice,84,3,5,,8,"(6.171601,-75.427454)"
2021,Agosto,Benín,204,0,1,,1,"(4.697144,-74.140516)"
2021,Agosto,Bermudas/Territorio Británico de Ultramar,60,0,2,,2,"(4.697144,-74.140516)"
2021,Agosto,Bermudas/Territorio Británico de Ultramar,60,2,0,,2,"(4.815061,-75.736532)"
2021,Agosto,Bermudas/Territorio Británico de Ultramar,60,1,3,,4,"(6.171601,-75.427454)"
2021,Agosto,Bolivia,68,1,1,,2,"(10.886611,-74.776708)"
2021,Agosto,Bolivia,68,6,3,,9,"(3.541112,-76.384584)"
2021,Agosto,Bolivia,68,279,488,,767,"(4.697144,-74.140516)"
2021,Agosto,Bolivia,68,0,4,,4,"(4.815061,-75.736532)"
2021,Agosto,Bolivia,68,5,12,,17,"(6.171601,-75.427454)"
2021,Agosto,Bolivia,68,0,7,,7,"(7.128456,-73.183637)"
2021,Agosto,Bosnia y Herzegovina,70,0,1,,1,"(3.541112,-76.384584)"
2021,Agosto,Bosnia y Herzegovina,70,42,20,,62,"(4.697144,-74.140516)"
2021,Agosto,Botsuana,72,0,1,,1,"(4.697144,-74.140516)"
2021,Agosto,Brasil,76,46,80,,126,"(-4.197703,-69.941278)"
2021,Agosto,Brasil,76,17,26,,43,"(10.445761,-75.516429)"
2021,Agosto,Brasil,76,22,22,,44,"(10.886611,-74.776708)"
2021,Agosto,Brasil,76,97,138,,235,"(3.541112,-76.384584)"
2021,Agosto,Brasil,76,1060,1395,,2455,"(4.697144,-74.140516)"
2021,Agosto,Brasil,76,50,117,,167,"(4.815061,-75.736532)"
2021,Agosto,Brasil,76,98,135,,233,"(6.171601,-75.427454)"
2021,Agosto,Brasil,76,3,4,,7,"(7.128456,-73.183637)"
2021,Agosto,Brasil,76,0,1,,1,"(8.066966,-76.735404)"
2021,Agosto,Bulgaria,100,2,0,,2,"(3.541112,-76.384584)"
2021,Agosto,Bulgaria,100,4,2,,6,"(4.697144,-74.140516)"
2021,Agosto,Cabo Verde,132,0,1,,1,"(4.697144,-74.140516)"
2021,Agosto,Cabo Verde,132,0,1,,1,"(6.171601,-75.427454)"
2021,Agosto,Islas Caimán/Territorio Británico de Ultramar,136,1,0,,1,"(10.445761,-75.516429)"
2021,Agosto,Islas Caimán/Territorio Británico de Ultramar,136,2,1,,3,"(4.697144,-74.140516)"
2021,Agosto,Camboya,116,1,1,,2,"(4.697144,-74.140516)"
2021,Agosto,Camerún,120,4,5,,9,"(6.171601,-75.427454)"
2021,Agosto,Canadá,124,23,15,,38,"(10.445761,-75.516429)"
2021,Agosto,Canadá,124,70,44,,114,"(10.886611,-74.776708)"
2021,Agosto,Canadá,124,124,98,,222,"(3.541112,-76.384584)"
2021,Agosto,Canadá,124,1746,1512,,3258,"(4.697144,-74.140516)"
2021,Agosto,Canadá,124,26,18,,44,"(4.815061,-75.736532)"
2021,Agosto,Canadá,124,276,238,,514,"(6.171601,-75.427454)"
2021,Agosto,Canadá,124,9,8,,17,"(7.128456,-73.183637)"
2021,Agosto,Chad,148,1,0,,1,"(6.171601,-75.427454)"
2021,Agosto,España,724,41,21,,62,"(10.445761,-75.516429)"
2021,Agosto,España,724,10,8,,18,"(10.886611,-74.776708)"
2021,Agosto,España,724,1009,529,,1538,"(3.541112,-76.384584)"
2021,Agosto,España,724,5830,3926,,9756,"(4.697144,-74.140516)"
2021,Agosto,España,724,21,13,,34,"(4.815061,-75.736532)"
2021,Agosto,España,724,597,390,,987,"(6.171601,-75.427454)"
2021,Agosto,España,724,1,0,,1,"(7.128456,-73.183637)"
2021,Agosto,Colombia,170,29,57,,86,"(4.697144,-74.140516)"
2021,Agosto,República Del Congo,178,0,1,,1,"(4.697144,-74.140516)"
2021,Agosto,República Democrática del Congo,180,1,0,,1,"(4.697144,-74.140516)"
2021,Agosto,República Democrática del Congo,180,3,1,,4,"(6.171601,-75.427454)"
2021,Agosto,República de Corea,410,1,1,,2,"(3.541112,-76.384584)"
2021,Agosto,República de Corea,410,51,68,,119,"(4.697144,-74.140516)"
2021,Agosto,República de Corea,410,1,0,,1,"(6.171601,-75.427454)"
2021,Agosto,República de Corea,410,1,0,,1,"(7.128456,-73.183637)"
2021,Agosto,Costa de Marfil,384,0,1,,1,"(3.541112,-76.384584)"
2021,Agosto,Costa de Marfil,384,1,7,,8,"(4.697144,-74.140516)"
2021,Agosto,Costa de Marfil,384,0,1,,1,"(6.171601,-75.427454)"
2021,Agosto,Costa Rica,188,3,7,,10,"(10.445761,-75.516429)"
2021,Agosto,Costa Rica,188,23,25,,48,"(10.886611,-74.776708)"
2021,Agosto,Costa Rica,188,0,1,,1,"(12.5744111,-81.703935)"
2021,Agosto,Costa Rica,188,65,76,,141,"(3.541112,-76.384584)"
2021,Agosto,Costa Rica,188,776,847,,1623,"(4.697144,-74.140516)"
2021,Agosto,Costa Rica,188,27,28,,55,"(4.815061,-75.736532)"
2021,Agosto,Costa Rica,188,150,161,,311,"(6.171601,-75.427454)"
2021,Agosto,Costa Rica,188,4,4,,8,"(7.128456,-73.183637)"
2021,Agosto,Croacia,191,1,1,,2,"(10.445761,-75.516429)"
2021,Agosto,Croacia,191,0,2,,2,"(3.541112,-76.384584)"
2021,Agosto,Croacia,191,34,28,,62,"(4.697144,-74.140516)"
2021,Agosto,Croacia,191,4,1,,5,"(6.171601,-75.427454)"
2021,Agosto,Cuba,192,0,25,,25,"(10.886611,-74.776708)"
2021,Agosto,Cuba,192,105,131,,236,"(4.697144,-74.140516)"
2021,Agosto,Curazao,99999,64,47,,111,"(10.886611,-74.776708)"
2021,Agosto,Curazao,99999,24,11,,35,"(3.541112,-76.384584)"
2021,Agosto,Curazao,99999,288,277,,565,"(4.697144,-74.140516)"
2021,Agosto,Curazao,99999,32,9,,41,"(6.171601,-75.427454)"
2021,Agosto,República Checa,203,6,6,,12,"(4.697144,-74.140516)"
2021,Agosto,Chile,152,3,1,,4,"(10.445761,-75.516429)"
2021,Agosto,Chile,152,6,7,,13,"(10.886611,-74.776708)"
2021,Agosto,Chile,152,234,184,,418,"(3.541112,-76.384584)"
2021,Agosto,Chile,152,1369,1096,,2465,"(4.697144,-74.140516)"
2021,Agosto,Chile,152,3,1,,4,"(4.815061,-75.736532)"
2021,Agosto,Chile,152,14,9,,23,"(6.171601,-75.427454)"
2021,Agosto,Chile,152,1,1,,2,"(7.128456,-73.183637)"
2021,Agosto,China,156,4,4,,8,"(4.697144,-74.140516)"
2021,Agosto,Chipre,196,4,3,,7,"(4.697144,-74.140516)"
2021,Agosto,Dinamarca,208,5,2,,7,"(10.445761,-75.516429)"
2021,Agosto,Dinamarca,208,40,31,,71,"(4.697144,-74.140516)"
2021,Agosto,Dinamarca,208,0,1,,1,"(4.815061,-75.736532)"
2021,Agosto,Dinamarca,208,1,3,,4,"(6.171601,-75.427454)"
2021,Agosto,Dominica,212,1,1,,2,"(10.445761,-75.516429)"
2021,Agosto,Dominica,212,3,3,,6,"(4.697144,-74.140516)"
2021,Agosto,Dominica,212,1,1,,2,"(6.171601,-75.427454)"
2021,Agosto,Ecuador,218,38,25,,63,"(0.814836,-77.662532)"
2021,Agosto,Ecuador,218,5,4,,9,"(10.445761,-75.516429)"
2021,Agosto,Ecuador,218,14,28,,42,"(10.886611,-74.776708)"
2021,Agosto,Ecuador,218,31,66,,97,"(3.541112,-76.384584)"
2021,Agosto,Ecuador,218,1826,2484,,4310,"(4.697144,-74.140516)"
2021,Agosto,Ecuador,218,17,15,,32,"(4.815061,-75.736532)"
2021,Agosto,Ecuador,218,65,106,,171,"(6.171601,-75.427454)"
2021,Agosto,Ecuador,218,7,7,,14,"(7.128456,-73.183637)"
2021,Agosto,Egipto,818,1,0,,1,"(3.541112,-76.384584)"
2021,Agosto,Egipto,818,40,31,,71,"(4.697144,-74.140516)"
2021,Agosto,Egipto,818,1,1,,2,"(6.171601,-75.427454)"
2021,Agosto,El Salvador,222,3,2,,5,"(10.445761,-75.516429)"
2021,Agosto,El Salvador,222,8,14,,22,"(10.886611,-74.776708)"
2021,Agosto,El Salvador,222,23,35,,58,"(3.541112,-76.384584)"
2021,Agosto,El Salvador,222,182,293,,475,"(4.697144,-74.140516)"
2021,Agosto,El Salvador,222,1,0,,1,"(4.815061,-75.736532)"
2021,Agosto,El Salvador,222,39,47,,86,"(6.171601,-75.427454)"
2021,Agosto,El Salvador,222,2,4,,6,"(7.128456,-73.183637)"
2021,Agosto,Emiratos Árabes,784,7,5,,12,"(10.445761,-75.516429)"
2021,Agosto,Emiratos Árabes,784,2,1,,3,"(10.886611,-74.776708)"
2021,Agosto,Emiratos Árabes,784,8,7,,15,"(3.541112,-76.384584)"
2021,Agosto,Emiratos Árabes,784,236,221,,457,"(4.697144,-74.140516)"
2021,Agosto,Emiratos Árabes,784,21,11,,32,"(6.171601,-75.427454)"
2021,Agosto,Eslovaquia,703,1,6,,7,"(4.697144,-74.140516)"
2021,Agosto,Eslovenia,705,1,0,,1,"(10.445761,-75.516429)"
2021,Agosto,Eslovenia,705,1,4,,5,"(4.697144,-74.140516)"
2021,Agosto,Estados Unidos de América,840,3133,2401,,5534,"(10.445761,-75.516429)"
2021,Agosto,Estados Unidos de América,840,4478,3478,,7956,"(10.886611,-74.776708)"
2021,Agosto,Estados Unidos de América,840,3,10,,13,"(11.117806,-74.232622)"
2021,Agosto,Estados Unidos de América,840,10514,7844,,18358,"(3.541112,-76.384584)"
2021,Agosto,Estados Unidos de América,840,1057,804,,1861,"(4.452882,-75.766298)"
2021,Agosto,Estados Unidos de América,840,39693,32494,,72188,"(4.697144,-74.140516)"
2021,Agosto,Estados Unidos de América,840,2224,1435,,3659,"(4.815061,-75.736532)"
2021,Agosto,Estados Unidos de América,840,15863,11942,,27805,"(6.171601,-75.427454)"
2021,Agosto,Estados Unidos de América,840,837,640,,1477,"(7.128456,-73.183637)"
2021,Agosto,Estonia,233,4,4,,8,"(4.697144,-74.140516)"
2021,Agosto,Estonia,233,0,1,,1,"(6.171601,-75.427454)"
2021,Agosto,Etiopia,231,1,4,,5,"(4.697144,-74.140516)"
2021,Agosto,Islas Fiji,242,0,1,,1,"(7.128456,-73.183637)"
2021,Agosto,Filipinas,608,1,2,,3,"(10.886611,-74.776708)"
2021,Agosto,Filipinas,608,0,2,,2,"(4.697144,-74.140516)"
2021,Agosto,Finlandia,246,1,0,,1,"(3.541112,-76.384584)"
2021,Agosto,Finlandia,246,24,19,,43,"(4.697144,-74.140516)"
2021,Agosto,Finlandia,246,1,0,,1,"(6.171601,-75.427454)"
2021,Agosto,Francia,250,48,39,,87,"(10.445761,-75.516429)"
2021,Agosto,Francia,250,9,7,,16,"(10.886611,-74.776708)"
2021,Agosto,Francia,250,104,69,,173,"(3.541112,-76.384584)"
2021,Agosto,Francia,250,2496,1669,,4165,"(4.697144,-74.140516)"
2021,Agosto,Francia,250,29,20,,49,"(4.815061,-75.736532)"
2021,Agosto,Francia,250,135,67,,202,"(6.171601,-75.427454)"
2021,Agosto,Francia,250,1,0,,1,"(7.128456,-73.183637)"
2021,Agosto,Gabón,266,0,1,,1,"(4.697144,-74.140516)"
2021,Agosto,Georgia,268,1,0,,1,"(10.445761,-75.516429)"
2021,Agosto,Georgia,268,1,1,,2,"(3.541112,-76.384584)"
2021,Agosto,Georgia,268,1,0,,1,"(4.452882,-75.766298)"
2021,Agosto,Georgia,268,8,7,,15,"(4.697144,-74.140516)"
2021,Agosto,Georgia,268,3,2,,5,"(6.171601,-75.427454)"
2021,Agosto,Ghana,288,4,4,,8,"(4.697144,-74.140516)"
2021,Agosto,Grecia,300,4,1,,5,"(10.445761,-75.516429)"
2021,Agosto,Grecia,300,1,1,,2,"(3.541112,-76.384584)"
2021,Agosto,Grecia,300,21,21,,42,"(4.697144,-74.140516)"
2021,Agosto,Groenlandia,304,1,0,,1,"(4.697144,-74.140516)"
2021,Agosto,Guatemala,320,0,1,,1,"(1.813928,-78.763924)"
2021,Agosto,Guatemala,320,2,0,,2,"(10.445761,-75.516429)"
2021,Agosto,Guatemala,320,11,29,,40,"(10.886611,-74.776708)"
2021,Agosto,Guatemala,320,0,6,,6,"(12.586067,-81.702563)"
2021,Agosto,Guatemala,320,41,53,,94,"(3.541112,-76.384584)"
2021,Agosto,Guatemala,320,337,450,,787,"(4.697144,-74.140516)"
2021,Agosto,Guatemala,320,11,19,,30,"(4.815061,-75.736532)"
2021,Agosto,Guatemala,320,113,88,,201,"(6.171601,-75.427454)"
2021,Agosto,Guatemala,320,4,9,,13,"(7.128456,-73.183637)"
2021,Agosto,Guyana,328,4,6,,10,"(10.886611,-74.776708)"
2021,Agosto,Guyana,328,1,0,,1,"(3.541112,-76.384584)"
2021,Agosto,Guyana,328,8,18,,26,"(4.697144,-74.140516)"
2021,Agosto,Guyana,328,0,6,,6,"(6.171601,-75.427454)"
2021,Agosto,Guinea Ecuatorial,226,2,5,,7,"(4.697144,-74.140516)"
2021,Agosto,Guadalupe/Territorio Francés,312,2,1,,3,"(4.697144,-74.140516)"
2021,Agosto,Guayana Francesa/Departamento de Ultramar Francés,254,3,8,,11,"(4.697144,-74.140516)"
2021,Agosto,Haití,332,0,2,,2,"(12.586067,-81.702563)"
2021,Agosto,Haití,332,1,0,,1,"(3.541112,-76.384584)"
2021,Agosto,Haití,332,4,35,,39,"(4.697144,-74.140516)"
2021,Agosto,Haití,332,0,1,,1,"(7.128456,-73.183637)"
2021,Agosto,Honduras,340,3,3,,6,"(10.445761,-75.516429)"
2021,Agosto,Honduras,340,19,25,,44,"(10.886611,-74.776708)"
2021,Agosto,Honduras,340,0,3,,3,"(12.5744111,-81.703935)"
2021,Agosto,Honduras,340,13,37,,50,"(3.541112,-76.384584)"
2021,Agosto,Honduras,340,53,124,,177,"(4.697144,-74.140516)"
2021,Agosto,Honduras,340,0,1,,1,"(4.815061,-75.736532)"
2021,Agosto,Honduras,340,39,61,,100,"(6.171601,-75.427454)"
2021,Agosto,Honduras,340,3,6,,9,"(7.128456,-73.183637)"
2021,Agosto,Hong Kong,344,8,3,,11,"(4.697144,-74.140516)"
2021,Agosto,Hungría,348,1,0,,1,"(10.445761,-75.516429)"
2021,Agosto,Hungría,348,2,1,,3,"(3.541112,-76.384584)"
2021,Agosto,Hungría,348,35,27,,62,"(4.697144,-74.140516)"
2021,Agosto,Hungría,348,0,1,,1,"(6.171601,-75.427454)"
2021,Agosto,India,356,0,2,,2,"(10.445761,-75.516429)"
2021,Agosto,India,356,3,3,,6,"(4.697144,-74.140516)"
2021,Agosto,India,356,1,1,,2,"(6.171601,-75.427454)"
2021,Agosto,Indonesia,360,3,3,,6,"(4.697144,-74.140516)"
2021,Agosto,Iraq,368,2,5,,7,"(4.697144,-74.140516)"
2021,Agosto,Irán,364,5,17,,22,"(4.697144,-74.140516)"
2021,Agosto,República de Irlanda,372,10,4,,14,"(4.697144,-74.140516)"
2021,Agosto,Islandia,352,1,2,,3,"(3.541112,-76.384584)"
2021,Agosto,Islandia,352,6,7,,13,"(4.697144,-74.140516)"
2021,Agosto,Islandia,352,0,1,,1,"(6.171601,-75.427454)"
2021,Agosto,Israel,376,4,0,,4,"(10.445761,-75.516429)"
2021,Agosto,Israel,376,3,0,,3,"(3.541112,-76.384584)"
2021,Agosto,Israel,376,50,20,,70,"(4.697144,-74.140516)"
2021,Agosto,Israel,376,1,0,,1,"(6.171601,-75.427454)"
2021,Agosto,Italia,380,44,14,,58,"(10.445761,-75.516429)"
2021,Agosto,Italia,380,4,3,,7,"(10.886611,-74.776708)"
2021,Agosto,Italia,380,65,34,,99,"(3.541112,-76.384584)"
2021,Agosto,Italia,380,623,399,,1022,"(4.697144,-74.140516)"
2021,Agosto,Italia,380,1,1,,2,"(4.815061,-75.736532)"
2021,Agosto,Italia,380,58,36,,94,"(6.171601,-75.427454)"
2021,Agosto,Jamaica,388,0,2,,2,"(10.445761,-75.516429)"
2021,Agosto,Jamaica,388,2,6,,8,"(4.697144,-74.140516)"
2021,Agosto,Japón,392,4,0,,4,"(10.445761,-75.516429)"
2021,Agosto,Japón,392,33,53,,86,"(4.697144,-74.140516)"
2021,Agosto,Japón,392,0,2,,2,"(6.171601,-75.427454)"
2021,Agosto,Jordania,400,5,5,,10,"(4.697144,-74.140516)"
2021,Agosto,Kazajistán,398,0,1,,1,"(4.697144,-74.140516)"
2021,Agosto,Kenia,404,0,1,,1,"(10.886611,-74.776708)"
2021,Agosto,Kenia,404,48,29,,77,"(4.697144,-74.140516)"
2021,Agosto,Kenia,404,2,0,,2,"(6.171601,-75.427454)"
2021,Agosto,Kuwait,414,11,7,,18,"(4.697144,-74.140516)"
2021,Agosto,República de Kosovo,901,0,1,,1,"(4.697144,-74.140516)"
2021,Agosto,Letonia,428,1,0,,1,"(4.697144,-74.140516)"
2021,Agosto,Lituania,440,4,2,,6,"(4.697144,-74.140516)"
2021,Agosto,Líbano,422,1,2,,3,"(10.886611,-74.776708)"
2021,Agosto,Líbano,422,10,14,,24,"(4.697144,-74.140516)"
2021,Agosto,Líbano,422,0,1,,1,"(6.171601,-75.427454)"
2021,Agosto,Liberia,430,0,1,,1,"(4.697144,-74.140516)"
2021,Agosto,Libia,434,0,1,,1,"(4.697144,-74.140516)"
2021,Agosto,Liechtenstein,438,0,1,,1,"(3.541112,-76.384584)"
2021,Agosto,Luxemburgo,442,1,2,,3,"(10.445761,-75.516429)"
2021,Agosto,Luxemburgo,442,3,2,,5,"(3.541112,-76.384584)"
2021,Agosto,Luxemburgo,442,23,15,,38,"(4.697144,-74.140516)"
2021,Agosto,Luxemburgo,442,2,2,,4,"(6.171601,-75.427454)"
2021,Agosto,Malasia,458,0,1,,1,"(4.697144,-74.140516)"
2021,Agosto,Maldivas,462,0,1,,1,"(10.886611,-74.776708)"
2021,Agosto,Maldivas,462,6,4,,10,"(4.697144,-74.140516)"
2021,Agosto,Malí,466,0,2,,2,"(4.697144,-74.140516)"
2021,Agosto,Malta,470,25,18,,43,"(4.697144,-74.140516)"
2021,Agosto,Malta,470,1,0,,1,"(6.171601,-75.427454)"
2021,Agosto,Marruecos,504,0,1,,1,"(3.541112,-76.384584)"
2021,Agosto,Marruecos,504,4,3,,7,"(4.697144,-74.140516)"
2021,Agosto,Marruecos,504,2,0,,2,"(6.171601,-75.427454)"
2021,Agosto,Mauricio,480,1,1,,2,"(4.697144,-74.140516)"
2021,Agosto,Mauritania,478,0,3,,3,"(4.697144,-74.140516)"
2021,Agosto,Martinica/Departamento de Ultramar Francés,474,1,0,,1,"(4.697144,-74.140516)"
2021,Agosto,México,484,2,5,,7,"(10.408582,-75.538003)"
2021,Agosto,México,484,81,58,,139,"(10.445761,-75.516429)"
2021,Agosto,México,484,304,253,,557,"(10.886611,-74.776708)"
2021,Agosto,México,484,1933,1569,,3502,"(3.541112,-76.384584)"
2021,Agosto,México,484,12193,10522,,22715,"(4.697144,-74.140516)"
2021,Agosto,México,484,99,61,,160,"(4.815061,-75.736532)"
2021,Agosto,México,484,6659,5259,,11918,"(6.171601,-75.427454)"
2021,Agosto,México,484,104,72,,176,"(7.128456,-73.183637)"
2021,Agosto,República de Moldavia,498,0,1,,1,"(4.697144,-74.140516)"
2021,Agosto,Mongolia,496,1,4,,5,"(4.697144,-74.140516)"
2021,Agosto,Montenegro,499,0,1,,1,"(10.445761,-75.516429)"
2021,Agosto,Montenegro,499,1,1,,2,"(3.541112,-76.384584)"
2021,Agosto,Montenegro,499,6,11,,17,"(4.697144,-74.140516)"
2021,Agosto,Montenegro,499,0,1,,1,"(6.171601,-75.427454)"
2021,Agosto,Mozambique,508,0,1,,1,"(4.697144,-74.140516)"
2021,Agosto,Myanmar,104,1,0,,1,"(4.697144,-74.140516)"
2021,Agosto,Nicaragua,558,1,0,,1,"(10.445761,-75.516429)"
2021,Agosto,Nicaragua,558,1,3,,4,"(10.886611,-74.776708)"
2021,Agosto,Nicaragua,558,3,7,,10,"(3.541112,-76.384584)"
2021,Agosto,Nicaragua,558,22,68,,90,"(4.697144,-74.140516)"
2021,Agosto,Nicaragua,558,3,1,,4,"(4.815061,-75.736532)"
2021,Agosto,Nicaragua,558,19,40,,59,"(6.171601,-75.427454)"
2021,Agosto,Nicaragua,558,5,3,,8,"(7.128456,-73.183637)"
2021,Agosto,Nigeria,566,0,2,,2,"(4.697144,-74.140516)"
2021,Agosto,Noruega,578,21,26,,47,"(4.697144,-74.140516)"
2021,Agosto,Noruega,578,4,2,,6,"(6.171601,-75.427454)"
2021,Agosto,Nueva Caledonia/Territorio francés,540,2,1,,3,"(10.445761,-75.516429)"
2021,Agosto,Nueva Zelanda,554,2,3,,5,"(4.697144,-74.140516)"
2021,Agosto,Omán,512,2,2,,4,"(4.697144,-74.140516)"
2021,Agosto,Omán,512,1,0,,1,"(6.171601,-75.427454)"
2021,Agosto,Papúa Nueva Guinea,598,1,0,,1,"(4.697144,-74.140516)"
2021,Agosto,Panamá,591,5,19,,24,"(10.408582,-75.538003)"
2021,Agosto,Panamá,591,744,561,,1305,"(10.445761,-75.516429)"
2021,Agosto,Panamá,591,338,334,,672,"(10.886611,-74.776708)"
2021,Agosto,Panamá,591,0,5,,5,"(10.971302,-74.765397)"
2021,Agosto,Panamá,591,0,1,,1,"(11.360009,-72.129330)"
2021,Agosto,Panamá,591,1,1,,2,"(12.5744111,-81.703935)"
2021,Agosto,Panamá,591,0,3,,3,"(12.586067,-81.702563)"
2021,Agosto,Panamá,591,1244,1011,,2255,"(3.541112,-76.384584)"
2021,Agosto,Panamá,591,2619,3028,,5648,"(4.697144,-74.140516)"
2021,Agosto,Panamá,591,168,96,,264,"(4.815061,-75.736532)"
2021,Agosto,Panamá,591,0,4,,4,"(6.17134,-75.427194)"
2021,Agosto,Panamá,591,1203,1053,,2256,"(6.171601,-75.427454)"
2021,Agosto,Panamá,591,0,7,,7,"(6.228046,-77.404104)"
2021,Agosto,Panamá,591,38,35,,73,"(7.128456,-73.183637)"
2021,Agosto,Panamá,591,1,2,,3,"(8.635765,-77.346578)"
2021,Agosto,Paraguay,600,2,5,,7,"(10.886611,-74.776708)"
2021,Agosto,Paraguay,600,6,16,,22,"(3.541112,-76.384584)"
2021,Agosto,Paraguay,600,53,137,,190,"(4.697144,-74.140516)"
2021,Agosto,Paraguay,600,2,5,,7,"(4.815061,-75.736532)"
2021,Agosto,Paraguay,600,5,9,,14,"(6.171601,-75.427454)"
2021,Agosto,Paraguay,600,1,1,,2,"(7.128456,-73.183637)"
2021,Agosto,Perú,604,8,14,,22,"(-4.197703,-69.941278)"
2021,Agosto,Perú,604,4,6,,10,"(10.445761,-75.516429)"
2021,Agosto,Perú,604,18,21,,39,"(10.886611,-74.776708)"
2021,Agosto,Perú,604,44,55,,99,"(3.541112,-76.384584)"
2021,Agosto,Perú,604,2136,2573,,4709,"(4.697144,-74.140516)"
2021,Agosto,Perú,604,12,12,,24,"(4.815061,-75.736532)"
2021,Agosto,Perú,604,417,412,,829,"(6.171601,-75.427454)"
2021,Agosto,Perú,604,8,9,,17,"(7.128456,-73.183637)"
2021,Agosto,Palestina,99999,1,0,,1,"(4.697144,-74.140516)"
2021,Agosto,Polonia,616,0,1,,1,"(10.445761,-75.516429)"
2021,Agosto,Polonia,616,2,2,,4,"(3.541112,-76.384584)"
2021,Agosto,Polonia,616,13,26,,39,"(4.697144,-74.140516)"
2021,Agosto,Polonia,616,1,0,,1,"(4.815061,-75.736532)"
2021,Agosto,Polonia,616,2,1,,3,"(6.171601,-75.427454)"
2021,Agosto,Portugal,620,5,8,,13,"(10.445761,-75.516429)"
2021,Agosto,Portugal,620,1,1,,2,"(10.886611,-74.776708)"
2021,Agosto,Portugal,620,8,0,,8,"(3.541112,-76.384584)"
2021,Agosto,Portugal,620,84,87,,171,"(4.697144,-74.140516)"
2021,Agosto,Portugal,620,1,1,,2,"(4.815061,-75.736532)"
2021,Agosto,Portugal,620,8,12,,20,"(6.171601,-75.427454)"
2021,Agosto,Puerto Rico/Territorio de Estados Unidos,630,11,4,,15,"(10.445761,-75.516429)"
2021,Agosto,Puerto Rico/Territorio de Estados Unidos,630,12,13,,25,"(10.886611,-74.776708)"
2021,Agosto,Puerto Rico/Territorio de Estados Unidos,630,54,32,,86,"(3.541112,-76.384584)"
2021,Agosto,Puerto Rico/Territorio de Estados Unidos,630,258,261,,519,"(4.697144,-74.140516)"
2021,Agosto,Puerto Rico/Territorio de Estados Unidos,630,9,7,,16,"(4.815061,-75.736532)"
2021,Agosto,Puerto Rico/Territorio de Estados Unidos,630,48,43,,91,"(6.171601,-75.427454)"
2021,Agosto,Puerto Rico/Territorio de Estados Unidos,630,1,1,,2,"(7.128456,-73.183637)"
2021,Agosto,Qatar,634,1,3,,4,"(10.886611,-74.776708)"
2021,Agosto,Qatar,634,20,32,,52,"(4.697144,-74.140516)"
2021,Agosto,Qatar,634,0,1,,1,"(4.815061,-75.736532)"
2021,Agosto,Qatar,634,10,5,,15,"(6.171601,-75.427454)"
2021,Agosto,Reino Unido de Gran Bretaña e Irlanda del Norte,826,4,3,,7,"(10.445761,-75.516429)"
2021,Agosto,Reino Unido de Gran Bretaña e Irlanda del Norte,826,5,0,,5,"(10.886611,-74.776708)"
2021,Agosto,Reino Unido de Gran Bretaña e Irlanda del Norte,826,13,11,,24,"(3.541112,-76.384584)"
2021,Agosto,Reino Unido de Gran Bretaña e Irlanda del Norte,826,1,0,,1,"(4.452882,-75.766298)"
2021,Agosto,Reino Unido de Gran Bretaña e Irlanda del Norte,826,118,65,,183,"(4.697144,-74.140516)"
2021,Agosto,Reino Unido de Gran Bretaña e Irlanda del Norte,826,1,3,,4,"(4.815061,-75.736532)"
2021,Agosto,Reino Unido de Gran Bretaña e Irlanda del Norte,826,12,5,,17,"(6.171601,-75.427454)"
2021,Agosto,República CentroÁfricana,140,1,0,,1,"(4.697144,-74.140516)"
2021,Agosto,Federación de Rusia,643,2,1,,3,"(10.445761,-75.516429)"
2021,Agosto,Federación de Rusia,643,14,13,,27,"(4.697144,-74.140516)"
2021,Agosto,República Dominicana,214,7,6,,13,"(10.445761,-75.516429)"
2021,Agosto,República Dominicana,214,107,101,,208,"(10.886611,-74.776708)"
2021,Agosto,República Dominicana,214,0,2,,2,"(12.586067,-81.702563)"
2021,Agosto,República Dominicana,214,425,298,,723,"(3.541112,-76.384584)"
2021,Agosto,República Dominicana,214,4140,3403,,7543,"(4.697144,-74.140516)"
2021,Agosto,República Dominicana,214,23,15,,38,"(4.815061,-75.736532)"
2021,Agosto,República Dominicana,214,2404,1856,,4260,"(6.171601,-75.427454)"
2021,Agosto,República Dominicana,214,48,33,,81,"(7.128456,-73.183637)"
2021,Agosto,República Democrática Popular de Corea,408,0,1,,1,"(4.697144,-74.140516)"
2021,Agosto,Rumania,642,2,0,,2,"(10.445761,-75.516429)"
2021,Agosto,Rumania,642,11,12,,23,"(4.697144,-74.140516)"
2021,Agosto,Rumania,642,1,0,,1,"(4.815061,-75.736532)"
2021,Agosto,San Marino,674,1,0,,1,"(4.697144,-74.140516)"
2021,Agosto,San  Vicente y las Granadinas,670,0,1,,1,"(4.697144,-74.140516)"
2021,Agosto,Santa Lucia,662,2,3,,5,"(4.697144,-74.140516)"
2021,Agosto,Senegal,686,0,1,,1,"(4.697144,-74.140516)"
2021,Agosto,Serbia,688,1,0,,1,"(10.445761,-75.516429)"
2021,Agosto,Serbia,688,10,16,,26,"(4.697144,-74.140516)"
2021,Agosto,Singapur,702,5,8,,13,"(4.697144,-74.140516)"
2021,Agosto,República Árabe Siria,760,1,0,,1,"(6.171601,-75.427454)"
2021,Agosto,Sri Lanka,144,0,3,,3,"(4.697144,-74.140516)"
2021,Agosto,Sudáfrica,710,5,1,,6,"(4.697144,-74.140516)"
2021,Agosto,Sudáfrica,710,1,0,,1,"(6.171601,-75.427454)"
2021,Agosto,Suecia,752,2,2,,4,"(10.445761,-75.516429)"
2021,Agosto,Suecia,752,4,3,,7,"(10.886611,-74.776708)"
2021,Agosto,Suecia,752,9,8,,17,"(3.541112,-76.384584)"
2021,Agosto,Suecia,752,100,73,,173,"(4.697144,-74.140516)"
2021,Agosto,Suecia,752,0,1,,1,"(4.815061,-75.736532)"
2021,Agosto,Suecia,752,21,9,,30,"(6.171601,-75.427454)"
2021,Agosto,Suecia,752,2,0,,2,"(7.128456,-73.183637)"
2021,Agosto,Suiza,756,30,12,,42,"(10.445761,-75.516429)"
2021,Agosto,Suiza,756,4,1,,5,"(10.886611,-74.776708)"
2021,Agosto,Suiza,756,76,48,,124,"(3.541112,-76.384584)"
2021,Agosto,Suiza,756,601,345,,946,"(4.697144,-74.140516)"
2021,Agosto,Suiza,756,0,1,,1,"(4.815061,-75.736532)"
2021,Agosto,Suiza,756,57,28,,85,"(6.171601,-75.427454)"
2021,Agosto,Suiza,756,1,0,,1,"(7.128456,-73.183637)"
2021,Agosto,Surinam,740,0,1,,1,"(10.886611,-74.776708)"
2021,Agosto,Surinam,740,2,8,,10,"(4.697144,-74.140516)"
2021,Agosto,Suazilandia,748,0,1,,1,"(4.697144,-74.140516)"
2021,Agosto,Taiwán,158,0,1,,1,"(4.697144,-74.140516)"
2021,Agosto,República de Tayikistán,762,0,1,,1,"(4.697144,-74.140516)"
2021,Agosto,Tailandia,764,3,8,,11,"(4.697144,-74.140516)"
2021,Agosto,Tanzania,834,4,2,,6,"(4.697144,-74.140516)"
2021,Agosto,República Democrática de Timor Oriental,626,0,1,,1,"(4.697144,-74.140516)"
2021,Agosto,Trinidad y Tobago,780,0,1,,1,"(10.445761,-75.516429)"
2021,Agosto,Trinidad y Tobago,780,0,5,,5,"(10.886611,-74.776708)"
2021,Agosto,Trinidad y Tobago,780,3,3,,6,"(3.541112,-76.384584)"
2021,Agosto,Trinidad y Tobago,780,2,33,,35,"(4.697144,-74.140516)"
2021,Agosto,Túnez,788,3,0,,3,"(4.697144,-74.140516)"
2021,Agosto,Turquía,792,8,3,,11,"(10.445761,-75.516429)"
2021,Agosto,Turquía,792,2,1,,3,"(3.541112,-76.384584)"
2021,Agosto,Turquía,792,545,431,,976,"(4.697144,-74.140516)"
2021,Agosto,Turquía,792,3,1,,4,"(6.171601,-75.427454)"
2021,Agosto,Turkmenistán,795,0,2,,2,"(4.697144,-74.140516)"
2021,Agosto,Ucrania,804,1,0,,1,"(10.886611,-74.776708)"
2021,Agosto,Ucrania,804,20,23,,43,"(4.697144,-74.140516)"
2021,Agosto,Uganda,800,1,3,,4,"(4.697144,-74.140516)"
2021,Agosto,Uruguay,858,0,4,,4,"(10.445761,-75.516429)"
2021,Agosto,Uruguay,858,2,0,,2,"(10.886611,-74.776708)"
2021,Agosto,Uruguay,858,9,11,,20,"(3.541112,-76.384584)"
2021,Agosto,Uruguay,858,33,49,,82,"(4.697144,-74.140516)"
2021,Agosto,Uruguay,858,3,3,,6,"(4.815061,-75.736532)"
2021,Agosto,Uruguay,858,2,9,,11,"(6.171601,-75.427454)"
2021,Agosto,Uruguay,858,0,2,,2,"(7.128456,-73.183637)"
2021,Agosto,Uzbekistán,860,0,2,,2,"(4.697144,-74.140516)"
2021,Agosto,Venezuela,862,3,3,,6,"(10.445761,-75.516429)"
2021,Agosto,Venezuela,862,20,15,,35,"(10.886611,-74.776708)"
2021,Agosto,Venezuela,862,62,243,,305,"(11.360009,-72.129330)"
2021,Agosto,Venezuela,862,14,10,,24,"(3.541112,-76.384584)"
2021,Agosto,Venezuela,862,111,190,,301,"(4.697144,-74.140516)"
2021,Agosto,Venezuela,862,23,24,,47,"(6.171601,-75.427454)"
2021,Agosto,Venezuela,862,0,3,,3,"(6.185799,-67.483929)"
2021,Agosto,Venezuela,862,3,8,,11,"(7.088729,-70.740253)"
2021,Agosto,Venezuela,862,3,3,,6,"(7.128456,-73.183637)"
2021,Agosto,Venezuela,862,51,62,,113,"(7.818934,-72.453226)"
2021,Agosto,Venezuela,862,12,5,,17,"(7.916725,-72.462544)"
2021,Agosto,Venezuela,862,1,2,,3,"(8.36068,-72.409396)"
2021,Agosto,Vietnam,704,1,0,,1,"(4.697144,-74.140516)"
2021,Agosto,Islas Vírgenes Británicas/Territorio Británico de Ultramar,92,0,1,,1,"(3.541112,-76.384584)"
2021,Agosto,Islas Vírgenes Británicas/Territorio Británico de Ultramar,92,1,0,,1,"(4.697144,-74.140516)"
2021,Agosto,Islas Vírgenes Estadounidenses/Territorio de Estados Unidos,850,2,0,,2,"(4.697144,-74.140516)"
2021,Agosto,República Árabe de Yemen,887,0,1,,1,"(4.697144,-74.140516)"
2021,Agosto,Islas Turcas y Caicos/Territorio Británico de Ultramar,796,0,1,,1,"(10.445761,-75.516429)"
2021,Agosto,Islas Turcas y Caicos/Territorio Británico de Ultramar,796,3,4,,7,"(4.697144,-74.140516)"
2021,Agosto,Islas Turcas y Caicos/Territorio Británico de Ultramar,796,0,1,,1,"(6.171601,-75.427454)"
2021,Agosto,Desconocido,99999,1,0,,1,"(4.697144,-74.140516)"
2021,Septiembre,Afganistán,4,1,1,,2,"(4.697144,-74.140516)"
2021,Septiembre,Albania,8,4,2,,6,"(4.697144,-74.140516)"
2021,Septiembre,Alemania,276,66,27,,93,"(10.445761,-75.516429)"
2021,Septiembre,Alemania,276,8,8,,16,"(10.886611,-74.776708)"
2021,Septiembre,Alemania,276,35,25,,60,"(3.541112,-76.384584)"
2021,Septiembre,Alemania,276,1306,879,,2185,"(4.697144,-74.140516)"
2021,Septiembre,Alemania,276,3,0,,3,"(4.815061,-75.736532)"
2021,Septiembre,Alemania,276,57,36,,93,"(6.171601,-75.427454)"
2021,Septiembre,Andorra,20,3,9,,12,"(4.697144,-74.140516)"
2021,Septiembre,Andorra,20,1,0,,1,"(6.171601,-75.427454)"
2021,Septiembre,Angola,24,3,5,,8,"(4.697144,-74.140516)"
2021,Septiembre,Antigua y Barbuda,28,4,0,,4,"(4.697144,-74.140516)"
2021,Septiembre,Antigua y Barbuda,28,0,1,,1,"(6.171601,-75.427454)"
2021,Septiembre,Países Bajos,528,119,63,,182,"(10.445761,-75.516429)"
2021,Septiembre,Países Bajos,528,11,9,,20,"(10.886611,-74.776708)"
2021,Septiembre,Países Bajos,528,40,10,,50,"(3.541112,-76.384584)"
2021,Septiembre,Países Bajos,528,780,629,,1409,"(4.697144,-74.140516)"
2021,Septiembre,Países Bajos,528,0,1,,1,"(4.815061,-75.736532)"
2021,Septiembre,Países Bajos,528,37,38,,75,"(6.171601,-75.427454)"
2021,Septiembre,Arabia Saudita,682,1,1,,2,"(10.445761,-75.516429)"
2021,Septiembre,Arabia Saudita,682,0,2,,2,"(3.541112,-76.384584)"
2021,Septiembre,Arabia Saudita,682,18,23,,41,"(4.697144,-74.140516)"
2021,Septiembre,Arabia Saudita,682,0,4,,4,"(6.171601,-75.427454)"
2021,Septiembre,Argelia,12,0,3,,3,"(4.697144,-74.140516)"
2021,Septiembre,Argentina,32,1,0,,1,"(10.445761,-75.516429)"
2021,Septiembre,Argentina,32,1,0,,1,"(10.886611,-74.776708)"
2021,Septiembre,Argentina,32,5,3,,8,"(3.541112,-76.384584)"
2021,Septiembre,Argentina,32,340,301,,641,"(4.697144,-74.140516)"
2021,Septiembre,Argentina,32,1,2,,3,"(4.815061,-75.736532)"
2021,Septiembre,Argentina,32,6,6,,12,"(6.171601,-75.427454)"
2021,Septiembre,Aruba,533,28,22,,50,"(10.886611,-74.776708)"
2021,Septiembre,Aruba,533,43,23,,66,"(3.541112,-76.384584)"
2021,Septiembre,Aruba,533,1428,1064,,2492,"(4.697144,-74.140516)"
2021,Septiembre,Aruba,533,37,28,,65,"(6.171601,-75.427454)"
2021,Septiembre,Aruba,533,17,43,,60,"(7.128456,-73.183637)"
2021,Septiembre,Australia,36,3,1,,4,"(4.697144,-74.140516)"
2021,Septiembre,Australia,36,0,1,,1,"(6.171601,-75.427454)"
2021,Septiembre,Austria,40,5,2,,7,"(10.445761,-75.516429)"
2021,Septiembre,Austria,40,0,1,,1,"(10.886611,-74.776708)"
2021,Septiembre,Austria,40,3,4,,7,"(3.541112,-76.384584)"
2021,Septiembre,Austria,40,109,81,,190,"(4.697144,-74.140516)"
2021,Septiembre,Austria,40,5,3,,8,"(6.171601,-75.427454)"
2021,Septiembre,Azerbaiyán,31,1,1,,2,"(4.697144,-74.140516)"
2021,Septiembre,Bahamas,44,2,0,,2,"(10.445761,-75.516429)"
2021,Septiembre,Bahamas,44,1,2,,3,"(10.886611,-74.776708)"
2021,Septiembre,Bahamas,44,26,19,,45,"(3.541112,-76.384584)"
2021,Septiembre,Bahamas,44,24,18,,42,"(4.697144,-74.140516)"
2021,Septiembre,Bahamas,44,4,2,,6,"(4.815061,-75.736532)"
2021,Septiembre,Bahamas,44,22,42,,64,"(6.171601,-75.427454)"
2021,Septiembre,Bahamas,44,0,1,,1,"(7.102626,-77.762647)"
2021,Septiembre,Bahamas,44,1,0,,1,"(7.128456,-73.183637)"
2021,Septiembre,Bahréin,48,1,0,,1,"(3.541112,-76.384584)"
2021,Septiembre,Bahréin,48,6,5,,11,"(4.697144,-74.140516)"
2021,Septiembre,Bangladesh,50,0,1,,1,"(7.102626,-77.762647)"
2021,Septiembre,Barbados,52,2,1,,3,"(4.697144,-74.140516)"
2021,Septiembre,República de Belarús,112,0,1,,1,"(10.445761,-75.516429)"
2021,Septiembre,República de Belarús,112,1,2,,3,"(4.697144,-74.140516)"
2021,Septiembre,República de Belarús,112,1,0,,1,"(9.402978,-75.681599)"
2021,Septiembre,Bélgica,56,7,5,,12,"(10.445761,-75.516429)"
2021,Septiembre,Bélgica,56,1,2,,3,"(10.886611,-74.776708)"
2021,Septiembre,Bélgica,56,7,9,,16,"(3.541112,-76.384584)"
2021,Septiembre,Bélgica,56,99,97,,196,"(4.697144,-74.140516)"
2021,Septiembre,Bélgica,56,30,14,,44,"(6.171601,-75.427454)"
2021,Septiembre,Belice,84,2,1,,3,"(10.886611,-74.776708)"
2021,Septiembre,Belice,84,0,3,,3,"(12.5744111,-81.703935)"
2021,Septiembre,Belice,84,5,7,,12,"(4.697144,-74.140516)"
2021,Septiembre,Belice,84,3,0,,3,"(6.171601,-75.427454)"
2021,Septiembre,Benín,204,0,1,,1,"(4.697144,-74.140516)"
2021,Septiembre,Bermudas/Territorio Británico de Ultramar,60,2,2,,4,"(6.171601,-75.427454)"
2021,Septiembre,Bolivia,68,0,1,,1,"(10.886611,-74.776708)"
2021,Septiembre,Bolivia,68,6,5,,11,"(3.541112,-76.384584)"
2021,Septiembre,Bolivia,68,245,417,,662,"(4.697144,-74.140516)"
2021,Septiembre,Bolivia,68,2,3,,5,"(4.815061,-75.736532)"
2021,Septiembre,Bolivia,68,8,14,,22,"(6.171601,-75.427454)"
2021,Septiembre,Bosnia y Herzegovina,70,15,1,,16,"(4.697144,-74.140516)"
2021,Septiembre,Bosnia y Herzegovina,70,1,0,,1,"(4.815061,-75.736532)"
2021,Septiembre,Brasil,76,41,60,,101,"(-4.197703,-69.941278)"
2021,Septiembre,Brasil,76,11,26,,37,"(10.445761,-75.516429)"
2021,Septiembre,Brasil,76,19,28,,47,"(10.886611,-74.776708)"
2021,Septiembre,Brasil,76,148,247,,395,"(3.541112,-76.384584)"
2021,Septiembre,Brasil,76,1228,1669,,2897,"(4.697144,-74.140516)"
2021,Septiembre,Brasil,76,43,76,,119,"(4.815061,-75.736532)"
2021,Septiembre,Brasil,76,134,168,,302,"(6.171601,-75.427454)"
2021,Septiembre,Brasil,76,7,10,,17,"(7.128456,-73.183637)"
2021,Septiembre,Bulgaria,100,1,0,,1,"(3.541112,-76.384584)"
2021,Septiembre,Bulgaria,100,2,3,,5,"(4.697144,-74.140516)"
2021,Septiembre,Burkina Faso,854,0,1,,1,"(4.697144,-74.140516)"
2021,Septiembre,Cabo Verde,132,1,1,,2,"(4.697144,-74.140516)"
2021,Septiembre,Islas Caimán/Territorio Británico de Ultramar,136,3,0,,3,"(10.445761,-75.516429)"
2021,Septiembre,Islas Caimán/Territorio Británico de Ultramar,136,1,0,,1,"(3.541112,-76.384584)"
2021,Septiembre,Islas Caimán/Territorio Británico de Ultramar,136,2,1,,3,"(4.697144,-74.140516)"
2021,Septiembre,Camboya,116,1,0,,1,"(4.697144,-74.140516)"
2021,Septiembre,Antártida,10,1,0,,1,"(4.697144,-74.140516)"
2021,Septiembre,Camerún,120,0,1,,1,"(4.697144,-74.140516)"
2021,Septiembre,Canadá,124,10,8,,18,"(10.445761,-75.516429)"
2021,Septiembre,Canadá,124,33,28,,61,"(10.886611,-74.776708)"
2021,Septiembre,Canadá,124,149,96,,245,"(3.541112,-76.384584)"
2021,Septiembre,Canadá,124,2,1,,3,"(4.452882,-75.766298)"
2021,Septiembre,Canadá,124,1874,1435,,3309,"(4.697144,-74.140516)"
2021,Septiembre,Canadá,124,16,13,,29,"(4.815061,-75.736532)"
2021,Septiembre,Canadá,124,285,230,,515,"(6.171601,-75.427454)"
2021,Septiembre,Canadá,124,9,4,,13,"(7.128456,-73.183637)"
2021,Septiembre,Chad,148,2,0,,2,"(4.697144,-74.140516)"
2021,Septiembre,España,724,122,78,,200,"(10.445761,-75.516429)"
2021,Septiembre,España,724,59,42,,101,"(10.886611,-74.776708)"
2021,Septiembre,España,724,1070,742,,1812,"(3.541112,-76.384584)"
2021,Septiembre,España,724,14659,10673,,25332,"(4.697144,-74.140516)"
2021,Septiembre,España,724,71,47,,118,"(4.815061,-75.736532)"
2021,Septiembre,España,724,1898,1366,,3264,"(6.171601,-75.427454)"
2021,Septiembre,España,724,5,2,,7,"(7.128456,-73.183637)"
2021,Septiembre,Norfolk,574,0,1,,1,"(4.815061,-75.736532)"
2021,Septiembre,Colombia,170,1,2,,3,"(10.445761,-75.516429)"
2021,Septiembre,Colombia,170,51,98,,149,"(4.697144,-74.140516)"
2021,Septiembre,Colombia,170,0,1,,1,"(7.102626,-77.762647)"
2021,Septiembre,República Del Congo,178,0,1,,1,"(4.697144,-74.140516)"
2021,Septiembre,Comoras,174,2,0,,2,"(4.697144,-74.140516)"
2021,Septiembre,Comoras,174,1,1,,2,"(6.171601,-75.427454)"
2021,Septiembre,República Democrática del Congo,180,5,1,,6,"(4.697144,-74.140516)"
2021,Septiembre,República Democrática del Congo,180,1,0,,1,"(6.171601,-75.427454)"
2021,Septiembre,República de Corea,410,3,3,,6,"(4.697144,-74.140516)"
2021,Septiembre,República de Corea,410,0,1,,1,"(6.171601,-75.427454)"
2021,Septiembre,Islas Malvinas,238,2,1,,3,"(4.697144,-74.140516)"
2021,Septiembre,Costa de Marfil,384,1,8,,9,"(4.697144,-74.140516)"
2021,Septiembre,Costa de Marfil,384,0,1,,1,"(6.171601,-75.427454)"
2021,Septiembre,Costa Rica,188,3,4,,7,"(10.445761,-75.516429)"
2021,Septiembre,Costa Rica,188,17,36,,53,"(10.886611,-74.776708)"
2021,Septiembre,Costa Rica,188,94,79,,173,"(3.541112,-76.384584)"
2021,Septiembre,Costa Rica,188,712,764,,1476,"(4.697144,-74.140516)"
2021,Septiembre,Costa Rica,188,21,24,,45,"(4.815061,-75.736532)"
2021,Septiembre,Costa Rica,188,2,2,,4,"(6.17134,-75.427194)"
2021,Septiembre,Costa Rica,188,190,167,,357,"(6.171601,-75.427454)"
2021,Septiembre,Costa Rica,188,5,1,,6,"(7.128456,-73.183637)"
2021,Septiembre,Croacia,191,3,2,,5,"(10.445761,-75.516429)"
2021,Septiembre,Croacia,191,1,1,,2,"(3.541112,-76.384584)"
2021,Septiembre,Croacia,191,19,17,,36,"(4.697144,-74.140516)"
2021,Septiembre,Croacia,191,6,3,,9,"(6.171601,-75.427454)"
2021,Septiembre,Cuba,192,0,20,,20,"(10.886611,-74.776708)"
2021,Septiembre,Cuba,192,138,149,,287,"(4.697144,-74.140516)"
2021,Septiembre,Cuba,192,0,1,,1,"(6.171601,-75.427454)"
2021,Septiembre,Curazao,99999,81,55,,136,"(10.886611,-74.776708)"
2021,Septiembre,Curazao,99999,43,25,,68,"(3.541112,-76.384584)"
2021,Septiembre,Curazao,99999,308,250,,558,"(4.697144,-74.140516)"
2021,Septiembre,Curazao,99999,33,25,,58,"(6.171601,-75.427454)"
2021,Septiembre,Curazao,99999,0,5,,5,"(7.128456,-73.183637)"
2021,Septiembre,República Checa,203,2,1,,3,"(3.541112,-76.384584)"
2021,Septiembre,República Checa,203,4,8,,12,"(4.697144,-74.140516)"
2021,Septiembre,República Checa,203,0,1,,1,"(4.815061,-75.736532)"
2021,Septiembre,Chile,152,7,1,,8,"(10.445761,-75.516429)"
2021,Septiembre,Chile,152,13,9,,22,"(10.886611,-74.776708)"
2021,Septiembre,Chile,152,449,309,,758,"(3.541112,-76.384584)"
2021,Septiembre,Chile,152,1953,1457,,3410,"(4.697144,-74.140516)"
2021,Septiembre,Chile,152,37,22,,59,"(4.815061,-75.736532)"
2021,Septiembre,Chile,152,56,34,,90,"(6.171601,-75.427454)"
2021,Septiembre,Chile,152,1,0,,1,"(7.128456,-73.183637)"
2021,Septiembre,China,156,1,0,,1,"(3.541112,-76.384584)"
2021,Septiembre,China,156,4,3,,7,"(4.697144,-74.140516)"
2021,Septiembre,Chipre,196,0,2,,2,"(10.445761,-75.516429)"
2021,Septiembre,Chipre,196,1,1,,2,"(3.541112,-76.384584)"
2021,Septiembre,Chipre,196,4,4,,8,"(4.697144,-74.140516)"
2021,Septiembre,Chipre,196,1,0,,1,"(6.171601,-75.427454)"
2021,Septiembre,Dinamarca,208,3,2,,5,"(10.445761,-75.516429)"
2021,Septiembre,Dinamarca,208,4,1,,5,"(3.541112,-76.384584)"
2021,Septiembre,Dinamarca,208,27,21,,48,"(4.697144,-74.140516)"
2021,Septiembre,Dinamarca,208,3,2,,5,"(6.171601,-75.427454)"
2021,Septiembre,Dominica,212,3,3,,6,"(3.541112,-76.384584)"
2021,Septiembre,Dominica,212,4,6,,10,"(4.697144,-74.140516)"
2021,Septiembre,Dominica,212,1,1,,2,"(6.171601,-75.427454)"
2021,Septiembre,Ecuador,218,1,0,,1,"(0.25129,-76.875963)"
2021,Septiembre,Ecuador,218,40,60,,100,"(0.814836,-77.662532)"
2021,Septiembre,Ecuador,218,0,8,,8,"(10.408582,-75.538003)"
2021,Septiembre,Ecuador,218,2,2,,4,"(10.445761,-75.516429)"
2021,Septiembre,Ecuador,218,14,20,,34,"(10.886611,-74.776708)"
2021,Septiembre,Ecuador,218,44,55,,99,"(3.541112,-76.384584)"
2021,Septiembre,Ecuador,218,1768,2785,,4553,"(4.697144,-74.140516)"
2021,Septiembre,Ecuador,218,14,20,,34,"(4.815061,-75.736532)"
2021,Septiembre,Ecuador,218,0,5,,5,"(6.17134,-75.427194)"
2021,Septiembre,Ecuador,218,82,94,,176,"(6.171601,-75.427454)"
2021,Septiembre,Ecuador,218,0,6,,6,"(6.228046,-77.404104)"
2021,Septiembre,Ecuador,218,4,3,,7,"(7.128456,-73.183637)"
2021,Septiembre,Egipto,818,5,4,,9,"(3.541112,-76.384584)"
2021,Septiembre,Egipto,818,90,50,,140,"(4.697144,-74.140516)"
2021,Septiembre,Egipto,818,9,2,,11,"(6.171601,-75.427454)"
2021,Septiembre,El Salvador,222,1,4,,5,"(10.445761,-75.516429)"
2021,Septiembre,El Salvador,222,6,8,,14,"(10.886611,-74.776708)"
2021,Septiembre,El Salvador,222,28,26,,54,"(3.541112,-76.384584)"
2021,Septiembre,El Salvador,222,227,331,,558,"(4.697144,-74.140516)"
2021,Septiembre,El Salvador,222,23,37,,60,"(6.171601,-75.427454)"
2021,Septiembre,Emiratos Árabes,784,12,13,,25,"(10.445761,-75.516429)"
2021,Septiembre,Emiratos Árabes,784,1,1,,2,"(10.886611,-74.776708)"
2021,Septiembre,Emiratos Árabes,784,4,7,,11,"(3.541112,-76.384584)"
2021,Septiembre,Emiratos Árabes,784,231,425,,656,"(4.697144,-74.140516)"
2021,Septiembre,Emiratos Árabes,784,10,12,,22,"(6.171601,-75.427454)"
2021,Septiembre,Eslovaquia,703,5,10,,15,"(4.697144,-74.140516)"
2021,Septiembre,Eslovaquia,703,1,0,,1,"(6.171601,-75.427454)"
2021,Septiembre,Eslovenia,705,1,1,,2,"(4.697144,-74.140516)"
2021,Septiembre,Eslovenia,705,0,1,,1,"(6.171601,-75.427454)"
2021,Septiembre,Estados Unidos de América,840,2265,1823,,4088,"(10.445761,-75.516429)"
2021,Septiembre,Estados Unidos de América,840,3875,3298,,7173,"(10.886611,-74.776708)"
2021,Septiembre,Estados Unidos de América,840,0,1,,1,"(12.586067,-81.702563)"
2021,Septiembre,Estados Unidos de América,840,7841,5838,,13680,"(3.541112,-76.384584)"
2021,Septiembre,Estados Unidos de América,840,1045,828,,1873,"(4.452882,-75.766298)"
2021,Septiembre,Estados Unidos de América,840,34306,28536,,62842,"(4.697144,-74.140516)"
2021,Septiembre,Estados Unidos de América,840,2074,1490,,3564,"(4.815061,-75.736532)"
2021,Septiembre,Estados Unidos de América,840,13020,10379,,23400,"(6.171601,-75.427454)"
2021,Septiembre,Estados Unidos de América,840,822,675,,1497,"(7.128456,-73.183637)"
2021,Septiembre,Estonia,233,0,1,,1,"(10.445761,-75.516429)"
2021,Septiembre,Estonia,233,3,6,,9,"(4.697144,-74.140516)"
2021,Septiembre,Etiopia,231,0,3,,3,"(4.697144,-74.140516)"
2021,Septiembre,Islas Fiji,242,0,1,,1,"(4.697144,-74.140516)"
2021,Septiembre,Filipinas,608,3,2,,5,"(4.697144,-74.140516)"
2021,Septiembre,Finlandia,246,0,2,,2,"(10.445761,-75.516429)"
2021,Septiembre,Finlandia,246,9,6,,15,"(4.697144,-74.140516)"
2021,Septiembre,Francia,250,29,18,,47,"(10.445761,-75.516429)"
2021,Septiembre,Francia,250,12,13,,25,"(10.886611,-74.776708)"
2021,Septiembre,Francia,250,56,38,,94,"(3.541112,-76.384584)"
2021,Septiembre,Francia,250,1974,1500,,3474,"(4.697144,-74.140516)"
2021,Septiembre,Francia,250,9,15,,24,"(4.815061,-75.736532)"
2021,Septiembre,Francia,250,105,65,,170,"(6.171601,-75.427454)"
2021,Septiembre,Francia,250,0,1,,1,"(7.128456,-73.183637)"
2021,Septiembre,Gabón,266,3,4,,7,"(4.697144,-74.140516)"
2021,Septiembre,Georgia,268,2,0,,2,"(3.541112,-76.384584)"
2021,Septiembre,Georgia,268,5,3,,8,"(4.697144,-74.140516)"
2021,Septiembre,Georgia,268,0,1,,1,"(4.815061,-75.736532)"
2021,Septiembre,Georgia,268,3,2,,5,"(6.171601,-75.427454)"
2021,Septiembre,Ghana,288,0,1,,1,"(10.886611,-74.776708)"
2021,Septiembre,Ghana,288,1,3,,4,"(4.697144,-74.140516)"
2021,Septiembre,Grecia,300,23,20,,43,"(4.697144,-74.140516)"
2021,Septiembre,Grecia,300,0,1,,1,"(6.171601,-75.427454)"
2021,Septiembre,Guatemala,320,0,1,,1,"(10.445761,-75.516429)"
2021,Septiembre,Guatemala,320,7,20,,27,"(10.886611,-74.776708)"
2021,Septiembre,Guatemala,320,48,97,,145,"(3.541112,-76.384584)"
2021,Septiembre,Guatemala,320,265,515,,780,"(4.697144,-74.140516)"
2021,Septiembre,Guatemala,320,13,18,,31,"(4.815061,-75.736532)"
2021,Septiembre,Guatemala,320,105,122,,227,"(6.171601,-75.427454)"
2021,Septiembre,Guatemala,320,4,6,,10,"(7.128456,-73.183637)"
2021,Septiembre,Guyana,328,0,1,,1,"(10.445761,-75.516429)"
2021,Septiembre,Guyana,328,0,1,,1,"(10.886611,-74.776708)"
2021,Septiembre,Guyana,328,0,1,,1,"(3.541112,-76.384584)"
2021,Septiembre,Guyana,328,6,18,,24,"(4.697144,-74.140516)"
2021,Septiembre,Guyana,328,4,6,,10,"(6.171601,-75.427454)"
2021,Septiembre,Guinea,324,0,1,,1,"(4.697144,-74.140516)"
2021,Septiembre,Guinea Ecuatorial,226,2,1,,3,"(3.541112,-76.384584)"
2021,Septiembre,Guinea Ecuatorial,226,5,4,,9,"(4.697144,-74.140516)"
2021,Septiembre,Guadalupe/Territorio Francés,312,0,1,,1,"(3.541112,-76.384584)"
2021,Septiembre,Guadalupe/Territorio Francés,312,1,3,,4,"(4.697144,-74.140516)"
2021,Septiembre,Guayana Francesa/Departamento de Ultramar Francés,254,1,0,,1,"(4.697144,-74.140516)"
2021,Septiembre,Guayana Francesa/Departamento de Ultramar Francés,254,1,4,,5,"(6.17134,-75.427194)"
2021,Septiembre,Haití,332,0,1,,1,"(10.445761,-75.516429)"
2021,Septiembre,Haití,332,0,1,,1,"(3.541112,-76.384584)"
2021,Septiembre,Haití,332,2,4,,6,"(4.697144,-74.140516)"
2021,Septiembre,Haití,332,0,2,,2,"(6.171601,-75.427454)"
2021,Septiembre,Haití,332,0,1,,1,"(7.128456,-73.183637)"
2021,Septiembre,Honduras,340,0,9,,9,"(10.445761,-75.516429)"
2021,Septiembre,Honduras,340,5,11,,16,"(10.886611,-74.776708)"
2021,Septiembre,Honduras,340,20,30,,50,"(3.541112,-76.384584)"
2021,Septiembre,Honduras,340,0,1,,1,"(4.452882,-75.766298)"
2021,Septiembre,Honduras,340,50,95,,145,"(4.697144,-74.140516)"
2021,Septiembre,Honduras,340,1,1,,2,"(4.815061,-75.736532)"
2021,Septiembre,Honduras,340,27,52,,79,"(6.171601,-75.427454)"
2021,Septiembre,Honduras,340,2,4,,6,"(7.128456,-73.183637)"
2021,Septiembre,Hong Kong,344,2,1,,3,"(4.697144,-74.140516)"
2021,Septiembre,Hungría,348,17,17,,34,"(4.697144,-74.140516)"
2021,Septiembre,Hungría,348,1,1,,2,"(6.171601,-75.427454)"
2021,Septiembre,India,356,1,0,,1,"(10.445761,-75.516429)"
2021,Septiembre,India,356,9,15,,24,"(4.697144,-74.140516)"
2021,Septiembre,India,356,2,0,,2,"(6.171601,-75.427454)"
2021,Septiembre,Indonesia,360,2,2,,4,"(4.697144,-74.140516)"
2021,Septiembre,Iraq,368,2,7,,9,"(4.697144,-74.140516)"
2021,Septiembre,Irán,364,4,1,,5,"(4.697144,-74.140516)"
2021,Septiembre,República de Irlanda,372,1,1,,2,"(10.445761,-75.516429)"
2021,Septiembre,República de Irlanda,372,1,0,,1,"(3.541112,-76.384584)"
2021,Septiembre,República de Irlanda,372,9,8,,17,"(4.697144,-74.140516)"
2021,Septiembre,República de Irlanda,372,2,1,,3,"(6.171601,-75.427454)"
2021,Septiembre,Islandia,352,0,4,,4,"(10.408582,-75.538003)"
2021,Septiembre,Islandia,352,1,0,,1,"(10.445761,-75.516429)"
2021,Septiembre,Islandia,352,24,22,,46,"(4.697144,-74.140516)"
2021,Septiembre,Islandia,352,3,3,,6,"(6.171601,-75.427454)"
2021,Septiembre,Israel,376,6,1,,7,"(10.445761,-75.516429)"
2021,Septiembre,Israel,376,2,2,,4,"(3.541112,-76.384584)"
2021,Septiembre,Israel,376,41,32,,73,"(4.697144,-74.140516)"
2021,Septiembre,Israel,376,2,1,,3,"(6.171601,-75.427454)"
2021,Septiembre,Islas Aland/Provincia de Finlandia,248,0,1,,1,"(6.171601,-75.427454)"
2021,Septiembre,Italia,380,44,19,,63,"(10.445761,-75.516429)"
2021,Septiembre,Italia,380,7,8,,15,"(10.886611,-74.776708)"
2021,Septiembre,Italia,380,45,31,,76,"(3.541112,-76.384584)"
2021,Septiembre,Italia,380,592,439,,1031,"(4.697144,-74.140516)"
2021,Septiembre,Italia,380,2,0,,2,"(4.815061,-75.736532)"
2021,Septiembre,Italia,380,62,47,,109,"(6.171601,-75.427454)"
2021,Septiembre,Jamaica,388,0,1,,1,"(10.886611,-74.776708)"
2021,Septiembre,Jamaica,388,3,3,,6,"(4.697144,-74.140516)"
2021,Septiembre,Jamaica,388,1,3,,4,"(6.171601,-75.427454)"
2021,Septiembre,Japón,392,1,0,,1,"(10.445761,-75.516429)"
2021,Septiembre,Japón,392,7,7,,14,"(4.697144,-74.140516)"
2021,Septiembre,Japón,392,1,1,,2,"(6.171601,-75.427454)"
2021,Septiembre,Jordania,400,3,2,,5,"(4.697144,-74.140516)"
2021,Septiembre,Jordania,400,2,0,,2,"(6.171601,-75.427454)"
2021,Septiembre,Kazajistán,398,0,2,,2,"(4.697144,-74.140516)"
2021,Septiembre,Kenia,404,5,3,,8,"(4.697144,-74.140516)"
2021,Septiembre,Kuwait,414,3,5,,8,"(4.697144,-74.140516)"
2021,Septiembre,Kuwait,414,2,1,,3,"(6.171601,-75.427454)"
2021,Septiembre,Lesoto,426,1,0,,1,"(4.697144,-74.140516)"
2021,Septiembre,Lituania,440,3,2,,5,"(4.697144,-74.140516)"
2021,Septiembre,Líbano,422,5,3,,8,"(10.886611,-74.776708)"
2021,Septiembre,Líbano,422,1,4,,5,"(3.541112,-76.384584)"
2021,Septiembre,Líbano,422,9,12,,21,"(4.697144,-74.140516)"
2021,Septiembre,Liechtenstein,438,1,0,,1,"(4.697144,-74.140516)"
2021,Septiembre,Luxemburgo,442,2,0,,2,"(10.445761,-75.516429)"
2021,Septiembre,Luxemburgo,442,2,0,,2,"(3.541112,-76.384584)"
2021,Septiembre,Luxemburgo,442,18,13,,31,"(4.697144,-74.140516)"
2021,Septiembre,Luxemburgo,442,0,1,,1,"(6.171601,-75.427454)"
2021,Septiembre,Madagascar,450,1,0,,1,"(4.697144,-74.140516)"
2021,Septiembre,Maldivas,462,1,1,,2,"(10.445761,-75.516429)"
2021,Septiembre,Maldivas,462,7,4,,11,"(4.697144,-74.140516)"
2021,Septiembre,Malí,466,0,1,,1,"(10.886611,-74.776708)"
2021,Septiembre,Malí,466,0,1,,1,"(4.697144,-74.140516)"
2021,Septiembre,Malta,470,1,0,,1,"(10.445761,-75.516429)"
2021,Septiembre,Malta,470,24,26,,50,"(4.697144,-74.140516)"
2021,Septiembre,Marruecos,504,2,3,,5,"(4.697144,-74.140516)"
2021,Septiembre,Marruecos,504,1,2,,3,"(6.171601,-75.427454)"
2021,Septiembre,Mauritania,478,0,5,,5,"(4.697144,-74.140516)"
2021,Septiembre,Martinica/Departamento de Ultramar Francés,474,1,1,,2,"(7.128456,-73.183637)"
2021,Septiembre,México,484,64,44,,108,"(10.445761,-75.516429)"
2021,Septiembre,México,484,212,185,,397,"(10.886611,-74.776708)"
2021,Septiembre,México,484,6,6,,12,"(11.117806,-74.232622)"
2021,Septiembre,México,484,2538,2049,,4587,"(3.541112,-76.384584)"
2021,Septiembre,México,484,13024,11582,,24606,"(4.697144,-74.140516)"
2021,Septiembre,México,484,119,92,,211,"(4.815061,-75.736532)"
2021,Septiembre,México,484,1,7,,8,"(6.17134,-75.427194)"
2021,Septiembre,México,484,7418,5849,,13267,"(6.171601,-75.427454)"
2021,Septiembre,México,484,77,58,,135,"(7.128456,-73.183637)"
2021,Septiembre,Mayotte/Colectividad Territorial Francesa,175,0,1,,1,"(6.171601,-75.427454)"
2021,Septiembre,República de Moldavia,498,1,1,,2,"(4.697144,-74.140516)"
2021,Septiembre,Mónaco,492,1,0,,1,"(10.445761,-75.516429)"
2021,Septiembre,Mónaco,492,1,0,,1,"(4.697144,-74.140516)"
2021,Septiembre,Montenegro,499,1,0,,1,"(10.886611,-74.776708)"
2021,Septiembre,Montenegro,499,5,11,,16,"(4.697144,-74.140516)"
2021,Septiembre,Mozambique,508,2,2,,4,"(4.697144,-74.140516)"
2021,Septiembre,Nicaragua,558,1,2,,3,"(10.886611,-74.776708)"
2021,Septiembre,Nicaragua,558,2,7,,9,"(3.541112,-76.384584)"
2021,Septiembre,Nicaragua,558,25,58,,83,"(4.697144,-74.140516)"
2021,Septiembre,Nicaragua,558,8,30,,38,"(6.171601,-75.427454)"
2021,Septiembre,Nicaragua,558,2,7,,9,"(7.128456,-73.183637)"
2021,Septiembre,Nigeria,566,0,7,,7,"(4.697144,-74.140516)"
2021,Septiembre,Noruega,578,1,2,,3,"(3.541112,-76.384584)"
2021,Septiembre,Noruega,578,18,10,,28,"(4.697144,-74.140516)"
2021,Septiembre,Noruega,578,2,0,,2,"(6.171601,-75.427454)"
2021,Septiembre,Nueva Zelanda,554,0,1,,1,"(4.697144,-74.140516)"
2021,Septiembre,Omán,512,0,1,,1,"(3.541112,-76.384584)"
2021,Septiembre,Omán,512,3,5,,8,"(4.697144,-74.140516)"
2021,Septiembre,Pakistán,586,2,0,,2,"(4.697144,-74.140516)"
2021,Septiembre,Panamá,591,9,48,,57,"(10.408582,-75.538003)"
2021,Septiembre,Panamá,591,673,530,,1203,"(10.445761,-75.516429)"
2021,Septiembre,Panamá,591,313,306,,619,"(10.886611,-74.776708)"
2021,Septiembre,Panamá,591,1,8,,9,"(12.5744111,-81.703935)"
2021,Septiembre,Panamá,591,1464,1125,,2589,"(3.541112,-76.384584)"
2021,Septiembre,Panamá,591,2943,3363,,6306,"(4.697144,-74.140516)"
2021,Septiembre,Panamá,591,200,137,,337,"(4.815061,-75.736532)"
2021,Septiembre,Panamá,591,1272,1108,,2380,"(6.171601,-75.427454)"
2021,Septiembre,Panamá,591,1,7,,8,"(6.228046,-77.404104)"
2021,Septiembre,Panamá,591,2,4,,6,"(7.102626,-77.762647)"
2021,Septiembre,Panamá,591,26,22,,48,"(7.128456,-73.183637)"
2021,Septiembre,Panamá,591,0,6,,6,"(8.066966,-76.735404)"
2021,Septiembre,Panamá,591,13,34,,47,"(8.635765,-77.346578)"
2021,Septiembre,Paraguay,600,0,3,,3,"(10.445761,-75.516429)"
2021,Septiembre,Paraguay,600,3,1,,4,"(10.886611,-74.776708)"
2021,Septiembre,Paraguay,600,9,16,,25,"(3.541112,-76.384584)"
2021,Septiembre,Paraguay,600,145,358,,503,"(4.697144,-74.140516)"
2021,Septiembre,Paraguay,600,6,9,,15,"(4.815061,-75.736532)"
2021,Septiembre,Paraguay,600,15,24,,39,"(6.171601,-75.427454)"
2021,Septiembre,Paraguay,600,1,7,,8,"(7.128456,-73.183637)"
2021,Septiembre,Perú,604,7,12,,19,"(-4.197703,-69.941278)"
2021,Septiembre,Perú,604,2,5,,7,"(10.445761,-75.516429)"
2021,Septiembre,Perú,604,24,28,,52,"(10.886611,-74.776708)"
2021,Septiembre,Perú,604,99,100,,199,"(3.541112,-76.384584)"
2021,Septiembre,Perú,604,2249,2736,,4986,"(4.697144,-74.140516)"
2021,Septiembre,Perú,604,11,19,,30,"(4.815061,-75.736532)"
2021,Septiembre,Perú,604,608,547,,1155,"(6.171601,-75.427454)"
2021,Septiembre,Perú,604,8,4,,12,"(7.128456,-73.183637)"
2021,Septiembre,Polonia,616,0,1,,1,"(10.445761,-75.516429)"
2021,Septiembre,Polonia,616,1,0,,1,"(3.541112,-76.384584)"
2021,Septiembre,Polonia,616,15,29,,44,"(4.697144,-74.140516)"
2021,Septiembre,Portugal,620,4,6,,10,"(10.445761,-75.516429)"
2021,Septiembre,Portugal,620,3,2,,5,"(10.886611,-74.776708)"
2021,Septiembre,Portugal,620,6,4,,10,"(3.541112,-76.384584)"
2021,Septiembre,Portugal,620,95,131,,226,"(4.697144,-74.140516)"
2021,Septiembre,Portugal,620,10,4,,14,"(6.171601,-75.427454)"
2021,Septiembre,Puerto Rico/Territorio de Estados Unidos,630,6,5,,11,"(10.445761,-75.516429)"
2021,Septiembre,Puerto Rico/Territorio de Estados Unidos,630,18,19,,37,"(10.886611,-74.776708)"
2021,Septiembre,Puerto Rico/Territorio de Estados Unidos,630,37,23,,60,"(3.541112,-76.384584)"
2021,Septiembre,Puerto Rico/Territorio de Estados Unidos,630,0,2,,2,"(4.452882,-75.766298)"
2021,Septiembre,Puerto Rico/Territorio de Estados Unidos,630,227,208,,435,"(4.697144,-74.140516)"
2021,Septiembre,Puerto Rico/Territorio de Estados Unidos,630,12,5,,17,"(4.815061,-75.736532)"
2021,Septiembre,Puerto Rico/Territorio de Estados Unidos,630,59,43,,102,"(6.171601,-75.427454)"
2021,Septiembre,Puerto Rico/Territorio de Estados Unidos,630,0,1,,1,"(7.128456,-73.183637)"
2021,Septiembre,Qatar,634,1,0,,1,"(10.886611,-74.776708)"
2021,Septiembre,Qatar,634,11,20,,31,"(4.697144,-74.140516)"
2021,Septiembre,Qatar,634,1,1,,2,"(4.815061,-75.736532)"
2021,Septiembre,Qatar,634,2,4,,6,"(6.171601,-75.427454)"
2021,Septiembre,Reino Unido de Gran Bretaña e Irlanda del Norte,826,3,2,,5,"(10.445761,-75.516429)"
2021,Septiembre,Reino Unido de Gran Bretaña e Irlanda del Norte,826,0,2,,2,"(10.886611,-74.776708)"
2021,Septiembre,Reino Unido de Gran Bretaña e Irlanda del Norte,826,10,8,,18,"(3.541112,-76.384584)"
2021,Septiembre,Reino Unido de Gran Bretaña e Irlanda del Norte,826,105,74,,179,"(4.697144,-74.140516)"
2021,Septiembre,Reino Unido de Gran Bretaña e Irlanda del Norte,826,1,1,,2,"(4.815061,-75.736532)"
2021,Septiembre,Reino Unido de Gran Bretaña e Irlanda del Norte,826,9,13,,22,"(6.171601,-75.427454)"
2021,Septiembre,República CentroÁfricana,140,1,0,,1,"(4.697144,-74.140516)"
2021,Septiembre,Federación de Rusia,643,1,0,,1,"(10.886611,-74.776708)"
2021,Septiembre,Federación de Rusia,643,1,6,,7,"(3.541112,-76.384584)"
2021,Septiembre,Federación de Rusia,643,19,19,,38,"(4.697144,-74.140516)"
2021,Septiembre,Federación de Rusia,643,1,0,,1,"(4.815061,-75.736532)"
2021,Septiembre,República Dominicana,214,0,1,,1,"(10.408582,-75.538003)"
2021,Septiembre,República Dominicana,214,19,18,,37,"(10.445761,-75.516429)"
2021,Septiembre,República Dominicana,214,66,51,,117,"(10.886611,-74.776708)"
2021,Septiembre,República Dominicana,214,3,2,,5,"(11.117806,-74.232622)"
2021,Septiembre,República Dominicana,214,370,286,,656,"(3.541112,-76.384584)"
2021,Septiembre,República Dominicana,214,4396,3689,,8085,"(4.697144,-74.140516)"
2021,Septiembre,República Dominicana,214,22,21,,43,"(4.815061,-75.736532)"
2021,Septiembre,República Dominicana,214,3210,2450,,5660,"(6.171601,-75.427454)"
2021,Septiembre,República Dominicana,214,32,20,,52,"(7.128456,-73.183637)"
2021,Septiembre,Rumania,642,1,0,,1,"(10.886611,-74.776708)"
2021,Septiembre,Rumania,642,14,18,,32,"(4.697144,-74.140516)"
2021,Septiembre,Rumania,642,0,1,,1,"(6.171601,-75.427454)"
2021,Septiembre,Rwanda,646,1,1,,2,"(4.697144,-74.140516)"
2021,Septiembre,San Cristóbal y Nevis,659,1,0,,1,"(4.697144,-74.140516)"
2021,Septiembre,Samoa Occidental,882,0,1,,1,"(4.697144,-74.140516)"
2021,Septiembre,Serbia,688,1,0,,1,"(3.541112,-76.384584)"
2021,Septiembre,Serbia,688,7,2,,9,"(4.697144,-74.140516)"
2021,Septiembre,Serbia,688,1,0,,1,"(6.171601,-75.427454)"
2021,Septiembre,Seychelles,690,1,0,,1,"(4.697144,-74.140516)"
2021,Septiembre,Singapur,702,0,1,,1,"(10.445761,-75.516429)"
2021,Septiembre,Singapur,702,0,1,,1,"(10.886611,-74.776708)"
2021,Septiembre,Singapur,702,2,4,,6,"(4.697144,-74.140516)"
2021,Septiembre,Sudáfrica,710,4,4,,8,"(4.697144,-74.140516)"
2021,Septiembre,Sudáfrica,710,1,0,,1,"(6.171601,-75.427454)"
2021,Septiembre,Sudán,736,0,1,,1,"(4.697144,-74.140516)"
2021,Septiembre,Suecia,752,2,3,,5,"(10.445761,-75.516429)"
2021,Septiembre,Suecia,752,1,0,,1,"(10.886611,-74.776708)"
2021,Septiembre,Suecia,752,13,9,,22,"(3.541112,-76.384584)"
2021,Septiembre,Suecia,752,51,31,,82,"(4.697144,-74.140516)"
2021,Septiembre,Suecia,752,0,1,,1,"(4.815061,-75.736532)"
2021,Septiembre,Suecia,752,7,9,,16,"(6.171601,-75.427454)"
2021,Septiembre,Suiza,756,19,15,,34,"(10.445761,-75.516429)"
2021,Septiembre,Suiza,756,4,1,,5,"(10.886611,-74.776708)"
2021,Septiembre,Suiza,756,37,15,,52,"(3.541112,-76.384584)"
2021,Septiembre,Suiza,756,397,249,,646,"(4.697144,-74.140516)"
2021,Septiembre,Suiza,756,4,2,,6,"(4.815061,-75.736532)"
2021,Septiembre,Suiza,756,45,26,,71,"(6.171601,-75.427454)"
2021,Septiembre,Suiza,756,2,0,,2,"(7.128456,-73.183637)"
2021,Septiembre,Surinam,740,0,1,,1,"(10.445761,-75.516429)"
2021,Septiembre,Surinam,740,0,3,,3,"(10.886611,-74.776708)"
2021,Septiembre,Surinam,740,3,7,,10,"(4.697144,-74.140516)"
2021,Septiembre,Taiwán,158,2,0,,2,"(4.697144,-74.140516)"
2021,Septiembre,República de Tayikistán,762,0,1,,1,"(4.697144,-74.140516)"
2021,Septiembre,Tailandia,764,0,1,,1,"(4.697144,-74.140516)"
2021,Septiembre,Tailandia,764,0,1,,1,"(6.171601,-75.427454)"
2021,Septiembre,Tanzania,834,1,0,,1,"(10.445761,-75.516429)"
2021,Septiembre,Tanzania,834,1,1,,2,"(4.697144,-74.140516)"
2021,Septiembre,Trinidad y Tobago,780,1,4,,5,"(3.541112,-76.384584)"
2021,Septiembre,Trinidad y Tobago,780,11,12,,23,"(4.697144,-74.140516)"
2021,Septiembre,Trinidad y Tobago,780,1,1,,2,"(4.815061,-75.736532)"
2021,Septiembre,Trinidad y Tobago,780,2,6,,8,"(6.171601,-75.427454)"
2021,Septiembre,Trinidad y Tobago,780,1,0,,1,"(7.128456,-73.183637)"
2021,Septiembre,Turquía,792,0,1,,1,"(10.886611,-74.776708)"
2021,Septiembre,Turquía,792,6,2,,8,"(3.541112,-76.384584)"
2021,Septiembre,Turquía,792,1186,703,,1889,"(4.697144,-74.140516)"
2021,Septiembre,Turquía,792,20,13,,33,"(6.171601,-75.427454)"
2021,Septiembre,Turkmenistán,795,4,1,,5,"(4.697144,-74.140516)"
2021,Septiembre,Ucrania,804,0,1,,1,"(10.445761,-75.516429)"
2021,Septiembre,Ucrania,804,7,13,,20,"(4.697144,-74.140516)"
2021,Septiembre,Uganda,800,0,2,,2,"(10.445761,-75.516429)"
2021,Septiembre,Uganda,800,4,2,,6,"(4.697144,-74.140516)"
2021,Septiembre,Uruguay,858,0,1,,1,"(10.445761,-75.516429)"
2021,Septiembre,Uruguay,858,0,1,,1,"(10.886611,-74.776708)"
2021,Septiembre,Uruguay,858,10,10,,20,"(3.541112,-76.384584)"
2021,Septiembre,Uruguay,858,39,38,,77,"(4.697144,-74.140516)"
2021,Septiembre,Uruguay,858,5,14,,19,"(4.815061,-75.736532)"
2021,Septiembre,Uruguay,858,10,8,,18,"(6.171601,-75.427454)"
2021,Septiembre,Uruguay,858,1,0,,1,"(7.128456,-73.183637)"
2021,Septiembre,Uzbekistán,860,0,1,,1,"(10.445761,-75.516429)"
2021,Septiembre,Uzbekistán,860,0,1,,1,"(3.541112,-76.384584)"
2021,Septiembre,Uzbekistán,860,1,1,,2,"(4.697144,-74.140516)"
2021,Septiembre,Venezuela,862,7,1,,8,"(10.445761,-75.516429)"
2021,Septiembre,Venezuela,862,20,24,,44,"(10.886611,-74.776708)"
2021,Septiembre,Venezuela,862,71,255,,326,"(11.360009,-72.129330)"
2021,Septiembre,Venezuela,862,24,16,,40,"(3.541112,-76.384584)"
2021,Septiembre,Venezuela,862,163,196,,359,"(4.697144,-74.140516)"
2021,Septiembre,Venezuela,862,43,42,,85,"(6.171601,-75.427454)"
2021,Septiembre,Venezuela,862,1,1,,2,"(6.185799,-67.483929)"
2021,Septiembre,Venezuela,862,5,6,,11,"(7.088729,-70.740253)"
2021,Septiembre,Venezuela,862,2,2,,4,"(7.128456,-73.183637)"
2021,Septiembre,Venezuela,862,56,62,,118,"(7.818934,-72.453226)"
2021,Septiembre,Venezuela,862,9,8,,17,"(7.916725,-72.462544)"
2021,Septiembre,Venezuela,862,2,4,,6,"(8.36068,-72.409396)"
2021,Septiembre,Vietnam,704,0,2,,2,"(4.697144,-74.140516)"
2021,Septiembre,Vietnam,704,0,1,,1,"(4.815061,-75.736532)"
2021,Septiembre,Islas Vírgenes Británicas/Territorio Británico de Ultramar,92,0,1,,1,"(4.697144,-74.140516)"
2021,Septiembre,Islas Vírgenes Británicas/Territorio Británico de Ultramar,92,1,1,,2,"(6.171601,-75.427454)"
2021,Septiembre,Islas Vírgenes Estadounidenses/Territorio de Estados Unidos,850,1,0,,1,"(3.541112,-76.384584)"
2021,Septiembre,Islas Vírgenes Estadounidenses/Territorio de Estados Unidos,850,1,1,,2,"(4.697144,-74.140516)"
2021,Septiembre,Islas Vírgenes Estadounidenses/Territorio de Estados Unidos,850,0,1,,1,"(6.171601,-75.427454)"
2021,Septiembre,Zambia,894,0,2,,2,"(4.697144,-74.140516)"
2021,Septiembre,Zimbabue,716,0,1,,1,"(4.697144,-74.140516)"
2021,Septiembre,Islas Turcas y Caicos/Territorio Británico de Ultramar,796,2,2,,4,"(4.697144,-74.140516)"
2021,Septiembre,Desconocido,99999,1,0,,1,"(3.541112,-76.384584)"
2021,Octubre,Afganistán,4,0,1,,1,"(4.697144,-74.140516)"
2021,Octubre,Albania,8,2,0,,2,"(4.697144,-74.140516)"
2021,Octubre,Alemania,276,47,32,,79,"(10.445761,-75.516429)"
2021,Octubre,Alemania,276,2,7,,9,"(10.886611,-74.776708)"
2021,Octubre,Alemania,276,57,50,,107,"(3.541112,-76.384584)"
2021,Octubre,Alemania,276,1069,813,,1882,"(4.697144,-74.140516)"
2021,Octubre,Alemania,276,6,8,,14,"(4.815061,-75.736532)"
2021,Octubre,Alemania,276,67,49,,116,"(6.171601,-75.427454)"
2021,Octubre,Alemania,276,0,1,,1,"(7.128456,-73.183637)"
2021,Octubre,Andorra,20,6,4,,10,"(4.697144,-74.140516)"
2021,Octubre,Angola,24,1,4,,5,"(4.697144,-74.140516)"
2021,Octubre,Antigua y Barbuda,28,1,0,,1,"(10.445761,-75.516429)"
2021,Octubre,Antigua y Barbuda,28,2,2,,4,"(4.697144,-74.140516)"
2021,Octubre,Países Bajos,528,0,2,,2,"(10.408582,-75.538003)"
2021,Octubre,Países Bajos,528,125,78,,203,"(10.445761,-75.516429)"
2021,Octubre,Países Bajos,528,31,19,,50,"(10.886611,-74.776708)"
2021,Octubre,Países Bajos,528,55,36,,91,"(3.541112,-76.384584)"
2021,Octubre,Países Bajos,528,830,788,,1618,"(4.697144,-74.140516)"
2021,Octubre,Países Bajos,528,5,3,,8,"(4.815061,-75.736532)"
2021,Octubre,Países Bajos,528,80,53,,133,"(6.171601,-75.427454)"
2021,Octubre,Arabia Saudita,682,0,1,,1,"(10.445761,-75.516429)"
2021,Octubre,Arabia Saudita,682,0,1,,1,"(3.541112,-76.384584)"
2021,Octubre,Arabia Saudita,682,16,56,,72,"(4.697144,-74.140516)"
2021,Octubre,Arabia Saudita,682,1,6,,7,"(6.171601,-75.427454)"
2021,Octubre,Argelia,12,0,3,,3,"(4.697144,-74.140516)"
2021,Octubre,Argentina,32,4,0,,4,"(10.445761,-75.516429)"
2021,Octubre,Argentina,32,2,0,,2,"(10.886611,-74.776708)"
2021,Octubre,Argentina,32,3,6,,9,"(3.541112,-76.384584)"
2021,Octubre,Argentina,32,796,647,,1443,"(4.697144,-74.140516)"
2021,Octubre,Argentina,32,0,1,,1,"(4.815061,-75.736532)"
2021,Octubre,Argentina,32,13,3,,16,"(6.171601,-75.427454)"
2021,Octubre,Aruba,533,0,1,,1,"(10.408582,-75.538003)"
2021,Octubre,Aruba,533,1,0,,1,"(10.445761,-75.516429)"
2021,Octubre,Aruba,533,37,25,,62,"(10.886611,-74.776708)"
2021,Octubre,Aruba,533,0,2,,2,"(11.117806,-74.232622)"
2021,Octubre,Aruba,533,1,0,,1,"(11.247723,-74.213989)"
2021,Octubre,Aruba,533,60,30,,90,"(3.541112,-76.384584)"
2021,Octubre,Aruba,533,1582,1193,,2775,"(4.697144,-74.140516)"
2021,Octubre,Aruba,533,49,47,,96,"(6.171601,-75.427454)"
2021,Octubre,Aruba,533,20,43,,63,"(7.128456,-73.183637)"
2021,Octubre,Australia,36,10,7,,17,"(4.697144,-74.140516)"
2021,Octubre,Austria,40,5,3,,8,"(10.445761,-75.516429)"
2021,Octubre,Austria,40,0,1,,1,"(10.886611,-74.776708)"
2021,Octubre,Austria,40,4,3,,7,"(3.541112,-76.384584)"
2021,Octubre,Austria,40,50,42,,92,"(4.697144,-74.140516)"
2021,Octubre,Austria,40,4,3,,7,"(6.171601,-75.427454)"
2021,Octubre,Azerbaiyán,31,1,1,,2,"(4.697144,-74.140516)"
2021,Octubre,Bahamas,44,1,1,,2,"(10.445761,-75.516429)"
2021,Octubre,Bahamas,44,9,7,,16,"(10.886611,-74.776708)"
2021,Octubre,Bahamas,44,37,17,,54,"(3.541112,-76.384584)"
2021,Octubre,Bahamas,44,103,79,,182,"(4.697144,-74.140516)"
2021,Octubre,Bahamas,44,3,3,,6,"(4.815061,-75.736532)"
2021,Octubre,Bahamas,44,30,30,,60,"(6.171601,-75.427454)"
2021,Octubre,Bahréin,48,0,1,,1,"(10.445761,-75.516429)"
2021,Octubre,Bahréin,48,1,0,,1,"(3.541112,-76.384584)"
2021,Octubre,Bahréin,48,7,9,,16,"(4.697144,-74.140516)"
2021,Octubre,Bangladesh,50,0,2,,2,"(4.697144,-74.140516)"
2021,Octubre,Barbados,52,0,1,,1,"(3.541112,-76.384584)"
2021,Octubre,Barbados,52,4,3,,7,"(4.697144,-74.140516)"
2021,Octubre,Barbados,52,1,1,,2,"(6.171601,-75.427454)"
2021,Octubre,República de Belarús,112,1,3,,4,"(4.697144,-74.140516)"
2021,Octubre,Bélgica,56,6,6,,12,"(10.445761,-75.516429)"
2021,Octubre,Bélgica,56,1,1,,2,"(10.886611,-74.776708)"
2021,Octubre,Bélgica,56,12,13,,25,"(3.541112,-76.384584)"
2021,Octubre,Bélgica,56,96,64,,160,"(4.697144,-74.140516)"
2021,Octubre,Bélgica,56,0,1,,1,"(4.815061,-75.736532)"
2021,Octubre,Bélgica,56,41,20,,61,"(6.171601,-75.427454)"
2021,Octubre,Bélgica,56,0,1,,1,"(7.102626,-77.762647)"
2021,Octubre,Belice,84,0,1,,1,"(10.433609,-73.247863)"
2021,Octubre,Belice,84,3,4,,7,"(3.541112,-76.384584)"
2021,Octubre,Belice,84,4,17,,21,"(4.697144,-74.140516)"
2021,Octubre,Belice,84,5,8,,13,"(6.171601,-75.427454)"
2021,Octubre,Benín,204,1,0,,1,"(4.697144,-74.140516)"
2021,Octubre,Bermudas/Territorio Británico de Ultramar,60,0,3,,3,"(4.697144,-74.140516)"
2021,Octubre,Bermudas/Territorio Británico de Ultramar,60,1,1,,2,"(6.171601,-75.427454)"
2021,Octubre,Bolivia,68,0,1,,1,"(10.445761,-75.516429)"
2021,Octubre,Bolivia,68,2,1,,3,"(10.886611,-74.776708)"
2021,Octubre,Bolivia,68,3,3,,6,"(3.541112,-76.384584)"
2021,Octubre,Bolivia,68,289,499,,788,"(4.697144,-74.140516)"
2021,Octubre,Bolivia,68,1,0,,1,"(4.815061,-75.736532)"
2021,Octubre,Bolivia,68,0,7,,7,"(6.171601,-75.427454)"
2021,Octubre,Bolivia,68,0,1,,1,"(7.128456,-73.183637)"
2021,Octubre,Bosnia y Herzegovina,70,4,1,,5,"(4.697144,-74.140516)"
2021,Octubre,Brasil,76,46,68,,114,"(-4.197703,-69.941278)"
2021,Octubre,Brasil,76,19,24,,43,"(10.445761,-75.516429)"
2021,Octubre,Brasil,76,31,26,,57,"(10.886611,-74.776708)"
2021,Octubre,Brasil,76,113,136,,249,"(3.541112,-76.384584)"
2021,Octubre,Brasil,76,1589,2009,,3598,"(4.697144,-74.140516)"
2021,Octubre,Brasil,76,23,34,,57,"(4.815061,-75.736532)"
2021,Octubre,Brasil,76,123,211,,334,"(6.171601,-75.427454)"
2021,Octubre,Brasil,76,8,8,,16,"(7.128456,-73.183637)"
2021,Octubre,Brunei Darussalam,96,1,0,,1,"(3.541112,-76.384584)"
2021,Octubre,Bulgaria,100,0,1,,1,"(4.697144,-74.140516)"
2021,Octubre,Cabo Verde,132,1,1,,2,"(4.697144,-74.140516)"
2021,Octubre,Islas Caimán/Territorio Británico de Ultramar,136,1,3,,4,"(10.445761,-75.516429)"
2021,Octubre,Islas Caimán/Territorio Británico de Ultramar,136,0,1,,1,"(4.697144,-74.140516)"
2021,Octubre,Islas Caimán/Territorio Británico de Ultramar,136,0,2,,2,"(6.171601,-75.427454)"
2021,Octubre,Camboya,116,1,0,,1,"(4.697144,-74.140516)"
2021,Octubre,Camerún,120,0,1,,1,"(4.697144,-74.140516)"
2021,Octubre,Canadá,124,18,18,,36,"(10.445761,-75.516429)"
2021,Octubre,Canadá,124,42,33,,75,"(10.886611,-74.776708)"
2021,Octubre,Canadá,124,145,119,,264,"(3.541112,-76.384584)"
2021,Octubre,Canadá,124,1701,1390,,3091,"(4.697144,-74.140516)"
2021,Octubre,Canadá,124,9,12,,21,"(4.815061,-75.736532)"
2021,Octubre,Canadá,124,224,210,,434,"(6.171601,-75.427454)"
2021,Octubre,Canadá,124,5,3,,8,"(7.128456,-73.183637)"
2021,Octubre,España,724,131,88,,219,"(10.445761,-75.516429)"
2021,Octubre,España,724,48,60,,108,"(10.886611,-74.776708)"
2021,Octubre,España,724,1665,1236,,2901,"(3.541112,-76.384584)"
2021,Octubre,España,724,2,0,,2,"(4.452882,-75.766298)"
2021,Octubre,España,724,15864,11650,,27514,"(4.697144,-74.140516)"
2021,Octubre,España,724,105,70,,175,"(4.815061,-75.736532)"
2021,Octubre,España,724,1877,1365,,3242,"(6.171601,-75.427454)"
2021,Octubre,España,724,7,5,,12,"(7.128456,-73.183637)"
2021,Octubre,Colombia,170,1,5,,6,"(10.445761,-75.516429)"
2021,Octubre,Colombia,170,54,95,,149,"(4.697144,-74.140516)"
2021,Octubre,Comoras,174,0,1,,1,"(4.697144,-74.140516)"
2021,Octubre,República Democrática del Congo,180,0,1,,1,"(4.697144,-74.140516)"
2021,Octubre,República de Corea,410,2,8,,10,"(4.697144,-74.140516)"
2021,Octubre,República de Corea,410,1,3,,4,"(6.171601,-75.427454)"
2021,Octubre,Costa de Marfil,384,0,5,,5,"(4.697144,-74.140516)"
2021,Octubre,Costa Rica,188,0,6,,6,"(10.408582,-75.538003)"
2021,Octubre,Costa Rica,188,6,8,,14,"(10.445761,-75.516429)"
2021,Octubre,Costa Rica,188,30,31,,61,"(10.886611,-74.776708)"
2021,Octubre,Costa Rica,188,1,8,,9,"(12.5744111,-81.703935)"
2021,Octubre,Costa Rica,188,100,98,,198,"(3.541112,-76.384584)"
2021,Octubre,Costa Rica,188,968,939,,1907,"(4.697144,-74.140516)"
2021,Octubre,Costa Rica,188,31,16,,47,"(4.815061,-75.736532)"
2021,Octubre,Costa Rica,188,174,156,,330,"(6.171601,-75.427454)"
2021,Octubre,Costa Rica,188,5,4,,9,"(7.128456,-73.183637)"
2021,Octubre,Croacia,191,2,1,,3,"(10.445761,-75.516429)"
2021,Octubre,Croacia,191,2,0,,2,"(3.541112,-76.384584)"
2021,Octubre,Croacia,191,32,19,,51,"(4.697144,-74.140516)"
2021,Octubre,Croacia,191,1,0,,1,"(4.815061,-75.736532)"
2021,Octubre,Croacia,191,1,1,,2,"(6.171601,-75.427454)"
2021,Octubre,Cuba,192,2,28,,30,"(10.886611,-74.776708)"
2021,Octubre,Cuba,192,0,1,,1,"(3.541112,-76.384584)"
2021,Octubre,Cuba,192,45,94,,139,"(4.697144,-74.140516)"
2021,Octubre,Cuba,192,1,3,,4,"(6.171601,-75.427454)"
2021,Octubre,Curazao,99999,44,30,,74,"(10.886611,-74.776708)"
2021,Octubre,Curazao,99999,25,20,,45,"(3.541112,-76.384584)"
2021,Octubre,Curazao,99999,819,611,,1430,"(4.697144,-74.140516)"
2021,Octubre,Curazao,99999,36,16,,52,"(6.171601,-75.427454)"
2021,Octubre,Curazao,99999,1,1,,2,"(7.128456,-73.183637)"
2021,Octubre,República Checa,203,2,0,,2,"(10.445761,-75.516429)"
2021,Octubre,República Checa,203,1,1,,2,"(3.541112,-76.384584)"
2021,Octubre,República Checa,203,13,14,,27,"(4.697144,-74.140516)"
2021,Octubre,República Checa,203,2,1,,3,"(6.171601,-75.427454)"
2021,Octubre,Chile,152,15,8,,23,"(10.445761,-75.516429)"
2021,Octubre,Chile,152,37,16,,53,"(10.886611,-74.776708)"
2021,Octubre,Chile,152,819,564,,1383,"(3.541112,-76.384584)"
2021,Octubre,Chile,152,2953,2245,,5198,"(4.697144,-74.140516)"
2021,Octubre,Chile,152,58,41,,99,"(4.815061,-75.736532)"
2021,Octubre,Chile,152,138,96,,234,"(6.171601,-75.427454)"
2021,Octubre,Chile,152,2,5,,7,"(7.128456,-73.183637)"
2021,Octubre,China,156,5,3,,8,"(4.697144,-74.140516)"
2021,Octubre,China,156,0,2,,2,"(6.171601,-75.427454)"
2021,Octubre,Chipre,196,1,2,,3,"(4.697144,-74.140516)"
2021,Octubre,Dinamarca,208,2,3,,5,"(10.445761,-75.516429)"
2021,Octubre,Dinamarca,208,7,2,,9,"(3.541112,-76.384584)"
2021,Octubre,Dinamarca,208,39,26,,65,"(4.697144,-74.140516)"
2021,Octubre,Dinamarca,208,1,0,,1,"(4.815061,-75.736532)"
2021,Octubre,Dinamarca,208,2,3,,5,"(6.171601,-75.427454)"
2021,Octubre,Dominica,212,0,1,,1,"(3.541112,-76.384584)"
2021,Octubre,Dominica,212,4,2,,6,"(4.697144,-74.140516)"
2021,Octubre,Dominica,212,0,1,,1,"(4.815061,-75.736532)"
2021,Octubre,Dominica,212,1,0,,1,"(6.171601,-75.427454)"
2021,Octubre,Ecuador,218,63,82,,145,"(0.814836,-77.662532)"
2021,Octubre,Ecuador,218,4,6,,10,"(10.445761,-75.516429)"
2021,Octubre,Ecuador,218,14,27,,41,"(10.886611,-74.776708)"
2021,Octubre,Ecuador,218,1,2,,3,"(11.117806,-74.232622)"
2021,Octubre,Ecuador,218,47,59,,106,"(3.541112,-76.384584)"
2021,Octubre,Ecuador,218,2330,3028,,5358,"(4.697144,-74.140516)"
2021,Octubre,Ecuador,218,15,11,,26,"(4.815061,-75.736532)"
2021,Octubre,Ecuador,218,77,110,,187,"(6.171601,-75.427454)"
2021,Octubre,Ecuador,218,5,5,,10,"(7.128456,-73.183637)"
2021,Octubre,Egipto,818,0,2,,2,"(10.408582,-75.538003)"
2021,Octubre,Egipto,818,1,1,,2,"(10.445761,-75.516429)"
2021,Octubre,Egipto,818,3,0,,3,"(10.886611,-74.776708)"
2021,Octubre,Egipto,818,77,43,,120,"(4.697144,-74.140516)"
2021,Octubre,Egipto,818,3,1,,4,"(6.171601,-75.427454)"
2021,Octubre,El Salvador,222,1,3,,4,"(10.445761,-75.516429)"
2021,Octubre,El Salvador,222,12,8,,20,"(10.886611,-74.776708)"
2021,Octubre,El Salvador,222,28,40,,68,"(3.541112,-76.384584)"
2021,Octubre,El Salvador,222,277,375,,652,"(4.697144,-74.140516)"
2021,Octubre,El Salvador,222,1,3,,4,"(4.815061,-75.736532)"
2021,Octubre,El Salvador,222,37,48,,85,"(6.171601,-75.427454)"
2021,Octubre,El Salvador,222,0,4,,4,"(7.128456,-73.183637)"
2021,Octubre,Emiratos Árabes,784,13,16,,29,"(10.445761,-75.516429)"
2021,Octubre,Emiratos Árabes,784,6,13,,19,"(3.541112,-76.384584)"
2021,Octubre,Emiratos Árabes,784,279,479,,758,"(4.697144,-74.140516)"
2021,Octubre,Emiratos Árabes,784,3,7,,10,"(4.815061,-75.736532)"
2021,Octubre,Emiratos Árabes,784,22,26,,48,"(6.171601,-75.427454)"
2021,Octubre,Eritrea,232,0,1,,1,"(10.886611,-74.776708)"
2021,Octubre,Eritrea,232,2,0,,2,"(4.697144,-74.140516)"
2021,Octubre,Eslovaquia,703,6,14,,20,"(4.697144,-74.140516)"
2021,Octubre,Eslovenia,705,2,0,,2,"(4.697144,-74.140516)"
2021,Octubre,Eslovenia,705,0,1,,1,"(6.171601,-75.427454)"
2021,Octubre,Estados Unidos de América,840,0,1,,1,"(10.408582,-75.538003)"
2021,Octubre,Estados Unidos de América,840,3043,2569,,5612,"(10.445761,-75.516429)"
2021,Octubre,Estados Unidos de América,840,4908,4135,,9043,"(10.886611,-74.776708)"
2021,Octubre,Estados Unidos de América,840,6,2,,8,"(11.117806,-74.232622)"
2021,Octubre,Estados Unidos de América,840,9720,7118,,16838,"(3.541112,-76.384584)"
2021,Octubre,Estados Unidos de América,840,1080,921,,2001,"(4.452882,-75.766298)"
2021,Octubre,Estados Unidos de América,840,40331,34338,,74669,"(4.697144,-74.140516)"
2021,Octubre,Estados Unidos de América,840,2330,1642,,3972,"(4.815061,-75.736532)"
2021,Octubre,Estados Unidos de América,840,16178,12771,,28949,"(6.171601,-75.427454)"
2021,Octubre,Estados Unidos de América,840,946,778,,1724,"(7.128456,-73.183637)"
2021,Octubre,Estonia,233,1,0,,1,"(3.541112,-76.384584)"
2021,Octubre,Estonia,233,3,3,,6,"(4.697144,-74.140516)"
2021,Octubre,Etiopia,231,3,6,,9,"(4.697144,-74.140516)"
2021,Octubre,Etiopia,231,0,2,,2,"(6.171601,-75.427454)"
2021,Octubre,Islas Fiji,242,1,0,,1,"(3.541112,-76.384584)"
2021,Octubre,Filipinas,608,1,1,,2,"(4.697144,-74.140516)"
2021,Octubre,Finlandia,246,1,1,,2,"(10.445761,-75.516429)"
2021,Octubre,Finlandia,246,2,2,,4,"(3.541112,-76.384584)"
2021,Octubre,Finlandia,246,8,9,,17,"(4.697144,-74.140516)"
2021,Octubre,Finlandia,246,0,1,,1,"(6.171601,-75.427454)"
2021,Octubre,Francia,250,28,24,,52,"(10.445761,-75.516429)"
2021,Octubre,Francia,250,5,1,,6,"(10.886611,-74.776708)"
2021,Octubre,Francia,250,57,41,,98,"(3.541112,-76.384584)"
2021,Octubre,Francia,250,1910,1499,,3409,"(4.697144,-74.140516)"
2021,Octubre,Francia,250,11,15,,26,"(4.815061,-75.736532)"
2021,Octubre,Francia,250,72,55,,127,"(6.171601,-75.427454)"
2021,Octubre,Gabón,266,0,1,,1,"(6.171601,-75.427454)"
2021,Octubre,Gambia,270,1,0,,1,"(4.697144,-74.140516)"
2021,Octubre,Georgia,268,1,0,,1,"(10.445761,-75.516429)"
2021,Octubre,Georgia,268,2,1,,3,"(3.541112,-76.384584)"
2021,Octubre,Georgia,268,6,6,,12,"(4.697144,-74.140516)"
2021,Octubre,Georgia,268,2,0,,2,"(6.171601,-75.427454)"
2021,Octubre,Ghana,288,0,1,,1,"(10.445761,-75.516429)"
2021,Octubre,Ghana,288,2,9,,11,"(4.697144,-74.140516)"
2021,Octubre,Ghana,288,1,1,,2,"(6.171601,-75.427454)"
2021,Octubre,Gibraltar/Territorio Británico de Ultramar,292,1,0,,1,"(4.697144,-74.140516)"
2021,Octubre,Granada,308,0,7,,7,"(3.541112,-76.384584)"
2021,Octubre,Granada,308,1,0,,1,"(4.697144,-74.140516)"
2021,Octubre,Grecia,300,0,1,,1,"(10.445761,-75.516429)"
2021,Octubre,Grecia,300,18,18,,36,"(4.697144,-74.140516)"
2021,Octubre,Grecia,300,0,3,,3,"(4.815061,-75.736532)"
2021,Octubre,Grecia,300,1,1,,2,"(6.171601,-75.427454)"
2021,Octubre,Guatemala,320,1,2,,3,"(10.445761,-75.516429)"
2021,Octubre,Guatemala,320,12,19,,31,"(10.886611,-74.776708)"
2021,Octubre,Guatemala,320,1,5,,6,"(12.586067,-81.702563)"
2021,Octubre,Guatemala,320,52,76,,128,"(3.541112,-76.384584)"
2021,Octubre,Guatemala,320,314,428,,742,"(4.697144,-74.140516)"
2021,Octubre,Guatemala,320,17,16,,33,"(4.815061,-75.736532)"
2021,Octubre,Guatemala,320,91,98,,189,"(6.171601,-75.427454)"
2021,Octubre,Guatemala,320,9,6,,15,"(7.128456,-73.183637)"
2021,Octubre,Guyana,328,0,1,,1,"(10.445761,-75.516429)"
2021,Octubre,Guyana,328,1,1,,2,"(10.886611,-74.776708)"
2021,Octubre,Guyana,328,4,26,,30,"(4.697144,-74.140516)"
2021,Octubre,Guyana,328,0,1,,1,"(4.815061,-75.736532)"
2021,Octubre,Guyana,328,2,7,,9,"(6.171601,-75.427454)"
2021,Octubre,Guyana,328,0,1,,1,"(7.128456,-73.183637)"
2021,Octubre,Guinea,324,0,1,,1,"(10.886611,-74.776708)"
2021,Octubre,Guinea,324,1,1,,2,"(4.697144,-74.140516)"
2021,Octubre,Guinea Ecuatorial,226,3,7,,10,"(4.697144,-74.140516)"
2021,Octubre,Guadalupe/Territorio Francés,312,1,0,,1,"(3.541112,-76.384584)"
2021,Octubre,Guadalupe/Territorio Francés,312,1,3,,4,"(4.697144,-74.140516)"
2021,Octubre,Guayana Francesa/Departamento de Ultramar Francés,254,2,6,,8,"(4.697144,-74.140516)"
2021,Octubre,Guayana Francesa/Departamento de Ultramar Francés,254,0,1,,1,"(6.171601,-75.427454)"
2021,Octubre,Haití,332,0,2,,2,"(10.886611,-74.776708)"
2021,Octubre,Haití,332,2,11,,13,"(4.697144,-74.140516)"
2021,Octubre,Haití,332,0,2,,2,"(6.171601,-75.427454)"
2021,Octubre,Honduras,340,2,12,,14,"(10.445761,-75.516429)"
2021,Octubre,Honduras,340,8,17,,25,"(10.886611,-74.776708)"
2021,Octubre,Honduras,340,12,28,,40,"(3.541112,-76.384584)"
2021,Octubre,Honduras,340,0,7,,7,"(3.893038,-77.067921)"
2021,Octubre,Honduras,340,63,109,,172,"(4.697144,-74.140516)"
2021,Octubre,Honduras,340,2,2,,4,"(4.815061,-75.736532)"
2021,Octubre,Honduras,340,30,63,,93,"(6.171601,-75.427454)"
2021,Octubre,Honduras,340,5,5,,10,"(7.128456,-73.183637)"
2021,Octubre,Hong Kong,344,1,1,,2,"(3.541112,-76.384584)"
2021,Octubre,Hong Kong,344,1,0,,1,"(4.697144,-74.140516)"
2021,Octubre,Hong Kong,344,1,0,,1,"(6.171601,-75.427454)"
2021,Octubre,Hungría,348,6,3,,9,"(4.697144,-74.140516)"
2021,Octubre,Hungría,348,1,0,,1,"(4.815061,-75.736532)"
2021,Octubre,India,356,9,4,,13,"(4.697144,-74.140516)"
2021,Octubre,India,356,1,0,,1,"(6.171601,-75.427454)"
2021,Octubre,Indonesia,360,1,5,,6,"(4.697144,-74.140516)"
2021,Octubre,Iraq,368,1,7,,8,"(4.697144,-74.140516)"
2021,Octubre,Irán,364,0,1,,1,"(4.697144,-74.140516)"
2021,Octubre,República de Irlanda,372,1,0,,1,"(3.541112,-76.384584)"
2021,Octubre,República de Irlanda,372,10,6,,16,"(4.697144,-74.140516)"
2021,Octubre,República de Irlanda,372,1,0,,1,"(4.815061,-75.736532)"
2021,Octubre,República de Irlanda,372,1,0,,1,"(6.171601,-75.427454)"
2021,Octubre,Islandia,352,2,0,,2,"(3.541112,-76.384584)"
2021,Octubre,Islandia,352,8,5,,13,"(4.697144,-74.140516)"
2021,Octubre,Islandia,352,0,1,,1,"(4.815061,-75.736532)"
2021,Octubre,Islandia,352,3,3,,6,"(6.171601,-75.427454)"
2021,Octubre,Israel,376,2,0,,2,"(10.445761,-75.516429)"
2021,Octubre,Israel,376,4,5,,9,"(3.541112,-76.384584)"
2021,Octubre,Israel,376,41,48,,89,"(4.697144,-74.140516)"
2021,Octubre,Israel,376,3,3,,6,"(6.171601,-75.427454)"
2021,Octubre,Italia,380,39,14,,53,"(10.445761,-75.516429)"
2021,Octubre,Italia,380,6,3,,9,"(10.886611,-74.776708)"
2021,Octubre,Italia,380,69,39,,108,"(3.541112,-76.384584)"
2021,Octubre,Italia,380,453,325,,778,"(4.697144,-74.140516)"
2021,Octubre,Italia,380,3,3,,6,"(4.815061,-75.736532)"
2021,Octubre,Italia,380,48,23,,71,"(6.171601,-75.427454)"
2021,Octubre,Italia,380,3,2,,5,"(7.128456,-73.183637)"
2021,Octubre,Jamaica,388,2,1,,3,"(10.445761,-75.516429)"
2021,Octubre,Jamaica,388,1,0,,1,"(3.541112,-76.384584)"
2021,Octubre,Jamaica,388,2,7,,9,"(4.697144,-74.140516)"
2021,Octubre,Jamaica,388,1,4,,5,"(6.171601,-75.427454)"
2021,Octubre,Jamaica,388,2,3,,5,"(7.128456,-73.183637)"
2021,Octubre,Japón,392,18,13,,31,"(4.697144,-74.140516)"
2021,Octubre,Jordania,400,8,3,,11,"(4.697144,-74.140516)"
2021,Octubre,Kazajistán,398,1,1,,2,"(4.697144,-74.140516)"
2021,Octubre,Kenia,404,1,0,,1,"(10.445761,-75.516429)"
2021,Octubre,Kenia,404,13,10,,23,"(4.697144,-74.140516)"
2021,Octubre,Kenia,404,0,1,,1,"(4.815061,-75.736532)"
2021,Octubre,Kenia,404,2,3,,5,"(6.171601,-75.427454)"
2021,Octubre,Kuwait,414,0,1,,1,"(10.886611,-74.776708)"
2021,Octubre,Kuwait,414,1,2,,3,"(4.697144,-74.140516)"
2021,Octubre,Letonia,428,0,1,,1,"(4.697144,-74.140516)"
2021,Octubre,Líbano,422,1,0,,1,"(10.445761,-75.516429)"
2021,Octubre,Líbano,422,0,1,,1,"(10.886611,-74.776708)"
2021,Octubre,Líbano,422,1,0,,1,"(3.541112,-76.384584)"
2021,Octubre,Líbano,422,7,8,,15,"(4.697144,-74.140516)"
2021,Octubre,Líbano,422,0,1,,1,"(6.171601,-75.427454)"
2021,Octubre,Liechtenstein,438,1,0,,1,"(6.171601,-75.427454)"
2021,Octubre,Luxemburgo,442,1,0,,1,"(3.541112,-76.384584)"
2021,Octubre,Luxemburgo,442,6,6,,12,"(4.697144,-74.140516)"
2021,Octubre,Luxemburgo,442,3,1,,4,"(6.171601,-75.427454)"
2021,Octubre,Macao,446,1,0,,1,"(4.697144,-74.140516)"
2021,Octubre,Malasia,458,2,0,,2,"(4.697144,-74.140516)"
2021,Octubre,Malasia,458,1,0,,1,"(6.171601,-75.427454)"
2021,Octubre,Maldivas,462,1,0,,1,"(4.697144,-74.140516)"
2021,Octubre,Malí,466,0,5,,5,"(4.697144,-74.140516)"
2021,Octubre,Malí,466,1,0,,1,"(6.171601,-75.427454)"
2021,Octubre,Malta,470,25,12,,37,"(4.697144,-74.140516)"
2021,Octubre,Malta,470,0,1,,1,"(6.171601,-75.427454)"
2021,Octubre,Marruecos,504,2,2,,4,"(4.697144,-74.140516)"
2021,Octubre,Mauricio,480,0,1,,1,"(4.697144,-74.140516)"
2021,Octubre,Mauritania,478,1,6,,7,"(4.697144,-74.140516)"
2021,Octubre,México,484,62,29,,91,"(10.445761,-75.516429)"
2021,Octubre,México,484,241,216,,457,"(10.886611,-74.776708)"
2021,Octubre,México,484,2578,1925,,4503,"(3.541112,-76.384584)"
2021,Octubre,México,484,0,2,,2,"(4.452882,-75.766298)"
2021,Octubre,México,484,19423,16948,,36371,"(4.697144,-74.140516)"
2021,Octubre,México,484,167,121,,288,"(4.815061,-75.736532)"
2021,Octubre,México,484,7830,6467,,14297,"(6.171601,-75.427454)"
2021,Octubre,México,484,137,102,,239,"(7.128456,-73.183637)"
2021,Octubre,Mónaco,492,2,1,,3,"(4.697144,-74.140516)"
2021,Octubre,Mongolia,496,1,0,,1,"(4.697144,-74.140516)"
2021,Octubre,Montenegro,499,0,6,,6,"(4.697144,-74.140516)"
2021,Octubre,Mozambique,508,1,1,,2,"(4.697144,-74.140516)"
2021,Octubre,Nauru,520,0,1,,1,"(4.697144,-74.140516)"
2021,Octubre,Nepal,524,1,2,,3,"(4.697144,-74.140516)"
2021,Octubre,Nicaragua,558,0,1,,1,"(10.445761,-75.516429)"
2021,Octubre,Nicaragua,558,0,1,,1,"(10.886611,-74.776708)"
2021,Octubre,Nicaragua,558,3,5,,8,"(3.541112,-76.384584)"
2021,Octubre,Nicaragua,558,12,42,,54,"(4.697144,-74.140516)"
2021,Octubre,Nicaragua,558,1,0,,1,"(4.815061,-75.736532)"
2021,Octubre,Nicaragua,558,10,26,,36,"(6.171601,-75.427454)"
2021,Octubre,Nicaragua,558,0,1,,1,"(7.128456,-73.183637)"
2021,Octubre,Nigeria,566,2,4,,6,"(4.697144,-74.140516)"
2021,Octubre,Níger,562,1,0,,1,"(4.697144,-74.140516)"
2021,Octubre,Noruega,578,0,1,,1,"(10.445761,-75.516429)"
2021,Octubre,Noruega,578,2,0,,2,"(10.886611,-74.776708)"
2021,Octubre,Noruega,578,0,2,,2,"(3.541112,-76.384584)"
2021,Octubre,Noruega,578,26,14,,40,"(4.697144,-74.140516)"
2021,Octubre,Noruega,578,0,1,,1,"(4.815061,-75.736532)"
2021,Octubre,Noruega,578,6,2,,8,"(6.171601,-75.427454)"
2021,Octubre,Nueva Zelanda,554,0,1,,1,"(10.886611,-74.776708)"
2021,Octubre,Nueva Zelanda,554,1,0,,1,"(4.697144,-74.140516)"
2021,Octubre,Omán,512,7,6,,13,"(4.697144,-74.140516)"
2021,Octubre,Omán,512,0,1,,1,"(6.171601,-75.427454)"
2021,Octubre,Pakistán,586,2,2,,4,"(4.697144,-74.140516)"
2021,Octubre,Panamá,591,19,87,,106,"(10.408582,-75.538003)"
2021,Octubre,Panamá,591,868,711,,1579,"(10.445761,-75.516429)"
2021,Octubre,Panamá,591,497,488,,985,"(10.886611,-74.776708)"
2021,Octubre,Panamá,591,1,22,,23,"(12.5744111,-81.703935)"
2021,Octubre,Panamá,591,0,3,,3,"(12.586067,-81.702563)"
2021,Octubre,Panamá,591,0,5,,5,"(13.3387613,-81.372937)"
2021,Octubre,Panamá,591,1958,1508,,3466,"(3.541112,-76.384584)"
2021,Octubre,Panamá,591,3987,3973,,7960,"(4.697144,-74.140516)"
2021,Octubre,Panamá,591,289,205,,494,"(4.815061,-75.736532)"
2021,Octubre,Panamá,591,2,7,,9,"(6.17134,-75.427194)"
2021,Octubre,Panamá,591,1646,1377,,3023,"(6.171601,-75.427454)"
2021,Octubre,Panamá,591,0,8,,8,"(6.228046,-77.404104)"
2021,Octubre,Panamá,591,4,28,,32,"(7.102626,-77.762647)"
2021,Octubre,Panamá,591,88,82,,170,"(7.128456,-73.183637)"
2021,Octubre,Panamá,591,23,76,,99,"(8.635765,-77.346578)"
2021,Octubre,Paraguay,600,3,2,,5,"(10.445761,-75.516429)"
2021,Octubre,Paraguay,600,2,6,,8,"(10.886611,-74.776708)"
2021,Octubre,Paraguay,600,9,30,,39,"(3.541112,-76.384584)"
2021,Octubre,Paraguay,600,140,225,,365,"(4.697144,-74.140516)"
2021,Octubre,Paraguay,600,6,8,,14,"(4.815061,-75.736532)"
2021,Octubre,Paraguay,600,15,13,,28,"(6.171601,-75.427454)"
2021,Octubre,Paraguay,600,3,3,,6,"(7.128456,-73.183637)"
2021,Octubre,Perú,604,17,17,,34,"(-4.197703,-69.941278)"
2021,Octubre,Perú,604,4,3,,7,"(10.445761,-75.516429)"
2021,Octubre,Perú,604,42,30,,72,"(10.886611,-74.776708)"
2021,Octubre,Perú,604,128,97,,225,"(3.541112,-76.384584)"
2021,Octubre,Perú,604,2756,2993,,5749,"(4.697144,-74.140516)"
2021,Octubre,Perú,604,12,4,,16,"(4.815061,-75.736532)"
2021,Octubre,Perú,604,791,744,,1535,"(6.171601,-75.427454)"
2021,Octubre,Perú,604,2,3,,5,"(7.128456,-73.183637)"
2021,Octubre,Polonia,616,0,1,,1,"(10.445761,-75.516429)"
2021,Octubre,Polonia,616,14,16,,30,"(4.697144,-74.140516)"
2021,Octubre,Polonia,616,0,2,,2,"(6.171601,-75.427454)"
2021,Octubre,Portugal,620,3,4,,7,"(10.445761,-75.516429)"
2021,Octubre,Portugal,620,1,1,,2,"(10.886611,-74.776708)"
2021,Octubre,Portugal,620,7,0,,7,"(3.541112,-76.384584)"
2021,Octubre,Portugal,620,108,103,,211,"(4.697144,-74.140516)"
2021,Octubre,Portugal,620,0,2,,2,"(4.815061,-75.736532)"
2021,Octubre,Portugal,620,13,6,,19,"(6.171601,-75.427454)"
2021,Octubre,Puerto Rico/Territorio de Estados Unidos,630,0,1,,1,"(10.433609,-73.247863)"
2021,Octubre,Puerto Rico/Territorio de Estados Unidos,630,2,2,,4,"(10.445761,-75.516429)"
2021,Octubre,Puerto Rico/Territorio de Estados Unidos,630,15,11,,26,"(10.886611,-74.776708)"
2021,Octubre,Puerto Rico/Territorio de Estados Unidos,630,79,53,,132,"(3.541112,-76.384584)"
2021,Octubre,Puerto Rico/Territorio de Estados Unidos,630,273,242,,515,"(4.697144,-74.140516)"
2021,Octubre,Puerto Rico/Territorio de Estados Unidos,630,20,7,,27,"(4.815061,-75.736532)"
2021,Octubre,Puerto Rico/Territorio de Estados Unidos,630,74,58,,132,"(6.171601,-75.427454)"
2021,Octubre,Puerto Rico/Territorio de Estados Unidos,630,2,1,,3,"(7.128456,-73.183637)"
2021,Octubre,Qatar,634,0,1,,1,"(3.541112,-76.384584)"
2021,Octubre,Qatar,634,12,14,,26,"(4.697144,-74.140516)"
2021,Octubre,Qatar,634,4,3,,7,"(6.171601,-75.427454)"
2021,Octubre,Reino Unido de Gran Bretaña e Irlanda del Norte,826,4,2,,6,"(10.445761,-75.516429)"
2021,Octubre,Reino Unido de Gran Bretaña e Irlanda del Norte,826,2,0,,2,"(10.886611,-74.776708)"
2021,Octubre,Reino Unido de Gran Bretaña e Irlanda del Norte,826,9,3,,12,"(3.541112,-76.384584)"
2021,Octubre,Reino Unido de Gran Bretaña e Irlanda del Norte,826,116,126,,242,"(4.697144,-74.140516)"
2021,Octubre,Reino Unido de Gran Bretaña e Irlanda del Norte,826,0,1,,1,"(4.815061,-75.736532)"
2021,Octubre,Reino Unido de Gran Bretaña e Irlanda del Norte,826,15,7,,22,"(6.171601,-75.427454)"
2021,Octubre,República CentroÁfricana,140,0,1,,1,"(10.886611,-74.776708)"
2021,Octubre,República CentroÁfricana,140,1,0,,1,"(6.171601,-75.427454)"
2021,Octubre,Federación de Rusia,643,10,18,,28,"(4.697144,-74.140516)"
2021,Octubre,Federación de Rusia,643,2,0,,2,"(4.815061,-75.736532)"
2021,Octubre,Federación de Rusia,643,0,1,,1,"(6.171601,-75.427454)"
2021,Octubre,República Dominicana,214,0,1,,1,"(10.408582,-75.538003)"
2021,Octubre,República Dominicana,214,12,15,,27,"(10.445761,-75.516429)"
2021,Octubre,República Dominicana,214,119,122,,241,"(10.886611,-74.776708)"
2021,Octubre,República Dominicana,214,21,26,,47,"(11.117806,-74.232622)"
2021,Octubre,República Dominicana,214,476,376,,852,"(3.541112,-76.384584)"
2021,Octubre,República Dominicana,214,4490,3783,,8273,"(4.697144,-74.140516)"
2021,Octubre,República Dominicana,214,26,18,,44,"(4.815061,-75.736532)"
2021,Octubre,República Dominicana,214,2934,2261,,5195,"(6.171601,-75.427454)"
2021,Octubre,República Dominicana,214,105,66,,171,"(7.128456,-73.183637)"
2021,Octubre,Rumania,642,18,28,,46,"(4.697144,-74.140516)"
2021,Octubre,Rumania,642,3,3,,6,"(6.171601,-75.427454)"
2021,Octubre,Rwanda,646,0,2,,2,"(4.697144,-74.140516)"
2021,Octubre,San  Vicente y las Granadinas,670,1,5,,6,"(10.886611,-74.776708)"
2021,Octubre,San  Vicente y las Granadinas,670,1,0,,1,"(4.697144,-74.140516)"
2021,Octubre,San  Vicente y las Granadinas,670,1,5,,6,"(7.927209,-72.507910)"
2021,Octubre,Santa Lucia,662,1,1,,2,"(6.171601,-75.427454)"
2021,Octubre,Senegal,686,1,1,,2,"(4.697144,-74.140516)"
2021,Octubre,Serbia,688,6,13,,19,"(4.697144,-74.140516)"
2021,Octubre,Singapur,702,2,3,,5,"(4.697144,-74.140516)"
2021,Octubre,Sudáfrica,710,5,1,,6,"(4.697144,-74.140516)"
2021,Octubre,Sudáfrica,710,1,0,,1,"(6.171601,-75.427454)"
2021,Octubre,Suecia,752,3,1,,4,"(10.445761,-75.516429)"
2021,Octubre,Suecia,752,8,4,,12,"(3.541112,-76.384584)"
2021,Octubre,Suecia,752,50,35,,85,"(4.697144,-74.140516)"
2021,Octubre,Suecia,752,1,0,,1,"(4.815061,-75.736532)"
2021,Octubre,Suecia,752,8,7,,15,"(6.171601,-75.427454)"
2021,Octubre,Suiza,756,20,17,,37,"(10.445761,-75.516429)"
2021,Octubre,Suiza,756,11,6,,17,"(10.886611,-74.776708)"
2021,Octubre,Suiza,756,43,32,,75,"(3.541112,-76.384584)"
2021,Octubre,Suiza,756,378,198,,576,"(4.697144,-74.140516)"
2021,Octubre,Suiza,756,8,6,,14,"(4.815061,-75.736532)"
2021,Octubre,Suiza,756,41,20,,61,"(6.171601,-75.427454)"
2021,Octubre,Suiza,756,2,0,,2,"(7.128456,-73.183637)"
2021,Octubre,Surinam,740,3,9,,12,"(4.697144,-74.140516)"
2021,Octubre,Taiwán,158,2,6,,8,"(4.697144,-74.140516)"
2021,Octubre,Tailandia,764,2,2,,4,"(4.697144,-74.140516)"
2021,Octubre,Tanzania,834,1,2,,3,"(4.697144,-74.140516)"
2021,Octubre,Trinidad y Tobago,780,0,2,,2,"(10.445761,-75.516429)"
2021,Octubre,Trinidad y Tobago,780,2,1,,3,"(10.886611,-74.776708)"
2021,Octubre,Trinidad y Tobago,780,2,1,,3,"(3.541112,-76.384584)"
2021,Octubre,Trinidad y Tobago,780,7,15,,22,"(4.697144,-74.140516)"
2021,Octubre,Trinidad y Tobago,780,1,1,,2,"(4.815061,-75.736532)"
2021,Octubre,Trinidad y Tobago,780,7,4,,11,"(6.171601,-75.427454)"
2021,Octubre,Túnez,788,0,1,,1,"(4.697144,-74.140516)"
2021,Octubre,Turquía,792,4,3,,7,"(10.445761,-75.516429)"
2021,Octubre,Turquía,792,7,4,,11,"(3.541112,-76.384584)"
2021,Octubre,Turquía,792,1337,846,,2183,"(4.697144,-74.140516)"
2021,Octubre,Turquía,792,13,15,,28,"(6.171601,-75.427454)"
2021,Octubre,Turkmenistán,795,0,1,,1,"(10.445761,-75.516429)"
2021,Octubre,Turkmenistán,795,4,2,,6,"(4.697144,-74.140516)"
2021,Octubre,Ucrania,804,0,2,,2,"(3.541112,-76.384584)"
2021,Octubre,Ucrania,804,15,32,,47,"(4.697144,-74.140516)"
2021,Octubre,Ucrania,804,1,0,,1,"(6.171601,-75.427454)"
2021,Octubre,Uganda,800,2,1,,3,"(4.697144,-74.140516)"
2021,Octubre,Uruguay,858,1,4,,5,"(10.445761,-75.516429)"
2021,Octubre,Uruguay,858,2,2,,4,"(10.886611,-74.776708)"
2021,Octubre,Uruguay,858,13,15,,28,"(3.541112,-76.384584)"
2021,Octubre,Uruguay,858,38,114,,152,"(4.697144,-74.140516)"
2021,Octubre,Uruguay,858,2,3,,5,"(4.815061,-75.736532)"
2021,Octubre,Uruguay,858,8,12,,20,"(6.171601,-75.427454)"
2021,Octubre,Uruguay,858,0,1,,1,"(7.128456,-73.183637)"
2021,Octubre,Vanuatu,548,1,0,,1,"(6.171601,-75.427454)"
2021,Octubre,Venezuela,862,3,5,,8,"(10.445761,-75.516429)"
2021,Octubre,Venezuela,862,26,40,,66,"(10.886611,-74.776708)"
2021,Octubre,Venezuela,862,77,225,,302,"(11.360009,-72.129330)"
2021,Octubre,Venezuela,862,24,30,,54,"(3.541112,-76.384584)"
2021,Octubre,Venezuela,862,0,1,,1,"(3.866713,-67.927521)"
2021,Octubre,Venezuela,862,174,210,,384,"(4.697144,-74.140516)"
2021,Octubre,Venezuela,862,2,2,,4,"(4.815061,-75.736532)"
2021,Octubre,Venezuela,862,76,66,,142,"(6.171601,-75.427454)"
2021,Octubre,Venezuela,862,4,5,,9,"(6.185799,-67.483929)"
2021,Octubre,Venezuela,862,5,11,,16,"(7.088729,-70.740253)"
2021,Octubre,Venezuela,862,12,5,,17,"(7.128456,-73.183637)"
2021,Octubre,Venezuela,862,90,104,,194,"(7.818934,-72.453226)"
2021,Octubre,Venezuela,862,16,16,,32,"(7.916725,-72.462544)"
2021,Octubre,Venezuela,862,7,6,,13,"(8.36068,-72.409396)"
2021,Octubre,Islas Vírgenes Británicas/Territorio Británico de Ultramar,92,1,1,,2,"(4.697144,-74.140516)"
2021,Octubre,Islas Vírgenes Británicas/Territorio Británico de Ultramar,92,1,0,,1,"(6.171601,-75.427454)"
2021,Octubre,Islas Vírgenes Estadounidenses/Territorio de Estados Unidos,850,0,2,,2,"(4.697144,-74.140516)"
2021,Octubre,Zambia,894,1,0,,1,"(4.697144,-74.140516)"
2021,Octubre,Islas Turcas y Caicos/Territorio Británico de Ultramar,796,1,3,,4,"(4.697144,-74.140516)"
2021,Octubre,Desconocido,99999,2,0,,2,"(4.697144,-74.140516)"
2021,Noviembre,Afganistán,4,3,0,,3,"(4.697144,-74.140516)"
2021,Noviembre,Albania,8,4,0,,4,"(4.697144,-74.140516)"
2021,Noviembre,Alemania,276,24,17,,41,"(10.445761,-75.516429)"
2021,Noviembre,Alemania,276,7,5,,12,"(10.886611,-74.776708)"
2021,Noviembre,Alemania,276,45,45,,90,"(3.541112,-76.384584)"
2021,Noviembre,Alemania,276,1068,751,,1819,"(4.697144,-74.140516)"
2021,Noviembre,Alemania,276,1,1,,2,"(4.815061,-75.736532)"
2021,Noviembre,Alemania,276,48,44,,92,"(6.171601,-75.427454)"
2021,Noviembre,Andorra,20,16,24,,40,"(4.697144,-74.140516)"
2021,Noviembre,Andorra,20,0,1,,1,"(6.171601,-75.427454)"
2021,Noviembre,Angola,24,0,4,,4,"(4.697144,-74.140516)"
2021,Noviembre,Antigua y Barbuda,28,1,2,,3,"(10.445761,-75.516429)"
2021,Noviembre,Antigua y Barbuda,28,2,3,,5,"(4.697144,-74.140516)"
2021,Noviembre,Antigua y Barbuda,28,0,1,,1,"(4.815061,-75.736532)"
2021,Noviembre,Países Bajos,528,101,84,,185,"(10.445761,-75.516429)"
2021,Noviembre,Países Bajos,528,23,10,,33,"(10.886611,-74.776708)"
2021,Noviembre,Países Bajos,528,63,26,,89,"(3.541112,-76.384584)"
2021,Noviembre,Países Bajos,528,863,743,,1606,"(4.697144,-74.140516)"
2021,Noviembre,Países Bajos,528,3,1,,4,"(4.815061,-75.736532)"
2021,Noviembre,Países Bajos,528,52,27,,79,"(6.171601,-75.427454)"
2021,Noviembre,Arabia Saudita,682,2,1,,3,"(10.445761,-75.516429)"
2021,Noviembre,Arabia Saudita,682,0,1,,1,"(10.886611,-74.776708)"
2021,Noviembre,Arabia Saudita,682,4,3,,7,"(3.541112,-76.384584)"
2021,Noviembre,Arabia Saudita,682,6,21,,27,"(4.697144,-74.140516)"
2021,Noviembre,Arabia Saudita,682,1,0,,1,"(4.815061,-75.736532)"
2021,Noviembre,Arabia Saudita,682,2,0,,2,"(6.171601,-75.427454)"
2021,Noviembre,Argelia,12,3,4,,7,"(4.697144,-74.140516)"
2021,Noviembre,Argentina,32,0,1,,1,"(0.814836,-77.662532)"
2021,Noviembre,Argentina,32,5,4,,9,"(10.445761,-75.516429)"
2021,Noviembre,Argentina,32,14,7,,21,"(10.886611,-74.776708)"
2021,Noviembre,Argentina,32,43,37,,80,"(3.541112,-76.384584)"
2021,Noviembre,Argentina,32,1777,1602,,3379,"(4.697144,-74.140516)"
2021,Noviembre,Argentina,32,2,4,,6,"(4.815061,-75.736532)"
2021,Noviembre,Argentina,32,25,27,,52,"(6.171601,-75.427454)"
2021,Noviembre,Argentina,32,1,0,,1,"(7.128456,-73.183637)"
2021,Noviembre,Aruba,533,35,14,,49,"(10.886611,-74.776708)"
2021,Noviembre,Aruba,533,2,0,,2,"(11.247723,-74.213989)"
2021,Noviembre,Aruba,533,63,49,,112,"(3.541112,-76.384584)"
2021,Noviembre,Aruba,533,1419,1055,,2474,"(4.697144,-74.140516)"
2021,Noviembre,Aruba,533,2,1,,3,"(4.815061,-75.736532)"
2021,Noviembre,Aruba,533,46,39,,85,"(6.171601,-75.427454)"
2021,Noviembre,Aruba,533,7,21,,28,"(7.128456,-73.183637)"
2021,Noviembre,Australia,36,1,2,,3,"(3.541112,-76.384584)"
2021,Noviembre,Australia,36,16,15,,31,"(4.697144,-74.140516)"
2021,Noviembre,Australia,36,4,2,,6,"(6.171601,-75.427454)"
2021,Noviembre,Austria,40,2,1,,3,"(10.445761,-75.516429)"
2021,Noviembre,Austria,40,3,1,,4,"(3.541112,-76.384584)"
2021,Noviembre,Austria,40,47,52,,99,"(4.697144,-74.140516)"
2021,Noviembre,Austria,40,2,3,,5,"(6.171601,-75.427454)"
2021,Noviembre,Azerbaiyán,31,5,7,,12,"(4.697144,-74.140516)"
2021,Noviembre,Bahamas,44,0,3,,3,"(10.408582,-75.538003)"
2021,Noviembre,Bahamas,44,0,2,,2,"(10.445761,-75.516429)"
2021,Noviembre,Bahamas,44,1,0,,1,"(10.886611,-74.776708)"
2021,Noviembre,Bahamas,44,23,16,,39,"(3.541112,-76.384584)"
2021,Noviembre,Bahamas,44,30,34,,64,"(4.697144,-74.140516)"
2021,Noviembre,Bahamas,44,25,21,,46,"(6.171601,-75.427454)"
2021,Noviembre,Bahréin,48,1,0,,1,"(10.445761,-75.516429)"
2021,Noviembre,Bahréin,48,1,0,,1,"(10.886611,-74.776708)"
2021,Noviembre,Bahréin,48,6,7,,13,"(4.697144,-74.140516)"
2021,Noviembre,Bahréin,48,2,1,,3,"(6.171601,-75.427454)"
2021,Noviembre,Bangladesh,50,0,2,,2,"(4.697144,-74.140516)"
2021,Noviembre,Barbados,52,1,5,,6,"(4.697144,-74.140516)"
2021,Noviembre,Barbados,52,3,0,,3,"(6.171601,-75.427454)"
2021,Noviembre,República de Belarús,112,0,1,,1,"(4.697144,-74.140516)"
2021,Noviembre,Bélgica,56,3,4,,7,"(10.445761,-75.516429)"
2021,Noviembre,Bélgica,56,0,2,,2,"(10.886611,-74.776708)"
2021,Noviembre,Bélgica,56,28,21,,49,"(3.541112,-76.384584)"
2021,Noviembre,Bélgica,56,113,77,,190,"(4.697144,-74.140516)"
2021,Noviembre,Bélgica,56,12,10,,22,"(4.815061,-75.736532)"
2021,Noviembre,Bélgica,56,28,15,,43,"(6.171601,-75.427454)"
2021,Noviembre,Belice,84,0,1,,1,"(10.445761,-75.516429)"
2021,Noviembre,Belice,84,2,2,,4,"(10.886611,-74.776708)"
2021,Noviembre,Belice,84,0,1,,1,"(12.165168,-71.983761)"
2021,Noviembre,Belice,84,2,1,,3,"(3.541112,-76.384584)"
2021,Noviembre,Belice,84,10,8,,18,"(4.697144,-74.140516)"
2021,Noviembre,Belice,84,3,0,,3,"(6.171601,-75.427454)"
2021,Noviembre,Benín,204,1,1,,2,"(4.697144,-74.140516)"
2021,Noviembre,Bermudas/Territorio Británico de Ultramar,60,0,1,,1,"(4.697144,-74.140516)"
2021,Noviembre,Bermudas/Territorio Británico de Ultramar,60,1,0,,1,"(4.815061,-75.736532)"
2021,Noviembre,Bolivia,68,1,2,,3,"(10.886611,-74.776708)"
2021,Noviembre,Bolivia,68,4,10,,14,"(3.541112,-76.384584)"
2021,Noviembre,Bolivia,68,277,465,,742,"(4.697144,-74.140516)"
2021,Noviembre,Bolivia,68,2,4,,6,"(4.815061,-75.736532)"
2021,Noviembre,Bolivia,68,5,11,,16,"(6.171601,-75.427454)"
2021,Noviembre,Bolivia,68,0,1,,1,"(7.128456,-73.183637)"
2021,Noviembre,Bosnia y Herzegovina,70,31,9,,40,"(4.697144,-74.140516)"
2021,Noviembre,Brasil,76,62,111,,173,"(-4.197703,-69.941278)"
2021,Noviembre,Brasil,76,9,10,,19,"(10.445761,-75.516429)"
2021,Noviembre,Brasil,76,20,19,,39,"(10.886611,-74.776708)"
2021,Noviembre,Brasil,76,142,221,,363,"(3.541112,-76.384584)"
2021,Noviembre,Brasil,76,1940,2301,,4241,"(4.697144,-74.140516)"
2021,Noviembre,Brasil,76,28,26,,54,"(4.815061,-75.736532)"
2021,Noviembre,Brasil,76,131,175,,306,"(6.171601,-75.427454)"
2021,Noviembre,Brasil,76,2,6,,8,"(7.128456,-73.183637)"
2021,Noviembre,Bulgaria,100,3,1,,4,"(4.697144,-74.140516)"
2021,Noviembre,Burkina Faso,854,0,1,,1,"(10.886611,-74.776708)"
2021,Noviembre,Cabo Verde,132,1,0,,1,"(4.697144,-74.140516)"
2021,Noviembre,Cabo Verde,132,1,0,,1,"(6.171601,-75.427454)"
2021,Noviembre,Islas Caimán/Territorio Británico de Ultramar,136,2,0,,2,"(10.445761,-75.516429)"
2021,Noviembre,Islas Caimán/Territorio Británico de Ultramar,136,3,0,,3,"(4.815061,-75.736532)"
2021,Noviembre,Islas Caimán/Territorio Británico de Ultramar,136,0,1,,1,"(6.171601,-75.427454)"
2021,Noviembre,Camerún,120,0,2,,2,"(4.697144,-74.140516)"
2021,Noviembre,Canadá,124,16,23,,39,"(10.445761,-75.516429)"
2021,Noviembre,Canadá,124,47,40,,87,"(10.886611,-74.776708)"
2021,Noviembre,Canadá,124,138,84,,222,"(3.541112,-76.384584)"
2021,Noviembre,Canadá,124,0,1,,1,"(4.452882,-75.766298)"
2021,Noviembre,Canadá,124,1497,1217,,2714,"(4.697144,-74.140516)"
2021,Noviembre,Canadá,124,20,12,,32,"(4.815061,-75.736532)"
2021,Noviembre,Canadá,124,187,182,,369,"(6.171601,-75.427454)"
2021,Noviembre,Canadá,124,3,4,,7,"(7.128456,-73.183637)"
2021,Noviembre,Chad,148,1,0,,1,"(3.541112,-76.384584)"
2021,Noviembre,España,724,84,60,,144,"(10.445761,-75.516429)"
2021,Noviembre,España,724,48,34,,82,"(10.886611,-74.776708)"
2021,Noviembre,España,724,1340,1126,,2466,"(3.541112,-76.384584)"
2021,Noviembre,España,724,19790,15234,,35024,"(4.697144,-74.140516)"
2021,Noviembre,España,724,83,64,,147,"(4.815061,-75.736532)"
2021,Noviembre,España,724,1283,955,,2238,"(6.171601,-75.427454)"
2021,Noviembre,España,724,2,3,,5,"(7.128456,-73.183637)"
2021,Noviembre,Norfolk,574,1,0,,1,"(3.541112,-76.384584)"
2021,Noviembre,Norfolk,574,1,0,,1,"(6.171601,-75.427454)"
2021,Noviembre,Colombia,170,1,3,,4,"(10.445761,-75.516429)"
2021,Noviembre,Colombia,170,38,105,,143,"(4.697144,-74.140516)"
2021,Noviembre,República Del Congo,178,0,1,,1,"(4.697144,-74.140516)"
2021,Noviembre,República Democrática del Congo,180,0,1,,1,"(4.697144,-74.140516)"
2021,Noviembre,República de Corea,410,8,14,,22,"(4.697144,-74.140516)"
2021,Noviembre,República de Corea,410,0,1,,1,"(6.171601,-75.427454)"
2021,Noviembre,Costa de Marfil,384,5,6,,11,"(4.697144,-74.140516)"
2021,Noviembre,Costa de Marfil,384,0,1,,1,"(6.171601,-75.427454)"
2021,Noviembre,Costa Rica,188,0,8,,8,"(10.408582,-75.538003)"
2021,Noviembre,Costa Rica,188,9,18,,27,"(10.445761,-75.516429)"
2021,Noviembre,Costa Rica,188,13,27,,40,"(10.886611,-74.776708)"
2021,Noviembre,Costa Rica,188,6,47,,53,"(12.5744111,-81.703935)"
2021,Noviembre,Costa Rica,188,0,6,,6,"(13.3387613,-81.372937)"
2021,Noviembre,Costa Rica,188,88,75,,163,"(3.541112,-76.384584)"
2021,Noviembre,Costa Rica,188,868,912,,1780,"(4.697144,-74.140516)"
2021,Noviembre,Costa Rica,188,15,14,,29,"(4.815061,-75.736532)"
2021,Noviembre,Costa Rica,188,162,141,,303,"(6.171601,-75.427454)"
2021,Noviembre,Costa Rica,188,4,2,,6,"(7.128456,-73.183637)"
2021,Noviembre,Croacia,191,1,0,,1,"(10.445761,-75.516429)"
2021,Noviembre,Croacia,191,2,1,,3,"(3.541112,-76.384584)"
2021,Noviembre,Croacia,191,1,6,,7,"(4.697144,-74.140516)"
2021,Noviembre,Croacia,191,1,0,,1,"(6.171601,-75.427454)"
2021,Noviembre,Cuba,192,1,0,,1,"(10.445761,-75.516429)"
2021,Noviembre,Cuba,192,2,39,,41,"(10.886611,-74.776708)"
2021,Noviembre,Cuba,192,0,1,,1,"(3.541112,-76.384584)"
2021,Noviembre,Cuba,192,117,248,,365,"(4.697144,-74.140516)"
2021,Noviembre,Cuba,192,1,1,,2,"(4.815061,-75.736532)"
2021,Noviembre,Cuba,192,0,1,,1,"(6.171601,-75.427454)"
2021,Noviembre,Curazao,99999,1,45,,46,"(10.445761,-75.516429)"
2021,Noviembre,Curazao,99999,48,33,,81,"(10.886611,-74.776708)"
2021,Noviembre,Curazao,99999,20,10,,30,"(3.541112,-76.384584)"
2021,Noviembre,Curazao,99999,943,784,,1727,"(4.697144,-74.140516)"
2021,Noviembre,Curazao,99999,29,15,,44,"(6.171601,-75.427454)"
2021,Noviembre,República Checa,203,1,0,,1,"(10.445761,-75.516429)"
2021,Noviembre,República Checa,203,8,8,,16,"(4.697144,-74.140516)"
2021,Noviembre,República Checa,203,0,1,,1,"(6.171601,-75.427454)"
2021,Noviembre,Chile,152,9,6,,15,"(10.445761,-75.516429)"
2021,Noviembre,Chile,152,36,32,,68,"(10.886611,-74.776708)"
2021,Noviembre,Chile,152,1314,1007,,2321,"(3.541112,-76.384584)"
2021,Noviembre,Chile,152,0,1,,1,"(3.893038,-77.067921)"
2021,Noviembre,Chile,152,3332,2654,,5986,"(4.697144,-74.140516)"
2021,Noviembre,Chile,152,47,26,,73,"(4.815061,-75.736532)"
2021,Noviembre,Chile,152,102,96,,198,"(6.171601,-75.427454)"
2021,Noviembre,Chile,152,7,4,,11,"(7.128456,-73.183637)"
2021,Noviembre,China,156,0,1,,1,"(11.360009,-72.129330)"
2021,Noviembre,China,156,2,3,,5,"(4.697144,-74.140516)"
2021,Noviembre,China,156,5,4,,9,"(6.171601,-75.427454)"
2021,Noviembre,Chipre,196,0,1,,1,"(3.541112,-76.384584)"
2021,Noviembre,Chipre,196,0,1,,1,"(6.171601,-75.427454)"
2021,Noviembre,Dinamarca,208,3,1,,4,"(10.445761,-75.516429)"
2021,Noviembre,Dinamarca,208,1,4,,5,"(3.541112,-76.384584)"
2021,Noviembre,Dinamarca,208,38,21,,59,"(4.697144,-74.140516)"
2021,Noviembre,Dinamarca,208,1,1,,2,"(4.815061,-75.736532)"
2021,Noviembre,Dinamarca,208,5,0,,5,"(6.171601,-75.427454)"
2021,Noviembre,Dinamarca,208,1,1,,2,"(7.128456,-73.183637)"
2021,Noviembre,Dominica,212,4,2,,6,"(4.697144,-74.140516)"
2021,Noviembre,Dominica,212,2,3,,5,"(6.171601,-75.427454)"
2021,Noviembre,Ecuador,218,0,4,,4,"(0.25129,-76.875963)"
2021,Noviembre,Ecuador,218,63,66,,129,"(0.814836,-77.662532)"
2021,Noviembre,Ecuador,218,0,1,,1,"(1.813928,-78.763924)"
2021,Noviembre,Ecuador,218,5,11,,16,"(10.445761,-75.516429)"
2021,Noviembre,Ecuador,218,20,35,,55,"(10.886611,-74.776708)"
2021,Noviembre,Ecuador,218,57,85,,142,"(3.541112,-76.384584)"
2021,Noviembre,Ecuador,218,2416,3631,,6047,"(4.697144,-74.140516)"
2021,Noviembre,Ecuador,218,13,20,,33,"(4.815061,-75.736532)"
2021,Noviembre,Ecuador,218,64,117,,181,"(6.171601,-75.427454)"
2021,Noviembre,Ecuador,218,3,5,,8,"(7.128456,-73.183637)"
2021,Noviembre,Egipto,818,1,0,,1,"(3.541112,-76.384584)"
2021,Noviembre,Egipto,818,74,34,,108,"(4.697144,-74.140516)"
2021,Noviembre,Egipto,818,1,1,,2,"(6.171601,-75.427454)"
2021,Noviembre,El Salvador,222,0,1,,1,"(0.814836,-77.662532)"
2021,Noviembre,El Salvador,222,2,1,,3,"(10.445761,-75.516429)"
2021,Noviembre,El Salvador,222,13,16,,29,"(10.886611,-74.776708)"
2021,Noviembre,El Salvador,222,26,65,,91,"(3.541112,-76.384584)"
2021,Noviembre,El Salvador,222,420,533,,953,"(4.697144,-74.140516)"
2021,Noviembre,El Salvador,222,5,12,,17,"(4.815061,-75.736532)"
2021,Noviembre,El Salvador,222,26,44,,70,"(6.171601,-75.427454)"
2021,Noviembre,El Salvador,222,2,5,,7,"(7.128456,-73.183637)"
2021,Noviembre,Emiratos Árabes,784,10,9,,19,"(10.445761,-75.516429)"
2021,Noviembre,Emiratos Árabes,784,2,1,,3,"(10.886611,-74.776708)"
2021,Noviembre,Emiratos Árabes,784,2,1,,3,"(3.541112,-76.384584)"
2021,Noviembre,Emiratos Árabes,784,575,665,,1240,"(4.697144,-74.140516)"
2021,Noviembre,Emiratos Árabes,784,1,1,,2,"(4.815061,-75.736532)"
2021,Noviembre,Emiratos Árabes,784,14,23,,37,"(6.171601,-75.427454)"
2021,Noviembre,Emiratos Árabes,784,3,1,,4,"(7.128456,-73.183637)"
2021,Noviembre,Eritrea,232,1,0,,1,"(3.541112,-76.384584)"
2021,Noviembre,Eslovaquia,703,0,7,,7,"(4.697144,-74.140516)"
2021,Noviembre,Eslovenia,705,2,2,,4,"(4.697144,-74.140516)"
2021,Noviembre,Eslovenia,705,0,1,,1,"(6.171601,-75.427454)"
2021,Noviembre,Estados Unidos de América,840,3061,2356,,5418,"(10.445761,-75.516429)"
2021,Noviembre,Estados Unidos de América,840,5098,4164,,9262,"(10.886611,-74.776708)"
2021,Noviembre,Estados Unidos de América,840,2,4,,6,"(11.117806,-74.232622)"
2021,Noviembre,Estados Unidos de América,840,9102,6520,,15622,"(3.541112,-76.384584)"
2021,Noviembre,Estados Unidos de América,840,878,684,,1562,"(4.452882,-75.766298)"
2021,Noviembre,Estados Unidos de América,840,36670,31141,,67811,"(4.697144,-74.140516)"
2021,Noviembre,Estados Unidos de América,840,2031,1341,,3372,"(4.815061,-75.736532)"
2021,Noviembre,Estados Unidos de América,840,14983,11853,,26836,"(6.171601,-75.427454)"
2021,Noviembre,Estados Unidos de América,840,922,748,,1670,"(7.128456,-73.183637)"
2021,Noviembre,Estados Unidos de América,840,1,0,,1,"(7.927209,-72.507910)"
2021,Noviembre,Estonia,233,0,1,,1,"(10.445761,-75.516429)"
2021,Noviembre,Estonia,233,2,1,,3,"(4.697144,-74.140516)"
2021,Noviembre,Etiopia,231,1,1,,2,"(4.697144,-74.140516)"
2021,Noviembre,Filipinas,608,1,3,,4,"(4.697144,-74.140516)"
2021,Noviembre,Finlandia,246,9,9,,18,"(4.697144,-74.140516)"
2021,Noviembre,Finlandia,246,0,1,,1,"(4.815061,-75.736532)"
2021,Noviembre,Finlandia,246,1,2,,3,"(6.171601,-75.427454)"
2021,Noviembre,Francia,250,15,6,,21,"(10.445761,-75.516429)"
2021,Noviembre,Francia,250,4,4,,8,"(10.886611,-74.776708)"
2021,Noviembre,Francia,250,52,42,,94,"(3.541112,-76.384584)"
2021,Noviembre,Francia,250,1693,1389,,3082,"(4.697144,-74.140516)"
2021,Noviembre,Francia,250,10,9,,19,"(4.815061,-75.736532)"
2021,Noviembre,Francia,250,74,45,,119,"(6.171601,-75.427454)"
2021,Noviembre,Gabón,266,0,2,,2,"(4.697144,-74.140516)"
2021,Noviembre,Gambia,270,1,1,,2,"(4.697144,-74.140516)"
2021,Noviembre,Georgia,268,2,1,,3,"(3.541112,-76.384584)"
2021,Noviembre,Georgia,268,8,12,,20,"(4.697144,-74.140516)"
2021,Noviembre,Georgia,268,1,0,,1,"(4.815061,-75.736532)"
2021,Noviembre,Georgia,268,4,1,,5,"(6.171601,-75.427454)"
2021,Noviembre,Ghana,288,1,4,,5,"(4.697144,-74.140516)"
2021,Noviembre,Granada,308,1,1,,2,"(4.697144,-74.140516)"
2021,Noviembre,Grecia,300,1,0,,1,"(10.445761,-75.516429)"
2021,Noviembre,Grecia,300,9,3,,12,"(4.697144,-74.140516)"
2021,Noviembre,Grecia,300,1,0,,1,"(6.171601,-75.427454)"
2021,Noviembre,Guatemala,320,4,5,,9,"(10.445761,-75.516429)"
2021,Noviembre,Guatemala,320,17,18,,35,"(10.886611,-74.776708)"
2021,Noviembre,Guatemala,320,53,71,,124,"(3.541112,-76.384584)"
2021,Noviembre,Guatemala,320,399,593,,992,"(4.697144,-74.140516)"
2021,Noviembre,Guatemala,320,21,29,,50,"(4.815061,-75.736532)"
2021,Noviembre,Guatemala,320,108,118,,226,"(6.171601,-75.427454)"
2021,Noviembre,Guatemala,320,7,5,,12,"(7.128456,-73.183637)"
2021,Noviembre,Guyana,328,0,3,,3,"(10.445761,-75.516429)"
2021,Noviembre,Guyana,328,2,5,,7,"(10.886611,-74.776708)"
2021,Noviembre,Guyana,328,1,0,,1,"(3.541112,-76.384584)"
2021,Noviembre,Guyana,328,6,19,,25,"(4.697144,-74.140516)"
2021,Noviembre,Guyana,328,1,1,,2,"(4.815061,-75.736532)"
2021,Noviembre,Guyana,328,4,12,,16,"(6.171601,-75.427454)"
2021,Noviembre,Guinea,324,1,0,,1,"(4.697144,-74.140516)"
2021,Noviembre,Guinea Ecuatorial,226,4,0,,4,"(4.697144,-74.140516)"
2021,Noviembre,Guadalupe/Territorio Francés,312,1,4,,5,"(4.697144,-74.140516)"
2021,Noviembre,Guayana Francesa/Departamento de Ultramar Francés,254,3,2,,5,"(4.697144,-74.140516)"
2021,Noviembre,Haití,332,0,9,,9,"(4.697144,-74.140516)"
2021,Noviembre,Haití,332,0,2,,2,"(6.171601,-75.427454)"
2021,Noviembre,Honduras,340,3,8,,11,"(10.445761,-75.516429)"
2021,Noviembre,Honduras,340,4,11,,15,"(10.886611,-74.776708)"
2021,Noviembre,Honduras,340,13,24,,37,"(3.541112,-76.384584)"
2021,Noviembre,Honduras,340,49,129,,178,"(4.697144,-74.140516)"
2021,Noviembre,Honduras,340,1,0,,1,"(4.815061,-75.736532)"
2021,Noviembre,Honduras,340,22,42,,64,"(6.171601,-75.427454)"
2021,Noviembre,Honduras,340,6,11,,17,"(7.128456,-73.183637)"
2021,Noviembre,Hong Kong,344,3,3,,6,"(4.697144,-74.140516)"
2021,Noviembre,Hungría,348,0,1,,1,"(10.445761,-75.516429)"
2021,Noviembre,Hungría,348,8,16,,24,"(4.697144,-74.140516)"
2021,Noviembre,Hungría,348,0,1,,1,"(6.171601,-75.427454)"
2021,Noviembre,India,356,17,10,,27,"(4.697144,-74.140516)"
2021,Noviembre,India,356,1,3,,4,"(6.171601,-75.427454)"
2021,Noviembre,Indonesia,360,1,0,,1,"(3.541112,-76.384584)"
2021,Noviembre,Indonesia,360,2,0,,2,"(4.697144,-74.140516)"
2021,Noviembre,Iraq,368,2,0,,2,"(3.541112,-76.384584)"
2021,Noviembre,Iraq,368,1,4,,5,"(4.697144,-74.140516)"
2021,Noviembre,Iraq,368,0,1,,1,"(6.171601,-75.427454)"
2021,Noviembre,Irán,364,1,7,,8,"(4.697144,-74.140516)"
2021,Noviembre,República de Irlanda,372,0,1,,1,"(10.445761,-75.516429)"
2021,Noviembre,República de Irlanda,372,2,0,,2,"(3.541112,-76.384584)"
2021,Noviembre,República de Irlanda,372,11,8,,19,"(4.697144,-74.140516)"
2021,Noviembre,República de Irlanda,372,2,0,,2,"(6.171601,-75.427454)"
2021,Noviembre,Islandia,352,17,18,,35,"(4.697144,-74.140516)"
2021,Noviembre,Islandia,352,0,1,,1,"(6.171601,-75.427454)"
2021,Noviembre,Israel,376,2,2,,4,"(10.445761,-75.516429)"
2021,Noviembre,Israel,376,2,1,,3,"(10.886611,-74.776708)"
2021,Noviembre,Israel,376,2,4,,6,"(3.541112,-76.384584)"
2021,Noviembre,Israel,376,88,68,,156,"(4.697144,-74.140516)"
2021,Noviembre,Israel,376,0,1,,1,"(6.171601,-75.427454)"
2021,Noviembre,Italia,380,37,23,,60,"(10.445761,-75.516429)"
2021,Noviembre,Italia,380,1,2,,3,"(10.886611,-74.776708)"
2021,Noviembre,Italia,380,61,22,,83,"(3.541112,-76.384584)"
2021,Noviembre,Italia,380,454,326,,780,"(4.697144,-74.140516)"
2021,Noviembre,Italia,380,3,4,,7,"(4.815061,-75.736532)"
2021,Noviembre,Italia,380,40,18,,58,"(6.171601,-75.427454)"
2021,Noviembre,Jamaica,388,0,2,,2,"(10.445761,-75.516429)"
2021,Noviembre,Jamaica,388,2,2,,4,"(10.886611,-74.776708)"
2021,Noviembre,Jamaica,388,2,2,,4,"(11.117806,-74.232622)"
2021,Noviembre,Jamaica,388,12,8,,20,"(3.541112,-76.384584)"
2021,Noviembre,Jamaica,388,25,25,,50,"(4.697144,-74.140516)"
2021,Noviembre,Jamaica,388,6,1,,7,"(6.171601,-75.427454)"
2021,Noviembre,Japón,392,0,1,,1,"(10.445761,-75.516429)"
2021,Noviembre,Japón,392,1,0,,1,"(10.886611,-74.776708)"
2021,Noviembre,Japón,392,1,0,,1,"(3.541112,-76.384584)"
2021,Noviembre,Japón,392,11,9,,20,"(4.697144,-74.140516)"
2021,Noviembre,Jordania,400,1,5,,6,"(4.697144,-74.140516)"
2021,Noviembre,Kazajistán,398,0,5,,5,"(4.697144,-74.140516)"
2021,Noviembre,Kenia,404,0,1,,1,"(10.886611,-74.776708)"
2021,Noviembre,Kenia,404,7,8,,15,"(4.697144,-74.140516)"
2021,Noviembre,Kenia,404,1,0,,1,"(6.171601,-75.427454)"
2021,Noviembre,Kuwait,414,0,5,,5,"(4.697144,-74.140516)"
2021,Noviembre,Lituania,440,0,2,,2,"(4.697144,-74.140516)"
2021,Noviembre,Lituania,440,0,1,,1,"(6.171601,-75.427454)"
2021,Noviembre,Líbano,422,1,0,,1,"(10.886611,-74.776708)"
2021,Noviembre,Líbano,422,1,2,,3,"(3.541112,-76.384584)"
2021,Noviembre,Líbano,422,13,4,,17,"(4.697144,-74.140516)"
2021,Noviembre,Libia,434,0,1,,1,"(6.171601,-75.427454)"
2021,Noviembre,Luxemburgo,442,2,0,,2,"(10.445761,-75.516429)"
2021,Noviembre,Luxemburgo,442,10,6,,16,"(4.697144,-74.140516)"
2021,Noviembre,Macao,446,0,1,,1,"(4.697144,-74.140516)"
2021,Noviembre,Malasia,458,1,0,,1,"(6.171601,-75.427454)"
2021,Noviembre,Maldivas,462,5,3,,8,"(4.697144,-74.140516)"
2021,Noviembre,Malí,466,0,1,,1,"(4.697144,-74.140516)"
2021,Noviembre,Malta,470,0,1,,1,"(10.445761,-75.516429)"
2021,Noviembre,Malta,470,50,54,,104,"(4.697144,-74.140516)"
2021,Noviembre,Marruecos,504,1,0,,1,"(3.541112,-76.384584)"
2021,Noviembre,Marruecos,504,4,2,,6,"(4.697144,-74.140516)"
2021,Noviembre,Mauricio,480,1,1,,2,"(4.697144,-74.140516)"
2021,Noviembre,Mauritania,478,0,1,,1,"(4.697144,-74.140516)"
2021,Noviembre,Martinica/Departamento de Ultramar Francés,474,1,1,,2,"(4.697144,-74.140516)"
2021,Noviembre,México,484,59,52,,111,"(10.445761,-75.516429)"
2021,Noviembre,México,484,203,175,,378,"(10.886611,-74.776708)"
2021,Noviembre,México,484,1468,1272,,2740,"(3.541112,-76.384584)"
2021,Noviembre,México,484,0,7,,7,"(3.893038,-77.067921)"
2021,Noviembre,México,484,19289,17371,,36660,"(4.697144,-74.140516)"
2021,Noviembre,México,484,108,99,,207,"(4.815061,-75.736532)"
2021,Noviembre,México,484,6541,5504,,12045,"(6.171601,-75.427454)"
2021,Noviembre,México,484,97,80,,177,"(7.128456,-73.183637)"
2021,Noviembre,República de Moldavia,498,0,1,,1,"(4.697144,-74.140516)"
2021,Noviembre,Mónaco,492,1,0,,1,"(4.697144,-74.140516)"
2021,Noviembre,Mónaco,492,1,0,,1,"(6.171601,-75.427454)"
2021,Noviembre,Montenegro,499,0,2,,2,"(4.697144,-74.140516)"
2021,Noviembre,Montserrat/Territorio Británico de Ultramar,500,1,0,,1,"(4.697144,-74.140516)"
2021,Noviembre,Nauru,520,1,0,,1,"(4.697144,-74.140516)"
2021,Noviembre,Nepal,524,0,1,,1,"(4.697144,-74.140516)"
2021,Noviembre,Nicaragua,558,2,1,,3,"(10.886611,-74.776708)"
2021,Noviembre,Nicaragua,558,4,6,,10,"(3.541112,-76.384584)"
2021,Noviembre,Nicaragua,558,20,77,,97,"(4.697144,-74.140516)"
2021,Noviembre,Nicaragua,558,10,20,,30,"(6.171601,-75.427454)"
2021,Noviembre,Nigeria,566,0,2,,2,"(4.697144,-74.140516)"
2021,Noviembre,Noruega,578,5,0,,5,"(10.445761,-75.516429)"
2021,Noviembre,Noruega,578,1,0,,1,"(10.886611,-74.776708)"
2021,Noviembre,Noruega,578,9,3,,12,"(3.541112,-76.384584)"
2021,Noviembre,Noruega,578,27,17,,44,"(4.697144,-74.140516)"
2021,Noviembre,Noruega,578,6,2,,8,"(6.171601,-75.427454)"
2021,Noviembre,Nueva Caledonia/Territorio francés,540,1,0,,1,"(6.171601,-75.427454)"
2021,Noviembre,Nueva Zelanda,554,2,1,,3,"(4.697144,-74.140516)"
2021,Noviembre,Nueva Zelanda,554,0,1,,1,"(6.171601,-75.427454)"
2021,Noviembre,Omán,512,1,4,,5,"(4.697144,-74.140516)"
2021,Noviembre,Omán,512,1,0,,1,"(6.171601,-75.427454)"
2021,Noviembre,Papúa Nueva Guinea,598,0,1,,1,"(6.171601,-75.427454)"
2021,Noviembre,Pakistán,586,0,2,,2,"(4.697144,-74.140516)"
2021,Noviembre,Panamá,591,18,64,,82,"(10.408582,-75.538003)"
2021,Noviembre,Panamá,591,863,653,,1516,"(10.445761,-75.516429)"
2021,Noviembre,Panamá,591,584,565,,1149,"(10.886611,-74.776708)"
2021,Noviembre,Panamá,591,2,8,,10,"(10.971302,-74.765397)"
2021,Noviembre,Panamá,591,1650,1387,,3037,"(3.541112,-76.384584)"
2021,Noviembre,Panamá,591,0,3,,3,"(3.893038,-77.067921)"
2021,Noviembre,Panamá,591,4750,4850,,9600,"(4.697144,-74.140516)"
2021,Noviembre,Panamá,591,393,267,,660,"(4.815061,-75.736532)"
2021,Noviembre,Panamá,591,0,2,,2,"(6.17134,-75.427194)"
2021,Noviembre,Panamá,591,1810,1585,,3395,"(6.171601,-75.427454)"
2021,Noviembre,Panamá,591,10,20,,30,"(7.102626,-77.762647)"
2021,Noviembre,Panamá,591,94,79,,173,"(7.128456,-73.183637)"
2021,Noviembre,Panamá,591,5,1,,6,"(7.927209,-72.507910)"
2021,Noviembre,Panamá,591,47,88,,135,"(8.635765,-77.346578)"
2021,Noviembre,Paraguay,600,2,0,,2,"(10.445761,-75.516429)"
2021,Noviembre,Paraguay,600,1,6,,7,"(10.886611,-74.776708)"
2021,Noviembre,Paraguay,600,36,30,,66,"(3.541112,-76.384584)"
2021,Noviembre,Paraguay,600,151,266,,417,"(4.697144,-74.140516)"
2021,Noviembre,Paraguay,600,6,4,,10,"(4.815061,-75.736532)"
2021,Noviembre,Paraguay,600,12,20,,32,"(6.171601,-75.427454)"
2021,Noviembre,Paraguay,600,1,0,,1,"(7.128456,-73.183637)"
2021,Noviembre,Perú,604,9,16,,25,"(-4.197703,-69.941278)"
2021,Noviembre,Perú,604,1,0,,1,"(10.445761,-75.516429)"
2021,Noviembre,Perú,604,38,48,,86,"(10.886611,-74.776708)"
2021,Noviembre,Perú,604,90,130,,220,"(3.541112,-76.384584)"
2021,Noviembre,Perú,604,3140,3628,,6768,"(4.697144,-74.140516)"
2021,Noviembre,Perú,604,19,16,,35,"(4.815061,-75.736532)"
2021,Noviembre,Perú,604,0,1,,1,"(6.17134,-75.427194)"
2021,Noviembre,Perú,604,791,671,,1462,"(6.171601,-75.427454)"
2021,Noviembre,Perú,604,7,4,,11,"(7.128456,-73.183637)"
2021,Noviembre,Polonia,616,14,14,,28,"(4.697144,-74.140516)"
2021,Noviembre,Polonia,616,2,1,,3,"(6.171601,-75.427454)"
2021,Noviembre,Portugal,620,7,4,,11,"(10.445761,-75.516429)"
2021,Noviembre,Portugal,620,2,2,,4,"(10.886611,-74.776708)"
2021,Noviembre,Portugal,620,10,3,,13,"(3.541112,-76.384584)"
2021,Noviembre,Portugal,620,89,82,,171,"(4.697144,-74.140516)"
2021,Noviembre,Portugal,620,15,19,,34,"(6.171601,-75.427454)"
2021,Noviembre,Puerto Rico/Territorio de Estados Unidos,630,3,5,,8,"(10.445761,-75.516429)"
2021,Noviembre,Puerto Rico/Territorio de Estados Unidos,630,8,8,,16,"(10.886611,-74.776708)"
2021,Noviembre,Puerto Rico/Territorio de Estados Unidos,630,33,27,,60,"(3.541112,-76.384584)"
2021,Noviembre,Puerto Rico/Territorio de Estados Unidos,630,461,400,,861,"(4.697144,-74.140516)"
2021,Noviembre,Puerto Rico/Territorio de Estados Unidos,630,11,5,,16,"(4.815061,-75.736532)"
2021,Noviembre,Puerto Rico/Territorio de Estados Unidos,630,51,38,,89,"(6.171601,-75.427454)"
2021,Noviembre,Puerto Rico/Territorio de Estados Unidos,630,2,3,,5,"(7.128456,-73.183637)"
2021,Noviembre,Qatar,634,0,1,,1,"(10.886611,-74.776708)"
2021,Noviembre,Qatar,634,17,19,,36,"(4.697144,-74.140516)"
2021,Noviembre,Qatar,634,1,0,,1,"(4.815061,-75.736532)"
2021,Noviembre,Qatar,634,5,7,,12,"(6.171601,-75.427454)"
2021,Noviembre,Reino Unido de Gran Bretaña e Irlanda del Norte,826,2,1,,3,"(10.445761,-75.516429)"
2021,Noviembre,Reino Unido de Gran Bretaña e Irlanda del Norte,826,2,0,,2,"(10.886611,-74.776708)"
2021,Noviembre,Reino Unido de Gran Bretaña e Irlanda del Norte,826,13,12,,25,"(3.541112,-76.384584)"
2021,Noviembre,Reino Unido de Gran Bretaña e Irlanda del Norte,826,1,0,,1,"(4.452882,-75.766298)"
2021,Noviembre,Reino Unido de Gran Bretaña e Irlanda del Norte,826,185,134,,319,"(4.697144,-74.140516)"
2021,Noviembre,Reino Unido de Gran Bretaña e Irlanda del Norte,826,1,0,,1,"(4.815061,-75.736532)"
2021,Noviembre,Reino Unido de Gran Bretaña e Irlanda del Norte,826,13,9,,22,"(6.171601,-75.427454)"
2021,Noviembre,República CentroÁfricana,140,2,1,,3,"(4.697144,-74.140516)"
2021,Noviembre,Federación de Rusia,643,3,1,,4,"(10.445761,-75.516429)"
2021,Noviembre,Federación de Rusia,643,0,1,,1,"(10.886611,-74.776708)"
2021,Noviembre,Federación de Rusia,643,124,109,,233,"(4.697144,-74.140516)"
2021,Noviembre,Federación de Rusia,643,0,3,,3,"(6.171601,-75.427454)"
2021,Noviembre,República Dominicana,214,2,5,,7,"(10.408582,-75.538003)"
2021,Noviembre,República Dominicana,214,6,10,,16,"(10.445761,-75.516429)"
2021,Noviembre,República Dominicana,214,44,56,,100,"(10.886611,-74.776708)"
2021,Noviembre,República Dominicana,214,290,227,,517,"(3.541112,-76.384584)"
2021,Noviembre,República Dominicana,214,5183,4429,,9612,"(4.697144,-74.140516)"
2021,Noviembre,República Dominicana,214,12,12,,24,"(4.815061,-75.736532)"
2021,Noviembre,República Dominicana,214,2484,1876,,4360,"(6.171601,-75.427454)"
2021,Noviembre,República Dominicana,214,55,38,,93,"(7.128456,-73.183637)"
2021,Noviembre,Reunión,638,1,0,,1,"(4.697144,-74.140516)"
2021,Noviembre,Rumania,642,3,0,,3,"(10.445761,-75.516429)"
2021,Noviembre,Rumania,642,1,0,,1,"(10.886611,-74.776708)"
2021,Noviembre,Rumania,642,2,19,,21,"(4.697144,-74.140516)"
2021,Noviembre,Rumania,642,1,1,,2,"(6.171601,-75.427454)"
2021,Noviembre,Rwanda,646,1,2,,3,"(4.697144,-74.140516)"
2021,Noviembre,San Cristóbal y Nevis,659,2,0,,2,"(10.886611,-74.776708)"
2021,Noviembre,San Cristóbal y Nevis,659,1,1,,2,"(6.171601,-75.427454)"
2021,Noviembre,San Cristóbal y Nevis,659,2,0,,2,"(7.818934,-72.453226)"
2021,Noviembre,San  Vicente y las Granadinas,670,0,1,,1,"(6.171601,-75.427454)"
2021,Noviembre,Santa Elena/Territorio Británico de Ultramar,654,1,0,,1,"(4.697144,-74.140516)"
2021,Noviembre,Santa Lucia,662,1,0,,1,"(3.541112,-76.384584)"
2021,Noviembre,Santa Lucia,662,1,1,,2,"(4.697144,-74.140516)"
2021,Noviembre,Santa Sede/Ciudad del Vaticano,336,1,1,,2,"(4.697144,-74.140516)"
2021,Noviembre,Senegal,686,0,1,,1,"(3.541112,-76.384584)"
2021,Noviembre,Senegal,686,0,1,,1,"(4.697144,-74.140516)"
2021,Noviembre,Serbia,688,2,2,,4,"(4.697144,-74.140516)"
2021,Noviembre,Singapur,702,0,1,,1,"(3.541112,-76.384584)"
2021,Noviembre,Singapur,702,3,2,,5,"(4.697144,-74.140516)"
2021,Noviembre,Somalia,706,1,0,,1,"(4.697144,-74.140516)"
2021,Noviembre,Sri Lanka,144,2,0,,2,"(4.697144,-74.140516)"
2021,Noviembre,Sudáfrica,710,2,6,,8,"(4.697144,-74.140516)"
2021,Noviembre,Sudáfrica,710,0,1,,1,"(6.171601,-75.427454)"
2021,Noviembre,Sudán,736,1,1,,2,"(4.697144,-74.140516)"
2021,Noviembre,Suecia,752,7,3,,10,"(10.445761,-75.516429)"
2021,Noviembre,Suecia,752,1,0,,1,"(10.886611,-74.776708)"
2021,Noviembre,Suecia,752,25,15,,40,"(3.541112,-76.384584)"
2021,Noviembre,Suecia,752,72,57,,129,"(4.697144,-74.140516)"
2021,Noviembre,Suecia,752,6,2,,8,"(4.815061,-75.736532)"
2021,Noviembre,Suecia,752,15,13,,28,"(6.171601,-75.427454)"
2021,Noviembre,Suiza,756,16,13,,29,"(10.445761,-75.516429)"
2021,Noviembre,Suiza,756,4,5,,9,"(10.886611,-74.776708)"
2021,Noviembre,Suiza,756,33,17,,50,"(3.541112,-76.384584)"
2021,Noviembre,Suiza,756,339,200,,539,"(4.697144,-74.140516)"
2021,Noviembre,Suiza,756,10,6,,16,"(4.815061,-75.736532)"
2021,Noviembre,Suiza,756,26,22,,48,"(6.171601,-75.427454)"
2021,Noviembre,Surinam,740,0,1,,1,"(10.886611,-74.776708)"
2021,Noviembre,Surinam,740,1,6,,7,"(4.697144,-74.140516)"
2021,Noviembre,Surinam,740,1,2,,3,"(6.171601,-75.427454)"
2021,Noviembre,Taiwán,158,2,4,,6,"(4.697144,-74.140516)"
2021,Noviembre,República de Tayikistán,762,0,1,,1,"(4.697144,-74.140516)"
2021,Noviembre,Tailandia,764,1,2,,3,"(3.541112,-76.384584)"
2021,Noviembre,Tailandia,764,9,11,,20,"(4.697144,-74.140516)"
2021,Noviembre,Tailandia,764,0,2,,2,"(6.171601,-75.427454)"
2021,Noviembre,Territorio Británico del Océano Índico/Territorios Británicos de Ultramar,86,1,0,,1,"(3.541112,-76.384584)"
2021,Noviembre,Tanzania,834,4,5,,9,"(4.697144,-74.140516)"
2021,Noviembre,Trinidad y Tobago,780,0,1,,1,"(10.445761,-75.516429)"
2021,Noviembre,Trinidad y Tobago,780,0,1,,1,"(10.886611,-74.776708)"
2021,Noviembre,Trinidad y Tobago,780,2,1,,3,"(3.541112,-76.384584)"
2021,Noviembre,Trinidad y Tobago,780,7,24,,31,"(4.697144,-74.140516)"
2021,Noviembre,Trinidad y Tobago,780,1,2,,3,"(4.815061,-75.736532)"
2021,Noviembre,Trinidad y Tobago,780,3,1,,4,"(6.171601,-75.427454)"
2021,Noviembre,Trinidad y Tobago,780,1,1,,2,"(7.128456,-73.183637)"
2021,Noviembre,Túnez,788,0,2,,2,"(4.697144,-74.140516)"
2021,Noviembre,Turquía,792,5,2,,7,"(10.445761,-75.516429)"
2021,Noviembre,Turquía,792,0,1,,1,"(10.886611,-74.776708)"
2021,Noviembre,Turquía,792,1,0,,1,"(3.541112,-76.384584)"
2021,Noviembre,Turquía,792,1101,877,,1978,"(4.697144,-74.140516)"
2021,Noviembre,Turquía,792,9,10,,19,"(6.171601,-75.427454)"
2021,Noviembre,Turkmenistán,795,3,2,,5,"(4.697144,-74.140516)"
2021,Noviembre,Ucrania,804,1,1,,2,"(10.445761,-75.516429)"
2021,Noviembre,Ucrania,804,28,28,,56,"(4.697144,-74.140516)"
2021,Noviembre,Ucrania,804,2,0,,2,"(6.171601,-75.427454)"
2021,Noviembre,Uganda,800,1,1,,2,"(4.697144,-74.140516)"
2021,Noviembre,Uruguay,858,3,2,,5,"(10.445761,-75.516429)"
2021,Noviembre,Uruguay,858,3,2,,5,"(10.886611,-74.776708)"
2021,Noviembre,Uruguay,858,20,22,,42,"(3.541112,-76.384584)"
2021,Noviembre,Uruguay,858,125,124,,249,"(4.697144,-74.140516)"
2021,Noviembre,Uruguay,858,10,10,,20,"(4.815061,-75.736532)"
2021,Noviembre,Uruguay,858,51,40,,91,"(6.171601,-75.427454)"
2021,Noviembre,Uruguay,858,1,0,,1,"(7.128456,-73.183637)"
2021,Noviembre,Uzbekistán,860,0,1,,1,"(4.697144,-74.140516)"
2021,Noviembre,Vanuatu,548,0,1,,1,"(4.697144,-74.140516)"
2021,Noviembre,Venezuela,862,3,4,,7,"(10.445761,-75.516429)"
2021,Noviembre,Venezuela,862,26,27,,53,"(10.886611,-74.776708)"
2021,Noviembre,Venezuela,862,83,216,,299,"(11.360009,-72.129330)"
2021,Noviembre,Venezuela,862,24,20,,44,"(3.541112,-76.384584)"
2021,Noviembre,Venezuela,862,0,2,,2,"(3.866713,-67.927521)"
2021,Noviembre,Venezuela,862,137,264,,401,"(4.697144,-74.140516)"
2021,Noviembre,Venezuela,862,0,1,,1,"(4.815061,-75.736532)"
2021,Noviembre,Venezuela,862,46,54,,100,"(6.171601,-75.427454)"
2021,Noviembre,Venezuela,862,2,3,,5,"(6.185799,-67.483929)"
2021,Noviembre,Venezuela,862,6,9,,15,"(7.088729,-70.740253)"
2021,Noviembre,Venezuela,862,12,6,,18,"(7.128456,-73.183637)"
2021,Noviembre,Venezuela,862,128,177,,305,"(7.818934,-72.453226)"
2021,Noviembre,Venezuela,862,14,17,,31,"(7.916725,-72.462544)"
2021,Noviembre,Venezuela,862,5,11,,16,"(8.36068,-72.409396)"
2021,Noviembre,Vietnam,704,0,1,,1,"(3.541112,-76.384584)"
2021,Noviembre,Islas Vírgenes Británicas/Territorio Británico de Ultramar,92,1,1,,2,"(4.697144,-74.140516)"
2021,Noviembre,Zambia,894,0,1,,1,"(4.697144,-74.140516)"
2021,Noviembre,Zimbabue,716,0,1,,1,"(4.697144,-74.140516)"
2021,Noviembre,Islas Turcas y Caicos/Territorio Británico de Ultramar,796,1,4,,5,"(10.445761,-75.516429)"
2021,Noviembre,Islas Turcas y Caicos/Territorio Británico de Ultramar,796,0,1,,1,"(3.541112,-76.384584)"
2021,Noviembre,Islas Turcas y Caicos/Territorio Británico de Ultramar,796,1,1,,2,"(4.697144,-74.140516)"
2021,Noviembre,Desconocido,99999,2,1,,3,"(4.697144,-74.140516)"
2021,Diciembre,Afganistán,4,0,4,,4,"(10.408582,-75.538003)"
2021,Diciembre,Albania,8,2,3,,5,"(4.697144,-74.140516)"
2021,Diciembre,Alemania,276,50,22,,72,"(10.445761,-75.516429)"
2021,Diciembre,Alemania,276,10,9,,19,"(10.886611,-74.776708)"
2021,Diciembre,Alemania,276,57,41,,98,"(3.541112,-76.384584)"
2021,Diciembre,Alemania,276,1356,867,,2223,"(4.697144,-74.140516)"
2021,Diciembre,Alemania,276,3,2,,5,"(4.815061,-75.736532)"
2021,Diciembre,Alemania,276,96,61,,157,"(6.171601,-75.427454)"
2021,Diciembre,Alemania,276,1,2,,3,"(7.128456,-73.183637)"
2021,Diciembre,Andorra,20,13,12,,25,"(4.697144,-74.140516)"
2021,Diciembre,Andorra,20,2,1,,3,"(6.171601,-75.427454)"
2021,Diciembre,Angola,24,0,2,,2,"(4.697144,-74.140516)"
2021,Diciembre,Antigua y Barbuda,28,0,1,,1,"(10.886611,-74.776708)"
2021,Diciembre,Antigua y Barbuda,28,0,1,,1,"(3.541112,-76.384584)"
2021,Diciembre,Antigua y Barbuda,28,2,0,,2,"(4.697144,-74.140516)"
2021,Diciembre,Países Bajos,528,133,71,,204,"(10.445761,-75.516429)"
2021,Diciembre,Países Bajos,528,15,10,,25,"(10.886611,-74.776708)"
2021,Diciembre,Países Bajos,528,82,52,,134,"(3.541112,-76.384584)"
2021,Diciembre,Países Bajos,528,972,734,,1706,"(4.697144,-74.140516)"
2021,Diciembre,Países Bajos,528,4,3,,7,"(4.815061,-75.736532)"
2021,Diciembre,Países Bajos,528,94,40,,134,"(6.171601,-75.427454)"
2021,Diciembre,Arabia Saudita,682,0,1,,1,"(10.408582,-75.538003)"
2021,Diciembre,Arabia Saudita,682,1,1,,2,"(10.445761,-75.516429)"
2021,Diciembre,Arabia Saudita,682,0,1,,1,"(10.886611,-74.776708)"
2021,Diciembre,Arabia Saudita,682,11,19,,30,"(4.697144,-74.140516)"
2021,Diciembre,Arabia Saudita,682,1,0,,1,"(6.171601,-75.427454)"
2021,Diciembre,Argelia,12,3,3,,6,"(4.697144,-74.140516)"
2021,Diciembre,Argentina,32,6,14,,20,"(0.814836,-77.662532)"
2021,Diciembre,Argentina,32,7,6,,13,"(10.445761,-75.516429)"
2021,Diciembre,Argentina,32,7,5,,12,"(10.886611,-74.776708)"
2021,Diciembre,Argentina,32,54,43,,97,"(3.541112,-76.384584)"
2021,Diciembre,Argentina,32,0,2,,2,"(4.452882,-75.766298)"
2021,Diciembre,Argentina,32,2507,1934,,4441,"(4.697144,-74.140516)"
2021,Diciembre,Argentina,32,5,4,,9,"(4.815061,-75.736532)"
2021,Diciembre,Argentina,32,68,52,,120,"(6.171601,-75.427454)"
2021,Diciembre,Argentina,32,1,0,,1,"(7.128456,-73.183637)"
2021,Diciembre,Argentina,32,2,1,,3,"(7.927209,-72.507910)"
2021,Diciembre,Aruba,533,6,1,,7,"(10.445761,-75.516429)"
2021,Diciembre,Aruba,533,44,37,,81,"(10.886611,-74.776708)"
2021,Diciembre,Aruba,533,93,64,,157,"(3.541112,-76.384584)"
2021,Diciembre,Aruba,533,1,1,,2,"(4.452882,-75.766298)"
2021,Diciembre,Aruba,533,2275,1775,,4050,"(4.697144,-74.140516)"
2021,Diciembre,Aruba,533,14,7,,21,"(4.815061,-75.736532)"
2021,Diciembre,Aruba,533,69,66,,135,"(6.171601,-75.427454)"
2021,Diciembre,Aruba,533,27,47,,74,"(7.128456,-73.183637)"
2021,Diciembre,Aruba,533,0,1,,1,"(7.927209,-72.507910)"
2021,Diciembre,Australia,36,1,1,,2,"(10.445761,-75.516429)"
2021,Diciembre,Australia,36,1,1,,2,"(10.886611,-74.776708)"
2021,Diciembre,Australia,36,1,4,,5,"(3.541112,-76.384584)"
2021,Diciembre,Australia,36,102,63,,165,"(4.697144,-74.140516)"
2021,Diciembre,Australia,36,1,1,,2,"(4.815061,-75.736532)"
2021,Diciembre,Australia,36,8,5,,13,"(6.171601,-75.427454)"
2021,Diciembre,Australia,36,1,0,,1,"(7.128456,-73.183637)"
2021,Diciembre,Austria,40,1,0,,1,"(10.445761,-75.516429)"
2021,Diciembre,Austria,40,4,1,,5,"(3.541112,-76.384584)"
2021,Diciembre,Austria,40,87,55,,142,"(4.697144,-74.140516)"
2021,Diciembre,Austria,40,9,1,,10,"(6.171601,-75.427454)"
2021,Diciembre,Azerbaiyán,31,2,1,,3,"(4.697144,-74.140516)"
2021,Diciembre,Bahamas,44,3,2,,5,"(10.445761,-75.516429)"
2021,Diciembre,Bahamas,44,0,1,,1,"(10.886611,-74.776708)"
2021,Diciembre,Bahamas,44,31,11,,42,"(3.541112,-76.384584)"
2021,Diciembre,Bahamas,44,41,36,,77,"(4.697144,-74.140516)"
2021,Diciembre,Bahamas,44,3,3,,6,"(4.815061,-75.736532)"
2021,Diciembre,Bahamas,44,3,6,,9,"(6.17134,-75.427194)"
2021,Diciembre,Bahamas,44,35,15,,50,"(6.171601,-75.427454)"
2021,Diciembre,Bahamas,44,1,0,,1,"(7.927209,-72.507910)"
2021,Diciembre,Bahréin,48,15,23,,38,"(4.697144,-74.140516)"
2021,Diciembre,Bahréin,48,0,1,,1,"(4.815061,-75.736532)"
2021,Diciembre,Bahréin,48,1,0,,1,"(6.171601,-75.427454)"
2021,Diciembre,Barbados,52,1,1,,2,"(3.541112,-76.384584)"
2021,Diciembre,Barbados,52,82,77,,159,"(4.697144,-74.140516)"
2021,Diciembre,Barbados,52,2,2,,4,"(6.171601,-75.427454)"
2021,Diciembre,Barbados,52,0,1,,1,"(7.927209,-72.507910)"
2021,Diciembre,República de Belarús,112,0,2,,2,"(4.697144,-74.140516)"
2021,Diciembre,Bélgica,56,17,4,,21,"(10.445761,-75.516429)"
2021,Diciembre,Bélgica,56,2,1,,3,"(10.886611,-74.776708)"
2021,Diciembre,Bélgica,56,30,27,,57,"(3.541112,-76.384584)"
2021,Diciembre,Bélgica,56,155,92,,247,"(4.697144,-74.140516)"
2021,Diciembre,Bélgica,56,2,3,,5,"(4.815061,-75.736532)"
2021,Diciembre,Bélgica,56,47,29,,76,"(6.171601,-75.427454)"
2021,Diciembre,Belice,84,4,4,,8,"(3.541112,-76.384584)"
2021,Diciembre,Belice,84,11,8,,19,"(4.697144,-74.140516)"
2021,Diciembre,Belice,84,5,4,,9,"(6.171601,-75.427454)"
2021,Diciembre,Bermudas/Territorio Británico de Ultramar,60,2,0,,2,"(4.697144,-74.140516)"
2021,Diciembre,Bermudas/Territorio Británico de Ultramar,60,1,1,,2,"(4.815061,-75.736532)"
2021,Diciembre,Bolivia,68,2,1,,3,"(0.814836,-77.662532)"
2021,Diciembre,Bolivia,68,0,1,,1,"(10.886611,-74.776708)"
2021,Diciembre,Bolivia,68,2,2,,4,"(3.541112,-76.384584)"
2021,Diciembre,Bolivia,68,1,1,,2,"(4.452882,-75.766298)"
2021,Diciembre,Bolivia,68,308,359,,667,"(4.697144,-74.140516)"
2021,Diciembre,Bolivia,68,1,1,,2,"(4.815061,-75.736532)"
2021,Diciembre,Bolivia,68,6,13,,19,"(6.171601,-75.427454)"
2021,Diciembre,Bolivia,68,1,0,,1,"(7.128456,-73.183637)"
2021,Diciembre,Bosnia y Herzegovina,70,2,2,,4,"(4.697144,-74.140516)"
2021,Diciembre,Brasil,76,128,168,,296,"(-4.197703,-69.941278)"
2021,Diciembre,Brasil,76,16,21,,37,"(10.445761,-75.516429)"
2021,Diciembre,Brasil,76,16,14,,30,"(10.886611,-74.776708)"
2021,Diciembre,Brasil,76,93,95,,188,"(3.541112,-76.384584)"
2021,Diciembre,Brasil,76,7,15,,22,"(4.452882,-75.766298)"
2021,Diciembre,Brasil,76,2698,2708,,5406,"(4.697144,-74.140516)"
2021,Diciembre,Brasil,76,46,30,,76,"(4.815061,-75.736532)"
2021,Diciembre,Brasil,76,135,139,,274,"(6.171601,-75.427454)"
2021,Diciembre,Brasil,76,8,6,,14,"(7.128456,-73.183637)"
2021,Diciembre,Brasil,76,2,2,,4,"(7.927209,-72.507910)"
2021,Diciembre,Brunei Darussalam,96,0,1,,1,"(4.697144,-74.140516)"
2021,Diciembre,Bulgaria,100,0,1,,1,"(10.886611,-74.776708)"
2021,Diciembre,Bulgaria,100,3,4,,7,"(4.697144,-74.140516)"
2021,Diciembre,Bulgaria,100,2,0,,2,"(6.171601,-75.427454)"
2021,Diciembre,Burkina Faso,854,0,2,,2,"(4.697144,-74.140516)"
2021,Diciembre,Islas Caimán/Territorio Británico de Ultramar,136,1,0,,1,"(10.445761,-75.516429)"
2021,Diciembre,Islas Caimán/Territorio Británico de Ultramar,136,1,1,,2,"(10.886611,-74.776708)"
2021,Diciembre,Islas Caimán/Territorio Británico de Ultramar,136,1,0,,1,"(12.586067,-81.702563)"
2021,Diciembre,Islas Caimán/Territorio Británico de Ultramar,136,1,0,,1,"(3.541112,-76.384584)"
2021,Diciembre,Islas Caimán/Territorio Británico de Ultramar,136,1,3,,4,"(4.697144,-74.140516)"
2021,Diciembre,Islas Caimán/Territorio Británico de Ultramar,136,0,1,,1,"(6.171601,-75.427454)"
2021,Diciembre,Camboya,116,1,2,,3,"(4.697144,-74.140516)"
2021,Diciembre,Camerún,120,6,6,,12,"(4.697144,-74.140516)"
2021,Diciembre,Canadá,124,129,103,,232,"(10.445761,-75.516429)"
2021,Diciembre,Canadá,124,41,28,,69,"(10.886611,-74.776708)"
2021,Diciembre,Canadá,124,137,103,,240,"(3.541112,-76.384584)"
2021,Diciembre,Canadá,124,6,3,,9,"(4.452882,-75.766298)"
2021,Diciembre,Canadá,124,2975,2399,,5374,"(4.697144,-74.140516)"
2021,Diciembre,Canadá,124,14,13,,27,"(4.815061,-75.736532)"
2021,Diciembre,Canadá,124,261,203,,464,"(6.171601,-75.427454)"
2021,Diciembre,Canadá,124,9,3,,12,"(7.128456,-73.183637)"
2021,Diciembre,Canadá,124,1,0,,1,"(7.927209,-72.507910)"
2021,Diciembre,Chad,148,0,1,,1,"(6.171601,-75.427454)"
2021,Diciembre,España,724,2,1,,3,"(0.814836,-77.662532)"
2021,Diciembre,España,724,86,53,,139,"(10.445761,-75.516429)"
2021,Diciembre,España,724,67,37,,104,"(10.886611,-74.776708)"
2021,Diciembre,España,724,2644,1914,,4558,"(3.541112,-76.384584)"
2021,Diciembre,España,724,18174,13491,,31665,"(4.697144,-74.140516)"
2021,Diciembre,España,724,54,51,,105,"(4.815061,-75.736532)"
2021,Diciembre,España,724,1855,1274,,3129,"(6.171601,-75.427454)"
2021,Diciembre,España,724,9,8,,17,"(7.128456,-73.183637)"
2021,Diciembre,Norfolk,574,1,1,,2,"(4.815061,-75.736532)"
2021,Diciembre,Colombia,170,57,121,,178,"(4.697144,-74.140516)"
2021,Diciembre,Comoras,174,0,1,,1,"(0.814836,-77.662532)"
2021,Diciembre,Comoras,174,1,0,,1,"(4.697144,-74.140516)"
2021,Diciembre,República Democrática del Congo,180,2,2,,4,"(4.697144,-74.140516)"
2021,Diciembre,República de Corea,410,4,3,,7,"(4.697144,-74.140516)"
2021,Diciembre,Islas Malvinas,238,1,1,,2,"(3.541112,-76.384584)"
2021,Diciembre,Costa de Marfil,384,2,1,,3,"(4.697144,-74.140516)"
2021,Diciembre,Costa de Marfil,384,0,1,,1,"(6.171601,-75.427454)"
2021,Diciembre,Costa Rica,188,12,11,,23,"(10.445761,-75.516429)"
2021,Diciembre,Costa Rica,188,13,20,,33,"(10.886611,-74.776708)"
2021,Diciembre,Costa Rica,188,1,8,,9,"(12.5744111,-81.703935)"
2021,Diciembre,Costa Rica,188,81,87,,168,"(3.541112,-76.384584)"
2021,Diciembre,Costa Rica,188,1,2,,3,"(4.452882,-75.766298)"
2021,Diciembre,Costa Rica,188,1198,1062,,2260,"(4.697144,-74.140516)"
2021,Diciembre,Costa Rica,188,25,13,,38,"(4.815061,-75.736532)"
2021,Diciembre,Costa Rica,188,211,149,,360,"(6.171601,-75.427454)"
2021,Diciembre,Costa Rica,188,9,4,,13,"(7.128456,-73.183637)"
2021,Diciembre,Costa Rica,188,1,0,,1,"(7.927209,-72.507910)"
2021,Diciembre,Croacia,191,9,7,,16,"(4.697144,-74.140516)"
2021,Diciembre,Croacia,191,2,0,,2,"(6.171601,-75.427454)"
2021,Diciembre,Cuba,192,1,0,,1,"(10.445761,-75.516429)"
2021,Diciembre,Cuba,192,1,34,,35,"(10.886611,-74.776708)"
2021,Diciembre,Cuba,192,4,3,,7,"(3.541112,-76.384584)"
2021,Diciembre,Cuba,192,312,305,,617,"(4.697144,-74.140516)"
2021,Diciembre,Cuba,192,3,2,,5,"(4.815061,-75.736532)"
2021,Diciembre,Cuba,192,8,8,,16,"(6.171601,-75.427454)"
2021,Diciembre,Curazao,99999,47,24,,71,"(10.886611,-74.776708)"
2021,Diciembre,Curazao,99999,31,27,,58,"(3.541112,-76.384584)"
2021,Diciembre,Curazao,99999,1382,1140,,2522,"(4.697144,-74.140516)"
2021,Diciembre,Curazao,99999,14,9,,23,"(4.815061,-75.736532)"
2021,Diciembre,Curazao,99999,64,46,,110,"(6.171601,-75.427454)"
2021,Diciembre,Curazao,99999,1,0,,1,"(7.927209,-72.507910)"
2021,Diciembre,República Checa,203,1,0,,1,"(10.445761,-75.516429)"
2021,Diciembre,República Checa,203,1,0,,1,"(10.886611,-74.776708)"
2021,Diciembre,República Checa,203,2,0,,2,"(3.541112,-76.384584)"
2021,Diciembre,República Checa,203,22,13,,35,"(4.697144,-74.140516)"
2021,Diciembre,Chile,152,0,3,,3,"(-4.197703,-69.941278)"
2021,Diciembre,Chile,152,5,15,,20,"(0.814836,-77.662532)"
2021,Diciembre,Chile,152,10,9,,19,"(10.445761,-75.516429)"
2021,Diciembre,Chile,152,36,25,,61,"(10.886611,-74.776708)"
2021,Diciembre,Chile,152,2829,2028,,4857,"(3.541112,-76.384584)"
2021,Diciembre,Chile,152,20,11,,31,"(4.452882,-75.766298)"
2021,Diciembre,Chile,152,5806,4142,,9948,"(4.697144,-74.140516)"
2021,Diciembre,Chile,152,21,14,,35,"(4.815061,-75.736532)"
2021,Diciembre,Chile,152,577,442,,1019,"(6.171601,-75.427454)"
2021,Diciembre,Chile,152,8,6,,14,"(7.128456,-73.183637)"
2021,Diciembre,Chile,152,6,4,,10,"(7.927209,-72.507910)"
2021,Diciembre,China,156,2,5,,7,"(4.697144,-74.140516)"
2021,Diciembre,China,156,0,1,,1,"(6.171601,-75.427454)"
2021,Diciembre,Chipre,196,3,0,,3,"(4.697144,-74.140516)"
2021,Diciembre,Chipre,196,3,2,,5,"(6.171601,-75.427454)"
2021,Diciembre,Dinamarca,208,5,1,,6,"(10.445761,-75.516429)"
2021,Diciembre,Dinamarca,208,1,1,,2,"(10.886611,-74.776708)"
2021,Diciembre,Dinamarca,208,9,3,,12,"(3.541112,-76.384584)"
2021,Diciembre,Dinamarca,208,40,24,,64,"(4.697144,-74.140516)"
2021,Diciembre,Dinamarca,208,10,5,,15,"(6.171601,-75.427454)"
2021,Diciembre,Dominica,212,3,1,,4,"(10.445761,-75.516429)"
2021,Diciembre,Dominica,212,6,7,,13,"(4.697144,-74.140516)"
2021,Diciembre,Dominica,212,1,2,,3,"(6.171601,-75.427454)"
2021,Diciembre,Dominica,212,1,0,,1,"(7.927209,-72.507910)"
2021,Diciembre,Ecuador,218,0,9,,9,"(0.25129,-76.875963)"
2021,Diciembre,Ecuador,218,769,925,,1694,"(0.814836,-77.662532)"
2021,Diciembre,Ecuador,218,1,0,,1,"(1.813928,-78.763924)"
2021,Diciembre,Ecuador,218,2,3,,5,"(10.445761,-75.516429)"
2021,Diciembre,Ecuador,218,12,12,,24,"(10.886611,-74.776708)"
2021,Diciembre,Ecuador,218,46,47,,93,"(3.541112,-76.384584)"
2021,Diciembre,Ecuador,218,3,4,,7,"(4.452882,-75.766298)"
2021,Diciembre,Ecuador,218,3577,3834,,7411,"(4.697144,-74.140516)"
2021,Diciembre,Ecuador,218,6,2,,8,"(4.815061,-75.736532)"
2021,Diciembre,Ecuador,218,77,68,,145,"(6.171601,-75.427454)"
2021,Diciembre,Ecuador,218,5,1,,6,"(7.128456,-73.183637)"
2021,Diciembre,Ecuador,218,2,0,,2,"(7.927209,-72.507910)"
2021,Diciembre,Egipto,818,1,2,,3,"(10.445761,-75.516429)"
2021,Diciembre,Egipto,818,104,140,,244,"(4.697144,-74.140516)"
2021,Diciembre,El Salvador,222,2,3,,5,"(10.445761,-75.516429)"
2021,Diciembre,El Salvador,222,3,2,,5,"(10.886611,-74.776708)"
2021,Diciembre,El Salvador,222,16,30,,46,"(3.541112,-76.384584)"
2021,Diciembre,El Salvador,222,422,440,,862,"(4.697144,-74.140516)"
2021,Diciembre,El Salvador,222,5,5,,10,"(4.815061,-75.736532)"
2021,Diciembre,El Salvador,222,19,28,,47,"(6.171601,-75.427454)"
2021,Diciembre,El Salvador,222,1,3,,4,"(7.128456,-73.183637)"
2021,Diciembre,El Salvador,222,2,2,,4,"(7.927209,-72.507910)"
2021,Diciembre,Emiratos Árabes,784,6,3,,9,"(10.445761,-75.516429)"
2021,Diciembre,Emiratos Árabes,784,1,0,,1,"(10.886611,-74.776708)"
2021,Diciembre,Emiratos Árabes,784,10,5,,15,"(3.541112,-76.384584)"
2021,Diciembre,Emiratos Árabes,784,425,526,,951,"(4.697144,-74.140516)"
2021,Diciembre,Emiratos Árabes,784,29,25,,54,"(6.171601,-75.427454)"
2021,Diciembre,Emiratos Árabes,784,0,1,,1,"(7.128456,-73.183637)"
2021,Diciembre,Eslovaquia,703,3,4,,7,"(4.697144,-74.140516)"
2021,Diciembre,Eslovenia,705,2,1,,3,"(4.697144,-74.140516)"
2021,Diciembre,Estados Unidos de América,840,3536,2804,,6340,"(10.445761,-75.516429)"
2021,Diciembre,Estados Unidos de América,840,6678,5341,,12020,"(10.886611,-74.776708)"
2021,Diciembre,Estados Unidos de América,840,3,7,,10,"(11.117806,-74.232622)"
2021,Diciembre,Estados Unidos de América,840,56,46,,102,"(12.586067,-81.702563)"
2021,Diciembre,Estados Unidos de América,840,11974,8651,,20625,"(3.541112,-76.384584)"
2021,Diciembre,Estados Unidos de América,840,1054,743,,1797,"(4.452882,-75.766298)"
2021,Diciembre,Estados Unidos de América,840,49390,39314,,88704,"(4.697144,-74.140516)"
2021,Diciembre,Estados Unidos de América,840,2065,1334,,3399,"(4.815061,-75.736532)"
2021,Diciembre,Estados Unidos de América,840,19584,14816,,34400,"(6.171601,-75.427454)"
2021,Diciembre,Estados Unidos de América,840,1275,930,,2205,"(7.128456,-73.183637)"
2021,Diciembre,Estados Unidos de América,840,62,49,,111,"(7.927209,-72.507910)"
2021,Diciembre,Estonia,233,1,2,,3,"(4.697144,-74.140516)"
2021,Diciembre,Etiopia,231,0,5,,5,"(4.697144,-74.140516)"
2021,Diciembre,Etiopia,231,0,1,,1,"(6.171601,-75.427454)"
2021,Diciembre,Filipinas,608,1,2,,3,"(4.697144,-74.140516)"
2021,Diciembre,Finlandia,246,1,1,,2,"(3.541112,-76.384584)"
2021,Diciembre,Finlandia,246,14,11,,25,"(4.697144,-74.140516)"
2021,Diciembre,Finlandia,246,1,2,,3,"(6.171601,-75.427454)"
2021,Diciembre,Francia,250,35,17,,52,"(10.445761,-75.516429)"
2021,Diciembre,Francia,250,8,3,,11,"(10.886611,-74.776708)"
2021,Diciembre,Francia,250,83,78,,161,"(3.541112,-76.384584)"
2021,Diciembre,Francia,250,1,1,,2,"(4.452882,-75.766298)"
2021,Diciembre,Francia,250,2188,1574,,3762,"(4.697144,-74.140516)"
2021,Diciembre,Francia,250,7,4,,11,"(4.815061,-75.736532)"
2021,Diciembre,Francia,250,107,98,,205,"(6.171601,-75.427454)"
2021,Diciembre,Gabón,266,0,1,,1,"(4.697144,-74.140516)"
2021,Diciembre,Georgia,268,3,1,,4,"(3.541112,-76.384584)"
2021,Diciembre,Georgia,268,2,0,,2,"(4.452882,-75.766298)"
2021,Diciembre,Georgia,268,11,6,,17,"(4.697144,-74.140516)"
2021,Diciembre,Georgia,268,2,0,,2,"(6.171601,-75.427454)"
2021,Diciembre,Ghana,288,0,2,,2,"(4.697144,-74.140516)"
2021,Diciembre,Gibraltar/Territorio Británico de Ultramar,292,0,1,,1,"(10.445761,-75.516429)"
2021,Diciembre,Granada,308,0,1,,1,"(4.697144,-74.140516)"
2021,Diciembre,Grecia,300,1,3,,4,"(3.541112,-76.384584)"
2021,Diciembre,Grecia,300,13,7,,20,"(4.697144,-74.140516)"
2021,Diciembre,Grecia,300,1,1,,2,"(6.171601,-75.427454)"
2021,Diciembre,Guatemala,320,0,1,,1,"(1.813928,-78.763924)"
2021,Diciembre,Guatemala,320,11,4,,15,"(10.445761,-75.516429)"
2021,Diciembre,Guatemala,320,19,22,,41,"(10.886611,-74.776708)"
2021,Diciembre,Guatemala,320,1,5,,6,"(12.586067,-81.702563)"
2021,Diciembre,Guatemala,320,59,64,,123,"(3.541112,-76.384584)"
2021,Diciembre,Guatemala,320,1,3,,4,"(4.452882,-75.766298)"
2021,Diciembre,Guatemala,320,521,515,,1036,"(4.697144,-74.140516)"
2021,Diciembre,Guatemala,320,18,17,,35,"(4.815061,-75.736532)"
2021,Diciembre,Guatemala,320,108,86,,194,"(6.171601,-75.427454)"
2021,Diciembre,Guatemala,320,5,3,,8,"(7.128456,-73.183637)"
2021,Diciembre,Guyana,328,0,1,,1,"(0.814836,-77.662532)"
2021,Diciembre,Guyana,328,0,2,,2,"(10.445761,-75.516429)"
2021,Diciembre,Guyana,328,1,2,,3,"(10.886611,-74.776708)"
2021,Diciembre,Guyana,328,2,1,,3,"(3.541112,-76.384584)"
2021,Diciembre,Guyana,328,5,16,,21,"(4.697144,-74.140516)"
2021,Diciembre,Guyana,328,0,2,,2,"(4.815061,-75.736532)"
2021,Diciembre,Guyana,328,3,8,,11,"(6.171601,-75.427454)"
2021,Diciembre,Guinea,324,0,1,,1,"(4.697144,-74.140516)"
2021,Diciembre,Guinea Ecuatorial,226,1,1,,2,"(4.697144,-74.140516)"
2021,Diciembre,Guayana Francesa/Departamento de Ultramar Francés,254,2,0,,2,"(4.697144,-74.140516)"
2021,Diciembre,Guayana Francesa/Departamento de Ultramar Francés,254,0,1,,1,"(6.171601,-75.427454)"
2021,Diciembre,Haití,332,1,5,,6,"(4.697144,-74.140516)"
2021,Diciembre,Haití,332,0,5,,5,"(6.171601,-75.427454)"
2021,Diciembre,Honduras,340,5,5,,10,"(10.445761,-75.516429)"
2021,Diciembre,Honduras,340,6,6,,12,"(10.886611,-74.776708)"
2021,Diciembre,Honduras,340,13,19,,32,"(3.541112,-76.384584)"
2021,Diciembre,Honduras,340,0,1,,1,"(4.452882,-75.766298)"
2021,Diciembre,Honduras,340,75,90,,165,"(4.697144,-74.140516)"
2021,Diciembre,Honduras,340,3,3,,6,"(4.815061,-75.736532)"
2021,Diciembre,Honduras,340,35,43,,78,"(6.171601,-75.427454)"
2021,Diciembre,Honduras,340,5,7,,12,"(7.128456,-73.183637)"
2021,Diciembre,Hong Kong,344,1,0,,1,"(4.697144,-74.140516)"
2021,Diciembre,Hong Kong,344,1,0,,1,"(6.171601,-75.427454)"
2021,Diciembre,Hungría,348,20,9,,29,"(4.697144,-74.140516)"
2021,Diciembre,Hungría,348,1,1,,2,"(6.171601,-75.427454)"
2021,Diciembre,India,356,4,4,,8,"(4.697144,-74.140516)"
2021,Diciembre,India,356,0,1,,1,"(6.171601,-75.427454)"
2021,Diciembre,Indonesia,360,0,1,,1,"(10.445761,-75.516429)"
2021,Diciembre,Indonesia,360,0,2,,2,"(4.697144,-74.140516)"
2021,Diciembre,Indonesia,360,1,0,,1,"(6.171601,-75.427454)"
2021,Diciembre,Iraq,368,1,4,,5,"(4.697144,-74.140516)"
2021,Diciembre,Irán,364,1,2,,3,"(4.697144,-74.140516)"
2021,Diciembre,República de Irlanda,372,4,2,,6,"(10.445761,-75.516429)"
2021,Diciembre,República de Irlanda,372,0,1,,1,"(10.886611,-74.776708)"
2021,Diciembre,República de Irlanda,372,6,2,,8,"(3.541112,-76.384584)"
2021,Diciembre,República de Irlanda,372,23,9,,32,"(4.697144,-74.140516)"
2021,Diciembre,República de Irlanda,372,1,1,,2,"(6.171601,-75.427454)"
2021,Diciembre,Islandia,352,10,9,,19,"(4.697144,-74.140516)"
2021,Diciembre,Islandia,352,0,1,,1,"(6.171601,-75.427454)"
2021,Diciembre,Israel,376,1,1,,2,"(10.445761,-75.516429)"
2021,Diciembre,Israel,376,1,0,,1,"(10.886611,-74.776708)"
2021,Diciembre,Israel,376,2,1,,3,"(3.541112,-76.384584)"
2021,Diciembre,Israel,376,43,46,,89,"(4.697144,-74.140516)"
2021,Diciembre,Israel,376,3,0,,3,"(6.171601,-75.427454)"
2021,Diciembre,Italia,380,35,20,,55,"(10.445761,-75.516429)"
2021,Diciembre,Italia,380,4,4,,8,"(10.886611,-74.776708)"
2021,Diciembre,Italia,380,101,37,,138,"(3.541112,-76.384584)"
2021,Diciembre,Italia,380,532,349,,881,"(4.697144,-74.140516)"
2021,Diciembre,Italia,380,1,0,,1,"(4.815061,-75.736532)"
2021,Diciembre,Italia,380,80,50,,130,"(6.171601,-75.427454)"
2021,Diciembre,Islas Feroe/Región Autónoma de Dinamarca,234,1,0,,1,"(10.886611,-74.776708)"
2021,Diciembre,Jamaica,388,1,0,,1,"(10.445761,-75.516429)"
2021,Diciembre,Jamaica,388,3,6,,9,"(10.886611,-74.776708)"
2021,Diciembre,Jamaica,388,7,12,,19,"(3.541112,-76.384584)"
2021,Diciembre,Jamaica,388,40,41,,81,"(4.697144,-74.140516)"
2021,Diciembre,Jamaica,388,3,4,,7,"(4.815061,-75.736532)"
2021,Diciembre,Jamaica,388,16,9,,25,"(6.171601,-75.427454)"
2021,Diciembre,Jamaica,388,1,5,,6,"(7.128456,-73.183637)"
2021,Diciembre,Japón,392,1,0,,1,"(3.541112,-76.384584)"
2021,Diciembre,Japón,392,8,3,,11,"(4.697144,-74.140516)"
2021,Diciembre,Japón,392,2,0,,2,"(4.815061,-75.736532)"
2021,Diciembre,Japón,392,1,0,,1,"(6.171601,-75.427454)"
2021,Diciembre,Jordania,400,9,7,,16,"(4.697144,-74.140516)"
2021,Diciembre,Kazajistán,398,0,1,,1,"(10.445761,-75.516429)"
2021,Diciembre,Kazajistán,398,1,0,,1,"(4.697144,-74.140516)"
2021,Diciembre,Kenia,404,8,11,,19,"(4.697144,-74.140516)"
2021,Diciembre,Kuwait,414,1,1,,2,"(4.697144,-74.140516)"
2021,Diciembre,Letonia,428,1,1,,2,"(4.697144,-74.140516)"
2021,Diciembre,Lituania,440,0,2,,2,"(4.697144,-74.140516)"
2021,Diciembre,Lituania,440,1,0,,1,"(6.171601,-75.427454)"
2021,Diciembre,Líbano,422,1,0,,1,"(10.886611,-74.776708)"
2021,Diciembre,Líbano,422,2,0,,2,"(3.541112,-76.384584)"
2021,Diciembre,Líbano,422,7,14,,21,"(4.697144,-74.140516)"
2021,Diciembre,Liechtenstein,438,1,0,,1,"(3.541112,-76.384584)"
2021,Diciembre,Luxemburgo,442,4,2,,6,"(10.445761,-75.516429)"
2021,Diciembre,Luxemburgo,442,12,7,,19,"(4.697144,-74.140516)"
2021,Diciembre,Luxemburgo,442,2,1,,3,"(6.171601,-75.427454)"
2021,Diciembre,Malasia,458,1,2,,3,"(4.697144,-74.140516)"
2021,Diciembre,Maldivas,462,3,2,,5,"(4.697144,-74.140516)"
2021,Diciembre,Malta,470,72,63,,135,"(4.697144,-74.140516)"
2021,Diciembre,Malta,470,7,3,,10,"(6.171601,-75.427454)"
2021,Diciembre,Mauricio,480,0,1,,1,"(4.697144,-74.140516)"
2021,Diciembre,Mauritania,478,0,3,,3,"(4.697144,-74.140516)"
2021,Diciembre,Martinica/Departamento de Ultramar Francés,474,1,1,,2,"(4.697144,-74.140516)"
2021,Diciembre,México,484,101,72,,173,"(10.445761,-75.516429)"
2021,Diciembre,México,484,159,153,,312,"(10.886611,-74.776708)"
2021,Diciembre,México,484,2,6,,8,"(12.586067,-81.702563)"
2021,Diciembre,México,484,1629,1426,,3055,"(3.541112,-76.384584)"
2021,Diciembre,México,484,21,16,,37,"(4.452882,-75.766298)"
2021,Diciembre,México,484,23737,19586,,43323,"(4.697144,-74.140516)"
2021,Diciembre,México,484,153,87,,240,"(4.815061,-75.736532)"
2021,Diciembre,México,484,6858,5545,,12403,"(6.171601,-75.427454)"
2021,Diciembre,México,484,77,60,,137,"(7.128456,-73.183637)"
2021,Diciembre,México,484,38,28,,66,"(7.927209,-72.507910)"
2021,Diciembre,Mayotte/Colectividad Territorial Francesa,175,1,0,,1,"(4.697144,-74.140516)"
2021,Diciembre,Mónaco,492,1,1,,2,"(4.697144,-74.140516)"
2021,Diciembre,Mónaco,492,1,0,,1,"(6.171601,-75.427454)"
2021,Diciembre,Montenegro,499,1,2,,3,"(4.697144,-74.140516)"
2021,Diciembre,Mozambique,508,0,1,,1,"(4.697144,-74.140516)"
2021,Diciembre,Nicaragua,558,2,2,,4,"(10.445761,-75.516429)"
2021,Diciembre,Nicaragua,558,1,0,,1,"(10.886611,-74.776708)"
2021,Diciembre,Nicaragua,558,0,2,,2,"(3.541112,-76.384584)"
2021,Diciembre,Nicaragua,558,33,50,,83,"(4.697144,-74.140516)"
2021,Diciembre,Nicaragua,558,10,10,,20,"(6.171601,-75.427454)"
2021,Diciembre,Nicaragua,558,0,1,,1,"(7.128456,-73.183637)"
2021,Diciembre,Nigeria,566,1,1,,2,"(4.697144,-74.140516)"
2021,Diciembre,Níger,562,0,1,,1,"(4.697144,-74.140516)"
2021,Diciembre,Noruega,578,3,2,,5,"(10.445761,-75.516429)"
2021,Diciembre,Noruega,578,2,1,,3,"(10.886611,-74.776708)"
2021,Diciembre,Noruega,578,13,5,,18,"(3.541112,-76.384584)"
2021,Diciembre,Noruega,578,43,33,,76,"(4.697144,-74.140516)"
2021,Diciembre,Noruega,578,7,2,,9,"(6.171601,-75.427454)"
2021,Diciembre,Nueva Zelanda,554,0,1,,1,"(4.697144,-74.140516)"
2021,Diciembre,Omán,512,4,11,,15,"(4.697144,-74.140516)"
2021,Diciembre,Omán,512,2,0,,2,"(6.171601,-75.427454)"
2021,Diciembre,Papúa Nueva Guinea,598,0,1,,1,"(4.697144,-74.140516)"
2021,Diciembre,Pakistán,586,1,1,,2,"(4.697144,-74.140516)"
2021,Diciembre,Panamá,591,15,53,,68,"(10.408582,-75.538003)"
2021,Diciembre,Panamá,591,1111,844,,1955,"(10.445761,-75.516429)"
2021,Diciembre,Panamá,591,627,555,,1182,"(10.886611,-74.776708)"
2021,Diciembre,Panamá,591,2,15,,17,"(12.5744111,-81.703935)"
2021,Diciembre,Panamá,591,1915,1418,,3333,"(3.541112,-76.384584)"
2021,Diciembre,Panamá,591,130,93,,223,"(4.452882,-75.766298)"
2021,Diciembre,Panamá,591,5617,5262,,10879,"(4.697144,-74.140516)"
2021,Diciembre,Panamá,591,238,171,,409,"(4.815061,-75.736532)"
2021,Diciembre,Panamá,591,2052,1608,,3660,"(6.171601,-75.427454)"
2021,Diciembre,Panamá,591,0,2,,2,"(6.228046,-77.404104)"
2021,Diciembre,Panamá,591,15,15,,30,"(7.102626,-77.762647)"
2021,Diciembre,Panamá,591,130,96,,226,"(7.128456,-73.183637)"
2021,Diciembre,Panamá,591,53,50,,103,"(7.927209,-72.507910)"
2021,Diciembre,Panamá,591,22,41,,63,"(8.635765,-77.346578)"
2021,Diciembre,Paraguay,600,1,1,,2,"(0.814836,-77.662532)"
2021,Diciembre,Paraguay,600,2,1,,3,"(10.445761,-75.516429)"
2021,Diciembre,Paraguay,600,6,4,,10,"(10.886611,-74.776708)"
2021,Diciembre,Paraguay,600,4,14,,18,"(3.541112,-76.384584)"
2021,Diciembre,Paraguay,600,200,237,,437,"(4.697144,-74.140516)"
2021,Diciembre,Paraguay,600,3,3,,6,"(4.815061,-75.736532)"
2021,Diciembre,Paraguay,600,7,10,,17,"(6.171601,-75.427454)"
2021,Diciembre,Perú,604,1,1,,2,"(-0.193180,-74.784874)"
2021,Diciembre,Perú,604,9,16,,25,"(-4.197703,-69.941278)"
2021,Diciembre,Perú,604,18,26,,44,"(0.814836,-77.662532)"
2021,Diciembre,Perú,604,2,10,,12,"(10.445761,-75.516429)"
2021,Diciembre,Perú,604,14,16,,30,"(10.886611,-74.776708)"
2021,Diciembre,Perú,604,44,33,,77,"(3.541112,-76.384584)"
2021,Diciembre,Perú,604,4907,4320,,9227,"(4.697144,-74.140516)"
2021,Diciembre,Perú,604,8,8,,16,"(4.815061,-75.736532)"
2021,Diciembre,Perú,604,683,523,,1206,"(6.171601,-75.427454)"
2021,Diciembre,Perú,604,4,5,,9,"(7.128456,-73.183637)"
2021,Diciembre,Perú,604,1,0,,1,"(7.927209,-72.507910)"
2021,Diciembre,Polonia,616,1,0,,1,"(3.541112,-76.384584)"
2021,Diciembre,Polonia,616,14,30,,44,"(4.697144,-74.140516)"
2021,Diciembre,Polonia,616,2,1,,3,"(6.171601,-75.427454)"
2021,Diciembre,Portugal,620,4,5,,9,"(10.445761,-75.516429)"
2021,Diciembre,Portugal,620,1,0,,1,"(10.886611,-74.776708)"
2021,Diciembre,Portugal,620,11,12,,23,"(3.541112,-76.384584)"
2021,Diciembre,Portugal,620,143,108,,251,"(4.697144,-74.140516)"
2021,Diciembre,Portugal,620,1,0,,1,"(4.815061,-75.736532)"
2021,Diciembre,Portugal,620,26,12,,38,"(6.171601,-75.427454)"
2021,Diciembre,Portugal,620,1,1,,2,"(7.128456,-73.183637)"
2021,Diciembre,Puerto Rico/Territorio de Estados Unidos,630,7,4,,11,"(10.445761,-75.516429)"
2021,Diciembre,Puerto Rico/Territorio de Estados Unidos,630,17,11,,28,"(10.886611,-74.776708)"
2021,Diciembre,Puerto Rico/Territorio de Estados Unidos,630,57,36,,93,"(3.541112,-76.384584)"
2021,Diciembre,Puerto Rico/Territorio de Estados Unidos,630,0,1,,1,"(4.452882,-75.766298)"
2021,Diciembre,Puerto Rico/Territorio de Estados Unidos,630,602,489,,1091,"(4.697144,-74.140516)"
2021,Diciembre,Puerto Rico/Territorio de Estados Unidos,630,2,3,,5,"(4.815061,-75.736532)"
2021,Diciembre,Puerto Rico/Territorio de Estados Unidos,630,88,66,,154,"(6.171601,-75.427454)"
2021,Diciembre,Puerto Rico/Territorio de Estados Unidos,630,7,3,,10,"(7.128456,-73.183637)"
2021,Diciembre,Puerto Rico/Territorio de Estados Unidos,630,1,0,,1,"(7.927209,-72.507910)"
2021,Diciembre,Qatar,634,0,1,,1,"(10.445761,-75.516429)"
2021,Diciembre,Qatar,634,2,1,,3,"(10.886611,-74.776708)"
2021,Diciembre,Qatar,634,29,32,,61,"(4.697144,-74.140516)"
2021,Diciembre,Qatar,634,6,3,,9,"(6.171601,-75.427454)"
2021,Diciembre,Reino Unido de Gran Bretaña e Irlanda del Norte,826,10,11,,21,"(10.445761,-75.516429)"
2021,Diciembre,Reino Unido de Gran Bretaña e Irlanda del Norte,826,7,0,,7,"(10.886611,-74.776708)"
2021,Diciembre,Reino Unido de Gran Bretaña e Irlanda del Norte,826,59,43,,102,"(3.541112,-76.384584)"
2021,Diciembre,Reino Unido de Gran Bretaña e Irlanda del Norte,826,333,199,,532,"(4.697144,-74.140516)"
2021,Diciembre,Reino Unido de Gran Bretaña e Irlanda del Norte,826,10,5,,15,"(4.815061,-75.736532)"
2021,Diciembre,Reino Unido de Gran Bretaña e Irlanda del Norte,826,2,8,,10,"(6.17134,-75.427194)"
2021,Diciembre,Reino Unido de Gran Bretaña e Irlanda del Norte,826,59,23,,82,"(6.171601,-75.427454)"
2021,Diciembre,Reino Unido de Gran Bretaña e Irlanda del Norte,826,1,0,,1,"(7.128456,-73.183637)"
2021,Diciembre,Reino Unido de Gran Bretaña e Irlanda del Norte,826,0,1,,1,"(7.927209,-72.507910)"
2021,Diciembre,República CentroÁfricana,140,2,2,,4,"(4.697144,-74.140516)"
2021,Diciembre,Federación de Rusia,643,0,1,,1,"(10.445761,-75.516429)"
2021,Diciembre,Federación de Rusia,643,0,3,,3,"(3.541112,-76.384584)"
2021,Diciembre,Federación de Rusia,643,86,101,,187,"(4.697144,-74.140516)"
2021,Diciembre,Federación de Rusia,643,2,3,,5,"(6.171601,-75.427454)"
2021,Diciembre,República Dominicana,214,0,1,,1,"(10.408582,-75.538003)"
2021,Diciembre,República Dominicana,214,37,33,,70,"(10.445761,-75.516429)"
2021,Diciembre,República Dominicana,214,77,85,,162,"(10.886611,-74.776708)"
2021,Diciembre,República Dominicana,214,4,7,,11,"(11.117806,-74.232622)"
2021,Diciembre,República Dominicana,214,271,209,,480,"(3.541112,-76.384584)"
2021,Diciembre,República Dominicana,214,1,0,,1,"(4.452882,-75.766298)"
2021,Diciembre,República Dominicana,214,6804,5609,,12413,"(4.697144,-74.140516)"
2021,Diciembre,República Dominicana,214,86,63,,149,"(4.815061,-75.736532)"
2021,Diciembre,República Dominicana,214,2700,2166,,4866,"(6.171601,-75.427454)"
2021,Diciembre,República Dominicana,214,69,48,,117,"(7.128456,-73.183637)"
2021,Diciembre,República Dominicana,214,54,40,,94,"(7.927209,-72.507910)"
2021,Diciembre,Reunión,638,1,0,,1,"(6.171601,-75.427454)"
2021,Diciembre,Rumania,642,1,0,,1,"(10.445761,-75.516429)"
2021,Diciembre,Rumania,642,7,5,,12,"(4.697144,-74.140516)"
2021,Diciembre,Rumania,642,2,4,,6,"(6.171601,-75.427454)"
2021,Diciembre,Sahara Occidental/Desierto Sahara,732,1,0,,1,"(4.697144,-74.140516)"
2021,Diciembre,Sahara Occidental/Desierto Sahara,732,1,0,,1,"(6.171601,-75.427454)"
2021,Diciembre,San Cristóbal y Nevis,659,3,0,,3,"(3.541112,-76.384584)"
2021,Diciembre,San Cristóbal y Nevis,659,1,1,,2,"(7.818934,-72.453226)"
2021,Diciembre,Senegal,686,3,4,,7,"(4.697144,-74.140516)"
2021,Diciembre,Serbia,688,1,0,,1,"(6.171601,-75.427454)"
2021,Diciembre,Islas Svalbard,744,1,0,,1,"(4.697144,-74.140516)"
2021,Diciembre,Singapur,702,1,0,,1,"(3.541112,-76.384584)"
2021,Diciembre,Singapur,702,5,1,,6,"(4.697144,-74.140516)"
2021,Diciembre,Sri Lanka,144,0,5,,5,"(4.697144,-74.140516)"
2021,Diciembre,Sudáfrica,710,11,5,,16,"(4.697144,-74.140516)"
2021,Diciembre,Suecia,752,14,2,,16,"(10.445761,-75.516429)"
2021,Diciembre,Suecia,752,1,2,,3,"(10.886611,-74.776708)"
2021,Diciembre,Suecia,752,22,17,,39,"(3.541112,-76.384584)"
2021,Diciembre,Suecia,752,0,2,,2,"(4.452882,-75.766298)"
2021,Diciembre,Suecia,752,127,96,,223,"(4.697144,-74.140516)"
2021,Diciembre,Suecia,752,4,4,,8,"(4.815061,-75.736532)"
2021,Diciembre,Suecia,752,17,13,,30,"(6.171601,-75.427454)"
2021,Diciembre,Suiza,756,29,17,,46,"(10.445761,-75.516429)"
2021,Diciembre,Suiza,756,9,5,,14,"(10.886611,-74.776708)"
2021,Diciembre,Suiza,756,61,46,,107,"(3.541112,-76.384584)"
2021,Diciembre,Suiza,756,457,303,,760,"(4.697144,-74.140516)"
2021,Diciembre,Suiza,756,68,33,,101,"(6.171601,-75.427454)"
2021,Diciembre,Surinam,740,0,12,,12,"(10.408582,-75.538003)"
2021,Diciembre,Surinam,740,9,3,,12,"(4.697144,-74.140516)"
2021,Diciembre,Surinam,740,0,3,,3,"(6.171601,-75.427454)"
2021,Diciembre,República de Tayikistán,762,1,0,,1,"(4.697144,-74.140516)"
2021,Diciembre,Tailandia,764,1,1,,2,"(3.541112,-76.384584)"
2021,Diciembre,Tailandia,764,12,11,,23,"(4.697144,-74.140516)"
2021,Diciembre,Tailandia,764,1,0,,1,"(6.171601,-75.427454)"
2021,Diciembre,Tanzania,834,2,1,,3,"(4.697144,-74.140516)"
2021,Diciembre,Trinidad y Tobago,780,3,4,,7,"(10.445761,-75.516429)"
2021,Diciembre,Trinidad y Tobago,780,1,0,,1,"(10.886611,-74.776708)"
2021,Diciembre,Trinidad y Tobago,780,3,0,,3,"(3.541112,-76.384584)"
2021,Diciembre,Trinidad y Tobago,780,3,4,,7,"(4.452882,-75.766298)"
2021,Diciembre,Trinidad y Tobago,780,7,12,,19,"(4.697144,-74.140516)"
2021,Diciembre,Trinidad y Tobago,780,0,1,,1,"(4.815061,-75.736532)"
2021,Diciembre,Trinidad y Tobago,780,5,2,,7,"(6.171601,-75.427454)"
2021,Diciembre,Trinidad y Tobago,780,1,0,,1,"(7.128456,-73.183637)"
2021,Diciembre,Túnez,788,2,4,,6,"(4.697144,-74.140516)"
2021,Diciembre,Turquía,792,3,2,,5,"(10.445761,-75.516429)"
2021,Diciembre,Turquía,792,5,2,,7,"(3.541112,-76.384584)"
2021,Diciembre,Turquía,792,1555,1086,,2641,"(4.697144,-74.140516)"
2021,Diciembre,Turquía,792,10,5,,15,"(6.171601,-75.427454)"
2021,Diciembre,Turkmenistán,795,1,2,,3,"(4.697144,-74.140516)"
2021,Diciembre,Ucrania,804,13,8,,21,"(3.541112,-76.384584)"
2021,Diciembre,Ucrania,804,15,24,,39,"(4.697144,-74.140516)"
2021,Diciembre,Uganda,800,1,3,,4,"(4.697144,-74.140516)"
2021,Diciembre,Uruguay,858,4,4,,8,"(10.445761,-75.516429)"
2021,Diciembre,Uruguay,858,1,3,,4,"(10.886611,-74.776708)"
2021,Diciembre,Uruguay,858,23,22,,45,"(3.541112,-76.384584)"
2021,Diciembre,Uruguay,858,7,3,,10,"(4.452882,-75.766298)"
2021,Diciembre,Uruguay,858,387,349,,736,"(4.697144,-74.140516)"
2021,Diciembre,Uruguay,858,7,8,,15,"(4.815061,-75.736532)"
2021,Diciembre,Uruguay,858,18,25,,43,"(6.171601,-75.427454)"
2021,Diciembre,Uruguay,858,1,2,,3,"(7.128456,-73.183637)"
2021,Diciembre,Uruguay,858,2,0,,2,"(7.927209,-72.507910)"
2021,Diciembre,Uzbekistán,860,4,14,,18,"(4.697144,-74.140516)"
2021,Diciembre,Venezuela,862,4,5,,9,"(10.445761,-75.516429)"
2021,Diciembre,Venezuela,862,34,50,,84,"(10.886611,-74.776708)"
2021,Diciembre,Venezuela,862,118,252,,370,"(11.360009,-72.129330)"
2021,Diciembre,Venezuela,862,29,39,,68,"(3.541112,-76.384584)"
2021,Diciembre,Venezuela,862,1,2,,3,"(3.866713,-67.927521)"
2021,Diciembre,Venezuela,862,174,268,,442,"(4.697144,-74.140516)"
2021,Diciembre,Venezuela,862,5,5,,10,"(4.815061,-75.736532)"
2021,Diciembre,Venezuela,862,41,49,,90,"(6.171601,-75.427454)"
2021,Diciembre,Venezuela,862,2,9,,11,"(6.185799,-67.483929)"
2021,Diciembre,Venezuela,862,18,27,,45,"(7.088729,-70.740253)"
2021,Diciembre,Venezuela,862,6,6,,12,"(7.128456,-73.183637)"
2021,Diciembre,Venezuela,862,376,399,,775,"(7.818934,-72.453226)"
2021,Diciembre,Venezuela,862,49,55,,104,"(7.916725,-72.462544)"
2021,Diciembre,Venezuela,862,2,1,,3,"(7.927209,-72.507910)"
2021,Diciembre,Venezuela,862,18,31,,49,"(8.36068,-72.409396)"
2021,Diciembre,Vietnam,704,0,1,,1,"(4.697144,-74.140516)"
2021,Diciembre,Islas Vírgenes Británicas/Territorio Británico de Ultramar,92,2,2,,4,"(4.697144,-74.140516)"
2021,Diciembre,Islas Vírgenes Estadounidenses/Territorio de Estados Unidos,850,1,1,,2,"(3.541112,-76.384584)"
2021,Diciembre,Islas Vírgenes Estadounidenses/Territorio de Estados Unidos,850,3,1,,4,"(4.697144,-74.140516)"
2021,Diciembre,Anguila/Territorio Británico de Ultramar,660,1,5,,6,"(4.697144,-74.140516)"
2021,Diciembre,Islas Turcas y Caicos/Territorio Británico de Ultramar,796,2,2,,4,"(4.697144,-74.140516)"
2021,Diciembre,Islas Turcas y Caicos/Territorio Británico de Ultramar,796,1,0,,1,"(6.171601,-75.427454)"
2021,Diciembre,Desconocido,99999,0,1,,1,"(3.541112,-76.384584)"
2021,Diciembre,Desconocido,99999,1,1,,2,"(4.697144,-74.140516)"
2022,Enero,Afganistán,4,1,0,,1,"(3.541112,-76.384584)"
2022,Enero,Albania,8,2,3,,5,"(4.697144,-74.140516)"
2022,Enero,Alemania,276,48,29,,77,"(10.445761,-75.516429)"
2022,Enero,Alemania,276,14,12,,26,"(10.886611,-74.776708)"
2022,Enero,Alemania,276,69,35,,104,"(3.541112,-76.384584)"
2022,Enero,Alemania,276,1772,1363,,3135,"(4.697144,-74.140516)"
2022,Enero,Alemania,276,3,1,,4,"(4.815061,-75.736532)"
2022,Enero,Alemania,276,107,87,,194,"(6.171601,-75.427454)"
2022,Enero,Alemania,276,0,1,,1,"(7.128456,-73.183637)"
2022,Enero,Andorra,20,2,0,,2,"(10.445761,-75.516429)"
2022,Enero,Andorra,20,8,8,,16,"(4.697144,-74.140516)"
2022,Enero,Angola,24,7,12,,19,"(4.697144,-74.140516)"
2022,Enero,Angola,24,0,1,,1,"(6.171601,-75.427454)"
2022,Enero,Antigua y Barbuda,28,2,4,,6,"(4.697144,-74.140516)"
2022,Enero,Antigua y Barbuda,28,0,3,,3,"(4.815061,-75.736532)"
2022,Enero,Países Bajos,528,167,95,,262,"(10.445761,-75.516429)"
2022,Enero,Países Bajos,528,30,17,,47,"(10.886611,-74.776708)"
2022,Enero,Países Bajos,528,68,46,,114,"(3.541112,-76.384584)"
2022,Enero,Países Bajos,528,996,918,,1914,"(4.697144,-74.140516)"
2022,Enero,Países Bajos,528,3,1,,4,"(4.815061,-75.736532)"
2022,Enero,Países Bajos,528,92,56,,148,"(6.171601,-75.427454)"
2022,Enero,Arabia Saudita,682,0,1,,1,"(10.408582,-75.538003)"
2022,Enero,Arabia Saudita,682,0,5,,5,"(10.445761,-75.516429)"
2022,Enero,Arabia Saudita,682,2,2,,4,"(3.541112,-76.384584)"
2022,Enero,Arabia Saudita,682,38,81,,119,"(4.697144,-74.140516)"
2022,Enero,Arabia Saudita,682,4,3,,7,"(6.171601,-75.427454)"
2022,Enero,Arabia Saudita,682,0,1,,1,"(7.128456,-73.183637)"
2022,Enero,Argelia,12,0,6,,6,"(4.697144,-74.140516)"
2022,Enero,Argelia,12,0,1,,1,"(6.171601,-75.427454)"
2022,Enero,Argentina,32,3,13,,16,"(0.814836,-77.662532)"
2022,Enero,Argentina,32,25,17,,42,"(10.445761,-75.516429)"
2022,Enero,Argentina,32,22,66,,88,"(10.886611,-74.776708)"
2022,Enero,Argentina,32,63,67,,130,"(3.541112,-76.384584)"
2022,Enero,Argentina,32,3,6,,9,"(4.452882,-75.766298)"
2022,Enero,Argentina,32,2670,2256,,4926,"(4.697144,-74.140516)"
2022,Enero,Argentina,32,0,5,,5,"(4.815061,-75.736532)"
2022,Enero,Argentina,32,78,90,,168,"(6.171601,-75.427454)"
2022,Enero,Argentina,32,1,2,,3,"(7.128456,-73.183637)"
2022,Enero,República de Armenia,51,2,4,,6,"(4.697144,-74.140516)"
2022,Enero,República de Armenia,51,0,1,,1,"(6.171601,-75.427454)"
2022,Enero,Aruba,533,0,1,,1,"(10.445761,-75.516429)"
2022,Enero,Aruba,533,85,59,,144,"(10.886611,-74.776708)"
2022,Enero,Aruba,533,60,35,,95,"(3.541112,-76.384584)"
2022,Enero,Aruba,533,1861,1514,,3375,"(4.697144,-74.140516)"
2022,Enero,Aruba,533,8,3,,11,"(4.815061,-75.736532)"
2022,Enero,Aruba,533,101,100,,201,"(6.171601,-75.427454)"
2022,Enero,Aruba,533,13,41,,54,"(7.128456,-73.183637)"
2022,Enero,Aruba,533,8,4,,12,"(7.927209,-72.507910)"
2022,Enero,Australia,36,0,1,,1,"(10.445761,-75.516429)"
2022,Enero,Australia,36,0,1,,1,"(10.886611,-74.776708)"
2022,Enero,Australia,36,17,12,,29,"(3.541112,-76.384584)"
2022,Enero,Australia,36,236,185,,421,"(4.697144,-74.140516)"
2022,Enero,Australia,36,1,2,,3,"(4.815061,-75.736532)"
2022,Enero,Australia,36,43,36,,79,"(6.171601,-75.427454)"
2022,Enero,Austria,40,3,1,,4,"(10.445761,-75.516429)"
2022,Enero,Austria,40,0,1,,1,"(10.886611,-74.776708)"
2022,Enero,Austria,40,7,4,,11,"(3.541112,-76.384584)"
2022,Enero,Austria,40,99,71,,170,"(4.697144,-74.140516)"
2022,Enero,Austria,40,0,2,,2,"(4.815061,-75.736532)"
2022,Enero,Austria,40,4,4,,8,"(6.171601,-75.427454)"
2022,Enero,Azerbaiyán,31,8,6,,14,"(4.697144,-74.140516)"
2022,Enero,Bahamas,44,10,11,,21,"(10.445761,-75.516429)"
2022,Enero,Bahamas,44,1,9,,10,"(10.886611,-74.776708)"
2022,Enero,Bahamas,44,13,11,,24,"(3.541112,-76.384584)"
2022,Enero,Bahamas,44,30,36,,66,"(4.697144,-74.140516)"
2022,Enero,Bahamas,44,3,1,,4,"(4.815061,-75.736532)"
2022,Enero,Bahamas,44,35,84,,119,"(6.171601,-75.427454)"
2022,Enero,Bahamas,44,2,1,,3,"(7.128456,-73.183637)"
2022,Enero,Bahamas,44,1,0,,1,"(7.927209,-72.507910)"
2022,Enero,Bahréin,48,0,1,,1,"(10.445761,-75.516429)"
2022,Enero,Bahréin,48,11,9,,20,"(4.697144,-74.140516)"
2022,Enero,Bahréin,48,1,0,,1,"(6.171601,-75.427454)"
2022,Enero,Bangladesh,50,1,0,,1,"(10.445761,-75.516429)"
2022,Enero,Bangladesh,50,1,2,,3,"(4.697144,-74.140516)"
2022,Enero,Barbados,52,2,7,,9,"(10.886611,-74.776708)"
2022,Enero,Barbados,52,0,2,,2,"(3.541112,-76.384584)"
2022,Enero,Barbados,52,66,72,,138,"(4.697144,-74.140516)"
2022,Enero,Barbados,52,1,2,,3,"(6.171601,-75.427454)"
2022,Enero,Bélgica,56,9,4,,13,"(10.445761,-75.516429)"
2022,Enero,Bélgica,56,8,6,,14,"(10.886611,-74.776708)"
2022,Enero,Bélgica,56,40,26,,66,"(3.541112,-76.384584)"
2022,Enero,Bélgica,56,230,156,,386,"(4.697144,-74.140516)"
2022,Enero,Bélgica,56,3,1,,4,"(4.815061,-75.736532)"
2022,Enero,Bélgica,56,54,45,,99,"(6.171601,-75.427454)"
2022,Enero,Bélgica,56,1,0,,1,"(7.128456,-73.183637)"
2022,Enero,Belice,84,1,2,,3,"(3.541112,-76.384584)"
2022,Enero,Belice,84,4,10,,14,"(4.697144,-74.140516)"
2022,Enero,Belice,84,0,1,,1,"(4.815061,-75.736532)"
2022,Enero,Belice,84,1,2,,3,"(6.171601,-75.427454)"
2022,Enero,Benín,204,3,1,,4,"(4.697144,-74.140516)"
2022,Enero,Bermudas/Territorio Británico de Ultramar,60,1,1,,2,"(3.541112,-76.384584)"
2022,Enero,Bermudas/Territorio Británico de Ultramar,60,4,4,,8,"(4.697144,-74.140516)"
2022,Enero,Bermudas/Territorio Británico de Ultramar,60,1,0,,1,"(4.815061,-75.736532)"
2022,Enero,Bermudas/Territorio Británico de Ultramar,60,3,3,,6,"(6.171601,-75.427454)"
2022,Enero,Bolivia,68,5,5,,10,"(0.814836,-77.662532)"
2022,Enero,Bolivia,68,1,1,,2,"(10.445761,-75.516429)"
2022,Enero,Bolivia,68,2,2,,4,"(10.886611,-74.776708)"
2022,Enero,Bolivia,68,0,11,,11,"(3.541112,-76.384584)"
2022,Enero,Bolivia,68,11,14,,25,"(4.452882,-75.766298)"
2022,Enero,Bolivia,68,422,697,,1119,"(4.697144,-74.140516)"
2022,Enero,Bolivia,68,4,8,,12,"(4.815061,-75.736532)"
2022,Enero,Bolivia,68,6,23,,29,"(6.171601,-75.427454)"
2022,Enero,Bolivia,68,3,2,,5,"(7.128456,-73.183637)"
2022,Enero,Bolivia,68,0,1,,1,"(7.927209,-72.507910)"
2022,Enero,Bosnia y Herzegovina,70,0,2,,2,"(4.697144,-74.140516)"
2022,Enero,Botsuana,72,1,1,,2,"(4.697144,-74.140516)"
2022,Enero,Brasil,76,267,440,,707,"(-4.197703,-69.941278)"
2022,Enero,Brasil,76,6,89,,95,"(10.408582,-75.538003)"
2022,Enero,Brasil,76,33,28,,61,"(10.445761,-75.516429)"
2022,Enero,Brasil,76,18,16,,34,"(10.886611,-74.776708)"
2022,Enero,Brasil,76,129,190,,319,"(3.541112,-76.384584)"
2022,Enero,Brasil,76,8,27,,35,"(4.452882,-75.766298)"
2022,Enero,Brasil,76,2134,2706,,4840,"(4.697144,-74.140516)"
2022,Enero,Brasil,76,27,39,,66,"(4.815061,-75.736532)"
2022,Enero,Brasil,76,135,150,,285,"(6.171601,-75.427454)"
2022,Enero,Brasil,76,18,19,,37,"(7.128456,-73.183637)"
2022,Enero,Brasil,76,3,4,,7,"(7.927209,-72.507910)"
2022,Enero,Bulgaria,100,1,6,,7,"(4.697144,-74.140516)"
2022,Enero,Burkina Faso,854,0,1,,1,"(4.697144,-74.140516)"
2022,Enero,Burundi,108,1,0,,1,"(4.697144,-74.140516)"
2022,Enero,Islas Caimán/Territorio Británico de Ultramar,136,2,0,,2,"(10.445761,-75.516429)"
2022,Enero,Islas Caimán/Territorio Británico de Ultramar,136,0,1,,1,"(10.886611,-74.776708)"
2022,Enero,Islas Caimán/Territorio Británico de Ultramar,136,3,1,,4,"(12.586067,-81.702563)"
2022,Enero,Islas Caimán/Territorio Británico de Ultramar,136,1,1,,2,"(3.541112,-76.384584)"
2022,Enero,Islas Caimán/Territorio Británico de Ultramar,136,5,7,,12,"(4.697144,-74.140516)"
2022,Enero,Islas Caimán/Territorio Británico de Ultramar,136,4,5,,9,"(6.171601,-75.427454)"
2022,Enero,Camboya,116,1,3,,4,"(4.697144,-74.140516)"
2022,Enero,Antártida,10,3,1,,4,"(4.697144,-74.140516)"
2022,Enero,Camerún,120,1,0,,1,"(0.814836,-77.662532)"
2022,Enero,Camerún,120,0,4,,4,"(4.697144,-74.140516)"
2022,Enero,Camerún,120,3,2,,5,"(6.171601,-75.427454)"
2022,Enero,Guernsey,831,0,1,,1,"(3.541112,-76.384584)"
2022,Enero,Canadá,124,424,371,,795,"(10.445761,-75.516429)"
2022,Enero,Canadá,124,84,92,,176,"(10.886611,-74.776708)"
2022,Enero,Canadá,124,0,1,,1,"(12.586067,-81.702563)"
2022,Enero,Canadá,124,266,215,,481,"(3.541112,-76.384584)"
2022,Enero,Canadá,124,16,8,,24,"(4.452882,-75.766298)"
2022,Enero,Canadá,124,3977,3746,,7723,"(4.697144,-74.140516)"
2022,Enero,Canadá,124,40,35,,75,"(4.815061,-75.736532)"
2022,Enero,Canadá,124,498,452,,950,"(6.171601,-75.427454)"
2022,Enero,Canadá,124,11,8,,19,"(7.128456,-73.183637)"
2022,Enero,Canadá,124,4,2,,6,"(7.927209,-72.507910)"
2022,Enero,Chad,148,2,1,,3,"(4.697144,-74.140516)"
2022,Enero,España,724,66,71,,137,"(10.445761,-75.516429)"
2022,Enero,España,724,70,29,,99,"(10.886611,-74.776708)"
2022,Enero,España,724,0,1,,1,"(12.586067,-81.702563)"
2022,Enero,España,724,2209,1511,,3720,"(3.541112,-76.384584)"
2022,Enero,España,724,3,3,,6,"(4.452882,-75.766298)"
2022,Enero,España,724,15927,11707,,27634,"(4.697144,-74.140516)"
2022,Enero,España,724,57,49,,106,"(4.815061,-75.736532)"
2022,Enero,España,724,1486,988,,2474,"(6.171601,-75.427454)"
2022,Enero,España,724,1,2,,3,"(7.128456,-73.183637)"
2022,Enero,España,724,1,0,,1,"(7.927209,-72.507910)"
2022,Enero,Colombia,170,30,51,,81,"(4.697144,-74.140516)"
2022,Enero,República Del Congo,178,0,2,,2,"(4.697144,-74.140516)"
2022,Enero,Comoras,174,0,1,,1,"(10.445761,-75.516429)"
2022,Enero,Isla Bouvet,74,1,0,,1,"(4.697144,-74.140516)"
2022,Enero,República Democrática del Congo,180,1,2,,3,"(4.697144,-74.140516)"
2022,Enero,República de Corea,410,16,13,,29,"(4.697144,-74.140516)"
2022,Enero,República de Corea,410,2,0,,2,"(6.171601,-75.427454)"
2022,Enero,Costa de Marfil,384,2,9,,11,"(4.697144,-74.140516)"
2022,Enero,Costa de Marfil,384,2,3,,5,"(6.171601,-75.427454)"
2022,Enero,Costa Rica,188,0,1,,1,"(0.814836,-77.662532)"
2022,Enero,Costa Rica,188,23,30,,53,"(10.445761,-75.516429)"
2022,Enero,Costa Rica,188,34,41,,75,"(10.886611,-74.776708)"
2022,Enero,Costa Rica,188,3,23,,26,"(12.5744111,-81.703935)"
2022,Enero,Costa Rica,188,156,164,,320,"(3.541112,-76.384584)"
2022,Enero,Costa Rica,188,10,7,,17,"(4.452882,-75.766298)"
2022,Enero,Costa Rica,188,1292,1243,,2535,"(4.697144,-74.140516)"
2022,Enero,Costa Rica,188,34,24,,58,"(4.815061,-75.736532)"
2022,Enero,Costa Rica,188,337,276,,613,"(6.171601,-75.427454)"
2022,Enero,Costa Rica,188,9,12,,21,"(7.128456,-73.183637)"
2022,Enero,Costa Rica,188,2,8,,10,"(7.927209,-72.507910)"
2022,Enero,Croacia,191,1,1,,2,"(10.445761,-75.516429)"
2022,Enero,Croacia,191,0,1,,1,"(3.541112,-76.384584)"
2022,Enero,Croacia,191,6,5,,11,"(4.697144,-74.140516)"
2022,Enero,Croacia,191,0,3,,3,"(6.171601,-75.427454)"
2022,Enero,Cuba,192,3,3,,6,"(10.445761,-75.516429)"
2022,Enero,Cuba,192,4,30,,34,"(10.886611,-74.776708)"
2022,Enero,Cuba,192,19,19,,38,"(3.541112,-76.384584)"
2022,Enero,Cuba,192,421,596,,1017,"(4.697144,-74.140516)"
2022,Enero,Cuba,192,5,2,,7,"(4.815061,-75.736532)"
2022,Enero,Cuba,192,6,10,,16,"(6.171601,-75.427454)"
2022,Enero,Cuba,192,3,1,,4,"(7.128456,-73.183637)"
2022,Enero,Curazao,99999,1,33,,34,"(10.445761,-75.516429)"
2022,Enero,Curazao,99999,75,42,,117,"(10.886611,-74.776708)"
2022,Enero,Curazao,99999,30,23,,53,"(3.541112,-76.384584)"
2022,Enero,Curazao,99999,1143,997,,2140,"(4.697144,-74.140516)"
2022,Enero,Curazao,99999,2,2,,4,"(4.815061,-75.736532)"
2022,Enero,Curazao,99999,137,129,,266,"(6.171601,-75.427454)"
2022,Enero,Curazao,99999,2,3,,5,"(7.128456,-73.183637)"
2022,Enero,República Checa,203,1,1,,2,"(10.445761,-75.516429)"
2022,Enero,República Checa,203,2,0,,2,"(3.541112,-76.384584)"
2022,Enero,República Checa,203,25,30,,55,"(4.697144,-74.140516)"
2022,Enero,República Checa,203,2,4,,6,"(6.171601,-75.427454)"
2022,Enero,Chile,152,18,20,,38,"(0.814836,-77.662532)"
2022,Enero,Chile,152,13,16,,29,"(10.445761,-75.516429)"
2022,Enero,Chile,152,35,35,,70,"(10.886611,-74.776708)"
2022,Enero,Chile,152,3124,2603,,5727,"(3.541112,-76.384584)"
2022,Enero,Chile,152,30,25,,55,"(4.452882,-75.766298)"
2022,Enero,Chile,152,6102,5021,,11123,"(4.697144,-74.140516)"
2022,Enero,Chile,152,41,27,,68,"(4.815061,-75.736532)"
2022,Enero,Chile,152,500,388,,888,"(6.171601,-75.427454)"
2022,Enero,Chile,152,6,6,,12,"(7.128456,-73.183637)"
2022,Enero,Chile,152,4,5,,9,"(7.927209,-72.507910)"
2022,Enero,China,156,1,0,,1,"(3.541112,-76.384584)"
2022,Enero,China,156,0,6,,6,"(4.697144,-74.140516)"
2022,Enero,China,156,0,1,,1,"(6.171601,-75.427454)"
2022,Enero,Chipre,196,1,0,,1,"(10.445761,-75.516429)"
2022,Enero,Chipre,196,2,1,,3,"(3.541112,-76.384584)"
2022,Enero,Chipre,196,4,8,,12,"(4.697144,-74.140516)"
2022,Enero,Chipre,196,0,1,,1,"(6.171601,-75.427454)"
2022,Enero,Dinamarca,208,7,2,,9,"(10.445761,-75.516429)"
2022,Enero,Dinamarca,208,10,6,,16,"(3.541112,-76.384584)"
2022,Enero,Dinamarca,208,58,66,,124,"(4.697144,-74.140516)"
2022,Enero,Dinamarca,208,0,1,,1,"(4.815061,-75.736532)"
2022,Enero,Dinamarca,208,9,4,,13,"(6.171601,-75.427454)"
2022,Enero,Dinamarca,208,1,0,,1,"(7.128456,-73.183637)"
2022,Enero,República de Yibuti,262,1,1,,2,"(4.697144,-74.140516)"
2022,Enero,Dominica,212,1,0,,1,"(0.814836,-77.662532)"
2022,Enero,Dominica,212,0,1,,1,"(10.886611,-74.776708)"
2022,Enero,Dominica,212,1,1,,2,"(3.541112,-76.384584)"
2022,Enero,Dominica,212,0,3,,3,"(4.697144,-74.140516)"
2022,Enero,Dominica,212,2,2,,4,"(6.171601,-75.427454)"
2022,Enero,Dominica,212,0,1,,1,"(7.927209,-72.507910)"
2022,Enero,Ecuador,218,0,17,,17,"(0.25129,-76.875963)"
2022,Enero,Ecuador,218,2064,3722,,5786,"(0.814836,-77.662532)"
2022,Enero,Ecuador,218,0,4,,4,"(1.813928,-78.763924)"
2022,Enero,Ecuador,218,8,8,,16,"(10.445761,-75.516429)"
2022,Enero,Ecuador,218,10,16,,26,"(10.886611,-74.776708)"
2022,Enero,Ecuador,218,34,50,,84,"(3.541112,-76.384584)"
2022,Enero,Ecuador,218,2776,3560,,6336,"(4.697144,-74.140516)"
2022,Enero,Ecuador,218,2,3,,5,"(4.815061,-75.736532)"
2022,Enero,Ecuador,218,64,75,,139,"(6.171601,-75.427454)"
2022,Enero,Ecuador,218,0,5,,5,"(6.228046,-77.404104)"
2022,Enero,Ecuador,218,1,3,,4,"(7.128456,-73.183637)"
2022,Enero,Ecuador,218,2,1,,3,"(7.927209,-72.507910)"
2022,Enero,Egipto,818,1,0,,1,"(0.814836,-77.662532)"
2022,Enero,Egipto,818,1,0,,1,"(10.445761,-75.516429)"
2022,Enero,Egipto,818,1,0,,1,"(10.886611,-74.776708)"
2022,Enero,Egipto,818,46,38,,84,"(4.697144,-74.140516)"
2022,Enero,Egipto,818,2,1,,3,"(6.171601,-75.427454)"
2022,Enero,El Salvador,222,0,7,,7,"(10.445761,-75.516429)"
2022,Enero,El Salvador,222,7,7,,14,"(10.886611,-74.776708)"
2022,Enero,El Salvador,222,9,38,,47,"(3.541112,-76.384584)"
2022,Enero,El Salvador,222,338,467,,805,"(4.697144,-74.140516)"
2022,Enero,El Salvador,222,3,1,,4,"(4.815061,-75.736532)"
2022,Enero,El Salvador,222,33,46,,79,"(6.171601,-75.427454)"
2022,Enero,El Salvador,222,1,3,,4,"(7.128456,-73.183637)"
2022,Enero,El Salvador,222,0,1,,1,"(7.927209,-72.507910)"
2022,Enero,Emiratos Árabes,784,12,12,,24,"(10.445761,-75.516429)"
2022,Enero,Emiratos Árabes,784,1,0,,1,"(10.886611,-74.776708)"
2022,Enero,Emiratos Árabes,784,7,6,,13,"(3.541112,-76.384584)"
2022,Enero,Emiratos Árabes,784,519,891,,1410,"(4.697144,-74.140516)"
2022,Enero,Emiratos Árabes,784,2,0,,2,"(4.815061,-75.736532)"
2022,Enero,Emiratos Árabes,784,43,37,,80,"(6.171601,-75.427454)"
2022,Enero,Eslovaquia,703,0,1,,1,"(3.541112,-76.384584)"
2022,Enero,Eslovaquia,703,6,10,,16,"(4.697144,-74.140516)"
2022,Enero,Eslovenia,705,1,2,,3,"(3.541112,-76.384584)"
2022,Enero,Eslovenia,705,2,1,,3,"(4.697144,-74.140516)"
2022,Enero,Eslovenia,705,0,1,,1,"(6.171601,-75.427454)"
2022,Enero,Estados Unidos de América,840,1,0,,1,"(0.814836,-77.662532)"
2022,Enero,Estados Unidos de América,840,3502,3044,,6546,"(10.445761,-75.516429)"
2022,Enero,Estados Unidos de América,840,5145,4473,,9618,"(10.886611,-74.776708)"
2022,Enero,Estados Unidos de América,840,5,15,,20,"(11.117806,-74.232622)"
2022,Enero,Estados Unidos de América,840,122,82,,204,"(12.586067,-81.702563)"
2022,Enero,Estados Unidos de América,840,11292,9177,,20469,"(3.541112,-76.384584)"
2022,Enero,Estados Unidos de América,840,1044,918,,1962,"(4.452882,-75.766298)"
2022,Enero,Estados Unidos de América,840,36726,31887,,68613,"(4.697144,-74.140516)"
2022,Enero,Estados Unidos de América,840,1848,1392,,3240,"(4.815061,-75.736532)"
2022,Enero,Estados Unidos de América,840,16186,13444,,29630,"(6.171601,-75.427454)"
2022,Enero,Estados Unidos de América,840,872,689,,1561,"(7.128456,-73.183637)"
2022,Enero,Estados Unidos de América,840,64,54,,118,"(7.927209,-72.507910)"
2022,Enero,Estonia,233,4,3,,7,"(4.697144,-74.140516)"
2022,Enero,Etiopia,231,1,5,,6,"(4.697144,-74.140516)"
2022,Enero,Filipinas,608,0,5,,5,"(4.697144,-74.140516)"
2022,Enero,Filipinas,608,1,0,,1,"(6.171601,-75.427454)"
2022,Enero,Finlandia,246,2,1,,3,"(10.445761,-75.516429)"
2022,Enero,Finlandia,246,1,0,,1,"(10.886611,-74.776708)"
2022,Enero,Finlandia,246,4,2,,6,"(3.541112,-76.384584)"
2022,Enero,Finlandia,246,40,26,,66,"(4.697144,-74.140516)"
2022,Enero,Finlandia,246,1,0,,1,"(6.171601,-75.427454)"
2022,Enero,Francia,250,1,0,,1,"(0.814836,-77.662532)"
2022,Enero,Francia,250,24,24,,48,"(10.445761,-75.516429)"
2022,Enero,Francia,250,14,11,,25,"(10.886611,-74.776708)"
2022,Enero,Francia,250,126,90,,216,"(3.541112,-76.384584)"
2022,Enero,Francia,250,5,3,,8,"(4.452882,-75.766298)"
2022,Enero,Francia,250,2187,1604,,3791,"(4.697144,-74.140516)"
2022,Enero,Francia,250,2,5,,7,"(4.815061,-75.736532)"
2022,Enero,Francia,250,161,123,,284,"(6.171601,-75.427454)"
2022,Enero,Francia,250,0,1,,1,"(7.128456,-73.183637)"
2022,Enero,Francia,250,0,1,,1,"(7.927209,-72.507910)"
2022,Enero,Gabón,266,0,1,,1,"(4.697144,-74.140516)"
2022,Enero,Georgia,268,2,0,,2,"(10.445761,-75.516429)"
2022,Enero,Georgia,268,0,1,,1,"(3.541112,-76.384584)"
2022,Enero,Georgia,268,3,5,,8,"(4.697144,-74.140516)"
2022,Enero,Georgia,268,2,0,,2,"(6.171601,-75.427454)"
2022,Enero,Ghana,288,4,5,,9,"(4.697144,-74.140516)"
2022,Enero,Ghana,288,2,2,,4,"(6.171601,-75.427454)"
2022,Enero,Gibraltar/Territorio Británico de Ultramar,292,1,0,,1,"(4.697144,-74.140516)"
2022,Enero,Gibraltar/Territorio Británico de Ultramar,292,1,0,,1,"(6.171601,-75.427454)"
2022,Enero,Granada,308,2,0,,2,"(4.697144,-74.140516)"
2022,Enero,Grecia,300,1,0,,1,"(3.541112,-76.384584)"
2022,Enero,Grecia,300,8,6,,14,"(4.697144,-74.140516)"
2022,Enero,Grecia,300,2,2,,4,"(6.171601,-75.427454)"
2022,Enero,Guatemala,320,12,6,,18,"(10.445761,-75.516429)"
2022,Enero,Guatemala,320,18,16,,34,"(10.886611,-74.776708)"
2022,Enero,Guatemala,320,71,106,,177,"(3.541112,-76.384584)"
2022,Enero,Guatemala,320,4,3,,7,"(4.452882,-75.766298)"
2022,Enero,Guatemala,320,547,631,,1178,"(4.697144,-74.140516)"
2022,Enero,Guatemala,320,24,13,,37,"(4.815061,-75.736532)"
2022,Enero,Guatemala,320,135,139,,274,"(6.171601,-75.427454)"
2022,Enero,Guatemala,320,5,7,,12,"(7.128456,-73.183637)"
2022,Enero,Guatemala,320,4,2,,6,"(7.927209,-72.507910)"
2022,Enero,Guyana,328,0,2,,2,"(10.445761,-75.516429)"
2022,Enero,Guyana,328,5,9,,14,"(10.886611,-74.776708)"
2022,Enero,Guyana,328,1,2,,3,"(3.541112,-76.384584)"
2022,Enero,Guyana,328,11,22,,33,"(4.697144,-74.140516)"
2022,Enero,Guyana,328,3,14,,17,"(6.171601,-75.427454)"
2022,Enero,Guyana,328,0,2,,2,"(7.128456,-73.183637)"
2022,Enero,Guinea,324,0,1,,1,"(10.886611,-74.776708)"
2022,Enero,Guinea,324,2,2,,4,"(4.697144,-74.140516)"
2022,Enero,Guinea Ecuatorial,226,0,3,,3,"(4.697144,-74.140516)"
2022,Enero,Guinea Bissau,624,2,0,,2,"(4.697144,-74.140516)"
2022,Enero,Guadalupe/Territorio Francés,312,2,1,,3,"(4.697144,-74.140516)"
2022,Enero,Guayana Francesa/Departamento de Ultramar Francés,254,0,5,,5,"(4.697144,-74.140516)"
2022,Enero,Haití,332,0,1,,1,"(10.445761,-75.516429)"
2022,Enero,Haití,332,0,2,,2,"(10.886611,-74.776708)"
2022,Enero,Haití,332,0,9,,9,"(4.697144,-74.140516)"
2022,Enero,Honduras,340,6,14,,20,"(10.445761,-75.516429)"
2022,Enero,Honduras,340,9,16,,25,"(10.886611,-74.776708)"
2022,Enero,Honduras,340,14,26,,40,"(3.541112,-76.384584)"
2022,Enero,Honduras,340,102,159,,261,"(4.697144,-74.140516)"
2022,Enero,Honduras,340,4,11,,15,"(4.815061,-75.736532)"
2022,Enero,Honduras,340,30,80,,110,"(6.171601,-75.427454)"
2022,Enero,Honduras,340,6,14,,20,"(7.128456,-73.183637)"
2022,Enero,Honduras,340,0,1,,1,"(7.927209,-72.507910)"
2022,Enero,Hong Kong,344,0,1,,1,"(3.541112,-76.384584)"
2022,Enero,Hong Kong,344,2,4,,6,"(4.697144,-74.140516)"
2022,Enero,Hong Kong,344,1,1,,2,"(6.171601,-75.427454)"
2022,Enero,Hungría,348,0,1,,1,"(10.886611,-74.776708)"
2022,Enero,Hungría,348,1,0,,1,"(3.541112,-76.384584)"
2022,Enero,Hungría,348,19,13,,32,"(4.697144,-74.140516)"
2022,Enero,Hungría,348,1,1,,2,"(6.171601,-75.427454)"
2022,Enero,India,356,13,10,,23,"(4.697144,-74.140516)"
2022,Enero,India,356,1,1,,2,"(6.171601,-75.427454)"
2022,Enero,Indonesia,360,2,1,,3,"(4.697144,-74.140516)"
2022,Enero,Iraq,368,0,1,,1,"(10.886611,-74.776708)"
2022,Enero,Iraq,368,0,4,,4,"(4.697144,-74.140516)"
2022,Enero,Iraq,368,0,1,,1,"(6.171601,-75.427454)"
2022,Enero,Irán,364,2,1,,3,"(4.697144,-74.140516)"
2022,Enero,República de Irlanda,372,3,1,,4,"(10.445761,-75.516429)"
2022,Enero,República de Irlanda,372,1,1,,2,"(10.886611,-74.776708)"
2022,Enero,República de Irlanda,372,5,4,,9,"(3.541112,-76.384584)"
2022,Enero,República de Irlanda,372,47,35,,82,"(4.697144,-74.140516)"
2022,Enero,República de Irlanda,372,4,3,,7,"(6.171601,-75.427454)"
2022,Enero,Islandia,352,2,0,,2,"(10.445761,-75.516429)"
2022,Enero,Islandia,352,9,8,,17,"(4.697144,-74.140516)"
2022,Enero,Israel,376,5,1,,6,"(10.445761,-75.516429)"
2022,Enero,Israel,376,10,10,,20,"(3.541112,-76.384584)"
2022,Enero,Israel,376,106,76,,182,"(4.697144,-74.140516)"
2022,Enero,Israel,376,3,3,,6,"(6.171601,-75.427454)"
2022,Enero,Italia,380,38,14,,52,"(10.445761,-75.516429)"
2022,Enero,Italia,380,4,5,,9,"(10.886611,-74.776708)"
2022,Enero,Italia,380,153,85,,238,"(3.541112,-76.384584)"
2022,Enero,Italia,380,1,1,,2,"(4.452882,-75.766298)"
2022,Enero,Italia,380,787,481,,1268,"(4.697144,-74.140516)"
2022,Enero,Italia,380,102,56,,158,"(6.171601,-75.427454)"
2022,Enero,Italia,380,0,1,,1,"(7.128456,-73.183637)"
2022,Enero,Islas Feroe/Región Autónoma de Dinamarca,234,0,2,,2,"(4.697144,-74.140516)"
2022,Enero,Jamaica,388,0,2,,2,"(10.408582,-75.538003)"
2022,Enero,Jamaica,388,4,5,,9,"(10.445761,-75.516429)"
2022,Enero,Jamaica,388,3,3,,6,"(10.886611,-74.776708)"
2022,Enero,Jamaica,388,12,9,,21,"(3.541112,-76.384584)"
2022,Enero,Jamaica,388,35,46,,81,"(4.697144,-74.140516)"
2022,Enero,Jamaica,388,4,5,,9,"(4.815061,-75.736532)"
2022,Enero,Jamaica,388,9,9,,18,"(6.171601,-75.427454)"
2022,Enero,Jamaica,388,0,12,,12,"(7.128456,-73.183637)"
2022,Enero,Jamaica,388,1,1,,2,"(7.927209,-72.507910)"
2022,Enero,Japón,392,0,1,,1,"(10.445761,-75.516429)"
2022,Enero,Japón,392,5,4,,9,"(3.541112,-76.384584)"
2022,Enero,Japón,392,14,18,,32,"(4.697144,-74.140516)"
2022,Enero,Japón,392,0,2,,2,"(6.171601,-75.427454)"
2022,Enero,Jordania,400,9,7,,16,"(4.697144,-74.140516)"
2022,Enero,Kazajistán,398,3,3,,6,"(4.697144,-74.140516)"
2022,Enero,Kenia,404,1,0,,1,"(10.445761,-75.516429)"
2022,Enero,Kenia,404,0,1,,1,"(3.541112,-76.384584)"
2022,Enero,Kenia,404,17,12,,29,"(4.697144,-74.140516)"
2022,Enero,Kuwait,414,1,0,,1,"(3.541112,-76.384584)"
2022,Enero,Kuwait,414,6,11,,17,"(4.697144,-74.140516)"
2022,Enero,Kuwait,414,1,0,,1,"(4.815061,-75.736532)"
2022,Enero,Kuwait,414,2,0,,2,"(6.171601,-75.427454)"
2022,Enero,República de Kosovo,901,1,0,,1,"(4.697144,-74.140516)"
2022,Enero,Lituania,440,1,0,,1,"(3.541112,-76.384584)"
2022,Enero,Lituania,440,8,3,,11,"(4.697144,-74.140516)"
2022,Enero,Lituania,440,0,1,,1,"(6.171601,-75.427454)"
2022,Enero,Líbano,422,0,1,,1,"(10.886611,-74.776708)"
2022,Enero,Líbano,422,2,0,,2,"(3.541112,-76.384584)"
2022,Enero,Líbano,422,5,10,,15,"(4.697144,-74.140516)"
2022,Enero,Libia,434,0,1,,1,"(4.697144,-74.140516)"
2022,Enero,Liechtenstein,438,1,1,,2,"(4.697144,-74.140516)"
2022,Enero,Luxemburgo,442,1,0,,1,"(10.445761,-75.516429)"
2022,Enero,Luxemburgo,442,3,2,,5,"(3.541112,-76.384584)"
2022,Enero,Luxemburgo,442,26,11,,37,"(4.697144,-74.140516)"
2022,Enero,Luxemburgo,442,2,1,,3,"(6.171601,-75.427454)"
2022,Enero,Madagascar,450,0,1,,1,"(6.171601,-75.427454)"
2022,Enero,Malasia,458,6,7,,13,"(4.697144,-74.140516)"
2022,Enero,Malasia,458,2,1,,3,"(6.171601,-75.427454)"
2022,Enero,Maldivas,462,1,0,,1,"(4.697144,-74.140516)"
2022,Enero,Maldivas,462,0,1,,1,"(6.171601,-75.427454)"
2022,Enero,Malí,466,3,4,,7,"(4.697144,-74.140516)"
2022,Enero,Malta,470,1,1,,2,"(10.445761,-75.516429)"
2022,Enero,Malta,470,2,1,,3,"(3.541112,-76.384584)"
2022,Enero,Malta,470,112,78,,190,"(4.697144,-74.140516)"
2022,Enero,Malta,470,5,7,,12,"(6.171601,-75.427454)"
2022,Enero,Marruecos,504,1,1,,2,"(4.697144,-74.140516)"
2022,Enero,Mauricio,480,1,0,,1,"(4.697144,-74.140516)"
2022,Enero,Mauritania,478,1,7,,8,"(4.697144,-74.140516)"
2022,Enero,Martinica/Departamento de Ultramar Francés,474,1,0,,1,"(10.445761,-75.516429)"
2022,Enero,Martinica/Departamento de Ultramar Francés,474,0,1,,1,"(4.697144,-74.140516)"
2022,Enero,México,484,111,95,,206,"(10.445761,-75.516429)"
2022,Enero,México,484,134,107,,241,"(10.886611,-74.776708)"
2022,Enero,México,484,2,2,,4,"(12.586067,-81.702563)"
2022,Enero,México,484,1305,1102,,2407,"(3.541112,-76.384584)"
2022,Enero,México,484,40,24,,64,"(4.452882,-75.766298)"
2022,Enero,México,484,22699,20875,,43574,"(4.697144,-74.140516)"
2022,Enero,México,484,99,97,,196,"(4.815061,-75.736532)"
2022,Enero,México,484,7265,6283,,13548,"(6.171601,-75.427454)"
2022,Enero,México,484,46,50,,96,"(7.128456,-73.183637)"
2022,Enero,México,484,63,45,,108,"(7.927209,-72.507910)"
2022,Enero,Mongolia,496,0,1,,1,"(4.697144,-74.140516)"
2022,Enero,Mongolia,496,2,2,,4,"(6.171601,-75.427454)"
2022,Enero,Montenegro,499,0,1,,1,"(4.697144,-74.140516)"
2022,Enero,Mozambique,508,1,0,,1,"(4.697144,-74.140516)"
2022,Enero,Namibia,516,1,1,,2,"(4.697144,-74.140516)"
2022,Enero,Nepal,524,0,1,,1,"(3.541112,-76.384584)"
2022,Enero,Nepal,524,0,1,,1,"(4.697144,-74.140516)"
2022,Enero,Nicaragua,558,0,1,,1,"(10.445761,-75.516429)"
2022,Enero,Nicaragua,558,2,1,,3,"(10.886611,-74.776708)"
2022,Enero,Nicaragua,558,1,4,,5,"(12.5744111,-81.703935)"
2022,Enero,Nicaragua,558,5,4,,9,"(3.541112,-76.384584)"
2022,Enero,Nicaragua,558,31,79,,110,"(4.697144,-74.140516)"
2022,Enero,Nicaragua,558,1,1,,2,"(4.815061,-75.736532)"
2022,Enero,Nicaragua,558,9,13,,22,"(6.171601,-75.427454)"
2022,Enero,Nicaragua,558,0,1,,1,"(7.927209,-72.507910)"
2022,Enero,Nigeria,566,0,6,,6,"(4.697144,-74.140516)"
2022,Enero,Nigeria,566,1,1,,2,"(6.171601,-75.427454)"
2022,Enero,Níger,562,2,0,,2,"(4.697144,-74.140516)"
2022,Enero,Noruega,578,9,8,,17,"(10.445761,-75.516429)"
2022,Enero,Noruega,578,5,3,,8,"(10.886611,-74.776708)"
2022,Enero,Noruega,578,13,7,,20,"(3.541112,-76.384584)"
2022,Enero,Noruega,578,74,75,,149,"(4.697144,-74.140516)"
2022,Enero,Noruega,578,3,1,,4,"(4.815061,-75.736532)"
2022,Enero,Noruega,578,13,7,,20,"(6.171601,-75.427454)"
2022,Enero,Nueva Zelanda,554,3,6,,9,"(4.697144,-74.140516)"
2022,Enero,Omán,512,8,10,,18,"(4.697144,-74.140516)"
2022,Enero,Omán,512,0,1,,1,"(6.171601,-75.427454)"
2022,Enero,Papúa Nueva Guinea,598,1,0,,1,"(4.697144,-74.140516)"
2022,Enero,Pakistán,586,3,3,,6,"(4.697144,-74.140516)"
2022,Enero,Panamá,591,16,81,,97,"(10.408582,-75.538003)"
2022,Enero,Panamá,591,1715,1140,,2855,"(10.445761,-75.516429)"
2022,Enero,Panamá,591,602,446,,1048,"(10.886611,-74.776708)"
2022,Enero,Panamá,591,0,4,,4,"(11.117806,-74.232622)"
2022,Enero,Panamá,591,1,0,,1,"(11.247723,-74.213989)"
2022,Enero,Panamá,591,3,15,,18,"(12.5744111,-81.703935)"
2022,Enero,Panamá,591,16,20,,36,"(12.586067,-81.702563)"
2022,Enero,Panamá,591,2195,1662,,3857,"(3.541112,-76.384584)"
2022,Enero,Panamá,591,154,92,,246,"(4.452882,-75.766298)"
2022,Enero,Panamá,591,5907,5798,,11705,"(4.697144,-74.140516)"
2022,Enero,Panamá,591,209,163,,372,"(4.815061,-75.736532)"
2022,Enero,Panamá,591,2398,2053,,4451,"(6.171601,-75.427454)"
2022,Enero,Panamá,591,0,6,,6,"(6.228046,-77.404104)"
2022,Enero,Panamá,591,14,15,,29,"(7.102626,-77.762647)"
2022,Enero,Panamá,591,105,107,,212,"(7.128456,-73.183637)"
2022,Enero,Panamá,591,97,65,,162,"(7.927209,-72.507910)"
2022,Enero,Panamá,591,29,65,,94,"(8.635765,-77.346578)"
2022,Enero,Paraguay,600,0,5,,5,"(10.445761,-75.516429)"
2022,Enero,Paraguay,600,2,5,,7,"(10.886611,-74.776708)"
2022,Enero,Paraguay,600,10,18,,28,"(3.541112,-76.384584)"
2022,Enero,Paraguay,600,2,1,,3,"(4.452882,-75.766298)"
2022,Enero,Paraguay,600,189,376,,565,"(4.697144,-74.140516)"
2022,Enero,Paraguay,600,3,2,,5,"(4.815061,-75.736532)"
2022,Enero,Paraguay,600,13,18,,31,"(6.171601,-75.427454)"
2022,Enero,Paraguay,600,0,1,,1,"(7.128456,-73.183637)"
2022,Enero,Perú,604,7,23,,30,"(-4.197703,-69.941278)"
2022,Enero,Perú,604,28,51,,79,"(0.814836,-77.662532)"
2022,Enero,Perú,604,5,13,,18,"(10.445761,-75.516429)"
2022,Enero,Perú,604,25,34,,59,"(10.886611,-74.776708)"
2022,Enero,Perú,604,56,59,,115,"(3.541112,-76.384584)"
2022,Enero,Perú,604,4,9,,13,"(4.452882,-75.766298)"
2022,Enero,Perú,604,3481,3920,,7401,"(4.697144,-74.140516)"
2022,Enero,Perú,604,12,9,,21,"(4.815061,-75.736532)"
2022,Enero,Perú,604,741,776,,1517,"(6.171601,-75.427454)"
2022,Enero,Perú,604,10,8,,18,"(7.128456,-73.183637)"
2022,Enero,Perú,604,8,3,,11,"(7.927209,-72.507910)"
2022,Enero,Polonia,616,0,3,,3,"(10.445761,-75.516429)"
2022,Enero,Polonia,616,23,31,,54,"(4.697144,-74.140516)"
2022,Enero,Polonia,616,0,1,,1,"(6.171601,-75.427454)"
2022,Enero,Portugal,620,2,3,,5,"(10.445761,-75.516429)"
2022,Enero,Portugal,620,3,2,,5,"(10.886611,-74.776708)"
2022,Enero,Portugal,620,10,9,,19,"(3.541112,-76.384584)"
2022,Enero,Portugal,620,109,113,,222,"(4.697144,-74.140516)"
2022,Enero,Portugal,620,1,1,,2,"(4.815061,-75.736532)"
2022,Enero,Portugal,620,20,18,,38,"(6.171601,-75.427454)"
2022,Enero,Polinesia Francesa/Colectividad de Ultramar Francesa,258,0,1,,1,"(3.541112,-76.384584)"
2022,Enero,Polinesia Francesa/Colectividad de Ultramar Francesa,258,0,2,,2,"(4.697144,-74.140516)"
2022,Enero,Puerto Rico/Territorio de Estados Unidos,630,20,13,,33,"(10.445761,-75.516429)"
2022,Enero,Puerto Rico/Territorio de Estados Unidos,630,33,17,,50,"(10.886611,-74.776708)"
2022,Enero,Puerto Rico/Territorio de Estados Unidos,630,0,1,,1,"(12.586067,-81.702563)"
2022,Enero,Puerto Rico/Territorio de Estados Unidos,630,71,33,,104,"(3.541112,-76.384584)"
2022,Enero,Puerto Rico/Territorio de Estados Unidos,630,3,3,,6,"(4.452882,-75.766298)"
2022,Enero,Puerto Rico/Territorio de Estados Unidos,630,555,446,,1001,"(4.697144,-74.140516)"
2022,Enero,Puerto Rico/Territorio de Estados Unidos,630,7,3,,10,"(4.815061,-75.736532)"
2022,Enero,Puerto Rico/Territorio de Estados Unidos,630,67,47,,114,"(6.171601,-75.427454)"
2022,Enero,Puerto Rico/Territorio de Estados Unidos,630,4,4,,8,"(7.128456,-73.183637)"
2022,Enero,Puerto Rico/Territorio de Estados Unidos,630,0,1,,1,"(7.927209,-72.507910)"
2022,Enero,Qatar,634,1,1,,2,"(10.445761,-75.516429)"
2022,Enero,Qatar,634,0,1,,1,"(10.886611,-74.776708)"
2022,Enero,Qatar,634,0,1,,1,"(12.586067,-81.702563)"
2022,Enero,Qatar,634,22,21,,43,"(4.697144,-74.140516)"
2022,Enero,Qatar,634,5,4,,9,"(6.171601,-75.427454)"
2022,Enero,Reino Unido de Gran Bretaña e Irlanda del Norte,826,16,10,,26,"(10.445761,-75.516429)"
2022,Enero,Reino Unido de Gran Bretaña e Irlanda del Norte,826,15,6,,21,"(10.886611,-74.776708)"
2022,Enero,Reino Unido de Gran Bretaña e Irlanda del Norte,826,218,186,,404,"(3.541112,-76.384584)"
2022,Enero,Reino Unido de Gran Bretaña e Irlanda del Norte,826,917,683,,1600,"(4.697144,-74.140516)"
2022,Enero,Reino Unido de Gran Bretaña e Irlanda del Norte,826,22,19,,41,"(4.815061,-75.736532)"
2022,Enero,Reino Unido de Gran Bretaña e Irlanda del Norte,826,138,96,,234,"(6.171601,-75.427454)"
2022,Enero,República CentroÁfricana,140,3,3,,6,"(4.697144,-74.140516)"
2022,Enero,Federación de Rusia,643,3,0,,3,"(10.445761,-75.516429)"
2022,Enero,Federación de Rusia,643,0,2,,2,"(3.541112,-76.384584)"
2022,Enero,Federación de Rusia,643,73,78,,151,"(4.697144,-74.140516)"
2022,Enero,Federación de Rusia,643,1,3,,4,"(6.171601,-75.427454)"
2022,Enero,República Dominicana,214,0,2,,2,"(10.408582,-75.538003)"
2022,Enero,República Dominicana,214,19,27,,46,"(10.445761,-75.516429)"
2022,Enero,República Dominicana,214,59,72,,131,"(10.886611,-74.776708)"
2022,Enero,República Dominicana,214,0,7,,7,"(11.117806,-74.232622)"
2022,Enero,República Dominicana,214,223,180,,403,"(3.541112,-76.384584)"
2022,Enero,República Dominicana,214,5,3,,8,"(4.452882,-75.766298)"
2022,Enero,República Dominicana,214,6143,5154,,11297,"(4.697144,-74.140516)"
2022,Enero,República Dominicana,214,40,37,,77,"(4.815061,-75.736532)"
2022,Enero,República Dominicana,214,2719,2231,,4950,"(6.171601,-75.427454)"
2022,Enero,República Dominicana,214,40,25,,65,"(7.128456,-73.183637)"
2022,Enero,República Dominicana,214,47,31,,78,"(7.927209,-72.507910)"
2022,Enero,Reunión,638,2,0,,2,"(4.697144,-74.140516)"
2022,Enero,República Democrática Popular de Corea,408,1,0,,1,"(4.697144,-74.140516)"
2022,Enero,Rumania,642,11,26,,37,"(4.697144,-74.140516)"
2022,Enero,Rwanda,646,1,0,,1,"(4.697144,-74.140516)"
2022,Enero,Sahara Occidental/Desierto Sahara,732,1,0,,1,"(4.697144,-74.140516)"
2022,Enero,San Cristóbal y Nevis,659,0,2,,2,"(7.818934,-72.453226)"
2022,Enero,San Marino,674,0,1,,1,"(4.697144,-74.140516)"
2022,Enero,Santa Elena/Territorio Británico de Ultramar,654,0,2,,2,"(0.814836,-77.662532)"
2022,Enero,Santa Elena/Territorio Británico de Ultramar,654,0,2,,2,"(7.818934,-72.453226)"
2022,Enero,Santa Lucia,662,1,1,,2,"(6.171601,-75.427454)"
2022,Enero,Santa Sede/Ciudad del Vaticano,336,2,0,,2,"(4.697144,-74.140516)"
2022,Enero,Senegal,686,2,2,,4,"(4.697144,-74.140516)"
2022,Enero,Senegal,686,2,1,,3,"(6.171601,-75.427454)"
2022,Enero,Serbia,688,4,2,,6,"(4.697144,-74.140516)"
2022,Enero,Singapur,702,0,1,,1,"(10.445761,-75.516429)"
2022,Enero,Singapur,702,1,1,,2,"(3.541112,-76.384584)"
2022,Enero,Singapur,702,7,9,,16,"(4.697144,-74.140516)"
2022,Enero,Somalia,706,0,1,,1,"(4.697144,-74.140516)"
2022,Enero,Sudáfrica,710,0,1,,1,"(3.541112,-76.384584)"
2022,Enero,Sudáfrica,710,7,7,,14,"(4.697144,-74.140516)"
2022,Enero,Sudáfrica,710,1,0,,1,"(6.171601,-75.427454)"
2022,Enero,Sudán,736,1,0,,1,"(4.697144,-74.140516)"
2022,Enero,Suecia,752,12,12,,24,"(10.445761,-75.516429)"
2022,Enero,Suecia,752,4,2,,6,"(10.886611,-74.776708)"
2022,Enero,Suecia,752,52,46,,98,"(3.541112,-76.384584)"
2022,Enero,Suecia,752,1,1,,2,"(4.452882,-75.766298)"
2022,Enero,Suecia,752,230,182,,412,"(4.697144,-74.140516)"
2022,Enero,Suecia,752,0,2,,2,"(4.815061,-75.736532)"
2022,Enero,Suecia,752,39,26,,65,"(6.171601,-75.427454)"
2022,Enero,Suiza,756,23,12,,35,"(10.445761,-75.516429)"
2022,Enero,Suiza,756,7,5,,12,"(10.886611,-74.776708)"
2022,Enero,Suiza,756,98,60,,158,"(3.541112,-76.384584)"
2022,Enero,Suiza,756,2,1,,3,"(4.452882,-75.766298)"
2022,Enero,Suiza,756,678,376,,1054,"(4.697144,-74.140516)"
2022,Enero,Suiza,756,3,2,,5,"(4.815061,-75.736532)"
2022,Enero,Suiza,756,67,39,,106,"(6.171601,-75.427454)"
2022,Enero,Suiza,756,1,0,,1,"(7.128456,-73.183637)"
2022,Enero,Surinam,740,0,1,,1,"(10.886611,-74.776708)"
2022,Enero,Surinam,740,0,1,,1,"(3.541112,-76.384584)"
2022,Enero,Surinam,740,3,6,,9,"(4.697144,-74.140516)"
2022,Enero,Surinam,740,3,0,,3,"(6.171601,-75.427454)"
2022,Enero,Taiwán,158,1,0,,1,"(4.697144,-74.140516)"
2022,Enero,República de Tayikistán,762,1,2,,3,"(4.697144,-74.140516)"
2022,Enero,Tailandia,764,7,16,,23,"(4.697144,-74.140516)"
2022,Enero,Tailandia,764,2,1,,3,"(6.171601,-75.427454)"
2022,Enero,Tanzania,834,0,2,,2,"(4.697144,-74.140516)"
2022,Enero,República Democrática de Timor Oriental,626,1,0,,1,"(4.697144,-74.140516)"
2022,Enero,República Democrática de Timor Oriental,626,0,1,,1,"(6.171601,-75.427454)"
2022,Enero,Togo,768,1,0,,1,"(4.697144,-74.140516)"
2022,Enero,Trinidad y Tobago,780,0,1,,1,"(10.445761,-75.516429)"
2022,Enero,Trinidad y Tobago,780,1,10,,11,"(3.541112,-76.384584)"
2022,Enero,Trinidad y Tobago,780,0,1,,1,"(4.452882,-75.766298)"
2022,Enero,Trinidad y Tobago,780,11,19,,30,"(4.697144,-74.140516)"
2022,Enero,Trinidad y Tobago,780,15,5,,20,"(6.171601,-75.427454)"
2022,Enero,Túnez,788,1,1,,2,"(4.697144,-74.140516)"
2022,Enero,Túnez,788,0,1,,1,"(6.171601,-75.427454)"
2022,Enero,Turquía,792,4,2,,6,"(10.445761,-75.516429)"
2022,Enero,Turquía,792,0,1,,1,"(3.541112,-76.384584)"
2022,Enero,Turquía,792,812,698,,1510,"(4.697144,-74.140516)"
2022,Enero,Turquía,792,3,3,,6,"(6.171601,-75.427454)"
2022,Enero,Turkmenistán,795,3,2,,5,"(4.697144,-74.140516)"
2022,Enero,Ucrania,804,0,1,,1,"(10.445761,-75.516429)"
2022,Enero,Ucrania,804,1,4,,5,"(3.541112,-76.384584)"
2022,Enero,Ucrania,804,7,17,,24,"(4.697144,-74.140516)"
2022,Enero,Ucrania,804,1,0,,1,"(6.171601,-75.427454)"
2022,Enero,Uganda,800,2,2,,4,"(4.697144,-74.140516)"
2022,Enero,Uruguay,858,2,0,,2,"(10.445761,-75.516429)"
2022,Enero,Uruguay,858,4,3,,7,"(10.886611,-74.776708)"
2022,Enero,Uruguay,858,23,27,,50,"(3.541112,-76.384584)"
2022,Enero,Uruguay,858,0,4,,4,"(4.452882,-75.766298)"
2022,Enero,Uruguay,858,280,354,,634,"(4.697144,-74.140516)"
2022,Enero,Uruguay,858,10,6,,16,"(4.815061,-75.736532)"
2022,Enero,Uruguay,858,24,23,,47,"(6.171601,-75.427454)"
2022,Enero,Uruguay,858,1,0,,1,"(7.128456,-73.183637)"
2022,Enero,Uruguay,858,1,4,,5,"(7.927209,-72.507910)"
2022,Enero,Venezuela,862,9,8,,17,"(10.445761,-75.516429)"
2022,Enero,Venezuela,862,36,34,,70,"(10.886611,-74.776708)"
2022,Enero,Venezuela,862,143,266,,409,"(11.360009,-72.129330)"
2022,Enero,Venezuela,862,25,25,,50,"(3.541112,-76.384584)"
2022,Enero,Venezuela,862,2,1,,3,"(4.452882,-75.766298)"
2022,Enero,Venezuela,862,147,187,,334,"(4.697144,-74.140516)"
2022,Enero,Venezuela,862,3,14,,17,"(4.815061,-75.736532)"
2022,Enero,Venezuela,862,65,57,,122,"(6.171601,-75.427454)"
2022,Enero,Venezuela,862,0,2,,2,"(6.185799,-67.483929)"
2022,Enero,Venezuela,862,8,8,,16,"(7.088729,-70.740253)"
2022,Enero,Venezuela,862,3,4,,7,"(7.128456,-73.183637)"
2022,Enero,Venezuela,862,302,449,,751,"(7.818934,-72.453226)"
2022,Enero,Venezuela,862,48,67,,115,"(7.916725,-72.462544)"
2022,Enero,Venezuela,862,2,0,,2,"(7.927209,-72.507910)"
2022,Enero,Venezuela,862,23,14,,37,"(8.36068,-72.409396)"
2022,Enero,Vietnam,704,0,4,,4,"(4.697144,-74.140516)"
2022,Enero,Vietnam,704,0,1,,1,"(6.171601,-75.427454)"
2022,Enero,Islas Vírgenes Británicas/Territorio Británico de Ultramar,92,0,1,,1,"(3.541112,-76.384584)"
2022,Enero,Islas Vírgenes Británicas/Territorio Británico de Ultramar,92,1,4,,5,"(4.697144,-74.140516)"
2022,Enero,Islas Vírgenes Británicas/Territorio Británico de Ultramar,92,0,2,,2,"(6.171601,-75.427454)"
2022,Enero,Islas Vírgenes Estadounidenses/Territorio de Estados Unidos,850,0,1,,1,"(4.697144,-74.140516)"
2022,Enero,República Árabe de Yemen,887,0,1,,1,"(6.171601,-75.427454)"
2022,Enero,Zambia,894,0,1,,1,"(4.697144,-74.140516)"
2022,Enero,Anguila/Territorio Británico de Ultramar,660,2,2,,4,"(3.541112,-76.384584)"
2022,Enero,Anguila/Territorio Británico de Ultramar,660,0,1,,1,"(4.697144,-74.140516)"
2022,Enero,Islas Turcas y Caicos/Territorio Británico de Ultramar,796,2,8,,10,"(10.445761,-75.516429)"
2022,Enero,Islas Turcas y Caicos/Territorio Británico de Ultramar,796,0,1,,1,"(3.541112,-76.384584)"
2022,Enero,Islas Turcas y Caicos/Territorio Británico de Ultramar,796,7,7,,14,"(4.697144,-74.140516)"
2022,Enero,Islas Turcas y Caicos/Territorio Británico de Ultramar,796,1,0,,1,"(6.171601,-75.427454)"
2022,Enero,Desconocido,99999,1,0,,1,"(4.697144,-74.140516)"
2022,Febrero,Afganistán,4,1,0,,1,"(3.541112,-76.384584)"
2022,Febrero,Afganistán,4,0,1,,1,"(4.697144,-74.140516)"
2022,Febrero,Albania,8,0,1,,1,"(10.445761,-75.516429)"
2022,Febrero,Albania,8,2,4,,6,"(4.697144,-74.140516)"
2022,Febrero,Alemania,276,47,20,,67,"(10.445761,-75.516429)"
2022,Febrero,Alemania,276,3,3,,6,"(10.886611,-74.776708)"
2022,Febrero,Alemania,276,49,19,,68,"(3.541112,-76.384584)"
2022,Febrero,Alemania,276,929,612,,1541,"(4.697144,-74.140516)"
2022,Febrero,Alemania,276,1,1,,2,"(4.815061,-75.736532)"
2022,Febrero,Alemania,276,50,50,,100,"(6.171601,-75.427454)"
2022,Febrero,Andorra,20,6,4,,10,"(4.697144,-74.140516)"
2022,Febrero,Angola,24,4,11,,15,"(4.697144,-74.140516)"
2022,Febrero,Antigua y Barbuda,28,0,1,,1,"(4.697144,-74.140516)"
2022,Febrero,Países Bajos,528,118,86,,204,"(10.445761,-75.516429)"
2022,Febrero,Países Bajos,528,15,13,,28,"(10.886611,-74.776708)"
2022,Febrero,Países Bajos,528,47,34,,81,"(3.541112,-76.384584)"
2022,Febrero,Países Bajos,528,783,639,,1422,"(4.697144,-74.140516)"
2022,Febrero,Países Bajos,528,0,1,,1,"(4.815061,-75.736532)"
2022,Febrero,Países Bajos,528,61,45,,106,"(6.171601,-75.427454)"
2022,Febrero,Arabia Saudita,682,0,1,,1,"(10.886611,-74.776708)"
2022,Febrero,Arabia Saudita,682,2,0,,2,"(3.541112,-76.384584)"
2022,Febrero,Arabia Saudita,682,11,31,,42,"(4.697144,-74.140516)"
2022,Febrero,Arabia Saudita,682,0,2,,2,"(6.171601,-75.427454)"
2022,Febrero,Arabia Saudita,682,0,1,,1,"(7.927209,-72.507910)"
2022,Febrero,Argelia,12,0,4,,4,"(4.697144,-74.140516)"
2022,Febrero,Argentina,32,12,12,,24,"(0.814836,-77.662532)"
2022,Febrero,Argentina,32,12,7,,19,"(10.445761,-75.516429)"
2022,Febrero,Argentina,32,9,11,,20,"(10.886611,-74.776708)"
2022,Febrero,Argentina,32,99,72,,171,"(3.541112,-76.384584)"
2022,Febrero,Argentina,32,36,37,,73,"(4.452882,-75.766298)"
2022,Febrero,Argentina,32,2704,2114,,4818,"(4.697144,-74.140516)"
2022,Febrero,Argentina,32,2,3,,5,"(4.815061,-75.736532)"
2022,Febrero,Argentina,32,63,80,,143,"(6.171601,-75.427454)"
2022,Febrero,Argentina,32,9,4,,13,"(7.128456,-73.183637)"
2022,Febrero,Argentina,32,21,16,,37,"(7.927209,-72.507910)"
2022,Febrero,República de Armenia,51,3,0,,3,"(4.697144,-74.140516)"
2022,Febrero,Aruba,533,0,2,,2,"(10.408582,-75.538003)"
2022,Febrero,Aruba,533,81,58,,139,"(10.886611,-74.776708)"
2022,Febrero,Aruba,533,1,0,,1,"(11.247723,-74.213989)"
2022,Febrero,Aruba,533,70,42,,112,"(3.541112,-76.384584)"
2022,Febrero,Aruba,533,1062,797,,1859,"(4.697144,-74.140516)"
2022,Febrero,Aruba,533,5,5,,10,"(4.815061,-75.736532)"
2022,Febrero,Aruba,533,102,94,,196,"(6.171601,-75.427454)"
2022,Febrero,Aruba,533,11,18,,29,"(7.128456,-73.183637)"
2022,Febrero,Australia,36,2,4,,6,"(10.445761,-75.516429)"
2022,Febrero,Australia,36,6,1,,7,"(10.886611,-74.776708)"
2022,Febrero,Australia,36,12,7,,19,"(3.541112,-76.384584)"
2022,Febrero,Australia,36,253,228,,481,"(4.697144,-74.140516)"
2022,Febrero,Australia,36,1,1,,2,"(4.815061,-75.736532)"
2022,Febrero,Australia,36,38,22,,60,"(6.171601,-75.427454)"
2022,Febrero,Australia,36,1,1,,2,"(7.128456,-73.183637)"
2022,Febrero,Austria,40,1,4,,5,"(10.445761,-75.516429)"
2022,Febrero,Austria,40,1,0,,1,"(10.886611,-74.776708)"
2022,Febrero,Austria,40,8,3,,11,"(3.541112,-76.384584)"
2022,Febrero,Austria,40,80,46,,126,"(4.697144,-74.140516)"
2022,Febrero,Austria,40,1,0,,1,"(4.815061,-75.736532)"
2022,Febrero,Austria,40,5,3,,8,"(6.171601,-75.427454)"
2022,Febrero,Azerbaiyán,31,3,3,,6,"(4.697144,-74.140516)"
2022,Febrero,Bahamas,44,1,1,,2,"(10.445761,-75.516429)"
2022,Febrero,Bahamas,44,2,3,,5,"(10.886611,-74.776708)"
2022,Febrero,Bahamas,44,25,12,,37,"(3.541112,-76.384584)"
2022,Febrero,Bahamas,44,23,25,,48,"(4.697144,-74.140516)"
2022,Febrero,Bahamas,44,4,3,,7,"(4.815061,-75.736532)"
2022,Febrero,Bahamas,44,18,12,,30,"(6.171601,-75.427454)"
2022,Febrero,Bahréin,48,0,1,,1,"(3.541112,-76.384584)"
2022,Febrero,Bahréin,48,8,4,,12,"(4.697144,-74.140516)"
2022,Febrero,Bahréin,48,0,1,,1,"(6.171601,-75.427454)"
2022,Febrero,Bangladesh,50,2,3,,5,"(4.697144,-74.140516)"
2022,Febrero,Barbados,52,1,4,,5,"(3.541112,-76.384584)"
2022,Febrero,Barbados,52,4,19,,23,"(4.697144,-74.140516)"
2022,Febrero,Bélgica,56,4,1,,5,"(10.445761,-75.516429)"
2022,Febrero,Bélgica,56,1,2,,3,"(10.886611,-74.776708)"
2022,Febrero,Bélgica,56,26,11,,37,"(3.541112,-76.384584)"
2022,Febrero,Bélgica,56,108,80,,188,"(4.697144,-74.140516)"
2022,Febrero,Bélgica,56,0,1,,1,"(4.815061,-75.736532)"
2022,Febrero,Bélgica,56,32,22,,54,"(6.171601,-75.427454)"
2022,Febrero,Belice,84,0,2,,2,"(10.445761,-75.516429)"
2022,Febrero,Belice,84,1,1,,2,"(10.886611,-74.776708)"
2022,Febrero,Belice,84,1,4,,5,"(3.541112,-76.384584)"
2022,Febrero,Belice,84,3,5,,8,"(4.697144,-74.140516)"
2022,Febrero,Belice,84,4,5,,9,"(6.171601,-75.427454)"
2022,Febrero,Bermudas/Territorio Británico de Ultramar,60,1,1,,2,"(4.697144,-74.140516)"
2022,Febrero,Bolivia,68,4,3,,7,"(0.814836,-77.662532)"
2022,Febrero,Bolivia,68,2,2,,4,"(10.445761,-75.516429)"
2022,Febrero,Bolivia,68,0,4,,4,"(10.886611,-74.776708)"
2022,Febrero,Bolivia,68,13,18,,31,"(3.541112,-76.384584)"
2022,Febrero,Bolivia,68,5,5,,10,"(4.452882,-75.766298)"
2022,Febrero,Bolivia,68,385,638,,1023,"(4.697144,-74.140516)"
2022,Febrero,Bolivia,68,8,4,,12,"(4.815061,-75.736532)"
2022,Febrero,Bolivia,68,6,34,,40,"(6.171601,-75.427454)"
2022,Febrero,Bolivia,68,0,1,,1,"(7.128456,-73.183637)"
2022,Febrero,Bolivia,68,1,1,,2,"(7.927209,-72.507910)"
2022,Febrero,Bosnia y Herzegovina,70,0,1,,1,"(4.697144,-74.140516)"
2022,Febrero,Brasil,76,203,328,,531,"(-4.197703,-69.941278)"
2022,Febrero,Brasil,76,0,1,,1,"(0.814836,-77.662532)"
2022,Febrero,Brasil,76,15,33,,48,"(10.445761,-75.516429)"
2022,Febrero,Brasil,76,28,27,,55,"(10.886611,-74.776708)"
2022,Febrero,Brasil,76,155,238,,393,"(3.541112,-76.384584)"
2022,Febrero,Brasil,76,35,53,,88,"(4.452882,-75.766298)"
2022,Febrero,Brasil,76,2003,2811,,4814,"(4.697144,-74.140516)"
2022,Febrero,Brasil,76,43,66,,109,"(4.815061,-75.736532)"
2022,Febrero,Brasil,76,184,201,,385,"(6.171601,-75.427454)"
2022,Febrero,Brasil,76,13,14,,27,"(7.128456,-73.183637)"
2022,Febrero,Brasil,76,7,12,,19,"(7.927209,-72.507910)"
2022,Febrero,Bulgaria,100,3,4,,7,"(4.697144,-74.140516)"
2022,Febrero,Bulgaria,100,1,0,,1,"(6.171601,-75.427454)"
2022,Febrero,Burkina Faso,854,1,1,,2,"(4.697144,-74.140516)"
2022,Febrero,Cabo Verde,132,2,0,,2,"(4.697144,-74.140516)"
2022,Febrero,Islas Caimán/Territorio Británico de Ultramar,136,1,1,,2,"(10.445761,-75.516429)"
2022,Febrero,Islas Caimán/Territorio Británico de Ultramar,136,1,0,,1,"(10.886611,-74.776708)"
2022,Febrero,Islas Caimán/Territorio Británico de Ultramar,136,2,3,,5,"(12.586067,-81.702563)"
2022,Febrero,Islas Caimán/Territorio Británico de Ultramar,136,5,2,,7,"(3.541112,-76.384584)"
2022,Febrero,Islas Caimán/Territorio Británico de Ultramar,136,2,2,,4,"(6.171601,-75.427454)"
2022,Febrero,Camboya,116,1,0,,1,"(4.697144,-74.140516)"
2022,Febrero,Camerún,120,0,3,,3,"(4.697144,-74.140516)"
2022,Febrero,Canadá,124,131,99,,230,"(10.445761,-75.516429)"
2022,Febrero,Canadá,124,48,31,,79,"(10.886611,-74.776708)"
2022,Febrero,Canadá,124,1,0,,1,"(12.586067,-81.702563)"
2022,Febrero,Canadá,124,123,111,,234,"(3.541112,-76.384584)"
2022,Febrero,Canadá,124,8,4,,12,"(4.452882,-75.766298)"
2022,Febrero,Canadá,124,2448,2177,,4625,"(4.697144,-74.140516)"
2022,Febrero,Canadá,124,15,15,,30,"(4.815061,-75.736532)"
2022,Febrero,Canadá,124,230,215,,445,"(6.171601,-75.427454)"
2022,Febrero,Canadá,124,0,3,,3,"(7.128456,-73.183637)"
2022,Febrero,Canadá,124,1,1,,2,"(7.927209,-72.507910)"
2022,Febrero,Chad,148,1,0,,1,"(3.541112,-76.384584)"
2022,Febrero,Chad,148,3,0,,3,"(4.697144,-74.140516)"
2022,Febrero,España,724,73,57,,130,"(10.445761,-75.516429)"
2022,Febrero,España,724,31,21,,52,"(10.886611,-74.776708)"
2022,Febrero,España,724,2775,2067,,4842,"(3.541112,-76.384584)"
2022,Febrero,España,724,3,3,,6,"(4.452882,-75.766298)"
2022,Febrero,España,724,18315,14911,,33226,"(4.697144,-74.140516)"
2022,Febrero,España,724,33,34,,67,"(4.815061,-75.736532)"
2022,Febrero,España,724,1540,1068,,2608,"(6.171601,-75.427454)"
2022,Febrero,España,724,0,2,,2,"(7.128456,-73.183637)"
2022,Febrero,Norfolk,574,0,2,,2,"(4.697144,-74.140516)"
2022,Febrero,Colombia,170,27,85,,112,"(4.697144,-74.140516)"
2022,Febrero,República Del Congo,178,0,1,,1,"(4.697144,-74.140516)"
2022,Febrero,Comoras,174,1,0,,1,"(4.697144,-74.140516)"
2022,Febrero,Comoras,174,1,0,,1,"(6.171601,-75.427454)"
2022,Febrero,República Democrática del Congo,180,0,1,,1,"(4.697144,-74.140516)"
2022,Febrero,República Democrática del Congo,180,1,0,,1,"(6.171601,-75.427454)"
2022,Febrero,República de Corea,410,1,0,,1,"(10.445761,-75.516429)"
2022,Febrero,República de Corea,410,1,1,,2,"(3.541112,-76.384584)"
2022,Febrero,República de Corea,410,22,9,,31,"(4.697144,-74.140516)"
2022,Febrero,República de Corea,410,0,1,,1,"(4.815061,-75.736532)"
2022,Febrero,República de Corea,410,1,0,,1,"(6.171601,-75.427454)"
2022,Febrero,Costa de Marfil,384,0,1,,1,"(10.445761,-75.516429)"
2022,Febrero,Costa de Marfil,384,1,4,,5,"(4.697144,-74.140516)"
2022,Febrero,Costa Rica,188,15,12,,27,"(10.445761,-75.516429)"
2022,Febrero,Costa Rica,188,17,23,,40,"(10.886611,-74.776708)"
2022,Febrero,Costa Rica,188,1,6,,7,"(12.5744111,-81.703935)"
2022,Febrero,Costa Rica,188,0,2,,2,"(12.586067,-81.702563)"
2022,Febrero,Costa Rica,188,87,77,,164,"(3.541112,-76.384584)"
2022,Febrero,Costa Rica,188,4,4,,8,"(4.452882,-75.766298)"
2022,Febrero,Costa Rica,188,936,899,,1835,"(4.697144,-74.140516)"
2022,Febrero,Costa Rica,188,21,16,,37,"(4.815061,-75.736532)"
2022,Febrero,Costa Rica,188,197,174,,371,"(6.171601,-75.427454)"
2022,Febrero,Costa Rica,188,6,3,,9,"(7.128456,-73.183637)"
2022,Febrero,Croacia,191,0,1,,1,"(3.541112,-76.384584)"
2022,Febrero,Croacia,191,9,6,,15,"(4.697144,-74.140516)"
2022,Febrero,Cuba,192,4,24,,28,"(10.886611,-74.776708)"
2022,Febrero,Cuba,192,15,13,,28,"(3.541112,-76.384584)"
2022,Febrero,Cuba,192,0,1,,1,"(4.452882,-75.766298)"
2022,Febrero,Cuba,192,285,308,,593,"(4.697144,-74.140516)"
2022,Febrero,Cuba,192,5,3,,8,"(4.815061,-75.736532)"
2022,Febrero,Cuba,192,9,13,,22,"(6.171601,-75.427454)"
2022,Febrero,Cuba,192,1,0,,1,"(7.128456,-73.183637)"
2022,Febrero,Curazao,99999,46,29,,75,"(10.886611,-74.776708)"
2022,Febrero,Curazao,99999,28,13,,41,"(3.541112,-76.384584)"
2022,Febrero,Curazao,99999,651,556,,1207,"(4.697144,-74.140516)"
2022,Febrero,Curazao,99999,73,77,,150,"(6.171601,-75.427454)"
2022,Febrero,Curazao,99999,1,0,,1,"(7.128456,-73.183637)"
2022,Febrero,República Checa,203,1,4,,5,"(10.445761,-75.516429)"
2022,Febrero,República Checa,203,2,2,,4,"(3.541112,-76.384584)"
2022,Febrero,República Checa,203,15,19,,34,"(4.697144,-74.140516)"
2022,Febrero,República Checa,203,1,1,,2,"(6.171601,-75.427454)"
2022,Febrero,Chile,152,20,32,,52,"(0.814836,-77.662532)"
2022,Febrero,Chile,152,17,9,,26,"(10.445761,-75.516429)"
2022,Febrero,Chile,152,34,27,,61,"(10.886611,-74.776708)"
2022,Febrero,Chile,152,3,2,,5,"(12.586067,-81.702563)"
2022,Febrero,Chile,152,3036,2131,,5167,"(3.541112,-76.384584)"
2022,Febrero,Chile,152,60,47,,107,"(4.452882,-75.766298)"
2022,Febrero,Chile,152,4932,3855,,8787,"(4.697144,-74.140516)"
2022,Febrero,Chile,152,18,25,,43,"(4.815061,-75.736532)"
2022,Febrero,Chile,152,508,369,,877,"(6.171601,-75.427454)"
2022,Febrero,Chile,152,5,7,,12,"(7.128456,-73.183637)"
2022,Febrero,Chile,152,8,4,,12,"(7.927209,-72.507910)"
2022,Febrero,China,156,0,1,,1,"(10.445761,-75.516429)"
2022,Febrero,China,156,3,1,,4,"(4.697144,-74.140516)"
2022,Febrero,Chipre,196,0,1,,1,"(10.445761,-75.516429)"
2022,Febrero,Chipre,196,1,1,,2,"(3.541112,-76.384584)"
2022,Febrero,Chipre,196,3,5,,8,"(4.697144,-74.140516)"
2022,Febrero,Chipre,196,0,1,,1,"(6.171601,-75.427454)"
2022,Febrero,Dinamarca,208,3,2,,5,"(10.445761,-75.516429)"
2022,Febrero,Dinamarca,208,10,5,,15,"(3.541112,-76.384584)"
2022,Febrero,Dinamarca,208,38,22,,60,"(4.697144,-74.140516)"
2022,Febrero,Dinamarca,208,4,2,,6,"(6.171601,-75.427454)"
2022,Febrero,Dominica,212,0,1,,1,"(10.445761,-75.516429)"
2022,Febrero,Dominica,212,1,0,,1,"(4.697144,-74.140516)"
2022,Febrero,Ecuador,218,0,1,,1,"(-0.193180,-74.784874)"
2022,Febrero,Ecuador,218,0,6,,6,"(0.25129,-76.875963)"
2022,Febrero,Ecuador,218,2004,4026,,6030,"(0.814836,-77.662532)"
2022,Febrero,Ecuador,218,5,11,,16,"(10.445761,-75.516429)"
2022,Febrero,Ecuador,218,5,7,,12,"(10.886611,-74.776708)"
2022,Febrero,Ecuador,218,1,0,,1,"(12.586067,-81.702563)"
2022,Febrero,Ecuador,218,50,72,,122,"(3.541112,-76.384584)"
2022,Febrero,Ecuador,218,3,0,,3,"(4.452882,-75.766298)"
2022,Febrero,Ecuador,218,2009,2988,,4997,"(4.697144,-74.140516)"
2022,Febrero,Ecuador,218,4,7,,11,"(4.815061,-75.736532)"
2022,Febrero,Ecuador,218,0,7,,7,"(6.17134,-75.427194)"
2022,Febrero,Ecuador,218,61,96,,157,"(6.171601,-75.427454)"
2022,Febrero,Ecuador,218,2,4,,6,"(7.128456,-73.183637)"
2022,Febrero,Egipto,818,3,0,,3,"(3.541112,-76.384584)"
2022,Febrero,Egipto,818,70,33,,103,"(4.697144,-74.140516)"
2022,Febrero,Egipto,818,5,0,,5,"(6.171601,-75.427454)"
2022,Febrero,El Salvador,222,1,5,,6,"(10.445761,-75.516429)"
2022,Febrero,El Salvador,222,2,4,,6,"(10.886611,-74.776708)"
2022,Febrero,El Salvador,222,31,29,,60,"(3.541112,-76.384584)"
2022,Febrero,El Salvador,222,272,374,,646,"(4.697144,-74.140516)"
2022,Febrero,El Salvador,222,3,3,,6,"(4.815061,-75.736532)"
2022,Febrero,El Salvador,222,17,19,,36,"(6.171601,-75.427454)"
2022,Febrero,El Salvador,222,1,4,,5,"(7.128456,-73.183637)"
2022,Febrero,Emiratos Árabes,784,9,4,,13,"(10.445761,-75.516429)"
2022,Febrero,Emiratos Árabes,784,6,5,,11,"(3.541112,-76.384584)"
2022,Febrero,Emiratos Árabes,784,262,404,,666,"(4.697144,-74.140516)"
2022,Febrero,Emiratos Árabes,784,4,1,,5,"(4.815061,-75.736532)"
2022,Febrero,Emiratos Árabes,784,10,8,,18,"(6.171601,-75.427454)"
2022,Febrero,Eritrea,232,0,1,,1,"(3.541112,-76.384584)"
2022,Febrero,Eslovaquia,703,0,3,,3,"(4.697144,-74.140516)"
2022,Febrero,Eslovenia,705,2,2,,4,"(4.697144,-74.140516)"
2022,Febrero,Estados Unidos de América,840,0,2,,2,"(10.408582,-75.538003)"
2022,Febrero,Estados Unidos de América,840,2173,1637,,3810,"(10.445761,-75.516429)"
2022,Febrero,Estados Unidos de América,840,3720,2979,,6700,"(10.886611,-74.776708)"
2022,Febrero,Estados Unidos de América,840,1,3,,4,"(11.117806,-74.232622)"
2022,Febrero,Estados Unidos de América,840,63,60,,123,"(12.586067,-81.702563)"
2022,Febrero,Estados Unidos de América,840,7839,5865,,13704,"(3.541112,-76.384584)"
2022,Febrero,Estados Unidos de América,840,755,640,,1395,"(4.452882,-75.766298)"
2022,Febrero,Estados Unidos de América,840,26779,23410,,50189,"(4.697144,-74.140516)"
2022,Febrero,Estados Unidos de América,840,1617,1213,,2830,"(4.815061,-75.736532)"
2022,Febrero,Estados Unidos de América,840,9335,7580,,16915,"(6.171601,-75.427454)"
2022,Febrero,Estados Unidos de América,840,604,500,,1104,"(7.128456,-73.183637)"
2022,Febrero,Estados Unidos de América,840,44,41,,85,"(7.927209,-72.507910)"
2022,Febrero,Estonia,233,4,11,,15,"(4.697144,-74.140516)"
2022,Febrero,Etiopia,231,3,13,,16,"(4.697144,-74.140516)"
2022,Febrero,Filipinas,608,1,0,,1,"(10.445761,-75.516429)"
2022,Febrero,Filipinas,608,1,7,,8,"(4.697144,-74.140516)"
2022,Febrero,Filipinas,608,2,0,,2,"(6.171601,-75.427454)"
2022,Febrero,Finlandia,246,1,1,,2,"(10.445761,-75.516429)"
2022,Febrero,Finlandia,246,3,1,,4,"(3.541112,-76.384584)"
2022,Febrero,Finlandia,246,24,10,,34,"(4.697144,-74.140516)"
2022,Febrero,Finlandia,246,2,4,,6,"(6.171601,-75.427454)"
2022,Febrero,Francia,250,18,16,,34,"(10.445761,-75.516429)"
2022,Febrero,Francia,250,3,7,,10,"(10.886611,-74.776708)"
2022,Febrero,Francia,250,0,1,,1,"(12.586067,-81.702563)"
2022,Febrero,Francia,250,83,42,,125,"(3.541112,-76.384584)"
2022,Febrero,Francia,250,3,1,,4,"(4.452882,-75.766298)"
2022,Febrero,Francia,250,1530,1209,,2739,"(4.697144,-74.140516)"
2022,Febrero,Francia,250,2,3,,5,"(4.815061,-75.736532)"
2022,Febrero,Francia,250,95,73,,168,"(6.171601,-75.427454)"
2022,Febrero,Francia,250,2,0,,2,"(7.128456,-73.183637)"
2022,Febrero,Georgia,268,0,2,,2,"(10.886611,-74.776708)"
2022,Febrero,Georgia,268,2,1,,3,"(3.541112,-76.384584)"
2022,Febrero,Georgia,268,3,2,,5,"(4.697144,-74.140516)"
2022,Febrero,Georgia,268,0,1,,1,"(6.171601,-75.427454)"
2022,Febrero,Ghana,288,1,0,,1,"(4.697144,-74.140516)"
2022,Febrero,Gibraltar/Territorio Británico de Ultramar,292,1,0,,1,"(4.697144,-74.140516)"
2022,Febrero,Granada,308,0,2,,2,"(3.541112,-76.384584)"
2022,Febrero,Granada,308,0,1,,1,"(4.697144,-74.140516)"
2022,Febrero,Grecia,300,1,0,,1,"(3.541112,-76.384584)"
2022,Febrero,Grecia,300,11,14,,25,"(4.697144,-74.140516)"
2022,Febrero,Grecia,300,4,0,,4,"(6.171601,-75.427454)"
2022,Febrero,Groenlandia,304,1,0,,1,"(6.171601,-75.427454)"
2022,Febrero,Guatemala,320,0,2,,2,"(1.813928,-78.763924)"
2022,Febrero,Guatemala,320,4,26,,30,"(10.445761,-75.516429)"
2022,Febrero,Guatemala,320,8,10,,18,"(10.886611,-74.776708)"
2022,Febrero,Guatemala,320,1,7,,8,"(12.586067,-81.702563)"
2022,Febrero,Guatemala,320,44,77,,121,"(3.541112,-76.384584)"
2022,Febrero,Guatemala,320,407,610,,1017,"(4.697144,-74.140516)"
2022,Febrero,Guatemala,320,23,16,,39,"(4.815061,-75.736532)"
2022,Febrero,Guatemala,320,88,94,,182,"(6.171601,-75.427454)"
2022,Febrero,Guatemala,320,2,5,,7,"(7.128456,-73.183637)"
2022,Febrero,Guatemala,320,2,4,,6,"(7.927209,-72.507910)"
2022,Febrero,Guyana,328,0,2,,2,"(10.886611,-74.776708)"
2022,Febrero,Guyana,328,2,3,,5,"(3.541112,-76.384584)"
2022,Febrero,Guyana,328,9,22,,31,"(4.697144,-74.140516)"
2022,Febrero,Guyana,328,0,1,,1,"(4.815061,-75.736532)"
2022,Febrero,Guyana,328,0,1,,1,"(6.171601,-75.427454)"
2022,Febrero,Guinea Ecuatorial,226,0,1,,1,"(3.541112,-76.384584)"
2022,Febrero,Guinea Ecuatorial,226,4,4,,8,"(4.697144,-74.140516)"
2022,Febrero,Guinea Bissau,624,1,0,,1,"(4.697144,-74.140516)"
2022,Febrero,Guadalupe/Territorio Francés,312,2,0,,2,"(3.541112,-76.384584)"
2022,Febrero,Guadalupe/Territorio Francés,312,2,3,,5,"(4.697144,-74.140516)"
2022,Febrero,Guadalupe/Territorio Francés,312,1,0,,1,"(6.171601,-75.427454)"
2022,Febrero,Guayana Francesa/Departamento de Ultramar Francés,254,0,4,,4,"(10.886611,-74.776708)"
2022,Febrero,Guayana Francesa/Departamento de Ultramar Francés,254,0,3,,3,"(4.697144,-74.140516)"
2022,Febrero,Haití,332,1,3,,4,"(4.697144,-74.140516)"
2022,Febrero,Haití,332,1,0,,1,"(6.171601,-75.427454)"
2022,Febrero,Honduras,340,0,1,,1,"(10.445761,-75.516429)"
2022,Febrero,Honduras,340,1,6,,7,"(10.886611,-74.776708)"
2022,Febrero,Honduras,340,16,23,,39,"(3.541112,-76.384584)"
2022,Febrero,Honduras,340,44,106,,150,"(4.697144,-74.140516)"
2022,Febrero,Honduras,340,5,7,,12,"(4.815061,-75.736532)"
2022,Febrero,Honduras,340,23,47,,70,"(6.171601,-75.427454)"
2022,Febrero,Hong Kong,344,1,0,,1,"(3.541112,-76.384584)"
2022,Febrero,Hong Kong,344,1,0,,1,"(4.697144,-74.140516)"
2022,Febrero,Hungría,348,1,0,,1,"(10.445761,-75.516429)"
2022,Febrero,Hungría,348,1,0,,1,"(3.541112,-76.384584)"
2022,Febrero,Hungría,348,14,27,,41,"(4.697144,-74.140516)"
2022,Febrero,Hungría,348,3,3,,6,"(6.171601,-75.427454)"
2022,Febrero,India,356,1,0,,1,"(10.445761,-75.516429)"
2022,Febrero,India,356,1,0,,1,"(3.541112,-76.384584)"
2022,Febrero,India,356,19,16,,35,"(4.697144,-74.140516)"
2022,Febrero,India,356,0,5,,5,"(6.171601,-75.427454)"
2022,Febrero,Indonesia,360,4,4,,8,"(4.697144,-74.140516)"
2022,Febrero,Iraq,368,0,9,,9,"(4.697144,-74.140516)"
2022,Febrero,Irán,364,1,0,,1,"(4.697144,-74.140516)"
2022,Febrero,República de Irlanda,372,1,0,,1,"(10.445761,-75.516429)"
2022,Febrero,República de Irlanda,372,1,0,,1,"(3.541112,-76.384584)"
2022,Febrero,República de Irlanda,372,23,15,,38,"(4.697144,-74.140516)"
2022,Febrero,República de Irlanda,372,0,1,,1,"(4.815061,-75.736532)"
2022,Febrero,República de Irlanda,372,6,1,,7,"(6.171601,-75.427454)"
2022,Febrero,Islandia,352,2,0,,2,"(3.541112,-76.384584)"
2022,Febrero,Islandia,352,7,9,,16,"(4.697144,-74.140516)"
2022,Febrero,Islandia,352,1,0,,1,"(6.171601,-75.427454)"
2022,Febrero,Israel,376,2,1,,3,"(10.445761,-75.516429)"
2022,Febrero,Israel,376,2,1,,3,"(3.541112,-76.384584)"
2022,Febrero,Israel,376,115,110,,225,"(4.697144,-74.140516)"
2022,Febrero,Israel,376,0,1,,1,"(4.815061,-75.736532)"
2022,Febrero,Israel,376,11,3,,14,"(6.171601,-75.427454)"
2022,Febrero,Islas Aland/Provincia de Finlandia,248,1,0,,1,"(3.541112,-76.384584)"
2022,Febrero,Italia,380,40,28,,68,"(10.445761,-75.516429)"
2022,Febrero,Italia,380,7,5,,12,"(10.886611,-74.776708)"
2022,Febrero,Italia,380,140,58,,198,"(3.541112,-76.384584)"
2022,Febrero,Italia,380,0,1,,1,"(4.452882,-75.766298)"
2022,Febrero,Italia,380,736,473,,1209,"(4.697144,-74.140516)"
2022,Febrero,Italia,380,93,46,,139,"(6.171601,-75.427454)"
2022,Febrero,Italia,380,2,0,,2,"(7.128456,-73.183637)"
2022,Febrero,Jamaica,388,2,3,,5,"(10.445761,-75.516429)"
2022,Febrero,Jamaica,388,2,5,,7,"(10.886611,-74.776708)"
2022,Febrero,Jamaica,388,11,12,,23,"(3.541112,-76.384584)"
2022,Febrero,Jamaica,388,34,35,,69,"(4.697144,-74.140516)"
2022,Febrero,Jamaica,388,0,2,,2,"(4.815061,-75.736532)"
2022,Febrero,Jamaica,388,1,3,,4,"(6.17134,-75.427194)"
2022,Febrero,Jamaica,388,14,12,,26,"(6.171601,-75.427454)"
2022,Febrero,Jamaica,388,2,4,,6,"(7.128456,-73.183637)"
2022,Febrero,Japón,392,2,0,,2,"(3.541112,-76.384584)"
2022,Febrero,Japón,392,15,16,,31,"(4.697144,-74.140516)"
2022,Febrero,Japón,392,1,0,,1,"(4.815061,-75.736532)"
2022,Febrero,Jordania,400,1,0,,1,"(10.886611,-74.776708)"
2022,Febrero,Jordania,400,1,1,,2,"(4.697144,-74.140516)"
2022,Febrero,Kazajistán,398,1,4,,5,"(4.697144,-74.140516)"
2022,Febrero,Kenia,404,1,1,,2,"(10.445761,-75.516429)"
2022,Febrero,Kenia,404,2,0,,2,"(3.541112,-76.384584)"
2022,Febrero,Kenia,404,10,8,,18,"(4.697144,-74.140516)"
2022,Febrero,Kenia,404,1,0,,1,"(6.171601,-75.427454)"
2022,Febrero,Kiribati,296,1,0,,1,"(4.697144,-74.140516)"
2022,Febrero,Kuwait,414,0,4,,4,"(4.697144,-74.140516)"
2022,Febrero,Kuwait,414,0,1,,1,"(6.171601,-75.427454)"
2022,Febrero,República de Kosovo,901,1,2,,3,"(4.697144,-74.140516)"
2022,Febrero,Letonia,428,0,4,,4,"(4.697144,-74.140516)"
2022,Febrero,Letonia,428,0,1,,1,"(6.171601,-75.427454)"
2022,Febrero,Lituania,440,2,2,,4,"(4.697144,-74.140516)"
2022,Febrero,Líbano,422,0,1,,1,"(10.886611,-74.776708)"
2022,Febrero,Líbano,422,14,15,,29,"(4.697144,-74.140516)"
2022,Febrero,Liberia,430,1,0,,1,"(4.697144,-74.140516)"
2022,Febrero,Luxemburgo,442,4,0,,4,"(10.445761,-75.516429)"
2022,Febrero,Luxemburgo,442,0,1,,1,"(3.541112,-76.384584)"
2022,Febrero,Luxemburgo,442,25,40,,65,"(4.697144,-74.140516)"
2022,Febrero,Malasia,458,2,2,,4,"(4.697144,-74.140516)"
2022,Febrero,Maldivas,462,1,0,,1,"(3.541112,-76.384584)"
2022,Febrero,Maldivas,462,6,6,,12,"(4.697144,-74.140516)"
2022,Febrero,Malí,466,2,1,,3,"(4.697144,-74.140516)"
2022,Febrero,Malta,470,2,1,,3,"(10.445761,-75.516429)"
2022,Febrero,Malta,470,5,2,,7,"(3.541112,-76.384584)"
2022,Febrero,Malta,470,164,139,,303,"(4.697144,-74.140516)"
2022,Febrero,Malta,470,2,10,,12,"(6.171601,-75.427454)"
2022,Febrero,Marruecos,504,11,2,,13,"(4.697144,-74.140516)"
2022,Febrero,Mauritania,478,2,2,,4,"(4.697144,-74.140516)"
2022,Febrero,Martinica/Departamento de Ultramar Francés,474,1,1,,2,"(3.541112,-76.384584)"
2022,Febrero,México,484,43,36,,79,"(10.445761,-75.516429)"
2022,Febrero,México,484,81,102,,183,"(10.886611,-74.776708)"
2022,Febrero,México,484,1,0,,1,"(10.971302,-74.765397)"
2022,Febrero,México,484,5,4,,9,"(11.117806,-74.232622)"
2022,Febrero,México,484,1465,1290,,2755,"(3.541112,-76.384584)"
2022,Febrero,México,484,27,27,,54,"(4.452882,-75.766298)"
2022,Febrero,México,484,19344,20306,,39650,"(4.697144,-74.140516)"
2022,Febrero,México,484,71,76,,147,"(4.815061,-75.736532)"
2022,Febrero,México,484,5273,4500,,9773,"(6.171601,-75.427454)"
2022,Febrero,México,484,79,90,,169,"(7.128456,-73.183637)"
2022,Febrero,México,484,38,30,,68,"(7.927209,-72.507910)"
2022,Febrero,República de Moldavia,498,0,1,,1,"(4.697144,-74.140516)"
2022,Febrero,Mónaco,492,2,0,,2,"(4.697144,-74.140516)"
2022,Febrero,Montenegro,499,0,1,,1,"(4.697144,-74.140516)"
2022,Febrero,Nepal,524,2,1,,3,"(4.697144,-74.140516)"
2022,Febrero,Nicaragua,558,0,1,,1,"(10.886611,-74.776708)"
2022,Febrero,Nicaragua,558,1,2,,3,"(3.541112,-76.384584)"
2022,Febrero,Nicaragua,558,24,57,,81,"(4.697144,-74.140516)"
2022,Febrero,Nicaragua,558,0,1,,1,"(4.815061,-75.736532)"
2022,Febrero,Nicaragua,558,5,18,,23,"(6.171601,-75.427454)"
2022,Febrero,Nigeria,566,0,6,,6,"(4.697144,-74.140516)"
2022,Febrero,Níger,562,0,1,,1,"(4.697144,-74.140516)"
2022,Febrero,Noruega,578,14,4,,18,"(10.445761,-75.516429)"
2022,Febrero,Noruega,578,5,4,,9,"(3.541112,-76.384584)"
2022,Febrero,Noruega,578,25,25,,50,"(4.697144,-74.140516)"
2022,Febrero,Noruega,578,0,1,,1,"(4.815061,-75.736532)"
2022,Febrero,Noruega,578,6,1,,7,"(6.171601,-75.427454)"
2022,Febrero,Noruega,578,1,1,,2,"(7.128456,-73.183637)"
2022,Febrero,Nueva Caledonia/Territorio francés,540,1,0,,1,"(6.171601,-75.427454)"
2022,Febrero,Nueva Zelanda,554,7,2,,9,"(4.697144,-74.140516)"
2022,Febrero,Nueva Zelanda,554,1,0,,1,"(6.171601,-75.427454)"
2022,Febrero,Omán,512,4,10,,14,"(4.697144,-74.140516)"
2022,Febrero,Papúa Nueva Guinea,598,0,1,,1,"(4.697144,-74.140516)"
2022,Febrero,Pakistán,586,0,3,,3,"(4.697144,-74.140516)"
2022,Febrero,Panamá,591,11,49,,60,"(10.408582,-75.538003)"
2022,Febrero,Panamá,591,1151,746,,1897,"(10.445761,-75.516429)"
2022,Febrero,Panamá,591,591,563,,1154,"(10.886611,-74.776708)"
2022,Febrero,Panamá,591,1,13,,14,"(10.971302,-74.765397)"
2022,Febrero,Panamá,591,1,4,,5,"(11.117806,-74.232622)"
2022,Febrero,Panamá,591,0,1,,1,"(12.165168,-71.983761)"
2022,Febrero,Panamá,591,19,36,,55,"(12.586067,-81.702563)"
2022,Febrero,Panamá,591,1,8,,9,"(13.3387613,-81.372937)"
2022,Febrero,Panamá,591,1956,1443,,3399,"(3.541112,-76.384584)"
2022,Febrero,Panamá,591,88,75,,163,"(4.452882,-75.766298)"
2022,Febrero,Panamá,591,4228,4587,,8815,"(4.697144,-74.140516)"
2022,Febrero,Panamá,591,242,166,,408,"(4.815061,-75.736532)"
2022,Febrero,Panamá,591,1635,1546,,3181,"(6.171601,-75.427454)"
2022,Febrero,Panamá,591,1,0,,1,"(6.228046,-77.404104)"
2022,Febrero,Panamá,591,20,17,,37,"(7.102626,-77.762647)"
2022,Febrero,Panamá,591,103,87,,190,"(7.128456,-73.183637)"
2022,Febrero,Panamá,591,113,77,,190,"(7.927209,-72.507910)"
2022,Febrero,Panamá,591,24,66,,90,"(8.635765,-77.346578)"
2022,Febrero,Paraguay,600,0,2,,2,"(0.814836,-77.662532)"
2022,Febrero,Paraguay,600,4,2,,6,"(10.445761,-75.516429)"
2022,Febrero,Paraguay,600,1,5,,6,"(10.886611,-74.776708)"
2022,Febrero,Paraguay,600,26,39,,65,"(3.541112,-76.384584)"
2022,Febrero,Paraguay,600,7,10,,17,"(4.452882,-75.766298)"
2022,Febrero,Paraguay,600,147,248,,395,"(4.697144,-74.140516)"
2022,Febrero,Paraguay,600,1,5,,6,"(4.815061,-75.736532)"
2022,Febrero,Paraguay,600,16,58,,74,"(6.171601,-75.427454)"
2022,Febrero,Paraguay,600,1,2,,3,"(7.128456,-73.183637)"
2022,Febrero,Paraguay,600,2,3,,5,"(7.927209,-72.507910)"
2022,Febrero,Perú,604,2,1,,3,"(-0.193180,-74.784874)"
2022,Febrero,Perú,604,36,56,,92,"(-4.197703,-69.941278)"
2022,Febrero,Perú,604,24,36,,60,"(0.814836,-77.662532)"
2022,Febrero,Perú,604,11,7,,18,"(10.445761,-75.516429)"
2022,Febrero,Perú,604,37,34,,71,"(10.886611,-74.776708)"
2022,Febrero,Perú,604,69,96,,165,"(3.541112,-76.384584)"
2022,Febrero,Perú,604,6,3,,9,"(4.452882,-75.766298)"
2022,Febrero,Perú,604,2610,3021,,5632,"(4.697144,-74.140516)"
2022,Febrero,Perú,604,11,21,,32,"(4.815061,-75.736532)"
2022,Febrero,Perú,604,467,493,,960,"(6.171601,-75.427454)"
2022,Febrero,Perú,604,4,5,,9,"(7.128456,-73.183637)"
2022,Febrero,Perú,604,4,0,,4,"(7.927209,-72.507910)"
2022,Febrero,Polonia,616,2,0,,2,"(10.445761,-75.516429)"
2022,Febrero,Polonia,616,19,42,,61,"(4.697144,-74.140516)"
2022,Febrero,Polonia,616,1,0,,1,"(4.815061,-75.736532)"
2022,Febrero,Polonia,616,1,1,,2,"(6.171601,-75.427454)"
2022,Febrero,Portugal,620,3,0,,3,"(10.445761,-75.516429)"
2022,Febrero,Portugal,620,1,0,,1,"(10.886611,-74.776708)"
2022,Febrero,Portugal,620,13,7,,20,"(3.541112,-76.384584)"
2022,Febrero,Portugal,620,134,159,,293,"(4.697144,-74.140516)"
2022,Febrero,Portugal,620,1,0,,1,"(4.815061,-75.736532)"
2022,Febrero,Portugal,620,23,13,,36,"(6.171601,-75.427454)"
2022,Febrero,Polinesia Francesa/Colectividad de Ultramar Francesa,258,0,1,,1,"(3.541112,-76.384584)"
2022,Febrero,Polinesia Francesa/Colectividad de Ultramar Francesa,258,1,0,,1,"(4.697144,-74.140516)"
2022,Febrero,Puerto Rico/Territorio de Estados Unidos,630,8,4,,12,"(10.445761,-75.516429)"
2022,Febrero,Puerto Rico/Territorio de Estados Unidos,630,6,6,,12,"(10.886611,-74.776708)"
2022,Febrero,Puerto Rico/Territorio de Estados Unidos,630,50,31,,81,"(3.541112,-76.384584)"
2022,Febrero,Puerto Rico/Territorio de Estados Unidos,630,4,2,,6,"(4.452882,-75.766298)"
2022,Febrero,Puerto Rico/Territorio de Estados Unidos,630,374,352,,726,"(4.697144,-74.140516)"
2022,Febrero,Puerto Rico/Territorio de Estados Unidos,630,1,0,,1,"(4.815061,-75.736532)"
2022,Febrero,Puerto Rico/Territorio de Estados Unidos,630,51,28,,79,"(6.171601,-75.427454)"
2022,Febrero,Puerto Rico/Territorio de Estados Unidos,630,1,0,,1,"(7.128456,-73.183637)"
2022,Febrero,Qatar,634,0,2,,2,"(10.445761,-75.516429)"
2022,Febrero,Qatar,634,2,2,,4,"(3.541112,-76.384584)"
2022,Febrero,Qatar,634,20,21,,41,"(4.697144,-74.140516)"
2022,Febrero,Qatar,634,2,0,,2,"(6.171601,-75.427454)"
2022,Febrero,Reino Unido de Gran Bretaña e Irlanda del Norte,826,8,8,,16,"(10.445761,-75.516429)"
2022,Febrero,Reino Unido de Gran Bretaña e Irlanda del Norte,826,3,2,,5,"(10.886611,-74.776708)"
2022,Febrero,Reino Unido de Gran Bretaña e Irlanda del Norte,826,95,62,,157,"(3.541112,-76.384584)"
2022,Febrero,Reino Unido de Gran Bretaña e Irlanda del Norte,826,541,378,,919,"(4.697144,-74.140516)"
2022,Febrero,Reino Unido de Gran Bretaña e Irlanda del Norte,826,10,14,,24,"(4.815061,-75.736532)"
2022,Febrero,Reino Unido de Gran Bretaña e Irlanda del Norte,826,69,47,,116,"(6.171601,-75.427454)"
2022,Febrero,República CentroÁfricana,140,2,0,,2,"(4.697144,-74.140516)"
2022,Febrero,Federación de Rusia,643,3,4,,7,"(10.445761,-75.516429)"
2022,Febrero,Federación de Rusia,643,2,1,,3,"(3.541112,-76.384584)"
2022,Febrero,Federación de Rusia,643,62,90,,152,"(4.697144,-74.140516)"
2022,Febrero,Federación de Rusia,643,1,1,,2,"(4.815061,-75.736532)"
2022,Febrero,Federación de Rusia,643,0,1,,1,"(6.171601,-75.427454)"
2022,Febrero,República Dominicana,214,21,31,,52,"(10.445761,-75.516429)"
2022,Febrero,República Dominicana,214,105,101,,206,"(10.886611,-74.776708)"
2022,Febrero,República Dominicana,214,5,6,,11,"(11.117806,-74.232622)"
2022,Febrero,República Dominicana,214,319,255,,574,"(3.541112,-76.384584)"
2022,Febrero,República Dominicana,214,1,2,,3,"(4.452882,-75.766298)"
2022,Febrero,República Dominicana,214,3701,3217,,6918,"(4.697144,-74.140516)"
2022,Febrero,República Dominicana,214,61,51,,112,"(4.815061,-75.736532)"
2022,Febrero,República Dominicana,214,1691,1274,,2965,"(6.171601,-75.427454)"
2022,Febrero,República Dominicana,214,21,20,,41,"(7.128456,-73.183637)"
2022,Febrero,República Dominicana,214,1,1,,2,"(7.818934,-72.453226)"
2022,Febrero,República Dominicana,214,3,3,,6,"(7.927209,-72.507910)"
2022,Febrero,República Democrática Popular de Corea,408,0,1,,1,"(3.541112,-76.384584)"
2022,Febrero,Rumania,642,13,16,,29,"(4.697144,-74.140516)"
2022,Febrero,Rumania,642,1,0,,1,"(6.171601,-75.427454)"
2022,Febrero,Rwanda,646,0,1,,1,"(4.697144,-74.140516)"
2022,Febrero,San Cristóbal y Nevis,659,0,1,,1,"(7.818934,-72.453226)"
2022,Febrero,Santa Elena/Territorio Británico de Ultramar,654,0,2,,2,"(0.814836,-77.662532)"
2022,Febrero,Santa Sede/Ciudad del Vaticano,336,1,0,,1,"(4.697144,-74.140516)"
2022,Febrero,Senegal,686,1,0,,1,"(3.541112,-76.384584)"
2022,Febrero,Senegal,686,1,1,,2,"(4.697144,-74.140516)"
2022,Febrero,Serbia,688,1,0,,1,"(3.541112,-76.384584)"
2022,Febrero,Serbia,688,2,0,,2,"(4.697144,-74.140516)"
2022,Febrero,Seychelles,690,0,1,,1,"(4.697144,-74.140516)"
2022,Febrero,Sierra Leona,694,2,0,,2,"(4.697144,-74.140516)"
2022,Febrero,Singapur,702,4,2,,6,"(4.697144,-74.140516)"
2022,Febrero,Sri Lanka,144,2,3,,5,"(4.697144,-74.140516)"
2022,Febrero,Sudáfrica,710,0,1,,1,"(10.886611,-74.776708)"
2022,Febrero,Sudáfrica,710,1,6,,7,"(4.697144,-74.140516)"
2022,Febrero,Sudáfrica,710,1,0,,1,"(6.171601,-75.427454)"
2022,Febrero,Sudán,736,1,0,,1,"(4.697144,-74.140516)"
2022,Febrero,Suecia,752,8,1,,9,"(10.445761,-75.516429)"
2022,Febrero,Suecia,752,1,0,,1,"(10.886611,-74.776708)"
2022,Febrero,Suecia,752,14,11,,25,"(3.541112,-76.384584)"
2022,Febrero,Suecia,752,112,82,,194,"(4.697144,-74.140516)"
2022,Febrero,Suecia,752,7,12,,19,"(6.171601,-75.427454)"
2022,Febrero,Suiza,756,14,16,,30,"(10.445761,-75.516429)"
2022,Febrero,Suiza,756,4,1,,5,"(10.886611,-74.776708)"
2022,Febrero,Suiza,756,75,44,,119,"(3.541112,-76.384584)"
2022,Febrero,Suiza,756,397,235,,632,"(4.697144,-74.140516)"
2022,Febrero,Suiza,756,1,1,,2,"(4.815061,-75.736532)"
2022,Febrero,Suiza,756,57,26,,83,"(6.171601,-75.427454)"
2022,Febrero,Surinam,740,4,0,,4,"(10.445761,-75.516429)"
2022,Febrero,Surinam,740,0,1,,1,"(10.886611,-74.776708)"
2022,Febrero,Surinam,740,1,1,,2,"(3.541112,-76.384584)"
2022,Febrero,Surinam,740,4,12,,16,"(4.697144,-74.140516)"
2022,Febrero,Surinam,740,3,3,,6,"(6.171601,-75.427454)"
2022,Febrero,Taiwán,158,0,1,,1,"(10.445761,-75.516429)"
2022,Febrero,Taiwán,158,2,2,,4,"(4.697144,-74.140516)"
2022,Febrero,Tailandia,764,0,1,,1,"(10.445761,-75.516429)"
2022,Febrero,Tailandia,764,0,1,,1,"(10.886611,-74.776708)"
2022,Febrero,Tailandia,764,2,2,,4,"(3.541112,-76.384584)"
2022,Febrero,Tailandia,764,5,5,,10,"(4.697144,-74.140516)"
2022,Febrero,Tanzania,834,4,0,,4,"(4.697144,-74.140516)"
2022,Febrero,Trinidad y Tobago,780,0,1,,1,"(10.408582,-75.538003)"
2022,Febrero,Trinidad y Tobago,780,2,0,,2,"(10.445761,-75.516429)"
2022,Febrero,Trinidad y Tobago,780,2,1,,3,"(10.886611,-74.776708)"
2022,Febrero,Trinidad y Tobago,780,5,8,,13,"(3.541112,-76.384584)"
2022,Febrero,Trinidad y Tobago,780,2,0,,2,"(4.452882,-75.766298)"
2022,Febrero,Trinidad y Tobago,780,9,20,,29,"(4.697144,-74.140516)"
2022,Febrero,Trinidad y Tobago,780,0,1,,1,"(4.815061,-75.736532)"
2022,Febrero,Trinidad y Tobago,780,3,4,,7,"(6.171601,-75.427454)"
2022,Febrero,Túnez,788,3,1,,4,"(4.697144,-74.140516)"
2022,Febrero,Turquía,792,4,1,,5,"(10.445761,-75.516429)"
2022,Febrero,Turquía,792,4,3,,7,"(3.541112,-76.384584)"
2022,Febrero,Turquía,792,613,510,,1123,"(4.697144,-74.140516)"
2022,Febrero,Turquía,792,6,10,,16,"(6.171601,-75.427454)"
2022,Febrero,Turkmenistán,795,0,2,,2,"(4.697144,-74.140516)"
2022,Febrero,Ucrania,804,1,1,,2,"(10.445761,-75.516429)"
2022,Febrero,Ucrania,804,2,1,,3,"(3.541112,-76.384584)"
2022,Febrero,Ucrania,804,1,6,,7,"(4.697144,-74.140516)"
2022,Febrero,Uganda,800,1,0,,1,"(4.697144,-74.140516)"
2022,Febrero,Uruguay,858,0,1,,1,"(0.814836,-77.662532)"
2022,Febrero,Uruguay,858,2,2,,4,"(10.445761,-75.516429)"
2022,Febrero,Uruguay,858,8,1,,9,"(10.886611,-74.776708)"
2022,Febrero,Uruguay,858,21,65,,86,"(3.541112,-76.384584)"
2022,Febrero,Uruguay,858,13,17,,30,"(4.452882,-75.766298)"
2022,Febrero,Uruguay,858,259,207,,466,"(4.697144,-74.140516)"
2022,Febrero,Uruguay,858,8,21,,29,"(4.815061,-75.736532)"
2022,Febrero,Uruguay,858,17,21,,38,"(6.171601,-75.427454)"
2022,Febrero,Uruguay,858,2,3,,5,"(7.128456,-73.183637)"
2022,Febrero,Uruguay,858,1,1,,2,"(7.927209,-72.507910)"
2022,Febrero,Venezuela,862,2,1,,3,"(10.445761,-75.516429)"
2022,Febrero,Venezuela,862,35,35,,70,"(10.886611,-74.776708)"
2022,Febrero,Venezuela,862,86,291,,377,"(11.360009,-72.129330)"
2022,Febrero,Venezuela,862,38,23,,61,"(3.541112,-76.384584)"
2022,Febrero,Venezuela,862,0,1,,1,"(3.866713,-67.927521)"
2022,Febrero,Venezuela,862,2,2,,4,"(4.452882,-75.766298)"
2022,Febrero,Venezuela,862,167,221,,388,"(4.697144,-74.140516)"
2022,Febrero,Venezuela,862,9,9,,18,"(4.815061,-75.736532)"
2022,Febrero,Venezuela,862,66,78,,144,"(6.171601,-75.427454)"
2022,Febrero,Venezuela,862,2,4,,6,"(6.185799,-67.483929)"
2022,Febrero,Venezuela,862,6,6,,12,"(7.088729,-70.740253)"
2022,Febrero,Venezuela,862,6,8,,14,"(7.128456,-73.183637)"
2022,Febrero,Venezuela,862,222,298,,520,"(7.818934,-72.453226)"
2022,Febrero,Venezuela,862,27,44,,71,"(7.916725,-72.462544)"
2022,Febrero,Venezuela,862,0,2,,2,"(7.927209,-72.507910)"
2022,Febrero,Venezuela,862,7,16,,23,"(8.36068,-72.409396)"
2022,Febrero,Vietnam,704,4,2,,6,"(4.697144,-74.140516)"
2022,Febrero,Islas Vírgenes Británicas/Territorio Británico de Ultramar,92,0,1,,1,"(3.541112,-76.384584)"
2022,Febrero,Islas Vírgenes Británicas/Territorio Británico de Ultramar,92,0,1,,1,"(4.697144,-74.140516)"
2022,Febrero,Islas Vírgenes Británicas/Territorio Británico de Ultramar,92,2,2,,4,"(6.171601,-75.427454)"
2022,Febrero,Islas Vírgenes Estadounidenses/Territorio de Estados Unidos,850,0,1,,1,"(4.697144,-74.140516)"
2022,Febrero,Islas Vírgenes Estadounidenses/Territorio de Estados Unidos,850,1,0,,1,"(6.171601,-75.427454)"
2022,Febrero,Zambia,894,0,4,,4,"(4.697144,-74.140516)"
2022,Febrero,Anguila/Territorio Británico de Ultramar,660,1,0,,1,"(6.171601,-75.427454)"
2022,Febrero,Islas Turcas y Caicos/Territorio Británico de Ultramar,796,2,0,,2,"(3.541112,-76.384584)"
2022,Febrero,Islas Turcas y Caicos/Territorio Británico de Ultramar,796,1,1,,2,"(6.171601,-75.427454)"
2022,Febrero,Desconocido,99999,0,1,,1,"(6.171601,-75.427454)"
2022,Marzo,Afganistán,4,0,1,,1,"(4.697144,-74.140516)"
2022,Marzo,Afganistán,4,1,0,,1,"(6.171601,-75.427454)"
2022,Marzo,Albania,8,1,1,,2,"(4.697144,-74.140516)"
2022,Marzo,Alemania,276,39,26,,65,"(10.445761,-75.516429)"
2022,Marzo,Alemania,276,7,13,,20,"(10.886611,-74.776708)"
2022,Marzo,Alemania,276,80,60,,140,"(3.541112,-76.384584)"
2022,Marzo,Alemania,276,1,0,,1,"(4.452882,-75.766298)"
2022,Marzo,Alemania,276,1094,782,,1876,"(4.697144,-74.140516)"
2022,Marzo,Alemania,276,3,2,,5,"(4.815061,-75.736532)"
2022,Marzo,Alemania,276,87,46,,133,"(6.171601,-75.427454)"
2022,Marzo,Andorra,20,0,1,,1,"(3.541112,-76.384584)"
2022,Marzo,Andorra,20,6,6,,12,"(4.697144,-74.140516)"
2022,Marzo,Angola,24,4,2,,6,"(4.697144,-74.140516)"
2022,Marzo,Antigua y Barbuda,28,2,0,,2,"(4.697144,-74.140516)"
2022,Marzo,Antigua y Barbuda,28,1,0,,1,"(6.171601,-75.427454)"
2022,Marzo,Países Bajos,528,153,87,,240,"(10.445761,-75.516429)"
2022,Marzo,Países Bajos,528,24,4,,28,"(10.886611,-74.776708)"
2022,Marzo,Países Bajos,528,68,33,,101,"(3.541112,-76.384584)"
2022,Marzo,Países Bajos,528,793,796,,1589,"(4.697144,-74.140516)"
2022,Marzo,Países Bajos,528,2,1,,3,"(4.815061,-75.736532)"
2022,Marzo,Países Bajos,528,3,4,,7,"(6.17134,-75.427194)"
2022,Marzo,Países Bajos,528,85,47,,132,"(6.171601,-75.427454)"
2022,Marzo,Países Bajos,528,1,2,,3,"(7.128456,-73.183637)"
2022,Marzo,Arabia Saudita,682,1,1,,2,"(3.541112,-76.384584)"
2022,Marzo,Arabia Saudita,682,16,34,,50,"(4.697144,-74.140516)"
2022,Marzo,Arabia Saudita,682,0,1,,1,"(6.171601,-75.427454)"
2022,Marzo,Argelia,12,1,5,,6,"(4.697144,-74.140516)"
2022,Marzo,Argentina,32,4,8,,12,"(0.814836,-77.662532)"
2022,Marzo,Argentina,32,7,7,,14,"(10.445761,-75.516429)"
2022,Marzo,Argentina,32,33,16,,49,"(10.886611,-74.776708)"
2022,Marzo,Argentina,32,90,85,,175,"(3.541112,-76.384584)"
2022,Marzo,Argentina,32,15,7,,22,"(4.452882,-75.766298)"
2022,Marzo,Argentina,32,2747,2247,,4994,"(4.697144,-74.140516)"
2022,Marzo,Argentina,32,6,8,,14,"(4.815061,-75.736532)"
2022,Marzo,Argentina,32,78,74,,152,"(6.171601,-75.427454)"
2022,Marzo,Argentina,32,1,3,,4,"(7.128456,-73.183637)"
2022,Marzo,Argentina,32,13,8,,21,"(7.927209,-72.507910)"
2022,Marzo,República de Armenia,51,2,1,,3,"(4.697144,-74.140516)"
2022,Marzo,República de Armenia,51,1,0,,1,"(4.815061,-75.736532)"
2022,Marzo,Aruba,533,1,7,,8,"(10.408582,-75.538003)"
2022,Marzo,Aruba,533,1,3,,4,"(10.445761,-75.516429)"
2022,Marzo,Aruba,533,98,81,,179,"(10.886611,-74.776708)"
2022,Marzo,Aruba,533,0,1,,1,"(11.247723,-74.213989)"
2022,Marzo,Aruba,533,101,77,,178,"(3.541112,-76.384584)"
2022,Marzo,Aruba,533,1240,960,,2200,"(4.697144,-74.140516)"
2022,Marzo,Aruba,533,4,3,,7,"(4.815061,-75.736532)"
2022,Marzo,Aruba,533,160,138,,298,"(6.171601,-75.427454)"
2022,Marzo,Aruba,533,1,13,,14,"(7.128456,-73.183637)"
2022,Marzo,Australia,36,4,4,,8,"(10.445761,-75.516429)"
2022,Marzo,Australia,36,2,2,,4,"(10.886611,-74.776708)"
2022,Marzo,Australia,36,17,13,,30,"(3.541112,-76.384584)"
2022,Marzo,Australia,36,267,252,,519,"(4.697144,-74.140516)"
2022,Marzo,Australia,36,1,2,,3,"(4.815061,-75.736532)"
2022,Marzo,Australia,36,25,30,,55,"(6.171601,-75.427454)"
2022,Marzo,Australia,36,2,2,,4,"(7.128456,-73.183637)"
2022,Marzo,Austria,40,5,0,,5,"(10.445761,-75.516429)"
2022,Marzo,Austria,40,7,0,,7,"(3.541112,-76.384584)"
2022,Marzo,Austria,40,54,41,,95,"(4.697144,-74.140516)"
2022,Marzo,Austria,40,1,0,,1,"(4.815061,-75.736532)"
2022,Marzo,Austria,40,3,3,,6,"(6.171601,-75.427454)"
2022,Marzo,Bahamas,44,1,1,,2,"(10.445761,-75.516429)"
2022,Marzo,Bahamas,44,25,5,,30,"(3.541112,-76.384584)"
2022,Marzo,Bahamas,44,31,31,,62,"(4.697144,-74.140516)"
2022,Marzo,Bahamas,44,3,2,,5,"(4.815061,-75.736532)"
2022,Marzo,Bahamas,44,41,16,,57,"(6.171601,-75.427454)"
2022,Marzo,Bahréin,48,4,7,,11,"(4.697144,-74.140516)"
2022,Marzo,Bangladesh,50,0,3,,3,"(4.697144,-74.140516)"
2022,Marzo,Barbados,52,0,1,,1,"(10.445761,-75.516429)"
2022,Marzo,Barbados,52,1,0,,1,"(12.586067,-81.702563)"
2022,Marzo,Barbados,52,1,0,,1,"(3.541112,-76.384584)"
2022,Marzo,Barbados,52,7,14,,21,"(4.697144,-74.140516)"
2022,Marzo,Barbados,52,3,2,,5,"(6.171601,-75.427454)"
2022,Marzo,República de Belarús,112,2,1,,3,"(4.697144,-74.140516)"
2022,Marzo,Bélgica,56,5,5,,10,"(10.445761,-75.516429)"
2022,Marzo,Bélgica,56,1,2,,3,"(10.886611,-74.776708)"
2022,Marzo,Bélgica,56,20,14,,34,"(3.541112,-76.384584)"
2022,Marzo,Bélgica,56,131,118,,249,"(4.697144,-74.140516)"
2022,Marzo,Bélgica,56,0,1,,1,"(4.815061,-75.736532)"
2022,Marzo,Bélgica,56,40,26,,66,"(6.171601,-75.427454)"
2022,Marzo,Belice,84,0,1,,1,"(10.445761,-75.516429)"
2022,Marzo,Belice,84,2,1,,3,"(3.541112,-76.384584)"
2022,Marzo,Belice,84,7,5,,12,"(4.697144,-74.140516)"
2022,Marzo,Belice,84,2,1,,3,"(6.171601,-75.427454)"
2022,Marzo,Benín,204,0,5,,5,"(4.697144,-74.140516)"
2022,Marzo,Bermudas/Territorio Británico de Ultramar,60,1,2,,3,"(4.697144,-74.140516)"
2022,Marzo,Bermudas/Territorio Británico de Ultramar,60,1,0,,1,"(4.815061,-75.736532)"
2022,Marzo,Bolivia,68,0,1,,1,"(0.25129,-76.875963)"
2022,Marzo,Bolivia,68,6,15,,21,"(0.814836,-77.662532)"
2022,Marzo,Bolivia,68,0,1,,1,"(10.445761,-75.516429)"
2022,Marzo,Bolivia,68,2,1,,3,"(10.886611,-74.776708)"
2022,Marzo,Bolivia,68,10,15,,25,"(3.541112,-76.384584)"
2022,Marzo,Bolivia,68,0,2,,2,"(4.452882,-75.766298)"
2022,Marzo,Bolivia,68,415,651,,1066,"(4.697144,-74.140516)"
2022,Marzo,Bolivia,68,0,2,,2,"(4.815061,-75.736532)"
2022,Marzo,Bolivia,68,17,21,,38,"(6.171601,-75.427454)"
2022,Marzo,Bosnia y Herzegovina,70,36,14,,50,"(4.697144,-74.140516)"
2022,Marzo,Brasil,76,217,320,,537,"(-4.197703,-69.941278)"
2022,Marzo,Brasil,76,3,7,,10,"(0.814836,-77.662532)"
2022,Marzo,Brasil,76,10,21,,31,"(10.445761,-75.516429)"
2022,Marzo,Brasil,76,18,20,,38,"(10.886611,-74.776708)"
2022,Marzo,Brasil,76,243,245,,488,"(3.541112,-76.384584)"
2022,Marzo,Brasil,76,23,43,,66,"(4.452882,-75.766298)"
2022,Marzo,Brasil,76,2171,2712,,4883,"(4.697144,-74.140516)"
2022,Marzo,Brasil,76,36,65,,101,"(4.815061,-75.736532)"
2022,Marzo,Brasil,76,192,257,,449,"(6.171601,-75.427454)"
2022,Marzo,Brasil,76,11,17,,28,"(7.128456,-73.183637)"
2022,Marzo,Brasil,76,4,12,,16,"(7.927209,-72.507910)"
2022,Marzo,Bulgaria,100,2,2,,4,"(4.697144,-74.140516)"
2022,Marzo,Burkina Faso,854,0,2,,2,"(4.697144,-74.140516)"
2022,Marzo,Islas Caimán/Territorio Británico de Ultramar,136,2,0,,2,"(10.445761,-75.516429)"
2022,Marzo,Islas Caimán/Territorio Británico de Ultramar,136,1,2,,3,"(12.586067,-81.702563)"
2022,Marzo,Islas Caimán/Territorio Británico de Ultramar,136,2,2,,4,"(3.541112,-76.384584)"
2022,Marzo,Islas Caimán/Territorio Británico de Ultramar,136,2,2,,4,"(4.697144,-74.140516)"
2022,Marzo,Islas Caimán/Territorio Británico de Ultramar,136,1,1,,2,"(6.171601,-75.427454)"
2022,Marzo,Islas Caimán/Territorio Británico de Ultramar,136,1,0,,1,"(7.128456,-73.183637)"
2022,Marzo,Camboya,116,1,0,,1,"(3.541112,-76.384584)"
2022,Marzo,Camboya,116,1,3,,4,"(4.697144,-74.140516)"
2022,Marzo,Camerún,120,1,0,,1,"(4.697144,-74.140516)"
2022,Marzo,Canadá,124,189,184,,373,"(10.445761,-75.516429)"
2022,Marzo,Canadá,124,40,42,,82,"(10.886611,-74.776708)"
2022,Marzo,Canadá,124,2,2,,4,"(12.586067,-81.702563)"
2022,Marzo,Canadá,124,124,107,,231,"(3.541112,-76.384584)"
2022,Marzo,Canadá,124,7,3,,10,"(4.452882,-75.766298)"
2022,Marzo,Canadá,124,2748,2196,,4944,"(4.697144,-74.140516)"
2022,Marzo,Canadá,124,15,13,,28,"(4.815061,-75.736532)"
2022,Marzo,Canadá,124,265,228,,493,"(6.171601,-75.427454)"
2022,Marzo,Canadá,124,10,6,,16,"(7.128456,-73.183637)"
2022,Marzo,Canadá,124,2,1,,3,"(7.927209,-72.507910)"
2022,Marzo,España,724,70,48,,118,"(10.445761,-75.516429)"
2022,Marzo,España,724,27,33,,60,"(10.886611,-74.776708)"
2022,Marzo,España,724,3238,2251,,5489,"(3.541112,-76.384584)"
2022,Marzo,España,724,3,3,,6,"(4.452882,-75.766298)"
2022,Marzo,España,724,20399,16421,,36820,"(4.697144,-74.140516)"
2022,Marzo,España,724,37,24,,61,"(4.815061,-75.736532)"
2022,Marzo,España,724,2113,1603,,3716,"(6.171601,-75.427454)"
2022,Marzo,España,724,1,1,,2,"(7.128456,-73.183637)"
2022,Marzo,España,724,1,0,,1,"(7.927209,-72.507910)"
2022,Marzo,Colombia,170,1,1,,2,"(10.445761,-75.516429)"
2022,Marzo,Colombia,170,40,115,,155,"(4.697144,-74.140516)"
2022,Marzo,Comoras,174,2,0,,2,"(4.697144,-74.140516)"
2022,Marzo,República Democrática del Congo,180,1,1,,2,"(4.697144,-74.140516)"
2022,Marzo,República de Corea,410,7,4,,11,"(4.697144,-74.140516)"
2022,Marzo,República de Corea,410,1,0,,1,"(6.171601,-75.427454)"
2022,Marzo,Costa de Marfil,384,5,9,,14,"(4.697144,-74.140516)"
2022,Marzo,Costa de Marfil,384,1,0,,1,"(6.171601,-75.427454)"
2022,Marzo,Costa Rica,188,29,39,,68,"(10.445761,-75.516429)"
2022,Marzo,Costa Rica,188,23,21,,44,"(10.886611,-74.776708)"
2022,Marzo,Costa Rica,188,2,17,,19,"(12.5744111,-81.703935)"
2022,Marzo,Costa Rica,188,1,0,,1,"(12.586067,-81.702563)"
2022,Marzo,Costa Rica,188,68,73,,141,"(3.541112,-76.384584)"
2022,Marzo,Costa Rica,188,6,6,,12,"(4.452882,-75.766298)"
2022,Marzo,Costa Rica,188,990,1045,,2035,"(4.697144,-74.140516)"
2022,Marzo,Costa Rica,188,10,10,,20,"(4.815061,-75.736532)"
2022,Marzo,Costa Rica,188,171,151,,322,"(6.171601,-75.427454)"
2022,Marzo,Costa Rica,188,3,1,,4,"(7.128456,-73.183637)"
2022,Marzo,Costa Rica,188,2,0,,2,"(7.927209,-72.507910)"
2022,Marzo,Croacia,191,2,0,,2,"(10.445761,-75.516429)"
2022,Marzo,Croacia,191,2,2,,4,"(3.541112,-76.384584)"
2022,Marzo,Croacia,191,7,5,,12,"(4.697144,-74.140516)"
2022,Marzo,Cuba,192,2,0,,2,"(10.445761,-75.516429)"
2022,Marzo,Cuba,192,3,14,,17,"(10.886611,-74.776708)"
2022,Marzo,Cuba,192,12,11,,23,"(3.541112,-76.384584)"
2022,Marzo,Cuba,192,446,444,,890,"(4.697144,-74.140516)"
2022,Marzo,Cuba,192,2,0,,2,"(4.815061,-75.736532)"
2022,Marzo,Cuba,192,16,14,,30,"(6.171601,-75.427454)"
2022,Marzo,Curazao,99999,52,27,,79,"(10.886611,-74.776708)"
2022,Marzo,Curazao,99999,23,18,,41,"(3.541112,-76.384584)"
2022,Marzo,Curazao,99999,858,755,,1613,"(4.697144,-74.140516)"
2022,Marzo,Curazao,99999,2,1,,3,"(4.815061,-75.736532)"
2022,Marzo,Curazao,99999,151,117,,268,"(6.171601,-75.427454)"
2022,Marzo,República Checa,203,1,0,,1,"(10.445761,-75.516429)"
2022,Marzo,República Checa,203,1,1,,2,"(10.886611,-74.776708)"
2022,Marzo,República Checa,203,21,21,,42,"(4.697144,-74.140516)"
2022,Marzo,República Checa,203,3,3,,6,"(6.171601,-75.427454)"
2022,Marzo,Chile,152,27,42,,69,"(0.814836,-77.662532)"
2022,Marzo,Chile,152,20,13,,33,"(10.445761,-75.516429)"
2022,Marzo,Chile,152,75,66,,141,"(10.886611,-74.776708)"
2022,Marzo,Chile,152,0,1,,1,"(12.586067,-81.702563)"
2022,Marzo,Chile,152,3464,2483,,5947,"(3.541112,-76.384584)"
2022,Marzo,Chile,152,90,82,,172,"(4.452882,-75.766298)"
2022,Marzo,Chile,152,4850,3986,,8836,"(4.697144,-74.140516)"
2022,Marzo,Chile,152,24,17,,41,"(4.815061,-75.736532)"
2022,Marzo,Chile,152,505,455,,960,"(6.171601,-75.427454)"
2022,Marzo,Chile,152,5,6,,11,"(7.128456,-73.183637)"
2022,Marzo,Chile,152,15,13,,28,"(7.927209,-72.507910)"
2022,Marzo,China,156,5,6,,11,"(4.697144,-74.140516)"
2022,Marzo,Chipre,196,0,1,,1,"(10.886611,-74.776708)"
2022,Marzo,Chipre,196,3,1,,4,"(3.541112,-76.384584)"
2022,Marzo,Chipre,196,1,5,,6,"(4.697144,-74.140516)"
2022,Marzo,Chipre,196,2,2,,4,"(6.171601,-75.427454)"
2022,Marzo,Dinamarca,208,3,1,,4,"(10.445761,-75.516429)"
2022,Marzo,Dinamarca,208,2,3,,5,"(3.541112,-76.384584)"
2022,Marzo,Dinamarca,208,46,32,,78,"(4.697144,-74.140516)"
2022,Marzo,Dinamarca,208,6,12,,18,"(6.171601,-75.427454)"
2022,Marzo,Dominica,212,6,4,,10,"(4.697144,-74.140516)"
2022,Marzo,Dominica,212,0,1,,1,"(6.171601,-75.427454)"
2022,Marzo,Dominica,212,0,1,,1,"(7.927209,-72.507910)"
2022,Marzo,Ecuador,218,371,464,,835,"(0.25129,-76.875963)"
2022,Marzo,Ecuador,218,5,14,,19,"(0.812436,-77.847006)"
2022,Marzo,Ecuador,218,2757,4709,,7466,"(0.814836,-77.662532)"
2022,Marzo,Ecuador,218,1,1,,2,"(1.813928,-78.763924)"
2022,Marzo,Ecuador,218,14,10,,24,"(10.445761,-75.516429)"
2022,Marzo,Ecuador,218,7,21,,28,"(10.886611,-74.776708)"
2022,Marzo,Ecuador,218,1,2,,3,"(12.586067,-81.702563)"
2022,Marzo,Ecuador,218,65,91,,156,"(3.541112,-76.384584)"
2022,Marzo,Ecuador,218,0,1,,1,"(4.452882,-75.766298)"
2022,Marzo,Ecuador,218,2561,3761,,6322,"(4.697144,-74.140516)"
2022,Marzo,Ecuador,218,1,3,,4,"(4.815061,-75.736532)"
2022,Marzo,Ecuador,218,92,129,,221,"(6.171601,-75.427454)"
2022,Marzo,Ecuador,218,0,1,,1,"(7.128456,-73.183637)"
2022,Marzo,Ecuador,218,1,2,,3,"(7.927209,-72.507910)"
2022,Marzo,Egipto,818,0,2,,2,"(10.408582,-75.538003)"
2022,Marzo,Egipto,818,35,122,,157,"(4.697144,-74.140516)"
2022,Marzo,Egipto,818,0,1,,1,"(4.815061,-75.736532)"
2022,Marzo,Egipto,818,2,3,,5,"(6.171601,-75.427454)"
2022,Marzo,El Salvador,222,0,4,,4,"(10.445761,-75.516429)"
2022,Marzo,El Salvador,222,6,6,,12,"(10.886611,-74.776708)"
2022,Marzo,El Salvador,222,1,0,,1,"(12.586067,-81.702563)"
2022,Marzo,El Salvador,222,17,17,,34,"(3.541112,-76.384584)"
2022,Marzo,El Salvador,222,1,0,,1,"(4.452882,-75.766298)"
2022,Marzo,El Salvador,222,323,431,,754,"(4.697144,-74.140516)"
2022,Marzo,El Salvador,222,7,2,,9,"(4.815061,-75.736532)"
2022,Marzo,El Salvador,222,15,38,,53,"(6.171601,-75.427454)"
2022,Marzo,Emiratos Árabes,784,8,6,,14,"(10.445761,-75.516429)"
2022,Marzo,Emiratos Árabes,784,2,3,,5,"(10.886611,-74.776708)"
2022,Marzo,Emiratos Árabes,784,10,10,,20,"(3.541112,-76.384584)"
2022,Marzo,Emiratos Árabes,784,284,463,,748,"(4.697144,-74.140516)"
2022,Marzo,Emiratos Árabes,784,1,0,,1,"(4.815061,-75.736532)"
2022,Marzo,Emiratos Árabes,784,15,16,,31,"(6.171601,-75.427454)"
2022,Marzo,Eritrea,232,1,0,,1,"(4.697144,-74.140516)"
2022,Marzo,Eslovaquia,703,1,0,,1,"(3.541112,-76.384584)"
2022,Marzo,Eslovaquia,703,0,4,,4,"(4.697144,-74.140516)"
2022,Marzo,Eslovaquia,703,1,0,,1,"(6.171601,-75.427454)"
2022,Marzo,Eslovenia,705,1,1,,2,"(4.697144,-74.140516)"
2022,Marzo,Estados Unidos de América,840,3,0,,3,"(0.814836,-77.662532)"
2022,Marzo,Estados Unidos de América,840,2908,2251,,5159,"(10.445761,-75.516429)"
2022,Marzo,Estados Unidos de América,840,4701,3896,,8597,"(10.886611,-74.776708)"
2022,Marzo,Estados Unidos de América,840,9,12,,21,"(11.117806,-74.232622)"
2022,Marzo,Estados Unidos de América,840,123,78,,201,"(12.586067,-81.702563)"
2022,Marzo,Estados Unidos de América,840,9845,7120,,16965,"(3.541112,-76.384584)"
2022,Marzo,Estados Unidos de América,840,0,1,,1,"(4.424712,-75.139263)"
2022,Marzo,Estados Unidos de América,840,1064,820,,1884,"(4.452882,-75.766298)"
2022,Marzo,Estados Unidos de América,840,33336,29332,,62668,"(4.697144,-74.140516)"
2022,Marzo,Estados Unidos de América,840,1883,1365,,3248,"(4.815061,-75.736532)"
2022,Marzo,Estados Unidos de América,840,13244,10472,,23716,"(6.171601,-75.427454)"
2022,Marzo,Estados Unidos de América,840,737,565,,1302,"(7.128456,-73.183637)"
2022,Marzo,Estados Unidos de América,840,59,34,,93,"(7.927209,-72.507910)"
2022,Marzo,Estonia,233,2,2,,4,"(4.697144,-74.140516)"
2022,Marzo,Etiopia,231,0,6,,6,"(4.697144,-74.140516)"
2022,Marzo,Filipinas,608,5,10,,15,"(4.697144,-74.140516)"
2022,Marzo,Finlandia,246,3,4,,7,"(3.541112,-76.384584)"
2022,Marzo,Finlandia,246,20,16,,36,"(4.697144,-74.140516)"
2022,Marzo,Finlandia,246,4,1,,5,"(6.171601,-75.427454)"
2022,Marzo,Francia,250,29,16,,45,"(10.445761,-75.516429)"
2022,Marzo,Francia,250,9,8,,17,"(10.886611,-74.776708)"
2022,Marzo,Francia,250,1,0,,1,"(12.586067,-81.702563)"
2022,Marzo,Francia,250,91,77,,168,"(3.541112,-76.384584)"
2022,Marzo,Francia,250,1,3,,4,"(4.452882,-75.766298)"
2022,Marzo,Francia,250,1961,1529,,3490,"(4.697144,-74.140516)"
2022,Marzo,Francia,250,3,4,,7,"(4.815061,-75.736532)"
2022,Marzo,Francia,250,130,82,,212,"(6.171601,-75.427454)"
2022,Marzo,Francia,250,2,0,,2,"(7.128456,-73.183637)"
2022,Marzo,Gabón,266,0,2,,2,"(4.697144,-74.140516)"
2022,Marzo,Gabón,266,0,1,,1,"(6.171601,-75.427454)"
2022,Marzo,Georgia,268,2,2,,4,"(10.886611,-74.776708)"
2022,Marzo,Georgia,268,1,0,,1,"(3.541112,-76.384584)"
2022,Marzo,Georgia,268,5,3,,8,"(4.697144,-74.140516)"
2022,Marzo,Georgia,268,2,0,,2,"(6.171601,-75.427454)"
2022,Marzo,Ghana,288,6,4,,10,"(4.697144,-74.140516)"
2022,Marzo,Granada,308,0,1,,1,"(3.541112,-76.384584)"
2022,Marzo,Grecia,300,1,0,,1,"(10.445761,-75.516429)"
2022,Marzo,Grecia,300,1,0,,1,"(3.541112,-76.384584)"
2022,Marzo,Grecia,300,17,21,,38,"(4.697144,-74.140516)"
2022,Marzo,Grecia,300,3,2,,5,"(6.171601,-75.427454)"
2022,Marzo,Guatemala,320,8,6,,14,"(10.445761,-75.516429)"
2022,Marzo,Guatemala,320,22,35,,57,"(10.886611,-74.776708)"
2022,Marzo,Guatemala,320,68,77,,145,"(3.541112,-76.384584)"
2022,Marzo,Guatemala,320,2,1,,3,"(4.452882,-75.766298)"
2022,Marzo,Guatemala,320,483,638,,1121,"(4.697144,-74.140516)"
2022,Marzo,Guatemala,320,18,28,,46,"(4.815061,-75.736532)"
2022,Marzo,Guatemala,320,140,109,,249,"(6.171601,-75.427454)"
2022,Marzo,Guatemala,320,6,10,,16,"(7.128456,-73.183637)"
2022,Marzo,Guatemala,320,1,0,,1,"(7.927209,-72.507910)"
2022,Marzo,Guyana,328,1,3,,4,"(10.886611,-74.776708)"
2022,Marzo,Guyana,328,3,3,,6,"(3.541112,-76.384584)"
2022,Marzo,Guyana,328,3,23,,26,"(4.697144,-74.140516)"
2022,Marzo,Guyana,328,1,1,,2,"(4.815061,-75.736532)"
2022,Marzo,Guyana,328,2,5,,7,"(6.171601,-75.427454)"
2022,Marzo,Guinea Ecuatorial,226,1,4,,5,"(4.697144,-74.140516)"
2022,Marzo,Guinea Bissau,624,1,0,,1,"(4.697144,-74.140516)"
2022,Marzo,Guadalupe/Territorio Francés,312,5,0,,5,"(3.541112,-76.384584)"
2022,Marzo,Guadalupe/Territorio Francés,312,1,2,,3,"(4.697144,-74.140516)"
2022,Marzo,Guam/Territorio no incorporado de Estados Unidos,316,0,2,,2,"(4.697144,-74.140516)"
2022,Marzo,Guayana Francesa/Departamento de Ultramar Francés,254,0,1,,1,"(4.697144,-74.140516)"
2022,Marzo,Guayana Francesa/Departamento de Ultramar Francés,254,0,1,,1,"(6.171601,-75.427454)"
2022,Marzo,Haití,332,0,1,,1,"(10.886611,-74.776708)"
2022,Marzo,Haití,332,2,3,,5,"(4.697144,-74.140516)"
2022,Marzo,Haití,332,0,1,,1,"(4.815061,-75.736532)"
2022,Marzo,Haití,332,0,1,,1,"(6.171601,-75.427454)"
2022,Marzo,Honduras,340,3,2,,5,"(10.445761,-75.516429)"
2022,Marzo,Honduras,340,10,15,,25,"(10.886611,-74.776708)"
2022,Marzo,Honduras,340,14,28,,42,"(3.541112,-76.384584)"
2022,Marzo,Honduras,340,71,157,,228,"(4.697144,-74.140516)"
2022,Marzo,Honduras,340,5,3,,8,"(4.815061,-75.736532)"
2022,Marzo,Honduras,340,31,41,,72,"(6.171601,-75.427454)"
2022,Marzo,Honduras,340,3,5,,8,"(7.128456,-73.183637)"
2022,Marzo,Honduras,340,0,1,,1,"(7.927209,-72.507910)"
2022,Marzo,Hong Kong,344,2,4,,6,"(4.697144,-74.140516)"
2022,Marzo,Hong Kong,344,1,0,,1,"(6.171601,-75.427454)"
2022,Marzo,Hungría,348,1,0,,1,"(10.445761,-75.516429)"
2022,Marzo,Hungría,348,5,1,,6,"(3.541112,-76.384584)"
2022,Marzo,Hungría,348,11,13,,24,"(4.697144,-74.140516)"
2022,Marzo,Hungría,348,0,2,,2,"(4.815061,-75.736532)"
2022,Marzo,Hungría,348,2,2,,4,"(6.171601,-75.427454)"
2022,Marzo,India,356,1,0,,1,"(10.445761,-75.516429)"
2022,Marzo,India,356,1,0,,1,"(12.586067,-81.702563)"
2022,Marzo,India,356,45,39,,84,"(4.697144,-74.140516)"
2022,Marzo,India,356,3,7,,10,"(6.171601,-75.427454)"
2022,Marzo,Indonesia,360,3,1,,4,"(4.697144,-74.140516)"
2022,Marzo,Iraq,368,1,5,,6,"(4.697144,-74.140516)"
2022,Marzo,Irán,364,3,0,,3,"(4.697144,-74.140516)"
2022,Marzo,República de Irlanda,372,1,0,,1,"(10.445761,-75.516429)"
2022,Marzo,República de Irlanda,372,1,0,,1,"(10.886611,-74.776708)"
2022,Marzo,República de Irlanda,372,0,3,,3,"(3.541112,-76.384584)"
2022,Marzo,República de Irlanda,372,15,6,,21,"(4.697144,-74.140516)"
2022,Marzo,República de Irlanda,372,3,2,,5,"(6.171601,-75.427454)"
2022,Marzo,Islandia,352,0,1,,1,"(3.541112,-76.384584)"
2022,Marzo,Islandia,352,27,22,,49,"(4.697144,-74.140516)"
2022,Marzo,Islandia,352,1,1,,2,"(6.171601,-75.427454)"
2022,Marzo,Israel,376,2,2,,4,"(10.445761,-75.516429)"
2022,Marzo,Israel,376,0,2,,2,"(10.886611,-74.776708)"
2022,Marzo,Israel,376,11,5,,16,"(3.541112,-76.384584)"
2022,Marzo,Israel,376,175,139,,314,"(4.697144,-74.140516)"
2022,Marzo,Israel,376,1,2,,3,"(4.815061,-75.736532)"
2022,Marzo,Israel,376,19,15,,34,"(6.171601,-75.427454)"
2022,Marzo,Italia,380,1,1,,2,"(0.814836,-77.662532)"
2022,Marzo,Italia,380,53,20,,73,"(10.445761,-75.516429)"
2022,Marzo,Italia,380,2,2,,4,"(10.886611,-74.776708)"
2022,Marzo,Italia,380,183,82,,265,"(3.541112,-76.384584)"
2022,Marzo,Italia,380,968,694,,1662,"(4.697144,-74.140516)"
2022,Marzo,Italia,380,3,1,,4,"(4.815061,-75.736532)"
2022,Marzo,Italia,380,141,82,,223,"(6.171601,-75.427454)"
2022,Marzo,Italia,380,1,0,,1,"(7.128456,-73.183637)"
2022,Marzo,Jamaica,388,6,3,,9,"(10.445761,-75.516429)"
2022,Marzo,Jamaica,388,2,5,,7,"(10.886611,-74.776708)"
2022,Marzo,Jamaica,388,2,0,,2,"(12.586067,-81.702563)"
2022,Marzo,Jamaica,388,7,10,,17,"(3.541112,-76.384584)"
2022,Marzo,Jamaica,388,36,49,,85,"(4.697144,-74.140516)"
2022,Marzo,Jamaica,388,2,1,,3,"(4.815061,-75.736532)"
2022,Marzo,Jamaica,388,15,16,,31,"(6.171601,-75.427454)"
2022,Marzo,Japón,392,0,1,,1,"(10.886611,-74.776708)"
2022,Marzo,Japón,392,4,4,,8,"(3.541112,-76.384584)"
2022,Marzo,Japón,392,27,22,,49,"(4.697144,-74.140516)"
2022,Marzo,Japón,392,1,0,,1,"(4.815061,-75.736532)"
2022,Marzo,Japón,392,1,2,,3,"(6.171601,-75.427454)"
2022,Marzo,Jordania,400,3,4,,7,"(4.697144,-74.140516)"
2022,Marzo,Jordania,400,1,0,,1,"(6.171601,-75.427454)"
2022,Marzo,Kazajistán,398,3,4,,7,"(4.697144,-74.140516)"
2022,Marzo,Kenia,404,1,1,,2,"(10.445761,-75.516429)"
2022,Marzo,Kenia,404,0,1,,1,"(3.541112,-76.384584)"
2022,Marzo,Kenia,404,8,3,,11,"(4.697144,-74.140516)"
2022,Marzo,Kuwait,414,3,3,,6,"(4.697144,-74.140516)"
2022,Marzo,Kuwait,414,1,0,,1,"(6.171601,-75.427454)"
2022,Marzo,República de Kosovo,901,0,1,,1,"(4.697144,-74.140516)"
2022,Marzo,Letonia,428,2,0,,2,"(6.171601,-75.427454)"
2022,Marzo,Lituania,440,1,1,,2,"(6.171601,-75.427454)"
2022,Marzo,Líbano,422,3,3,,6,"(10.886611,-74.776708)"
2022,Marzo,Líbano,422,1,0,,1,"(3.541112,-76.384584)"
2022,Marzo,Líbano,422,9,9,,18,"(4.697144,-74.140516)"
2022,Marzo,Liechtenstein,438,1,0,,1,"(10.445761,-75.516429)"
2022,Marzo,Luxemburgo,442,1,0,,1,"(10.445761,-75.516429)"
2022,Marzo,Luxemburgo,442,2,1,,3,"(3.541112,-76.384584)"
2022,Marzo,Luxemburgo,442,13,7,,20,"(4.697144,-74.140516)"
2022,Marzo,Luxemburgo,442,1,0,,1,"(6.171601,-75.427454)"
2022,Marzo,Macedonia,807,1,1,,2,"(4.697144,-74.140516)"
2022,Marzo,Malasia,458,1,0,,1,"(3.541112,-76.384584)"
2022,Marzo,Malasia,458,1,0,,1,"(4.697144,-74.140516)"
2022,Marzo,Malawi,454,1,0,,1,"(4.697144,-74.140516)"
2022,Marzo,Malawi,454,1,0,,1,"(6.171601,-75.427454)"
2022,Marzo,Maldivas,462,5,3,,8,"(4.697144,-74.140516)"
2022,Marzo,Malí,466,0,3,,3,"(4.697144,-74.140516)"
2022,Marzo,Malta,470,0,3,,3,"(10.445761,-75.516429)"
2022,Marzo,Malta,470,1,3,,4,"(3.541112,-76.384584)"
2022,Marzo,Malta,470,148,145,,293,"(4.697144,-74.140516)"
2022,Marzo,Malta,470,1,2,,3,"(4.815061,-75.736532)"
2022,Marzo,Malta,470,8,12,,20,"(6.171601,-75.427454)"
2022,Marzo,Marruecos,504,1,0,,1,"(10.445761,-75.516429)"
2022,Marzo,Marruecos,504,21,10,,31,"(4.697144,-74.140516)"
2022,Marzo,Marruecos,504,4,2,,6,"(6.171601,-75.427454)"
2022,Marzo,Mauricio,480,1,0,,1,"(4.697144,-74.140516)"
2022,Marzo,Mauritania,478,0,3,,3,"(4.697144,-74.140516)"
2022,Marzo,Martinica/Departamento de Ultramar Francés,474,0,3,,3,"(4.697144,-74.140516)"
2022,Marzo,Martinica/Departamento de Ultramar Francés,474,1,0,,1,"(6.171601,-75.427454)"
2022,Marzo,Martinica/Departamento de Ultramar Francés,474,1,0,,1,"(7.927209,-72.507910)"
2022,Marzo,México,484,0,11,,11,"(10.408582,-75.538003)"
2022,Marzo,México,484,56,41,,97,"(10.445761,-75.516429)"
2022,Marzo,México,484,278,250,,528,"(10.886611,-74.776708)"
2022,Marzo,México,484,1,0,,1,"(12.586067,-81.702563)"
2022,Marzo,México,484,2731,2609,,5340,"(3.541112,-76.384584)"
2022,Marzo,México,484,16,14,,30,"(4.452882,-75.766298)"
2022,Marzo,México,484,22754,23553,,46307,"(4.697144,-74.140516)"
2022,Marzo,México,484,162,114,,276,"(4.815061,-75.736532)"
2022,Marzo,México,484,8143,7335,,15478,"(6.171601,-75.427454)"
2022,Marzo,México,484,121,152,,273,"(7.128456,-73.183637)"
2022,Marzo,México,484,35,26,,61,"(7.927209,-72.507910)"
2022,Marzo,Mayotte/Colectividad Territorial Francesa,175,1,0,,1,"(4.697144,-74.140516)"
2022,Marzo,Mónaco,492,1,0,,1,"(6.171601,-75.427454)"
2022,Marzo,Mozambique,508,0,2,,2,"(4.697144,-74.140516)"
2022,Marzo,Nepal,524,1,1,,2,"(10.445761,-75.516429)"
2022,Marzo,Nepal,524,0,1,,1,"(3.541112,-76.384584)"
2022,Marzo,Nepal,524,4,5,,9,"(4.697144,-74.140516)"
2022,Marzo,Nepal,524,1,3,,4,"(6.171601,-75.427454)"
2022,Marzo,Nicaragua,558,0,1,,1,"(10.886611,-74.776708)"
2022,Marzo,Nicaragua,558,2,5,,7,"(12.5744111,-81.703935)"
2022,Marzo,Nicaragua,558,3,6,,9,"(3.541112,-76.384584)"
2022,Marzo,Nicaragua,558,27,64,,91,"(4.697144,-74.140516)"
2022,Marzo,Nicaragua,558,1,1,,2,"(4.815061,-75.736532)"
2022,Marzo,Nicaragua,558,4,11,,15,"(6.171601,-75.427454)"
2022,Marzo,Nicaragua,558,0,1,,1,"(7.128456,-73.183637)"
2022,Marzo,Nigeria,566,1,2,,3,"(4.697144,-74.140516)"
2022,Marzo,Noruega,578,4,3,,7,"(10.445761,-75.516429)"
2022,Marzo,Noruega,578,8,3,,11,"(3.541112,-76.384584)"
2022,Marzo,Noruega,578,36,23,,59,"(4.697144,-74.140516)"
2022,Marzo,Noruega,578,10,9,,19,"(6.171601,-75.427454)"
2022,Marzo,Nueva Zelanda,554,1,0,,1,"(3.541112,-76.384584)"
2022,Marzo,Nueva Zelanda,554,8,4,,12,"(4.697144,-74.140516)"
2022,Marzo,Omán,512,1,6,,7,"(4.697144,-74.140516)"
2022,Marzo,Omán,512,0,1,,1,"(4.815061,-75.736532)"
2022,Marzo,Omán,512,0,1,,1,"(6.171601,-75.427454)"
2022,Marzo,Papúa Nueva Guinea,598,0,1,,1,"(10.445761,-75.516429)"
2022,Marzo,Papúa Nueva Guinea,598,0,1,,1,"(4.697144,-74.140516)"
2022,Marzo,Pakistán,586,1,0,,1,"(4.697144,-74.140516)"
2022,Marzo,Panamá,591,15,44,,59,"(10.408582,-75.538003)"
2022,Marzo,Panamá,591,1194,899,,2093,"(10.445761,-75.516429)"
2022,Marzo,Panamá,591,621,621,,1242,"(10.886611,-74.776708)"
2022,Marzo,Panamá,591,4,16,,20,"(10.971302,-74.765397)"
2022,Marzo,Panamá,591,0,2,,2,"(12.165168,-71.983761)"
2022,Marzo,Panamá,591,3,13,,16,"(12.5744111,-81.703935)"
2022,Marzo,Panamá,591,19,28,,47,"(12.586067,-81.702563)"
2022,Marzo,Panamá,591,0,8,,8,"(13.3387613,-81.372937)"
2022,Marzo,Panamá,591,2137,1571,,3708,"(3.541112,-76.384584)"
2022,Marzo,Panamá,591,105,91,,196,"(4.452882,-75.766298)"
2022,Marzo,Panamá,591,5097,5630,,10727,"(4.697144,-74.140516)"
2022,Marzo,Panamá,591,246,174,,420,"(4.815061,-75.736532)"
2022,Marzo,Panamá,591,2172,2018,,4190,"(6.171601,-75.427454)"
2022,Marzo,Panamá,591,3,11,,14,"(6.228046,-77.404104)"
2022,Marzo,Panamá,591,9,13,,22,"(7.102626,-77.762647)"
2022,Marzo,Panamá,591,101,76,,177,"(7.128456,-73.183637)"
2022,Marzo,Panamá,591,59,38,,97,"(7.927209,-72.507910)"
2022,Marzo,Panamá,591,0,6,,6,"(8.066966,-76.735404)"
2022,Marzo,Panamá,591,0,1,,1,"(8.36068,-72.409396)"
2022,Marzo,Panamá,591,41,107,,148,"(8.635765,-77.346578)"
2022,Marzo,Paraguay,600,1,9,,10,"(0.814836,-77.662532)"
2022,Marzo,Paraguay,600,1,3,,4,"(10.445761,-75.516429)"
2022,Marzo,Paraguay,600,2,5,,7,"(10.886611,-74.776708)"
2022,Marzo,Paraguay,600,61,51,,112,"(3.541112,-76.384584)"
2022,Marzo,Paraguay,600,4,3,,7,"(4.452882,-75.766298)"
2022,Marzo,Paraguay,600,213,313,,526,"(4.697144,-74.140516)"
2022,Marzo,Paraguay,600,3,6,,9,"(4.815061,-75.736532)"
2022,Marzo,Paraguay,600,22,33,,55,"(6.171601,-75.427454)"
2022,Marzo,Paraguay,600,1,1,,2,"(7.128456,-73.183637)"
2022,Marzo,Paraguay,600,0,2,,2,"(7.927209,-72.507910)"
2022,Marzo,Perú,604,0,3,,3,"(-0.193180,-74.784874)"
2022,Marzo,Perú,604,85,143,,228,"(-4.197703,-69.941278)"
2022,Marzo,Perú,604,1,4,,5,"(0.25129,-76.875963)"
2022,Marzo,Perú,604,33,63,,96,"(0.814836,-77.662532)"
2022,Marzo,Perú,604,4,3,,7,"(10.445761,-75.516429)"
2022,Marzo,Perú,604,18,16,,34,"(10.886611,-74.776708)"
2022,Marzo,Perú,604,74,90,,164,"(3.541112,-76.384584)"
2022,Marzo,Perú,604,6,7,,13,"(4.452882,-75.766298)"
2022,Marzo,Perú,604,3454,3909,,7363,"(4.697144,-74.140516)"
2022,Marzo,Perú,604,12,10,,22,"(4.815061,-75.736532)"
2022,Marzo,Perú,604,660,611,,1271,"(6.171601,-75.427454)"
2022,Marzo,Perú,604,3,3,,6,"(7.128456,-73.183637)"
2022,Marzo,Perú,604,0,1,,1,"(7.927209,-72.507910)"
2022,Marzo,Polonia,616,0,2,,2,"(10.445761,-75.516429)"
2022,Marzo,Polonia,616,1,1,,2,"(3.541112,-76.384584)"
2022,Marzo,Polonia,616,15,61,,76,"(4.697144,-74.140516)"
2022,Marzo,Polonia,616,1,6,,7,"(6.171601,-75.427454)"
2022,Marzo,Portugal,620,8,2,,10,"(10.445761,-75.516429)"
2022,Marzo,Portugal,620,3,1,,4,"(10.886611,-74.776708)"
2022,Marzo,Portugal,620,18,19,,37,"(3.541112,-76.384584)"
2022,Marzo,Portugal,620,355,330,,685,"(4.697144,-74.140516)"
2022,Marzo,Portugal,620,113,101,,214,"(6.171601,-75.427454)"
2022,Marzo,Polinesia Francesa/Colectividad de Ultramar Francesa,258,1,0,,1,"(4.697144,-74.140516)"
2022,Marzo,Puerto Rico/Territorio de Estados Unidos,630,7,5,,12,"(10.445761,-75.516429)"
2022,Marzo,Puerto Rico/Territorio de Estados Unidos,630,7,3,,10,"(10.886611,-74.776708)"
2022,Marzo,Puerto Rico/Territorio de Estados Unidos,630,51,34,,85,"(3.541112,-76.384584)"
2022,Marzo,Puerto Rico/Territorio de Estados Unidos,630,3,1,,4,"(4.452882,-75.766298)"
2022,Marzo,Puerto Rico/Territorio de Estados Unidos,630,507,477,,984,"(4.697144,-74.140516)"
2022,Marzo,Puerto Rico/Territorio de Estados Unidos,630,1,1,,2,"(4.815061,-75.736532)"
2022,Marzo,Puerto Rico/Territorio de Estados Unidos,630,63,37,,100,"(6.171601,-75.427454)"
2022,Marzo,Qatar,634,1,1,,2,"(10.445761,-75.516429)"
2022,Marzo,Qatar,634,0,1,,1,"(10.886611,-74.776708)"
2022,Marzo,Qatar,634,1,0,,1,"(3.541112,-76.384584)"
2022,Marzo,Qatar,634,20,51,,71,"(4.697144,-74.140516)"
2022,Marzo,Qatar,634,1,1,,2,"(4.815061,-75.736532)"
2022,Marzo,Qatar,634,1,0,,1,"(6.171601,-75.427454)"
2022,Marzo,Reino Unido de Gran Bretaña e Irlanda del Norte,826,6,6,,12,"(10.445761,-75.516429)"
2022,Marzo,Reino Unido de Gran Bretaña e Irlanda del Norte,826,5,7,,12,"(10.886611,-74.776708)"
2022,Marzo,Reino Unido de Gran Bretaña e Irlanda del Norte,826,88,44,,132,"(3.541112,-76.384584)"
2022,Marzo,Reino Unido de Gran Bretaña e Irlanda del Norte,826,789,560,,1349,"(4.697144,-74.140516)"
2022,Marzo,Reino Unido de Gran Bretaña e Irlanda del Norte,826,4,5,,9,"(4.815061,-75.736532)"
2022,Marzo,Reino Unido de Gran Bretaña e Irlanda del Norte,826,78,54,,132,"(6.171601,-75.427454)"
2022,Marzo,Reino Unido de Gran Bretaña e Irlanda del Norte,826,1,0,,1,"(7.128456,-73.183637)"
2022,Marzo,República CentroÁfricana,140,4,3,,7,"(4.697144,-74.140516)"
2022,Marzo,Federación de Rusia,643,1,0,,1,"(10.445761,-75.516429)"
2022,Marzo,Federación de Rusia,643,19,24,,43,"(4.697144,-74.140516)"
2022,Marzo,Federación de Rusia,643,0,1,,1,"(6.171601,-75.427454)"
2022,Marzo,República Dominicana,214,19,17,,36,"(10.445761,-75.516429)"
2022,Marzo,República Dominicana,214,145,112,,257,"(10.886611,-74.776708)"
2022,Marzo,República Dominicana,214,0,1,,1,"(12.586067,-81.702563)"
2022,Marzo,República Dominicana,214,482,363,,845,"(3.541112,-76.384584)"
2022,Marzo,República Dominicana,214,1,3,,4,"(4.452882,-75.766298)"
2022,Marzo,República Dominicana,214,5001,4218,,9219,"(4.697144,-74.140516)"
2022,Marzo,República Dominicana,214,51,59,,110,"(4.815061,-75.736532)"
2022,Marzo,República Dominicana,214,2767,2115,,4882,"(6.171601,-75.427454)"
2022,Marzo,República Dominicana,214,17,14,,31,"(7.128456,-73.183637)"
2022,Marzo,República Dominicana,214,6,4,,10,"(7.927209,-72.507910)"
2022,Marzo,República Democrática Popular de Corea,408,1,0,,1,"(4.697144,-74.140516)"
2022,Marzo,Rumania,642,1,0,,1,"(3.541112,-76.384584)"
2022,Marzo,Rumania,642,5,3,,8,"(4.697144,-74.140516)"
2022,Marzo,Rwanda,646,0,2,,2,"(4.697144,-74.140516)"
2022,Marzo,San Cristóbal y Nevis,659,1,0,,1,"(7.916725,-72.462544)"
2022,Marzo,San  Vicente y las Granadinas,670,1,0,,1,"(4.697144,-74.140516)"
2022,Marzo,Santa Lucia,662,0,2,,2,"(3.541112,-76.384584)"
2022,Marzo,Santa Sede/Ciudad del Vaticano,336,0,1,,1,"(3.541112,-76.384584)"
2022,Marzo,Santa Sede/Ciudad del Vaticano,336,1,0,,1,"(4.697144,-74.140516)"
2022,Marzo,Serbia,688,1,1,,2,"(4.697144,-74.140516)"
2022,Marzo,Singapur,702,4,6,,10,"(4.697144,-74.140516)"
2022,Marzo,Somalia,706,0,1,,1,"(4.697144,-74.140516)"
2022,Marzo,Sri Lanka,144,2,1,,3,"(4.697144,-74.140516)"
2022,Marzo,Sudáfrica,710,0,1,,1,"(3.541112,-76.384584)"
2022,Marzo,Sudáfrica,710,6,15,,21,"(4.697144,-74.140516)"
2022,Marzo,Sudáfrica,710,2,0,,2,"(6.171601,-75.427454)"
2022,Marzo,Sudán,736,1,0,,1,"(6.171601,-75.427454)"
2022,Marzo,Suecia,752,9,6,,15,"(10.445761,-75.516429)"
2022,Marzo,Suecia,752,4,1,,5,"(10.886611,-74.776708)"
2022,Marzo,Suecia,752,17,18,,35,"(3.541112,-76.384584)"
2022,Marzo,Suecia,752,71,71,,142,"(4.697144,-74.140516)"
2022,Marzo,Suecia,752,16,8,,24,"(6.171601,-75.427454)"
2022,Marzo,Suecia,752,0,1,,1,"(7.128456,-73.183637)"
2022,Marzo,Suiza,756,18,4,,22,"(10.445761,-75.516429)"
2022,Marzo,Suiza,756,6,2,,8,"(10.886611,-74.776708)"
2022,Marzo,Suiza,756,60,35,,95,"(3.541112,-76.384584)"
2022,Marzo,Suiza,756,3,4,,7,"(4.452882,-75.766298)"
2022,Marzo,Suiza,756,354,210,,564,"(4.697144,-74.140516)"
2022,Marzo,Suiza,756,3,1,,4,"(4.815061,-75.736532)"
2022,Marzo,Suiza,756,41,32,,73,"(6.171601,-75.427454)"
2022,Marzo,Surinam,740,1,1,,2,"(3.541112,-76.384584)"
2022,Marzo,Surinam,740,5,15,,20,"(4.697144,-74.140516)"
2022,Marzo,Surinam,740,2,6,,8,"(6.171601,-75.427454)"
2022,Marzo,Taiwán,158,2,2,,4,"(4.697144,-74.140516)"
2022,Marzo,República de Tayikistán,762,0,1,,1,"(4.697144,-74.140516)"
2022,Marzo,Tailandia,764,5,7,,12,"(4.697144,-74.140516)"
2022,Marzo,Tanzania,834,0,1,,1,"(3.541112,-76.384584)"
2022,Marzo,Tanzania,834,1,0,,1,"(4.697144,-74.140516)"
2022,Marzo,República Democrática de Timor Oriental,626,1,1,,2,"(4.697144,-74.140516)"
2022,Marzo,Trinidad y Tobago,780,1,0,,1,"(10.445761,-75.516429)"
2022,Marzo,Trinidad y Tobago,780,1,2,,3,"(10.886611,-74.776708)"
2022,Marzo,Trinidad y Tobago,780,3,2,,5,"(3.541112,-76.384584)"
2022,Marzo,Trinidad y Tobago,780,1,1,,2,"(4.452882,-75.766298)"
2022,Marzo,Trinidad y Tobago,780,11,23,,34,"(4.697144,-74.140516)"
2022,Marzo,Trinidad y Tobago,780,10,6,,16,"(6.171601,-75.427454)"
2022,Marzo,Trinidad y Tobago,780,2,0,,2,"(7.927209,-72.507910)"
2022,Marzo,Túnez,788,1,1,,2,"(4.697144,-74.140516)"
2022,Marzo,Turquía,792,1,0,,1,"(10.445761,-75.516429)"
2022,Marzo,Turquía,792,1,0,,1,"(10.886611,-74.776708)"
2022,Marzo,Turquía,792,2,1,,3,"(3.541112,-76.384584)"
2022,Marzo,Turquía,792,1228,889,,2117,"(4.697144,-74.140516)"
2022,Marzo,Turquía,792,1,0,,1,"(4.815061,-75.736532)"
2022,Marzo,Turquía,792,16,13,,29,"(6.171601,-75.427454)"
2022,Marzo,Turkmenistán,795,2,1,,3,"(4.697144,-74.140516)"
2022,Marzo,Ucrania,804,1,1,,2,"(6.171601,-75.427454)"
2022,Marzo,Uganda,800,1,1,,2,"(4.697144,-74.140516)"
2022,Marzo,Uruguay,858,5,6,,11,"(10.445761,-75.516429)"
2022,Marzo,Uruguay,858,6,3,,9,"(10.886611,-74.776708)"
2022,Marzo,Uruguay,858,66,83,,149,"(3.541112,-76.384584)"
2022,Marzo,Uruguay,858,4,2,,6,"(4.452882,-75.766298)"
2022,Marzo,Uruguay,858,254,277,,531,"(4.697144,-74.140516)"
2022,Marzo,Uruguay,858,15,16,,31,"(4.815061,-75.736532)"
2022,Marzo,Uruguay,858,25,31,,56,"(6.171601,-75.427454)"
2022,Marzo,Uruguay,858,2,5,,7,"(7.128456,-73.183637)"
2022,Marzo,Uruguay,858,3,0,,3,"(7.927209,-72.507910)"
2022,Marzo,Venezuela,862,8,12,,20,"(10.445761,-75.516429)"
2022,Marzo,Venezuela,862,36,98,,134,"(10.886611,-74.776708)"
2022,Marzo,Venezuela,862,117,294,,411,"(11.360009,-72.129330)"
2022,Marzo,Venezuela,862,21,51,,72,"(3.541112,-76.384584)"
2022,Marzo,Venezuela,862,0,2,,2,"(3.866713,-67.927521)"
2022,Marzo,Venezuela,862,130,220,,350,"(4.697144,-74.140516)"
2022,Marzo,Venezuela,862,12,18,,30,"(4.815061,-75.736532)"
2022,Marzo,Venezuela,862,62,65,,127,"(6.171601,-75.427454)"
2022,Marzo,Venezuela,862,0,3,,3,"(6.185799,-67.483929)"
2022,Marzo,Venezuela,862,4,12,,16,"(7.088729,-70.740253)"
2022,Marzo,Venezuela,862,2,7,,9,"(7.128456,-73.183637)"
2022,Marzo,Venezuela,862,226,302,,528,"(7.818934,-72.453226)"
2022,Marzo,Venezuela,862,41,44,,85,"(7.916725,-72.462544)"
2022,Marzo,Venezuela,862,3,4,,7,"(7.927209,-72.507910)"
2022,Marzo,Venezuela,862,13,16,,29,"(8.36068,-72.409396)"
2022,Marzo,Vietnam,704,0,1,,1,"(4.697144,-74.140516)"
2022,Marzo,Vietnam,704,0,2,,2,"(6.171601,-75.427454)"
2022,Marzo,Islas Vírgenes Británicas/Territorio Británico de Ultramar,92,2,1,,3,"(3.541112,-76.384584)"
2022,Marzo,Islas Vírgenes Británicas/Territorio Británico de Ultramar,92,0,2,,2,"(4.697144,-74.140516)"
2022,Marzo,Islas Vírgenes Estadounidenses/Territorio de Estados Unidos,850,0,3,,3,"(4.697144,-74.140516)"
2022,Marzo,Islas Vírgenes Estadounidenses/Territorio de Estados Unidos,850,0,1,,1,"(6.171601,-75.427454)"
2022,Marzo,Zambia,894,1,0,,1,"(4.697144,-74.140516)"
2022,Marzo,Zimbabue,716,0,1,,1,"(4.697144,-74.140516)"
2022,Marzo,Anguila/Territorio Británico de Ultramar,660,0,1,,1,"(3.541112,-76.384584)"
2022,Marzo,Islas Turcas y Caicos/Territorio Británico de Ultramar,796,4,0,,4,"(6.171601,-75.427454)"
2022,Marzo,Desconocido,99999,2,1,,3,"(4.697144,-74.140516)"
2022,Marzo,Desconocido,99999,0,1,,1,"(6.171601,-75.427454)"
2022,Abril,Afganistán,4,0,1,,1,"(4.697144,-74.140516)"
2022,Abril,Albania,8,2,1,,3,"(4.697144,-74.140516)"
2022,Abril,Albania,8,2,0,,2,"(6.171601,-75.427454)"
2022,Abril,Alemania,276,67,57,,124,"(10.445761,-75.516429)"
2022,Abril,Alemania,276,7,7,,14,"(10.886611,-74.776708)"
2022,Abril,Alemania,276,56,46,,102,"(3.541112,-76.384584)"
2022,Abril,Alemania,276,1,1,,2,"(4.452882,-75.766298)"
2022,Abril,Alemania,276,1467,1111,,2578,"(4.697144,-74.140516)"
2022,Abril,Alemania,276,5,6,,11,"(4.815061,-75.736532)"
2022,Abril,Alemania,276,101,84,,185,"(6.171601,-75.427454)"
2022,Abril,Alemania,276,1,1,,2,"(7.128456,-73.183637)"
2022,Abril,Andorra,20,7,7,,14,"(4.697144,-74.140516)"
2022,Abril,Andorra,20,2,3,,5,"(6.171601,-75.427454)"
2022,Abril,Angola,24,1,7,,8,"(4.697144,-74.140516)"
2022,Abril,Antigua y Barbuda,28,2,5,,7,"(10.886611,-74.776708)"
2022,Abril,Antigua y Barbuda,28,1,1,,2,"(4.697144,-74.140516)"
2022,Abril,Países Bajos,528,218,131,,349,"(10.445761,-75.516429)"
2022,Abril,Países Bajos,528,14,16,,30,"(10.886611,-74.776708)"
2022,Abril,Países Bajos,528,56,37,,93,"(3.541112,-76.384584)"
2022,Abril,Países Bajos,528,1122,964,,2086,"(4.697144,-74.140516)"
2022,Abril,Países Bajos,528,2,1,,3,"(4.815061,-75.736532)"
2022,Abril,Países Bajos,528,92,52,,144,"(6.171601,-75.427454)"
2022,Abril,Países Bajos,528,2,2,,4,"(7.128456,-73.183637)"
2022,Abril,Arabia Saudita,682,1,4,,5,"(10.445761,-75.516429)"
2022,Abril,Arabia Saudita,682,1,1,,2,"(3.541112,-76.384584)"
2022,Abril,Arabia Saudita,682,10,39,,49,"(4.697144,-74.140516)"
2022,Abril,Arabia Saudita,682,1,2,,3,"(6.171601,-75.427454)"
2022,Abril,Argelia,12,0,1,,1,"(3.541112,-76.384584)"
2022,Abril,Argelia,12,7,10,,17,"(4.697144,-74.140516)"
2022,Abril,Argentina,32,1,1,,2,"(0.25129,-76.875963)"
2022,Abril,Argentina,32,7,9,,16,"(0.814836,-77.662532)"
2022,Abril,Argentina,32,18,9,,27,"(10.445761,-75.516429)"
2022,Abril,Argentina,32,23,20,,43,"(10.886611,-74.776708)"
2022,Abril,Argentina,32,60,81,,141,"(3.541112,-76.384584)"
2022,Abril,Argentina,32,14,15,,29,"(4.452882,-75.766298)"
2022,Abril,Argentina,32,2359,2140,,4499,"(4.697144,-74.140516)"
2022,Abril,Argentina,32,4,6,,10,"(4.815061,-75.736532)"
2022,Abril,Argentina,32,137,125,,262,"(6.171601,-75.427454)"
2022,Abril,Argentina,32,2,0,,2,"(7.128456,-73.183637)"
2022,Abril,Argentina,32,12,17,,29,"(7.927209,-72.507910)"
2022,Abril,República de Armenia,51,1,0,,1,"(4.452882,-75.766298)"
2022,Abril,República de Armenia,51,1,1,,2,"(4.697144,-74.140516)"
2022,Abril,Aruba,533,155,108,,263,"(10.886611,-74.776708)"
2022,Abril,Aruba,533,69,54,,123,"(3.541112,-76.384584)"
2022,Abril,Aruba,533,1500,1217,,2717,"(4.697144,-74.140516)"
2022,Abril,Aruba,533,6,3,,9,"(4.815061,-75.736532)"
2022,Abril,Aruba,533,118,107,,225,"(6.171601,-75.427454)"
2022,Abril,Aruba,533,7,16,,23,"(7.128456,-73.183637)"
2022,Abril,Australia,36,1,2,,3,"(10.445761,-75.516429)"
2022,Abril,Australia,36,4,2,,6,"(10.886611,-74.776708)"
2022,Abril,Australia,36,20,15,,35,"(3.541112,-76.384584)"
2022,Abril,Australia,36,0,1,,1,"(4.452882,-75.766298)"
2022,Abril,Australia,36,342,268,,610,"(4.697144,-74.140516)"
2022,Abril,Australia,36,1,2,,3,"(4.815061,-75.736532)"
2022,Abril,Australia,36,51,32,,83,"(6.171601,-75.427454)"
2022,Abril,Australia,36,3,0,,3,"(7.128456,-73.183637)"
2022,Abril,Austria,40,2,4,,6,"(10.445761,-75.516429)"
2022,Abril,Austria,40,1,0,,1,"(10.886611,-74.776708)"
2022,Abril,Austria,40,1,2,,3,"(3.541112,-76.384584)"
2022,Abril,Austria,40,81,53,,134,"(4.697144,-74.140516)"
2022,Abril,Austria,40,1,2,,3,"(4.815061,-75.736532)"
2022,Abril,Austria,40,3,7,,10,"(6.171601,-75.427454)"
2022,Abril,Azerbaiyán,31,1,2,,3,"(4.697144,-74.140516)"
2022,Abril,Bahamas,44,0,1,,1,"(10.445761,-75.516429)"
2022,Abril,Bahamas,44,6,9,,15,"(10.886611,-74.776708)"
2022,Abril,Bahamas,44,50,24,,74,"(3.541112,-76.384584)"
2022,Abril,Bahamas,44,31,49,,80,"(4.697144,-74.140516)"
2022,Abril,Bahamas,44,0,2,,2,"(4.815061,-75.736532)"
2022,Abril,Bahamas,44,55,35,,90,"(6.171601,-75.427454)"
2022,Abril,Bahréin,48,0,1,,1,"(10.445761,-75.516429)"
2022,Abril,Bahréin,48,15,3,,18,"(4.697144,-74.140516)"
2022,Abril,Bahréin,48,3,0,,3,"(6.171601,-75.427454)"
2022,Abril,Bangladesh,50,0,1,,1,"(10.445761,-75.516429)"
2022,Abril,Bangladesh,50,0,1,,1,"(4.697144,-74.140516)"
2022,Abril,Barbados,52,1,0,,1,"(12.586067,-81.702563)"
2022,Abril,Barbados,52,0,1,,1,"(3.541112,-76.384584)"
2022,Abril,Barbados,52,6,5,,11,"(4.697144,-74.140516)"
2022,Abril,Barbados,52,1,0,,1,"(6.171601,-75.427454)"
2022,Abril,Bélgica,56,24,10,,34,"(10.445761,-75.516429)"
2022,Abril,Bélgica,56,2,2,,4,"(10.886611,-74.776708)"
2022,Abril,Bélgica,56,35,13,,48,"(3.541112,-76.384584)"
2022,Abril,Bélgica,56,168,115,,283,"(4.697144,-74.140516)"
2022,Abril,Bélgica,56,1,1,,2,"(4.815061,-75.736532)"
2022,Abril,Bélgica,56,55,30,,85,"(6.171601,-75.427454)"
2022,Abril,Belice,84,1,0,,1,"(10.445761,-75.516429)"
2022,Abril,Belice,84,3,5,,8,"(3.541112,-76.384584)"
2022,Abril,Belice,84,5,9,,14,"(4.697144,-74.140516)"
2022,Abril,Belice,84,4,3,,7,"(6.171601,-75.427454)"
2022,Abril,Benín,204,1,4,,5,"(4.697144,-74.140516)"
2022,Abril,Bermudas/Territorio Británico de Ultramar,60,0,2,,2,"(4.697144,-74.140516)"
2022,Abril,Bolivia,68,9,21,,30,"(0.814836,-77.662532)"
2022,Abril,Bolivia,68,0,3,,3,"(10.445761,-75.516429)"
2022,Abril,Bolivia,68,0,8,,8,"(10.886611,-74.776708)"
2022,Abril,Bolivia,68,7,8,,15,"(3.541112,-76.384584)"
2022,Abril,Bolivia,68,2,2,,4,"(4.452882,-75.766298)"
2022,Abril,Bolivia,68,551,828,,1379,"(4.697144,-74.140516)"
2022,Abril,Bolivia,68,5,2,,7,"(4.815061,-75.736532)"
2022,Abril,Bolivia,68,6,6,,12,"(6.171601,-75.427454)"
2022,Abril,Bosnia y Herzegovina,70,35,16,,51,"(4.697144,-74.140516)"
2022,Abril,Brasil,76,171,292,,463,"(-4.197703,-69.941278)"
2022,Abril,Brasil,76,1,5,,6,"(0.814836,-77.662532)"
2022,Abril,Brasil,76,10,12,,22,"(10.445761,-75.516429)"
2022,Abril,Brasil,76,17,30,,47,"(10.886611,-74.776708)"
2022,Abril,Brasil,76,174,230,,404,"(3.541112,-76.384584)"
2022,Abril,Brasil,76,0,1,,1,"(3.866713,-67.927521)"
2022,Abril,Brasil,76,20,37,,57,"(4.452882,-75.766298)"
2022,Abril,Brasil,76,2343,2954,,5297,"(4.697144,-74.140516)"
2022,Abril,Brasil,76,18,37,,55,"(4.815061,-75.736532)"
2022,Abril,Brasil,76,192,245,,437,"(6.171601,-75.427454)"
2022,Abril,Brasil,76,3,8,,11,"(7.128456,-73.183637)"
2022,Abril,Brasil,76,6,1,,7,"(7.927209,-72.507910)"
2022,Abril,Brunei Darussalam,96,0,1,,1,"(4.697144,-74.140516)"
2022,Abril,Bulgaria,100,10,9,,19,"(4.697144,-74.140516)"
2022,Abril,Bulgaria,100,0,1,,1,"(6.171601,-75.427454)"
2022,Abril,Burkina Faso,854,0,2,,2,"(4.697144,-74.140516)"
2022,Abril,Cabo Verde,132,1,0,,1,"(3.541112,-76.384584)"
2022,Abril,Cabo Verde,132,0,1,,1,"(4.697144,-74.140516)"
2022,Abril,Islas Caimán/Territorio Británico de Ultramar,136,3,2,,5,"(10.445761,-75.516429)"
2022,Abril,Islas Caimán/Territorio Británico de Ultramar,136,1,1,,2,"(12.586067,-81.702563)"
2022,Abril,Islas Caimán/Territorio Británico de Ultramar,136,1,1,,2,"(3.541112,-76.384584)"
2022,Abril,Islas Caimán/Territorio Británico de Ultramar,136,6,2,,8,"(4.697144,-74.140516)"
2022,Abril,Islas Caimán/Territorio Británico de Ultramar,136,2,2,,4,"(6.171601,-75.427454)"
2022,Abril,Camboya,116,4,2,,6,"(4.697144,-74.140516)"
2022,Abril,Camerún,120,2,0,,2,"(3.541112,-76.384584)"
2022,Abril,Camerún,120,0,1,,1,"(4.697144,-74.140516)"
2022,Abril,Canadá,124,100,73,,173,"(10.445761,-75.516429)"
2022,Abril,Canadá,124,40,38,,78,"(10.886611,-74.776708)"
2022,Abril,Canadá,124,141,106,,247,"(3.541112,-76.384584)"
2022,Abril,Canadá,124,5,2,,7,"(4.452882,-75.766298)"
2022,Abril,Canadá,124,3006,2491,,5497,"(4.697144,-74.140516)"
2022,Abril,Canadá,124,18,17,,35,"(4.815061,-75.736532)"
2022,Abril,Canadá,124,288,205,,493,"(6.171601,-75.427454)"
2022,Abril,Canadá,124,5,4,,9,"(7.128456,-73.183637)"
2022,Abril,Chad,148,1,0,,1,"(4.697144,-74.140516)"
2022,Abril,España,724,74,76,,150,"(10.445761,-75.516429)"
2022,Abril,España,724,22,13,,35,"(10.886611,-74.776708)"
2022,Abril,España,724,2868,2271,,5139,"(3.541112,-76.384584)"
2022,Abril,España,724,2,4,,6,"(4.452882,-75.766298)"
2022,Abril,España,724,22143,17894,,40037,"(4.697144,-74.140516)"
2022,Abril,España,724,22,21,,43,"(4.815061,-75.736532)"
2022,Abril,España,724,3187,2421,,5608,"(6.171601,-75.427454)"
2022,Abril,España,724,2,1,,3,"(7.128456,-73.183637)"
2022,Abril,Norfolk,574,1,0,,1,"(4.697144,-74.140516)"
2022,Abril,Colombia,170,1,3,,4,"(10.445761,-75.516429)"
2022,Abril,Colombia,170,39,97,,136,"(4.697144,-74.140516)"
2022,Abril,República Del Congo,178,0,1,,1,"(4.697144,-74.140516)"
2022,Abril,Comoras,174,0,1,,1,"(4.697144,-74.140516)"
2022,Abril,República Democrática del Congo,180,1,1,,2,"(4.697144,-74.140516)"
2022,Abril,República de Corea,410,0,1,,1,"(10.886611,-74.776708)"
2022,Abril,República de Corea,410,0,2,,2,"(3.541112,-76.384584)"
2022,Abril,República de Corea,410,24,24,,48,"(4.697144,-74.140516)"
2022,Abril,República de Corea,410,2,9,,11,"(6.171601,-75.427454)"
2022,Abril,Islas Malvinas,238,0,1,,1,"(4.697144,-74.140516)"
2022,Abril,Costa de Marfil,384,1,0,,1,"(4.697144,-74.140516)"
2022,Abril,Costa Rica,188,76,93,,169,"(10.445761,-75.516429)"
2022,Abril,Costa Rica,188,14,28,,42,"(10.886611,-74.776708)"
2022,Abril,Costa Rica,188,1,9,,10,"(12.5744111,-81.703935)"
2022,Abril,Costa Rica,188,0,1,,1,"(12.586067,-81.702563)"
2022,Abril,Costa Rica,188,84,73,,157,"(3.541112,-76.384584)"
2022,Abril,Costa Rica,188,4,0,,4,"(4.452882,-75.766298)"
2022,Abril,Costa Rica,188,1227,1233,,2460,"(4.697144,-74.140516)"
2022,Abril,Costa Rica,188,16,7,,23,"(4.815061,-75.736532)"
2022,Abril,Costa Rica,188,361,306,,667,"(6.171601,-75.427454)"
2022,Abril,Costa Rica,188,4,3,,7,"(7.128456,-73.183637)"
2022,Abril,Costa Rica,188,3,2,,5,"(7.927209,-72.507910)"
2022,Abril,Croacia,191,0,1,,1,"(3.541112,-76.384584)"
2022,Abril,Croacia,191,22,15,,37,"(4.697144,-74.140516)"
2022,Abril,Croacia,191,2,0,,2,"(6.171601,-75.427454)"
2022,Abril,Cuba,192,5,3,,8,"(10.445761,-75.516429)"
2022,Abril,Cuba,192,3,5,,8,"(10.886611,-74.776708)"
2022,Abril,Cuba,192,10,18,,28,"(3.541112,-76.384584)"
2022,Abril,Cuba,192,1,0,,1,"(4.452882,-75.766298)"
2022,Abril,Cuba,192,802,772,,1574,"(4.697144,-74.140516)"
2022,Abril,Cuba,192,9,7,,16,"(4.815061,-75.736532)"
2022,Abril,Cuba,192,30,39,,69,"(6.171601,-75.427454)"
2022,Abril,Cuba,192,2,3,,5,"(7.128456,-73.183637)"
2022,Abril,Curazao,99999,0,1,,1,"(10.408582,-75.538003)"
2022,Abril,Curazao,99999,53,32,,85,"(10.886611,-74.776708)"
2022,Abril,Curazao,99999,31,24,,55,"(3.541112,-76.384584)"
2022,Abril,Curazao,99999,1453,1194,,2647,"(4.697144,-74.140516)"
2022,Abril,Curazao,99999,1,0,,1,"(4.815061,-75.736532)"
2022,Abril,Curazao,99999,180,115,,295,"(6.171601,-75.427454)"
2022,Abril,República Checa,203,1,1,,2,"(10.445761,-75.516429)"
2022,Abril,República Checa,203,2,1,,3,"(10.886611,-74.776708)"
2022,Abril,República Checa,203,1,0,,1,"(3.541112,-76.384584)"
2022,Abril,República Checa,203,11,23,,34,"(4.697144,-74.140516)"
2022,Abril,República Checa,203,2,2,,4,"(4.815061,-75.736532)"
2022,Abril,República Checa,203,3,1,,4,"(6.171601,-75.427454)"
2022,Abril,Chile,152,30,37,,67,"(0.814836,-77.662532)"
2022,Abril,Chile,152,8,10,,18,"(10.445761,-75.516429)"
2022,Abril,Chile,152,43,38,,81,"(10.886611,-74.776708)"
2022,Abril,Chile,152,2827,2060,,4887,"(3.541112,-76.384584)"
2022,Abril,Chile,152,38,29,,67,"(4.452882,-75.766298)"
2022,Abril,Chile,152,4983,4222,,9205,"(4.697144,-74.140516)"
2022,Abril,Chile,152,16,19,,35,"(4.815061,-75.736532)"
2022,Abril,Chile,152,516,379,,895,"(6.171601,-75.427454)"
2022,Abril,Chile,152,8,6,,14,"(7.128456,-73.183637)"
2022,Abril,Chile,152,20,25,,45,"(7.927209,-72.507910)"
2022,Abril,China,156,1,1,,2,"(4.697144,-74.140516)"
2022,Abril,China,156,0,1,,1,"(6.171601,-75.427454)"
2022,Abril,Chipre,196,1,0,,1,"(10.445761,-75.516429)"
2022,Abril,Chipre,196,0,1,,1,"(3.541112,-76.384584)"
2022,Abril,Chipre,196,4,2,,6,"(4.697144,-74.140516)"
2022,Abril,Chipre,196,1,0,,1,"(6.171601,-75.427454)"
2022,Abril,Dinamarca,208,4,2,,6,"(10.445761,-75.516429)"
2022,Abril,Dinamarca,208,4,1,,5,"(3.541112,-76.384584)"
2022,Abril,Dinamarca,208,38,47,,85,"(4.697144,-74.140516)"
2022,Abril,Dinamarca,208,6,11,,17,"(6.171601,-75.427454)"
2022,Abril,Dominica,212,1,0,,1,"(0.814836,-77.662532)"
2022,Abril,Dominica,212,0,1,,1,"(10.445761,-75.516429)"
2022,Abril,Dominica,212,0,1,,1,"(3.541112,-76.384584)"
2022,Abril,Dominica,212,4,3,,7,"(4.697144,-74.140516)"
2022,Abril,Dominica,212,4,3,,7,"(6.171601,-75.427454)"
2022,Abril,Ecuador,218,579,637,,1216,"(0.25129,-76.875963)"
2022,Abril,Ecuador,218,16,15,,31,"(0.812436,-77.847006)"
2022,Abril,Ecuador,218,4409,5672,,10081,"(0.814836,-77.662532)"
2022,Abril,Ecuador,218,0,4,,4,"(1.813928,-78.763924)"
2022,Abril,Ecuador,218,5,8,,13,"(10.445761,-75.516429)"
2022,Abril,Ecuador,218,20,32,,52,"(10.886611,-74.776708)"
2022,Abril,Ecuador,218,1,0,,1,"(12.586067,-81.702563)"
2022,Abril,Ecuador,218,118,131,,249,"(3.541112,-76.384584)"
2022,Abril,Ecuador,218,4,5,,9,"(4.452882,-75.766298)"
2022,Abril,Ecuador,218,3124,4026,,7150,"(4.697144,-74.140516)"
2022,Abril,Ecuador,218,2,3,,5,"(4.815061,-75.736532)"
2022,Abril,Ecuador,218,110,201,,311,"(6.171601,-75.427454)"
2022,Abril,Ecuador,218,0,1,,1,"(7.128456,-73.183637)"
2022,Abril,Egipto,818,67,57,,124,"(4.697144,-74.140516)"
2022,Abril,Egipto,818,1,1,,2,"(4.815061,-75.736532)"
2022,Abril,Egipto,818,6,2,,8,"(6.171601,-75.427454)"
2022,Abril,Egipto,818,0,1,,1,"(9.402978,-75.681599)"
2022,Abril,El Salvador,222,5,5,,10,"(10.445761,-75.516429)"
2022,Abril,El Salvador,222,2,8,,10,"(10.886611,-74.776708)"
2022,Abril,El Salvador,222,14,19,,33,"(3.541112,-76.384584)"
2022,Abril,El Salvador,222,395,467,,862,"(4.697144,-74.140516)"
2022,Abril,El Salvador,222,1,3,,4,"(4.815061,-75.736532)"
2022,Abril,El Salvador,222,17,25,,42,"(6.171601,-75.427454)"
2022,Abril,El Salvador,222,0,1,,1,"(7.128456,-73.183637)"
2022,Abril,El Salvador,222,0,2,,2,"(7.927209,-72.507910)"
2022,Abril,Emiratos Árabes,784,10,12,,22,"(10.445761,-75.516429)"
2022,Abril,Emiratos Árabes,784,2,2,,4,"(3.541112,-76.384584)"
2022,Abril,Emiratos Árabes,784,164,227,,391,"(4.697144,-74.140516)"
2022,Abril,Emiratos Árabes,784,9,8,,17,"(6.171601,-75.427454)"
2022,Abril,Eritrea,232,0,1,,1,"(4.697144,-74.140516)"
2022,Abril,Eslovaquia,703,1,3,,4,"(4.697144,-74.140516)"
2022,Abril,Eslovaquia,703,1,0,,1,"(6.171601,-75.427454)"
2022,Abril,Eslovenia,705,2,0,,2,"(4.697144,-74.140516)"
2022,Abril,Estados Unidos de América,840,4923,3988,,8912,"(10.445761,-75.516429)"
2022,Abril,Estados Unidos de América,840,5037,4120,,9157,"(10.886611,-74.776708)"
2022,Abril,Estados Unidos de América,840,8,7,,15,"(11.117806,-74.232622)"
2022,Abril,Estados Unidos de América,840,136,87,,223,"(12.586067,-81.702563)"
2022,Abril,Estados Unidos de América,840,12237,9071,,21308,"(3.541112,-76.384584)"
2022,Abril,Estados Unidos de América,840,1152,894,,2046,"(4.452882,-75.766298)"
2022,Abril,Estados Unidos de América,840,38329,32260,,70589,"(4.697144,-74.140516)"
2022,Abril,Estados Unidos de América,840,1778,1224,,3002,"(4.815061,-75.736532)"
2022,Abril,Estados Unidos de América,840,16036,12363,,28399,"(6.171601,-75.427454)"
2022,Abril,Estados Unidos de América,840,890,768,,1658,"(7.128456,-73.183637)"
2022,Abril,Estados Unidos de América,840,80,67,,147,"(7.927209,-72.507910)"
2022,Abril,Estonia,233,0,1,,1,"(10.445761,-75.516429)"
2022,Abril,Estonia,233,8,6,,14,"(4.697144,-74.140516)"
2022,Abril,Etiopia,231,0,3,,3,"(4.697144,-74.140516)"
2022,Abril,Etiopia,231,0,1,,1,"(6.171601,-75.427454)"
2022,Abril,Filipinas,608,13,8,,21,"(4.697144,-74.140516)"
2022,Abril,Finlandia,246,1,0,,1,"(3.541112,-76.384584)"
2022,Abril,Finlandia,246,18,22,,40,"(4.697144,-74.140516)"
2022,Abril,Finlandia,246,4,3,,7,"(6.171601,-75.427454)"
2022,Abril,Francia,250,42,17,,59,"(10.445761,-75.516429)"
2022,Abril,Francia,250,8,3,,11,"(10.886611,-74.776708)"
2022,Abril,Francia,250,82,58,,140,"(3.541112,-76.384584)"
2022,Abril,Francia,250,3,4,,7,"(4.452882,-75.766298)"
2022,Abril,Francia,250,2310,1886,,4196,"(4.697144,-74.140516)"
2022,Abril,Francia,250,5,0,,5,"(4.815061,-75.736532)"
2022,Abril,Francia,250,138,100,,238,"(6.171601,-75.427454)"
2022,Abril,Francia,250,1,0,,1,"(7.128456,-73.183637)"
2022,Abril,Gabón,266,0,4,,4,"(4.697144,-74.140516)"
2022,Abril,Gambia,270,1,0,,1,"(4.697144,-74.140516)"
2022,Abril,Georgia,268,1,0,,1,"(10.886611,-74.776708)"
2022,Abril,Georgia,268,2,2,,4,"(3.541112,-76.384584)"
2022,Abril,Georgia,268,3,7,,10,"(4.697144,-74.140516)"
2022,Abril,Georgia,268,2,2,,4,"(6.171601,-75.427454)"
2022,Abril,Ghana,288,0,2,,2,"(4.697144,-74.140516)"
2022,Abril,Granada,308,1,1,,2,"(4.697144,-74.140516)"
2022,Abril,Grecia,300,1,1,,2,"(3.541112,-76.384584)"
2022,Abril,Grecia,300,71,37,,108,"(4.697144,-74.140516)"
2022,Abril,Grecia,300,4,3,,7,"(6.171601,-75.427454)"
2022,Abril,Guatemala,320,0,2,,2,"(1.813928,-78.763924)"
2022,Abril,Guatemala,320,11,9,,20,"(10.445761,-75.516429)"
2022,Abril,Guatemala,320,29,18,,47,"(10.886611,-74.776708)"
2022,Abril,Guatemala,320,29,61,,90,"(3.541112,-76.384584)"
2022,Abril,Guatemala,320,2,2,,4,"(4.452882,-75.766298)"
2022,Abril,Guatemala,320,729,775,,1504,"(4.697144,-74.140516)"
2022,Abril,Guatemala,320,9,5,,14,"(4.815061,-75.736532)"
2022,Abril,Guatemala,320,115,93,,208,"(6.171601,-75.427454)"
2022,Abril,Guatemala,320,6,3,,9,"(7.128456,-73.183637)"
2022,Abril,Guatemala,320,1,1,,2,"(7.927209,-72.507910)"
2022,Abril,Guyana,328,1,3,,4,"(10.445761,-75.516429)"
2022,Abril,Guyana,328,1,3,,4,"(10.886611,-74.776708)"
2022,Abril,Guyana,328,0,2,,2,"(3.541112,-76.384584)"
2022,Abril,Guyana,328,3,15,,18,"(4.697144,-74.140516)"
2022,Abril,Guyana,328,0,1,,1,"(4.815061,-75.736532)"
2022,Abril,Guyana,328,2,5,,7,"(6.171601,-75.427454)"
2022,Abril,Guyana,328,0,1,,1,"(7.927209,-72.507910)"
2022,Abril,Guinea,324,0,2,,2,"(4.697144,-74.140516)"
2022,Abril,Guinea Ecuatorial,226,3,4,,7,"(4.697144,-74.140516)"
2022,Abril,Guinea Bissau,624,0,1,,1,"(4.697144,-74.140516)"
2022,Abril,Guadalupe/Territorio Francés,312,2,4,,6,"(4.697144,-74.140516)"
2022,Abril,Guam/Territorio no incorporado de Estados Unidos,316,1,0,,1,"(4.697144,-74.140516)"
2022,Abril,Guayana Francesa/Departamento de Ultramar Francés,254,1,1,,2,"(3.541112,-76.384584)"
2022,Abril,Guayana Francesa/Departamento de Ultramar Francés,254,1,0,,1,"(4.697144,-74.140516)"
2022,Abril,Haití,332,0,2,,2,"(10.886611,-74.776708)"
2022,Abril,Haití,332,0,5,,5,"(4.697144,-74.140516)"
2022,Abril,Haití,332,0,6,,6,"(6.171601,-75.427454)"
2022,Abril,Honduras,340,1,13,,14,"(10.445761,-75.516429)"
2022,Abril,Honduras,340,3,15,,18,"(10.886611,-74.776708)"
2022,Abril,Honduras,340,2,0,,2,"(12.5744111,-81.703935)"
2022,Abril,Honduras,340,1,0,,1,"(12.586067,-81.702563)"
2022,Abril,Honduras,340,22,25,,47,"(3.541112,-76.384584)"
2022,Abril,Honduras,340,0,8,,8,"(3.893038,-77.067921)"
2022,Abril,Honduras,340,75,128,,203,"(4.697144,-74.140516)"
2022,Abril,Honduras,340,5,14,,19,"(4.815061,-75.736532)"
2022,Abril,Honduras,340,28,43,,71,"(6.171601,-75.427454)"
2022,Abril,Honduras,340,2,3,,5,"(7.128456,-73.183637)"
2022,Abril,Hong Kong,344,3,1,,4,"(4.697144,-74.140516)"
2022,Abril,Hungría,348,1,0,,1,"(10.445761,-75.516429)"
2022,Abril,Hungría,348,14,13,,27,"(4.697144,-74.140516)"
2022,Abril,Hungría,348,0,1,,1,"(6.171601,-75.427454)"
2022,Abril,India,356,0,1,,1,"(10.445761,-75.516429)"
2022,Abril,India,356,0,2,,2,"(3.541112,-76.384584)"
2022,Abril,India,356,28,26,,54,"(4.697144,-74.140516)"
2022,Abril,India,356,0,3,,3,"(6.171601,-75.427454)"
2022,Abril,Indonesia,360,1,0,,1,"(10.445761,-75.516429)"
2022,Abril,Indonesia,360,4,6,,10,"(4.697144,-74.140516)"
2022,Abril,Indonesia,360,3,1,,4,"(6.171601,-75.427454)"
2022,Abril,Iraq,368,0,1,,1,"(10.886611,-74.776708)"
2022,Abril,Iraq,368,1,9,,10,"(4.697144,-74.140516)"
2022,Abril,República de Irlanda,372,2,1,,3,"(10.445761,-75.516429)"
2022,Abril,República de Irlanda,372,1,3,,4,"(3.541112,-76.384584)"
2022,Abril,República de Irlanda,372,17,10,,27,"(4.697144,-74.140516)"
2022,Abril,República de Irlanda,372,1,0,,1,"(4.815061,-75.736532)"
2022,Abril,República de Irlanda,372,4,5,,9,"(6.171601,-75.427454)"
2022,Abril,Islandia,352,0,1,,1,"(10.445761,-75.516429)"
2022,Abril,Islandia,352,8,9,,17,"(4.697144,-74.140516)"
2022,Abril,Islandia,352,1,1,,2,"(6.171601,-75.427454)"
2022,Abril,Israel,376,3,0,,3,"(10.445761,-75.516429)"
2022,Abril,Israel,376,1,2,,3,"(10.886611,-74.776708)"
2022,Abril,Israel,376,13,10,,23,"(3.541112,-76.384584)"
2022,Abril,Israel,376,195,117,,312,"(4.697144,-74.140516)"
2022,Abril,Israel,376,16,13,,29,"(6.171601,-75.427454)"
2022,Abril,Italia,380,1,0,,1,"(0.814836,-77.662532)"
2022,Abril,Italia,380,89,49,,138,"(10.445761,-75.516429)"
2022,Abril,Italia,380,7,3,,10,"(10.886611,-74.776708)"
2022,Abril,Italia,380,103,51,,154,"(3.541112,-76.384584)"
2022,Abril,Italia,380,1110,738,,1848,"(4.697144,-74.140516)"
2022,Abril,Italia,380,2,2,,4,"(4.815061,-75.736532)"
2022,Abril,Italia,380,139,74,,213,"(6.171601,-75.427454)"
2022,Abril,Islas Cook,184,1,0,,1,"(10.445761,-75.516429)"
2022,Abril,Jamaica,388,0,11,,11,"(10.408582,-75.538003)"
2022,Abril,Jamaica,388,1,3,,4,"(10.445761,-75.516429)"
2022,Abril,Jamaica,388,3,4,,7,"(10.886611,-74.776708)"
2022,Abril,Jamaica,388,10,8,,18,"(3.541112,-76.384584)"
2022,Abril,Jamaica,388,47,37,,84,"(4.697144,-74.140516)"
2022,Abril,Jamaica,388,3,1,,4,"(4.815061,-75.736532)"
2022,Abril,Jamaica,388,27,24,,51,"(6.171601,-75.427454)"
2022,Abril,Japón,392,1,0,,1,"(10.445761,-75.516429)"
2022,Abril,Japón,392,1,3,,4,"(3.541112,-76.384584)"
2022,Abril,Japón,392,39,27,,66,"(4.697144,-74.140516)"
2022,Abril,Japón,392,5,2,,7,"(6.171601,-75.427454)"
2022,Abril,Jordania,400,3,6,,9,"(4.697144,-74.140516)"
2022,Abril,Jordania,400,1,0,,1,"(6.171601,-75.427454)"
2022,Abril,Kazajistán,398,0,2,,2,"(4.697144,-74.140516)"
2022,Abril,Kenia,404,1,0,,1,"(3.541112,-76.384584)"
2022,Abril,Kenia,404,5,6,,11,"(4.697144,-74.140516)"
2022,Abril,Kenia,404,1,0,,1,"(6.171601,-75.427454)"
2022,Abril,Kuwait,414,1,9,,10,"(4.697144,-74.140516)"
2022,Abril,Kuwait,414,2,0,,2,"(6.171601,-75.427454)"
2022,Abril,Letonia,428,0,7,,7,"(4.697144,-74.140516)"
2022,Abril,Lituania,440,1,4,,5,"(4.697144,-74.140516)"
2022,Abril,Lituania,440,2,0,,2,"(6.171601,-75.427454)"
2022,Abril,Líbano,422,0,1,,1,"(10.886611,-74.776708)"
2022,Abril,Líbano,422,17,17,,34,"(4.697144,-74.140516)"
2022,Abril,Líbano,422,0,1,,1,"(6.171601,-75.427454)"
2022,Abril,Luxemburgo,442,1,3,,4,"(10.445761,-75.516429)"
2022,Abril,Luxemburgo,442,1,0,,1,"(10.886611,-74.776708)"
2022,Abril,Luxemburgo,442,1,0,,1,"(3.541112,-76.384584)"
2022,Abril,Luxemburgo,442,21,11,,32,"(4.697144,-74.140516)"
2022,Abril,Luxemburgo,442,1,3,,4,"(6.171601,-75.427454)"
2022,Abril,Madagascar,450,0,1,,1,"(4.697144,-74.140516)"
2022,Abril,Malasia,458,2,2,,4,"(4.697144,-74.140516)"
2022,Abril,Maldivas,462,0,1,,1,"(10.445761,-75.516429)"
2022,Abril,Maldivas,462,1,3,,4,"(4.697144,-74.140516)"
2022,Abril,Malta,470,4,5,,9,"(10.445761,-75.516429)"
2022,Abril,Malta,470,1,0,,1,"(10.886611,-74.776708)"
2022,Abril,Malta,470,2,2,,4,"(3.541112,-76.384584)"
2022,Abril,Malta,470,135,106,,241,"(4.697144,-74.140516)"
2022,Abril,Malta,470,4,1,,5,"(6.171601,-75.427454)"
2022,Abril,Marruecos,504,2,0,,2,"(3.541112,-76.384584)"
2022,Abril,Marruecos,504,22,11,,33,"(4.697144,-74.140516)"
2022,Abril,Marruecos,504,3,2,,5,"(6.171601,-75.427454)"
2022,Abril,Marruecos,504,0,2,,2,"(7.927209,-72.507910)"
2022,Abril,Mauricio,480,1,0,,1,"(4.697144,-74.140516)"
2022,Abril,Mauritania,478,1,5,,6,"(4.697144,-74.140516)"
2022,Abril,Martinica/Departamento de Ultramar Francés,474,3,0,,3,"(3.541112,-76.384584)"
2022,Abril,Martinica/Departamento de Ultramar Francés,474,0,1,,1,"(4.697144,-74.140516)"
2022,Abril,México,484,3,1,,4,"(0.814836,-77.662532)"
2022,Abril,México,484,0,1,,1,"(10.408582,-75.538003)"
2022,Abril,México,484,123,85,,208,"(10.445761,-75.516429)"
2022,Abril,México,484,286,222,,508,"(10.886611,-74.776708)"
2022,Abril,México,484,1,1,,2,"(12.586067,-81.702563)"
2022,Abril,México,484,3658,3287,,6945,"(3.541112,-76.384584)"
2022,Abril,México,484,18,17,,35,"(4.452882,-75.766298)"
2022,Abril,México,484,21760,20394,,42154,"(4.697144,-74.140516)"
2022,Abril,México,484,136,113,,249,"(4.815061,-75.736532)"
2022,Abril,México,484,4,4,,8,"(6.17134,-75.427194)"
2022,Abril,México,484,8843,7494,,16337,"(6.171601,-75.427454)"
2022,Abril,México,484,97,84,,181,"(7.128456,-73.183637)"
2022,Abril,México,484,41,25,,66,"(7.927209,-72.507910)"
2022,Abril,Mayotte/Colectividad Territorial Francesa,175,0,2,,2,"(4.697144,-74.140516)"
2022,Abril,República de Moldavia,498,0,1,,1,"(4.697144,-74.140516)"
2022,Abril,Montenegro,499,1,3,,4,"(4.697144,-74.140516)"
2022,Abril,Micronesia,583,0,2,,2,"(4.697144,-74.140516)"
2022,Abril,Micronesia,583,0,1,,1,"(6.171601,-75.427454)"
2022,Abril,Myanmar,104,1,1,,2,"(4.697144,-74.140516)"
2022,Abril,Nepal,524,10,11,,21,"(4.697144,-74.140516)"
2022,Abril,Nicaragua,558,1,0,,1,"(10.886611,-74.776708)"
2022,Abril,Nicaragua,558,3,3,,6,"(12.5744111,-81.703935)"
2022,Abril,Nicaragua,558,2,7,,9,"(3.541112,-76.384584)"
2022,Abril,Nicaragua,558,30,54,,84,"(4.697144,-74.140516)"
2022,Abril,Nicaragua,558,7,11,,18,"(6.171601,-75.427454)"
2022,Abril,Nigeria,566,3,2,,5,"(4.697144,-74.140516)"
2022,Abril,Níger,562,0,1,,1,"(4.697144,-74.140516)"
2022,Abril,Noruega,578,1,5,,6,"(10.445761,-75.516429)"
2022,Abril,Noruega,578,8,2,,10,"(3.541112,-76.384584)"
2022,Abril,Noruega,578,44,35,,79,"(4.697144,-74.140516)"
2022,Abril,Noruega,578,0,1,,1,"(4.815061,-75.736532)"
2022,Abril,Noruega,578,6,4,,10,"(6.171601,-75.427454)"
2022,Abril,Nueva Caledonia/Territorio francés,540,2,0,,2,"(4.697144,-74.140516)"
2022,Abril,Nueva Zelanda,554,2,0,,2,"(3.541112,-76.384584)"
2022,Abril,Nueva Zelanda,554,16,9,,25,"(4.697144,-74.140516)"
2022,Abril,Nueva Zelanda,554,1,0,,1,"(6.171601,-75.427454)"
2022,Abril,Omán,512,4,6,,10,"(4.697144,-74.140516)"
2022,Abril,Omán,512,2,0,,2,"(6.171601,-75.427454)"
2022,Abril,Papúa Nueva Guinea,598,1,2,,3,"(4.697144,-74.140516)"
2022,Abril,Pakistán,586,1,0,,1,"(4.697144,-74.140516)"
2022,Abril,Palau,585,1,0,,1,"(4.697144,-74.140516)"
2022,Abril,Panamá,591,20,81,,101,"(10.408582,-75.538003)"
2022,Abril,Panamá,591,1143,855,,1998,"(10.445761,-75.516429)"
2022,Abril,Panamá,591,583,620,,1203,"(10.886611,-74.776708)"
2022,Abril,Panamá,591,0,4,,4,"(11.117806,-74.232622)"
2022,Abril,Panamá,591,1,11,,12,"(12.5744111,-81.703935)"
2022,Abril,Panamá,591,11,19,,30,"(12.586067,-81.702563)"
2022,Abril,Panamá,591,2129,1698,,3827,"(3.541112,-76.384584)"
2022,Abril,Panamá,591,0,12,,12,"(3.893038,-77.067921)"
2022,Abril,Panamá,591,103,69,,172,"(4.452882,-75.766298)"
2022,Abril,Panamá,591,6173,6130,,12303,"(4.697144,-74.140516)"
2022,Abril,Panamá,591,186,132,,318,"(4.815061,-75.736532)"
2022,Abril,Panamá,591,1,2,,3,"(6.17134,-75.427194)"
2022,Abril,Panamá,591,2391,2301,,4692,"(6.171601,-75.427454)"
2022,Abril,Panamá,591,11,18,,29,"(7.102626,-77.762647)"
2022,Abril,Panamá,591,101,87,,188,"(7.128456,-73.183637)"
2022,Abril,Panamá,591,102,82,,184,"(7.927209,-72.507910)"
2022,Abril,Panamá,591,22,68,,90,"(8.635765,-77.346578)"
2022,Abril,Paraguay,600,2,1,,3,"(10.445761,-75.516429)"
2022,Abril,Paraguay,600,5,3,,8,"(10.886611,-74.776708)"
2022,Abril,Paraguay,600,13,23,,36,"(3.541112,-76.384584)"
2022,Abril,Paraguay,600,2,1,,3,"(4.452882,-75.766298)"
2022,Abril,Paraguay,600,202,295,,497,"(4.697144,-74.140516)"
2022,Abril,Paraguay,600,2,3,,5,"(4.815061,-75.736532)"
2022,Abril,Paraguay,600,12,56,,68,"(6.171601,-75.427454)"
2022,Abril,Paraguay,600,2,5,,7,"(7.128456,-73.183637)"
2022,Abril,Paraguay,600,0,1,,1,"(7.927209,-72.507910)"
2022,Abril,Perú,604,133,182,,315,"(-4.197703,-69.941278)"
2022,Abril,Perú,604,1,4,,5,"(0.25129,-76.875963)"
2022,Abril,Perú,604,51,71,,122,"(0.814836,-77.662532)"
2022,Abril,Perú,604,52,32,,84,"(10.445761,-75.516429)"
2022,Abril,Perú,604,23,19,,42,"(10.886611,-74.776708)"
2022,Abril,Perú,604,58,52,,110,"(3.541112,-76.384584)"
2022,Abril,Perú,604,0,5,,5,"(3.893038,-77.067921)"
2022,Abril,Perú,604,3,5,,8,"(4.452882,-75.766298)"
2022,Abril,Perú,604,4798,4954,,9752,"(4.697144,-74.140516)"
2022,Abril,Perú,604,3,4,,7,"(4.815061,-75.736532)"
2022,Abril,Perú,604,804,623,,1427,"(6.171601,-75.427454)"
2022,Abril,Perú,604,6,5,,11,"(7.128456,-73.183637)"
2022,Abril,Perú,604,1,0,,1,"(7.927209,-72.507910)"
2022,Abril,Polonia,616,3,1,,4,"(10.445761,-75.516429)"
2022,Abril,Polonia,616,2,3,,5,"(3.541112,-76.384584)"
2022,Abril,Polonia,616,23,53,,76,"(4.697144,-74.140516)"
2022,Abril,Polonia,616,0,3,,3,"(6.171601,-75.427454)"
2022,Abril,Portugal,620,6,5,,11,"(10.445761,-75.516429)"
2022,Abril,Portugal,620,0,2,,2,"(10.886611,-74.776708)"
2022,Abril,Portugal,620,23,18,,41,"(3.541112,-76.384584)"
2022,Abril,Portugal,620,248,198,,446,"(4.697144,-74.140516)"
2022,Abril,Portugal,620,35,48,,83,"(6.171601,-75.427454)"
2022,Abril,Polinesia Francesa/Colectividad de Ultramar Francesa,258,1,1,,2,"(4.697144,-74.140516)"
2022,Abril,Puerto Rico/Territorio de Estados Unidos,630,5,5,,10,"(10.445761,-75.516429)"
2022,Abril,Puerto Rico/Territorio de Estados Unidos,630,3,9,,12,"(10.886611,-74.776708)"
2022,Abril,Puerto Rico/Territorio de Estados Unidos,630,68,55,,123,"(3.541112,-76.384584)"
2022,Abril,Puerto Rico/Territorio de Estados Unidos,630,2,2,,4,"(4.452882,-75.766298)"
2022,Abril,Puerto Rico/Territorio de Estados Unidos,630,720,642,,1362,"(4.697144,-74.140516)"
2022,Abril,Puerto Rico/Territorio de Estados Unidos,630,7,5,,12,"(4.815061,-75.736532)"
2022,Abril,Puerto Rico/Territorio de Estados Unidos,630,77,45,,122,"(6.171601,-75.427454)"
2022,Abril,Puerto Rico/Territorio de Estados Unidos,630,1,1,,2,"(7.128456,-73.183637)"
2022,Abril,Qatar,634,2,1,,3,"(10.886611,-74.776708)"
2022,Abril,Qatar,634,0,1,,1,"(3.541112,-76.384584)"
2022,Abril,Qatar,634,12,17,,29,"(4.697144,-74.140516)"
2022,Abril,Qatar,634,1,2,,3,"(6.171601,-75.427454)"
2022,Abril,Reino Unido de Gran Bretaña e Irlanda del Norte,826,9,2,,11,"(10.445761,-75.516429)"
2022,Abril,Reino Unido de Gran Bretaña e Irlanda del Norte,826,5,2,,7,"(10.886611,-74.776708)"
2022,Abril,Reino Unido de Gran Bretaña e Irlanda del Norte,826,66,50,,116,"(3.541112,-76.384584)"
2022,Abril,Reino Unido de Gran Bretaña e Irlanda del Norte,826,1955,1378,,3333,"(4.697144,-74.140516)"
2022,Abril,Reino Unido de Gran Bretaña e Irlanda del Norte,826,3,3,,6,"(4.815061,-75.736532)"
2022,Abril,Reino Unido de Gran Bretaña e Irlanda del Norte,826,68,34,,102,"(6.171601,-75.427454)"
2022,Abril,República CentroÁfricana,140,2,1,,3,"(4.697144,-74.140516)"
2022,Abril,Federación de Rusia,643,25,35,,60,"(4.697144,-74.140516)"
2022,Abril,República Dominicana,214,18,30,,48,"(10.445761,-75.516429)"
2022,Abril,República Dominicana,214,107,102,,209,"(10.886611,-74.776708)"
2022,Abril,República Dominicana,214,5,7,,12,"(11.117806,-74.232622)"
2022,Abril,República Dominicana,214,544,385,,929,"(3.541112,-76.384584)"
2022,Abril,República Dominicana,214,5,2,,7,"(4.452882,-75.766298)"
2022,Abril,República Dominicana,214,5433,4515,,9948,"(4.697144,-74.140516)"
2022,Abril,República Dominicana,214,66,49,,115,"(4.815061,-75.736532)"
2022,Abril,República Dominicana,214,1,0,,1,"(6.17134,-75.427194)"
2022,Abril,República Dominicana,214,4223,3237,,7460,"(6.171601,-75.427454)"
2022,Abril,República Dominicana,214,32,22,,54,"(7.128456,-73.183637)"
2022,Abril,República Dominicana,214,9,10,,19,"(7.927209,-72.507910)"
2022,Abril,Rumania,642,0,1,,1,"(10.445761,-75.516429)"
2022,Abril,Rumania,642,28,27,,55,"(4.697144,-74.140516)"
2022,Abril,Rwanda,646,0,1,,1,"(4.697144,-74.140516)"
2022,Abril,Sahara Occidental/Desierto Sahara,732,1,0,,1,"(4.697144,-74.140516)"
2022,Abril,San Cristóbal y Nevis,659,0,2,,2,"(4.697144,-74.140516)"
2022,Abril,San Cristóbal y Nevis,659,3,1,,4,"(7.818934,-72.453226)"
2022,Abril,San  Vicente y las Granadinas,670,0,1,,1,"(3.541112,-76.384584)"
2022,Abril,San  Vicente y las Granadinas,670,0,1,,1,"(4.697144,-74.140516)"
2022,Abril,Santa Lucia,662,0,1,,1,"(10.886611,-74.776708)"
2022,Abril,Senegal,686,0,1,,1,"(4.697144,-74.140516)"
2022,Abril,Serbia,688,4,0,,4,"(4.697144,-74.140516)"
2022,Abril,Sierra Leona,694,0,2,,2,"(4.697144,-74.140516)"
2022,Abril,Singapur,702,0,1,,1,"(10.445761,-75.516429)"
2022,Abril,Singapur,702,8,14,,22,"(4.697144,-74.140516)"
2022,Abril,Singapur,702,0,1,,1,"(6.171601,-75.427454)"
2022,Abril,Sri Lanka,144,0,1,,1,"(10.445761,-75.516429)"
2022,Abril,Sri Lanka,144,2,1,,3,"(4.697144,-74.140516)"
2022,Abril,Sudáfrica,710,0,2,,2,"(10.445761,-75.516429)"
2022,Abril,Sudáfrica,710,13,6,,19,"(4.697144,-74.140516)"
2022,Abril,Suecia,752,9,3,,12,"(10.445761,-75.516429)"
2022,Abril,Suecia,752,2,2,,4,"(10.886611,-74.776708)"
2022,Abril,Suecia,752,27,18,,45,"(3.541112,-76.384584)"
2022,Abril,Suecia,752,110,99,,209,"(4.697144,-74.140516)"
2022,Abril,Suecia,752,2,0,,2,"(4.815061,-75.736532)"
2022,Abril,Suecia,752,7,11,,18,"(6.171601,-75.427454)"
2022,Abril,Suecia,752,1,0,,1,"(7.128456,-73.183637)"
2022,Abril,Suiza,756,26,21,,47,"(10.445761,-75.516429)"
2022,Abril,Suiza,756,3,0,,3,"(10.886611,-74.776708)"
2022,Abril,Suiza,756,51,27,,78,"(3.541112,-76.384584)"
2022,Abril,Suiza,756,2,1,,3,"(4.452882,-75.766298)"
2022,Abril,Suiza,756,443,252,,695,"(4.697144,-74.140516)"
2022,Abril,Suiza,756,1,1,,2,"(4.815061,-75.736532)"
2022,Abril,Suiza,756,47,32,,79,"(6.171601,-75.427454)"
2022,Abril,Surinam,740,10,15,,25,"(4.697144,-74.140516)"
2022,Abril,Surinam,740,3,1,,4,"(6.171601,-75.427454)"
2022,Abril,Taiwán,158,0,1,,1,"(4.697144,-74.140516)"
2022,Abril,Tailandia,764,0,1,,1,"(10.886611,-74.776708)"
2022,Abril,Tailandia,764,2,1,,3,"(3.541112,-76.384584)"
2022,Abril,Tailandia,764,19,9,,28,"(4.697144,-74.140516)"
2022,Abril,Tailandia,764,1,1,,2,"(6.171601,-75.427454)"
2022,Abril,Tanzania,834,0,1,,1,"(4.697144,-74.140516)"
2022,Abril,Tierras Australes y Antárticas,260,1,0,,1,"(4.697144,-74.140516)"
2022,Abril,Trinidad y Tobago,780,0,1,,1,"(10.408582,-75.538003)"
2022,Abril,Trinidad y Tobago,780,1,3,,4,"(10.445761,-75.516429)"
2022,Abril,Trinidad y Tobago,780,5,4,,9,"(3.541112,-76.384584)"
2022,Abril,Trinidad y Tobago,780,4,1,,5,"(4.452882,-75.766298)"
2022,Abril,Trinidad y Tobago,780,10,24,,34,"(4.697144,-74.140516)"
2022,Abril,Trinidad y Tobago,780,4,3,,7,"(6.171601,-75.427454)"
2022,Abril,Túnez,788,1,2,,3,"(4.697144,-74.140516)"
2022,Abril,Turquía,792,4,3,,7,"(10.445761,-75.516429)"
2022,Abril,Turquía,792,2,2,,4,"(10.886611,-74.776708)"
2022,Abril,Turquía,792,5,6,,11,"(3.541112,-76.384584)"
2022,Abril,Turquía,792,1511,1070,,2581,"(4.697144,-74.140516)"
2022,Abril,Turquía,792,23,23,,46,"(6.171601,-75.427454)"
2022,Abril,Turkmenistán,795,2,1,,3,"(4.697144,-74.140516)"
2022,Abril,Ucrania,804,1,2,,3,"(4.697144,-74.140516)"
2022,Abril,Uganda,800,0,1,,1,"(10.445761,-75.516429)"
2022,Abril,Uganda,800,1,0,,1,"(10.886611,-74.776708)"
2022,Abril,Uganda,800,4,1,,5,"(4.697144,-74.140516)"
2022,Abril,Uruguay,858,0,1,,1,"(0.814836,-77.662532)"
2022,Abril,Uruguay,858,4,4,,8,"(10.445761,-75.516429)"
2022,Abril,Uruguay,858,4,1,,5,"(10.886611,-74.776708)"
2022,Abril,Uruguay,858,26,30,,56,"(3.541112,-76.384584)"
2022,Abril,Uruguay,858,2,2,,4,"(4.452882,-75.766298)"
2022,Abril,Uruguay,858,271,322,,593,"(4.697144,-74.140516)"
2022,Abril,Uruguay,858,6,5,,11,"(4.815061,-75.736532)"
2022,Abril,Uruguay,858,17,26,,43,"(6.171601,-75.427454)"
2022,Abril,Uruguay,858,2,0,,2,"(7.128456,-73.183637)"
2022,Abril,Uzbekistán,860,1,0,,1,"(4.697144,-74.140516)"
2022,Abril,Venezuela,862,10,8,,18,"(10.445761,-75.516429)"
2022,Abril,Venezuela,862,17,23,,40,"(10.886611,-74.776708)"
2022,Abril,Venezuela,862,108,258,,366,"(11.360009,-72.129330)"
2022,Abril,Venezuela,862,18,25,,43,"(3.541112,-76.384584)"
2022,Abril,Venezuela,862,0,2,,2,"(3.866713,-67.927521)"
2022,Abril,Venezuela,862,139,195,,334,"(4.697144,-74.140516)"
2022,Abril,Venezuela,862,6,15,,21,"(4.815061,-75.736532)"
2022,Abril,Venezuela,862,51,70,,121,"(6.171601,-75.427454)"
2022,Abril,Venezuela,862,2,1,,3,"(6.185799,-67.483929)"
2022,Abril,Venezuela,862,6,13,,19,"(7.088729,-70.740253)"
2022,Abril,Venezuela,862,6,7,,13,"(7.128456,-73.183637)"
2022,Abril,Venezuela,862,271,321,,592,"(7.818934,-72.453226)"
2022,Abril,Venezuela,862,30,43,,73,"(7.916725,-72.462544)"
2022,Abril,Venezuela,862,5,3,,8,"(7.927209,-72.507910)"
2022,Abril,Venezuela,862,5,12,,17,"(8.36068,-72.409396)"
2022,Abril,Vietnam,704,1,1,,2,"(3.541112,-76.384584)"
2022,Abril,Vietnam,704,4,5,,9,"(4.697144,-74.140516)"
2022,Abril,Vietnam,704,0,1,,1,"(6.171601,-75.427454)"
2022,Abril,Islas Vírgenes Británicas/Territorio Británico de Ultramar,92,1,0,,1,"(3.541112,-76.384584)"
2022,Abril,Islas Vírgenes Británicas/Territorio Británico de Ultramar,92,2,0,,2,"(4.697144,-74.140516)"
2022,Abril,Islas Vírgenes Británicas/Territorio Británico de Ultramar,92,0,2,,2,"(6.171601,-75.427454)"
2022,Abril,Islas Vírgenes Estadounidenses/Territorio de Estados Unidos,850,0,1,,1,"(3.541112,-76.384584)"
2022,Abril,Islas Vírgenes Estadounidenses/Territorio de Estados Unidos,850,1,3,,4,"(4.697144,-74.140516)"
2022,Abril,Zimbabue,716,0,1,,1,"(4.697144,-74.140516)"
2022,Abril,Anguila/Territorio Británico de Ultramar,660,1,1,,2,"(4.697144,-74.140516)"
2022,Abril,Islas Turcas y Caicos/Territorio Británico de Ultramar,796,0,1,,1,"(10.886611,-74.776708)"
2022,Abril,Islas Turcas y Caicos/Territorio Británico de Ultramar,796,4,2,,6,"(4.697144,-74.140516)"
2022,Abril,Islas Turcas y Caicos/Territorio Británico de Ultramar,796,0,1,,1,"(6.171601,-75.427454)"
2022,Abril,Islas Turcas y Caicos/Territorio Británico de Ultramar,796,1,2,,3,"(7.128456,-73.183637)"
2022,Abril,Desconocido,99999,1,0,,1,"(10.445761,-75.516429)"
2022,Abril,Desconocido,99999,2,1,,3,"(4.697144,-74.140516)"
2022,Abril,Desconocido,99999,1,0,,1,"(6.171601,-75.427454)"
2022,Mayo,Afganistán,4,2,1,,3,"(4.697144,-74.140516)"
2022,Mayo,Albania,8,0,1,,1,"(3.541112,-76.384584)"
2022,Mayo,Albania,8,2,3,,5,"(4.697144,-74.140516)"
2022,Mayo,Albania,8,1,0,,1,"(6.171601,-75.427454)"
2022,Mayo,Alemania,276,56,37,,93,"(10.445761,-75.516429)"
2022,Mayo,Alemania,276,16,12,,28,"(10.886611,-74.776708)"
2022,Mayo,Alemania,276,66,63,,129,"(3.541112,-76.384584)"
2022,Mayo,Alemania,276,0,1,,1,"(4.452882,-75.766298)"
2022,Mayo,Alemania,276,1506,1201,,2707,"(4.697144,-74.140516)"
2022,Mayo,Alemania,276,5,9,,14,"(4.815061,-75.736532)"
2022,Mayo,Alemania,276,95,82,,177,"(6.171601,-75.427454)"
2022,Mayo,Andorra,20,1,1,,2,"(3.541112,-76.384584)"
2022,Mayo,Andorra,20,11,16,,27,"(4.697144,-74.140516)"
2022,Mayo,Angola,24,0,1,,1,"(10.445761,-75.516429)"
2022,Mayo,Angola,24,3,5,,8,"(4.697144,-74.140516)"
2022,Mayo,Antigua y Barbuda,28,1,3,,4,"(4.697144,-74.140516)"
2022,Mayo,Antigua y Barbuda,28,1,1,,2,"(6.171601,-75.427454)"
2022,Mayo,Países Bajos,528,255,163,,418,"(10.445761,-75.516429)"
2022,Mayo,Países Bajos,528,15,18,,33,"(10.886611,-74.776708)"
2022,Mayo,Países Bajos,528,81,41,,122,"(3.541112,-76.384584)"
2022,Mayo,Países Bajos,528,1,0,,1,"(4.452882,-75.766298)"
2022,Mayo,Países Bajos,528,1239,1035,,2274,"(4.697144,-74.140516)"
2022,Mayo,Países Bajos,528,2,2,,4,"(4.815061,-75.736532)"
2022,Mayo,Países Bajos,528,104,65,,169,"(6.171601,-75.427454)"
2022,Mayo,Países Bajos,528,1,0,,1,"(7.128456,-73.183637)"
2022,Mayo,Arabia Saudita,682,1,0,,1,"(10.445761,-75.516429)"
2022,Mayo,Arabia Saudita,682,11,28,,39,"(4.697144,-74.140516)"
2022,Mayo,Arabia Saudita,682,0,1,,1,"(7.128456,-73.183637)"
2022,Mayo,Argelia,12,4,5,,9,"(4.697144,-74.140516)"
2022,Mayo,Argentina,32,6,10,,16,"(0.814836,-77.662532)"
2022,Mayo,Argentina,32,7,7,,14,"(10.445761,-75.516429)"
2022,Mayo,Argentina,32,15,14,,29,"(10.886611,-74.776708)"
2022,Mayo,Argentina,32,84,117,,201,"(3.541112,-76.384584)"
2022,Mayo,Argentina,32,25,24,,49,"(4.452882,-75.766298)"
2022,Mayo,Argentina,32,2149,2035,,4184,"(4.697144,-74.140516)"
2022,Mayo,Argentina,32,3,1,,4,"(4.815061,-75.736532)"
2022,Mayo,Argentina,32,57,73,,130,"(6.171601,-75.427454)"
2022,Mayo,Argentina,32,0,2,,2,"(7.128456,-73.183637)"
2022,Mayo,Argentina,32,13,11,,24,"(7.927209,-72.507910)"
2022,Mayo,República de Armenia,51,1,0,,1,"(10.445761,-75.516429)"
2022,Mayo,República de Armenia,51,0,1,,1,"(4.452882,-75.766298)"
2022,Mayo,República de Armenia,51,0,1,,1,"(4.697144,-74.140516)"
2022,Mayo,Aruba,533,1,2,,3,"(10.445761,-75.516429)"
2022,Mayo,Aruba,533,117,86,,203,"(10.886611,-74.776708)"
2022,Mayo,Aruba,533,1,0,,1,"(11.247723,-74.213989)"
2022,Mayo,Aruba,533,101,70,,171,"(3.541112,-76.384584)"
2022,Mayo,Aruba,533,1666,1210,,2876,"(4.697144,-74.140516)"
2022,Mayo,Aruba,533,3,1,,4,"(4.815061,-75.736532)"
2022,Mayo,Aruba,533,140,114,,254,"(6.171601,-75.427454)"
2022,Mayo,Aruba,533,12,11,,23,"(7.128456,-73.183637)"
2022,Mayo,Australia,36,4,6,,10,"(10.445761,-75.516429)"
2022,Mayo,Australia,36,3,4,,7,"(10.886611,-74.776708)"
2022,Mayo,Australia,36,26,12,,38,"(3.541112,-76.384584)"
2022,Mayo,Australia,36,1,0,,1,"(4.452882,-75.766298)"
2022,Mayo,Australia,36,425,350,,775,"(4.697144,-74.140516)"
2022,Mayo,Australia,36,5,2,,7,"(4.815061,-75.736532)"
2022,Mayo,Australia,36,52,45,,97,"(6.171601,-75.427454)"
2022,Mayo,Australia,36,2,4,,6,"(7.128456,-73.183637)"
2022,Mayo,Austria,40,2,2,,4,"(10.445761,-75.516429)"
2022,Mayo,Austria,40,3,4,,7,"(3.541112,-76.384584)"
2022,Mayo,Austria,40,75,63,,138,"(4.697144,-74.140516)"
2022,Mayo,Austria,40,3,2,,5,"(6.171601,-75.427454)"
2022,Mayo,Azerbaiyán,31,1,3,,4,"(4.697144,-74.140516)"
2022,Mayo,Bahamas,44,3,1,,4,"(10.886611,-74.776708)"
2022,Mayo,Bahamas,44,32,10,,42,"(3.541112,-76.384584)"
2022,Mayo,Bahamas,44,1,0,,1,"(4.452882,-75.766298)"
2022,Mayo,Bahamas,44,34,44,,78,"(4.697144,-74.140516)"
2022,Mayo,Bahamas,44,1,1,,2,"(4.815061,-75.736532)"
2022,Mayo,Bahamas,44,42,20,,62,"(6.171601,-75.427454)"
2022,Mayo,Bahréin,48,1,0,,1,"(10.445761,-75.516429)"
2022,Mayo,Bahréin,48,0,1,,1,"(3.541112,-76.384584)"
2022,Mayo,Bahréin,48,7,9,,16,"(4.697144,-74.140516)"
2022,Mayo,Bahréin,48,3,0,,3,"(6.171601,-75.427454)"
2022,Mayo,Bangladesh,50,2,1,,3,"(4.697144,-74.140516)"
2022,Mayo,Barbados,52,1,0,,1,"(3.541112,-76.384584)"
2022,Mayo,Barbados,52,3,3,,6,"(4.452882,-75.766298)"
2022,Mayo,Barbados,52,5,11,,16,"(4.697144,-74.140516)"
2022,Mayo,Barbados,52,1,0,,1,"(6.171601,-75.427454)"
2022,Mayo,Bélgica,56,14,8,,22,"(10.445761,-75.516429)"
2022,Mayo,Bélgica,56,2,0,,2,"(10.886611,-74.776708)"
2022,Mayo,Bélgica,56,24,24,,48,"(3.541112,-76.384584)"
2022,Mayo,Bélgica,56,142,120,,262,"(4.697144,-74.140516)"
2022,Mayo,Bélgica,56,2,4,,6,"(4.815061,-75.736532)"
2022,Mayo,Bélgica,56,37,41,,78,"(6.171601,-75.427454)"
2022,Mayo,Belice,84,0,75,,75,"(10.886611,-74.776708)"
2022,Mayo,Belice,84,2,0,,2,"(3.541112,-76.384584)"
2022,Mayo,Belice,84,3,15,,18,"(4.697144,-74.140516)"
2022,Mayo,Belice,84,5,3,,8,"(6.171601,-75.427454)"
2022,Mayo,Benín,204,0,1,,1,"(10.445761,-75.516429)"
2022,Mayo,Benín,204,0,8,,8,"(4.697144,-74.140516)"
2022,Mayo,Bermudas/Territorio Británico de Ultramar,60,1,2,,3,"(10.886611,-74.776708)"
2022,Mayo,Bermudas/Territorio Británico de Ultramar,60,3,1,,4,"(4.697144,-74.140516)"
2022,Mayo,Bolivia,68,4,8,,12,"(0.814836,-77.662532)"
2022,Mayo,Bolivia,68,6,6,,12,"(10.445761,-75.516429)"
2022,Mayo,Bolivia,68,0,2,,2,"(10.886611,-74.776708)"
2022,Mayo,Bolivia,68,0,2,,2,"(12.586067,-81.702563)"
2022,Mayo,Bolivia,68,5,13,,18,"(3.541112,-76.384584)"
2022,Mayo,Bolivia,68,1,1,,2,"(4.452882,-75.766298)"
2022,Mayo,Bolivia,68,345,576,,921,"(4.697144,-74.140516)"
2022,Mayo,Bolivia,68,3,1,,4,"(4.815061,-75.736532)"
2022,Mayo,Bolivia,68,13,38,,51,"(6.171601,-75.427454)"
2022,Mayo,Bosnia y Herzegovina,70,2,0,,2,"(10.445761,-75.516429)"
2022,Mayo,Bosnia y Herzegovina,70,1,0,,1,"(6.171601,-75.427454)"
2022,Mayo,Botsuana,72,0,1,,1,"(4.697144,-74.140516)"
2022,Mayo,Brasil,76,263,443,,706,"(-4.197703,-69.941278)"
2022,Mayo,Brasil,76,2,8,,10,"(0.814836,-77.662532)"
2022,Mayo,Brasil,76,6,15,,21,"(10.445761,-75.516429)"
2022,Mayo,Brasil,76,27,32,,59,"(10.886611,-74.776708)"
2022,Mayo,Brasil,76,86,98,,184,"(3.541112,-76.384584)"
2022,Mayo,Brasil,76,2,0,,2,"(3.866713,-67.927521)"
2022,Mayo,Brasil,76,48,60,,108,"(4.452882,-75.766298)"
2022,Mayo,Brasil,76,2218,2781,,4999,"(4.697144,-74.140516)"
2022,Mayo,Brasil,76,13,21,,34,"(4.815061,-75.736532)"
2022,Mayo,Brasil,76,132,214,,346,"(6.171601,-75.427454)"
2022,Mayo,Brasil,76,5,4,,9,"(7.128456,-73.183637)"
2022,Mayo,Brasil,76,4,9,,13,"(7.927209,-72.507910)"
2022,Mayo,Bulgaria,100,5,12,,17,"(4.697144,-74.140516)"
2022,Mayo,Bulgaria,100,1,2,,3,"(6.171601,-75.427454)"
2022,Mayo,Burkina Faso,854,0,1,,1,"(4.697144,-74.140516)"
2022,Mayo,Burundi,108,0,1,,1,"(10.445761,-75.516429)"
2022,Mayo,Burundi,108,1,0,,1,"(4.697144,-74.140516)"
2022,Mayo,Cabo Verde,132,0,1,,1,"(4.697144,-74.140516)"
2022,Mayo,Cabo Verde,132,0,1,,1,"(6.171601,-75.427454)"
2022,Mayo,Islas Caimán/Territorio Británico de Ultramar,136,2,1,,3,"(10.445761,-75.516429)"
2022,Mayo,Islas Caimán/Territorio Británico de Ultramar,136,1,0,,1,"(10.886611,-74.776708)"
2022,Mayo,Islas Caimán/Territorio Británico de Ultramar,136,4,5,,9,"(12.586067,-81.702563)"
2022,Mayo,Islas Caimán/Territorio Británico de Ultramar,136,1,1,,2,"(3.541112,-76.384584)"
2022,Mayo,Islas Caimán/Territorio Británico de Ultramar,136,4,2,,6,"(4.697144,-74.140516)"
2022,Mayo,Camboya,116,4,11,,15,"(4.697144,-74.140516)"
2022,Mayo,Camerún,120,1,0,,1,"(4.697144,-74.140516)"
2022,Mayo,Camerún,120,1,3,,4,"(6.171601,-75.427454)"
2022,Mayo,Guernsey,831,0,1,,1,"(4.697144,-74.140516)"
2022,Mayo,Canadá,124,47,25,,72,"(10.445761,-75.516429)"
2022,Mayo,Canadá,124,45,33,,78,"(10.886611,-74.776708)"
2022,Mayo,Canadá,124,1,2,,3,"(12.586067,-81.702563)"
2022,Mayo,Canadá,124,127,107,,234,"(3.541112,-76.384584)"
2022,Mayo,Canadá,124,18,9,,27,"(4.452882,-75.766298)"
2022,Mayo,Canadá,124,3737,2976,,6713,"(4.697144,-74.140516)"
2022,Mayo,Canadá,124,14,9,,23,"(4.815061,-75.736532)"
2022,Mayo,Canadá,124,392,285,,677,"(6.171601,-75.427454)"
2022,Mayo,Canadá,124,2,1,,3,"(7.128456,-73.183637)"
2022,Mayo,Canadá,124,1,2,,3,"(7.927209,-72.507910)"
2022,Mayo,Chad,148,1,0,,1,"(6.171601,-75.427454)"
2022,Mayo,España,724,1,0,,1,"(0.814836,-77.662532)"
2022,Mayo,España,724,141,100,,241,"(10.445761,-75.516429)"
2022,Mayo,España,724,40,30,,70,"(10.886611,-74.776708)"
2022,Mayo,España,724,3785,2927,,6712,"(3.541112,-76.384584)"
2022,Mayo,España,724,5,7,,12,"(4.452882,-75.766298)"
2022,Mayo,España,724,25180,20127,,45307,"(4.697144,-74.140516)"
2022,Mayo,España,724,46,34,,80,"(4.815061,-75.736532)"
2022,Mayo,España,724,3620,2649,,6269,"(6.171601,-75.427454)"
2022,Mayo,España,724,5,2,,7,"(7.128456,-73.183637)"
2022,Mayo,España,724,0,1,,1,"(7.927209,-72.507910)"
2022,Mayo,Colombia,170,40,111,,151,"(4.697144,-74.140516)"
2022,Mayo,Comoras,174,1,3,,4,"(4.697144,-74.140516)"
2022,Mayo,Comoras,174,1,0,,1,"(6.171601,-75.427454)"
2022,Mayo,República Democrática del Congo,180,2,1,,3,"(4.697144,-74.140516)"
2022,Mayo,República de Corea,410,1,1,,2,"(10.445761,-75.516429)"
2022,Mayo,República de Corea,410,42,33,,75,"(4.697144,-74.140516)"
2022,Mayo,República de Corea,410,1,0,,1,"(6.171601,-75.427454)"
2022,Mayo,Costa de Marfil,384,0,2,,2,"(4.697144,-74.140516)"
2022,Mayo,Costa Rica,188,86,72,,158,"(10.445761,-75.516429)"
2022,Mayo,Costa Rica,188,9,20,,29,"(10.886611,-74.776708)"
2022,Mayo,Costa Rica,188,3,27,,30,"(12.5744111,-81.703935)"
2022,Mayo,Costa Rica,188,0,1,,1,"(12.586067,-81.702563)"
2022,Mayo,Costa Rica,188,85,60,,145,"(3.541112,-76.384584)"
2022,Mayo,Costa Rica,188,2,2,,4,"(4.452882,-75.766298)"
2022,Mayo,Costa Rica,188,1069,1151,,2220,"(4.697144,-74.140516)"
2022,Mayo,Costa Rica,188,9,5,,14,"(4.815061,-75.736532)"
2022,Mayo,Costa Rica,188,0,7,,7,"(6.17134,-75.427194)"
2022,Mayo,Costa Rica,188,316,284,,600,"(6.171601,-75.427454)"
2022,Mayo,Costa Rica,188,1,0,,1,"(7.128456,-73.183637)"
2022,Mayo,Costa Rica,188,2,3,,5,"(7.927209,-72.507910)"
2022,Mayo,Croacia,191,2,0,,2,"(3.541112,-76.384584)"
2022,Mayo,Croacia,191,13,10,,23,"(4.697144,-74.140516)"
2022,Mayo,Croacia,191,5,1,,6,"(6.171601,-75.427454)"
2022,Mayo,Cuba,192,5,4,,9,"(10.445761,-75.516429)"
2022,Mayo,Cuba,192,7,8,,15,"(10.886611,-74.776708)"
2022,Mayo,Cuba,192,0,9,,9,"(11.247723,-74.213989)"
2022,Mayo,Cuba,192,20,13,,33,"(3.541112,-76.384584)"
2022,Mayo,Cuba,192,1,1,,2,"(4.452882,-75.766298)"
2022,Mayo,Cuba,192,755,863,,1618,"(4.697144,-74.140516)"
2022,Mayo,Cuba,192,8,4,,12,"(4.815061,-75.736532)"
2022,Mayo,Cuba,192,39,29,,68,"(6.171601,-75.427454)"
2022,Mayo,Cuba,192,0,1,,1,"(7.128456,-73.183637)"
2022,Mayo,Curazao,99999,0,1,,1,"(10.445761,-75.516429)"
2022,Mayo,Curazao,99999,59,30,,89,"(10.886611,-74.776708)"
2022,Mayo,Curazao,99999,1,10,,11,"(10.971302,-74.765397)"
2022,Mayo,Curazao,99999,35,14,,49,"(3.541112,-76.384584)"
2022,Mayo,Curazao,99999,1267,990,,2257,"(4.697144,-74.140516)"
2022,Mayo,Curazao,99999,1,1,,2,"(4.815061,-75.736532)"
2022,Mayo,Curazao,99999,129,109,,238,"(6.171601,-75.427454)"
2022,Mayo,Curazao,99999,0,1,,1,"(7.128456,-73.183637)"
2022,Mayo,República Checa,203,1,2,,3,"(10.445761,-75.516429)"
2022,Mayo,República Checa,203,4,0,,4,"(3.541112,-76.384584)"
2022,Mayo,República Checa,203,23,27,,50,"(4.697144,-74.140516)"
2022,Mayo,República Checa,203,5,4,,9,"(6.171601,-75.427454)"
2022,Mayo,Chile,152,2,2,,4,"(0.25129,-76.875963)"
2022,Mayo,Chile,152,61,54,,115,"(0.814836,-77.662532)"
2022,Mayo,Chile,152,11,3,,14,"(10.445761,-75.516429)"
2022,Mayo,Chile,152,36,25,,61,"(10.886611,-74.776708)"
2022,Mayo,Chile,152,2338,1799,,4137,"(3.541112,-76.384584)"
2022,Mayo,Chile,152,48,46,,94,"(4.452882,-75.766298)"
2022,Mayo,Chile,152,3874,3546,,7420,"(4.697144,-74.140516)"
2022,Mayo,Chile,152,31,20,,51,"(4.815061,-75.736532)"
2022,Mayo,Chile,152,353,325,,678,"(6.171601,-75.427454)"
2022,Mayo,Chile,152,4,4,,8,"(7.128456,-73.183637)"
2022,Mayo,Chile,152,14,5,,19,"(7.927209,-72.507910)"
2022,Mayo,China,156,10,19,,29,"(4.697144,-74.140516)"
2022,Mayo,Chipre,196,2,0,,2,"(3.541112,-76.384584)"
2022,Mayo,Chipre,196,3,2,,5,"(4.697144,-74.140516)"
2022,Mayo,Chipre,196,0,2,,2,"(6.171601,-75.427454)"
2022,Mayo,Dinamarca,208,6,10,,16,"(10.445761,-75.516429)"
2022,Mayo,Dinamarca,208,4,3,,7,"(3.541112,-76.384584)"
2022,Mayo,Dinamarca,208,71,71,,142,"(4.697144,-74.140516)"
2022,Mayo,Dinamarca,208,10,8,,18,"(6.171601,-75.427454)"
2022,Mayo,Dominica,212,1,0,,1,"(10.445761,-75.516429)"
2022,Mayo,Dominica,212,1,1,,2,"(3.541112,-76.384584)"
2022,Mayo,Dominica,212,5,7,,12,"(4.697144,-74.140516)"
2022,Mayo,Dominica,212,9,2,,11,"(6.171601,-75.427454)"
2022,Mayo,Ecuador,218,268,399,,667,"(0.25129,-76.875963)"
2022,Mayo,Ecuador,218,11,6,,17,"(0.812436,-77.847006)"
2022,Mayo,Ecuador,218,2772,3706,,6478,"(0.814836,-77.662532)"
2022,Mayo,Ecuador,218,10,13,,23,"(10.445761,-75.516429)"
2022,Mayo,Ecuador,218,14,15,,29,"(10.886611,-74.776708)"
2022,Mayo,Ecuador,218,1,0,,1,"(12.586067,-81.702563)"
2022,Mayo,Ecuador,218,106,175,,281,"(3.541112,-76.384584)"
2022,Mayo,Ecuador,218,3,1,,4,"(4.452882,-75.766298)"
2022,Mayo,Ecuador,218,2684,3927,,6612,"(4.697144,-74.140516)"
2022,Mayo,Ecuador,218,0,8,,8,"(4.815061,-75.736532)"
2022,Mayo,Ecuador,218,125,237,,362,"(6.171601,-75.427454)"
2022,Mayo,Egipto,818,2,0,,2,"(3.541112,-76.384584)"
2022,Mayo,Egipto,818,75,64,,139,"(4.697144,-74.140516)"
2022,Mayo,Egipto,818,7,10,,17,"(6.171601,-75.427454)"
2022,Mayo,El Salvador,222,6,14,,20,"(10.445761,-75.516429)"
2022,Mayo,El Salvador,222,4,6,,10,"(10.886611,-74.776708)"
2022,Mayo,El Salvador,222,12,14,,26,"(3.541112,-76.384584)"
2022,Mayo,El Salvador,222,426,469,,895,"(4.697144,-74.140516)"
2022,Mayo,El Salvador,222,3,3,,6,"(4.815061,-75.736532)"
2022,Mayo,El Salvador,222,37,47,,84,"(6.171601,-75.427454)"
2022,Mayo,Emiratos Árabes,784,8,14,,22,"(10.445761,-75.516429)"
2022,Mayo,Emiratos Árabes,784,1,2,,3,"(10.886611,-74.776708)"
2022,Mayo,Emiratos Árabes,784,3,6,,9,"(3.541112,-76.384584)"
2022,Mayo,Emiratos Árabes,784,132,255,,387,"(4.697144,-74.140516)"
2022,Mayo,Emiratos Árabes,784,18,13,,31,"(6.171601,-75.427454)"
2022,Mayo,Eritrea,232,0,1,,1,"(4.697144,-74.140516)"
2022,Mayo,Eslovaquia,703,3,0,,3,"(4.697144,-74.140516)"
2022,Mayo,Eslovaquia,703,0,2,,2,"(6.171601,-75.427454)"
2022,Mayo,Eslovenia,705,5,4,,9,"(4.697144,-74.140516)"
2022,Mayo,Eslovenia,705,0,1,,1,"(6.171601,-75.427454)"
2022,Mayo,Estados Unidos de América,840,11,161,,172,"(10.408582,-75.538003)"
2022,Mayo,Estados Unidos de América,840,3438,2684,,6122,"(10.445761,-75.516429)"
2022,Mayo,Estados Unidos de América,840,4577,3816,,8393,"(10.886611,-74.776708)"
2022,Mayo,Estados Unidos de América,840,2,3,,5,"(11.117806,-74.232622)"
2022,Mayo,Estados Unidos de América,840,154,104,,258,"(12.586067,-81.702563)"
2022,Mayo,Estados Unidos de América,840,10135,7384,,17519,"(3.541112,-76.384584)"
2022,Mayo,Estados Unidos de América,840,1281,950,,2231,"(4.452882,-75.766298)"
2022,Mayo,Estados Unidos de América,840,36816,32395,,69211,"(4.697144,-74.140516)"
2022,Mayo,Estados Unidos de América,840,2031,1366,,3397,"(4.815061,-75.736532)"
2022,Mayo,Estados Unidos de América,840,2,5,,7,"(6.17134,-75.427194)"
2022,Mayo,Estados Unidos de América,840,15095,11915,,27010,"(6.171601,-75.427454)"
2022,Mayo,Estados Unidos de América,840,1038,887,,1925,"(7.128456,-73.183637)"
2022,Mayo,Estados Unidos de América,840,120,80,,200,"(7.927209,-72.507910)"
2022,Mayo,Estonia,233,0,1,,1,"(0.814836,-77.662532)"
2022,Mayo,Estonia,233,3,5,,8,"(4.697144,-74.140516)"
2022,Mayo,Estonia,233,0,1,,1,"(6.171601,-75.427454)"
2022,Mayo,Etiopia,231,1,0,,1,"(3.541112,-76.384584)"
2022,Mayo,Etiopia,231,0,7,,7,"(4.697144,-74.140516)"
2022,Mayo,Islas Fiji,242,1,0,,1,"(10.445761,-75.516429)"
2022,Mayo,Islas Fiji,242,0,1,,1,"(4.697144,-74.140516)"
2022,Mayo,Islas Fiji,242,1,0,,1,"(6.171601,-75.427454)"
2022,Mayo,Filipinas,608,9,10,,19,"(4.697144,-74.140516)"
2022,Mayo,Finlandia,246,0,1,,1,"(10.445761,-75.516429)"
2022,Mayo,Finlandia,246,0,1,,1,"(10.886611,-74.776708)"
2022,Mayo,Finlandia,246,5,1,,6,"(3.541112,-76.384584)"
2022,Mayo,Finlandia,246,14,15,,29,"(4.697144,-74.140516)"
2022,Mayo,Finlandia,246,1,0,,1,"(4.815061,-75.736532)"
2022,Mayo,Finlandia,246,2,3,,5,"(6.171601,-75.427454)"
2022,Mayo,Francia,250,37,24,,61,"(10.445761,-75.516429)"
2022,Mayo,Francia,250,6,6,,12,"(10.886611,-74.776708)"
2022,Mayo,Francia,250,71,65,,136,"(3.541112,-76.384584)"
2022,Mayo,Francia,250,2,7,,9,"(4.452882,-75.766298)"
2022,Mayo,Francia,250,2974,2326,,5300,"(4.697144,-74.140516)"
2022,Mayo,Francia,250,6,2,,8,"(4.815061,-75.736532)"
2022,Mayo,Francia,250,175,105,,280,"(6.171601,-75.427454)"
2022,Mayo,Gabón,266,1,2,,3,"(4.697144,-74.140516)"
2022,Mayo,Gambia,270,3,0,,3,"(4.697144,-74.140516)"
2022,Mayo,Georgia,268,0,1,,1,"(10.886611,-74.776708)"
2022,Mayo,Georgia,268,2,1,,3,"(4.452882,-75.766298)"
2022,Mayo,Georgia,268,11,7,,18,"(4.697144,-74.140516)"
2022,Mayo,Georgia,268,1,1,,2,"(4.815061,-75.736532)"
2022,Mayo,Georgia,268,5,4,,9,"(6.171601,-75.427454)"
2022,Mayo,Ghana,288,1,0,,1,"(10.445761,-75.516429)"
2022,Mayo,Ghana,288,2,3,,5,"(4.697144,-74.140516)"
2022,Mayo,Ghana,288,0,1,,1,"(6.171601,-75.427454)"
2022,Mayo,Grecia,300,2,1,,3,"(10.445761,-75.516429)"
2022,Mayo,Grecia,300,5,3,,8,"(3.541112,-76.384584)"
2022,Mayo,Grecia,300,78,66,,144,"(4.697144,-74.140516)"
2022,Mayo,Grecia,300,1,0,,1,"(4.815061,-75.736532)"
2022,Mayo,Grecia,300,11,8,,19,"(6.171601,-75.427454)"
2022,Mayo,Guatemala,320,3,5,,8,"(10.445761,-75.516429)"
2022,Mayo,Guatemala,320,10,6,,16,"(10.886611,-74.776708)"
2022,Mayo,Guatemala,320,68,71,,139,"(3.541112,-76.384584)"
2022,Mayo,Guatemala,320,3,11,,14,"(4.452882,-75.766298)"
2022,Mayo,Guatemala,320,660,794,,1454,"(4.697144,-74.140516)"
2022,Mayo,Guatemala,320,9,12,,21,"(4.815061,-75.736532)"
2022,Mayo,Guatemala,320,82,98,,180,"(6.171601,-75.427454)"
2022,Mayo,Guatemala,320,2,3,,5,"(7.128456,-73.183637)"
2022,Mayo,Guatemala,320,1,0,,1,"(7.927209,-72.507910)"
2022,Mayo,Guyana,328,0,1,,1,"(10.445761,-75.516429)"
2022,Mayo,Guyana,328,0,2,,2,"(10.886611,-74.776708)"
2022,Mayo,Guyana,328,1,4,,5,"(3.541112,-76.384584)"
2022,Mayo,Guyana,328,5,30,,35,"(4.697144,-74.140516)"
2022,Mayo,Guyana,328,0,1,,1,"(4.815061,-75.736532)"
2022,Mayo,Guyana,328,4,7,,11,"(6.171601,-75.427454)"
2022,Mayo,Guyana,328,0,1,,1,"(7.927209,-72.507910)"
2022,Mayo,Guinea,324,0,1,,1,"(10.886611,-74.776708)"
2022,Mayo,Guinea,324,3,1,,4,"(4.697144,-74.140516)"
2022,Mayo,Guinea Ecuatorial,226,1,2,,3,"(4.697144,-74.140516)"
2022,Mayo,Guadalupe/Territorio Francés,312,2,0,,2,"(10.445761,-75.516429)"
2022,Mayo,Guadalupe/Territorio Francés,312,1,0,,1,"(3.541112,-76.384584)"
2022,Mayo,Guadalupe/Territorio Francés,312,3,0,,3,"(4.697144,-74.140516)"
2022,Mayo,Guayana Francesa/Departamento de Ultramar Francés,254,0,1,,1,"(10.886611,-74.776708)"
2022,Mayo,Guayana Francesa/Departamento de Ultramar Francés,254,0,1,,1,"(4.697144,-74.140516)"
2022,Mayo,Guayana Francesa/Departamento de Ultramar Francés,254,0,1,,1,"(6.171601,-75.427454)"
2022,Mayo,Haití,332,2,8,,10,"(4.697144,-74.140516)"
2022,Mayo,Haití,332,0,3,,3,"(6.171601,-75.427454)"
2022,Mayo,Honduras,340,0,1,,1,"(10.408582,-75.538003)"
2022,Mayo,Honduras,340,1,5,,6,"(10.445761,-75.516429)"
2022,Mayo,Honduras,340,12,21,,33,"(10.886611,-74.776708)"
2022,Mayo,Honduras,340,0,2,,2,"(12.5744111,-81.703935)"
2022,Mayo,Honduras,340,14,21,,35,"(3.541112,-76.384584)"
2022,Mayo,Honduras,340,72,154,,226,"(4.697144,-74.140516)"
2022,Mayo,Honduras,340,4,9,,13,"(4.815061,-75.736532)"
2022,Mayo,Honduras,340,40,56,,96,"(6.171601,-75.427454)"
2022,Mayo,Honduras,340,2,3,,5,"(7.128456,-73.183637)"
2022,Mayo,Hong Kong,344,1,1,,2,"(3.541112,-76.384584)"
2022,Mayo,Hong Kong,344,3,1,,4,"(4.697144,-74.140516)"
2022,Mayo,Hong Kong,344,1,0,,1,"(4.815061,-75.736532)"
2022,Mayo,Hungría,348,1,0,,1,"(10.445761,-75.516429)"
2022,Mayo,Hungría,348,9,11,,20,"(4.697144,-74.140516)"
2022,Mayo,Hungría,348,0,1,,1,"(6.171601,-75.427454)"
2022,Mayo,India,356,1,2,,3,"(10.445761,-75.516429)"
2022,Mayo,India,356,1,1,,2,"(3.541112,-76.384584)"
2022,Mayo,India,356,33,43,,76,"(4.697144,-74.140516)"
2022,Mayo,India,356,1,0,,1,"(6.171601,-75.427454)"
2022,Mayo,Indonesia,360,0,1,,1,"(10.886611,-74.776708)"
2022,Mayo,Indonesia,360,3,4,,7,"(4.697144,-74.140516)"
2022,Mayo,Indonesia,360,3,6,,9,"(6.171601,-75.427454)"
2022,Mayo,Iraq,368,5,7,,12,"(4.697144,-74.140516)"
2022,Mayo,Irán,364,2,2,,4,"(4.697144,-74.140516)"
2022,Mayo,Irán,364,1,0,,1,"(6.171601,-75.427454)"
2022,Mayo,República de Irlanda,372,0,1,,1,"(10.445761,-75.516429)"
2022,Mayo,República de Irlanda,372,1,0,,1,"(10.886611,-74.776708)"
2022,Mayo,República de Irlanda,372,1,2,,3,"(3.541112,-76.384584)"
2022,Mayo,República de Irlanda,372,17,14,,31,"(4.697144,-74.140516)"
2022,Mayo,República de Irlanda,372,2,2,,4,"(6.171601,-75.427454)"
2022,Mayo,Islandia,352,2,1,,3,"(10.445761,-75.516429)"
2022,Mayo,Islandia,352,1,2,,3,"(10.886611,-74.776708)"
2022,Mayo,Islandia,352,9,8,,17,"(4.697144,-74.140516)"
2022,Mayo,Islandia,352,2,0,,2,"(6.171601,-75.427454)"
2022,Mayo,Israel,376,1,2,,3,"(10.445761,-75.516429)"
2022,Mayo,Israel,376,2,1,,3,"(10.886611,-74.776708)"
2022,Mayo,Israel,376,5,4,,9,"(3.541112,-76.384584)"
2022,Mayo,Israel,376,206,119,,325,"(4.697144,-74.140516)"
2022,Mayo,Israel,376,19,10,,29,"(6.171601,-75.427454)"
2022,Mayo,Italia,380,77,36,,113,"(10.445761,-75.516429)"
2022,Mayo,Italia,380,4,5,,9,"(10.886611,-74.776708)"
2022,Mayo,Italia,380,150,99,,249,"(3.541112,-76.384584)"
2022,Mayo,Italia,380,3,1,,4,"(4.452882,-75.766298)"
2022,Mayo,Italia,380,1232,871,,2103,"(4.697144,-74.140516)"
2022,Mayo,Italia,380,2,2,,4,"(4.815061,-75.736532)"
2022,Mayo,Italia,380,203,126,,329,"(6.171601,-75.427454)"
2022,Mayo,Italia,380,1,0,,1,"(7.128456,-73.183637)"
2022,Mayo,Jamaica,388,3,5,,8,"(10.445761,-75.516429)"
2022,Mayo,Jamaica,388,1,5,,6,"(10.886611,-74.776708)"
2022,Mayo,Jamaica,388,1,0,,1,"(12.586067,-81.702563)"
2022,Mayo,Jamaica,388,9,3,,12,"(3.541112,-76.384584)"
2022,Mayo,Jamaica,388,35,36,,71,"(4.697144,-74.140516)"
2022,Mayo,Jamaica,388,0,1,,1,"(4.815061,-75.736532)"
2022,Mayo,Jamaica,388,14,10,,24,"(6.171601,-75.427454)"
2022,Mayo,Jamaica,388,1,3,,4,"(7.128456,-73.183637)"
2022,Mayo,Japón,392,0,2,,2,"(10.886611,-74.776708)"
2022,Mayo,Japón,392,4,1,,5,"(3.541112,-76.384584)"
2022,Mayo,Japón,392,21,14,,35,"(4.697144,-74.140516)"
2022,Mayo,Japón,392,1,0,,1,"(4.815061,-75.736532)"
2022,Mayo,Japón,392,0,1,,1,"(6.171601,-75.427454)"
2022,Mayo,Jordania,400,0,1,,1,"(3.541112,-76.384584)"
2022,Mayo,Jordania,400,4,4,,8,"(4.697144,-74.140516)"
2022,Mayo,Kazajistán,398,1,0,,1,"(10.445761,-75.516429)"
2022,Mayo,Kazajistán,398,0,3,,3,"(4.697144,-74.140516)"
2022,Mayo,Kazajistán,398,0,1,,1,"(6.171601,-75.427454)"
2022,Mayo,Kenia,404,0,1,,1,"(3.541112,-76.384584)"
2022,Mayo,Kenia,404,9,13,,22,"(4.697144,-74.140516)"
2022,Mayo,Kenia,404,1,0,,1,"(6.171601,-75.427454)"
2022,Mayo,Kuwait,414,0,7,,7,"(4.697144,-74.140516)"
2022,Mayo,Letonia,428,1,3,,4,"(4.697144,-74.140516)"
2022,Mayo,Lituania,440,0,7,,7,"(4.697144,-74.140516)"
2022,Mayo,Lituania,440,1,0,,1,"(6.171601,-75.427454)"
2022,Mayo,Líbano,422,1,3,,4,"(10.445761,-75.516429)"
2022,Mayo,Líbano,422,3,5,,8,"(10.886611,-74.776708)"
2022,Mayo,Líbano,422,1,0,,1,"(12.586067,-81.702563)"
2022,Mayo,Líbano,422,1,1,,2,"(3.541112,-76.384584)"
2022,Mayo,Líbano,422,20,21,,41,"(4.697144,-74.140516)"
2022,Mayo,Líbano,422,2,0,,2,"(6.171601,-75.427454)"
2022,Mayo,Libia,434,0,1,,1,"(4.697144,-74.140516)"
2022,Mayo,Luxemburgo,442,3,0,,3,"(10.445761,-75.516429)"
2022,Mayo,Luxemburgo,442,28,15,,43,"(4.697144,-74.140516)"
2022,Mayo,Luxemburgo,442,1,2,,3,"(6.171601,-75.427454)"
2022,Mayo,Macao,446,1,1,,2,"(4.697144,-74.140516)"
2022,Mayo,Macedonia,807,2,2,,4,"(4.697144,-74.140516)"
2022,Mayo,Malasia,458,2,3,,5,"(4.697144,-74.140516)"
2022,Mayo,Maldivas,462,0,1,,1,"(3.541112,-76.384584)"
2022,Mayo,Maldivas,462,5,5,,10,"(4.697144,-74.140516)"
2022,Mayo,Malí,466,0,2,,2,"(4.697144,-74.140516)"
2022,Mayo,Malta,470,1,1,,2,"(0.814836,-77.662532)"
2022,Mayo,Malta,470,6,6,,12,"(10.445761,-75.516429)"
2022,Mayo,Malta,470,6,3,,9,"(3.541112,-76.384584)"
2022,Mayo,Malta,470,166,146,,312,"(4.697144,-74.140516)"
2022,Mayo,Malta,470,5,5,,10,"(6.171601,-75.427454)"
2022,Mayo,Marruecos,504,2,0,,2,"(10.445761,-75.516429)"
2022,Mayo,Marruecos,504,1,0,,1,"(10.886611,-74.776708)"
2022,Mayo,Marruecos,504,1,0,,1,"(3.541112,-76.384584)"
2022,Mayo,Marruecos,504,44,35,,79,"(4.697144,-74.140516)"
2022,Mayo,Marruecos,504,7,2,,9,"(6.171601,-75.427454)"
2022,Mayo,Mauritania,478,0,1,,1,"(4.697144,-74.140516)"
2022,Mayo,Martinica/Departamento de Ultramar Francés,474,0,1,,1,"(4.697144,-74.140516)"
2022,Mayo,Martinica/Departamento de Ultramar Francés,474,1,0,,1,"(6.171601,-75.427454)"
2022,Mayo,México,484,138,90,,228,"(10.445761,-75.516429)"
2022,Mayo,México,484,426,404,,830,"(10.886611,-74.776708)"
2022,Mayo,México,484,2,2,,4,"(12.586067,-81.702563)"
2022,Mayo,México,484,3779,3497,,7276,"(3.541112,-76.384584)"
2022,Mayo,México,484,35,21,,56,"(4.452882,-75.766298)"
2022,Mayo,México,484,22445,22315,,44760,"(4.697144,-74.140516)"
2022,Mayo,México,484,133,102,,235,"(4.815061,-75.736532)"
2022,Mayo,México,484,9349,8501,,17850,"(6.171601,-75.427454)"
2022,Mayo,México,484,102,106,,208,"(7.128456,-73.183637)"
2022,Mayo,México,484,59,51,,110,"(7.927209,-72.507910)"
2022,Mayo,Mayotte/Colectividad Territorial Francesa,175,3,1,,4,"(4.697144,-74.140516)"
2022,Mayo,Mayotte/Colectividad Territorial Francesa,175,2,0,,2,"(6.171601,-75.427454)"
2022,Mayo,Mónaco,492,2,3,,5,"(4.697144,-74.140516)"
2022,Mayo,Mongolia,496,0,1,,1,"(4.697144,-74.140516)"
2022,Mayo,Montenegro,499,2,3,,5,"(4.697144,-74.140516)"
2022,Mayo,Micronesia,583,1,2,,3,"(4.697144,-74.140516)"
2022,Mayo,Mozambique,508,0,1,,1,"(4.697144,-74.140516)"
2022,Mayo,Nicaragua,558,0,1,,1,"(10.445761,-75.516429)"
2022,Mayo,Nicaragua,558,1,1,,2,"(10.886611,-74.776708)"
2022,Mayo,Nicaragua,558,5,10,,15,"(3.541112,-76.384584)"
2022,Mayo,Nicaragua,558,0,6,,6,"(3.893038,-77.067921)"
2022,Mayo,Nicaragua,558,24,60,,84,"(4.697144,-74.140516)"
2022,Mayo,Nicaragua,558,5,28,,33,"(6.171601,-75.427454)"
2022,Mayo,Nicaragua,558,0,1,,1,"(7.128456,-73.183637)"
2022,Mayo,Nigeria,566,0,3,,3,"(4.697144,-74.140516)"
2022,Mayo,Noruega,578,5,3,,8,"(10.445761,-75.516429)"
2022,Mayo,Noruega,578,1,0,,1,"(10.886611,-74.776708)"
2022,Mayo,Noruega,578,3,3,,6,"(3.541112,-76.384584)"
2022,Mayo,Noruega,578,54,49,,103,"(4.697144,-74.140516)"
2022,Mayo,Noruega,578,9,5,,14,"(6.171601,-75.427454)"
2022,Mayo,Noruega,578,2,0,,2,"(7.128456,-73.183637)"
2022,Mayo,Nueva Zelanda,554,1,0,,1,"(3.541112,-76.384584)"
2022,Mayo,Nueva Zelanda,554,16,5,,21,"(4.697144,-74.140516)"
2022,Mayo,Nueva Zelanda,554,1,0,,1,"(6.171601,-75.427454)"
2022,Mayo,Omán,512,9,8,,17,"(4.697144,-74.140516)"
2022,Mayo,Papúa Nueva Guinea,598,1,2,,3,"(4.697144,-74.140516)"
2022,Mayo,Papúa Nueva Guinea,598,1,0,,1,"(6.171601,-75.427454)"
2022,Mayo,Pakistán,586,3,1,,4,"(4.697144,-74.140516)"
2022,Mayo,Panamá,591,24,114,,138,"(10.408582,-75.538003)"
2022,Mayo,Panamá,591,1084,863,,1947,"(10.445761,-75.516429)"
2022,Mayo,Panamá,591,628,645,,1273,"(10.886611,-74.776708)"
2022,Mayo,Panamá,591,0,6,,6,"(10.971302,-74.765397)"
2022,Mayo,Panamá,591,0,4,,4,"(11.117806,-74.232622)"
2022,Mayo,Panamá,591,1,1,,2,"(11.247723,-74.213989)"
2022,Mayo,Panamá,591,0,1,,1,"(12.165168,-71.983761)"
2022,Mayo,Panamá,591,3,27,,30,"(12.5744111,-81.703935)"
2022,Mayo,Panamá,591,11,18,,29,"(12.586067,-81.702563)"
2022,Mayo,Panamá,591,1980,1472,,3452,"(3.541112,-76.384584)"
2022,Mayo,Panamá,591,0,9,,9,"(3.893038,-77.067921)"
2022,Mayo,Panamá,591,101,71,,172,"(4.452882,-75.766298)"
2022,Mayo,Panamá,591,5581,5971,,11552,"(4.697144,-74.140516)"
2022,Mayo,Panamá,591,205,124,,329,"(4.815061,-75.736532)"
2022,Mayo,Panamá,591,6,14,,20,"(6.17134,-75.427194)"
2022,Mayo,Panamá,591,2145,1974,,4119,"(6.171601,-75.427454)"
2022,Mayo,Panamá,591,8,21,,29,"(7.102626,-77.762647)"
2022,Mayo,Panamá,591,89,68,,157,"(7.128456,-73.183637)"
2022,Mayo,Panamá,591,77,46,,123,"(7.927209,-72.507910)"
2022,Mayo,Panamá,591,30,41,,71,"(8.635765,-77.346578)"
2022,Mayo,Paraguay,600,1,2,,3,"(10.445761,-75.516429)"
2022,Mayo,Paraguay,600,3,16,,19,"(10.886611,-74.776708)"
2022,Mayo,Paraguay,600,11,21,,32,"(3.541112,-76.384584)"
2022,Mayo,Paraguay,600,1,1,,2,"(4.452882,-75.766298)"
2022,Mayo,Paraguay,600,208,335,,543,"(4.697144,-74.140516)"
2022,Mayo,Paraguay,600,0,3,,3,"(4.815061,-75.736532)"
2022,Mayo,Paraguay,600,5,30,,35,"(6.171601,-75.427454)"
2022,Mayo,Paraguay,600,1,1,,2,"(7.128456,-73.183637)"
2022,Mayo,Paraguay,600,1,0,,1,"(7.927209,-72.507910)"
2022,Mayo,Perú,604,2,5,,7,"(-0.193180,-74.784874)"
2022,Mayo,Perú,604,3,2,,5,"(-3.790089,-70.356599)"
2022,Mayo,Perú,604,95,152,,247,"(-4.197703,-69.941278)"
2022,Mayo,Perú,604,45,83,,128,"(0.814836,-77.662532)"
2022,Mayo,Perú,604,25,41,,66,"(10.445761,-75.516429)"
2022,Mayo,Perú,604,14,26,,40,"(10.886611,-74.776708)"
2022,Mayo,Perú,604,25,28,,53,"(3.541112,-76.384584)"
2022,Mayo,Perú,604,2,2,,4,"(4.452882,-75.766298)"
2022,Mayo,Perú,604,4110,4537,,8647,"(4.697144,-74.140516)"
2022,Mayo,Perú,604,9,6,,15,"(4.815061,-75.736532)"
2022,Mayo,Perú,604,530,528,,1058,"(6.171601,-75.427454)"
2022,Mayo,Perú,604,2,1,,3,"(7.128456,-73.183637)"
2022,Mayo,Perú,604,1,0,,1,"(7.927209,-72.507910)"
2022,Mayo,Palestina,99999,1,0,,1,"(10.445761,-75.516429)"
2022,Mayo,Palestina,99999,0,1,,1,"(4.697144,-74.140516)"
2022,Mayo,Palestina,99999,1,0,,1,"(6.171601,-75.427454)"
2022,Mayo,Polonia,616,3,1,,4,"(10.445761,-75.516429)"
2022,Mayo,Polonia,616,1,3,,4,"(3.541112,-76.384584)"
2022,Mayo,Polonia,616,23,59,,82,"(4.697144,-74.140516)"
2022,Mayo,Polonia,616,8,5,,13,"(6.171601,-75.427454)"
2022,Mayo,Portugal,620,12,10,,22,"(10.445761,-75.516429)"
2022,Mayo,Portugal,620,20,20,,40,"(3.541112,-76.384584)"
2022,Mayo,Portugal,620,292,244,,536,"(4.697144,-74.140516)"
2022,Mayo,Portugal,620,2,0,,2,"(4.815061,-75.736532)"
2022,Mayo,Portugal,620,54,42,,96,"(6.171601,-75.427454)"
2022,Mayo,Polinesia Francesa/Colectividad de Ultramar Francesa,258,1,1,,2,"(3.541112,-76.384584)"
2022,Mayo,Polinesia Francesa/Colectividad de Ultramar Francesa,258,1,0,,1,"(4.697144,-74.140516)"
2022,Mayo,Puerto Rico/Territorio de Estados Unidos,630,3,6,,9,"(10.445761,-75.516429)"
2022,Mayo,Puerto Rico/Territorio de Estados Unidos,630,15,9,,24,"(10.886611,-74.776708)"
2022,Mayo,Puerto Rico/Territorio de Estados Unidos,630,0,1,,1,"(12.586067,-81.702563)"
2022,Mayo,Puerto Rico/Territorio de Estados Unidos,630,46,37,,83,"(3.541112,-76.384584)"
2022,Mayo,Puerto Rico/Territorio de Estados Unidos,630,1,0,,1,"(4.452882,-75.766298)"
2022,Mayo,Puerto Rico/Territorio de Estados Unidos,630,647,585,,1232,"(4.697144,-74.140516)"
2022,Mayo,Puerto Rico/Territorio de Estados Unidos,630,6,3,,9,"(4.815061,-75.736532)"
2022,Mayo,Puerto Rico/Territorio de Estados Unidos,630,0,2,,2,"(6.17134,-75.427194)"
2022,Mayo,Puerto Rico/Territorio de Estados Unidos,630,43,31,,74,"(6.171601,-75.427454)"
2022,Mayo,Puerto Rico/Territorio de Estados Unidos,630,0,1,,1,"(7.128456,-73.183637)"
2022,Mayo,Puerto Rico/Territorio de Estados Unidos,630,1,0,,1,"(7.927209,-72.507910)"
2022,Mayo,Qatar,634,2,3,,5,"(3.541112,-76.384584)"
2022,Mayo,Qatar,634,17,17,,34,"(4.697144,-74.140516)"
2022,Mayo,Qatar,634,0,2,,2,"(6.171601,-75.427454)"
2022,Mayo,Reino Unido de Gran Bretaña e Irlanda del Norte,826,2,1,,3,"(10.445761,-75.516429)"
2022,Mayo,Reino Unido de Gran Bretaña e Irlanda del Norte,826,0,2,,2,"(10.886611,-74.776708)"
2022,Mayo,Reino Unido de Gran Bretaña e Irlanda del Norte,826,0,1,,1,"(12.586067,-81.702563)"
2022,Mayo,Reino Unido de Gran Bretaña e Irlanda del Norte,826,21,20,,41,"(3.541112,-76.384584)"
2022,Mayo,Reino Unido de Gran Bretaña e Irlanda del Norte,826,1632,1245,,2877,"(4.697144,-74.140516)"
2022,Mayo,Reino Unido de Gran Bretaña e Irlanda del Norte,826,1,0,,1,"(4.815061,-75.736532)"
2022,Mayo,Reino Unido de Gran Bretaña e Irlanda del Norte,826,36,29,,65,"(6.171601,-75.427454)"
2022,Mayo,República CentroÁfricana,140,1,2,,3,"(4.697144,-74.140516)"
2022,Mayo,Federación de Rusia,643,8,18,,26,"(4.697144,-74.140516)"
2022,Mayo,República Dominicana,214,1,12,,13,"(10.408582,-75.538003)"
2022,Mayo,República Dominicana,214,18,16,,34,"(10.445761,-75.516429)"
2022,Mayo,República Dominicana,214,73,60,,133,"(10.886611,-74.776708)"
2022,Mayo,República Dominicana,214,9,13,,22,"(11.117806,-74.232622)"
2022,Mayo,República Dominicana,214,2,2,,4,"(12.586067,-81.702563)"
2022,Mayo,República Dominicana,214,457,348,,805,"(3.541112,-76.384584)"
2022,Mayo,República Dominicana,214,2,4,,6,"(4.452882,-75.766298)"
2022,Mayo,República Dominicana,214,5472,4728,,10200,"(4.697144,-74.140516)"
2022,Mayo,República Dominicana,214,105,107,,212,"(4.815061,-75.736532)"
2022,Mayo,República Dominicana,214,5550,4066,,9616,"(6.171601,-75.427454)"
2022,Mayo,República Dominicana,214,13,12,,25,"(7.128456,-73.183637)"
2022,Mayo,República Dominicana,214,6,2,,8,"(7.927209,-72.507910)"
2022,Mayo,Reunión,638,1,0,,1,"(4.697144,-74.140516)"
2022,Mayo,Rumania,642,5,4,,9,"(10.445761,-75.516429)"
2022,Mayo,Rumania,642,1,2,,3,"(3.541112,-76.384584)"
2022,Mayo,Rumania,642,18,10,,28,"(4.697144,-74.140516)"
2022,Mayo,Rumania,642,1,0,,1,"(6.171601,-75.427454)"
2022,Mayo,Rwanda,646,0,3,,3,"(4.697144,-74.140516)"
2022,Mayo,Rwanda,646,0,1,,1,"(6.171601,-75.427454)"
2022,Mayo,San Pedro y Miquelón/territorio de Ultramar de La Unión Europea,666,0,1,,1,"(4.697144,-74.140516)"
2022,Mayo,San Cristóbal y Nevis,659,1,1,,2,"(7.818934,-72.453226)"
2022,Mayo,San  Vicente y las Granadinas,670,0,1,,1,"(10.886611,-74.776708)"
2022,Mayo,San  Vicente y las Granadinas,670,1,1,,2,"(4.697144,-74.140516)"
2022,Mayo,Santa Sede/Ciudad del Vaticano,336,5,1,,6,"(4.697144,-74.140516)"
2022,Mayo,Senegal,686,2,4,,6,"(4.697144,-74.140516)"
2022,Mayo,Senegal,686,2,0,,2,"(6.171601,-75.427454)"
2022,Mayo,Serbia,688,1,0,,1,"(10.445761,-75.516429)"
2022,Mayo,Serbia,688,1,0,,1,"(3.541112,-76.384584)"
2022,Mayo,Serbia,688,8,3,,11,"(4.697144,-74.140516)"
2022,Mayo,Serbia,688,2,1,,3,"(6.171601,-75.427454)"
2022,Mayo,Sierra Leona,694,2,0,,2,"(4.697144,-74.140516)"
2022,Mayo,Singapur,702,1,0,,1,"(10.445761,-75.516429)"
2022,Mayo,Singapur,702,2,2,,4,"(3.541112,-76.384584)"
2022,Mayo,Singapur,702,21,19,,40,"(4.697144,-74.140516)"
2022,Mayo,Singapur,702,0,1,,1,"(6.171601,-75.427454)"
2022,Mayo,República Árabe Siria,760,0,1,,1,"(6.171601,-75.427454)"
2022,Mayo,Somalia,706,1,1,,2,"(4.697144,-74.140516)"
2022,Mayo,Sri Lanka,144,0,1,,1,"(4.697144,-74.140516)"
2022,Mayo,Sudáfrica,710,0,1,,1,"(10.445761,-75.516429)"
2022,Mayo,Sudáfrica,710,9,8,,17,"(4.697144,-74.140516)"
2022,Mayo,Sudáfrica,710,1,1,,2,"(6.171601,-75.427454)"
2022,Mayo,Sudán,736,1,0,,1,"(4.697144,-74.140516)"
2022,Mayo,Suecia,752,7,9,,16,"(10.445761,-75.516429)"
2022,Mayo,Suecia,752,1,3,,4,"(10.886611,-74.776708)"
2022,Mayo,Suecia,752,29,20,,49,"(3.541112,-76.384584)"
2022,Mayo,Suecia,752,0,2,,2,"(4.452882,-75.766298)"
2022,Mayo,Suecia,752,131,89,,220,"(4.697144,-74.140516)"
2022,Mayo,Suecia,752,2,1,,3,"(4.815061,-75.736532)"
2022,Mayo,Suecia,752,25,18,,43,"(6.171601,-75.427454)"
2022,Mayo,Suecia,752,1,0,,1,"(7.927209,-72.507910)"
2022,Mayo,Suiza,756,21,19,,40,"(10.445761,-75.516429)"
2022,Mayo,Suiza,756,6,4,,10,"(10.886611,-74.776708)"
2022,Mayo,Suiza,756,73,39,,112,"(3.541112,-76.384584)"
2022,Mayo,Suiza,756,2,1,,3,"(4.452882,-75.766298)"
2022,Mayo,Suiza,756,405,269,,674,"(4.697144,-74.140516)"
2022,Mayo,Suiza,756,6,2,,8,"(4.815061,-75.736532)"
2022,Mayo,Suiza,756,53,38,,91,"(6.171601,-75.427454)"
2022,Mayo,Suiza,756,1,0,,1,"(7.927209,-72.507910)"
2022,Mayo,Surinam,740,0,1,,1,"(10.445761,-75.516429)"
2022,Mayo,Surinam,740,0,6,,6,"(10.886611,-74.776708)"
2022,Mayo,Surinam,740,2,0,,2,"(3.541112,-76.384584)"
2022,Mayo,Surinam,740,16,18,,34,"(4.697144,-74.140516)"
2022,Mayo,Surinam,740,3,4,,7,"(6.171601,-75.427454)"
2022,Mayo,Taiwán,158,2,2,,4,"(4.697144,-74.140516)"
2022,Mayo,Taiwán,158,0,1,,1,"(6.171601,-75.427454)"
2022,Mayo,Tailandia,764,0,2,,2,"(3.541112,-76.384584)"
2022,Mayo,Tailandia,764,19,11,,30,"(4.697144,-74.140516)"
2022,Mayo,Tanzania,834,6,2,,8,"(4.697144,-74.140516)"
2022,Mayo,Togo,768,1,0,,1,"(4.697144,-74.140516)"
2022,Mayo,Trinidad y Tobago,780,0,5,,5,"(10.408582,-75.538003)"
2022,Mayo,Trinidad y Tobago,780,0,9,,9,"(10.445761,-75.516429)"
2022,Mayo,Trinidad y Tobago,780,0,1,,1,"(10.886611,-74.776708)"
2022,Mayo,Trinidad y Tobago,780,4,3,,7,"(3.541112,-76.384584)"
2022,Mayo,Trinidad y Tobago,780,0,2,,2,"(4.452882,-75.766298)"
2022,Mayo,Trinidad y Tobago,780,19,25,,44,"(4.697144,-74.140516)"
2022,Mayo,Trinidad y Tobago,780,1,1,,2,"(4.815061,-75.736532)"
2022,Mayo,Trinidad y Tobago,780,7,4,,11,"(6.171601,-75.427454)"
2022,Mayo,Trinidad y Tobago,780,0,1,,1,"(7.927209,-72.507910)"
2022,Mayo,Túnez,788,2,3,,5,"(4.697144,-74.140516)"
2022,Mayo,Turquía,792,2,3,,5,"(10.445761,-75.516429)"
2022,Mayo,Turquía,792,1,0,,1,"(10.886611,-74.776708)"
2022,Mayo,Turquía,792,12,6,,18,"(3.541112,-76.384584)"
2022,Mayo,Turquía,792,1854,1134,,2988,"(4.697144,-74.140516)"
2022,Mayo,Turquía,792,40,35,,75,"(6.171601,-75.427454)"
2022,Mayo,Tuvalu,798,0,1,,1,"(10.886611,-74.776708)"
2022,Mayo,Turkmenistán,795,3,0,,3,"(4.697144,-74.140516)"
2022,Mayo,Ucrania,804,1,1,,2,"(4.697144,-74.140516)"
2022,Mayo,Uganda,800,0,1,,1,"(10.445761,-75.516429)"
2022,Mayo,Uganda,800,0,1,,1,"(4.697144,-74.140516)"
2022,Mayo,Uruguay,858,1,0,,1,"(0.814836,-77.662532)"
2022,Mayo,Uruguay,858,3,3,,6,"(10.445761,-75.516429)"
2022,Mayo,Uruguay,858,1,1,,2,"(10.886611,-74.776708)"
2022,Mayo,Uruguay,858,30,39,,69,"(3.541112,-76.384584)"
2022,Mayo,Uruguay,858,2,3,,5,"(4.452882,-75.766298)"
2022,Mayo,Uruguay,858,202,251,,453,"(4.697144,-74.140516)"
2022,Mayo,Uruguay,858,4,7,,11,"(4.815061,-75.736532)"
2022,Mayo,Uruguay,858,7,11,,18,"(6.171601,-75.427454)"
2022,Mayo,Uruguay,858,0,1,,1,"(7.128456,-73.183637)"
2022,Mayo,Uruguay,858,1,2,,3,"(7.927209,-72.507910)"
2022,Mayo,Venezuela,862,9,9,,18,"(10.445761,-75.516429)"
2022,Mayo,Venezuela,862,22,31,,53,"(10.886611,-74.776708)"
2022,Mayo,Venezuela,862,246,516,,762,"(11.360009,-72.129330)"
2022,Mayo,Venezuela,862,27,28,,55,"(3.541112,-76.384584)"
2022,Mayo,Venezuela,862,0,1,,1,"(3.866713,-67.927521)"
2022,Mayo,Venezuela,862,1,4,,5,"(4.452882,-75.766298)"
2022,Mayo,Venezuela,862,123,254,,377,"(4.697144,-74.140516)"
2022,Mayo,Venezuela,862,10,14,,24,"(4.815061,-75.736532)"
2022,Mayo,Venezuela,862,50,56,,106,"(6.171601,-75.427454)"
2022,Mayo,Venezuela,862,5,7,,12,"(6.185799,-67.483929)"
2022,Mayo,Venezuela,862,15,29,,44,"(7.088729,-70.740253)"
2022,Mayo,Venezuela,862,4,4,,8,"(7.128456,-73.183637)"
2022,Mayo,Venezuela,862,289,418,,707,"(7.818934,-72.453226)"
2022,Mayo,Venezuela,862,38,67,,105,"(7.916725,-72.462544)"
2022,Mayo,Venezuela,862,6,11,,17,"(7.927209,-72.507910)"
2022,Mayo,Venezuela,862,18,19,,37,"(8.36068,-72.409396)"
2022,Mayo,Vietnam,704,3,4,,7,"(4.697144,-74.140516)"
2022,Mayo,Islas Vírgenes Británicas/Territorio Británico de Ultramar,92,2,0,,2,"(4.697144,-74.140516)"
2022,Mayo,Islas Vírgenes Británicas/Territorio Británico de Ultramar,92,3,3,,6,"(6.171601,-75.427454)"
2022,Mayo,Islas Vírgenes Estadounidenses/Territorio de Estados Unidos,850,1,0,,1,"(10.886611,-74.776708)"
2022,Mayo,Islas Vírgenes Estadounidenses/Territorio de Estados Unidos,850,1,0,,1,"(4.697144,-74.140516)"
2022,Mayo,Zambia,894,0,2,,2,"(4.697144,-74.140516)"
2022,Mayo,Zimbabue,716,1,0,,1,"(4.697144,-74.140516)"
2022,Mayo,Anguila/Territorio Británico de Ultramar,660,1,0,,1,"(10.886611,-74.776708)"
2022,Mayo,Anguila/Territorio Británico de Ultramar,660,1,0,,1,"(4.697144,-74.140516)"
2022,Mayo,Islas Turcas y Caicos/Territorio Británico de Ultramar,796,0,4,,4,"(4.697144,-74.140516)"
2022,Mayo,Islas Turcas y Caicos/Territorio Británico de Ultramar,796,2,1,,3,"(6.171601,-75.427454)"
2022,Mayo,Islas Turcas y Caicos/Territorio Británico de Ultramar,796,1,0,,1,"(7.128456,-73.183637)"
2022,Mayo,Desconocido,99999,0,3,,3,"(4.697144,-74.140516)"
2022,Mayo,Desconocido,99999,0,2,,2,"(6.171601,-75.427454)"
2022,Junio,Afganistán,4,0,1,,1,"(3.541112,-76.384584)"
2022,Junio,Albania,8,2,2,,4,"(4.697144,-74.140516)"
2022,Junio,Alemania,276,71,37,,108,"(10.445761,-75.516429)"
2022,Junio,Alemania,276,12,11,,23,"(10.886611,-74.776708)"
2022,Junio,Alemania,276,102,56,,158,"(3.541112,-76.384584)"
2022,Junio,Alemania,276,1705,1352,,3057,"(4.697144,-74.140516)"
2022,Junio,Alemania,276,2,0,,2,"(4.815061,-75.736532)"
2022,Junio,Alemania,276,148,107,,255,"(6.171601,-75.427454)"
2022,Junio,Andorra,20,1,2,,3,"(3.541112,-76.384584)"
2022,Junio,Andorra,20,5,4,,9,"(4.697144,-74.140516)"
2022,Junio,Angola,24,2,8,,10,"(4.697144,-74.140516)"
2022,Junio,Antigua y Barbuda,28,2,5,,7,"(4.697144,-74.140516)"
2022,Junio,Países Bajos,528,303,191,,494,"(10.445761,-75.516429)"
2022,Junio,Países Bajos,528,17,25,,42,"(10.886611,-74.776708)"
2022,Junio,Países Bajos,528,90,56,,146,"(3.541112,-76.384584)"
2022,Junio,Países Bajos,528,1456,1182,,2638,"(4.697144,-74.140516)"
2022,Junio,Países Bajos,528,4,5,,9,"(4.815061,-75.736532)"
2022,Junio,Países Bajos,528,135,85,,220,"(6.171601,-75.427454)"
2022,Junio,Arabia Saudita,682,1,3,,4,"(10.445761,-75.516429)"
2022,Junio,Arabia Saudita,682,2,1,,3,"(3.541112,-76.384584)"
2022,Junio,Arabia Saudita,682,1,1,,2,"(4.452882,-75.766298)"
2022,Junio,Arabia Saudita,682,3,41,,44,"(4.697144,-74.140516)"
2022,Junio,Arabia Saudita,682,1,2,,3,"(6.171601,-75.427454)"
2022,Junio,Argelia,12,3,10,,13,"(4.697144,-74.140516)"
2022,Junio,Argelia,12,0,1,,1,"(6.171601,-75.427454)"
2022,Junio,Argentina,32,1,8,,9,"(0.814836,-77.662532)"
2022,Junio,Argentina,32,16,15,,31,"(10.445761,-75.516429)"
2022,Junio,Argentina,32,16,19,,35,"(10.886611,-74.776708)"
2022,Junio,Argentina,32,1,0,,1,"(12.586067,-81.702563)"
2022,Junio,Argentina,32,47,58,,105,"(3.541112,-76.384584)"
2022,Junio,Argentina,32,6,7,,13,"(4.452882,-75.766298)"
2022,Junio,Argentina,32,2688,2448,,5136,"(4.697144,-74.140516)"
2022,Junio,Argentina,32,2,1,,3,"(4.815061,-75.736532)"
2022,Junio,Argentina,32,285,250,,535,"(6.171601,-75.427454)"
2022,Junio,Argentina,32,2,0,,2,"(7.128456,-73.183637)"
2022,Junio,Argentina,32,15,8,,23,"(7.927209,-72.507910)"
2022,Junio,República de Armenia,51,1,2,,3,"(4.697144,-74.140516)"
2022,Junio,República de Armenia,51,0,1,,1,"(6.171601,-75.427454)"
2022,Junio,Aruba,533,0,9,,9,"(10.408582,-75.538003)"
2022,Junio,Aruba,533,2,1,,3,"(10.445761,-75.516429)"
2022,Junio,Aruba,533,148,107,,255,"(10.886611,-74.776708)"
2022,Junio,Aruba,533,0,1,,1,"(11.247723,-74.213989)"
2022,Junio,Aruba,533,49,43,,92,"(3.541112,-76.384584)"
2022,Junio,Aruba,533,3,0,,3,"(4.452882,-75.766298)"
2022,Junio,Aruba,533,2098,1694,,3792,"(4.697144,-74.140516)"
2022,Junio,Aruba,533,1,0,,1,"(4.815061,-75.736532)"
2022,Junio,Aruba,533,236,197,,433,"(6.171601,-75.427454)"
2022,Junio,Aruba,533,5,48,,53,"(7.128456,-73.183637)"
2022,Junio,Australia,36,7,4,,11,"(10.445761,-75.516429)"
2022,Junio,Australia,36,0,2,,2,"(10.886611,-74.776708)"
2022,Junio,Australia,36,37,23,,60,"(3.541112,-76.384584)"
2022,Junio,Australia,36,543,446,,989,"(4.697144,-74.140516)"
2022,Junio,Australia,36,4,1,,5,"(4.815061,-75.736532)"
2022,Junio,Australia,36,85,79,,164,"(6.171601,-75.427454)"
2022,Junio,Australia,36,4,1,,5,"(7.128456,-73.183637)"
2022,Junio,Australia,36,1,1,,2,"(7.927209,-72.507910)"
2022,Junio,Austria,40,1,4,,5,"(10.445761,-75.516429)"
2022,Junio,Austria,40,9,4,,13,"(3.541112,-76.384584)"
2022,Junio,Austria,40,0,1,,1,"(4.452882,-75.766298)"
2022,Junio,Austria,40,150,96,,246,"(4.697144,-74.140516)"
2022,Junio,Austria,40,11,1,,12,"(6.171601,-75.427454)"
2022,Junio,Azerbaiyán,31,1,3,,4,"(4.697144,-74.140516)"
2022,Junio,Bahamas,44,4,3,,7,"(10.445761,-75.516429)"
2022,Junio,Bahamas,44,6,3,,9,"(10.886611,-74.776708)"
2022,Junio,Bahamas,44,29,8,,37,"(3.541112,-76.384584)"
2022,Junio,Bahamas,44,42,56,,98,"(4.697144,-74.140516)"
2022,Junio,Bahamas,44,0,1,,1,"(4.815061,-75.736532)"
2022,Junio,Bahamas,44,62,29,,91,"(6.171601,-75.427454)"
2022,Junio,Bahréin,48,1,1,,2,"(10.445761,-75.516429)"
2022,Junio,Bahréin,48,2,2,,4,"(3.541112,-76.384584)"
2022,Junio,Bahréin,48,4,7,,11,"(4.697144,-74.140516)"
2022,Junio,Bahréin,48,3,2,,5,"(6.171601,-75.427454)"
2022,Junio,Bangladesh,50,0,1,,1,"(10.445761,-75.516429)"
2022,Junio,Bangladesh,50,2,1,,3,"(4.697144,-74.140516)"
2022,Junio,Barbados,52,1,1,,2,"(3.541112,-76.384584)"
2022,Junio,Barbados,52,14,15,,29,"(4.697144,-74.140516)"
2022,Junio,Barbados,52,5,6,,11,"(6.171601,-75.427454)"
2022,Junio,República de Belarús,112,1,0,,1,"(4.697144,-74.140516)"
2022,Junio,Bélgica,56,14,8,,22,"(10.445761,-75.516429)"
2022,Junio,Bélgica,56,1,1,,2,"(10.886611,-74.776708)"
2022,Junio,Bélgica,56,38,19,,57,"(3.541112,-76.384584)"
2022,Junio,Bélgica,56,167,123,,290,"(4.697144,-74.140516)"
2022,Junio,Bélgica,56,0,1,,1,"(4.815061,-75.736532)"
2022,Junio,Bélgica,56,45,36,,81,"(6.171601,-75.427454)"
2022,Junio,Bélgica,56,1,0,,1,"(7.128456,-73.183637)"
2022,Junio,Bélgica,56,2,2,,4,"(7.927209,-72.507910)"
2022,Junio,Belice,84,3,0,,3,"(3.541112,-76.384584)"
2022,Junio,Belice,84,3,2,,5,"(4.697144,-74.140516)"
2022,Junio,Belice,84,0,1,,1,"(4.815061,-75.736532)"
2022,Junio,Belice,84,2,0,,2,"(6.171601,-75.427454)"
2022,Junio,Benín,204,0,1,,1,"(10.445761,-75.516429)"
2022,Junio,Benín,204,3,7,,10,"(4.697144,-74.140516)"
2022,Junio,Bermudas/Territorio Británico de Ultramar,60,3,2,,5,"(4.697144,-74.140516)"
2022,Junio,Bermudas/Territorio Británico de Ultramar,60,1,0,,1,"(4.815061,-75.736532)"
2022,Junio,Bolivia,68,4,4,,8,"(0.814836,-77.662532)"
2022,Junio,Bolivia,68,1,5,,6,"(10.445761,-75.516429)"
2022,Junio,Bolivia,68,2,2,,4,"(10.886611,-74.776708)"
2022,Junio,Bolivia,68,6,13,,19,"(3.541112,-76.384584)"
2022,Junio,Bolivia,68,418,564,,982,"(4.697144,-74.140516)"
2022,Junio,Bolivia,68,4,4,,8,"(4.815061,-75.736532)"
2022,Junio,Bolivia,68,9,24,,33,"(6.171601,-75.427454)"
2022,Junio,Bosnia y Herzegovina,70,2,0,,2,"(10.445761,-75.516429)"
2022,Junio,Bosnia y Herzegovina,70,14,7,,21,"(4.697144,-74.140516)"
2022,Junio,Brasil,76,237,479,,716,"(-4.197703,-69.941278)"
2022,Junio,Brasil,76,1,2,,3,"(0.814836,-77.662532)"
2022,Junio,Brasil,76,5,12,,17,"(10.445761,-75.516429)"
2022,Junio,Brasil,76,20,26,,46,"(10.886611,-74.776708)"
2022,Junio,Brasil,76,0,1,,1,"(11.117806,-74.232622)"
2022,Junio,Brasil,76,83,95,,178,"(3.541112,-76.384584)"
2022,Junio,Brasil,76,0,1,,1,"(3.866713,-67.927521)"
2022,Junio,Brasil,76,30,34,,64,"(4.452882,-75.766298)"
2022,Junio,Brasil,76,2347,2809,,5156,"(4.697144,-74.140516)"
2022,Junio,Brasil,76,6,16,,22,"(4.815061,-75.736532)"
2022,Junio,Brasil,76,319,324,,643,"(6.171601,-75.427454)"
2022,Junio,Brasil,76,3,2,,5,"(7.128456,-73.183637)"
2022,Junio,Brasil,76,9,16,,25,"(7.927209,-72.507910)"
2022,Junio,Brunei Darussalam,96,1,0,,1,"(4.697144,-74.140516)"
2022,Junio,Bulgaria,100,1,1,,2,"(10.886611,-74.776708)"
2022,Junio,Bulgaria,100,1,1,,2,"(3.541112,-76.384584)"
2022,Junio,Bulgaria,100,8,11,,19,"(4.697144,-74.140516)"
2022,Junio,Bulgaria,100,0,4,,4,"(6.171601,-75.427454)"
2022,Junio,Burkina Faso,854,0,1,,1,"(10.886611,-74.776708)"
2022,Junio,Cabo Verde,132,0,1,,1,"(6.171601,-75.427454)"
2022,Junio,Islas Caimán/Territorio Británico de Ultramar,136,2,0,,2,"(10.445761,-75.516429)"
2022,Junio,Islas Caimán/Territorio Británico de Ultramar,136,2,1,,3,"(12.586067,-81.702563)"
2022,Junio,Islas Caimán/Territorio Británico de Ultramar,136,2,7,,9,"(4.697144,-74.140516)"
2022,Junio,Islas Caimán/Territorio Británico de Ultramar,136,0,3,,3,"(6.171601,-75.427454)"
2022,Junio,Camboya,116,2,1,,3,"(4.697144,-74.140516)"
2022,Junio,Canadá,124,67,39,,106,"(10.445761,-75.516429)"
2022,Junio,Canadá,124,43,41,,84,"(10.886611,-74.776708)"
2022,Junio,Canadá,124,3,3,,6,"(11.117806,-74.232622)"
2022,Junio,Canadá,124,0,2,,2,"(12.586067,-81.702563)"
2022,Junio,Canadá,124,117,88,,205,"(3.541112,-76.384584)"
2022,Junio,Canadá,124,7,7,,14,"(4.452882,-75.766298)"
2022,Junio,Canadá,124,4565,3399,,7964,"(4.697144,-74.140516)"
2022,Junio,Canadá,124,21,9,,30,"(4.815061,-75.736532)"
2022,Junio,Canadá,124,371,256,,627,"(6.171601,-75.427454)"
2022,Junio,Canadá,124,2,1,,3,"(7.128456,-73.183637)"
2022,Junio,Canadá,124,3,4,,7,"(7.927209,-72.507910)"
2022,Junio,Chad,148,0,1,,1,"(4.697144,-74.140516)"
2022,Junio,España,724,0,1,,1,"(0.814836,-77.662532)"
2022,Junio,España,724,116,109,,225,"(10.445761,-75.516429)"
2022,Junio,España,724,47,38,,85,"(10.886611,-74.776708)"
2022,Junio,España,724,2921,2103,,5024,"(3.541112,-76.384584)"
2022,Junio,España,724,11,8,,19,"(4.452882,-75.766298)"
2022,Junio,España,724,24602,18624,,43226,"(4.697144,-74.140516)"
2022,Junio,España,724,27,35,,62,"(4.815061,-75.736532)"
2022,Junio,España,724,3631,2772,,6403,"(6.171601,-75.427454)"
2022,Junio,España,724,4,4,,8,"(7.128456,-73.183637)"
2022,Junio,Colombia,170,1,0,,1,"(10.445761,-75.516429)"
2022,Junio,Colombia,170,34,97,,131,"(4.697144,-74.140516)"
2022,Junio,República Del Congo,178,0,2,,2,"(4.697144,-74.140516)"
2022,Junio,Comoras,174,1,0,,1,"(4.697144,-74.140516)"
2022,Junio,Isla Bouvet,74,0,1,,1,"(3.541112,-76.384584)"
2022,Junio,República Democrática del Congo,180,3,0,,3,"(4.697144,-74.140516)"
2022,Junio,República de Corea,410,1,0,,1,"(10.886611,-74.776708)"
2022,Junio,República de Corea,410,1,0,,1,"(3.541112,-76.384584)"
2022,Junio,República de Corea,410,37,43,,80,"(4.697144,-74.140516)"
2022,Junio,República de Corea,410,1,3,,4,"(6.171601,-75.427454)"
2022,Junio,Costa de Marfil,384,0,1,,1,"(10.445761,-75.516429)"
2022,Junio,Costa de Marfil,384,1,8,,9,"(4.697144,-74.140516)"
2022,Junio,Costa de Marfil,384,2,2,,4,"(6.171601,-75.427454)"
2022,Junio,Costa Rica,188,66,72,,138,"(10.445761,-75.516429)"
2022,Junio,Costa Rica,188,8,11,,19,"(10.886611,-74.776708)"
2022,Junio,Costa Rica,188,3,21,,24,"(12.5744111,-81.703935)"
2022,Junio,Costa Rica,188,1,0,,1,"(12.586067,-81.702563)"
2022,Junio,Costa Rica,188,38,44,,82,"(3.541112,-76.384584)"
2022,Junio,Costa Rica,188,0,1,,1,"(4.452882,-75.766298)"
2022,Junio,Costa Rica,188,1298,1414,,2712,"(4.697144,-74.140516)"
2022,Junio,Costa Rica,188,2,1,,3,"(4.815061,-75.736532)"
2022,Junio,Costa Rica,188,271,273,,544,"(6.171601,-75.427454)"
2022,Junio,Costa Rica,188,0,1,,1,"(7.128456,-73.183637)"
2022,Junio,Croacia,191,2,0,,2,"(10.445761,-75.516429)"
2022,Junio,Croacia,191,3,1,,4,"(3.541112,-76.384584)"
2022,Junio,Croacia,191,44,39,,83,"(4.697144,-74.140516)"
2022,Junio,Croacia,191,6,1,,7,"(6.171601,-75.427454)"
2022,Junio,Cuba,192,3,7,,10,"(10.445761,-75.516429)"
2022,Junio,Cuba,192,9,6,,15,"(10.886611,-74.776708)"
2022,Junio,Cuba,192,18,18,,36,"(3.541112,-76.384584)"
2022,Junio,Cuba,192,0,1,,1,"(4.452882,-75.766298)"
2022,Junio,Cuba,192,1071,1054,,2125,"(4.697144,-74.140516)"
2022,Junio,Cuba,192,2,2,,4,"(4.815061,-75.736532)"
2022,Junio,Cuba,192,47,44,,91,"(6.171601,-75.427454)"
2022,Junio,Cuba,192,6,2,,8,"(7.128456,-73.183637)"
2022,Junio,Cuba,192,1,0,,1,"(7.927209,-72.507910)"
2022,Junio,Curazao,99999,0,1,,1,"(10.445761,-75.516429)"
2022,Junio,Curazao,99999,61,45,,106,"(10.886611,-74.776708)"
2022,Junio,Curazao,99999,69,43,,112,"(3.541112,-76.384584)"
2022,Junio,Curazao,99999,1608,1379,,2987,"(4.697144,-74.140516)"
2022,Junio,Curazao,99999,6,3,,9,"(4.815061,-75.736532)"
2022,Junio,Curazao,99999,200,164,,364,"(6.171601,-75.427454)"
2022,Junio,República Checa,203,4,3,,7,"(10.445761,-75.516429)"
2022,Junio,República Checa,203,0,2,,2,"(10.886611,-74.776708)"
2022,Junio,República Checa,203,37,33,,70,"(4.697144,-74.140516)"
2022,Junio,República Checa,203,4,6,,10,"(6.171601,-75.427454)"
2022,Junio,Chile,152,0,1,,1,"(0.25129,-76.875963)"
2022,Junio,Chile,152,53,58,,111,"(0.814836,-77.662532)"
2022,Junio,Chile,152,12,8,,20,"(10.445761,-75.516429)"
2022,Junio,Chile,152,36,9,,45,"(10.886611,-74.776708)"
2022,Junio,Chile,152,2,2,,4,"(12.586067,-81.702563)"
2022,Junio,Chile,152,2199,1521,,3720,"(3.541112,-76.384584)"
2022,Junio,Chile,152,18,14,,32,"(4.452882,-75.766298)"
2022,Junio,Chile,152,4483,3817,,8301,"(4.697144,-74.140516)"
2022,Junio,Chile,152,10,10,,20,"(4.815061,-75.736532)"
2022,Junio,Chile,152,397,305,,702,"(6.171601,-75.427454)"
2022,Junio,Chile,152,3,3,,6,"(7.128456,-73.183637)"
2022,Junio,Chile,152,0,1,,1,"(7.818934,-72.453226)"
2022,Junio,Chile,152,8,6,,14,"(7.927209,-72.507910)"
2022,Junio,China,156,3,2,,5,"(4.697144,-74.140516)"
2022,Junio,Chipre,196,7,9,,16,"(4.697144,-74.140516)"
2022,Junio,Dinamarca,208,11,5,,16,"(10.445761,-75.516429)"
2022,Junio,Dinamarca,208,1,0,,1,"(10.886611,-74.776708)"
2022,Junio,Dinamarca,208,12,6,,18,"(3.541112,-76.384584)"
2022,Junio,Dinamarca,208,103,80,,183,"(4.697144,-74.140516)"
2022,Junio,Dinamarca,208,18,7,,25,"(6.171601,-75.427454)"
2022,Junio,Dominica,212,5,4,,9,"(4.697144,-74.140516)"
2022,Junio,Dominica,212,4,3,,7,"(6.171601,-75.427454)"
2022,Junio,Ecuador,218,161,220,,381,"(0.25129,-76.875963)"
2022,Junio,Ecuador,218,2,4,,6,"(0.812436,-77.847006)"
2022,Junio,Ecuador,218,2066,2667,,4733,"(0.814836,-77.662532)"
2022,Junio,Ecuador,218,0,1,,1,"(1.813928,-78.763924)"
2022,Junio,Ecuador,218,8,26,,34,"(10.445761,-75.516429)"
2022,Junio,Ecuador,218,10,18,,28,"(10.886611,-74.776708)"
2022,Junio,Ecuador,218,0,1,,1,"(12.586067,-81.702563)"
2022,Junio,Ecuador,218,108,131,,239,"(3.541112,-76.384584)"
2022,Junio,Ecuador,218,2769,3436,,6205,"(4.697144,-74.140516)"
2022,Junio,Ecuador,218,3,4,,7,"(4.815061,-75.736532)"
2022,Junio,Ecuador,218,154,171,,325,"(6.171601,-75.427454)"
2022,Junio,Ecuador,218,1,0,,1,"(7.128456,-73.183637)"
2022,Junio,Ecuador,218,1,0,,1,"(7.927209,-72.507910)"
2022,Junio,Egipto,818,0,1,,1,"(3.541112,-76.384584)"
2022,Junio,Egipto,818,60,44,,104,"(4.697144,-74.140516)"
2022,Junio,Egipto,818,8,3,,11,"(6.171601,-75.427454)"
2022,Junio,El Salvador,222,3,8,,11,"(10.445761,-75.516429)"
2022,Junio,El Salvador,222,3,10,,13,"(10.886611,-74.776708)"
2022,Junio,El Salvador,222,18,13,,31,"(3.541112,-76.384584)"
2022,Junio,El Salvador,222,479,579,,1058,"(4.697144,-74.140516)"
2022,Junio,El Salvador,222,2,0,,2,"(4.815061,-75.736532)"
2022,Junio,El Salvador,222,35,51,,86,"(6.171601,-75.427454)"
2022,Junio,El Salvador,222,0,2,,2,"(7.128456,-73.183637)"
2022,Junio,Emiratos Árabes,784,6,6,,12,"(10.445761,-75.516429)"
2022,Junio,Emiratos Árabes,784,1,0,,1,"(10.886611,-74.776708)"
2022,Junio,Emiratos Árabes,784,9,8,,17,"(3.541112,-76.384584)"
2022,Junio,Emiratos Árabes,784,195,263,,458,"(4.697144,-74.140516)"
2022,Junio,Emiratos Árabes,784,15,16,,31,"(6.171601,-75.427454)"
2022,Junio,Eslovaquia,703,0,1,,1,"(3.541112,-76.384584)"
2022,Junio,Eslovaquia,703,3,10,,13,"(4.697144,-74.140516)"
2022,Junio,Eslovaquia,703,0,1,,1,"(6.171601,-75.427454)"
2022,Junio,Eslovenia,705,1,1,,2,"(3.541112,-76.384584)"
2022,Junio,Eslovenia,705,6,4,,10,"(4.697144,-74.140516)"
2022,Junio,Eslovenia,705,1,0,,1,"(6.171601,-75.427454)"
2022,Junio,Estados Unidos de América,840,1,0,,1,"(10.408582,-75.538003)"
2022,Junio,Estados Unidos de América,840,4006,3101,,7107,"(10.445761,-75.516429)"
2022,Junio,Estados Unidos de América,840,4666,3592,,8258,"(10.886611,-74.776708)"
2022,Junio,Estados Unidos de América,840,7,17,,24,"(11.117806,-74.232622)"
2022,Junio,Estados Unidos de América,840,163,122,,285,"(12.586067,-81.702563)"
2022,Junio,Estados Unidos de América,840,11779,8625,,20404,"(3.541112,-76.384584)"
2022,Junio,Estados Unidos de América,840,1543,1165,,2708,"(4.452882,-75.766298)"
2022,Junio,Estados Unidos de América,840,43175,35919,,79095,"(4.697144,-74.140516)"
2022,Junio,Estados Unidos de América,840,2169,1492,,3661,"(4.815061,-75.736532)"
2022,Junio,Estados Unidos de América,840,18934,14808,,33742,"(6.171601,-75.427454)"
2022,Junio,Estados Unidos de América,840,1199,863,,2062,"(7.128456,-73.183637)"
2022,Junio,Estados Unidos de América,840,204,126,,330,"(7.927209,-72.507910)"
2022,Junio,Estonia,233,3,3,,6,"(10.445761,-75.516429)"
2022,Junio,Estonia,233,0,2,,2,"(10.886611,-74.776708)"
2022,Junio,Estonia,233,3,0,,3,"(3.541112,-76.384584)"
2022,Junio,Estonia,233,7,8,,15,"(4.697144,-74.140516)"
2022,Junio,Estonia,233,1,2,,3,"(6.171601,-75.427454)"
2022,Junio,Etiopia,231,1,4,,5,"(4.697144,-74.140516)"
2022,Junio,Islas Fiji,242,3,1,,4,"(4.697144,-74.140516)"
2022,Junio,Filipinas,608,7,2,,9,"(4.697144,-74.140516)"
2022,Junio,Finlandia,246,2,5,,7,"(10.445761,-75.516429)"
2022,Junio,Finlandia,246,0,1,,1,"(10.886611,-74.776708)"
2022,Junio,Finlandia,246,3,2,,5,"(3.541112,-76.384584)"
2022,Junio,Finlandia,246,37,30,,67,"(4.697144,-74.140516)"
2022,Junio,Finlandia,246,2,4,,6,"(6.171601,-75.427454)"
2022,Junio,Francia,250,46,29,,75,"(10.445761,-75.516429)"
2022,Junio,Francia,250,2,2,,4,"(10.886611,-74.776708)"
2022,Junio,Francia,250,104,57,,161,"(3.541112,-76.384584)"
2022,Junio,Francia,250,2,5,,7,"(4.452882,-75.766298)"
2022,Junio,Francia,250,3428,2495,,5923,"(4.697144,-74.140516)"
2022,Junio,Francia,250,2,2,,4,"(4.815061,-75.736532)"
2022,Junio,Francia,250,203,136,,339,"(6.171601,-75.427454)"
2022,Junio,Gabón,266,0,5,,5,"(4.697144,-74.140516)"
2022,Junio,Gambia,270,1,0,,1,"(4.697144,-74.140516)"
2022,Junio,Georgia,268,3,3,,6,"(10.445761,-75.516429)"
2022,Junio,Georgia,268,1,5,,6,"(3.541112,-76.384584)"
2022,Junio,Georgia,268,13,13,,26,"(4.697144,-74.140516)"
2022,Junio,Georgia,268,2,1,,3,"(6.171601,-75.427454)"
2022,Junio,Ghana,288,0,1,,1,"(10.886611,-74.776708)"
2022,Junio,Ghana,288,3,9,,12,"(4.697144,-74.140516)"
2022,Junio,Grecia,300,7,5,,12,"(10.445761,-75.516429)"
2022,Junio,Grecia,300,3,2,,5,"(3.541112,-76.384584)"
2022,Junio,Grecia,300,150,131,,281,"(4.697144,-74.140516)"
2022,Junio,Grecia,300,1,0,,1,"(4.815061,-75.736532)"
2022,Junio,Grecia,300,16,10,,26,"(6.171601,-75.427454)"
2022,Junio,Guatemala,320,4,19,,23,"(10.445761,-75.516429)"
2022,Junio,Guatemala,320,12,15,,27,"(10.886611,-74.776708)"
2022,Junio,Guatemala,320,41,71,,112,"(3.541112,-76.384584)"
2022,Junio,Guatemala,320,4,0,,4,"(4.452882,-75.766298)"
2022,Junio,Guatemala,320,694,843,,1537,"(4.697144,-74.140516)"
2022,Junio,Guatemala,320,5,3,,8,"(4.815061,-75.736532)"
2022,Junio,Guatemala,320,92,91,,183,"(6.171601,-75.427454)"
2022,Junio,Guatemala,320,2,4,,6,"(7.128456,-73.183637)"
2022,Junio,Guatemala,320,2,2,,4,"(7.927209,-72.507910)"
2022,Junio,Guyana,328,0,2,,2,"(10.445761,-75.516429)"
2022,Junio,Guyana,328,2,3,,5,"(10.886611,-74.776708)"
2022,Junio,Guyana,328,8,15,,23,"(4.697144,-74.140516)"
2022,Junio,Guyana,328,0,2,,2,"(4.815061,-75.736532)"
2022,Junio,Guyana,328,4,7,,11,"(6.171601,-75.427454)"
2022,Junio,Guyana,328,0,1,,1,"(7.927209,-72.507910)"
2022,Junio,Guinea Ecuatorial,226,1,1,,2,"(4.697144,-74.140516)"
2022,Junio,Guadalupe/Territorio Francés,312,1,0,,1,"(10.445761,-75.516429)"
2022,Junio,Guadalupe/Territorio Francés,312,1,0,,1,"(3.541112,-76.384584)"
2022,Junio,Guadalupe/Territorio Francés,312,2,1,,3,"(4.697144,-74.140516)"
2022,Junio,Guam/Territorio no incorporado de Estados Unidos,316,0,1,,1,"(10.886611,-74.776708)"
2022,Junio,Guayana Francesa/Departamento de Ultramar Francés,254,0,2,,2,"(10.445761,-75.516429)"
2022,Junio,Guayana Francesa/Departamento de Ultramar Francés,254,0,1,,1,"(3.541112,-76.384584)"
2022,Junio,Guayana Francesa/Departamento de Ultramar Francés,254,2,2,,4,"(4.697144,-74.140516)"
2022,Junio,Haití,332,1,2,,3,"(10.886611,-74.776708)"
2022,Junio,Haití,332,0,1,,1,"(3.541112,-76.384584)"
2022,Junio,Haití,332,3,6,,9,"(4.697144,-74.140516)"
2022,Junio,Haití,332,0,2,,2,"(6.171601,-75.427454)"
2022,Junio,Honduras,340,3,7,,10,"(10.445761,-75.516429)"
2022,Junio,Honduras,340,9,9,,18,"(10.886611,-74.776708)"
2022,Junio,Honduras,340,0,1,,1,"(12.586067,-81.702563)"
2022,Junio,Honduras,340,15,32,,47,"(3.541112,-76.384584)"
2022,Junio,Honduras,340,66,149,,215,"(4.697144,-74.140516)"
2022,Junio,Honduras,340,4,4,,8,"(4.815061,-75.736532)"
2022,Junio,Honduras,340,40,56,,96,"(6.171601,-75.427454)"
2022,Junio,Honduras,340,3,7,,10,"(7.128456,-73.183637)"
2022,Junio,Honduras,340,1,1,,2,"(7.927209,-72.507910)"
2022,Junio,Hong Kong,344,0,2,,2,"(4.697144,-74.140516)"
2022,Junio,Hungría,348,5,9,,14,"(3.541112,-76.384584)"
2022,Junio,Hungría,348,20,16,,36,"(4.697144,-74.140516)"
2022,Junio,Hungría,348,17,3,,20,"(6.171601,-75.427454)"
2022,Junio,India,356,2,0,,2,"(3.541112,-76.384584)"
2022,Junio,India,356,20,21,,41,"(4.697144,-74.140516)"
2022,Junio,India,356,0,3,,3,"(6.171601,-75.427454)"
2022,Junio,Indonesia,360,0,2,,2,"(10.445761,-75.516429)"
2022,Junio,Indonesia,360,13,15,,28,"(4.697144,-74.140516)"
2022,Junio,Iraq,368,0,7,,7,"(4.697144,-74.140516)"
2022,Junio,Irán,364,3,1,,4,"(4.697144,-74.140516)"
2022,Junio,República de Irlanda,372,5,4,,9,"(10.445761,-75.516429)"
2022,Junio,República de Irlanda,372,1,0,,1,"(10.886611,-74.776708)"
2022,Junio,República de Irlanda,372,1,0,,1,"(11.117806,-74.232622)"
2022,Junio,República de Irlanda,372,4,1,,5,"(3.541112,-76.384584)"
2022,Junio,República de Irlanda,372,36,46,,82,"(4.697144,-74.140516)"
2022,Junio,República de Irlanda,372,7,6,,13,"(6.171601,-75.427454)"
2022,Junio,Islandia,352,1,0,,1,"(10.445761,-75.516429)"
2022,Junio,Islandia,352,1,0,,1,"(10.886611,-74.776708)"
2022,Junio,Islandia,352,1,1,,2,"(3.541112,-76.384584)"
2022,Junio,Islandia,352,18,19,,37,"(4.697144,-74.140516)"
2022,Junio,Islandia,352,4,4,,8,"(6.171601,-75.427454)"
2022,Junio,Isla de Man,833,2,0,,2,"(4.697144,-74.140516)"
2022,Junio,Islas Pitcairn/Territorio Británico de Ultramar,612,1,0,,1,"(4.697144,-74.140516)"
2022,Junio,Israel,376,2,2,,4,"(10.445761,-75.516429)"
2022,Junio,Israel,376,1,3,,4,"(10.886611,-74.776708)"
2022,Junio,Israel,376,15,3,,18,"(3.541112,-76.384584)"
2022,Junio,Israel,376,1,1,,2,"(4.452882,-75.766298)"
2022,Junio,Israel,376,279,194,,473,"(4.697144,-74.140516)"
2022,Junio,Israel,376,0,1,,1,"(4.815061,-75.736532)"
2022,Junio,Israel,376,26,33,,59,"(6.171601,-75.427454)"
2022,Junio,Italia,380,4,0,,4,"(0.814836,-77.662532)"
2022,Junio,Italia,380,91,53,,144,"(10.445761,-75.516429)"
2022,Junio,Italia,380,10,6,,16,"(10.886611,-74.776708)"
2022,Junio,Italia,380,1,1,,2,"(11.117806,-74.232622)"
2022,Junio,Italia,380,138,64,,202,"(3.541112,-76.384584)"
2022,Junio,Italia,380,2,0,,2,"(4.452882,-75.766298)"
2022,Junio,Italia,380,1545,1006,,2551,"(4.697144,-74.140516)"
2022,Junio,Italia,380,1,1,,2,"(4.815061,-75.736532)"
2022,Junio,Italia,380,222,148,,370,"(6.171601,-75.427454)"
2022,Junio,Italia,380,2,0,,2,"(7.128456,-73.183637)"
2022,Junio,Jamaica,388,8,10,,18,"(10.445761,-75.516429)"
2022,Junio,Jamaica,388,8,6,,14,"(10.886611,-74.776708)"
2022,Junio,Jamaica,388,20,13,,33,"(3.541112,-76.384584)"
2022,Junio,Jamaica,388,50,51,,101,"(4.697144,-74.140516)"
2022,Junio,Jamaica,388,1,1,,2,"(4.815061,-75.736532)"
2022,Junio,Jamaica,388,38,31,,69,"(6.171601,-75.427454)"
2022,Junio,Japón,392,1,0,,1,"(10.445761,-75.516429)"
2022,Junio,Japón,392,2,0,,2,"(3.541112,-76.384584)"
2022,Junio,Japón,392,19,13,,32,"(4.697144,-74.140516)"
2022,Junio,Japón,392,1,1,,2,"(4.815061,-75.736532)"
2022,Junio,Japón,392,2,0,,2,"(6.171601,-75.427454)"
2022,Junio,Jordania,400,2,1,,3,"(3.541112,-76.384584)"
2022,Junio,Jordania,400,4,2,,6,"(4.697144,-74.140516)"
2022,Junio,Jordania,400,1,0,,1,"(6.171601,-75.427454)"
2022,Junio,Kazajistán,398,0,6,,6,"(4.697144,-74.140516)"
2022,Junio,Kenia,404,1,1,,2,"(3.541112,-76.384584)"
2022,Junio,Kenia,404,20,17,,37,"(4.697144,-74.140516)"
2022,Junio,Kenia,404,2,2,,4,"(6.171601,-75.427454)"
2022,Junio,Kirguistán,417,2,0,,2,"(4.697144,-74.140516)"
2022,Junio,Kuwait,414,0,5,,5,"(4.697144,-74.140516)"
2022,Junio,Kuwait,414,0,1,,1,"(6.171601,-75.427454)"
2022,Junio,Letonia,428,1,0,,1,"(10.445761,-75.516429)"
2022,Junio,Letonia,428,2,8,,10,"(4.697144,-74.140516)"
2022,Junio,Lituania,440,0,2,,2,"(3.541112,-76.384584)"
2022,Junio,Lituania,440,3,2,,5,"(4.697144,-74.140516)"
2022,Junio,Líbano,422,5,5,,10,"(10.445761,-75.516429)"
2022,Junio,Líbano,422,6,3,,9,"(10.886611,-74.776708)"
2022,Junio,Líbano,422,4,0,,4,"(3.541112,-76.384584)"
2022,Junio,Líbano,422,22,27,,49,"(4.697144,-74.140516)"
2022,Junio,Líbano,422,5,2,,7,"(6.171601,-75.427454)"
2022,Junio,Liberia,430,3,1,,4,"(4.697144,-74.140516)"
2022,Junio,Liberia,430,0,1,,1,"(6.171601,-75.427454)"
2022,Junio,Luxemburgo,442,3,1,,4,"(10.445761,-75.516429)"
2022,Junio,Luxemburgo,442,2,0,,2,"(10.886611,-74.776708)"
2022,Junio,Luxemburgo,442,1,0,,1,"(3.541112,-76.384584)"
2022,Junio,Luxemburgo,442,23,17,,40,"(4.697144,-74.140516)"
2022,Junio,Luxemburgo,442,3,1,,4,"(6.171601,-75.427454)"
2022,Junio,Macao,446,0,1,,1,"(6.171601,-75.427454)"
2022,Junio,Macedonia,807,0,1,,1,"(4.697144,-74.140516)"
2022,Junio,Malasia,458,0,1,,1,"(10.445761,-75.516429)"
2022,Junio,Malasia,458,1,2,,3,"(4.697144,-74.140516)"
2022,Junio,Malawi,454,0,1,,1,"(4.697144,-74.140516)"
2022,Junio,Maldivas,462,0,2,,2,"(4.697144,-74.140516)"
2022,Junio,Malí,466,3,2,,5,"(4.697144,-74.140516)"
2022,Junio,Malta,470,12,12,,24,"(10.445761,-75.516429)"
2022,Junio,Malta,470,0,4,,4,"(3.541112,-76.384584)"
2022,Junio,Malta,470,162,126,,288,"(4.697144,-74.140516)"
2022,Junio,Malta,470,5,2,,7,"(6.171601,-75.427454)"
2022,Junio,Marruecos,504,2,3,,5,"(3.541112,-76.384584)"
2022,Junio,Marruecos,504,29,18,,47,"(4.697144,-74.140516)"
2022,Junio,Marruecos,504,1,0,,1,"(4.815061,-75.736532)"
2022,Junio,Marruecos,504,6,6,,12,"(6.171601,-75.427454)"
2022,Junio,Mauricio,480,1,1,,2,"(4.697144,-74.140516)"
2022,Junio,Mauricio,480,0,1,,1,"(6.171601,-75.427454)"
2022,Junio,Mauritania,478,0,2,,2,"(4.697144,-74.140516)"
2022,Junio,Martinica/Departamento de Ultramar Francés,474,1,2,,3,"(4.697144,-74.140516)"
2022,Junio,México,484,0,1,,1,"(0.814836,-77.662532)"
2022,Junio,México,484,362,280,,642,"(10.445761,-75.516429)"
2022,Junio,México,484,409,367,,776,"(10.886611,-74.776708)"
2022,Junio,México,484,5,8,,13,"(11.117806,-74.232622)"
2022,Junio,México,484,1,1,,2,"(12.586067,-81.702563)"
2022,Junio,México,484,4226,3617,,7843,"(3.541112,-76.384584)"
2022,Junio,México,484,23,17,,40,"(4.452882,-75.766298)"
2022,Junio,México,484,25492,23721,,49214,"(4.697144,-74.140516)"
2022,Junio,México,484,182,143,,325,"(4.815061,-75.736532)"
2022,Junio,México,484,2,1,,3,"(6.17134,-75.427194)"
2022,Junio,México,484,9915,8593,,18508,"(6.171601,-75.427454)"
2022,Junio,México,484,126,111,,237,"(7.128456,-73.183637)"
2022,Junio,México,484,44,45,,89,"(7.927209,-72.507910)"
2022,Junio,Mayotte/Colectividad Territorial Francesa,175,1,1,,2,"(4.697144,-74.140516)"
2022,Junio,Mayotte/Colectividad Territorial Francesa,175,1,0,,1,"(6.171601,-75.427454)"
2022,Junio,Mónaco,492,1,0,,1,"(4.697144,-74.140516)"
2022,Junio,Mongolia,496,0,1,,1,"(4.697144,-74.140516)"
2022,Junio,Mongolia,496,0,1,,1,"(6.171601,-75.427454)"
2022,Junio,Montenegro,499,1,1,,2,"(4.697144,-74.140516)"
2022,Junio,Micronesia,583,0,1,,1,"(4.697144,-74.140516)"
2022,Junio,Mozambique,508,1,0,,1,"(3.541112,-76.384584)"
2022,Junio,Nicaragua,558,0,2,,2,"(10.445761,-75.516429)"
2022,Junio,Nicaragua,558,0,1,,1,"(10.886611,-74.776708)"
2022,Junio,Nicaragua,558,7,6,,13,"(3.541112,-76.384584)"
2022,Junio,Nicaragua,558,21,59,,80,"(4.697144,-74.140516)"
2022,Junio,Nicaragua,558,4,0,,4,"(4.815061,-75.736532)"
2022,Junio,Nicaragua,558,5,22,,27,"(6.171601,-75.427454)"
2022,Junio,Nicaragua,558,2,3,,5,"(7.128456,-73.183637)"
2022,Junio,Nigeria,566,1,0,,1,"(10.445761,-75.516429)"
2022,Junio,Nigeria,566,1,2,,3,"(3.541112,-76.384584)"
2022,Junio,Nigeria,566,1,2,,3,"(4.697144,-74.140516)"
2022,Junio,Noruega,578,1,8,,9,"(10.445761,-75.516429)"
2022,Junio,Noruega,578,1,1,,2,"(10.886611,-74.776708)"
2022,Junio,Noruega,578,11,8,,19,"(3.541112,-76.384584)"
2022,Junio,Noruega,578,1,1,,2,"(4.452882,-75.766298)"
2022,Junio,Noruega,578,79,65,,144,"(4.697144,-74.140516)"
2022,Junio,Noruega,578,14,6,,20,"(6.171601,-75.427454)"
2022,Junio,Nueva Zelanda,554,1,1,,2,"(3.541112,-76.384584)"
2022,Junio,Nueva Zelanda,554,18,19,,37,"(4.697144,-74.140516)"
2022,Junio,Nueva Zelanda,554,3,0,,3,"(6.171601,-75.427454)"
2022,Junio,Omán,512,6,11,,17,"(4.697144,-74.140516)"
2022,Junio,Papúa Nueva Guinea,598,1,2,,3,"(4.697144,-74.140516)"
2022,Junio,Papúa Nueva Guinea,598,1,0,,1,"(6.171601,-75.427454)"
2022,Junio,Pakistán,586,0,1,,1,"(4.697144,-74.140516)"
2022,Junio,Palau,585,1,0,,1,"(6.171601,-75.427454)"
2022,Junio,Panamá,591,21,60,,81,"(10.408582,-75.538003)"
2022,Junio,Panamá,591,1500,1192,,2693,"(10.445761,-75.516429)"
2022,Junio,Panamá,591,635,656,,1291,"(10.886611,-74.776708)"
2022,Junio,Panamá,591,7,8,,15,"(11.117806,-74.232622)"
2022,Junio,Panamá,591,1,4,,5,"(11.247723,-74.213989)"
2022,Junio,Panamá,591,2,19,,21,"(12.5744111,-81.703935)"
2022,Junio,Panamá,591,15,17,,32,"(12.586067,-81.702563)"
2022,Junio,Panamá,591,2657,2124,,4781,"(3.541112,-76.384584)"
2022,Junio,Panamá,591,112,58,,170,"(4.452882,-75.766298)"
2022,Junio,Panamá,591,9356,8846,,18202,"(4.697144,-74.140516)"
2022,Junio,Panamá,591,211,149,,360,"(4.815061,-75.736532)"
2022,Junio,Panamá,591,3659,3301,,6960,"(6.171601,-75.427454)"
2022,Junio,Panamá,591,1,1,,2,"(6.228046,-77.404104)"
2022,Junio,Panamá,591,8,14,,22,"(7.102626,-77.762647)"
2022,Junio,Panamá,591,124,117,,241,"(7.128456,-73.183637)"
2022,Junio,Panamá,591,91,70,,161,"(7.927209,-72.507910)"
2022,Junio,Panamá,591,53,65,,118,"(8.635765,-77.346578)"
2022,Junio,Paraguay,600,2,5,,7,"(10.445761,-75.516429)"
2022,Junio,Paraguay,600,7,2,,9,"(10.886611,-74.776708)"
2022,Junio,Paraguay,600,35,61,,96,"(3.541112,-76.384584)"
2022,Junio,Paraguay,600,1,1,,2,"(4.452882,-75.766298)"
2022,Junio,Paraguay,600,229,287,,516,"(4.697144,-74.140516)"
2022,Junio,Paraguay,600,3,1,,4,"(4.815061,-75.736532)"
2022,Junio,Paraguay,600,17,36,,53,"(6.171601,-75.427454)"
2022,Junio,Paraguay,600,1,1,,2,"(7.128456,-73.183637)"
2022,Junio,Perú,604,6,4,,10,"(-0.193180,-74.784874)"
2022,Junio,Perú,604,0,1,,1,"(-3.790089,-70.356599)"
2022,Junio,Perú,604,313,367,,680,"(-4.197703,-69.941278)"
2022,Junio,Perú,604,0,2,,2,"(0.25129,-76.875963)"
2022,Junio,Perú,604,50,94,,144,"(0.814836,-77.662532)"
2022,Junio,Perú,604,37,31,,68,"(10.445761,-75.516429)"
2022,Junio,Perú,604,14,24,,38,"(10.886611,-74.776708)"
2022,Junio,Perú,604,24,33,,57,"(3.541112,-76.384584)"
2022,Junio,Perú,604,2,2,,4,"(4.452882,-75.766298)"
2022,Junio,Perú,604,5897,5742,,11639,"(4.697144,-74.140516)"
2022,Junio,Perú,604,8,5,,13,"(4.815061,-75.736532)"
2022,Junio,Perú,604,931,756,,1687,"(6.171601,-75.427454)"
2022,Junio,Perú,604,3,4,,7,"(7.128456,-73.183637)"
2022,Junio,Perú,604,1,2,,3,"(7.927209,-72.507910)"
2022,Junio,Palestina,99999,1,0,,1,"(4.697144,-74.140516)"
2022,Junio,Palestina,99999,1,0,,1,"(6.171601,-75.427454)"
2022,Junio,Polonia,616,4,3,,7,"(10.445761,-75.516429)"
2022,Junio,Polonia,616,3,4,,7,"(3.541112,-76.384584)"
2022,Junio,Polonia,616,46,60,,106,"(4.697144,-74.140516)"
2022,Junio,Polonia,616,4,6,,10,"(6.171601,-75.427454)"
2022,Junio,Portugal,620,4,4,,8,"(10.445761,-75.516429)"
2022,Junio,Portugal,620,20,18,,38,"(3.541112,-76.384584)"
2022,Junio,Portugal,620,323,352,,675,"(4.697144,-74.140516)"
2022,Junio,Portugal,620,46,48,,94,"(6.171601,-75.427454)"
2022,Junio,Polinesia Francesa/Colectividad de Ultramar Francesa,258,1,0,,1,"(4.697144,-74.140516)"
2022,Junio,Puerto Rico/Territorio de Estados Unidos,630,3,2,,5,"(10.445761,-75.516429)"
2022,Junio,Puerto Rico/Territorio de Estados Unidos,630,13,15,,28,"(10.886611,-74.776708)"
2022,Junio,Puerto Rico/Territorio de Estados Unidos,630,52,40,,92,"(3.541112,-76.384584)"
2022,Junio,Puerto Rico/Territorio de Estados Unidos,630,519,483,,1002,"(4.697144,-74.140516)"
2022,Junio,Puerto Rico/Territorio de Estados Unidos,630,3,1,,4,"(4.815061,-75.736532)"
2022,Junio,Puerto Rico/Territorio de Estados Unidos,630,63,32,,95,"(6.171601,-75.427454)"
2022,Junio,Puerto Rico/Territorio de Estados Unidos,630,0,1,,1,"(7.128456,-73.183637)"
2022,Junio,Qatar,634,1,1,,2,"(10.445761,-75.516429)"
2022,Junio,Qatar,634,13,26,,39,"(4.697144,-74.140516)"
2022,Junio,Qatar,634,2,3,,5,"(6.171601,-75.427454)"
2022,Junio,Reino Unido de Gran Bretaña e Irlanda del Norte,826,3,5,,8,"(10.445761,-75.516429)"
2022,Junio,Reino Unido de Gran Bretaña e Irlanda del Norte,826,3,4,,7,"(10.886611,-74.776708)"
2022,Junio,Reino Unido de Gran Bretaña e Irlanda del Norte,826,1,0,,1,"(12.586067,-81.702563)"
2022,Junio,Reino Unido de Gran Bretaña e Irlanda del Norte,826,21,19,,40,"(3.541112,-76.384584)"
2022,Junio,Reino Unido de Gran Bretaña e Irlanda del Norte,826,1821,1351,,3172,"(4.697144,-74.140516)"
2022,Junio,Reino Unido de Gran Bretaña e Irlanda del Norte,826,0,1,,1,"(4.815061,-75.736532)"
2022,Junio,Reino Unido de Gran Bretaña e Irlanda del Norte,826,43,23,,66,"(6.171601,-75.427454)"
2022,Junio,República CentroÁfricana,140,2,2,,4,"(4.697144,-74.140516)"
2022,Junio,Federación de Rusia,643,0,2,,2,"(10.445761,-75.516429)"
2022,Junio,Federación de Rusia,643,9,7,,16,"(4.697144,-74.140516)"
2022,Junio,Federación de Rusia,643,0,1,,1,"(6.171601,-75.427454)"
2022,Junio,República Dominicana,214,0,3,,3,"(10.408582,-75.538003)"
2022,Junio,República Dominicana,214,29,29,,58,"(10.445761,-75.516429)"
2022,Junio,República Dominicana,214,44,52,,96,"(10.886611,-74.776708)"
2022,Junio,República Dominicana,214,3,3,,6,"(11.117806,-74.232622)"
2022,Junio,República Dominicana,214,0,1,,1,"(12.586067,-81.702563)"
2022,Junio,República Dominicana,214,448,319,,767,"(3.541112,-76.384584)"
2022,Junio,República Dominicana,214,1,3,,4,"(4.452882,-75.766298)"
2022,Junio,República Dominicana,214,6579,5647,,12227,"(4.697144,-74.140516)"
2022,Junio,República Dominicana,214,24,16,,40,"(4.815061,-75.736532)"
2022,Junio,República Dominicana,214,6128,4601,,10729,"(6.171601,-75.427454)"
2022,Junio,República Dominicana,214,16,12,,28,"(7.128456,-73.183637)"
2022,Junio,República Dominicana,214,0,2,,2,"(7.927209,-72.507910)"
2022,Junio,Reunión,638,0,1,,1,"(4.697144,-74.140516)"
2022,Junio,Rumania,642,0,2,,2,"(10.445761,-75.516429)"
2022,Junio,Rumania,642,3,2,,5,"(3.541112,-76.384584)"
2022,Junio,Rumania,642,13,14,,27,"(4.697144,-74.140516)"
2022,Junio,Rwanda,646,2,2,,4,"(4.697144,-74.140516)"
2022,Junio,San Pedro y Miquelón/territorio de Ultramar de La Unión Europea,666,1,3,,4,"(4.697144,-74.140516)"
2022,Junio,San Cristóbal y Nevis,659,1,0,,1,"(3.541112,-76.384584)"
2022,Junio,San Cristóbal y Nevis,659,0,1,,1,"(4.697144,-74.140516)"
2022,Junio,San Cristóbal y Nevis,659,4,4,,8,"(7.818934,-72.453226)"
2022,Junio,San Marino,674,0,1,,1,"(4.815061,-75.736532)"
2022,Junio,Santa Elena/Territorio Británico de Ultramar,654,1,5,,6,"(0.814836,-77.662532)"
2022,Junio,Santa Lucia,662,0,1,,1,"(4.697144,-74.140516)"
2022,Junio,Santa Sede/Ciudad del Vaticano,336,0,1,,1,"(4.697144,-74.140516)"
2022,Junio,Santo Tomé y Príncipe,678,0,1,,1,"(4.697144,-74.140516)"
2022,Junio,Senegal,686,2,1,,3,"(4.697144,-74.140516)"
2022,Junio,Serbia,688,1,0,,1,"(3.541112,-76.384584)"
2022,Junio,Serbia,688,8,4,,12,"(4.697144,-74.140516)"
2022,Junio,Singapur,702,0,1,,1,"(10.445761,-75.516429)"
2022,Junio,Singapur,702,19,25,,44,"(4.697144,-74.140516)"
2022,Junio,Singapur,702,0,1,,1,"(6.171601,-75.427454)"
2022,Junio,Somalia,706,0,1,,1,"(4.697144,-74.140516)"
2022,Junio,Sudáfrica,710,1,0,,1,"(10.886611,-74.776708)"
2022,Junio,Sudáfrica,710,1,1,,2,"(3.541112,-76.384584)"
2022,Junio,Sudáfrica,710,4,5,,9,"(4.697144,-74.140516)"
2022,Junio,Sudáfrica,710,0,1,,1,"(6.171601,-75.427454)"
2022,Junio,Suecia,752,10,3,,13,"(10.445761,-75.516429)"
2022,Junio,Suecia,752,5,4,,9,"(10.886611,-74.776708)"
2022,Junio,Suecia,752,37,36,,73,"(3.541112,-76.384584)"
2022,Junio,Suecia,752,2,0,,2,"(4.452882,-75.766298)"
2022,Junio,Suecia,752,123,94,,217,"(4.697144,-74.140516)"
2022,Junio,Suecia,752,2,1,,3,"(4.815061,-75.736532)"
2022,Junio,Suecia,752,58,20,,78,"(6.171601,-75.427454)"
2022,Junio,Suecia,752,1,0,,1,"(7.128456,-73.183637)"
2022,Junio,Suiza,756,25,20,,45,"(10.445761,-75.516429)"
2022,Junio,Suiza,756,6,10,,16,"(10.886611,-74.776708)"
2022,Junio,Suiza,756,94,55,,149,"(3.541112,-76.384584)"
2022,Junio,Suiza,756,4,2,,6,"(4.452882,-75.766298)"
2022,Junio,Suiza,756,540,385,,925,"(4.697144,-74.140516)"
2022,Junio,Suiza,756,4,4,,8,"(4.815061,-75.736532)"
2022,Junio,Suiza,756,73,69,,142,"(6.171601,-75.427454)"
2022,Junio,Surinam,740,0,2,,2,"(10.445761,-75.516429)"
2022,Junio,Surinam,740,1,0,,1,"(10.886611,-74.776708)"
2022,Junio,Surinam,740,3,0,,3,"(3.541112,-76.384584)"
2022,Junio,Surinam,740,8,12,,20,"(4.697144,-74.140516)"
2022,Junio,Surinam,740,1,2,,3,"(4.815061,-75.736532)"
2022,Junio,Surinam,740,7,3,,10,"(6.171601,-75.427454)"
2022,Junio,Surinam,740,0,1,,1,"(7.927209,-72.507910)"
2022,Junio,Taiwán,158,0,1,,1,"(10.445761,-75.516429)"
2022,Junio,Taiwán,158,1,0,,1,"(4.697144,-74.140516)"
2022,Junio,República de Tayikistán,762,0,3,,3,"(4.697144,-74.140516)"
2022,Junio,Tailandia,764,30,12,,42,"(4.697144,-74.140516)"
2022,Junio,Tanzania,834,1,1,,2,"(3.541112,-76.384584)"
2022,Junio,Tanzania,834,3,6,,9,"(4.697144,-74.140516)"
2022,Junio,Trinidad y Tobago,780,1,4,,5,"(10.445761,-75.516429)"
2022,Junio,Trinidad y Tobago,780,1,4,,5,"(3.541112,-76.384584)"
2022,Junio,Trinidad y Tobago,780,0,1,,1,"(4.452882,-75.766298)"
2022,Junio,Trinidad y Tobago,780,11,24,,35,"(4.697144,-74.140516)"
2022,Junio,Trinidad y Tobago,780,8,3,,11,"(6.171601,-75.427454)"
2022,Junio,Trinidad y Tobago,780,1,1,,2,"(7.927209,-72.507910)"
2022,Junio,Túnez,788,4,5,,9,"(4.697144,-74.140516)"
2022,Junio,Turquía,792,4,5,,9,"(10.445761,-75.516429)"
2022,Junio,Turquía,792,3,1,,4,"(10.886611,-74.776708)"
2022,Junio,Turquía,792,21,22,,43,"(3.541112,-76.384584)"
2022,Junio,Turquía,792,2345,1338,,3683,"(4.697144,-74.140516)"
2022,Junio,Turquía,792,19,13,,32,"(6.171601,-75.427454)"
2022,Junio,Turkmenistán,795,4,1,,5,"(4.697144,-74.140516)"
2022,Junio,Ucrania,804,0,1,,1,"(3.541112,-76.384584)"
2022,Junio,Ucrania,804,1,3,,4,"(4.697144,-74.140516)"
2022,Junio,Uganda,800,1,1,,2,"(4.697144,-74.140516)"
2022,Junio,Uruguay,858,1,0,,1,"(0.814836,-77.662532)"
2022,Junio,Uruguay,858,1,1,,2,"(10.445761,-75.516429)"
2022,Junio,Uruguay,858,1,2,,3,"(10.886611,-74.776708)"
2022,Junio,Uruguay,858,17,43,,60,"(3.541112,-76.384584)"
2022,Junio,Uruguay,858,193,260,,453,"(4.697144,-74.140516)"
2022,Junio,Uruguay,858,11,5,,16,"(4.815061,-75.736532)"
2022,Junio,Uruguay,858,9,9,,18,"(6.171601,-75.427454)"
2022,Junio,Uruguay,858,2,2,,4,"(7.128456,-73.183637)"
2022,Junio,Uruguay,858,3,1,,4,"(7.927209,-72.507910)"
2022,Junio,Uzbekistán,860,9,3,,12,"(4.697144,-74.140516)"
2022,Junio,Venezuela,862,6,4,,10,"(10.445761,-75.516429)"
2022,Junio,Venezuela,862,38,39,,77,"(10.886611,-74.776708)"
2022,Junio,Venezuela,862,1,0,,1,"(11.117806,-74.232622)"
2022,Junio,Venezuela,862,353,715,,1068,"(11.360009,-72.129330)"
2022,Junio,Venezuela,862,21,33,,54,"(3.541112,-76.384584)"
2022,Junio,Venezuela,862,4,3,,7,"(3.866713,-67.927521)"
2022,Junio,Venezuela,862,1,1,,2,"(4.452882,-75.766298)"
2022,Junio,Venezuela,862,168,283,,451,"(4.697144,-74.140516)"
2022,Junio,Venezuela,862,20,18,,38,"(4.815061,-75.736532)"
2022,Junio,Venezuela,862,52,99,,151,"(6.171601,-75.427454)"
2022,Junio,Venezuela,862,7,5,,12,"(6.185799,-67.483929)"
2022,Junio,Venezuela,862,30,46,,76,"(7.088729,-70.740253)"
2022,Junio,Venezuela,862,9,5,,14,"(7.128456,-73.183637)"
2022,Junio,Venezuela,862,630,747,,1377,"(7.818934,-72.453226)"
2022,Junio,Venezuela,862,59,78,,137,"(7.916725,-72.462544)"
2022,Junio,Venezuela,862,6,7,,13,"(7.927209,-72.507910)"
2022,Junio,Venezuela,862,42,45,,87,"(8.36068,-72.409396)"
2022,Junio,Vietnam,704,0,1,,1,"(3.541112,-76.384584)"
2022,Junio,Vietnam,704,1,2,,3,"(4.697144,-74.140516)"
2022,Junio,Islas Vírgenes Británicas/Territorio Británico de Ultramar,92,0,1,,1,"(3.541112,-76.384584)"
2022,Junio,Anguila/Territorio Británico de Ultramar,660,5,11,,16,"(4.697144,-74.140516)"
2022,Junio,Islas Turcas y Caicos/Territorio Británico de Ultramar,796,2,0,,2,"(4.697144,-74.140516)"
2022,Junio,Islas Turcas y Caicos/Territorio Británico de Ultramar,796,3,5,,8,"(6.171601,-75.427454)"
2022,Junio,Desconocido,99999,2,0,,2,"(4.697144,-74.140516)"
2022,Junio,Desconocido,99999,0,1,,1,"(4.815061,-75.736532)"
2022,Junio,Desconocido,99999,1,0,,1,"(6.171601,-75.427454)"
2022,Julio,Afganistán,4,0,3,,3,"(4.697144,-74.140516)"
2022,Julio,Albania,8,1,1,,2,"(10.445761,-75.516429)"
2022,Julio,Albania,8,0,1,,1,"(3.541112,-76.384584)"
2022,Julio,Albania,8,1,3,,4,"(4.697144,-74.140516)"
2022,Julio,Alemania,276,63,29,,92,"(10.445761,-75.516429)"
2022,Julio,Alemania,276,11,8,,19,"(10.886611,-74.776708)"
2022,Julio,Alemania,276,2,0,,2,"(11.117806,-74.232622)"
2022,Julio,Alemania,276,75,62,,137,"(3.541112,-76.384584)"
2022,Julio,Alemania,276,1,0,,1,"(4.452882,-75.766298)"
2022,Julio,Alemania,276,1643,1175,,2818,"(4.697144,-74.140516)"
2022,Julio,Alemania,276,2,3,,5,"(4.815061,-75.736532)"
2022,Julio,Alemania,276,133,93,,226,"(6.171601,-75.427454)"
2022,Julio,Andorra,20,6,10,,16,"(4.697144,-74.140516)"
2022,Julio,Andorra,20,1,0,,1,"(6.171601,-75.427454)"
2022,Julio,Angola,24,3,5,,8,"(4.697144,-74.140516)"
2022,Julio,Antigua y Barbuda,28,0,1,,1,"(10.445761,-75.516429)"
2022,Julio,Antigua y Barbuda,28,0,1,,1,"(10.886611,-74.776708)"
2022,Julio,Antigua y Barbuda,28,0,3,,3,"(4.697144,-74.140516)"
2022,Julio,Antigua y Barbuda,28,2,2,,4,"(6.171601,-75.427454)"
2022,Julio,Países Bajos,528,257,175,,432,"(10.445761,-75.516429)"
2022,Julio,Países Bajos,528,11,7,,18,"(10.886611,-74.776708)"
2022,Julio,Países Bajos,528,1,0,,1,"(12.586067,-81.702563)"
2022,Julio,Países Bajos,528,153,73,,226,"(3.541112,-76.384584)"
2022,Julio,Países Bajos,528,1,2,,3,"(4.452882,-75.766298)"
2022,Julio,Países Bajos,528,1314,1141,,2455,"(4.697144,-74.140516)"
2022,Julio,Países Bajos,528,1,3,,4,"(4.815061,-75.736532)"
2022,Julio,Países Bajos,528,122,86,,208,"(6.171601,-75.427454)"
2022,Julio,Arabia Saudita,682,0,2,,2,"(10.445761,-75.516429)"
2022,Julio,Arabia Saudita,682,0,1,,1,"(3.541112,-76.384584)"
2022,Julio,Arabia Saudita,682,17,44,,61,"(4.697144,-74.140516)"
2022,Julio,Arabia Saudita,682,0,1,,1,"(6.171601,-75.427454)"
2022,Julio,Argelia,12,2,2,,4,"(4.697144,-74.140516)"
2022,Julio,Argentina,32,0,1,,1,"(0.25129,-76.875963)"
2022,Julio,Argentina,32,3,6,,9,"(0.814836,-77.662532)"
2022,Julio,Argentina,32,10,16,,26,"(10.445761,-75.516429)"
2022,Julio,Argentina,32,12,10,,22,"(10.886611,-74.776708)"
2022,Julio,Argentina,32,2,2,,4,"(11.117806,-74.232622)"
2022,Julio,Argentina,32,0,1,,1,"(12.586067,-81.702563)"
2022,Julio,Argentina,32,85,86,,171,"(3.541112,-76.384584)"
2022,Julio,Argentina,32,2,0,,2,"(4.452882,-75.766298)"
2022,Julio,Argentina,32,2783,2474,,5257,"(4.697144,-74.140516)"
2022,Julio,Argentina,32,3,2,,5,"(4.815061,-75.736532)"
2022,Julio,Argentina,32,281,257,,538,"(6.171601,-75.427454)"
2022,Julio,Argentina,32,4,2,,6,"(7.128456,-73.183637)"
2022,Julio,Argentina,32,8,19,,27,"(7.927209,-72.507910)"
2022,Julio,Argentina,32,0,1,,1,"(8.364293,-72.405710)"
2022,Julio,República de Armenia,51,1,1,,2,"(4.697144,-74.140516)"
2022,Julio,Aruba,533,0,1,,1,"(10.408582,-75.538003)"
2022,Julio,Aruba,533,1,1,,2,"(10.445761,-75.516429)"
2022,Julio,Aruba,533,158,106,,264,"(10.886611,-74.776708)"
2022,Julio,Aruba,533,70,43,,113,"(3.541112,-76.384584)"
2022,Julio,Aruba,533,1746,1321,,3067,"(4.697144,-74.140516)"
2022,Julio,Aruba,533,7,4,,11,"(4.815061,-75.736532)"
2022,Julio,Aruba,533,209,171,,380,"(6.171601,-75.427454)"
2022,Julio,Aruba,533,6,23,,29,"(7.128456,-73.183637)"
2022,Julio,Australia,36,2,2,,4,"(10.445761,-75.516429)"
2022,Julio,Australia,36,3,3,,6,"(10.886611,-74.776708)"
2022,Julio,Australia,36,27,16,,43,"(3.541112,-76.384584)"
2022,Julio,Australia,36,600,517,,1117,"(4.697144,-74.140516)"
2022,Julio,Australia,36,4,1,,5,"(4.815061,-75.736532)"
2022,Julio,Australia,36,59,50,,109,"(6.171601,-75.427454)"
2022,Julio,Australia,36,3,1,,4,"(7.128456,-73.183637)"
2022,Julio,Australia,36,0,2,,2,"(7.927209,-72.507910)"
2022,Julio,Austria,40,1,1,,2,"(10.445761,-75.516429)"
2022,Julio,Austria,40,6,6,,12,"(3.541112,-76.384584)"
2022,Julio,Austria,40,88,78,,166,"(4.697144,-74.140516)"
2022,Julio,Austria,40,11,7,,18,"(6.171601,-75.427454)"
2022,Julio,Azerbaiyán,31,1,17,,18,"(4.697144,-74.140516)"
2022,Julio,Bahamas,44,2,0,,2,"(10.445761,-75.516429)"
2022,Julio,Bahamas,44,4,4,,8,"(10.886611,-74.776708)"
2022,Julio,Bahamas,44,33,17,,50,"(3.541112,-76.384584)"
2022,Julio,Bahamas,44,39,32,,71,"(4.697144,-74.140516)"
2022,Julio,Bahamas,44,41,17,,58,"(6.171601,-75.427454)"
2022,Julio,Bahréin,48,0,1,,1,"(3.541112,-76.384584)"
2022,Julio,Bahréin,48,10,9,,19,"(4.697144,-74.140516)"
2022,Julio,Bahréin,48,1,0,,1,"(6.171601,-75.427454)"
2022,Julio,Bangladesh,50,1,0,,1,"(3.541112,-76.384584)"
2022,Julio,Bangladesh,50,0,1,,1,"(4.697144,-74.140516)"
2022,Julio,Barbados,52,1,1,,2,"(10.886611,-74.776708)"
2022,Julio,Barbados,52,2,5,,7,"(3.541112,-76.384584)"
2022,Julio,Barbados,52,11,13,,24,"(4.697144,-74.140516)"
2022,Julio,Barbados,52,3,2,,5,"(6.171601,-75.427454)"
2022,Julio,Bélgica,56,6,11,,17,"(10.445761,-75.516429)"
2022,Julio,Bélgica,56,1,2,,3,"(10.886611,-74.776708)"
2022,Julio,Bélgica,56,37,25,,62,"(3.541112,-76.384584)"
2022,Julio,Bélgica,56,230,191,,421,"(4.697144,-74.140516)"
2022,Julio,Bélgica,56,0,1,,1,"(4.815061,-75.736532)"
2022,Julio,Bélgica,56,100,79,,179,"(6.171601,-75.427454)"
2022,Julio,Belice,84,1,0,,1,"(10.445761,-75.516429)"
2022,Julio,Belice,84,1,2,,3,"(3.541112,-76.384584)"
2022,Julio,Belice,84,2,2,,4,"(4.697144,-74.140516)"
2022,Julio,Belice,84,3,0,,3,"(6.171601,-75.427454)"
2022,Julio,Benín,204,0,1,,1,"(10.886611,-74.776708)"
2022,Julio,Bermudas/Territorio Británico de Ultramar,60,3,2,,5,"(4.697144,-74.140516)"
2022,Julio,Bermudas/Territorio Británico de Ultramar,60,3,1,,4,"(4.815061,-75.736532)"
2022,Julio,Bermudas/Territorio Británico de Ultramar,60,1,0,,1,"(6.171601,-75.427454)"
2022,Julio,Bolivia,68,6,6,,12,"(0.814836,-77.662532)"
2022,Julio,Bolivia,68,1,1,,2,"(10.445761,-75.516429)"
2022,Julio,Bolivia,68,0,1,,1,"(10.886611,-74.776708)"
2022,Julio,Bolivia,68,2,0,,2,"(12.586067,-81.702563)"
2022,Julio,Bolivia,68,9,14,,23,"(3.541112,-76.384584)"
2022,Julio,Bolivia,68,383,597,,980,"(4.697144,-74.140516)"
2022,Julio,Bolivia,68,3,0,,3,"(4.815061,-75.736532)"
2022,Julio,Bolivia,68,10,15,,25,"(6.171601,-75.427454)"
2022,Julio,Bolivia,68,2,0,,2,"(7.128456,-73.183637)"
2022,Julio,Bosnia y Herzegovina,70,4,3,,7,"(4.697144,-74.140516)"
2022,Julio,Botsuana,72,1,0,,1,"(4.697144,-74.140516)"
2022,Julio,Botsuana,72,0,1,,1,"(6.171601,-75.427454)"
2022,Julio,Brasil,76,251,443,,694,"(-4.197703,-69.941278)"
2022,Julio,Brasil,76,0,1,,1,"(0.25129,-76.875963)"
2022,Julio,Brasil,76,0,1,,1,"(0.814836,-77.662532)"
2022,Julio,Brasil,76,18,25,,43,"(10.445761,-75.516429)"
2022,Julio,Brasil,76,14,13,,27,"(10.886611,-74.776708)"
2022,Julio,Brasil,76,5,4,,9,"(11.117806,-74.232622)"
2022,Julio,Brasil,76,2,8,,10,"(12.586067,-81.702563)"
2022,Julio,Brasil,76,104,136,,240,"(3.541112,-76.384584)"
2022,Julio,Brasil,76,23,30,,53,"(4.452882,-75.766298)"
2022,Julio,Brasil,76,2318,2882,,5200,"(4.697144,-74.140516)"
2022,Julio,Brasil,76,22,39,,61,"(4.815061,-75.736532)"
2022,Julio,Brasil,76,382,401,,783,"(6.171601,-75.427454)"
2022,Julio,Brasil,76,1,0,,1,"(7.128456,-73.183637)"
2022,Julio,Brasil,76,5,10,,15,"(7.927209,-72.507910)"
2022,Julio,Brunei Darussalam,96,0,1,,1,"(6.171601,-75.427454)"
2022,Julio,Bulgaria,100,0,1,,1,"(10.445761,-75.516429)"
2022,Julio,Bulgaria,100,4,5,,9,"(4.697144,-74.140516)"
2022,Julio,Burkina Faso,854,0,2,,2,"(4.697144,-74.140516)"
2022,Julio,Cabo Verde,132,2,0,,2,"(4.697144,-74.140516)"
2022,Julio,Islas Caimán/Territorio Británico de Ultramar,136,2,0,,2,"(10.445761,-75.516429)"
2022,Julio,Islas Caimán/Territorio Británico de Ultramar,136,4,4,,8,"(12.586067,-81.702563)"
2022,Julio,Islas Caimán/Territorio Británico de Ultramar,136,1,0,,1,"(3.541112,-76.384584)"
2022,Julio,Islas Caimán/Territorio Británico de Ultramar,136,5,7,,12,"(4.697144,-74.140516)"
2022,Julio,Islas Caimán/Territorio Británico de Ultramar,136,2,2,,4,"(6.171601,-75.427454)"
2022,Julio,Camboya,116,2,0,,2,"(4.697144,-74.140516)"
2022,Julio,Camerún,120,1,1,,2,"(4.697144,-74.140516)"
2022,Julio,Canadá,124,58,32,,90,"(10.445761,-75.516429)"
2022,Julio,Canadá,124,47,36,,83,"(10.886611,-74.776708)"
2022,Julio,Canadá,124,8,5,,13,"(11.117806,-74.232622)"
2022,Julio,Canadá,124,1,1,,2,"(12.586067,-81.702563)"
2022,Julio,Canadá,124,120,88,,208,"(3.541112,-76.384584)"
2022,Julio,Canadá,124,10,8,,18,"(4.452882,-75.766298)"
2022,Julio,Canadá,124,4156,3172,,7328,"(4.697144,-74.140516)"
2022,Julio,Canadá,124,9,16,,25,"(4.815061,-75.736532)"
2022,Julio,Canadá,124,271,205,,476,"(6.171601,-75.427454)"
2022,Julio,Canadá,124,9,6,,15,"(7.128456,-73.183637)"
2022,Julio,Canadá,124,11,3,,14,"(7.927209,-72.507910)"
2022,Julio,Chad,148,1,0,,1,"(4.697144,-74.140516)"
2022,Julio,España,724,225,154,,379,"(10.445761,-75.516429)"
2022,Julio,España,724,15,15,,30,"(10.886611,-74.776708)"
2022,Julio,España,724,0,1,,1,"(11.117806,-74.232622)"
2022,Julio,España,724,3003,2147,,5150,"(3.541112,-76.384584)"
2022,Julio,España,724,5,2,,7,"(4.452882,-75.766298)"
2022,Julio,España,724,22627,17495,,40122,"(4.697144,-74.140516)"
2022,Julio,España,724,31,23,,54,"(4.815061,-75.736532)"
2022,Julio,España,724,3396,2424,,5820,"(6.171601,-75.427454)"
2022,Julio,España,724,4,1,,5,"(7.128456,-73.183637)"
2022,Julio,España,724,2,0,,2,"(7.927209,-72.507910)"
2022,Julio,Colombia,170,1,2,,3,"(10.445761,-75.516429)"
2022,Julio,Colombia,170,28,94,,122,"(4.697144,-74.140516)"
2022,Julio,Comoras,174,1,0,,1,"(0.814836,-77.662532)"
2022,Julio,Comoras,174,0,1,,1,"(4.697144,-74.140516)"
2022,Julio,República Democrática del Congo,180,4,1,,5,"(4.697144,-74.140516)"
2022,Julio,República Democrática del Congo,180,0,1,,1,"(6.171601,-75.427454)"
2022,Julio,República de Corea,410,25,19,,44,"(4.697144,-74.140516)"
2022,Julio,República de Corea,410,1,1,,2,"(4.815061,-75.736532)"
2022,Julio,Costa de Marfil,384,2,7,,9,"(4.697144,-74.140516)"
2022,Julio,Costa de Marfil,384,1,2,,3,"(6.171601,-75.427454)"
2022,Julio,Costa Rica,188,68,55,,123,"(10.445761,-75.516429)"
2022,Julio,Costa Rica,188,10,11,,21,"(10.886611,-74.776708)"
2022,Julio,Costa Rica,188,4,6,,10,"(11.117806,-74.232622)"
2022,Julio,Costa Rica,188,2,19,,21,"(12.5744111,-81.703935)"
2022,Julio,Costa Rica,188,0,1,,1,"(12.586067,-81.702563)"
2022,Julio,Costa Rica,188,68,61,,129,"(3.541112,-76.384584)"
2022,Julio,Costa Rica,188,5,5,,10,"(4.452882,-75.766298)"
2022,Julio,Costa Rica,188,1342,1374,,2716,"(4.697144,-74.140516)"
2022,Julio,Costa Rica,188,6,8,,14,"(4.815061,-75.736532)"
2022,Julio,Costa Rica,188,0,1,,1,"(6.17134,-75.427194)"
2022,Julio,Costa Rica,188,300,243,,543,"(6.171601,-75.427454)"
2022,Julio,Costa Rica,188,2,1,,3,"(7.128456,-73.183637)"
2022,Julio,Costa Rica,188,2,4,,6,"(7.927209,-72.507910)"
2022,Julio,Croacia,191,1,0,,1,"(10.445761,-75.516429)"
2022,Julio,Croacia,191,1,1,,2,"(3.541112,-76.384584)"
2022,Julio,Croacia,191,30,28,,58,"(4.697144,-74.140516)"
2022,Julio,Croacia,191,0,1,,1,"(6.171601,-75.427454)"
2022,Julio,Cuba,192,5,5,,10,"(10.445761,-75.516429)"
2022,Julio,Cuba,192,10,13,,23,"(10.886611,-74.776708)"
2022,Julio,Cuba,192,0,1,,1,"(11.117806,-74.232622)"
2022,Julio,Cuba,192,28,27,,55,"(3.541112,-76.384584)"
2022,Julio,Cuba,192,1022,890,,1912,"(4.697144,-74.140516)"
2022,Julio,Cuba,192,10,3,,13,"(4.815061,-75.736532)"
2022,Julio,Cuba,192,37,35,,72,"(6.171601,-75.427454)"
2022,Julio,Cuba,192,5,3,,8,"(7.128456,-73.183637)"
2022,Julio,Curazao,99999,0,1,,1,"(10.445761,-75.516429)"
2022,Julio,Curazao,99999,60,47,,107,"(10.886611,-74.776708)"
2022,Julio,Curazao,99999,47,36,,83,"(3.541112,-76.384584)"
2022,Julio,Curazao,99999,2,4,,6,"(4.452882,-75.766298)"
2022,Julio,Curazao,99999,1329,1103,,2432,"(4.697144,-74.140516)"
2022,Julio,Curazao,99999,3,0,,3,"(4.815061,-75.736532)"
2022,Julio,Curazao,99999,104,80,,184,"(6.171601,-75.427454)"
2022,Julio,República Checa,203,1,0,,1,"(3.541112,-76.384584)"
2022,Julio,República Checa,203,26,17,,43,"(4.697144,-74.140516)"
2022,Julio,República Checa,203,1,0,,1,"(6.171601,-75.427454)"
2022,Julio,Chile,152,2,2,,4,"(0.25129,-76.875963)"
2022,Julio,Chile,152,71,52,,123,"(0.814836,-77.662532)"
2022,Julio,Chile,152,9,11,,20,"(10.445761,-75.516429)"
2022,Julio,Chile,152,39,25,,64,"(10.886611,-74.776708)"
2022,Julio,Chile,152,5,1,,6,"(11.117806,-74.232622)"
2022,Julio,Chile,152,2243,1589,,3832,"(3.541112,-76.384584)"
2022,Julio,Chile,152,21,21,,42,"(4.452882,-75.766298)"
2022,Julio,Chile,152,4394,3793,,8187,"(4.697144,-74.140516)"
2022,Julio,Chile,152,13,11,,24,"(4.815061,-75.736532)"
2022,Julio,Chile,152,420,315,,735,"(6.171601,-75.427454)"
2022,Julio,Chile,152,5,3,,8,"(7.128456,-73.183637)"
2022,Julio,Chile,152,16,8,,24,"(7.927209,-72.507910)"
2022,Julio,China,156,1,0,,1,"(3.541112,-76.384584)"
2022,Julio,China,156,8,6,,14,"(4.697144,-74.140516)"
2022,Julio,Chipre,196,0,1,,1,"(10.445761,-75.516429)"
2022,Julio,Chipre,196,0,1,,1,"(3.541112,-76.384584)"
2022,Julio,Chipre,196,2,6,,8,"(4.697144,-74.140516)"
2022,Julio,Dinamarca,208,7,6,,13,"(10.445761,-75.516429)"
2022,Julio,Dinamarca,208,2,0,,2,"(10.886611,-74.776708)"
2022,Julio,Dinamarca,208,12,8,,20,"(3.541112,-76.384584)"
2022,Julio,Dinamarca,208,71,52,,123,"(4.697144,-74.140516)"
2022,Julio,Dinamarca,208,0,1,,1,"(4.815061,-75.736532)"
2022,Julio,Dinamarca,208,13,6,,19,"(6.171601,-75.427454)"
2022,Julio,Dominica,212,0,2,,2,"(10.445761,-75.516429)"
2022,Julio,Dominica,212,0,1,,1,"(3.541112,-76.384584)"
2022,Julio,Dominica,212,0,5,,5,"(4.697144,-74.140516)"
2022,Julio,Dominica,212,3,4,,7,"(6.171601,-75.427454)"
2022,Julio,Ecuador,218,429,496,,925,"(0.25129,-76.875963)"
2022,Julio,Ecuador,218,24,21,,45,"(0.812436,-77.847006)"
2022,Julio,Ecuador,218,4164,5109,,9273,"(0.814836,-77.662532)"
2022,Julio,Ecuador,218,2,4,,6,"(1.813928,-78.763924)"
2022,Julio,Ecuador,218,22,20,,42,"(10.445761,-75.516429)"
2022,Julio,Ecuador,218,11,39,,50,"(10.886611,-74.776708)"
2022,Julio,Ecuador,218,1,3,,4,"(11.117806,-74.232622)"
2022,Julio,Ecuador,218,1,3,,4,"(12.586067,-81.702563)"
2022,Julio,Ecuador,218,196,201,,397,"(3.541112,-76.384584)"
2022,Julio,Ecuador,218,3145,4198,,7343,"(4.697144,-74.140516)"
2022,Julio,Ecuador,218,3,13,,16,"(4.815061,-75.736532)"
2022,Julio,Ecuador,218,147,221,,368,"(6.171601,-75.427454)"
2022,Julio,Ecuador,218,2,1,,3,"(7.927209,-72.507910)"
2022,Julio,Egipto,818,1,0,,1,"(3.541112,-76.384584)"
2022,Julio,Egipto,818,38,34,,72,"(4.697144,-74.140516)"
2022,Julio,Egipto,818,1,1,,2,"(6.171601,-75.427454)"
2022,Julio,El Salvador,222,6,6,,12,"(10.445761,-75.516429)"
2022,Julio,El Salvador,222,2,6,,8,"(10.886611,-74.776708)"
2022,Julio,El Salvador,222,2,0,,2,"(11.117806,-74.232622)"
2022,Julio,El Salvador,222,18,16,,34,"(3.541112,-76.384584)"
2022,Julio,El Salvador,222,1,1,,2,"(4.452882,-75.766298)"
2022,Julio,El Salvador,222,459,533,,992,"(4.697144,-74.140516)"
2022,Julio,El Salvador,222,2,4,,6,"(4.815061,-75.736532)"
2022,Julio,El Salvador,222,30,55,,85,"(6.171601,-75.427454)"
2022,Julio,Emiratos Árabes,784,7,17,,24,"(10.445761,-75.516429)"
2022,Julio,Emiratos Árabes,784,2,1,,3,"(10.886611,-74.776708)"
2022,Julio,Emiratos Árabes,784,6,7,,13,"(3.541112,-76.384584)"
2022,Julio,Emiratos Árabes,784,3,1,,4,"(4.452882,-75.766298)"
2022,Julio,Emiratos Árabes,784,151,233,,384,"(4.697144,-74.140516)"
2022,Julio,Emiratos Árabes,784,13,12,,25,"(6.171601,-75.427454)"
2022,Julio,Eritrea,232,0,2,,2,"(4.697144,-74.140516)"
2022,Julio,Eslovaquia,703,2,1,,3,"(10.445761,-75.516429)"
2022,Julio,Eslovaquia,703,2,5,,7,"(4.697144,-74.140516)"
2022,Julio,Eslovaquia,703,1,0,,1,"(6.171601,-75.427454)"
2022,Julio,Eslovenia,705,1,0,,1,"(10.886611,-74.776708)"
2022,Julio,Eslovenia,705,3,1,,4,"(4.697144,-74.140516)"
2022,Julio,Estados Unidos de América,840,3503,2721,,6225,"(10.445761,-75.516429)"
2022,Julio,Estados Unidos de América,840,4506,3518,,8024,"(10.886611,-74.776708)"
2022,Julio,Estados Unidos de América,840,134,79,,213,"(11.117806,-74.232622)"
2022,Julio,Estados Unidos de América,840,0,8,,8,"(11.247723,-74.213989)"
2022,Julio,Estados Unidos de América,840,150,92,,242,"(12.586067,-81.702563)"
2022,Julio,Estados Unidos de América,840,12693,9463,,22156,"(3.541112,-76.384584)"
2022,Julio,Estados Unidos de América,840,1578,1136,,2714,"(4.452882,-75.766298)"
2022,Julio,Estados Unidos de América,840,37740,31810,,69550,"(4.697144,-74.140516)"
2022,Julio,Estados Unidos de América,840,1996,1330,,3326,"(4.815061,-75.736532)"
2022,Julio,Estados Unidos de América,840,1,3,,4,"(6.17134,-75.427194)"
2022,Julio,Estados Unidos de América,840,17353,13435,,30788,"(6.171601,-75.427454)"
2022,Julio,Estados Unidos de América,840,1030,728,,1758,"(7.128456,-73.183637)"
2022,Julio,Estados Unidos de América,840,129,115,,244,"(7.927209,-72.507910)"
2022,Julio,Estonia,233,1,1,,2,"(10.445761,-75.516429)"
2022,Julio,Estonia,233,7,6,,13,"(4.697144,-74.140516)"
2022,Julio,Etiopia,231,0,1,,1,"(3.541112,-76.384584)"
2022,Julio,Etiopia,231,1,4,,5,"(4.697144,-74.140516)"
2022,Julio,Islas Fiji,242,2,0,,2,"(4.697144,-74.140516)"
2022,Julio,Filipinas,608,12,10,,22,"(4.697144,-74.140516)"
2022,Julio,Finlandia,246,3,4,,7,"(10.886611,-74.776708)"
2022,Julio,Finlandia,246,1,0,,1,"(11.117806,-74.232622)"
2022,Julio,Finlandia,246,6,1,,7,"(3.541112,-76.384584)"
2022,Julio,Finlandia,246,35,31,,66,"(4.697144,-74.140516)"
2022,Julio,Finlandia,246,1,3,,4,"(4.815061,-75.736532)"
2022,Julio,Finlandia,246,4,3,,7,"(6.171601,-75.427454)"
2022,Julio,Francia,250,40,26,,66,"(10.445761,-75.516429)"
2022,Julio,Francia,250,5,4,,9,"(10.886611,-74.776708)"
2022,Julio,Francia,250,97,83,,180,"(3.541112,-76.384584)"
2022,Julio,Francia,250,2,0,,2,"(4.452882,-75.766298)"
2022,Julio,Francia,250,2995,2116,,5111,"(4.697144,-74.140516)"
2022,Julio,Francia,250,6,3,,9,"(4.815061,-75.736532)"
2022,Julio,Francia,250,237,156,,393,"(6.171601,-75.427454)"
2022,Julio,Francia,250,1,0,,1,"(7.927209,-72.507910)"
2022,Julio,Gabón,266,1,4,,5,"(4.697144,-74.140516)"
2022,Julio,Gabón,266,1,0,,1,"(6.171601,-75.427454)"
2022,Julio,Georgia,268,0,2,,2,"(10.886611,-74.776708)"
2022,Julio,Georgia,268,1,2,,3,"(3.541112,-76.384584)"
2022,Julio,Georgia,268,9,4,,13,"(4.697144,-74.140516)"
2022,Julio,Georgia,268,4,2,,6,"(6.171601,-75.427454)"
2022,Julio,Ghana,288,1,0,,1,"(10.886611,-74.776708)"
2022,Julio,Ghana,288,1,3,,4,"(4.697144,-74.140516)"
2022,Julio,Ghana,288,0,2,,2,"(6.171601,-75.427454)"
2022,Julio,Gibraltar/Territorio Británico de Ultramar,292,1,0,,1,"(4.697144,-74.140516)"
2022,Julio,Granada,308,1,0,,1,"(4.697144,-74.140516)"
2022,Julio,Grecia,300,2,1,,3,"(10.445761,-75.516429)"
2022,Julio,Grecia,300,2,1,,3,"(10.886611,-74.776708)"
2022,Julio,Grecia,300,6,2,,8,"(3.541112,-76.384584)"
2022,Julio,Grecia,300,99,75,,174,"(4.697144,-74.140516)"
2022,Julio,Grecia,300,10,5,,15,"(6.171601,-75.427454)"
2022,Julio,Groenlandia,304,0,1,,1,"(4.697144,-74.140516)"
2022,Julio,Guatemala,320,7,7,,14,"(10.445761,-75.516429)"
2022,Julio,Guatemala,320,20,38,,58,"(10.886611,-74.776708)"
2022,Julio,Guatemala,320,2,2,,4,"(11.117806,-74.232622)"
2022,Julio,Guatemala,320,0,6,,6,"(12.586067,-81.702563)"
2022,Julio,Guatemala,320,57,90,,147,"(3.541112,-76.384584)"
2022,Julio,Guatemala,320,8,5,,13,"(4.452882,-75.766298)"
2022,Julio,Guatemala,320,603,711,,1314,"(4.697144,-74.140516)"
2022,Julio,Guatemala,320,8,18,,26,"(4.815061,-75.736532)"
2022,Julio,Guatemala,320,96,118,,214,"(6.171601,-75.427454)"
2022,Julio,Guatemala,320,3,3,,6,"(7.128456,-73.183637)"
2022,Julio,Guatemala,320,3,1,,4,"(7.927209,-72.507910)"
2022,Julio,Guyana,328,1,1,,2,"(10.886611,-74.776708)"
2022,Julio,Guyana,328,0,4,,4,"(3.541112,-76.384584)"
2022,Julio,Guyana,328,13,23,,36,"(4.697144,-74.140516)"
2022,Julio,Guyana,328,0,1,,1,"(4.815061,-75.736532)"
2022,Julio,Guyana,328,3,8,,11,"(6.171601,-75.427454)"
2022,Julio,Guinea,324,1,0,,1,"(4.697144,-74.140516)"
2022,Julio,Guinea Ecuatorial,226,0,5,,5,"(4.697144,-74.140516)"
2022,Julio,Guadalupe/Territorio Francés,312,4,4,,8,"(3.541112,-76.384584)"
2022,Julio,Guadalupe/Territorio Francés,312,2,2,,4,"(4.697144,-74.140516)"
2022,Julio,Guadalupe/Territorio Francés,312,1,0,,1,"(6.171601,-75.427454)"
2022,Julio,Guayana Francesa/Departamento de Ultramar Francés,254,1,0,,1,"(3.541112,-76.384584)"
2022,Julio,Guayana Francesa/Departamento de Ultramar Francés,254,2,2,,4,"(4.697144,-74.140516)"
2022,Julio,Guayana Francesa/Departamento de Ultramar Francés,254,0,1,,1,"(6.171601,-75.427454)"
2022,Julio,Haití,332,0,1,,1,"(10.886611,-74.776708)"
2022,Julio,Haití,332,1,5,,6,"(4.697144,-74.140516)"
2022,Julio,Haití,332,1,0,,1,"(6.171601,-75.427454)"
2022,Julio,Honduras,340,9,9,,18,"(10.445761,-75.516429)"
2022,Julio,Honduras,340,6,18,,24,"(10.886611,-74.776708)"
2022,Julio,Honduras,340,16,37,,53,"(3.541112,-76.384584)"
2022,Julio,Honduras,340,70,143,,213,"(4.697144,-74.140516)"
2022,Julio,Honduras,340,5,6,,11,"(4.815061,-75.736532)"
2022,Julio,Honduras,340,36,50,,86,"(6.171601,-75.427454)"
2022,Julio,Honduras,340,1,4,,5,"(7.128456,-73.183637)"
2022,Julio,Honduras,340,0,1,,1,"(7.927209,-72.507910)"
2022,Julio,Hong Kong,344,0,1,,1,"(10.445761,-75.516429)"
2022,Julio,Hong Kong,344,3,3,,6,"(4.697144,-74.140516)"
2022,Julio,Hong Kong,344,0,1,,1,"(6.171601,-75.427454)"
2022,Julio,Hungría,348,1,3,,4,"(10.445761,-75.516429)"
2022,Julio,Hungría,348,23,16,,39,"(4.697144,-74.140516)"
2022,Julio,Hungría,348,6,5,,11,"(6.171601,-75.427454)"
2022,Julio,India,356,3,0,,3,"(10.445761,-75.516429)"
2022,Julio,India,356,1,0,,1,"(10.886611,-74.776708)"
2022,Julio,India,356,0,1,,1,"(3.541112,-76.384584)"
2022,Julio,India,356,29,27,,56,"(4.697144,-74.140516)"
2022,Julio,India,356,5,1,,6,"(6.171601,-75.427454)"
2022,Julio,Indonesia,360,3,9,,12,"(4.697144,-74.140516)"
2022,Julio,Indonesia,360,2,0,,2,"(6.171601,-75.427454)"
2022,Julio,Iraq,368,1,4,,5,"(4.697144,-74.140516)"
2022,Julio,Irán,364,0,1,,1,"(4.697144,-74.140516)"
2022,Julio,República de Irlanda,372,4,1,,5,"(10.445761,-75.516429)"
2022,Julio,República de Irlanda,372,2,0,,2,"(3.541112,-76.384584)"
2022,Julio,República de Irlanda,372,29,22,,51,"(4.697144,-74.140516)"
2022,Julio,República de Irlanda,372,2,4,,6,"(6.171601,-75.427454)"
2022,Julio,Islandia,352,1,0,,1,"(10.886611,-74.776708)"
2022,Julio,Islandia,352,6,8,,14,"(3.541112,-76.384584)"
2022,Julio,Islandia,352,12,15,,27,"(4.697144,-74.140516)"
2022,Julio,Islandia,352,4,2,,6,"(6.171601,-75.427454)"
2022,Julio,Israel,376,3,2,,5,"(10.445761,-75.516429)"
2022,Julio,Israel,376,2,3,,5,"(10.886611,-74.776708)"
2022,Julio,Israel,376,11,6,,17,"(3.541112,-76.384584)"
2022,Julio,Israel,376,173,118,,291,"(4.697144,-74.140516)"
2022,Julio,Israel,376,14,15,,29,"(6.171601,-75.427454)"
2022,Julio,Italia,380,76,46,,122,"(10.445761,-75.516429)"
2022,Julio,Italia,380,8,7,,15,"(10.886611,-74.776708)"
2022,Julio,Italia,380,158,102,,260,"(3.541112,-76.384584)"
2022,Julio,Italia,380,1,0,,1,"(4.452882,-75.766298)"
2022,Julio,Italia,380,1195,812,,2007,"(4.697144,-74.140516)"
2022,Julio,Italia,380,3,2,,5,"(4.815061,-75.736532)"
2022,Julio,Italia,380,196,132,,328,"(6.171601,-75.427454)"
2022,Julio,Islas Feroe/Región Autónoma de Dinamarca,234,1,0,,1,"(4.697144,-74.140516)"
2022,Julio,Jamaica,388,1,8,,9,"(10.408582,-75.538003)"
2022,Julio,Jamaica,388,2,5,,7,"(10.445761,-75.516429)"
2022,Julio,Jamaica,388,3,3,,6,"(10.886611,-74.776708)"
2022,Julio,Jamaica,388,0,5,,5,"(11.117806,-74.232622)"
2022,Julio,Jamaica,388,2,1,,3,"(12.586067,-81.702563)"
2022,Julio,Jamaica,388,6,4,,10,"(3.541112,-76.384584)"
2022,Julio,Jamaica,388,32,45,,77,"(4.697144,-74.140516)"
2022,Julio,Jamaica,388,1,0,,1,"(4.815061,-75.736532)"
2022,Julio,Jamaica,388,1,3,,4,"(6.17134,-75.427194)"
2022,Julio,Jamaica,388,14,8,,22,"(6.171601,-75.427454)"
2022,Julio,Japón,392,21,14,,35,"(4.697144,-74.140516)"
2022,Julio,Japón,392,1,0,,1,"(4.815061,-75.736532)"
2022,Julio,Japón,392,0,2,,2,"(6.171601,-75.427454)"
2022,Julio,Japón,392,1,1,,2,"(7.128456,-73.183637)"
2022,Julio,Jordania,400,3,3,,6,"(3.541112,-76.384584)"
2022,Julio,Jordania,400,5,3,,8,"(4.697144,-74.140516)"
2022,Julio,Kazajistán,398,0,1,,1,"(3.541112,-76.384584)"
2022,Julio,Kazajistán,398,1,3,,4,"(4.697144,-74.140516)"
2022,Julio,Kenia,404,1,3,,4,"(3.541112,-76.384584)"
2022,Julio,Kenia,404,16,7,,23,"(4.697144,-74.140516)"
2022,Julio,Kuwait,414,1,6,,7,"(4.697144,-74.140516)"
2022,Julio,Letonia,428,1,6,,7,"(4.697144,-74.140516)"
2022,Julio,Lituania,440,6,6,,12,"(4.697144,-74.140516)"
2022,Julio,Lituania,440,1,0,,1,"(6.171601,-75.427454)"
2022,Julio,Líbano,422,0,2,,2,"(10.408582,-75.538003)"
2022,Julio,Líbano,422,3,2,,5,"(10.445761,-75.516429)"
2022,Julio,Líbano,422,2,1,,3,"(10.886611,-74.776708)"
2022,Julio,Líbano,422,1,2,,3,"(3.541112,-76.384584)"
2022,Julio,Líbano,422,14,17,,31,"(4.697144,-74.140516)"
2022,Julio,Líbano,422,0,1,,1,"(6.171601,-75.427454)"
2022,Julio,Luxemburgo,442,1,0,,1,"(10.445761,-75.516429)"
2022,Julio,Luxemburgo,442,2,2,,4,"(3.541112,-76.384584)"
2022,Julio,Luxemburgo,442,20,21,,41,"(4.697144,-74.140516)"
2022,Julio,Luxemburgo,442,3,0,,3,"(6.171601,-75.427454)"
2022,Julio,Macedonia,807,0,1,,1,"(4.697144,-74.140516)"
2022,Julio,Malasia,458,1,2,,3,"(3.541112,-76.384584)"
2022,Julio,Malasia,458,3,1,,4,"(4.697144,-74.140516)"
2022,Julio,Maldivas,462,1,1,,2,"(10.445761,-75.516429)"
2022,Julio,Maldivas,462,1,2,,3,"(4.697144,-74.140516)"
2022,Julio,Maldivas,462,1,1,,2,"(6.171601,-75.427454)"
2022,Julio,Malí,466,1,3,,4,"(4.697144,-74.140516)"
2022,Julio,Malí,466,1,0,,1,"(6.171601,-75.427454)"
2022,Julio,Malta,470,3,5,,8,"(10.445761,-75.516429)"
2022,Julio,Malta,470,1,0,,1,"(10.886611,-74.776708)"
2022,Julio,Malta,470,4,3,,7,"(3.541112,-76.384584)"
2022,Julio,Malta,470,163,134,,297,"(4.697144,-74.140516)"
2022,Julio,Malta,470,7,8,,15,"(6.171601,-75.427454)"
2022,Julio,Marruecos,504,0,1,,1,"(10.445761,-75.516429)"
2022,Julio,Marruecos,504,2,0,,2,"(3.541112,-76.384584)"
2022,Julio,Marruecos,504,18,10,,28,"(4.697144,-74.140516)"
2022,Julio,Marruecos,504,5,1,,6,"(6.171601,-75.427454)"
2022,Julio,Mauritania,478,0,4,,4,"(4.697144,-74.140516)"
2022,Julio,Martinica/Departamento de Ultramar Francés,474,1,0,,1,"(4.697144,-74.140516)"
2022,Julio,México,484,0,8,,8,"(10.408582,-75.538003)"
2022,Julio,México,484,318,236,,554,"(10.445761,-75.516429)"
2022,Julio,México,484,426,426,,852,"(10.886611,-74.776708)"
2022,Julio,México,484,19,21,,40,"(11.117806,-74.232622)"
2022,Julio,México,484,3,3,,6,"(12.586067,-81.702563)"
2022,Julio,México,484,4120,3748,,7868,"(3.541112,-76.384584)"
2022,Julio,México,484,14,9,,23,"(4.452882,-75.766298)"
2022,Julio,México,484,22573,22591,,45164,"(4.697144,-74.140516)"
2022,Julio,México,484,193,152,,345,"(4.815061,-75.736532)"
2022,Julio,México,484,8397,7290,,15687,"(6.171601,-75.427454)"
2022,Julio,México,484,129,108,,237,"(7.128456,-73.183637)"
2022,Julio,México,484,73,66,,139,"(7.927209,-72.507910)"
2022,Julio,Mayotte/Colectividad Territorial Francesa,175,0,2,,2,"(4.697144,-74.140516)"
2022,Julio,Mónaco,492,2,1,,3,"(4.697144,-74.140516)"
2022,Julio,Mongolia,496,3,4,,7,"(4.697144,-74.140516)"
2022,Julio,Montenegro,499,1,1,,2,"(4.697144,-74.140516)"
2022,Julio,Micronesia,583,2,1,,3,"(4.697144,-74.140516)"
2022,Julio,Mozambique,508,1,2,,3,"(4.697144,-74.140516)"
2022,Julio,Myanmar,104,1,0,,1,"(4.697144,-74.140516)"
2022,Julio,Nauru,520,1,0,,1,"(4.697144,-74.140516)"
2022,Julio,Namibia,516,0,1,,1,"(4.697144,-74.140516)"
2022,Julio,Nicaragua,558,1,1,,2,"(10.445761,-75.516429)"
2022,Julio,Nicaragua,558,2,3,,5,"(10.886611,-74.776708)"
2022,Julio,Nicaragua,558,1,0,,1,"(12.586067,-81.702563)"
2022,Julio,Nicaragua,558,3,11,,14,"(3.541112,-76.384584)"
2022,Julio,Nicaragua,558,1,0,,1,"(4.452882,-75.766298)"
2022,Julio,Nicaragua,558,23,65,,88,"(4.697144,-74.140516)"
2022,Julio,Nicaragua,558,0,1,,1,"(4.815061,-75.736532)"
2022,Julio,Nicaragua,558,7,20,,27,"(6.171601,-75.427454)"
2022,Julio,Nigeria,566,0,6,,6,"(4.697144,-74.140516)"
2022,Julio,Noruega,578,12,8,,20,"(10.445761,-75.516429)"
2022,Julio,Noruega,578,2,1,,3,"(10.886611,-74.776708)"
2022,Julio,Noruega,578,7,3,,10,"(3.541112,-76.384584)"
2022,Julio,Noruega,578,60,45,,105,"(4.697144,-74.140516)"
2022,Julio,Noruega,578,1,1,,2,"(4.815061,-75.736532)"
2022,Julio,Noruega,578,8,6,,14,"(6.171601,-75.427454)"
2022,Julio,Nueva Caledonia/Territorio francés,540,1,0,,1,"(3.541112,-76.384584)"
2022,Julio,Nueva Caledonia/Territorio francés,540,0,1,,1,"(6.171601,-75.427454)"
2022,Julio,Nueva Zelanda,554,2,2,,4,"(3.541112,-76.384584)"
2022,Julio,Nueva Zelanda,554,36,32,,68,"(4.697144,-74.140516)"
2022,Julio,Nueva Zelanda,554,1,3,,4,"(6.171601,-75.427454)"
2022,Julio,Omán,512,0,1,,1,"(10.445761,-75.516429)"
2022,Julio,Omán,512,5,5,,10,"(4.697144,-74.140516)"
2022,Julio,Papúa Nueva Guinea,598,0,2,,2,"(4.697144,-74.140516)"
2022,Julio,Papúa Nueva Guinea,598,1,0,,1,"(6.171601,-75.427454)"
2022,Julio,Pakistán,586,0,3,,3,"(4.697144,-74.140516)"
2022,Julio,Panamá,591,27,58,,85,"(10.408582,-75.538003)"
2022,Julio,Panamá,591,1279,1018,,2297,"(10.445761,-75.516429)"
2022,Julio,Panamá,591,747,670,,1417,"(10.886611,-74.776708)"
2022,Julio,Panamá,591,1,3,,4,"(10.971302,-74.765397)"
2022,Julio,Panamá,591,60,49,,109,"(11.117806,-74.232622)"
2022,Julio,Panamá,591,0,1,,1,"(12.165168,-71.983761)"
2022,Julio,Panamá,591,24,19,,43,"(12.586067,-81.702563)"
2022,Julio,Panamá,591,2574,1974,,4548,"(3.541112,-76.384584)"
2022,Julio,Panamá,591,85,61,,146,"(4.452882,-75.766298)"
2022,Julio,Panamá,591,7087,7246,,14333,"(4.697144,-74.140516)"
2022,Julio,Panamá,591,197,172,,369,"(4.815061,-75.736532)"
2022,Julio,Panamá,591,0,6,,6,"(6.17134,-75.427194)"
2022,Julio,Panamá,591,2631,2594,,5225,"(6.171601,-75.427454)"
2022,Julio,Panamá,591,10,15,,25,"(7.102626,-77.762647)"
2022,Julio,Panamá,591,120,102,,222,"(7.128456,-73.183637)"
2022,Julio,Panamá,591,51,33,,84,"(7.927209,-72.507910)"
2022,Julio,Panamá,591,26,82,,108,"(8.635765,-77.346578)"
2022,Julio,Paraguay,600,0,3,,3,"(10.445761,-75.516429)"
2022,Julio,Paraguay,600,0,1,,1,"(10.886611,-74.776708)"
2022,Julio,Paraguay,600,18,44,,62,"(3.541112,-76.384584)"
2022,Julio,Paraguay,600,220,299,,519,"(4.697144,-74.140516)"
2022,Julio,Paraguay,600,2,3,,5,"(4.815061,-75.736532)"
2022,Julio,Paraguay,600,17,25,,42,"(6.171601,-75.427454)"
2022,Julio,Paraguay,600,3,0,,3,"(7.128456,-73.183637)"
2022,Julio,Paraguay,600,0,1,,1,"(7.927209,-72.507910)"
2022,Julio,Perú,604,1,2,,3,"(-0.193180,-74.784874)"
2022,Julio,Perú,604,2,2,,4,"(-3.790089,-70.356599)"
2022,Julio,Perú,604,93,162,,255,"(-4.197703,-69.941278)"
2022,Julio,Perú,604,3,5,,8,"(0.25129,-76.875963)"
2022,Julio,Perú,604,58,73,,131,"(0.814836,-77.662532)"
2022,Julio,Perú,604,68,51,,119,"(10.445761,-75.516429)"
2022,Julio,Perú,604,17,25,,42,"(10.886611,-74.776708)"
2022,Julio,Perú,604,4,5,,9,"(11.117806,-74.232622)"
2022,Julio,Perú,604,0,1,,1,"(12.586067,-81.702563)"
2022,Julio,Perú,604,175,245,,420,"(3.541112,-76.384584)"
2022,Julio,Perú,604,7,1,,8,"(4.452882,-75.766298)"
2022,Julio,Perú,604,4371,4841,,9212,"(4.697144,-74.140516)"
2022,Julio,Perú,604,10,11,,21,"(4.815061,-75.736532)"
2022,Julio,Perú,604,852,760,,1612,"(6.171601,-75.427454)"
2022,Julio,Perú,604,3,1,,4,"(7.128456,-73.183637)"
2022,Julio,Perú,604,2,0,,2,"(7.927209,-72.507910)"
2022,Julio,Palestina,99999,0,1,,1,"(10.886611,-74.776708)"
2022,Julio,Palestina,99999,1,2,,3,"(4.697144,-74.140516)"
2022,Julio,Polonia,616,4,8,,12,"(10.445761,-75.516429)"
2022,Julio,Polonia,616,3,4,,7,"(3.541112,-76.384584)"
2022,Julio,Polonia,616,44,83,,127,"(4.697144,-74.140516)"
2022,Julio,Polonia,616,4,5,,9,"(6.171601,-75.427454)"
2022,Julio,Portugal,620,4,6,,10,"(10.445761,-75.516429)"
2022,Julio,Portugal,620,22,15,,37,"(3.541112,-76.384584)"
2022,Julio,Portugal,620,280,275,,555,"(4.697144,-74.140516)"
2022,Julio,Portugal,620,3,0,,3,"(4.815061,-75.736532)"
2022,Julio,Portugal,620,49,80,,129,"(6.171601,-75.427454)"
2022,Julio,Portugal,620,1,1,,2,"(7.128456,-73.183637)"
2022,Julio,Portugal,620,0,1,,1,"(7.927209,-72.507910)"
2022,Julio,Polinesia Francesa/Colectividad de Ultramar Francesa,258,0,1,,1,"(6.171601,-75.427454)"
2022,Julio,Puerto Rico/Territorio de Estados Unidos,630,9,145,,154,"(10.408582,-75.538003)"
2022,Julio,Puerto Rico/Territorio de Estados Unidos,630,6,3,,9,"(10.445761,-75.516429)"
2022,Julio,Puerto Rico/Territorio de Estados Unidos,630,9,8,,17,"(10.886611,-74.776708)"
2022,Julio,Puerto Rico/Territorio de Estados Unidos,630,1,3,,4,"(11.117806,-74.232622)"
2022,Julio,Puerto Rico/Territorio de Estados Unidos,630,65,55,,120,"(3.541112,-76.384584)"
2022,Julio,Puerto Rico/Territorio de Estados Unidos,630,1,0,,1,"(4.452882,-75.766298)"
2022,Julio,Puerto Rico/Territorio de Estados Unidos,630,438,355,,793,"(4.697144,-74.140516)"
2022,Julio,Puerto Rico/Territorio de Estados Unidos,630,4,0,,4,"(4.815061,-75.736532)"
2022,Julio,Puerto Rico/Territorio de Estados Unidos,630,44,23,,67,"(6.171601,-75.427454)"
2022,Julio,Puerto Rico/Territorio de Estados Unidos,630,1,0,,1,"(7.128456,-73.183637)"
2022,Julio,Puerto Rico/Territorio de Estados Unidos,630,2,0,,2,"(7.927209,-72.507910)"
2022,Julio,Qatar,634,0,1,,1,"(10.445761,-75.516429)"
2022,Julio,Qatar,634,0,1,,1,"(3.541112,-76.384584)"
2022,Julio,Qatar,634,23,29,,52,"(4.697144,-74.140516)"
2022,Julio,Qatar,634,5,5,,10,"(6.171601,-75.427454)"
2022,Julio,Reino Unido de Gran Bretaña e Irlanda del Norte,826,9,2,,11,"(10.445761,-75.516429)"
2022,Julio,Reino Unido de Gran Bretaña e Irlanda del Norte,826,3,0,,3,"(10.886611,-74.776708)"
2022,Julio,Reino Unido de Gran Bretaña e Irlanda del Norte,826,31,17,,48,"(3.541112,-76.384584)"
2022,Julio,Reino Unido de Gran Bretaña e Irlanda del Norte,826,1821,1332,,3153,"(4.697144,-74.140516)"
2022,Julio,Reino Unido de Gran Bretaña e Irlanda del Norte,826,1,0,,1,"(4.815061,-75.736532)"
2022,Julio,Reino Unido de Gran Bretaña e Irlanda del Norte,826,49,42,,91,"(6.171601,-75.427454)"
2022,Julio,República CentroÁfricana,140,0,2,,2,"(4.697144,-74.140516)"
2022,Julio,República CentroÁfricana,140,1,0,,1,"(6.171601,-75.427454)"
2022,Julio,Federación de Rusia,643,9,16,,25,"(4.697144,-74.140516)"
2022,Julio,Federación de Rusia,643,2,1,,3,"(6.171601,-75.427454)"
2022,Julio,República Dominicana,214,0,1,,1,"(10.433609,-73.247863)"
2022,Julio,República Dominicana,214,27,28,,55,"(10.445761,-75.516429)"
2022,Julio,República Dominicana,214,74,91,,165,"(10.886611,-74.776708)"
2022,Julio,República Dominicana,214,16,15,,31,"(11.117806,-74.232622)"
2022,Julio,República Dominicana,214,1,1,,2,"(12.586067,-81.702563)"
2022,Julio,República Dominicana,214,504,384,,888,"(3.541112,-76.384584)"
2022,Julio,República Dominicana,214,2,1,,3,"(4.452882,-75.766298)"
2022,Julio,República Dominicana,214,6263,5397,,11661,"(4.697144,-74.140516)"
2022,Julio,República Dominicana,214,36,30,,66,"(4.815061,-75.736532)"
2022,Julio,República Dominicana,214,5312,4111,,9423,"(6.171601,-75.427454)"
2022,Julio,República Dominicana,214,19,11,,30,"(7.128456,-73.183637)"
2022,Julio,República Dominicana,214,2,4,,6,"(7.927209,-72.507910)"
2022,Julio,Rumania,642,1,0,,1,"(10.445761,-75.516429)"
2022,Julio,Rumania,642,1,0,,1,"(3.541112,-76.384584)"
2022,Julio,Rumania,642,16,12,,28,"(4.697144,-74.140516)"
2022,Julio,Rumania,642,0,3,,3,"(6.171601,-75.427454)"
2022,Julio,Rwanda,646,1,3,,4,"(4.697144,-74.140516)"
2022,Julio,San Cristóbal y Nevis,659,1,5,,6,"(3.541112,-76.384584)"
2022,Julio,San Cristóbal y Nevis,659,2,1,,3,"(7.818934,-72.453226)"
2022,Julio,San Marino,674,3,2,,5,"(4.697144,-74.140516)"
2022,Julio,San  Vicente y las Granadinas,670,0,3,,3,"(4.697144,-74.140516)"
2022,Julio,Santa Elena/Territorio Británico de Ultramar,654,2,1,,3,"(0.814836,-77.662532)"
2022,Julio,Santa Elena/Territorio Británico de Ultramar,654,1,1,,2,"(4.697144,-74.140516)"
2022,Julio,Santa Sede/Ciudad del Vaticano,336,2,0,,2,"(4.697144,-74.140516)"
2022,Julio,Senegal,686,1,3,,4,"(4.697144,-74.140516)"
2022,Julio,Serbia,688,3,2,,5,"(10.445761,-75.516429)"
2022,Julio,Serbia,688,7,5,,12,"(4.697144,-74.140516)"
2022,Julio,Serbia,688,1,0,,1,"(6.171601,-75.427454)"
2022,Julio,Sierra Leona,694,1,0,,1,"(6.171601,-75.427454)"
2022,Julio,Singapur,702,1,1,,2,"(3.541112,-76.384584)"
2022,Julio,Singapur,702,19,10,,29,"(4.697144,-74.140516)"
2022,Julio,Sudáfrica,710,0,1,,1,"(3.541112,-76.384584)"
2022,Julio,Sudáfrica,710,2,5,,7,"(4.697144,-74.140516)"
2022,Julio,Sudán,736,1,0,,1,"(4.697144,-74.140516)"
2022,Julio,Sudán,736,1,1,,2,"(6.171601,-75.427454)"
2022,Julio,Suecia,752,16,8,,24,"(10.445761,-75.516429)"
2022,Julio,Suecia,752,1,1,,2,"(11.117806,-74.232622)"
2022,Julio,Suecia,752,49,32,,81,"(3.541112,-76.384584)"
2022,Julio,Suecia,752,3,1,,4,"(4.452882,-75.766298)"
2022,Julio,Suecia,752,164,104,,268,"(4.697144,-74.140516)"
2022,Julio,Suecia,752,1,0,,1,"(4.815061,-75.736532)"
2022,Julio,Suecia,752,23,12,,35,"(6.171601,-75.427454)"
2022,Julio,Suecia,752,1,0,,1,"(7.128456,-73.183637)"
2022,Julio,Suiza,756,43,30,,73,"(10.445761,-75.516429)"
2022,Julio,Suiza,756,4,2,,6,"(10.886611,-74.776708)"
2022,Julio,Suiza,756,1,1,,2,"(11.117806,-74.232622)"
2022,Julio,Suiza,756,91,47,,138,"(3.541112,-76.384584)"
2022,Julio,Suiza,756,2,3,,5,"(4.452882,-75.766298)"
2022,Julio,Suiza,756,488,315,,803,"(4.697144,-74.140516)"
2022,Julio,Suiza,756,2,4,,6,"(4.815061,-75.736532)"
2022,Julio,Suiza,756,106,49,,155,"(6.171601,-75.427454)"
2022,Julio,Suiza,756,1,1,,2,"(7.927209,-72.507910)"
2022,Julio,Surinam,740,0,17,,17,"(10.408582,-75.538003)"
2022,Julio,Surinam,740,1,1,,2,"(10.445761,-75.516429)"
2022,Julio,Surinam,740,0,11,,11,"(10.886611,-74.776708)"
2022,Julio,Surinam,740,1,2,,3,"(3.541112,-76.384584)"
2022,Julio,Surinam,740,12,21,,33,"(4.697144,-74.140516)"
2022,Julio,Surinam,740,4,4,,8,"(6.171601,-75.427454)"
2022,Julio,Taiwán,158,3,2,,5,"(4.697144,-74.140516)"
2022,Julio,Tailandia,764,1,0,,1,"(10.886611,-74.776708)"
2022,Julio,Tailandia,764,16,23,,39,"(4.697144,-74.140516)"
2022,Julio,Tailandia,764,1,1,,2,"(6.171601,-75.427454)"
2022,Julio,Tanzania,834,1,0,,1,"(10.445761,-75.516429)"
2022,Julio,Tanzania,834,7,5,,12,"(4.697144,-74.140516)"
2022,Julio,Tanzania,834,3,1,,4,"(6.171601,-75.427454)"
2022,Julio,Trinidad y Tobago,780,0,3,,3,"(10.445761,-75.516429)"
2022,Julio,Trinidad y Tobago,780,0,1,,1,"(10.886611,-74.776708)"
2022,Julio,Trinidad y Tobago,780,2,13,,15,"(3.541112,-76.384584)"
2022,Julio,Trinidad y Tobago,780,4,7,,11,"(4.452882,-75.766298)"
2022,Julio,Trinidad y Tobago,780,12,19,,31,"(4.697144,-74.140516)"
2022,Julio,Trinidad y Tobago,780,4,5,,9,"(6.171601,-75.427454)"
2022,Julio,Trinidad y Tobago,780,0,2,,2,"(7.927209,-72.507910)"
2022,Julio,Túnez,788,0,3,,3,"(4.697144,-74.140516)"
2022,Julio,Túnez,788,1,1,,2,"(6.171601,-75.427454)"
2022,Julio,Turquía,792,1,1,,2,"(10.445761,-75.516429)"
2022,Julio,Turquía,792,1,0,,1,"(10.886611,-74.776708)"
2022,Julio,Turquía,792,6,7,,13,"(3.541112,-76.384584)"
2022,Julio,Turquía,792,1081,797,,1878,"(4.697144,-74.140516)"
2022,Julio,Turquía,792,24,20,,44,"(6.171601,-75.427454)"
2022,Julio,Turkmenistán,795,1,0,,1,"(4.697144,-74.140516)"
2022,Julio,Ucrania,804,1,0,,1,"(4.697144,-74.140516)"
2022,Julio,Uganda,800,0,3,,3,"(10.445761,-75.516429)"
2022,Julio,Uganda,800,2,0,,2,"(4.697144,-74.140516)"
2022,Julio,Uruguay,858,2,1,,3,"(10.445761,-75.516429)"
2022,Julio,Uruguay,858,1,2,,3,"(10.886611,-74.776708)"
2022,Julio,Uruguay,858,30,50,,80,"(3.541112,-76.384584)"
2022,Julio,Uruguay,858,2,1,,3,"(4.452882,-75.766298)"
2022,Julio,Uruguay,858,189,248,,437,"(4.697144,-74.140516)"
2022,Julio,Uruguay,858,2,3,,5,"(4.815061,-75.736532)"
2022,Julio,Uruguay,858,11,5,,16,"(6.171601,-75.427454)"
2022,Julio,Uruguay,858,0,1,,1,"(7.927209,-72.507910)"
2022,Julio,Venezuela,862,7,4,,11,"(10.445761,-75.516429)"
2022,Julio,Venezuela,862,21,28,,49,"(10.886611,-74.776708)"
2022,Julio,Venezuela,862,429,654,,1083,"(11.360009,-72.129330)"
2022,Julio,Venezuela,862,26,35,,61,"(3.541112,-76.384584)"
2022,Julio,Venezuela,862,144,291,,435,"(4.697144,-74.140516)"
2022,Julio,Venezuela,862,7,25,,32,"(4.815061,-75.736532)"
2022,Julio,Venezuela,862,61,95,,156,"(6.171601,-75.427454)"
2022,Julio,Venezuela,862,5,18,,23,"(6.18189,-67.47535)"
2022,Julio,Venezuela,862,33,45,,78,"(7.088729,-70.740253)"
2022,Julio,Venezuela,862,11,6,,17,"(7.128456,-73.183637)"
2022,Julio,Venezuela,862,634,775,,1409,"(7.818934,-72.453226)"
2022,Julio,Venezuela,862,81,98,,179,"(7.916725,-72.462544)"
2022,Julio,Venezuela,862,14,6,,20,"(7.927209,-72.507910)"
2022,Julio,Venezuela,862,63,80,,143,"(8.36068,-72.409396)"
2022,Julio,Vietnam,704,6,10,,16,"(4.697144,-74.140516)"
2022,Julio,Vietnam,704,0,1,,1,"(6.171601,-75.427454)"
2022,Julio,Islas Vírgenes Británicas/Territorio Británico de Ultramar,92,1,6,,7,"(4.697144,-74.140516)"
2022,Julio,Islas Vírgenes Estadounidenses/Territorio de Estados Unidos,850,0,1,,1,"(4.452882,-75.766298)"
2022,Julio,Islas Vírgenes Estadounidenses/Territorio de Estados Unidos,850,0,1,,1,"(4.697144,-74.140516)"
2022,Julio,Islas Vírgenes Estadounidenses/Territorio de Estados Unidos,850,0,1,,1,"(7.128456,-73.183637)"
2022,Julio,Anguila/Territorio Británico de Ultramar,660,2,3,,5,"(4.697144,-74.140516)"
2022,Julio,Anguila/Territorio Británico de Ultramar,660,4,1,,5,"(6.171601,-75.427454)"
2022,Julio,Islas Turcas y Caicos/Territorio Británico de Ultramar,796,2,2,,4,"(4.697144,-74.140516)"
2022,Julio,Desconocido,99999,0,1,,1,"(4.697144,-74.140516)"
2022,Julio,Desconocido,99999,0,1,,1,"(6.171601,-75.427454)"
2022,Agosto,Afganistán,4,1,1,,2,"(0.814836,-77.662532)"
2022,Agosto,Albania,8,0,1,,1,"(11.360009,-72.129330)"
2022,Agosto,Albania,8,1,1,,2,"(3.541112,-76.384584)"
2022,Agosto,Albania,8,3,3,,6,"(4.697144,-74.140516)"
2022,Agosto,Albania,8,1,1,,2,"(6.171601,-75.427454)"
2022,Agosto,Alemania,276,39,29,,68,"(10.445761,-75.516429)"
2022,Agosto,Alemania,276,7,5,,12,"(10.886611,-74.776708)"
2022,Agosto,Alemania,276,3,1,,4,"(11.117806,-74.232622)"
2022,Agosto,Alemania,276,74,50,,124,"(3.541112,-76.384584)"
2022,Agosto,Alemania,276,1152,850,,2002,"(4.697144,-74.140516)"
2022,Agosto,Alemania,276,6,1,,7,"(4.815061,-75.736532)"
2022,Agosto,Alemania,276,155,105,,260,"(6.171601,-75.427454)"
2022,Agosto,Andorra,20,6,6,,12,"(4.697144,-74.140516)"
2022,Agosto,Andorra,20,2,1,,3,"(6.171601,-75.427454)"
2022,Agosto,Angola,24,2,7,,9,"(4.697144,-74.140516)"
2022,Agosto,Antigua y Barbuda,28,1,0,,1,"(3.541112,-76.384584)"
2022,Agosto,Antigua y Barbuda,28,0,1,,1,"(4.697144,-74.140516)"
2022,Agosto,Antigua y Barbuda,28,1,0,,1,"(6.171601,-75.427454)"
2022,Agosto,Países Bajos,528,0,1,,1,"(10.408582,-75.538003)"
2022,Agosto,Países Bajos,528,237,170,,407,"(10.445761,-75.516429)"
2022,Agosto,Países Bajos,528,14,12,,26,"(10.886611,-74.776708)"
2022,Agosto,Países Bajos,528,125,59,,184,"(3.541112,-76.384584)"
2022,Agosto,Países Bajos,528,1150,938,,2088,"(4.697144,-74.140516)"
2022,Agosto,Países Bajos,528,4,2,,6,"(4.815061,-75.736532)"
2022,Agosto,Países Bajos,528,135,89,,224,"(6.171601,-75.427454)"
2022,Agosto,Países Bajos,528,0,1,,1,"(7.128456,-73.183637)"
2022,Agosto,Países Bajos,528,1,0,,1,"(7.927209,-72.507910)"
2022,Agosto,Arabia Saudita,682,2,5,,7,"(10.445761,-75.516429)"
2022,Agosto,Arabia Saudita,682,2,2,,4,"(3.541112,-76.384584)"
2022,Agosto,Arabia Saudita,682,40,50,,90,"(4.697144,-74.140516)"
2022,Agosto,Arabia Saudita,682,4,7,,11,"(6.171601,-75.427454)"
2022,Agosto,Argelia,12,1,5,,6,"(4.697144,-74.140516)"
2022,Agosto,Argentina,32,2,0,,2,"(0.25129,-76.875963)"
2022,Agosto,Argentina,32,8,12,,20,"(0.814836,-77.662532)"
2022,Agosto,Argentina,32,9,14,,23,"(10.445761,-75.516429)"
2022,Agosto,Argentina,32,34,21,,55,"(10.886611,-74.776708)"
2022,Agosto,Argentina,32,2,8,,10,"(11.117806,-74.232622)"
2022,Agosto,Argentina,32,82,75,,157,"(3.541112,-76.384584)"
2022,Agosto,Argentina,32,3,4,,7,"(4.452882,-75.766298)"
2022,Agosto,Argentina,32,2896,2526,,5422,"(4.697144,-74.140516)"
2022,Agosto,Argentina,32,1,1,,2,"(4.815061,-75.736532)"
2022,Agosto,Argentina,32,264,258,,522,"(6.171601,-75.427454)"
2022,Agosto,Argentina,32,1,2,,3,"(7.128456,-73.183637)"
2022,Agosto,Argentina,32,9,7,,16,"(7.927209,-72.507910)"
2022,Agosto,Aruba,533,0,2,,2,"(10.445761,-75.516429)"
2022,Agosto,Aruba,533,166,84,,250,"(10.886611,-74.776708)"
2022,Agosto,Aruba,533,3,7,,10,"(11.117806,-74.232622)"
2022,Agosto,Aruba,533,83,43,,126,"(3.541112,-76.384584)"
2022,Agosto,Aruba,533,1685,1279,,2964,"(4.697144,-74.140516)"
2022,Agosto,Aruba,533,6,2,,8,"(4.815061,-75.736532)"
2022,Agosto,Aruba,533,216,167,,383,"(6.171601,-75.427454)"
2022,Agosto,Aruba,533,11,50,,61,"(7.128456,-73.183637)"
2022,Agosto,Australia,36,5,4,,9,"(10.445761,-75.516429)"
2022,Agosto,Australia,36,2,5,,7,"(10.886611,-74.776708)"
2022,Agosto,Australia,36,51,44,,95,"(3.541112,-76.384584)"
2022,Agosto,Australia,36,1,0,,1,"(4.452882,-75.766298)"
2022,Agosto,Australia,36,954,900,,1854,"(4.697144,-74.140516)"
2022,Agosto,Australia,36,6,2,,8,"(4.815061,-75.736532)"
2022,Agosto,Australia,36,114,103,,217,"(6.171601,-75.427454)"
2022,Agosto,Australia,36,1,0,,1,"(7.128456,-73.183637)"
2022,Agosto,Austria,40,8,10,,18,"(10.445761,-75.516429)"
2022,Agosto,Austria,40,0,1,,1,"(11.117806,-74.232622)"
2022,Agosto,Austria,40,7,5,,12,"(3.541112,-76.384584)"
2022,Agosto,Austria,40,98,82,,180,"(4.697144,-74.140516)"
2022,Agosto,Austria,40,10,4,,14,"(6.171601,-75.427454)"
2022,Agosto,Azerbaiyán,31,3,2,,5,"(4.697144,-74.140516)"
2022,Agosto,Bahamas,44,1,0,,1,"(10.445761,-75.516429)"
2022,Agosto,Bahamas,44,4,2,,6,"(10.886611,-74.776708)"
2022,Agosto,Bahamas,44,21,7,,28,"(3.541112,-76.384584)"
2022,Agosto,Bahamas,44,19,19,,38,"(4.697144,-74.140516)"
2022,Agosto,Bahamas,44,2,1,,3,"(4.815061,-75.736532)"
2022,Agosto,Bahamas,44,19,18,,37,"(6.171601,-75.427454)"
2022,Agosto,Bahamas,44,1,1,,2,"(7.927209,-72.507910)"
2022,Agosto,Bahréin,48,5,9,,14,"(4.697144,-74.140516)"
2022,Agosto,Bahréin,48,2,0,,2,"(6.171601,-75.427454)"
2022,Agosto,Bangladesh,50,1,2,,3,"(4.697144,-74.140516)"
2022,Agosto,Barbados,52,0,1,,1,"(3.541112,-76.384584)"
2022,Agosto,Barbados,52,16,26,,42,"(4.697144,-74.140516)"
2022,Agosto,Barbados,52,0,1,,1,"(4.815061,-75.736532)"
2022,Agosto,Barbados,52,2,1,,3,"(6.171601,-75.427454)"
2022,Agosto,Bélgica,56,9,9,,18,"(10.445761,-75.516429)"
2022,Agosto,Bélgica,56,2,3,,5,"(10.886611,-74.776708)"
2022,Agosto,Bélgica,56,20,19,,39,"(3.541112,-76.384584)"
2022,Agosto,Bélgica,56,219,151,,370,"(4.697144,-74.140516)"
2022,Agosto,Bélgica,56,78,59,,137,"(6.171601,-75.427454)"
2022,Agosto,Belice,84,0,1,,1,"(10.886611,-74.776708)"
2022,Agosto,Belice,84,7,13,,20,"(4.697144,-74.140516)"
2022,Agosto,Belice,84,0,1,,1,"(4.815061,-75.736532)"
2022,Agosto,Belice,84,0,1,,1,"(6.171601,-75.427454)"
2022,Agosto,Benín,204,0,1,,1,"(10.445761,-75.516429)"
2022,Agosto,Benín,204,1,0,,1,"(4.697144,-74.140516)"
2022,Agosto,Bermudas/Territorio Británico de Ultramar,60,1,0,,1,"(4.697144,-74.140516)"
2022,Agosto,Bermudas/Territorio Británico de Ultramar,60,1,0,,1,"(4.815061,-75.736532)"
2022,Agosto,Bolivia,68,2,3,,5,"(0.814836,-77.662532)"
2022,Agosto,Bolivia,68,1,1,,2,"(10.445761,-75.516429)"
2022,Agosto,Bolivia,68,4,3,,7,"(10.886611,-74.776708)"
2022,Agosto,Bolivia,68,0,2,,2,"(11.117806,-74.232622)"
2022,Agosto,Bolivia,68,22,23,,45,"(3.541112,-76.384584)"
2022,Agosto,Bolivia,68,341,551,,892,"(4.697144,-74.140516)"
2022,Agosto,Bolivia,68,3,18,,21,"(4.815061,-75.736532)"
2022,Agosto,Bolivia,68,19,29,,48,"(6.171601,-75.427454)"
2022,Agosto,Bolivia,68,0,1,,1,"(7.128456,-73.183637)"
2022,Agosto,Bosnia y Herzegovina,70,1,0,,1,"(3.541112,-76.384584)"
2022,Agosto,Bosnia y Herzegovina,70,3,3,,6,"(4.697144,-74.140516)"
2022,Agosto,Brasil,76,240,439,,679,"(-4.197703,-69.941278)"
2022,Agosto,Brasil,76,1,4,,5,"(-4.223468,-69.945098)"
2022,Agosto,Brasil,76,3,5,,8,"(0.814836,-77.662532)"
2022,Agosto,Brasil,76,9,22,,31,"(10.445761,-75.516429)"
2022,Agosto,Brasil,76,18,25,,43,"(10.886611,-74.776708)"
2022,Agosto,Brasil,76,2,1,,3,"(11.117806,-74.232622)"
2022,Agosto,Brasil,76,115,195,,310,"(3.541112,-76.384584)"
2022,Agosto,Brasil,76,28,27,,55,"(4.452882,-75.766298)"
2022,Agosto,Brasil,76,2591,3278,,5869,"(4.697144,-74.140516)"
2022,Agosto,Brasil,76,17,36,,53,"(4.815061,-75.736532)"
2022,Agosto,Brasil,76,445,499,,944,"(6.171601,-75.427454)"
2022,Agosto,Brasil,76,5,6,,11,"(7.128456,-73.183637)"
2022,Agosto,Brasil,76,6,7,,13,"(7.927209,-72.507910)"
2022,Agosto,Bulgaria,100,6,11,,17,"(4.697144,-74.140516)"
2022,Agosto,Burkina Faso,854,0,1,,1,"(10.886611,-74.776708)"
2022,Agosto,Burkina Faso,854,0,2,,2,"(4.697144,-74.140516)"
2022,Agosto,Bután,64,0,1,,1,"(4.697144,-74.140516)"
2022,Agosto,Cabo Verde,132,1,1,,2,"(4.697144,-74.140516)"
2022,Agosto,Islas Caimán/Territorio Británico de Ultramar,136,2,0,,2,"(10.445761,-75.516429)"
2022,Agosto,Islas Caimán/Territorio Británico de Ultramar,136,0,1,,1,"(10.886611,-74.776708)"
2022,Agosto,Islas Caimán/Territorio Británico de Ultramar,136,4,3,,7,"(12.586067,-81.702563)"
2022,Agosto,Islas Caimán/Territorio Británico de Ultramar,136,0,1,,1,"(3.541112,-76.384584)"
2022,Agosto,Islas Caimán/Territorio Británico de Ultramar,136,5,4,,9,"(4.697144,-74.140516)"
2022,Agosto,Islas Caimán/Territorio Británico de Ultramar,136,3,3,,6,"(6.171601,-75.427454)"
2022,Agosto,Camerún,120,0,6,,6,"(4.697144,-74.140516)"
2022,Agosto,Camerún,120,4,5,,9,"(6.171601,-75.427454)"
2022,Agosto,Canadá,124,63,50,,113,"(10.445761,-75.516429)"
2022,Agosto,Canadá,124,76,48,,124,"(10.886611,-74.776708)"
2022,Agosto,Canadá,124,12,5,,17,"(11.117806,-74.232622)"
2022,Agosto,Canadá,124,3,1,,4,"(12.586067,-81.702563)"
2022,Agosto,Canadá,124,164,116,,280,"(3.541112,-76.384584)"
2022,Agosto,Canadá,124,9,10,,19,"(4.452882,-75.766298)"
2022,Agosto,Canadá,124,4428,3695,,8123,"(4.697144,-74.140516)"
2022,Agosto,Canadá,124,6,8,,14,"(4.815061,-75.736532)"
2022,Agosto,Canadá,124,0,1,,1,"(6.17134,-75.427194)"
2022,Agosto,Canadá,124,314,258,,572,"(6.171601,-75.427454)"
2022,Agosto,Canadá,124,14,11,,25,"(7.128456,-73.183637)"
2022,Agosto,Canadá,124,1,3,,4,"(7.927209,-72.507910)"
2022,Agosto,España,724,191,139,,330,"(10.445761,-75.516429)"
2022,Agosto,España,724,19,18,,37,"(10.886611,-74.776708)"
2022,Agosto,España,724,1,1,,2,"(11.117806,-74.232622)"
2022,Agosto,España,724,2598,1870,,4468,"(3.541112,-76.384584)"
2022,Agosto,España,724,1,2,,3,"(4.452882,-75.766298)"
2022,Agosto,España,724,18396,13937,,32333,"(4.697144,-74.140516)"
2022,Agosto,España,724,33,29,,62,"(4.815061,-75.736532)"
2022,Agosto,España,724,2840,2083,,4923,"(6.171601,-75.427454)"
2022,Agosto,España,724,5,2,,7,"(7.128456,-73.183637)"
2022,Agosto,Colombia,170,42,100,,142,"(4.697144,-74.140516)"
2022,Agosto,República Del Congo,178,0,1,,1,"(4.697144,-74.140516)"
2022,Agosto,República Democrática del Congo,180,4,4,,8,"(4.697144,-74.140516)"
2022,Agosto,República Democrática del Congo,180,0,3,,3,"(6.171601,-75.427454)"
2022,Agosto,República de Corea,410,1,1,,2,"(3.541112,-76.384584)"
2022,Agosto,República de Corea,410,51,33,,84,"(4.697144,-74.140516)"
2022,Agosto,República de Corea,410,4,2,,6,"(6.171601,-75.427454)"
2022,Agosto,Costa de Marfil,384,1,2,,3,"(4.697144,-74.140516)"
2022,Agosto,Costa de Marfil,384,3,1,,4,"(6.171601,-75.427454)"
2022,Agosto,Costa Rica,188,37,54,,91,"(10.445761,-75.516429)"
2022,Agosto,Costa Rica,188,4,12,,16,"(10.886611,-74.776708)"
2022,Agosto,Costa Rica,188,7,3,,10,"(11.117806,-74.232622)"
2022,Agosto,Costa Rica,188,5,34,,39,"(12.5744111,-81.703935)"
2022,Agosto,Costa Rica,188,0,1,,1,"(12.586067,-81.702563)"
2022,Agosto,Costa Rica,188,84,72,,156,"(3.541112,-76.384584)"
2022,Agosto,Costa Rica,188,2,2,,4,"(4.452882,-75.766298)"
2022,Agosto,Costa Rica,188,1242,1328,,2570,"(4.697144,-74.140516)"
2022,Agosto,Costa Rica,188,6,7,,13,"(4.815061,-75.736532)"
2022,Agosto,Costa Rica,188,294,267,,561,"(6.171601,-75.427454)"
2022,Agosto,Costa Rica,188,2,3,,5,"(7.128456,-73.183637)"
2022,Agosto,Croacia,191,4,2,,6,"(10.445761,-75.516429)"
2022,Agosto,Croacia,191,1,1,,2,"(3.541112,-76.384584)"
2022,Agosto,Croacia,191,37,50,,87,"(4.697144,-74.140516)"
2022,Agosto,Croacia,191,3,3,,6,"(6.171601,-75.427454)"
2022,Agosto,Cuba,192,1,1,,2,"(10.445761,-75.516429)"
2022,Agosto,Cuba,192,3,11,,14,"(10.886611,-74.776708)"
2022,Agosto,Cuba,192,1,1,,2,"(11.117806,-74.232622)"
2022,Agosto,Cuba,192,17,18,,35,"(3.541112,-76.384584)"
2022,Agosto,Cuba,192,1,2,,3,"(4.452882,-75.766298)"
2022,Agosto,Cuba,192,1091,981,,2072,"(4.697144,-74.140516)"
2022,Agosto,Cuba,192,4,1,,5,"(4.815061,-75.736532)"
2022,Agosto,Cuba,192,53,39,,92,"(6.171601,-75.427454)"
2022,Agosto,Curazao,99999,0,10,,10,"(10.408582,-75.538003)"
2022,Agosto,Curazao,99999,76,50,,126,"(10.886611,-74.776708)"
2022,Agosto,Curazao,99999,23,11,,34,"(3.541112,-76.384584)"
2022,Agosto,Curazao,99999,1286,1039,,2325,"(4.697144,-74.140516)"
2022,Agosto,Curazao,99999,173,100,,273,"(6.171601,-75.427454)"
2022,Agosto,Curazao,99999,0,1,,1,"(7.128456,-73.183637)"
2022,Agosto,República Checa,203,3,1,,4,"(10.445761,-75.516429)"
2022,Agosto,República Checa,203,0,2,,2,"(3.541112,-76.384584)"
2022,Agosto,República Checa,203,32,23,,55,"(4.697144,-74.140516)"
2022,Agosto,República Checa,203,1,1,,2,"(7.128456,-73.183637)"
2022,Agosto,Chile,152,1,1,,2,"(0.25129,-76.875963)"
2022,Agosto,Chile,152,35,43,,78,"(0.814836,-77.662532)"
2022,Agosto,Chile,152,21,14,,35,"(10.445761,-75.516429)"
2022,Agosto,Chile,152,51,24,,75,"(10.886611,-74.776708)"
2022,Agosto,Chile,152,8,6,,14,"(11.117806,-74.232622)"
2022,Agosto,Chile,152,2461,1749,,4210,"(3.541112,-76.384584)"
2022,Agosto,Chile,152,34,19,,53,"(4.452882,-75.766298)"
2022,Agosto,Chile,152,4113,3666,,7779,"(4.697144,-74.140516)"
2022,Agosto,Chile,152,24,20,,44,"(4.815061,-75.736532)"
2022,Agosto,Chile,152,466,362,,828,"(6.171601,-75.427454)"
2022,Agosto,Chile,152,14,4,,18,"(7.128456,-73.183637)"
2022,Agosto,Chile,152,15,2,,17,"(7.927209,-72.507910)"
2022,Agosto,China,156,1,0,,1,"(10.886611,-74.776708)"
2022,Agosto,China,156,1,0,,1,"(3.541112,-76.384584)"
2022,Agosto,China,156,11,17,,28,"(4.697144,-74.140516)"
2022,Agosto,Chipre,196,4,1,,5,"(4.697144,-74.140516)"
2022,Agosto,Chipre,196,4,3,,7,"(6.171601,-75.427454)"
2022,Agosto,Dinamarca,208,5,1,,6,"(10.445761,-75.516429)"
2022,Agosto,Dinamarca,208,2,1,,3,"(10.886611,-74.776708)"
2022,Agosto,Dinamarca,208,5,7,,12,"(3.541112,-76.384584)"
2022,Agosto,Dinamarca,208,81,82,,163,"(4.697144,-74.140516)"
2022,Agosto,Dinamarca,208,1,1,,2,"(4.815061,-75.736532)"
2022,Agosto,Dinamarca,208,12,3,,15,"(6.171601,-75.427454)"
2022,Agosto,Dominica,212,1,1,,2,"(10.445761,-75.516429)"
2022,Agosto,Dominica,212,3,3,,6,"(4.697144,-74.140516)"
2022,Agosto,Dominica,212,2,4,,6,"(6.171601,-75.427454)"
2022,Agosto,Ecuador,218,0,1,,1,"(-0.193180,-74.784874)"
2022,Agosto,Ecuador,218,406,517,,923,"(0.25129,-76.875963)"
2022,Agosto,Ecuador,218,6,12,,18,"(0.812436,-77.847006)"
2022,Agosto,Ecuador,218,3621,4404,,8025,"(0.814836,-77.662532)"
2022,Agosto,Ecuador,218,31,45,,76,"(1.813928,-78.763924)"
2022,Agosto,Ecuador,218,23,28,,51,"(10.445761,-75.516429)"
2022,Agosto,Ecuador,218,15,18,,33,"(10.886611,-74.776708)"
2022,Agosto,Ecuador,218,1,1,,2,"(11.117806,-74.232622)"
2022,Agosto,Ecuador,218,0,1,,1,"(12.586067,-81.702563)"
2022,Agosto,Ecuador,218,113,108,,221,"(3.541112,-76.384584)"
2022,Agosto,Ecuador,218,1,1,,2,"(4.452882,-75.766298)"
2022,Agosto,Ecuador,218,3030,4144,,7174,"(4.697144,-74.140516)"
2022,Agosto,Ecuador,218,5,14,,19,"(4.815061,-75.736532)"
2022,Agosto,Ecuador,218,152,217,,369,"(6.171601,-75.427454)"
2022,Agosto,Ecuador,218,1,5,,6,"(7.128456,-73.183637)"
2022,Agosto,Ecuador,218,0,1,,1,"(7.927209,-72.507910)"
2022,Agosto,Egipto,818,6,1,,7,"(3.541112,-76.384584)"
2022,Agosto,Egipto,818,85,57,,142,"(4.697144,-74.140516)"
2022,Agosto,Egipto,818,2,0,,2,"(6.171601,-75.427454)"
2022,Agosto,El Salvador,222,13,17,,30,"(10.445761,-75.516429)"
2022,Agosto,El Salvador,222,2,8,,10,"(10.886611,-74.776708)"
2022,Agosto,El Salvador,222,1,0,,1,"(12.586067,-81.702563)"
2022,Agosto,El Salvador,222,14,22,,36,"(3.541112,-76.384584)"
2022,Agosto,El Salvador,222,445,555,,1000,"(4.697144,-74.140516)"
2022,Agosto,El Salvador,222,3,1,,4,"(4.815061,-75.736532)"
2022,Agosto,El Salvador,222,36,62,,98,"(6.171601,-75.427454)"
2022,Agosto,El Salvador,222,1,1,,2,"(7.128456,-73.183637)"
2022,Agosto,Emiratos Árabes,784,6,16,,22,"(10.445761,-75.516429)"
2022,Agosto,Emiratos Árabes,784,2,1,,3,"(10.886611,-74.776708)"
2022,Agosto,Emiratos Árabes,784,11,6,,17,"(3.541112,-76.384584)"
2022,Agosto,Emiratos Árabes,784,0,2,,2,"(4.452882,-75.766298)"
2022,Agosto,Emiratos Árabes,784,197,282,,479,"(4.697144,-74.140516)"
2022,Agosto,Emiratos Árabes,784,23,14,,37,"(6.171601,-75.427454)"
2022,Agosto,Eritrea,232,1,0,,1,"(4.697144,-74.140516)"
2022,Agosto,Eslovaquia,703,2,4,,6,"(4.697144,-74.140516)"
2022,Agosto,Eslovaquia,703,1,0,,1,"(6.171601,-75.427454)"
2022,Agosto,Eslovenia,705,4,2,,6,"(4.697144,-74.140516)"
2022,Agosto,Eslovenia,705,0,1,,1,"(6.171601,-75.427454)"
2022,Agosto,Estados Unidos de América,840,3215,2335,,5550,"(10.445761,-75.516429)"
2022,Agosto,Estados Unidos de América,840,4384,3265,,7649,"(10.886611,-74.776708)"
2022,Agosto,Estados Unidos de América,840,81,63,,144,"(11.117806,-74.232622)"
2022,Agosto,Estados Unidos de América,840,159,115,,274,"(12.586067,-81.702563)"
2022,Agosto,Estados Unidos de América,840,11678,8181,,19860,"(3.541112,-76.384584)"
2022,Agosto,Estados Unidos de América,840,1544,1106,,2650,"(4.452882,-75.766298)"
2022,Agosto,Estados Unidos de América,840,36320,29784,,66104,"(4.697144,-74.140516)"
2022,Agosto,Estados Unidos de América,840,2033,1322,,3355,"(4.815061,-75.736532)"
2022,Agosto,Estados Unidos de América,840,17186,12956,,30142,"(6.171601,-75.427454)"
2022,Agosto,Estados Unidos de América,840,1036,757,,1793,"(7.128456,-73.183637)"
2022,Agosto,Estados Unidos de América,840,83,77,,160,"(7.927209,-72.507910)"
2022,Agosto,Estonia,233,1,1,,2,"(10.886611,-74.776708)"
2022,Agosto,Estonia,233,8,8,,16,"(4.697144,-74.140516)"
2022,Agosto,Estonia,233,0,2,,2,"(6.171601,-75.427454)"
2022,Agosto,Etiopia,231,0,4,,4,"(4.697144,-74.140516)"
2022,Agosto,Islas Fiji,242,1,0,,1,"(4.697144,-74.140516)"
2022,Agosto,Filipinas,608,14,9,,23,"(4.697144,-74.140516)"
2022,Agosto,Filipinas,608,1,0,,1,"(6.171601,-75.427454)"
2022,Agosto,Finlandia,246,1,1,,2,"(10.445761,-75.516429)"
2022,Agosto,Finlandia,246,1,2,,3,"(3.541112,-76.384584)"
2022,Agosto,Finlandia,246,14,16,,30,"(4.697144,-74.140516)"
2022,Agosto,Finlandia,246,4,2,,6,"(6.171601,-75.427454)"
2022,Agosto,Francia,250,41,19,,60,"(10.445761,-75.516429)"
2022,Agosto,Francia,250,7,0,,7,"(10.886611,-74.776708)"
2022,Agosto,Francia,250,148,80,,228,"(3.541112,-76.384584)"
2022,Agosto,Francia,250,1,2,,3,"(4.452882,-75.766298)"
2022,Agosto,Francia,250,2883,1979,,4862,"(4.697144,-74.140516)"
2022,Agosto,Francia,250,11,9,,20,"(4.815061,-75.736532)"
2022,Agosto,Francia,250,203,127,,330,"(6.171601,-75.427454)"
2022,Agosto,Francia,250,1,2,,3,"(7.128456,-73.183637)"
2022,Agosto,Gabón,266,0,3,,3,"(4.697144,-74.140516)"
2022,Agosto,Georgia,268,2,0,,2,"(10.886611,-74.776708)"
2022,Agosto,Georgia,268,2,1,,3,"(3.541112,-76.384584)"
2022,Agosto,Georgia,268,7,8,,15,"(4.697144,-74.140516)"
2022,Agosto,Georgia,268,0,1,,1,"(6.171601,-75.427454)"
2022,Agosto,Ghana,288,1,4,,5,"(4.697144,-74.140516)"
2022,Agosto,Gibraltar/Territorio Británico de Ultramar,292,0,1,,1,"(4.697144,-74.140516)"
2022,Agosto,Granada,308,1,0,,1,"(4.697144,-74.140516)"
2022,Agosto,Grecia,300,4,0,,4,"(10.445761,-75.516429)"
2022,Agosto,Grecia,300,4,0,,4,"(3.541112,-76.384584)"
2022,Agosto,Grecia,300,70,44,,114,"(4.697144,-74.140516)"
2022,Agosto,Grecia,300,12,1,,13,"(6.171601,-75.427454)"
2022,Agosto,Guatemala,320,7,6,,13,"(10.445761,-75.516429)"
2022,Agosto,Guatemala,320,9,14,,23,"(10.886611,-74.776708)"
2022,Agosto,Guatemala,320,0,1,,1,"(11.117806,-74.232622)"
2022,Agosto,Guatemala,320,66,81,,147,"(3.541112,-76.384584)"
2022,Agosto,Guatemala,320,8,7,,15,"(4.452882,-75.766298)"
2022,Agosto,Guatemala,320,542,759,,1301,"(4.697144,-74.140516)"
2022,Agosto,Guatemala,320,8,8,,16,"(4.815061,-75.736532)"
2022,Agosto,Guatemala,320,122,130,,252,"(6.171601,-75.427454)"
2022,Agosto,Guatemala,320,1,6,,7,"(7.128456,-73.183637)"
2022,Agosto,Guatemala,320,0,2,,2,"(7.927209,-72.507910)"
2022,Agosto,Guyana,328,0,2,,2,"(10.445761,-75.516429)"
2022,Agosto,Guyana,328,3,4,,7,"(10.886611,-74.776708)"
2022,Agosto,Guyana,328,2,2,,4,"(3.541112,-76.384584)"
2022,Agosto,Guyana,328,1,2,,3,"(4.452882,-75.766298)"
2022,Agosto,Guyana,328,10,32,,42,"(4.697144,-74.140516)"
2022,Agosto,Guyana,328,0,1,,1,"(4.815061,-75.736532)"
2022,Agosto,Guyana,328,2,5,,7,"(6.171601,-75.427454)"
2022,Agosto,Guinea Ecuatorial,226,1,1,,2,"(4.697144,-74.140516)"
2022,Agosto,Guadalupe/Territorio Francés,312,7,0,,7,"(3.541112,-76.384584)"
2022,Agosto,Guadalupe/Territorio Francés,312,0,1,,1,"(4.697144,-74.140516)"
2022,Agosto,Guam/Territorio no incorporado de Estados Unidos,316,2,1,,3,"(4.697144,-74.140516)"
2022,Agosto,Guayana Francesa/Departamento de Ultramar Francés,254,1,2,,3,"(4.697144,-74.140516)"
2022,Agosto,Guayana Francesa/Departamento de Ultramar Francés,254,5,5,,10,"(6.171601,-75.427454)"
2022,Agosto,Haití,332,0,2,,2,"(10.886611,-74.776708)"
2022,Agosto,Haití,332,0,3,,3,"(4.697144,-74.140516)"
2022,Agosto,Honduras,340,5,9,,14,"(10.445761,-75.516429)"
2022,Agosto,Honduras,340,12,17,,29,"(10.886611,-74.776708)"
2022,Agosto,Honduras,340,0,1,,1,"(12.5744111,-81.703935)"
2022,Agosto,Honduras,340,19,31,,50,"(3.541112,-76.384584)"
2022,Agosto,Honduras,340,72,146,,218,"(4.697144,-74.140516)"
2022,Agosto,Honduras,340,3,7,,10,"(4.815061,-75.736532)"
2022,Agosto,Honduras,340,32,54,,86,"(6.171601,-75.427454)"
2022,Agosto,Honduras,340,2,6,,8,"(7.128456,-73.183637)"
2022,Agosto,Hong Kong,344,4,7,,11,"(4.697144,-74.140516)"
2022,Agosto,Hungría,348,2,3,,5,"(10.445761,-75.516429)"
2022,Agosto,Hungría,348,2,1,,3,"(3.541112,-76.384584)"
2022,Agosto,Hungría,348,22,20,,42,"(4.697144,-74.140516)"
2022,Agosto,Hungría,348,4,2,,6,"(6.171601,-75.427454)"
2022,Agosto,India,356,6,0,,6,"(3.541112,-76.384584)"
2022,Agosto,India,356,20,28,,48,"(4.697144,-74.140516)"
2022,Agosto,India,356,11,4,,15,"(6.171601,-75.427454)"
2022,Agosto,Indonesia,360,2,1,,3,"(10.445761,-75.516429)"
2022,Agosto,Indonesia,360,15,12,,27,"(4.697144,-74.140516)"
2022,Agosto,Indonesia,360,1,0,,1,"(6.171601,-75.427454)"
2022,Agosto,Iraq,368,0,1,,1,"(4.452882,-75.766298)"
2022,Agosto,Iraq,368,1,8,,9,"(4.697144,-74.140516)"
2022,Agosto,Irán,364,1,2,,3,"(4.697144,-74.140516)"
2022,Agosto,República de Irlanda,372,5,0,,5,"(10.445761,-75.516429)"
2022,Agosto,República de Irlanda,372,1,0,,1,"(10.886611,-74.776708)"
2022,Agosto,República de Irlanda,372,2,1,,3,"(3.541112,-76.384584)"
2022,Agosto,República de Irlanda,372,34,26,,60,"(4.697144,-74.140516)"
2022,Agosto,República de Irlanda,372,5,3,,8,"(6.171601,-75.427454)"
2022,Agosto,Islandia,352,0,2,,2,"(10.445761,-75.516429)"
2022,Agosto,Islandia,352,0,1,,1,"(3.541112,-76.384584)"
2022,Agosto,Islandia,352,6,9,,15,"(4.697144,-74.140516)"
2022,Agosto,Islandia,352,0,1,,1,"(6.171601,-75.427454)"
2022,Agosto,Israel,376,2,0,,2,"(10.445761,-75.516429)"
2022,Agosto,Israel,376,1,1,,2,"(10.886611,-74.776708)"
2022,Agosto,Israel,376,7,2,,9,"(3.541112,-76.384584)"
2022,Agosto,Israel,376,2,0,,2,"(4.452882,-75.766298)"
2022,Agosto,Israel,376,173,118,,291,"(4.697144,-74.140516)"
2022,Agosto,Israel,376,9,4,,13,"(6.171601,-75.427454)"
2022,Agosto,Italia,380,61,22,,83,"(10.445761,-75.516429)"
2022,Agosto,Italia,380,5,3,,8,"(10.886611,-74.776708)"
2022,Agosto,Italia,380,0,3,,3,"(11.117806,-74.232622)"
2022,Agosto,Italia,380,113,51,,164,"(3.541112,-76.384584)"
2022,Agosto,Italia,380,925,627,,1552,"(4.697144,-74.140516)"
2022,Agosto,Italia,380,4,3,,7,"(4.815061,-75.736532)"
2022,Agosto,Italia,380,151,79,,230,"(6.171601,-75.427454)"
2022,Agosto,Jamaica,388,1,6,,7,"(10.445761,-75.516429)"
2022,Agosto,Jamaica,388,1,5,,6,"(10.886611,-74.776708)"
2022,Agosto,Jamaica,388,1,2,,3,"(11.117806,-74.232622)"
2022,Agosto,Jamaica,388,1,0,,1,"(12.586067,-81.702563)"
2022,Agosto,Jamaica,388,9,8,,17,"(3.541112,-76.384584)"
2022,Agosto,Jamaica,388,24,39,,63,"(4.697144,-74.140516)"
2022,Agosto,Jamaica,388,3,5,,8,"(4.815061,-75.736532)"
2022,Agosto,Jamaica,388,8,5,,13,"(6.171601,-75.427454)"
2022,Agosto,Japón,392,0,1,,1,"(10.886611,-74.776708)"
2022,Agosto,Japón,392,2,3,,5,"(3.541112,-76.384584)"
2022,Agosto,Japón,392,45,30,,75,"(4.697144,-74.140516)"
2022,Agosto,Japón,392,4,0,,4,"(6.171601,-75.427454)"
2022,Agosto,Jordania,400,0,1,,1,"(10.445761,-75.516429)"
2022,Agosto,Jordania,400,3,5,,8,"(4.697144,-74.140516)"
2022,Agosto,Jordania,400,1,0,,1,"(6.171601,-75.427454)"
2022,Agosto,Kazajistán,398,3,2,,5,"(4.697144,-74.140516)"
2022,Agosto,Kenia,404,1,1,,2,"(3.541112,-76.384584)"
2022,Agosto,Kenia,404,19,7,,26,"(4.697144,-74.140516)"
2022,Agosto,Kenia,404,1,2,,3,"(6.171601,-75.427454)"
2022,Agosto,Kirguistán,417,1,1,,2,"(4.697144,-74.140516)"
2022,Agosto,Kuwait,414,0,1,,1,"(10.445761,-75.516429)"
2022,Agosto,Kuwait,414,8,5,,13,"(4.697144,-74.140516)"
2022,Agosto,Kuwait,414,3,0,,3,"(6.171601,-75.427454)"
2022,Agosto,República de Kosovo,901,0,1,,1,"(4.697144,-74.140516)"
2022,Agosto,República Democrática Popular  Lao,418,1,0,,1,"(4.697144,-74.140516)"
2022,Agosto,Letonia,428,1,1,,2,"(10.445761,-75.516429)"
2022,Agosto,Letonia,428,0,2,,2,"(4.697144,-74.140516)"
2022,Agosto,Lituania,440,1,0,,1,"(10.886611,-74.776708)"
2022,Agosto,Lituania,440,3,4,,7,"(4.697144,-74.140516)"
2022,Agosto,Lituania,440,1,0,,1,"(6.171601,-75.427454)"
2022,Agosto,Líbano,422,1,1,,2,"(10.445761,-75.516429)"
2022,Agosto,Líbano,422,0,2,,2,"(3.541112,-76.384584)"
2022,Agosto,Líbano,422,5,13,,18,"(4.697144,-74.140516)"
2022,Agosto,Líbano,422,0,1,,1,"(6.171601,-75.427454)"
2022,Agosto,Liberia,430,3,1,,4,"(4.697144,-74.140516)"
2022,Agosto,Luxemburgo,442,1,1,,2,"(10.445761,-75.516429)"
2022,Agosto,Luxemburgo,442,2,1,,3,"(3.541112,-76.384584)"
2022,Agosto,Luxemburgo,442,29,7,,36,"(4.697144,-74.140516)"
2022,Agosto,Luxemburgo,442,1,2,,3,"(6.171601,-75.427454)"
2022,Agosto,Macao,446,0,1,,1,"(6.171601,-75.427454)"
2022,Agosto,Malasia,458,8,8,,16,"(4.697144,-74.140516)"
2022,Agosto,Maldivas,462,2,2,,4,"(4.697144,-74.140516)"
2022,Agosto,Malí,466,0,1,,1,"(6.171601,-75.427454)"
2022,Agosto,Malta,470,0,2,,2,"(0.814836,-77.662532)"
2022,Agosto,Malta,470,2,3,,5,"(10.445761,-75.516429)"
2022,Agosto,Malta,470,1,1,,2,"(3.541112,-76.384584)"
2022,Agosto,Malta,470,88,93,,181,"(4.697144,-74.140516)"
2022,Agosto,Malta,470,5,5,,10,"(6.171601,-75.427454)"
2022,Agosto,Marruecos,504,0,1,,1,"(10.445761,-75.516429)"
2022,Agosto,Marruecos,504,13,12,,25,"(4.697144,-74.140516)"
2022,Agosto,Mauritania,478,0,2,,2,"(4.697144,-74.140516)"
2022,Agosto,Martinica/Departamento de Ultramar Francés,474,0,1,,1,"(3.541112,-76.384584)"
2022,Agosto,Martinica/Departamento de Ultramar Francés,474,1,0,,1,"(4.697144,-74.140516)"
2022,Agosto,Martinica/Departamento de Ultramar Francés,474,1,0,,1,"(4.815061,-75.736532)"
2022,Agosto,México,484,1,0,,1,"(0.814836,-77.662532)"
2022,Agosto,México,484,282,283,,565,"(10.445761,-75.516429)"
2022,Agosto,México,484,411,356,,767,"(10.886611,-74.776708)"
2022,Agosto,México,484,14,12,,26,"(11.117806,-74.232622)"
2022,Agosto,México,484,0,1,,1,"(12.586067,-81.702563)"
2022,Agosto,México,484,4091,3599,,7690,"(3.541112,-76.384584)"
2022,Agosto,México,484,8,13,,21,"(4.452882,-75.766298)"
2022,Agosto,México,484,22923,22401,,45324,"(4.697144,-74.140516)"
2022,Agosto,México,484,257,192,,449,"(4.815061,-75.736532)"
2022,Agosto,México,484,1,3,,4,"(6.17134,-75.427194)"
2022,Agosto,México,484,8128,6748,,14876,"(6.171601,-75.427454)"
2022,Agosto,México,484,147,129,,276,"(7.128456,-73.183637)"
2022,Agosto,México,484,38,29,,67,"(7.927209,-72.507910)"
2022,Agosto,Mayotte/Colectividad Territorial Francesa,175,0,1,,1,"(4.697144,-74.140516)"
2022,Agosto,Mónaco,492,1,0,,1,"(6.171601,-75.427454)"
2022,Agosto,Mongolia,496,2,1,,3,"(4.697144,-74.140516)"
2022,Agosto,Micronesia,583,2,5,,7,"(4.697144,-74.140516)"
2022,Agosto,Micronesia,583,0,1,,1,"(6.171601,-75.427454)"
2022,Agosto,Mozambique,508,1,0,,1,"(4.697144,-74.140516)"
2022,Agosto,Namibia,516,1,1,,2,"(6.171601,-75.427454)"
2022,Agosto,Nepal,524,17,5,,22,"(4.697144,-74.140516)"
2022,Agosto,Nicaragua,558,1,3,,4,"(10.445761,-75.516429)"
2022,Agosto,Nicaragua,558,0,2,,2,"(10.886611,-74.776708)"
2022,Agosto,Nicaragua,558,1,15,,16,"(12.5744111,-81.703935)"
2022,Agosto,Nicaragua,558,0,2,,2,"(12.586067,-81.702563)"
2022,Agosto,Nicaragua,558,5,13,,18,"(3.541112,-76.384584)"
2022,Agosto,Nicaragua,558,23,66,,89,"(4.697144,-74.140516)"
2022,Agosto,Nicaragua,558,0,2,,2,"(4.815061,-75.736532)"
2022,Agosto,Nicaragua,558,20,38,,58,"(6.171601,-75.427454)"
2022,Agosto,Nicaragua,558,0,2,,2,"(7.128456,-73.183637)"
2022,Agosto,Nigeria,566,0,5,,5,"(4.697144,-74.140516)"
2022,Agosto,Noruega,578,7,2,,9,"(10.445761,-75.516429)"
2022,Agosto,Noruega,578,5,10,,15,"(3.541112,-76.384584)"
2022,Agosto,Noruega,578,56,46,,102,"(4.697144,-74.140516)"
2022,Agosto,Noruega,578,3,5,,8,"(6.171601,-75.427454)"
2022,Agosto,Nueva Caledonia/Territorio francés,540,1,0,,1,"(4.697144,-74.140516)"
2022,Agosto,Nueva Zelanda,554,35,21,,56,"(4.697144,-74.140516)"
2022,Agosto,Nueva Zelanda,554,2,2,,4,"(6.171601,-75.427454)"
2022,Agosto,Omán,512,10,19,,29,"(4.697144,-74.140516)"
2022,Agosto,Papúa Nueva Guinea,598,2,0,,2,"(10.445761,-75.516429)"
2022,Agosto,Papúa Nueva Guinea,598,1,1,,2,"(4.697144,-74.140516)"
2022,Agosto,Papúa Nueva Guinea,598,0,1,,1,"(6.171601,-75.427454)"
2022,Agosto,Pakistán,586,0,1,,1,"(4.697144,-74.140516)"
2022,Agosto,Palau,585,1,0,,1,"(4.697144,-74.140516)"
2022,Agosto,Panamá,591,19,60,,79,"(10.408582,-75.538003)"
2022,Agosto,Panamá,591,1216,946,,2162,"(10.445761,-75.516429)"
2022,Agosto,Panamá,591,755,706,,1461,"(10.886611,-74.776708)"
2022,Agosto,Panamá,591,0,2,,2,"(10.971302,-74.765397)"
2022,Agosto,Panamá,591,52,36,,88,"(11.117806,-74.232622)"
2022,Agosto,Panamá,591,0,1,,1,"(12.165168,-71.983761)"
2022,Agosto,Panamá,591,1,16,,17,"(12.5744111,-81.703935)"
2022,Agosto,Panamá,591,19,27,,46,"(12.586067,-81.702563)"
2022,Agosto,Panamá,591,2420,1949,,4369,"(3.541112,-76.384584)"
2022,Agosto,Panamá,591,0,14,,14,"(3.893038,-77.067921)"
2022,Agosto,Panamá,591,127,80,,207,"(4.452882,-75.766298)"
2022,Agosto,Panamá,591,6772,7300,,14072,"(4.697144,-74.140516)"
2022,Agosto,Panamá,591,257,182,,439,"(4.815061,-75.736532)"
2022,Agosto,Panamá,591,2,11,,13,"(6.17134,-75.427194)"
2022,Agosto,Panamá,591,2631,2563,,5194,"(6.171601,-75.427454)"
2022,Agosto,Panamá,591,19,15,,34,"(7.102626,-77.762647)"
2022,Agosto,Panamá,591,123,94,,217,"(7.128456,-73.183637)"
2022,Agosto,Panamá,591,81,67,,148,"(7.927209,-72.507910)"
2022,Agosto,Panamá,591,34,55,,89,"(8.635765,-77.346578)"
2022,Agosto,Paraguay,600,3,7,,10,"(10.445761,-75.516429)"
2022,Agosto,Paraguay,600,3,7,,10,"(10.886611,-74.776708)"
2022,Agosto,Paraguay,600,0,2,,2,"(11.117806,-74.232622)"
2022,Agosto,Paraguay,600,29,42,,71,"(3.541112,-76.384584)"
2022,Agosto,Paraguay,600,1,2,,3,"(4.452882,-75.766298)"
2022,Agosto,Paraguay,600,195,286,,481,"(4.697144,-74.140516)"
2022,Agosto,Paraguay,600,14,13,,27,"(4.815061,-75.736532)"
2022,Agosto,Paraguay,600,16,20,,36,"(6.171601,-75.427454)"
2022,Agosto,Paraguay,600,1,1,,2,"(7.128456,-73.183637)"
2022,Agosto,Paraguay,600,3,0,,3,"(7.927209,-72.507910)"
2022,Agosto,Perú,604,5,9,,14,"(-0.193180,-74.784874)"
2022,Agosto,Perú,604,150,210,,360,"(-4.197703,-69.941278)"
2022,Agosto,Perú,604,14,28,,42,"(-4.223468,-69.945098)"
2022,Agosto,Perú,604,1,6,,7,"(0.25129,-76.875963)"
2022,Agosto,Perú,604,57,81,,138,"(0.814836,-77.662532)"
2022,Agosto,Perú,604,50,61,,111,"(10.445761,-75.516429)"
2022,Agosto,Perú,604,18,30,,48,"(10.886611,-74.776708)"
2022,Agosto,Perú,604,1,2,,3,"(11.117806,-74.232622)"
2022,Agosto,Perú,604,0,1,,1,"(12.586067,-81.702563)"
2022,Agosto,Perú,604,254,244,,498,"(3.541112,-76.384584)"
2022,Agosto,Perú,604,2,1,,3,"(4.452882,-75.766298)"
2022,Agosto,Perú,604,4509,4995,,9504,"(4.697144,-74.140516)"
2022,Agosto,Perú,604,7,7,,14,"(4.815061,-75.736532)"
2022,Agosto,Perú,604,921,927,,1848,"(6.171601,-75.427454)"
2022,Agosto,Perú,604,3,1,,4,"(7.128456,-73.183637)"
2022,Agosto,Palestina,99999,1,3,,4,"(4.697144,-74.140516)"
2022,Agosto,Polonia,616,1,1,,2,"(10.445761,-75.516429)"
2022,Agosto,Polonia,616,1,1,,2,"(10.886611,-74.776708)"
2022,Agosto,Polonia,616,3,2,,5,"(3.541112,-76.384584)"
2022,Agosto,Polonia,616,39,110,,149,"(4.697144,-74.140516)"
2022,Agosto,Polonia,616,2,0,,2,"(4.815061,-75.736532)"
2022,Agosto,Polonia,616,3,3,,6,"(6.171601,-75.427454)"
2022,Agosto,Portugal,620,3,2,,5,"(10.445761,-75.516429)"
2022,Agosto,Portugal,620,1,2,,3,"(10.886611,-74.776708)"
2022,Agosto,Portugal,620,7,4,,11,"(3.541112,-76.384584)"
2022,Agosto,Portugal,620,172,187,,359,"(4.697144,-74.140516)"
2022,Agosto,Portugal,620,46,58,,104,"(6.171601,-75.427454)"
2022,Agosto,Polinesia Francesa/Colectividad de Ultramar Francesa,258,1,2,,3,"(4.697144,-74.140516)"
2022,Agosto,Puerto Rico/Territorio de Estados Unidos,630,7,6,,13,"(10.445761,-75.516429)"
2022,Agosto,Puerto Rico/Territorio de Estados Unidos,630,1,5,,6,"(10.886611,-74.776708)"
2022,Agosto,Puerto Rico/Territorio de Estados Unidos,630,2,2,,4,"(11.117806,-74.232622)"
2022,Agosto,Puerto Rico/Territorio de Estados Unidos,630,38,28,,66,"(3.541112,-76.384584)"
2022,Agosto,Puerto Rico/Territorio de Estados Unidos,630,2,0,,2,"(4.452882,-75.766298)"
2022,Agosto,Puerto Rico/Territorio de Estados Unidos,630,398,400,,798,"(4.697144,-74.140516)"
2022,Agosto,Puerto Rico/Territorio de Estados Unidos,630,0,1,,1,"(4.815061,-75.736532)"
2022,Agosto,Puerto Rico/Territorio de Estados Unidos,630,3,2,,5,"(6.17134,-75.427194)"
2022,Agosto,Puerto Rico/Territorio de Estados Unidos,630,34,35,,69,"(6.171601,-75.427454)"
2022,Agosto,Puerto Rico/Territorio de Estados Unidos,630,1,0,,1,"(7.128456,-73.183637)"
2022,Agosto,Puerto Rico/Territorio de Estados Unidos,630,2,1,,3,"(7.927209,-72.507910)"
2022,Agosto,Qatar,634,2,4,,6,"(10.445761,-75.516429)"
2022,Agosto,Qatar,634,0,1,,1,"(10.886611,-74.776708)"
2022,Agosto,Qatar,634,1,0,,1,"(3.541112,-76.384584)"
2022,Agosto,Qatar,634,41,36,,77,"(4.697144,-74.140516)"
2022,Agosto,Qatar,634,8,7,,15,"(6.171601,-75.427454)"
2022,Agosto,Reino Unido de Gran Bretaña e Irlanda del Norte,826,11,5,,16,"(10.445761,-75.516429)"
2022,Agosto,Reino Unido de Gran Bretaña e Irlanda del Norte,826,2,1,,3,"(10.886611,-74.776708)"
2022,Agosto,Reino Unido de Gran Bretaña e Irlanda del Norte,826,1,0,,1,"(12.586067,-81.702563)"
2022,Agosto,Reino Unido de Gran Bretaña e Irlanda del Norte,826,162,98,,260,"(3.541112,-76.384584)"
2022,Agosto,Reino Unido de Gran Bretaña e Irlanda del Norte,826,1921,1292,,3213,"(4.697144,-74.140516)"
2022,Agosto,Reino Unido de Gran Bretaña e Irlanda del Norte,826,10,9,,19,"(4.815061,-75.736532)"
2022,Agosto,Reino Unido de Gran Bretaña e Irlanda del Norte,826,98,62,,160,"(6.171601,-75.427454)"
2022,Agosto,República CentroÁfricana,140,1,0,,1,"(4.697144,-74.140516)"
2022,Agosto,Federación de Rusia,643,1,1,,2,"(3.541112,-76.384584)"
2022,Agosto,Federación de Rusia,643,27,30,,57,"(4.697144,-74.140516)"
2022,Agosto,Federación de Rusia,643,1,0,,1,"(6.171601,-75.427454)"
2022,Agosto,República Dominicana,214,48,65,,113,"(10.445761,-75.516429)"
2022,Agosto,República Dominicana,214,141,128,,269,"(10.886611,-74.776708)"
2022,Agosto,República Dominicana,214,6,9,,15,"(11.117806,-74.232622)"
2022,Agosto,República Dominicana,214,7,7,,14,"(12.586067,-81.702563)"
2022,Agosto,República Dominicana,214,722,572,,1294,"(3.541112,-76.384584)"
2022,Agosto,República Dominicana,214,2,1,,3,"(4.452882,-75.766298)"
2022,Agosto,República Dominicana,214,6291,5284,,11576,"(4.697144,-74.140516)"
2022,Agosto,República Dominicana,214,100,74,,174,"(4.815061,-75.736532)"
2022,Agosto,República Dominicana,214,5878,4379,,10257,"(6.171601,-75.427454)"
2022,Agosto,República Dominicana,214,24,29,,53,"(7.128456,-73.183637)"
2022,Agosto,República Dominicana,214,2,5,,7,"(7.927209,-72.507910)"
2022,Agosto,Reunión,638,0,1,,1,"(4.697144,-74.140516)"
2022,Agosto,República Democrática Popular de Corea,408,1,0,,1,"(4.697144,-74.140516)"
2022,Agosto,Rumania,642,3,4,,7,"(3.541112,-76.384584)"
2022,Agosto,Rumania,642,9,9,,18,"(4.697144,-74.140516)"
2022,Agosto,Rumania,642,0,1,,1,"(6.171601,-75.427454)"
2022,Agosto,Rwanda,646,1,1,,2,"(4.697144,-74.140516)"
2022,Agosto,San Cristóbal y Nevis,659,8,6,,14,"(7.818934,-72.453226)"
2022,Agosto,Samoa Occidental,882,1,0,,1,"(4.697144,-74.140516)"
2022,Agosto,San Marino,674,1,0,,1,"(3.541112,-76.384584)"
2022,Agosto,San Marino,674,0,3,,3,"(4.697144,-74.140516)"
2022,Agosto,San  Vicente y las Granadinas,670,0,2,,2,"(4.697144,-74.140516)"
2022,Agosto,Santa Lucia,662,0,2,,2,"(4.697144,-74.140516)"
2022,Agosto,Santa Sede/Ciudad del Vaticano,336,1,0,,1,"(4.697144,-74.140516)"
2022,Agosto,Senegal,686,0,1,,1,"(3.541112,-76.384584)"
2022,Agosto,Senegal,686,2,2,,4,"(4.697144,-74.140516)"
2022,Agosto,Serbia,688,2,5,,7,"(4.697144,-74.140516)"
2022,Agosto,Serbia,688,2,0,,2,"(6.171601,-75.427454)"
2022,Agosto,Sierra Leona,694,1,0,,1,"(4.697144,-74.140516)"
2022,Agosto,Singapur,702,1,0,,1,"(11.117806,-74.232622)"
2022,Agosto,Singapur,702,1,0,,1,"(3.541112,-76.384584)"
2022,Agosto,Singapur,702,20,17,,37,"(4.697144,-74.140516)"
2022,Agosto,Singapur,702,2,2,,4,"(6.171601,-75.427454)"
2022,Agosto,Sri Lanka,144,1,1,,2,"(4.697144,-74.140516)"
2022,Agosto,Sudáfrica,710,1,0,,1,"(3.541112,-76.384584)"
2022,Agosto,Sudáfrica,710,21,15,,36,"(4.697144,-74.140516)"
2022,Agosto,Sudáfrica,710,0,1,,1,"(4.815061,-75.736532)"
2022,Agosto,Sudán,736,0,1,,1,"(4.697144,-74.140516)"
2022,Agosto,Suecia,752,8,9,,17,"(10.445761,-75.516429)"
2022,Agosto,Suecia,752,5,2,,7,"(10.886611,-74.776708)"
2022,Agosto,Suecia,752,25,21,,46,"(3.541112,-76.384584)"
2022,Agosto,Suecia,752,1,2,,3,"(4.452882,-75.766298)"
2022,Agosto,Suecia,752,131,92,,223,"(4.697144,-74.140516)"
2022,Agosto,Suecia,752,2,1,,3,"(4.815061,-75.736532)"
2022,Agosto,Suecia,752,22,21,,43,"(6.171601,-75.427454)"
2022,Agosto,Suiza,756,27,11,,38,"(10.445761,-75.516429)"
2022,Agosto,Suiza,756,5,2,,7,"(10.886611,-74.776708)"
2022,Agosto,Suiza,756,0,1,,1,"(11.117806,-74.232622)"
2022,Agosto,Suiza,756,80,41,,121,"(3.541112,-76.384584)"
2022,Agosto,Suiza,756,4,1,,5,"(4.452882,-75.766298)"
2022,Agosto,Suiza,756,498,296,,794,"(4.697144,-74.140516)"
2022,Agosto,Suiza,756,1,2,,3,"(4.815061,-75.736532)"
2022,Agosto,Suiza,756,65,36,,101,"(6.171601,-75.427454)"
2022,Agosto,Surinam,740,0,3,,3,"(10.886611,-74.776708)"
2022,Agosto,Surinam,740,3,3,,6,"(3.541112,-76.384584)"
2022,Agosto,Surinam,740,11,25,,36,"(4.697144,-74.140516)"
2022,Agosto,Surinam,740,9,7,,16,"(6.171601,-75.427454)"
2022,Agosto,Taiwán,158,1,0,,1,"(3.541112,-76.384584)"
2022,Agosto,Taiwán,158,7,11,,18,"(4.697144,-74.140516)"
2022,Agosto,Taiwán,158,0,1,,1,"(6.171601,-75.427454)"
2022,Agosto,Tailandia,764,0,1,,1,"(10.886611,-74.776708)"
2022,Agosto,Tailandia,764,1,1,,2,"(3.541112,-76.384584)"
2022,Agosto,Tailandia,764,8,14,,22,"(4.697144,-74.140516)"
2022,Agosto,Tailandia,764,1,0,,1,"(4.815061,-75.736532)"
2022,Agosto,Tailandia,764,3,4,,7,"(6.171601,-75.427454)"
2022,Agosto,Tanzania,834,3,4,,7,"(4.697144,-74.140516)"
2022,Agosto,Tanzania,834,1,1,,2,"(6.171601,-75.427454)"
2022,Agosto,Trinidad y Tobago,780,0,2,,2,"(10.445761,-75.516429)"
2022,Agosto,Trinidad y Tobago,780,2,1,,3,"(10.886611,-74.776708)"
2022,Agosto,Trinidad y Tobago,780,2,0,,2,"(11.117806,-74.232622)"
2022,Agosto,Trinidad y Tobago,780,4,5,,9,"(3.541112,-76.384584)"
2022,Agosto,Trinidad y Tobago,780,1,2,,3,"(4.452882,-75.766298)"
2022,Agosto,Trinidad y Tobago,780,13,20,,33,"(4.697144,-74.140516)"
2022,Agosto,Trinidad y Tobago,780,0,1,,1,"(4.815061,-75.736532)"
2022,Agosto,Trinidad y Tobago,780,12,6,,18,"(6.171601,-75.427454)"
2022,Agosto,Trinidad y Tobago,780,1,0,,1,"(7.927209,-72.507910)"
2022,Agosto,Túnez,788,2,1,,3,"(4.697144,-74.140516)"
2022,Agosto,Turquía,792,5,6,,11,"(10.445761,-75.516429)"
2022,Agosto,Turquía,792,1,0,,1,"(10.886611,-74.776708)"
2022,Agosto,Turquía,792,11,5,,16,"(3.541112,-76.384584)"
2022,Agosto,Turquía,792,1075,740,,1815,"(4.697144,-74.140516)"
2022,Agosto,Turquía,792,1,1,,2,"(4.815061,-75.736532)"
2022,Agosto,Turquía,792,13,8,,21,"(6.171601,-75.427454)"
2022,Agosto,Tuvalu,798,1,0,,1,"(4.697144,-74.140516)"
2022,Agosto,Turkmenistán,795,3,1,,4,"(4.697144,-74.140516)"
2022,Agosto,Ucrania,804,0,2,,2,"(4.697144,-74.140516)"
2022,Agosto,Uganda,800,3,1,,4,"(4.697144,-74.140516)"
2022,Agosto,Uruguay,858,2,1,,3,"(10.445761,-75.516429)"
2022,Agosto,Uruguay,858,4,3,,7,"(10.886611,-74.776708)"
2022,Agosto,Uruguay,858,36,51,,87,"(3.541112,-76.384584)"
2022,Agosto,Uruguay,858,2,1,,3,"(4.452882,-75.766298)"
2022,Agosto,Uruguay,858,188,234,,422,"(4.697144,-74.140516)"
2022,Agosto,Uruguay,858,2,7,,9,"(4.815061,-75.736532)"
2022,Agosto,Uruguay,858,12,31,,43,"(6.171601,-75.427454)"
2022,Agosto,Uruguay,858,0,1,,1,"(7.128456,-73.183637)"
2022,Agosto,Uruguay,858,4,1,,5,"(7.927209,-72.507910)"
2022,Agosto,Uzbekistán,860,1,1,,2,"(4.697144,-74.140516)"
2022,Agosto,Venezuela,862,8,4,,12,"(10.445761,-75.516429)"
2022,Agosto,Venezuela,862,22,26,,48,"(10.886611,-74.776708)"
2022,Agosto,Venezuela,862,401,563,,964,"(11.360009,-72.129330)"
2022,Agosto,Venezuela,862,21,40,,61,"(3.541112,-76.384584)"
2022,Agosto,Venezuela,862,0,1,,1,"(3.866713,-67.927521)"
2022,Agosto,Venezuela,862,2,2,,4,"(4.452882,-75.766298)"
2022,Agosto,Venezuela,862,135,319,,454,"(4.697144,-74.140516)"
2022,Agosto,Venezuela,862,6,14,,20,"(4.815061,-75.736532)"
2022,Agosto,Venezuela,862,54,97,,151,"(6.171601,-75.427454)"
2022,Agosto,Venezuela,862,5,7,,12,"(6.18189,-67.47535)"
2022,Agosto,Venezuela,862,37,68,,105,"(7.088729,-70.740253)"
2022,Agosto,Venezuela,862,7,9,,16,"(7.128456,-73.183637)"
2022,Agosto,Venezuela,862,641,829,,1470,"(7.818934,-72.453226)"
2022,Agosto,Venezuela,862,188,205,,393,"(7.916725,-72.462544)"
2022,Agosto,Venezuela,862,1,1,,2,"(7.927209,-72.507910)"
2022,Agosto,Venezuela,862,69,93,,162,"(8.36068,-72.409396)"
2022,Agosto,Vietnam,704,10,4,,14,"(4.697144,-74.140516)"
2022,Agosto,Vietnam,704,1,2,,3,"(6.171601,-75.427454)"
2022,Agosto,Islas Vírgenes Británicas/Territorio Británico de Ultramar,92,1,0,,1,"(4.697144,-74.140516)"
2022,Agosto,Islas Vírgenes Estadounidenses/Territorio de Estados Unidos,850,1,0,,1,"(4.697144,-74.140516)"
2022,Agosto,Islas Vírgenes Estadounidenses/Territorio de Estados Unidos,850,0,1,,1,"(6.171601,-75.427454)"
2022,Agosto,Zambia,894,0,1,,1,"(4.697144,-74.140516)"
2022,Agosto,Zimbabue,716,0,2,,2,"(6.171601,-75.427454)"
2022,Agosto,Anguila/Territorio Británico de Ultramar,660,2,4,,6,"(3.541112,-76.384584)"
2022,Agosto,Anguila/Territorio Británico de Ultramar,660,0,1,,1,"(6.171601,-75.427454)"
2022,Agosto,Islas Turcas y Caicos/Territorio Británico de Ultramar,796,1,1,,2,"(10.445761,-75.516429)"
2022,Agosto,Islas Turcas y Caicos/Territorio Británico de Ultramar,796,2,3,,5,"(10.886611,-74.776708)"
2022,Agosto,Islas Turcas y Caicos/Territorio Británico de Ultramar,796,3,7,,10,"(4.697144,-74.140516)"
2022,Agosto,Islas Turcas y Caicos/Territorio Británico de Ultramar,796,1,0,,1,"(4.815061,-75.736532)"
2022,Agosto,Desconocido,99999,1,0,,1,"(10.445761,-75.516429)"
2022,Agosto,Desconocido,99999,1,1,,2,"(3.541112,-76.384584)"
2022,Agosto,Desconocido,99999,1,0,,1,"(4.697144,-74.140516)"
2022,Septiembre,Albania,8,1,16,,17,"(4.697144,-74.140516)"
2022,Septiembre,Albania,8,0,3,,3,"(6.171601,-75.427454)"
2022,Septiembre,Alemania,276,67,42,,109,"(10.445761,-75.516429)"
2022,Septiembre,Alemania,276,4,7,,11,"(10.886611,-74.776708)"
2022,Septiembre,Alemania,276,0,3,,3,"(11.117806,-74.232622)"
2022,Septiembre,Alemania,276,78,40,,118,"(3.541112,-76.384584)"
2022,Septiembre,Alemania,276,1582,1327,,2909,"(4.697144,-74.140516)"
2022,Septiembre,Alemania,276,11,3,,14,"(4.815061,-75.736532)"
2022,Septiembre,Alemania,276,150,102,,252,"(6.171601,-75.427454)"
2022,Septiembre,Andorra,20,11,5,,16,"(4.697144,-74.140516)"
2022,Septiembre,Angola,24,3,9,,12,"(4.697144,-74.140516)"
2022,Septiembre,Angola,24,0,1,,1,"(6.171601,-75.427454)"
2022,Septiembre,Antigua y Barbuda,28,2,2,,4,"(4.697144,-74.140516)"
2022,Septiembre,Antigua y Barbuda,28,0,1,,1,"(4.815061,-75.736532)"
2022,Septiembre,Países Bajos,528,338,243,,581,"(10.445761,-75.516429)"
2022,Septiembre,Países Bajos,528,20,13,,33,"(10.886611,-74.776708)"
2022,Septiembre,Países Bajos,528,82,45,,127,"(3.541112,-76.384584)"
2022,Septiembre,Países Bajos,528,1231,1138,,2369,"(4.697144,-74.140516)"
2022,Septiembre,Países Bajos,528,6,2,,8,"(4.815061,-75.736532)"
2022,Septiembre,Países Bajos,528,128,95,,223,"(6.171601,-75.427454)"
2022,Septiembre,Países Bajos,528,0,1,,1,"(7.128456,-73.183637)"
2022,Septiembre,Arabia Saudita,682,0,1,,1,"(10.445761,-75.516429)"
2022,Septiembre,Arabia Saudita,682,9,25,,34,"(4.697144,-74.140516)"
2022,Septiembre,Arabia Saudita,682,2,3,,5,"(6.171601,-75.427454)"
2022,Septiembre,Argelia,12,4,5,,9,"(4.697144,-74.140516)"
2022,Septiembre,Argelia,12,1,0,,1,"(6.171601,-75.427454)"
2022,Septiembre,Argentina,32,7,4,,11,"(0.814836,-77.662532)"
2022,Septiembre,Argentina,32,11,15,,26,"(10.445761,-75.516429)"
2022,Septiembre,Argentina,32,17,24,,41,"(10.886611,-74.776708)"
2022,Septiembre,Argentina,32,11,7,,18,"(11.117806,-74.232622)"
2022,Septiembre,Argentina,32,96,105,,201,"(3.541112,-76.384584)"
2022,Septiembre,Argentina,32,10,13,,23,"(4.452882,-75.766298)"
2022,Septiembre,Argentina,32,2951,2797,,5748,"(4.697144,-74.140516)"
2022,Septiembre,Argentina,32,7,10,,17,"(4.815061,-75.736532)"
2022,Septiembre,Argentina,32,318,305,,623,"(6.171601,-75.427454)"
2022,Septiembre,Argentina,32,13,8,,21,"(7.927209,-72.507910)"
2022,Septiembre,República de Armenia,51,1,1,,2,"(4.697144,-74.140516)"
2022,Septiembre,Aruba,533,143,110,,253,"(10.886611,-74.776708)"
2022,Septiembre,Aruba,533,47,30,,77,"(3.541112,-76.384584)"
2022,Septiembre,Aruba,533,1627,1307,,2934,"(4.697144,-74.140516)"
2022,Septiembre,Aruba,533,6,2,,8,"(4.815061,-75.736532)"
2022,Septiembre,Aruba,533,153,126,,279,"(6.171601,-75.427454)"
2022,Septiembre,Aruba,533,2,23,,25,"(7.128456,-73.183637)"
2022,Septiembre,Australia,36,7,5,,12,"(10.445761,-75.516429)"
2022,Septiembre,Australia,36,4,4,,8,"(10.886611,-74.776708)"
2022,Septiembre,Australia,36,1,1,,2,"(11.117806,-74.232622)"
2022,Septiembre,Australia,36,51,55,,106,"(3.541112,-76.384584)"
2022,Septiembre,Australia,36,851,852,,1703,"(4.697144,-74.140516)"
2022,Septiembre,Australia,36,7,4,,11,"(4.815061,-75.736532)"
2022,Septiembre,Australia,36,110,125,,235,"(6.171601,-75.427454)"
2022,Septiembre,Australia,36,2,1,,3,"(7.128456,-73.183637)"
2022,Septiembre,Australia,36,1,0,,1,"(7.927209,-72.507910)"
2022,Septiembre,Austria,40,7,6,,13,"(10.445761,-75.516429)"
2022,Septiembre,Austria,40,6,2,,8,"(3.541112,-76.384584)"
2022,Septiembre,Austria,40,77,67,,144,"(4.697144,-74.140516)"
2022,Septiembre,Austria,40,0,1,,1,"(4.815061,-75.736532)"
2022,Septiembre,Austria,40,6,4,,10,"(6.171601,-75.427454)"
2022,Septiembre,Azerbaiyán,31,1,2,,3,"(4.697144,-74.140516)"
2022,Septiembre,Bahamas,44,1,0,,1,"(10.445761,-75.516429)"
2022,Septiembre,Bahamas,44,0,1,,1,"(10.886611,-74.776708)"
2022,Septiembre,Bahamas,44,15,3,,18,"(3.541112,-76.384584)"
2022,Septiembre,Bahamas,44,18,18,,36,"(4.697144,-74.140516)"
2022,Septiembre,Bahamas,44,1,1,,2,"(4.815061,-75.736532)"
2022,Septiembre,Bahamas,44,21,12,,33,"(6.171601,-75.427454)"
2022,Septiembre,Bahamas,44,1,0,,1,"(7.927209,-72.507910)"
2022,Septiembre,Bahréin,48,1,1,,2,"(10.445761,-75.516429)"
2022,Septiembre,Bahréin,48,5,4,,9,"(4.697144,-74.140516)"
2022,Septiembre,Bahréin,48,3,0,,3,"(6.171601,-75.427454)"
2022,Septiembre,Bangladesh,50,0,1,,1,"(4.697144,-74.140516)"
2022,Septiembre,Barbados,52,0,3,,3,"(10.408582,-75.538003)"
2022,Septiembre,Barbados,52,0,5,,5,"(10.886611,-74.776708)"
2022,Septiembre,Barbados,52,0,1,,1,"(3.541112,-76.384584)"
2022,Septiembre,Barbados,52,12,27,,39,"(4.697144,-74.140516)"
2022,Septiembre,Barbados,52,2,1,,3,"(4.815061,-75.736532)"
2022,Septiembre,Barbados,52,0,2,,2,"(6.171601,-75.427454)"
2022,Septiembre,República de Belarús,112,0,1,,1,"(7.818934,-72.453226)"
2022,Septiembre,Bélgica,56,6,7,,13,"(10.445761,-75.516429)"
2022,Septiembre,Bélgica,56,0,1,,1,"(10.886611,-74.776708)"
2022,Septiembre,Bélgica,56,23,17,,40,"(3.541112,-76.384584)"
2022,Septiembre,Bélgica,56,159,108,,267,"(4.697144,-74.140516)"
2022,Septiembre,Bélgica,56,4,2,,6,"(4.815061,-75.736532)"
2022,Septiembre,Bélgica,56,52,47,,99,"(6.171601,-75.427454)"
2022,Septiembre,Belice,84,3,2,,5,"(3.541112,-76.384584)"
2022,Septiembre,Belice,84,6,7,,13,"(4.697144,-74.140516)"
2022,Septiembre,Belice,84,2,5,,7,"(6.171601,-75.427454)"
2022,Septiembre,Benín,204,0,1,,1,"(4.697144,-74.140516)"
2022,Septiembre,Bermudas/Territorio Británico de Ultramar,60,1,2,,3,"(4.697144,-74.140516)"
2022,Septiembre,Bermudas/Territorio Británico de Ultramar,60,1,0,,1,"(4.815061,-75.736532)"
2022,Septiembre,Bolivia,68,2,8,,10,"(0.814836,-77.662532)"
2022,Septiembre,Bolivia,68,1,2,,3,"(10.445761,-75.516429)"
2022,Septiembre,Bolivia,68,4,2,,6,"(10.886611,-74.776708)"
2022,Septiembre,Bolivia,68,13,26,,39,"(3.541112,-76.384584)"
2022,Septiembre,Bolivia,68,0,2,,2,"(4.452882,-75.766298)"
2022,Septiembre,Bolivia,68,337,550,,887,"(4.697144,-74.140516)"
2022,Septiembre,Bolivia,68,9,11,,20,"(4.815061,-75.736532)"
2022,Septiembre,Bolivia,68,22,21,,43,"(6.171601,-75.427454)"
2022,Septiembre,Bolivia,68,1,1,,2,"(7.128456,-73.183637)"
2022,Septiembre,Bosnia y Herzegovina,70,15,7,,22,"(4.697144,-74.140516)"
2022,Septiembre,Brasil,76,1,1,,2,"(-3.790089,-70.356599)"
2022,Septiembre,Brasil,76,206,378,,584,"(-4.197703,-69.941278)"
2022,Septiembre,Brasil,76,3,2,,5,"(-4.223468,-69.945098)"
2022,Septiembre,Brasil,76,1,2,,3,"(0.814836,-77.662532)"
2022,Septiembre,Brasil,76,10,15,,25,"(10.445761,-75.516429)"
2022,Septiembre,Brasil,76,17,20,,37,"(10.886611,-74.776708)"
2022,Septiembre,Brasil,76,2,4,,6,"(11.117806,-74.232622)"
2022,Septiembre,Brasil,76,0,1,,1,"(12.586067,-81.702563)"
2022,Septiembre,Brasil,76,115,178,,293,"(3.541112,-76.384584)"
2022,Septiembre,Brasil,76,1,0,,1,"(3.866713,-67.927521)"
2022,Septiembre,Brasil,76,21,22,,43,"(4.452882,-75.766298)"
2022,Septiembre,Brasil,76,2250,2861,,5111,"(4.697144,-74.140516)"
2022,Septiembre,Brasil,76,30,47,,77,"(4.815061,-75.736532)"
2022,Septiembre,Brasil,76,378,437,,815,"(6.171601,-75.427454)"
2022,Septiembre,Brasil,76,10,4,,14,"(7.128456,-73.183637)"
2022,Septiembre,Brasil,76,10,14,,24,"(7.927209,-72.507910)"
2022,Septiembre,Bulgaria,100,1,0,,1,"(3.541112,-76.384584)"
2022,Septiembre,Bulgaria,100,1,1,,2,"(4.452882,-75.766298)"
2022,Septiembre,Bulgaria,100,3,14,,17,"(4.697144,-74.140516)"
2022,Septiembre,Bulgaria,100,0,1,,1,"(6.171601,-75.427454)"
2022,Septiembre,Burkina Faso,854,0,1,,1,"(10.886611,-74.776708)"
2022,Septiembre,Cabo Verde,132,1,0,,1,"(4.697144,-74.140516)"
2022,Septiembre,Islas Caimán/Territorio Británico de Ultramar,136,4,1,,5,"(12.586067,-81.702563)"
2022,Septiembre,Islas Caimán/Territorio Británico de Ultramar,136,1,2,,3,"(3.541112,-76.384584)"
2022,Septiembre,Islas Caimán/Territorio Británico de Ultramar,136,1,5,,6,"(4.697144,-74.140516)"
2022,Septiembre,Camboya,116,3,2,,5,"(4.697144,-74.140516)"
2022,Septiembre,Camerún,120,0,1,,1,"(3.541112,-76.384584)"
2022,Septiembre,Camerún,120,1,0,,1,"(4.697144,-74.140516)"
2022,Septiembre,Camerún,120,0,1,,1,"(6.171601,-75.427454)"
2022,Septiembre,Canadá,124,44,40,,84,"(10.445761,-75.516429)"
2022,Septiembre,Canadá,124,53,48,,101,"(10.886611,-74.776708)"
2022,Septiembre,Canadá,124,6,5,,11,"(11.117806,-74.232622)"
2022,Septiembre,Canadá,124,1,3,,4,"(12.586067,-81.702563)"
2022,Septiembre,Canadá,124,95,84,,179,"(3.541112,-76.384584)"
2022,Septiembre,Canadá,124,24,24,,48,"(4.452882,-75.766298)"
2022,Septiembre,Canadá,124,3562,3092,,6654,"(4.697144,-74.140516)"
2022,Septiembre,Canadá,124,13,10,,23,"(4.815061,-75.736532)"
2022,Septiembre,Canadá,124,259,243,,502,"(6.171601,-75.427454)"
2022,Septiembre,Canadá,124,10,5,,15,"(7.128456,-73.183637)"
2022,Septiembre,Canadá,124,0,1,,1,"(7.927209,-72.507910)"
2022,Septiembre,Chad,148,1,1,,2,"(4.697144,-74.140516)"
2022,Septiembre,España,724,0,2,,2,"(10.408582,-75.538003)"
2022,Septiembre,España,724,271,211,,482,"(10.445761,-75.516429)"
2022,Septiembre,España,724,34,17,,51,"(10.886611,-74.776708)"
2022,Septiembre,España,724,1,0,,1,"(11.117806,-74.232622)"
2022,Septiembre,España,724,2689,2013,,4702,"(3.541112,-76.384584)"
2022,Septiembre,España,724,4,3,,7,"(4.452882,-75.766298)"
2022,Septiembre,España,724,22593,17305,,39898,"(4.697144,-74.140516)"
2022,Septiembre,España,724,39,33,,72,"(4.815061,-75.736532)"
2022,Septiembre,España,724,4012,2944,,6956,"(6.171601,-75.427454)"
2022,Septiembre,España,724,5,1,,6,"(7.128456,-73.183637)"
2022,Septiembre,Norfolk,574,1,1,,2,"(4.697144,-74.140516)"
2022,Septiembre,Colombia,170,55,108,,163,"(4.697144,-74.140516)"
2022,Septiembre,Comoras,174,1,0,,1,"(4.697144,-74.140516)"
2022,Septiembre,Comoras,174,1,0,,1,"(6.171601,-75.427454)"
2022,Septiembre,República Democrática del Congo,180,0,1,,1,"(10.886611,-74.776708)"
2022,Septiembre,República Democrática del Congo,180,1,1,,2,"(4.697144,-74.140516)"
2022,Septiembre,República Democrática del Congo,180,2,0,,2,"(6.171601,-75.427454)"
2022,Septiembre,República de Corea,410,0,1,,1,"(10.445761,-75.516429)"
2022,Septiembre,República de Corea,410,4,1,,5,"(3.541112,-76.384584)"
2022,Septiembre,República de Corea,410,38,46,,84,"(4.697144,-74.140516)"
2022,Septiembre,República de Corea,410,2,0,,2,"(6.171601,-75.427454)"
2022,Septiembre,Costa de Marfil,384,0,1,,1,"(10.445761,-75.516429)"
2022,Septiembre,Costa de Marfil,384,1,2,,3,"(4.697144,-74.140516)"
2022,Septiembre,Costa Rica,188,57,53,,110,"(10.445761,-75.516429)"
2022,Septiembre,Costa Rica,188,12,14,,26,"(10.886611,-74.776708)"
2022,Septiembre,Costa Rica,188,3,7,,10,"(11.117806,-74.232622)"
2022,Septiembre,Costa Rica,188,3,26,,29,"(12.5744111,-81.703935)"
2022,Septiembre,Costa Rica,188,2,0,,2,"(12.586067,-81.702563)"
2022,Septiembre,Costa Rica,188,56,56,,112,"(3.541112,-76.384584)"
2022,Septiembre,Costa Rica,188,4,4,,8,"(4.452882,-75.766298)"
2022,Septiembre,Costa Rica,188,1109,1217,,2326,"(4.697144,-74.140516)"
2022,Septiembre,Costa Rica,188,8,5,,13,"(4.815061,-75.736532)"
2022,Septiembre,Costa Rica,188,0,2,,2,"(6.17134,-75.427194)"
2022,Septiembre,Costa Rica,188,283,269,,552,"(6.171601,-75.427454)"
2022,Septiembre,Costa Rica,188,2,8,,10,"(7.128456,-73.183637)"
2022,Septiembre,Costa Rica,188,0,1,,1,"(7.927209,-72.507910)"
2022,Septiembre,Croacia,191,2,0,,2,"(10.445761,-75.516429)"
2022,Septiembre,Croacia,191,0,1,,1,"(3.541112,-76.384584)"
2022,Septiembre,Croacia,191,1,0,,1,"(4.452882,-75.766298)"
2022,Septiembre,Croacia,191,32,29,,61,"(4.697144,-74.140516)"
2022,Septiembre,Croacia,191,6,3,,9,"(6.171601,-75.427454)"
2022,Septiembre,Cuba,192,6,5,,11,"(10.445761,-75.516429)"
2022,Septiembre,Cuba,192,4,7,,11,"(10.886611,-74.776708)"
2022,Septiembre,Cuba,192,1,0,,1,"(12.586067,-81.702563)"
2022,Septiembre,Cuba,192,14,15,,29,"(3.541112,-76.384584)"
2022,Septiembre,Cuba,192,1,2,,3,"(4.452882,-75.766298)"
2022,Septiembre,Cuba,192,1015,1030,,2045,"(4.697144,-74.140516)"
2022,Septiembre,Cuba,192,5,2,,7,"(4.815061,-75.736532)"
2022,Septiembre,Cuba,192,70,66,,136,"(6.171601,-75.427454)"
2022,Septiembre,Cuba,192,1,0,,1,"(7.128456,-73.183637)"
2022,Septiembre,Curazao,99999,58,21,,79,"(10.886611,-74.776708)"
2022,Septiembre,Curazao,99999,28,27,,55,"(3.541112,-76.384584)"
2022,Septiembre,Curazao,99999,1076,961,,2037,"(4.697144,-74.140516)"
2022,Septiembre,Curazao,99999,3,3,,6,"(4.815061,-75.736532)"
2022,Septiembre,Curazao,99999,124,83,,207,"(6.171601,-75.427454)"
2022,Septiembre,República Checa,203,2,2,,4,"(10.445761,-75.516429)"
2022,Septiembre,República Checa,203,3,0,,3,"(10.886611,-74.776708)"
2022,Septiembre,República Checa,203,4,6,,10,"(3.541112,-76.384584)"
2022,Septiembre,República Checa,203,32,30,,62,"(4.697144,-74.140516)"
2022,Septiembre,República Checa,203,3,2,,5,"(6.171601,-75.427454)"
2022,Septiembre,Chile,152,0,1,,1,"(0.25129,-76.875963)"
2022,Septiembre,Chile,152,58,56,,114,"(0.814836,-77.662532)"
2022,Septiembre,Chile,152,2,0,,2,"(1.813928,-78.763924)"
2022,Septiembre,Chile,152,17,9,,26,"(10.445761,-75.516429)"
2022,Septiembre,Chile,152,47,24,,71,"(10.886611,-74.776708)"
2022,Septiembre,Chile,152,7,6,,13,"(11.117806,-74.232622)"
2022,Septiembre,Chile,152,2250,1674,,3924,"(3.541112,-76.384584)"
2022,Septiembre,Chile,152,26,16,,42,"(4.452882,-75.766298)"
2022,Septiembre,Chile,152,4113,3648,,7761,"(4.697144,-74.140516)"
2022,Septiembre,Chile,152,35,33,,68,"(4.815061,-75.736532)"
2022,Septiembre,Chile,152,276,219,,495,"(6.171601,-75.427454)"
2022,Septiembre,Chile,152,8,12,,20,"(7.128456,-73.183637)"
2022,Septiembre,Chile,152,18,14,,32,"(7.927209,-72.507910)"
2022,Septiembre,China,156,0,1,,1,"(3.541112,-76.384584)"
2022,Septiembre,China,156,7,14,,21,"(4.697144,-74.140516)"
2022,Septiembre,China,156,0,1,,1,"(6.171601,-75.427454)"
2022,Septiembre,Chipre,196,3,2,,5,"(3.541112,-76.384584)"
2022,Septiembre,Chipre,196,5,8,,13,"(4.697144,-74.140516)"
2022,Septiembre,Chipre,196,2,2,,4,"(6.171601,-75.427454)"
2022,Septiembre,Dinamarca,208,7,2,,9,"(10.445761,-75.516429)"
2022,Septiembre,Dinamarca,208,6,8,,14,"(3.541112,-76.384584)"
2022,Septiembre,Dinamarca,208,60,47,,107,"(4.697144,-74.140516)"
2022,Septiembre,Dinamarca,208,1,0,,1,"(4.815061,-75.736532)"
2022,Septiembre,Dinamarca,208,5,6,,11,"(6.171601,-75.427454)"
2022,Septiembre,Dominica,212,0,1,,1,"(10.445761,-75.516429)"
2022,Septiembre,Dominica,212,2,0,,2,"(3.541112,-76.384584)"
2022,Septiembre,Dominica,212,8,3,,11,"(4.697144,-74.140516)"
2022,Septiembre,Dominica,212,1,0,,1,"(6.171601,-75.427454)"
2022,Septiembre,Ecuador,218,329,441,,770,"(0.25129,-76.875963)"
2022,Septiembre,Ecuador,218,18,28,,46,"(0.812436,-77.847006)"
2022,Septiembre,Ecuador,218,3243,4265,,7508,"(0.814836,-77.662532)"
2022,Septiembre,Ecuador,218,22,28,,50,"(1.813928,-78.763924)"
2022,Septiembre,Ecuador,218,13,13,,26,"(10.445761,-75.516429)"
2022,Septiembre,Ecuador,218,19,36,,55,"(10.886611,-74.776708)"
2022,Septiembre,Ecuador,218,2,4,,6,"(11.117806,-74.232622)"
2022,Septiembre,Ecuador,218,1,0,,1,"(12.586067,-81.702563)"
2022,Septiembre,Ecuador,218,98,114,,212,"(3.541112,-76.384584)"
2022,Septiembre,Ecuador,218,1,1,,2,"(4.452882,-75.766298)"
2022,Septiembre,Ecuador,218,3084,4276,,7360,"(4.697144,-74.140516)"
2022,Septiembre,Ecuador,218,7,8,,15,"(4.815061,-75.736532)"
2022,Septiembre,Ecuador,218,106,168,,274,"(6.171601,-75.427454)"
2022,Septiembre,Ecuador,218,1,5,,6,"(7.128456,-73.183637)"
2022,Septiembre,Ecuador,218,3,1,,4,"(7.927209,-72.507910)"
2022,Septiembre,Egipto,818,1,1,,2,"(10.445761,-75.516429)"
2022,Septiembre,Egipto,818,1,2,,3,"(3.541112,-76.384584)"
2022,Septiembre,Egipto,818,92,43,,135,"(4.697144,-74.140516)"
2022,Septiembre,Egipto,818,4,3,,7,"(6.171601,-75.427454)"
2022,Septiembre,Egipto,818,0,1,,1,"(9.402978,-75.681599)"
2022,Septiembre,El Salvador,222,3,6,,9,"(10.445761,-75.516429)"
2022,Septiembre,El Salvador,222,3,6,,9,"(10.886611,-74.776708)"
2022,Septiembre,El Salvador,222,0,1,,1,"(12.586067,-81.702563)"
2022,Septiembre,El Salvador,222,35,50,,85,"(3.541112,-76.384584)"
2022,Septiembre,El Salvador,222,472,578,,1050,"(4.697144,-74.140516)"
2022,Septiembre,El Salvador,222,0,2,,2,"(4.815061,-75.736532)"
2022,Septiembre,El Salvador,222,45,65,,110,"(6.171601,-75.427454)"
2022,Septiembre,Emiratos Árabes,784,2,14,,16,"(10.445761,-75.516429)"
2022,Septiembre,Emiratos Árabes,784,0,1,,1,"(10.886611,-74.776708)"
2022,Septiembre,Emiratos Árabes,784,1,5,,6,"(3.541112,-76.384584)"
2022,Septiembre,Emiratos Árabes,784,0,3,,3,"(4.452882,-75.766298)"
2022,Septiembre,Emiratos Árabes,784,185,188,,373,"(4.697144,-74.140516)"
2022,Septiembre,Emiratos Árabes,784,1,0,,1,"(4.815061,-75.736532)"
2022,Septiembre,Emiratos Árabes,784,21,11,,32,"(6.171601,-75.427454)"
2022,Septiembre,Eritrea,232,1,0,,1,"(4.697144,-74.140516)"
2022,Septiembre,Eslovaquia,703,7,6,,13,"(4.697144,-74.140516)"
2022,Septiembre,Eslovenia,705,1,0,,1,"(10.445761,-75.516429)"
2022,Septiembre,Eslovenia,705,9,9,,18,"(4.697144,-74.140516)"
2022,Septiembre,Eslovenia,705,1,0,,1,"(6.171601,-75.427454)"
2022,Septiembre,Estados Unidos de América,840,2327,1825,,4152,"(10.445761,-75.516429)"
2022,Septiembre,Estados Unidos de América,840,3260,2708,,5968,"(10.886611,-74.776708)"
2022,Septiembre,Estados Unidos de América,840,103,77,,180,"(11.117806,-74.232622)"
2022,Septiembre,Estados Unidos de América,840,144,112,,256,"(12.586067,-81.702563)"
2022,Septiembre,Estados Unidos de América,840,6954,4971,,11925,"(3.541112,-76.384584)"
2022,Septiembre,Estados Unidos de América,840,1234,957,,2191,"(4.452882,-75.766298)"
2022,Septiembre,Estados Unidos de América,840,34534,29486,,64020,"(4.697144,-74.140516)"
2022,Septiembre,Estados Unidos de América,840,1973,1368,,3341,"(4.815061,-75.736532)"
2022,Septiembre,Estados Unidos de América,840,0,6,,6,"(6.17134,-75.427194)"
2022,Septiembre,Estados Unidos de América,840,12535,10171,,22706,"(6.171601,-75.427454)"
2022,Septiembre,Estados Unidos de América,840,756,605,,1361,"(7.128456,-73.183637)"
2022,Septiembre,Estados Unidos de América,840,110,80,,190,"(7.927209,-72.507910)"
2022,Septiembre,Estonia,233,1,0,,1,"(10.445761,-75.516429)"
2022,Septiembre,Estonia,233,2,6,,8,"(4.697144,-74.140516)"
2022,Septiembre,Estonia,233,0,1,,1,"(6.171601,-75.427454)"
2022,Septiembre,Etiopia,231,1,5,,6,"(4.697144,-74.140516)"
2022,Septiembre,Islas Fiji,242,2,0,,2,"(4.697144,-74.140516)"
2022,Septiembre,Islas Fiji,242,1,0,,1,"(6.171601,-75.427454)"
2022,Septiembre,Filipinas,608,1,0,,1,"(10.445761,-75.516429)"
2022,Septiembre,Filipinas,608,4,7,,11,"(4.697144,-74.140516)"
2022,Septiembre,Finlandia,246,2,2,,4,"(10.445761,-75.516429)"
2022,Septiembre,Finlandia,246,0,2,,2,"(3.541112,-76.384584)"
2022,Septiembre,Finlandia,246,16,17,,33,"(4.697144,-74.140516)"
2022,Septiembre,Finlandia,246,0,3,,3,"(6.171601,-75.427454)"
2022,Septiembre,Francia,250,36,29,,65,"(10.445761,-75.516429)"
2022,Septiembre,Francia,250,5,5,,10,"(10.886611,-74.776708)"
2022,Septiembre,Francia,250,69,65,,134,"(3.541112,-76.384584)"
2022,Septiembre,Francia,250,2,6,,8,"(4.452882,-75.766298)"
2022,Septiembre,Francia,250,2990,2282,,5272,"(4.697144,-74.140516)"
2022,Septiembre,Francia,250,7,7,,14,"(4.815061,-75.736532)"
2022,Septiembre,Francia,250,182,120,,302,"(6.171601,-75.427454)"
2022,Septiembre,Gabón,266,1,0,,1,"(4.697144,-74.140516)"
2022,Septiembre,Gambia,270,1,0,,1,"(4.697144,-74.140516)"
2022,Septiembre,Georgia,268,1,0,,1,"(3.541112,-76.384584)"
2022,Septiembre,Georgia,268,2,1,,3,"(4.452882,-75.766298)"
2022,Septiembre,Georgia,268,6,4,,10,"(4.697144,-74.140516)"
2022,Septiembre,Georgia,268,2,0,,2,"(6.171601,-75.427454)"
2022,Septiembre,Ghana,288,0,4,,4,"(10.445761,-75.516429)"
2022,Septiembre,Ghana,288,1,0,,1,"(4.697144,-74.140516)"
2022,Septiembre,Granada,308,0,1,,1,"(4.697144,-74.140516)"
2022,Septiembre,Granada,308,0,1,,1,"(6.171601,-75.427454)"
2022,Septiembre,Grecia,300,3,5,,8,"(10.445761,-75.516429)"
2022,Septiembre,Grecia,300,7,4,,11,"(3.541112,-76.384584)"
2022,Septiembre,Grecia,300,88,57,,145,"(4.697144,-74.140516)"
2022,Septiembre,Grecia,300,1,0,,1,"(4.815061,-75.736532)"
2022,Septiembre,Grecia,300,12,10,,22,"(6.171601,-75.427454)"
2022,Septiembre,Guatemala,320,5,12,,17,"(10.445761,-75.516429)"
2022,Septiembre,Guatemala,320,13,22,,35,"(10.886611,-74.776708)"
2022,Septiembre,Guatemala,320,0,12,,12,"(12.586067,-81.702563)"
2022,Septiembre,Guatemala,320,58,93,,151,"(3.541112,-76.384584)"
2022,Septiembre,Guatemala,320,9,9,,18,"(4.452882,-75.766298)"
2022,Septiembre,Guatemala,320,431,741,,1172,"(4.697144,-74.140516)"
2022,Septiembre,Guatemala,320,19,33,,52,"(4.815061,-75.736532)"
2022,Septiembre,Guatemala,320,124,136,,260,"(6.171601,-75.427454)"
2022,Septiembre,Guatemala,320,3,12,,15,"(7.128456,-73.183637)"
2022,Septiembre,Guatemala,320,2,1,,3,"(7.927209,-72.507910)"
2022,Septiembre,Guyana,328,2,2,,4,"(10.886611,-74.776708)"
2022,Septiembre,Guyana,328,0,4,,4,"(3.541112,-76.384584)"
2022,Septiembre,Guyana,328,6,18,,24,"(4.697144,-74.140516)"
2022,Septiembre,Guyana,328,0,1,,1,"(4.815061,-75.736532)"
2022,Septiembre,Guyana,328,0,7,,7,"(6.171601,-75.427454)"
2022,Septiembre,Guinea Ecuatorial,226,4,5,,9,"(4.697144,-74.140516)"
2022,Septiembre,Guinea Ecuatorial,226,1,0,,1,"(6.171601,-75.427454)"
2022,Septiembre,Guinea Bissau,624,1,0,,1,"(4.697144,-74.140516)"
2022,Septiembre,Guadalupe/Territorio Francés,312,2,1,,3,"(3.541112,-76.384584)"
2022,Septiembre,Guadalupe/Territorio Francés,312,3,0,,3,"(4.697144,-74.140516)"
2022,Septiembre,Guayana Francesa/Departamento de Ultramar Francés,254,0,1,,1,"(4.697144,-74.140516)"
2022,Septiembre,Haití,332,2,3,,5,"(4.697144,-74.140516)"
2022,Septiembre,Haití,332,1,0,,1,"(6.171601,-75.427454)"
2022,Septiembre,Honduras,340,2,10,,12,"(10.445761,-75.516429)"
2022,Septiembre,Honduras,340,15,21,,36,"(10.886611,-74.776708)"
2022,Septiembre,Honduras,340,19,33,,52,"(3.541112,-76.384584)"
2022,Septiembre,Honduras,340,74,137,,211,"(4.697144,-74.140516)"
2022,Septiembre,Honduras,340,6,10,,16,"(4.815061,-75.736532)"
2022,Septiembre,Honduras,340,33,58,,91,"(6.171601,-75.427454)"
2022,Septiembre,Honduras,340,1,6,,7,"(7.128456,-73.183637)"
2022,Septiembre,Honduras,340,0,1,,1,"(7.927209,-72.507910)"
2022,Septiembre,Hong Kong,344,2,4,,6,"(4.697144,-74.140516)"
2022,Septiembre,Hungría,348,5,5,,10,"(10.445761,-75.516429)"
2022,Septiembre,Hungría,348,29,17,,46,"(4.697144,-74.140516)"
2022,Septiembre,Hungría,348,2,1,,3,"(6.171601,-75.427454)"
2022,Septiembre,India,356,2,2,,4,"(10.445761,-75.516429)"
2022,Septiembre,India,356,6,2,,8,"(3.541112,-76.384584)"
2022,Septiembre,India,356,66,38,,104,"(4.697144,-74.140516)"
2022,Septiembre,India,356,6,4,,10,"(6.171601,-75.427454)"
2022,Septiembre,Indonesia,360,1,0,,1,"(10.886611,-74.776708)"
2022,Septiembre,Indonesia,360,1,0,,1,"(3.541112,-76.384584)"
2022,Septiembre,Indonesia,360,10,4,,14,"(4.697144,-74.140516)"
2022,Septiembre,Indonesia,360,1,1,,2,"(6.171601,-75.427454)"
2022,Septiembre,Iraq,368,1,4,,5,"(4.697144,-74.140516)"
2022,Septiembre,Irán,364,4,2,,6,"(4.697144,-74.140516)"
2022,Septiembre,República de Irlanda,372,3,5,,8,"(10.445761,-75.516429)"
2022,Septiembre,República de Irlanda,372,3,1,,4,"(3.541112,-76.384584)"
2022,Septiembre,República de Irlanda,372,23,13,,36,"(4.697144,-74.140516)"
2022,Septiembre,República de Irlanda,372,1,0,,1,"(4.815061,-75.736532)"
2022,Septiembre,República de Irlanda,372,4,6,,10,"(6.171601,-75.427454)"
2022,Septiembre,Islandia,352,13,11,,24,"(4.697144,-74.140516)"
2022,Septiembre,Islandia,352,1,0,,1,"(4.815061,-75.736532)"
2022,Septiembre,Islandia,352,3,4,,7,"(6.171601,-75.427454)"
2022,Septiembre,Israel,376,6,3,,9,"(10.445761,-75.516429)"
2022,Septiembre,Israel,376,0,1,,1,"(10.886611,-74.776708)"
2022,Septiembre,Israel,376,11,6,,17,"(3.541112,-76.384584)"
2022,Septiembre,Israel,376,369,165,,534,"(4.697144,-74.140516)"
2022,Septiembre,Israel,376,2,0,,2,"(4.815061,-75.736532)"
2022,Septiembre,Israel,376,9,13,,22,"(6.171601,-75.427454)"
2022,Septiembre,Italia,380,75,50,,125,"(10.445761,-75.516429)"
2022,Septiembre,Italia,380,3,4,,7,"(10.886611,-74.776708)"
2022,Septiembre,Italia,380,3,1,,4,"(11.117806,-74.232622)"
2022,Septiembre,Italia,380,0,1,,1,"(12.586067,-81.702563)"
2022,Septiembre,Italia,380,117,72,,189,"(3.541112,-76.384584)"
2022,Septiembre,Italia,380,1425,1027,,2452,"(4.697144,-74.140516)"
2022,Septiembre,Italia,380,4,0,,4,"(4.815061,-75.736532)"
2022,Septiembre,Italia,380,244,172,,416,"(6.171601,-75.427454)"
2022,Septiembre,Italia,380,0,1,,1,"(7.128456,-73.183637)"
2022,Septiembre,Jamaica,388,1,3,,4,"(10.445761,-75.516429)"
2022,Septiembre,Jamaica,388,2,3,,5,"(10.886611,-74.776708)"
2022,Septiembre,Jamaica,388,10,5,,15,"(3.541112,-76.384584)"
2022,Septiembre,Jamaica,388,46,42,,88,"(4.697144,-74.140516)"
2022,Septiembre,Jamaica,388,4,1,,5,"(4.815061,-75.736532)"
2022,Septiembre,Jamaica,388,13,16,,29,"(6.171601,-75.427454)"
2022,Septiembre,Japón,392,3,3,,6,"(3.541112,-76.384584)"
2022,Septiembre,Japón,392,33,28,,61,"(4.697144,-74.140516)"
2022,Septiembre,Japón,392,1,0,,1,"(4.815061,-75.736532)"
2022,Septiembre,Japón,392,6,2,,8,"(6.171601,-75.427454)"
2022,Septiembre,Jordania,400,4,3,,7,"(4.697144,-74.140516)"
2022,Septiembre,Kazajistán,398,0,6,,6,"(4.697144,-74.140516)"
2022,Septiembre,Kenia,404,1,0,,1,"(10.445761,-75.516429)"
2022,Septiembre,Kenia,404,0,1,,1,"(3.541112,-76.384584)"
2022,Septiembre,Kenia,404,4,8,,12,"(4.697144,-74.140516)"
2022,Septiembre,Kirguistán,417,1,0,,1,"(6.171601,-75.427454)"
2022,Septiembre,Kuwait,414,2,6,,8,"(4.697144,-74.140516)"
2022,Septiembre,República Democrática Popular  Lao,418,1,2,,3,"(4.697144,-74.140516)"
2022,Septiembre,Letonia,428,0,1,,1,"(10.445761,-75.516429)"
2022,Septiembre,Letonia,428,1,1,,2,"(4.697144,-74.140516)"
2022,Septiembre,Líbano,422,0,1,,1,"(12.586067,-81.702563)"
2022,Septiembre,Líbano,422,1,1,,2,"(3.541112,-76.384584)"
2022,Septiembre,Líbano,422,7,10,,17,"(4.697144,-74.140516)"
2022,Septiembre,Líbano,422,1,1,,2,"(6.171601,-75.427454)"
2022,Septiembre,Liberia,430,0,1,,1,"(4.697144,-74.140516)"
2022,Septiembre,Luxemburgo,442,4,3,,7,"(10.445761,-75.516429)"
2022,Septiembre,Luxemburgo,442,1,1,,2,"(3.541112,-76.384584)"
2022,Septiembre,Luxemburgo,442,13,11,,24,"(4.697144,-74.140516)"
2022,Septiembre,Luxemburgo,442,5,7,,12,"(6.171601,-75.427454)"
2022,Septiembre,Macao,446,1,0,,1,"(4.697144,-74.140516)"
2022,Septiembre,Macedonia,807,0,2,,2,"(4.697144,-74.140516)"
2022,Septiembre,Madagascar,450,1,0,,1,"(4.697144,-74.140516)"
2022,Septiembre,Malasia,458,0,2,,2,"(10.445761,-75.516429)"
2022,Septiembre,Malasia,458,4,7,,11,"(4.697144,-74.140516)"
2022,Septiembre,Malasia,458,1,0,,1,"(6.171601,-75.427454)"
2022,Septiembre,Maldivas,462,5,3,,8,"(4.697144,-74.140516)"
2022,Septiembre,Maldivas,462,2,0,,2,"(6.171601,-75.427454)"
2022,Septiembre,Malí,466,0,1,,1,"(4.697144,-74.140516)"
2022,Septiembre,Malí,466,0,1,,1,"(6.171601,-75.427454)"
2022,Septiembre,Malta,470,4,6,,10,"(10.445761,-75.516429)"
2022,Septiembre,Malta,470,4,1,,5,"(10.886611,-74.776708)"
2022,Septiembre,Malta,470,11,3,,14,"(3.541112,-76.384584)"
2022,Septiembre,Malta,470,121,112,,233,"(4.697144,-74.140516)"
2022,Septiembre,Malta,470,8,3,,11,"(6.171601,-75.427454)"
2022,Septiembre,Malta,470,0,1,,1,"(7.128456,-73.183637)"
2022,Septiembre,Marruecos,504,1,1,,2,"(10.445761,-75.516429)"
2022,Septiembre,Marruecos,504,2,0,,2,"(3.541112,-76.384584)"
2022,Septiembre,Marruecos,504,29,26,,55,"(4.697144,-74.140516)"
2022,Septiembre,Marruecos,504,7,3,,10,"(6.171601,-75.427454)"
2022,Septiembre,Islas Marshall,584,0,1,,1,"(4.697144,-74.140516)"
2022,Septiembre,Mauricio,480,0,1,,1,"(4.697144,-74.140516)"
2022,Septiembre,Mauritania,478,0,2,,2,"(4.697144,-74.140516)"
2022,Septiembre,Martinica/Departamento de Ultramar Francés,474,1,0,,1,"(4.697144,-74.140516)"
2022,Septiembre,Martinica/Departamento de Ultramar Francés,474,1,0,,1,"(6.171601,-75.427454)"
2022,Septiembre,Martinica/Departamento de Ultramar Francés,474,1,0,,1,"(7.927209,-72.507910)"
2022,Septiembre,México,484,289,250,,539,"(10.445761,-75.516429)"
2022,Septiembre,México,484,434,402,,836,"(10.886611,-74.776708)"
2022,Septiembre,México,484,30,24,,54,"(11.117806,-74.232622)"
2022,Septiembre,México,484,2,1,,3,"(12.586067,-81.702563)"
2022,Septiembre,México,484,3057,2694,,5751,"(3.541112,-76.384584)"
2022,Septiembre,México,484,24,23,,47,"(4.452882,-75.766298)"
2022,Septiembre,México,484,23116,22577,,45694,"(4.697144,-74.140516)"
2022,Septiembre,México,484,345,256,,601,"(4.815061,-75.736532)"
2022,Septiembre,México,484,8153,7184,,15337,"(6.171601,-75.427454)"
2022,Septiembre,México,484,143,121,,264,"(7.128456,-73.183637)"
2022,Septiembre,México,484,61,53,,114,"(7.927209,-72.507910)"
2022,Septiembre,Mayotte/Colectividad Territorial Francesa,175,1,2,,3,"(4.697144,-74.140516)"
2022,Septiembre,República de Moldavia,498,1,0,,1,"(4.697144,-74.140516)"
2022,Septiembre,Mónaco,492,2,0,,2,"(4.697144,-74.140516)"
2022,Septiembre,Montenegro,499,0,1,,1,"(10.886611,-74.776708)"
2022,Septiembre,Montenegro,499,0,1,,1,"(3.541112,-76.384584)"
2022,Septiembre,Montenegro,499,1,2,,3,"(4.697144,-74.140516)"
2022,Septiembre,Micronesia,583,1,1,,2,"(4.697144,-74.140516)"
2022,Septiembre,Mozambique,508,1,1,,2,"(4.697144,-74.140516)"
2022,Septiembre,Nepal,524,2,2,,4,"(4.697144,-74.140516)"
2022,Septiembre,Nicaragua,558,2,0,,2,"(10.445761,-75.516429)"
2022,Septiembre,Nicaragua,558,1,2,,3,"(10.886611,-74.776708)"
2022,Septiembre,Nicaragua,558,0,1,,1,"(12.5744111,-81.703935)"
2022,Septiembre,Nicaragua,558,4,6,,10,"(3.541112,-76.384584)"
2022,Septiembre,Nicaragua,558,1,0,,1,"(4.452882,-75.766298)"
2022,Septiembre,Nicaragua,558,36,55,,91,"(4.697144,-74.140516)"
2022,Septiembre,Nicaragua,558,0,3,,3,"(4.815061,-75.736532)"
2022,Septiembre,Nicaragua,558,9,43,,52,"(6.171601,-75.427454)"
2022,Septiembre,Nicaragua,558,0,2,,2,"(7.128456,-73.183637)"
2022,Septiembre,Nigeria,566,1,0,,1,"(10.445761,-75.516429)"
2022,Septiembre,Nigeria,566,0,1,,1,"(3.541112,-76.384584)"
2022,Septiembre,Nigeria,566,2,4,,6,"(4.697144,-74.140516)"
2022,Septiembre,Noruega,578,6,1,,7,"(10.445761,-75.516429)"
2022,Septiembre,Noruega,578,7,7,,14,"(3.541112,-76.384584)"
2022,Septiembre,Noruega,578,41,32,,73,"(4.697144,-74.140516)"
2022,Septiembre,Noruega,578,4,2,,6,"(6.171601,-75.427454)"
2022,Septiembre,Nueva Zelanda,554,1,1,,2,"(3.541112,-76.384584)"
2022,Septiembre,Nueva Zelanda,554,30,22,,52,"(4.697144,-74.140516)"
2022,Septiembre,Nueva Zelanda,554,2,3,,5,"(6.171601,-75.427454)"
2022,Septiembre,Omán,512,0,1,,1,"(3.541112,-76.384584)"
2022,Septiembre,Omán,512,1,4,,5,"(4.697144,-74.140516)"
2022,Septiembre,Omán,512,0,1,,1,"(6.171601,-75.427454)"
2022,Septiembre,Papúa Nueva Guinea,598,3,2,,5,"(4.697144,-74.140516)"
2022,Septiembre,Pakistán,586,0,2,,2,"(4.697144,-74.140516)"
2022,Septiembre,Pakistán,586,0,1,,1,"(6.171601,-75.427454)"
2022,Septiembre,Panamá,591,7,59,,66,"(10.408582,-75.538003)"
2022,Septiembre,Panamá,591,1086,885,,1971,"(10.445761,-75.516429)"
2022,Septiembre,Panamá,591,685,612,,1297,"(10.886611,-74.776708)"
2022,Septiembre,Panamá,591,0,1,,1,"(10.971302,-74.765397)"
2022,Septiembre,Panamá,591,46,40,,86,"(11.117806,-74.232622)"
2022,Septiembre,Panamá,591,1,11,,12,"(12.5744111,-81.703935)"
2022,Septiembre,Panamá,591,13,22,,35,"(12.586067,-81.702563)"
2022,Septiembre,Panamá,591,2033,1680,,3713,"(3.541112,-76.384584)"
2022,Septiembre,Panamá,591,0,14,,14,"(3.893038,-77.067921)"
2022,Septiembre,Panamá,591,131,84,,215,"(4.452882,-75.766298)"
2022,Septiembre,Panamá,591,6279,6743,,13022,"(4.697144,-74.140516)"
2022,Septiembre,Panamá,591,328,249,,577,"(4.815061,-75.736532)"
2022,Septiembre,Panamá,591,3,20,,23,"(6.17134,-75.427194)"
2022,Septiembre,Panamá,591,2435,2387,,4822,"(6.171601,-75.427454)"
2022,Septiembre,Panamá,591,0,1,,1,"(6.228046,-77.404104)"
2022,Septiembre,Panamá,591,6,16,,22,"(7.102626,-77.762647)"
2022,Septiembre,Panamá,591,108,93,,201,"(7.128456,-73.183637)"
2022,Septiembre,Panamá,591,72,59,,131,"(7.927209,-72.507910)"
2022,Septiembre,Panamá,591,52,112,,164,"(8.635765,-77.346578)"
2022,Septiembre,Paraguay,600,4,2,,6,"(10.445761,-75.516429)"
2022,Septiembre,Paraguay,600,2,6,,8,"(10.886611,-74.776708)"
2022,Septiembre,Paraguay,600,3,2,,5,"(11.117806,-74.232622)"
2022,Septiembre,Paraguay,600,35,50,,85,"(3.541112,-76.384584)"
2022,Septiembre,Paraguay,600,1,2,,3,"(4.452882,-75.766298)"
2022,Septiembre,Paraguay,600,232,378,,610,"(4.697144,-74.140516)"
2022,Septiembre,Paraguay,600,12,7,,19,"(4.815061,-75.736532)"
2022,Septiembre,Paraguay,600,23,30,,53,"(6.171601,-75.427454)"
2022,Septiembre,Paraguay,600,0,1,,1,"(7.128456,-73.183637)"
2022,Septiembre,Paraguay,600,2,1,,3,"(7.927209,-72.507910)"
2022,Septiembre,Perú,604,1,8,,9,"(-0.193180,-74.784874)"
2022,Septiembre,Perú,604,1,1,,2,"(-3.790089,-70.356599)"
2022,Septiembre,Perú,604,48,83,,131,"(-4.197703,-69.941278)"
2022,Septiembre,Perú,604,74,98,,172,"(-4.223468,-69.945098)"
2022,Septiembre,Perú,604,2,1,,3,"(0.25129,-76.875963)"
2022,Septiembre,Perú,604,55,86,,141,"(0.814836,-77.662532)"
2022,Septiembre,Perú,604,56,49,,105,"(10.445761,-75.516429)"
2022,Septiembre,Perú,604,18,31,,49,"(10.886611,-74.776708)"
2022,Septiembre,Perú,604,1,2,,3,"(11.117806,-74.232622)"
2022,Septiembre,Perú,604,230,234,,464,"(3.541112,-76.384584)"
2022,Septiembre,Perú,604,0,4,,4,"(3.893038,-77.067921)"
2022,Septiembre,Perú,604,3,8,,11,"(4.452882,-75.766298)"
2022,Septiembre,Perú,604,4417,4700,,9117,"(4.697144,-74.140516)"
2022,Septiembre,Perú,604,5,14,,19,"(4.815061,-75.736532)"
2022,Septiembre,Perú,604,995,976,,1971,"(6.171601,-75.427454)"
2022,Septiembre,Perú,604,1,1,,2,"(7.128456,-73.183637)"
2022,Septiembre,Perú,604,1,0,,1,"(7.927209,-72.507910)"
2022,Septiembre,Palestina,99999,1,1,,2,"(4.697144,-74.140516)"
2022,Septiembre,Polonia,616,3,7,,10,"(10.445761,-75.516429)"
2022,Septiembre,Polonia,616,1,0,,1,"(10.886611,-74.776708)"
2022,Septiembre,Polonia,616,2,3,,5,"(3.541112,-76.384584)"
2022,Septiembre,Polonia,616,46,91,,137,"(4.697144,-74.140516)"
2022,Septiembre,Polonia,616,7,9,,16,"(6.171601,-75.427454)"
2022,Septiembre,Portugal,620,9,9,,18,"(10.445761,-75.516429)"
2022,Septiembre,Portugal,620,14,14,,28,"(3.541112,-76.384584)"
2022,Septiembre,Portugal,620,301,247,,548,"(4.697144,-74.140516)"
2022,Septiembre,Portugal,620,51,55,,106,"(6.171601,-75.427454)"
2022,Septiembre,Puerto Rico/Territorio de Estados Unidos,630,5,1,,6,"(10.445761,-75.516429)"
2022,Septiembre,Puerto Rico/Territorio de Estados Unidos,630,2,6,,8,"(10.886611,-74.776708)"
2022,Septiembre,Puerto Rico/Territorio de Estados Unidos,630,35,25,,60,"(3.541112,-76.384584)"
2022,Septiembre,Puerto Rico/Territorio de Estados Unidos,630,275,262,,537,"(4.697144,-74.140516)"
2022,Septiembre,Puerto Rico/Territorio de Estados Unidos,630,1,1,,2,"(4.815061,-75.736532)"
2022,Septiembre,Puerto Rico/Territorio de Estados Unidos,630,38,29,,67,"(6.171601,-75.427454)"
2022,Septiembre,Puerto Rico/Territorio de Estados Unidos,630,1,1,,2,"(7.128456,-73.183637)"
2022,Septiembre,Puerto Rico/Territorio de Estados Unidos,630,1,1,,2,"(7.927209,-72.507910)"
2022,Septiembre,Qatar,634,1,3,,4,"(10.445761,-75.516429)"
2022,Septiembre,Qatar,634,2,0,,2,"(3.541112,-76.384584)"
2022,Septiembre,Qatar,634,19,23,,42,"(4.697144,-74.140516)"
2022,Septiembre,Qatar,634,3,2,,5,"(6.171601,-75.427454)"
2022,Septiembre,Reino Unido de Gran Bretaña e Irlanda del Norte,826,13,6,,19,"(10.445761,-75.516429)"
2022,Septiembre,Reino Unido de Gran Bretaña e Irlanda del Norte,826,4,4,,8,"(10.886611,-74.776708)"
2022,Septiembre,Reino Unido de Gran Bretaña e Irlanda del Norte,826,91,51,,142,"(3.541112,-76.384584)"
2022,Septiembre,Reino Unido de Gran Bretaña e Irlanda del Norte,826,1934,1422,,3356,"(4.697144,-74.140516)"
2022,Septiembre,Reino Unido de Gran Bretaña e Irlanda del Norte,826,6,5,,11,"(4.815061,-75.736532)"
2022,Septiembre,Reino Unido de Gran Bretaña e Irlanda del Norte,826,71,43,,114,"(6.171601,-75.427454)"
2022,Septiembre,República CentroÁfricana,140,1,2,,3,"(4.697144,-74.140516)"
2022,Septiembre,Federación de Rusia,643,1,1,,2,"(10.445761,-75.516429)"
2022,Septiembre,Federación de Rusia,643,0,1,,1,"(3.541112,-76.384584)"
2022,Septiembre,Federación de Rusia,643,24,37,,61,"(4.697144,-74.140516)"
2022,Septiembre,Federación de Rusia,643,0,1,,1,"(4.815061,-75.736532)"
2022,Septiembre,Federación de Rusia,643,0,2,,2,"(6.171601,-75.427454)"
2022,Septiembre,República Dominicana,214,0,2,,2,"(10.408582,-75.538003)"
2022,Septiembre,República Dominicana,214,70,55,,125,"(10.445761,-75.516429)"
2022,Septiembre,República Dominicana,214,187,197,,384,"(10.886611,-74.776708)"
2022,Septiembre,República Dominicana,214,6,9,,15,"(11.117806,-74.232622)"
2022,Septiembre,República Dominicana,214,1,1,,2,"(12.586067,-81.702563)"
2022,Septiembre,República Dominicana,214,775,625,,1400,"(3.541112,-76.384584)"
2022,Septiembre,República Dominicana,214,1,1,,2,"(4.452882,-75.766298)"
2022,Septiembre,República Dominicana,214,7376,6181,,13557,"(4.697144,-74.140516)"
2022,Septiembre,República Dominicana,214,146,117,,263,"(4.815061,-75.736532)"
2022,Septiembre,República Dominicana,214,4918,3562,,8480,"(6.171601,-75.427454)"
2022,Septiembre,República Dominicana,214,68,52,,120,"(7.128456,-73.183637)"
2022,Septiembre,República Dominicana,214,7,5,,12,"(7.927209,-72.507910)"
2022,Septiembre,Rumania,642,3,2,,5,"(10.445761,-75.516429)"
2022,Septiembre,Rumania,642,1,0,,1,"(3.541112,-76.384584)"
2022,Septiembre,Rumania,642,13,11,,24,"(4.697144,-74.140516)"
2022,Septiembre,Rumania,642,1,1,,2,"(6.171601,-75.427454)"
2022,Septiembre,Rwanda,646,1,1,,2,"(3.541112,-76.384584)"
2022,Septiembre,Rwanda,646,4,0,,4,"(4.697144,-74.140516)"
2022,Septiembre,San Cristóbal y Nevis,659,1,1,,2,"(10.886611,-74.776708)"
2022,Septiembre,San Cristóbal y Nevis,659,0,1,,1,"(3.541112,-76.384584)"
2022,Septiembre,San Cristóbal y Nevis,659,1,0,,1,"(6.171601,-75.427454)"
2022,Septiembre,San Cristóbal y Nevis,659,1,4,,5,"(7.818934,-72.453226)"
2022,Septiembre,San Marino,674,1,0,,1,"(6.171601,-75.427454)"
2022,Septiembre,San  Vicente y las Granadinas,670,1,1,,2,"(4.697144,-74.140516)"
2022,Septiembre,Santa Elena/Territorio Británico de Ultramar,654,3,1,,4,"(0.814836,-77.662532)"
2022,Septiembre,Santa Lucia,662,0,1,,1,"(4.697144,-74.140516)"
2022,Septiembre,Santa Lucia,662,0,1,,1,"(6.171601,-75.427454)"
2022,Septiembre,Santa Sede/Ciudad del Vaticano,336,2,1,,3,"(4.697144,-74.140516)"
2022,Septiembre,Santo Tomé y Príncipe,678,1,0,,1,"(4.697144,-74.140516)"
2022,Septiembre,Senegal,686,3,2,,5,"(4.697144,-74.140516)"
2022,Septiembre,Senegal,686,1,1,,2,"(6.171601,-75.427454)"
2022,Septiembre,Serbia,688,2,4,,6,"(4.697144,-74.140516)"
2022,Septiembre,Seychelles,690,1,4,,5,"(4.697144,-74.140516)"
2022,Septiembre,Singapur,702,0,1,,1,"(10.445761,-75.516429)"
2022,Septiembre,Singapur,702,13,22,,35,"(4.697144,-74.140516)"
2022,Septiembre,Singapur,702,0,2,,2,"(6.171601,-75.427454)"
2022,Septiembre,Somalia,706,0,1,,1,"(4.697144,-74.140516)"
2022,Septiembre,Sudáfrica,710,12,12,,24,"(4.697144,-74.140516)"
2022,Septiembre,Sudáfrica,710,1,0,,1,"(6.171601,-75.427454)"
2022,Septiembre,Sudán,736,1,0,,1,"(4.697144,-74.140516)"
2022,Septiembre,Suecia,752,8,4,,12,"(10.445761,-75.516429)"
2022,Septiembre,Suecia,752,14,16,,30,"(3.541112,-76.384584)"
2022,Septiembre,Suecia,752,1,0,,1,"(4.452882,-75.766298)"
2022,Septiembre,Suecia,752,66,72,,138,"(4.697144,-74.140516)"
2022,Septiembre,Suecia,752,12,10,,22,"(6.171601,-75.427454)"
2022,Septiembre,Suiza,756,25,14,,39,"(10.445761,-75.516429)"
2022,Septiembre,Suiza,756,8,6,,14,"(10.886611,-74.776708)"
2022,Septiembre,Suiza,756,68,42,,110,"(3.541112,-76.384584)"
2022,Septiembre,Suiza,756,0,1,,1,"(4.452882,-75.766298)"
2022,Septiembre,Suiza,756,322,211,,533,"(4.697144,-74.140516)"
2022,Septiembre,Suiza,756,7,2,,9,"(4.815061,-75.736532)"
2022,Septiembre,Suiza,756,66,45,,111,"(6.171601,-75.427454)"
2022,Septiembre,Surinam,740,0,2,,2,"(10.408582,-75.538003)"
2022,Septiembre,Surinam,740,0,1,,1,"(10.445761,-75.516429)"
2022,Septiembre,Surinam,740,0,2,,2,"(10.886611,-74.776708)"
2022,Septiembre,Surinam,740,1,2,,3,"(3.541112,-76.384584)"
2022,Septiembre,Surinam,740,8,19,,27,"(4.697144,-74.140516)"
2022,Septiembre,Surinam,740,4,2,,6,"(6.171601,-75.427454)"
2022,Septiembre,Suazilandia,748,0,1,,1,"(4.697144,-74.140516)"
2022,Septiembre,Taiwán,158,2,2,,4,"(4.697144,-74.140516)"
2022,Septiembre,Tailandia,764,1,1,,2,"(10.445761,-75.516429)"
2022,Septiembre,Tailandia,764,13,18,,31,"(4.697144,-74.140516)"
2022,Septiembre,Tailandia,764,2,2,,4,"(6.171601,-75.427454)"
2022,Septiembre,Tanzania,834,1,0,,1,"(10.445761,-75.516429)"
2022,Septiembre,Tanzania,834,1,1,,2,"(3.541112,-76.384584)"
2022,Septiembre,Tanzania,834,2,4,,6,"(4.697144,-74.140516)"
2022,Septiembre,Tanzania,834,1,1,,2,"(6.171601,-75.427454)"
2022,Septiembre,Trinidad y Tobago,780,0,4,,4,"(10.445761,-75.516429)"
2022,Septiembre,Trinidad y Tobago,780,2,3,,5,"(10.886611,-74.776708)"
2022,Septiembre,Trinidad y Tobago,780,1,0,,1,"(11.117806,-74.232622)"
2022,Septiembre,Trinidad y Tobago,780,6,5,,11,"(3.541112,-76.384584)"
2022,Septiembre,Trinidad y Tobago,780,1,0,,1,"(4.452882,-75.766298)"
2022,Septiembre,Trinidad y Tobago,780,15,13,,28,"(4.697144,-74.140516)"
2022,Septiembre,Trinidad y Tobago,780,0,1,,1,"(4.815061,-75.736532)"
2022,Septiembre,Trinidad y Tobago,780,11,11,,22,"(6.171601,-75.427454)"
2022,Septiembre,Trinidad y Tobago,780,0,1,,1,"(7.927209,-72.507910)"
2022,Septiembre,Túnez,788,3,0,,3,"(4.697144,-74.140516)"
2022,Septiembre,Turquía,792,3,7,,10,"(10.445761,-75.516429)"
2022,Septiembre,Turquía,792,2,0,,2,"(10.886611,-74.776708)"
2022,Septiembre,Turquía,792,14,8,,22,"(3.541112,-76.384584)"
2022,Septiembre,Turquía,792,2067,1239,,3306,"(4.697144,-74.140516)"
2022,Septiembre,Turquía,792,4,1,,5,"(4.815061,-75.736532)"
2022,Septiembre,Turquía,792,32,23,,55,"(6.171601,-75.427454)"
2022,Septiembre,Tuvalu,798,2,0,,2,"(4.697144,-74.140516)"
2022,Septiembre,Turkmenistán,795,2,2,,4,"(4.697144,-74.140516)"
2022,Septiembre,Ucrania,804,0,1,,1,"(4.697144,-74.140516)"
2022,Septiembre,Uganda,800,3,9,,12,"(4.697144,-74.140516)"
2022,Septiembre,Uruguay,858,3,7,,10,"(10.445761,-75.516429)"
2022,Septiembre,Uruguay,858,4,2,,6,"(10.886611,-74.776708)"
2022,Septiembre,Uruguay,858,41,72,,113,"(3.541112,-76.384584)"
2022,Septiembre,Uruguay,858,1,2,,3,"(4.452882,-75.766298)"
2022,Septiembre,Uruguay,858,186,226,,412,"(4.697144,-74.140516)"
2022,Septiembre,Uruguay,858,5,7,,12,"(4.815061,-75.736532)"
2022,Septiembre,Uruguay,858,28,32,,60,"(6.171601,-75.427454)"
2022,Septiembre,Uruguay,858,3,3,,6,"(7.927209,-72.507910)"
2022,Septiembre,Uzbekistán,860,1,1,,2,"(4.697144,-74.140516)"
2022,Septiembre,Venezuela,862,8,12,,20,"(10.445761,-75.516429)"
2022,Septiembre,Venezuela,862,29,30,,59,"(10.886611,-74.776708)"
2022,Septiembre,Venezuela,862,0,2,,2,"(11.117806,-74.232622)"
2022,Septiembre,Venezuela,862,489,762,,1251,"(11.360009,-72.129330)"
2022,Septiembre,Venezuela,862,28,39,,67,"(3.541112,-76.384584)"
2022,Septiembre,Venezuela,862,1,4,,5,"(3.866713,-67.927521)"
2022,Septiembre,Venezuela,862,0,3,,3,"(4.452882,-75.766298)"
2022,Septiembre,Venezuela,862,138,303,,441,"(4.697144,-74.140516)"
2022,Septiembre,Venezuela,862,13,20,,33,"(4.815061,-75.736532)"
2022,Septiembre,Venezuela,862,51,80,,131,"(6.171601,-75.427454)"
2022,Septiembre,Venezuela,862,7,9,,16,"(6.18189,-67.47535)"
2022,Septiembre,Venezuela,862,33,69,,102,"(7.088729,-70.740253)"
2022,Septiembre,Venezuela,862,11,5,,16,"(7.128456,-73.183637)"
2022,Septiembre,Venezuela,862,542,754,,1296,"(7.818934,-72.453226)"
2022,Septiembre,Venezuela,862,117,154,,271,"(7.916725,-72.462544)"
2022,Septiembre,Venezuela,862,3,2,,5,"(7.927209,-72.507910)"
2022,Septiembre,Venezuela,862,44,87,,131,"(8.36068,-72.409396)"
2022,Septiembre,Vietnam,704,1,1,,2,"(3.541112,-76.384584)"
2022,Septiembre,Vietnam,704,3,7,,10,"(4.697144,-74.140516)"
2022,Septiembre,Islas Vírgenes Británicas/Territorio Británico de Ultramar,92,2,1,,3,"(3.541112,-76.384584)"
2022,Septiembre,Islas Vírgenes Británicas/Territorio Británico de Ultramar,92,0,1,,1,"(4.697144,-74.140516)"
2022,Septiembre,Islas Vírgenes Británicas/Territorio Británico de Ultramar,92,0,1,,1,"(6.171601,-75.427454)"
2022,Septiembre,Islas Vírgenes Estadounidenses/Territorio de Estados Unidos,850,1,0,,1,"(4.697144,-74.140516)"
2022,Septiembre,Anguila/Territorio Británico de Ultramar,660,2,3,,5,"(3.541112,-76.384584)"
2022,Septiembre,Anguila/Territorio Británico de Ultramar,660,2,5,,7,"(4.697144,-74.140516)"
2022,Septiembre,Islas Turcas y Caicos/Territorio Británico de Ultramar,796,2,1,,3,"(4.697144,-74.140516)"
2022,Septiembre,Islas Turcas y Caicos/Territorio Británico de Ultramar,796,2,0,,2,"(6.171601,-75.427454)"
2022,Octubre,Albania,8,2,1,,3,"(4.697144,-74.140516)"
2022,Octubre,Albania,8,1,0,,1,"(6.171601,-75.427454)"
2022,Octubre,Alemania,276,0,1,,1,"(0.814836,-77.662532)"
2022,Octubre,Alemania,276,70,49,,119,"(10.445761,-75.516429)"
2022,Octubre,Alemania,276,6,7,,13,"(10.886611,-74.776708)"
2022,Octubre,Alemania,276,53,49,,102,"(3.541112,-76.384584)"
2022,Octubre,Alemania,276,1327,1239,,2566,"(4.697144,-74.140516)"
2022,Octubre,Alemania,276,9,5,,14,"(4.815061,-75.736532)"
2022,Octubre,Alemania,276,106,143,,249,"(6.171601,-75.427454)"
2022,Octubre,Alemania,276,0,1,,1,"(7.927209,-72.507910)"
2022,Octubre,Andorra,20,25,19,,44,"(4.697144,-74.140516)"
2022,Octubre,Andorra,20,1,0,,1,"(6.171601,-75.427454)"
2022,Octubre,Angola,24,2,4,,6,"(4.697144,-74.140516)"
2022,Octubre,Angola,24,0,1,,1,"(6.171601,-75.427454)"
2022,Octubre,Antigua y Barbuda,28,2,3,,5,"(4.697144,-74.140516)"
2022,Octubre,Antigua y Barbuda,28,0,4,,4,"(4.815061,-75.736532)"
2022,Octubre,Antigua y Barbuda,28,1,0,,1,"(6.171601,-75.427454)"
2022,Octubre,Países Bajos,528,0,1,,1,"(10.408582,-75.538003)"
2022,Octubre,Países Bajos,528,255,241,,496,"(10.445761,-75.516429)"
2022,Octubre,Países Bajos,528,16,10,,26,"(10.886611,-74.776708)"
2022,Octubre,Países Bajos,528,78,52,,130,"(3.541112,-76.384584)"
2022,Octubre,Países Bajos,528,1133,1003,,2136,"(4.697144,-74.140516)"
2022,Octubre,Países Bajos,528,3,3,,6,"(4.815061,-75.736532)"
2022,Octubre,Países Bajos,528,93,76,,169,"(6.171601,-75.427454)"
2022,Octubre,Arabia Saudita,682,5,4,,9,"(10.445761,-75.516429)"
2022,Octubre,Arabia Saudita,682,0,1,,1,"(3.541112,-76.384584)"
2022,Octubre,Arabia Saudita,682,7,42,,49,"(4.697144,-74.140516)"
2022,Octubre,Arabia Saudita,682,0,1,,1,"(6.171601,-75.427454)"
2022,Octubre,Argelia,12,2,4,,6,"(4.697144,-74.140516)"
2022,Octubre,Argelia,12,0,1,,1,"(6.171601,-75.427454)"
2022,Octubre,Argentina,32,0,1,,1,"(0.812436,-77.847006)"
2022,Octubre,Argentina,32,5,10,,15,"(0.814836,-77.662532)"
2022,Octubre,Argentina,32,17,14,,31,"(10.445761,-75.516429)"
2022,Octubre,Argentina,32,17,13,,30,"(10.886611,-74.776708)"
2022,Octubre,Argentina,32,8,11,,19,"(11.117806,-74.232622)"
2022,Octubre,Argentina,32,0,1,,1,"(11.360009,-72.129330)"
2022,Octubre,Argentina,32,94,92,,186,"(3.541112,-76.384584)"
2022,Octubre,Argentina,32,14,12,,26,"(4.452882,-75.766298)"
2022,Octubre,Argentina,32,3697,3448,,7145,"(4.697144,-74.140516)"
2022,Octubre,Argentina,32,1,5,,6,"(4.815061,-75.736532)"
2022,Octubre,Argentina,32,386,367,,753,"(6.171601,-75.427454)"
2022,Octubre,Argentina,32,1,1,,2,"(7.128456,-73.183637)"
2022,Octubre,Argentina,32,7,8,,15,"(7.927209,-72.507910)"
2022,Octubre,República de Armenia,51,3,4,,7,"(4.697144,-74.140516)"
2022,Octubre,Aruba,533,0,9,,9,"(10.408582,-75.538003)"
2022,Octubre,Aruba,533,1,3,,4,"(10.445761,-75.516429)"
2022,Octubre,Aruba,533,192,141,,333,"(10.886611,-74.776708)"
2022,Octubre,Aruba,533,0,1,,1,"(11.117806,-74.232622)"
2022,Octubre,Aruba,533,1,9,,10,"(11.247723,-74.213989)"
2022,Octubre,Aruba,533,33,18,,51,"(3.541112,-76.384584)"
2022,Octubre,Aruba,533,1602,1322,,2924,"(4.697144,-74.140516)"
2022,Octubre,Aruba,533,7,1,,8,"(4.815061,-75.736532)"
2022,Octubre,Aruba,533,576,453,,1029,"(6.171601,-75.427454)"
2022,Octubre,Aruba,533,11,29,,40,"(7.128456,-73.183637)"
2022,Octubre,Australia,36,6,12,,18,"(10.445761,-75.516429)"
2022,Octubre,Australia,36,5,5,,10,"(10.886611,-74.776708)"
2022,Octubre,Australia,36,1,0,,1,"(11.117806,-74.232622)"
2022,Octubre,Australia,36,63,42,,105,"(3.541112,-76.384584)"
2022,Octubre,Australia,36,962,853,,1815,"(4.697144,-74.140516)"
2022,Octubre,Australia,36,12,5,,17,"(4.815061,-75.736532)"
2022,Octubre,Australia,36,130,93,,223,"(6.171601,-75.427454)"
2022,Octubre,Australia,36,3,3,,6,"(7.128456,-73.183637)"
2022,Octubre,Australia,36,2,0,,2,"(7.927209,-72.507910)"
2022,Octubre,Austria,40,4,4,,8,"(10.445761,-75.516429)"
2022,Octubre,Austria,40,0,1,,1,"(10.886611,-74.776708)"
2022,Octubre,Austria,40,0,1,,1,"(11.117806,-74.232622)"
2022,Octubre,Austria,40,9,2,,11,"(3.541112,-76.384584)"
2022,Octubre,Austria,40,97,79,,176,"(4.697144,-74.140516)"
2022,Octubre,Austria,40,5,10,,15,"(6.171601,-75.427454)"
2022,Octubre,Azerbaiyán,31,0,8,,8,"(4.697144,-74.140516)"
2022,Octubre,Bahamas,44,2,0,,2,"(10.445761,-75.516429)"
2022,Octubre,Bahamas,44,3,4,,7,"(10.886611,-74.776708)"
2022,Octubre,Bahamas,44,34,10,,44,"(3.541112,-76.384584)"
2022,Octubre,Bahamas,44,22,32,,54,"(4.697144,-74.140516)"
2022,Octubre,Bahamas,44,2,0,,2,"(4.815061,-75.736532)"
2022,Octubre,Bahamas,44,38,19,,57,"(6.171601,-75.427454)"
2022,Octubre,Bahréin,48,0,1,,1,"(10.445761,-75.516429)"
2022,Octubre,Bahréin,48,2,9,,11,"(4.697144,-74.140516)"
2022,Octubre,Bahréin,48,0,1,,1,"(6.171601,-75.427454)"
2022,Octubre,Bangladesh,50,0,2,,2,"(4.697144,-74.140516)"
2022,Octubre,Barbados,52,1,0,,1,"(10.886611,-74.776708)"
2022,Octubre,Barbados,52,0,3,,3,"(3.541112,-76.384584)"
2022,Octubre,Barbados,52,6,28,,34,"(4.697144,-74.140516)"
2022,Octubre,Barbados,52,0,1,,1,"(4.815061,-75.736532)"
2022,Octubre,Barbados,52,2,1,,3,"(6.171601,-75.427454)"
2022,Octubre,República de Belarús,112,1,0,,1,"(4.697144,-74.140516)"
2022,Octubre,Bélgica,56,7,10,,17,"(10.445761,-75.516429)"
2022,Octubre,Bélgica,56,28,12,,40,"(3.541112,-76.384584)"
2022,Octubre,Bélgica,56,126,114,,240,"(4.697144,-74.140516)"
2022,Octubre,Bélgica,56,2,0,,2,"(4.815061,-75.736532)"
2022,Octubre,Bélgica,56,48,40,,88,"(6.171601,-75.427454)"
2022,Octubre,Belice,84,1,2,,3,"(3.541112,-76.384584)"
2022,Octubre,Belice,84,1,6,,7,"(4.697144,-74.140516)"
2022,Octubre,Belice,84,3,1,,4,"(6.171601,-75.427454)"
2022,Octubre,Benín,204,0,1,,1,"(10.445761,-75.516429)"
2022,Octubre,Benín,204,0,1,,1,"(6.171601,-75.427454)"
2022,Octubre,Bermudas/Territorio Británico de Ultramar,60,0,3,,3,"(4.697144,-74.140516)"
2022,Octubre,Bermudas/Territorio Británico de Ultramar,60,0,1,,1,"(6.171601,-75.427454)"
2022,Octubre,Bolivia,68,0,1,,1,"(10.445761,-75.516429)"
2022,Octubre,Bolivia,68,2,1,,3,"(10.886611,-74.776708)"
2022,Octubre,Bolivia,68,16,6,,22,"(3.541112,-76.384584)"
2022,Octubre,Bolivia,68,0,1,,1,"(4.452882,-75.766298)"
2022,Octubre,Bolivia,68,446,644,,1090,"(4.697144,-74.140516)"
2022,Octubre,Bolivia,68,12,19,,31,"(4.815061,-75.736532)"
2022,Octubre,Bolivia,68,13,19,,32,"(6.171601,-75.427454)"
2022,Octubre,Bolivia,68,1,1,,2,"(7.128456,-73.183637)"
2022,Octubre,Bosnia y Herzegovina,70,34,22,,56,"(4.697144,-74.140516)"
2022,Octubre,Brasil,76,187,340,,527,"(-4.197703,-69.941278)"
2022,Octubre,Brasil,76,2,0,,2,"(-4.223468,-69.945098)"
2022,Octubre,Brasil,76,0,2,,2,"(0.814836,-77.662532)"
2022,Octubre,Brasil,76,8,19,,27,"(10.445761,-75.516429)"
2022,Octubre,Brasil,76,12,22,,34,"(10.886611,-74.776708)"
2022,Octubre,Brasil,76,0,1,,1,"(11.117806,-74.232622)"
2022,Octubre,Brasil,76,110,146,,256,"(3.541112,-76.384584)"
2022,Octubre,Brasil,76,17,21,,38,"(4.452882,-75.766298)"
2022,Octubre,Brasil,76,2580,3218,,5798,"(4.697144,-74.140516)"
2022,Octubre,Brasil,76,29,27,,56,"(4.815061,-75.736532)"
2022,Octubre,Brasil,76,582,589,,1171,"(6.171601,-75.427454)"
2022,Octubre,Brasil,76,5,2,,7,"(7.128456,-73.183637)"
2022,Octubre,Brasil,76,1,3,,4,"(7.927209,-72.507910)"
2022,Octubre,Brunei Darussalam,96,0,1,,1,"(4.697144,-74.140516)"
2022,Octubre,Bulgaria,100,2,2,,4,"(4.697144,-74.140516)"
2022,Octubre,Bulgaria,100,4,3,,7,"(6.171601,-75.427454)"
2022,Octubre,Burkina Faso,854,1,1,,2,"(4.697144,-74.140516)"
2022,Octubre,Cabo Verde,132,2,1,,3,"(4.697144,-74.140516)"
2022,Octubre,Islas Caimán/Territorio Británico de Ultramar,136,1,0,,1,"(10.445761,-75.516429)"
2022,Octubre,Islas Caimán/Territorio Británico de Ultramar,136,1,1,,2,"(10.886611,-74.776708)"
2022,Octubre,Islas Caimán/Territorio Británico de Ultramar,136,4,1,,5,"(12.586067,-81.702563)"
2022,Octubre,Islas Caimán/Territorio Británico de Ultramar,136,2,0,,2,"(3.541112,-76.384584)"
2022,Octubre,Islas Caimán/Territorio Británico de Ultramar,136,2,4,,6,"(4.697144,-74.140516)"
2022,Octubre,Islas Caimán/Territorio Británico de Ultramar,136,2,0,,2,"(6.171601,-75.427454)"
2022,Octubre,Camerún,120,1,1,,2,"(4.697144,-74.140516)"
2022,Octubre,Canadá,124,44,37,,81,"(10.445761,-75.516429)"
2022,Octubre,Canadá,124,38,30,,68,"(10.886611,-74.776708)"
2022,Octubre,Canadá,124,4,5,,9,"(11.117806,-74.232622)"
2022,Octubre,Canadá,124,3,3,,6,"(12.586067,-81.702563)"
2022,Octubre,Canadá,124,64,66,,130,"(3.541112,-76.384584)"
2022,Octubre,Canadá,124,9,5,,14,"(4.452882,-75.766298)"
2022,Octubre,Canadá,124,2377,2138,,4515,"(4.697144,-74.140516)"
2022,Octubre,Canadá,124,11,15,,26,"(4.815061,-75.736532)"
2022,Octubre,Canadá,124,206,199,,405,"(6.171601,-75.427454)"
2022,Octubre,Canadá,124,4,2,,6,"(7.128456,-73.183637)"
2022,Octubre,Chad,148,0,2,,2,"(4.697144,-74.140516)"
2022,Octubre,España,724,348,248,,596,"(10.445761,-75.516429)"
2022,Octubre,España,724,17,21,,38,"(10.886611,-74.776708)"
2022,Octubre,España,724,1,0,,1,"(11.117806,-74.232622)"
2022,Octubre,España,724,2810,2182,,4992,"(3.541112,-76.384584)"
2022,Octubre,España,724,5,3,,8,"(4.452882,-75.766298)"
2022,Octubre,España,724,23699,19690,,43389,"(4.697144,-74.140516)"
2022,Octubre,España,724,25,24,,49,"(4.815061,-75.736532)"
2022,Octubre,España,724,3567,2782,,6349,"(6.171601,-75.427454)"
2022,Octubre,España,724,1,1,,2,"(7.128456,-73.183637)"
2022,Octubre,España,724,1,0,,1,"(7.818934,-72.453226)"
2022,Octubre,Norfolk,574,0,1,,1,"(4.697144,-74.140516)"
2022,Octubre,Colombia,170,35,105,,140,"(4.697144,-74.140516)"
2022,Octubre,República Del Congo,178,0,1,,1,"(4.697144,-74.140516)"
2022,Octubre,Comoras,174,1,1,,2,"(0.814836,-77.662532)"
2022,Octubre,Comoras,174,2,1,,3,"(4.697144,-74.140516)"
2022,Octubre,República Democrática del Congo,180,0,5,,5,"(4.697144,-74.140516)"
2022,Octubre,República Democrática del Congo,180,0,1,,1,"(6.171601,-75.427454)"
2022,Octubre,República de Corea,410,1,0,,1,"(10.445761,-75.516429)"
2022,Octubre,República de Corea,410,2,1,,3,"(3.541112,-76.384584)"
2022,Octubre,República de Corea,410,56,86,,142,"(4.697144,-74.140516)"
2022,Octubre,República de Corea,410,0,1,,1,"(6.171601,-75.427454)"
2022,Octubre,Islas Malvinas,238,0,2,,2,"(4.697144,-74.140516)"
2022,Octubre,Costa de Marfil,384,0,1,,1,"(3.541112,-76.384584)"
2022,Octubre,Costa de Marfil,384,2,4,,6,"(4.697144,-74.140516)"
2022,Octubre,Costa de Marfil,384,0,2,,2,"(6.171601,-75.427454)"
2022,Octubre,Costa Rica,188,43,36,,79,"(10.445761,-75.516429)"
2022,Octubre,Costa Rica,188,23,23,,46,"(10.886611,-74.776708)"
2022,Octubre,Costa Rica,188,5,2,,7,"(11.117806,-74.232622)"
2022,Octubre,Costa Rica,188,1,9,,10,"(12.5744111,-81.703935)"
2022,Octubre,Costa Rica,188,1,1,,2,"(12.586067,-81.702563)"
2022,Octubre,Costa Rica,188,60,61,,121,"(3.541112,-76.384584)"
2022,Octubre,Costa Rica,188,1,4,,5,"(4.452882,-75.766298)"
2022,Octubre,Costa Rica,188,1341,1486,,2827,"(4.697144,-74.140516)"
2022,Octubre,Costa Rica,188,10,8,,18,"(4.815061,-75.736532)"
2022,Octubre,Costa Rica,188,292,236,,528,"(6.171601,-75.427454)"
2022,Octubre,Costa Rica,188,5,1,,6,"(7.128456,-73.183637)"
2022,Octubre,Costa Rica,188,0,1,,1,"(7.927209,-72.507910)"
2022,Octubre,Croacia,191,0,1,,1,"(10.445761,-75.516429)"
2022,Octubre,Croacia,191,1,1,,2,"(3.541112,-76.384584)"
2022,Octubre,Croacia,191,24,29,,53,"(4.697144,-74.140516)"
2022,Octubre,Croacia,191,4,5,,9,"(6.171601,-75.427454)"
2022,Octubre,Cuba,192,5,4,,9,"(10.445761,-75.516429)"
2022,Octubre,Cuba,192,17,8,,25,"(10.886611,-74.776708)"
2022,Octubre,Cuba,192,13,18,,31,"(3.541112,-76.384584)"
2022,Octubre,Cuba,192,952,1045,,1997,"(4.697144,-74.140516)"
2022,Octubre,Cuba,192,2,3,,5,"(4.815061,-75.736532)"
2022,Octubre,Cuba,192,426,393,,819,"(6.171601,-75.427454)"
2022,Octubre,Cuba,192,4,3,,7,"(7.128456,-73.183637)"
2022,Octubre,Cuba,192,1,1,,2,"(7.927209,-72.507910)"
2022,Octubre,Curazao,99999,52,26,,78,"(10.886611,-74.776708)"
2022,Octubre,Curazao,99999,20,13,,33,"(3.541112,-76.384584)"
2022,Octubre,Curazao,99999,1265,1095,,2360,"(4.697144,-74.140516)"
2022,Octubre,Curazao,99999,0,1,,1,"(4.815061,-75.736532)"
2022,Octubre,Curazao,99999,172,113,,285,"(6.171601,-75.427454)"
2022,Octubre,Curazao,99999,2,1,,3,"(7.128456,-73.183637)"
2022,Octubre,Curazao,99999,4,2,,6,"(7.927209,-72.507910)"
2022,Octubre,República Checa,203,2,2,,4,"(10.445761,-75.516429)"
2022,Octubre,República Checa,203,0,1,,1,"(10.886611,-74.776708)"
2022,Octubre,República Checa,203,1,0,,1,"(3.541112,-76.384584)"
2022,Octubre,República Checa,203,13,22,,35,"(4.697144,-74.140516)"
2022,Octubre,República Checa,203,0,1,,1,"(4.815061,-75.736532)"
2022,Octubre,República Checa,203,4,4,,8,"(6.171601,-75.427454)"
2022,Octubre,Chile,152,1,2,,3,"(0.25129,-76.875963)"
2022,Octubre,Chile,152,21,28,,49,"(0.814836,-77.662532)"
2022,Octubre,Chile,152,25,12,,37,"(10.445761,-75.516429)"
2022,Octubre,Chile,152,51,40,,91,"(10.886611,-74.776708)"
2022,Octubre,Chile,152,11,4,,15,"(11.117806,-74.232622)"
2022,Octubre,Chile,152,1,1,,2,"(12.586067,-81.702563)"
2022,Octubre,Chile,152,2255,1629,,3884,"(3.541112,-76.384584)"
2022,Octubre,Chile,152,37,25,,62,"(4.452882,-75.766298)"
2022,Octubre,Chile,152,4887,4281,,9168,"(4.697144,-74.140516)"
2022,Octubre,Chile,152,40,34,,74,"(4.815061,-75.736532)"
2022,Octubre,Chile,152,214,174,,388,"(6.171601,-75.427454)"
2022,Octubre,Chile,152,7,5,,12,"(7.128456,-73.183637)"
2022,Octubre,Chile,152,13,13,,26,"(7.927209,-72.507910)"
2022,Octubre,China,156,0,1,,1,"(10.445761,-75.516429)"
2022,Octubre,China,156,8,9,,17,"(4.697144,-74.140516)"
2022,Octubre,China,156,0,1,,1,"(6.171601,-75.427454)"
2022,Octubre,Chipre,196,1,0,,1,"(3.541112,-76.384584)"
2022,Octubre,Chipre,196,6,4,,10,"(4.697144,-74.140516)"
2022,Octubre,Dinamarca,208,2,1,,3,"(10.445761,-75.516429)"
2022,Octubre,Dinamarca,208,2,0,,2,"(3.541112,-76.384584)"
2022,Octubre,Dinamarca,208,34,23,,57,"(4.697144,-74.140516)"
2022,Octubre,Dinamarca,208,6,3,,9,"(6.171601,-75.427454)"
2022,Octubre,Dominica,212,0,1,,1,"(10.886611,-74.776708)"
2022,Octubre,Dominica,212,13,7,,20,"(4.697144,-74.140516)"
2022,Octubre,Dominica,212,3,1,,4,"(6.171601,-75.427454)"
2022,Octubre,Dominica,212,1,0,,1,"(7.927209,-72.507910)"
2022,Octubre,Ecuador,218,344,490,,834,"(0.25129,-76.875963)"
2022,Octubre,Ecuador,218,6,5,,11,"(0.812436,-77.847006)"
2022,Octubre,Ecuador,218,4000,4832,,8832,"(0.814836,-77.662532)"
2022,Octubre,Ecuador,218,18,30,,48,"(1.813928,-78.763924)"
2022,Octubre,Ecuador,218,10,13,,23,"(10.445761,-75.516429)"
2022,Octubre,Ecuador,218,10,24,,34,"(10.886611,-74.776708)"
2022,Octubre,Ecuador,218,4,3,,7,"(11.117806,-74.232622)"
2022,Octubre,Ecuador,218,0,1,,1,"(12.586067,-81.702563)"
2022,Octubre,Ecuador,218,50,77,,127,"(3.541112,-76.384584)"
2022,Octubre,Ecuador,218,3764,5058,,8822,"(4.697144,-74.140516)"
2022,Octubre,Ecuador,218,7,5,,12,"(4.815061,-75.736532)"
2022,Octubre,Ecuador,218,2,4,,6,"(6.17134,-75.427194)"
2022,Octubre,Ecuador,218,73,110,,183,"(6.171601,-75.427454)"
2022,Octubre,Egipto,818,0,6,,6,"(10.408582,-75.538003)"
2022,Octubre,Egipto,818,1,0,,1,"(10.445761,-75.516429)"
2022,Octubre,Egipto,818,3,2,,5,"(3.541112,-76.384584)"
2022,Octubre,Egipto,818,156,95,,251,"(4.697144,-74.140516)"
2022,Octubre,Egipto,818,3,2,,5,"(6.171601,-75.427454)"
2022,Octubre,El Salvador,222,7,15,,22,"(10.445761,-75.516429)"
2022,Octubre,El Salvador,222,13,6,,19,"(10.886611,-74.776708)"
2022,Octubre,El Salvador,222,3,0,,3,"(11.117806,-74.232622)"
2022,Octubre,El Salvador,222,13,20,,33,"(3.541112,-76.384584)"
2022,Octubre,El Salvador,222,374,498,,872,"(4.697144,-74.140516)"
2022,Octubre,El Salvador,222,1,3,,4,"(4.815061,-75.736532)"
2022,Octubre,El Salvador,222,28,55,,83,"(6.171601,-75.427454)"
2022,Octubre,El Salvador,222,1,9,,10,"(7.128456,-73.183637)"
2022,Octubre,Emiratos Árabes,784,10,20,,30,"(10.445761,-75.516429)"
2022,Octubre,Emiratos Árabes,784,1,1,,2,"(10.886611,-74.776708)"
2022,Octubre,Emiratos Árabes,784,0,1,,1,"(12.586067,-81.702563)"
2022,Octubre,Emiratos Árabes,784,5,8,,13,"(3.541112,-76.384584)"
2022,Octubre,Emiratos Árabes,784,1,0,,1,"(4.452882,-75.766298)"
2022,Octubre,Emiratos Árabes,784,290,365,,655,"(4.697144,-74.140516)"
2022,Octubre,Emiratos Árabes,784,20,31,,51,"(6.171601,-75.427454)"
2022,Octubre,Emiratos Árabes,784,1,0,,1,"(7.128456,-73.183637)"
2022,Octubre,Eritrea,232,2,0,,2,"(4.697144,-74.140516)"
2022,Octubre,Eslovaquia,703,1,2,,3,"(4.697144,-74.140516)"
2022,Octubre,Eslovenia,705,2,2,,4,"(4.697144,-74.140516)"
2022,Octubre,Estados Unidos de América,840,1,0,,1,"(10.408582,-75.538003)"
2022,Octubre,Estados Unidos de América,840,2965,2228,,5193,"(10.445761,-75.516429)"
2022,Octubre,Estados Unidos de América,840,3049,2404,,5453,"(10.886611,-74.776708)"
2022,Octubre,Estados Unidos de América,840,112,98,,210,"(11.117806,-74.232622)"
2022,Octubre,Estados Unidos de América,840,132,110,,242,"(12.586067,-81.702563)"
2022,Octubre,Estados Unidos de América,840,7196,5083,,12279,"(3.541112,-76.384584)"
2022,Octubre,Estados Unidos de América,840,1008,736,,1744,"(4.452882,-75.766298)"
2022,Octubre,Estados Unidos de América,840,36226,31392,,67618,"(4.697144,-74.140516)"
2022,Octubre,Estados Unidos de América,840,2103,1506,,3609,"(4.815061,-75.736532)"
2022,Octubre,Estados Unidos de América,840,1,8,,9,"(6.17134,-75.427194)"
2022,Octubre,Estados Unidos de América,840,13332,10771,,24103,"(6.171601,-75.427454)"
2022,Octubre,Estados Unidos de América,840,881,721,,1602,"(7.128456,-73.183637)"
2022,Octubre,Estados Unidos de América,840,120,90,,210,"(7.927209,-72.507910)"
2022,Octubre,Estonia,233,1,6,,7,"(4.697144,-74.140516)"
2022,Octubre,Estonia,233,2,1,,3,"(6.171601,-75.427454)"
2022,Octubre,Etiopia,231,0,3,,3,"(4.697144,-74.140516)"
2022,Octubre,Islas Fiji,242,2,0,,2,"(4.697144,-74.140516)"
2022,Octubre,Filipinas,608,0,3,,3,"(10.445761,-75.516429)"
2022,Octubre,Filipinas,608,1,0,,1,"(3.541112,-76.384584)"
2022,Octubre,Filipinas,608,6,6,,12,"(4.697144,-74.140516)"
2022,Octubre,Finlandia,246,4,2,,6,"(10.445761,-75.516429)"
2022,Octubre,Finlandia,246,3,1,,4,"(3.541112,-76.384584)"
2022,Octubre,Finlandia,246,14,17,,31,"(4.697144,-74.140516)"
2022,Octubre,Finlandia,246,1,3,,4,"(6.171601,-75.427454)"
2022,Octubre,Francia,250,43,27,,70,"(10.445761,-75.516429)"
2022,Octubre,Francia,250,10,5,,15,"(10.886611,-74.776708)"
2022,Octubre,Francia,250,70,53,,123,"(3.541112,-76.384584)"
2022,Octubre,Francia,250,2515,1986,,4501,"(4.697144,-74.140516)"
2022,Octubre,Francia,250,1,3,,4,"(4.815061,-75.736532)"
2022,Octubre,Francia,250,113,87,,200,"(6.171601,-75.427454)"
2022,Octubre,Francia,250,1,0,,1,"(7.128456,-73.183637)"
2022,Octubre,Gabón,266,0,4,,4,"(4.697144,-74.140516)"
2022,Octubre,Georgia,268,1,1,,2,"(10.445761,-75.516429)"
2022,Octubre,Georgia,268,3,0,,3,"(10.886611,-74.776708)"
2022,Octubre,Georgia,268,1,2,,3,"(3.541112,-76.384584)"
2022,Octubre,Georgia,268,1,0,,1,"(4.452882,-75.766298)"
2022,Octubre,Georgia,268,6,3,,9,"(4.697144,-74.140516)"
2022,Octubre,Georgia,268,0,1,,1,"(4.815061,-75.736532)"
2022,Octubre,Georgia,268,2,2,,4,"(6.171601,-75.427454)"
2022,Octubre,Ghana,288,0,3,,3,"(4.697144,-74.140516)"
2022,Octubre,Gibraltar/Territorio Británico de Ultramar,292,1,1,,2,"(4.697144,-74.140516)"
2022,Octubre,Granada,308,1,0,,1,"(3.541112,-76.384584)"
2022,Octubre,Granada,308,1,1,,2,"(4.697144,-74.140516)"
2022,Octubre,Grecia,300,10,8,,18,"(10.445761,-75.516429)"
2022,Octubre,Grecia,300,0,1,,1,"(10.886611,-74.776708)"
2022,Octubre,Grecia,300,8,2,,10,"(3.541112,-76.384584)"
2022,Octubre,Grecia,300,78,73,,151,"(4.697144,-74.140516)"
2022,Octubre,Grecia,300,4,1,,5,"(4.815061,-75.736532)"
2022,Octubre,Grecia,300,4,2,,6,"(6.171601,-75.427454)"
2022,Octubre,Grecia,300,0,1,,1,"(7.128456,-73.183637)"
2022,Octubre,Guatemala,320,4,9,,13,"(10.445761,-75.516429)"
2022,Octubre,Guatemala,320,9,16,,25,"(10.886611,-74.776708)"
2022,Octubre,Guatemala,320,75,72,,147,"(3.541112,-76.384584)"
2022,Octubre,Guatemala,320,3,2,,5,"(4.452882,-75.766298)"
2022,Octubre,Guatemala,320,630,865,,1495,"(4.697144,-74.140516)"
2022,Octubre,Guatemala,320,10,11,,21,"(4.815061,-75.736532)"
2022,Octubre,Guatemala,320,107,117,,224,"(6.171601,-75.427454)"
2022,Octubre,Guatemala,320,4,6,,10,"(7.128456,-73.183637)"
2022,Octubre,Guatemala,320,2,3,,5,"(7.927209,-72.507910)"
2022,Octubre,Guyana,328,0,3,,3,"(10.445761,-75.516429)"
2022,Octubre,Guyana,328,0,5,,5,"(10.886611,-74.776708)"
2022,Octubre,Guyana,328,0,1,,1,"(11.247723,-74.213989)"
2022,Octubre,Guyana,328,6,23,,29,"(4.697144,-74.140516)"
2022,Octubre,Guyana,328,1,6,,7,"(6.171601,-75.427454)"
2022,Octubre,Guyana,328,0,2,,2,"(7.128456,-73.183637)"
2022,Octubre,Guinea,324,0,2,,2,"(4.697144,-74.140516)"
2022,Octubre,Guinea Ecuatorial,226,1,0,,1,"(3.541112,-76.384584)"
2022,Octubre,Guinea Ecuatorial,226,1,3,,4,"(4.697144,-74.140516)"
2022,Octubre,Guinea Bissau,624,1,0,,1,"(3.541112,-76.384584)"
2022,Octubre,Guadalupe/Territorio Francés,312,1,0,,1,"(3.541112,-76.384584)"
2022,Octubre,Guadalupe/Territorio Francés,312,1,0,,1,"(4.697144,-74.140516)"
2022,Octubre,Guadalupe/Territorio Francés,312,1,1,,2,"(6.171601,-75.427454)"
2022,Octubre,Guayana Francesa/Departamento de Ultramar Francés,254,1,0,,1,"(3.541112,-76.384584)"
2022,Octubre,Guayana Francesa/Departamento de Ultramar Francés,254,2,2,,4,"(4.697144,-74.140516)"
2022,Octubre,Guayana Francesa/Departamento de Ultramar Francés,254,0,1,,1,"(6.171601,-75.427454)"
2022,Octubre,Haití,332,0,1,,1,"(3.541112,-76.384584)"
2022,Octubre,Haití,332,2,9,,11,"(4.697144,-74.140516)"
2022,Octubre,Haití,332,1,0,,1,"(6.171601,-75.427454)"
2022,Octubre,Honduras,340,4,21,,25,"(10.445761,-75.516429)"
2022,Octubre,Honduras,340,1,13,,14,"(10.886611,-74.776708)"
2022,Octubre,Honduras,340,1,0,,1,"(12.586067,-81.702563)"
2022,Octubre,Honduras,340,14,12,,26,"(3.541112,-76.384584)"
2022,Octubre,Honduras,340,0,1,,1,"(4.452882,-75.766298)"
2022,Octubre,Honduras,340,97,137,,234,"(4.697144,-74.140516)"
2022,Octubre,Honduras,340,7,14,,21,"(4.815061,-75.736532)"
2022,Octubre,Honduras,340,44,59,,103,"(6.171601,-75.427454)"
2022,Octubre,Honduras,340,1,8,,9,"(7.128456,-73.183637)"
2022,Octubre,Hong Kong,344,0,1,,1,"(3.541112,-76.384584)"
2022,Octubre,Hong Kong,344,9,8,,17,"(4.697144,-74.140516)"
2022,Octubre,Hong Kong,344,1,0,,1,"(6.171601,-75.427454)"
2022,Octubre,Hungría,348,0,1,,1,"(10.445761,-75.516429)"
2022,Octubre,Hungría,348,6,14,,20,"(4.697144,-74.140516)"
2022,Octubre,Hungría,348,1,0,,1,"(6.171601,-75.427454)"
2022,Octubre,India,356,2,0,,2,"(10.445761,-75.516429)"
2022,Octubre,India,356,1,0,,1,"(10.886611,-74.776708)"
2022,Octubre,India,356,2,2,,4,"(3.541112,-76.384584)"
2022,Octubre,India,356,57,51,,108,"(4.697144,-74.140516)"
2022,Octubre,India,356,4,1,,5,"(6.171601,-75.427454)"
2022,Octubre,Indonesia,360,0,4,,4,"(10.445761,-75.516429)"
2022,Octubre,Indonesia,360,1,1,,2,"(10.886611,-74.776708)"
2022,Octubre,Indonesia,360,10,13,,23,"(4.697144,-74.140516)"
2022,Octubre,Indonesia,360,2,0,,2,"(6.171601,-75.427454)"
2022,Octubre,Iraq,368,0,9,,9,"(4.697144,-74.140516)"
2022,Octubre,República de Irlanda,372,1,1,,2,"(10.445761,-75.516429)"
2022,Octubre,República de Irlanda,372,0,1,,1,"(3.541112,-76.384584)"
2022,Octubre,República de Irlanda,372,16,16,,32,"(4.697144,-74.140516)"
2022,Octubre,República de Irlanda,372,3,1,,4,"(6.171601,-75.427454)"
2022,Octubre,Islandia,352,3,2,,5,"(10.445761,-75.516429)"
2022,Octubre,Islandia,352,1,2,,3,"(3.541112,-76.384584)"
2022,Octubre,Islandia,352,8,7,,15,"(4.697144,-74.140516)"
2022,Octubre,Islandia,352,9,6,,15,"(6.171601,-75.427454)"
2022,Octubre,Israel,376,7,4,,11,"(10.445761,-75.516429)"
2022,Octubre,Israel,376,14,1,,15,"(10.886611,-74.776708)"
2022,Octubre,Israel,376,5,3,,8,"(3.541112,-76.384584)"
2022,Octubre,Israel,376,366,234,,600,"(4.697144,-74.140516)"
2022,Octubre,Israel,376,0,1,,1,"(4.815061,-75.736532)"
2022,Octubre,Israel,376,17,9,,26,"(6.171601,-75.427454)"
2022,Octubre,Italia,380,66,49,,115,"(10.445761,-75.516429)"
2022,Octubre,Italia,380,2,5,,7,"(10.886611,-74.776708)"
2022,Octubre,Italia,380,4,1,,5,"(11.117806,-74.232622)"
2022,Octubre,Italia,380,112,62,,174,"(3.541112,-76.384584)"
2022,Octubre,Italia,380,2,0,,2,"(4.452882,-75.766298)"
2022,Octubre,Italia,380,1047,815,,1862,"(4.697144,-74.140516)"
2022,Octubre,Italia,380,2,4,,6,"(4.815061,-75.736532)"
2022,Octubre,Italia,380,151,110,,261,"(6.171601,-75.427454)"
2022,Octubre,Jamaica,388,1,0,,1,"(10.445761,-75.516429)"
2022,Octubre,Jamaica,388,5,4,,9,"(10.886611,-74.776708)"
2022,Octubre,Jamaica,388,10,8,,18,"(3.541112,-76.384584)"
2022,Octubre,Jamaica,388,43,49,,92,"(4.697144,-74.140516)"
2022,Octubre,Jamaica,388,3,1,,4,"(4.815061,-75.736532)"
2022,Octubre,Jamaica,388,18,11,,29,"(6.171601,-75.427454)"
2022,Octubre,Jamaica,388,4,0,,4,"(7.128456,-73.183637)"
2022,Octubre,Jamaica,388,0,1,,1,"(7.927209,-72.507910)"
2022,Octubre,Japón,392,3,1,,4,"(3.541112,-76.384584)"
2022,Octubre,Japón,392,42,49,,91,"(4.697144,-74.140516)"
2022,Octubre,Japón,392,2,0,,2,"(4.815061,-75.736532)"
2022,Octubre,Japón,392,3,0,,3,"(6.171601,-75.427454)"
2022,Octubre,Jordania,400,5,6,,11,"(4.697144,-74.140516)"
2022,Octubre,Jordania,400,1,0,,1,"(6.171601,-75.427454)"
2022,Octubre,Kazajistán,398,1,2,,3,"(4.697144,-74.140516)"
2022,Octubre,Kenia,404,0,1,,1,"(10.445761,-75.516429)"
2022,Octubre,Kenia,404,5,1,,6,"(3.541112,-76.384584)"
2022,Octubre,Kenia,404,5,6,,11,"(4.697144,-74.140516)"
2022,Octubre,Kenia,404,1,1,,2,"(6.171601,-75.427454)"
2022,Octubre,Kuwait,414,0,1,,1,"(10.445761,-75.516429)"
2022,Octubre,Kuwait,414,3,6,,9,"(4.697144,-74.140516)"
2022,Octubre,Kuwait,414,0,1,,1,"(6.171601,-75.427454)"
2022,Octubre,Letonia,428,0,1,,1,"(4.697144,-74.140516)"
2022,Octubre,Lituania,440,0,1,,1,"(10.445761,-75.516429)"
2022,Octubre,Lituania,440,4,6,,10,"(4.697144,-74.140516)"
2022,Octubre,Lituania,440,1,0,,1,"(6.171601,-75.427454)"
2022,Octubre,Líbano,422,9,7,,16,"(4.697144,-74.140516)"
2022,Octubre,Luxemburgo,442,0,1,,1,"(10.886611,-74.776708)"
2022,Octubre,Luxemburgo,442,0,1,,1,"(3.541112,-76.384584)"
2022,Octubre,Luxemburgo,442,18,8,,26,"(4.697144,-74.140516)"
2022,Octubre,Luxemburgo,442,2,0,,2,"(6.171601,-75.427454)"
2022,Octubre,Macao,446,3,2,,5,"(6.171601,-75.427454)"
2022,Octubre,Macedonia,807,2,2,,4,"(4.697144,-74.140516)"
2022,Octubre,Macedonia,807,1,0,,1,"(6.171601,-75.427454)"
2022,Octubre,Malasia,458,4,3,,7,"(4.697144,-74.140516)"
2022,Octubre,Maldivas,462,4,4,,8,"(3.541112,-76.384584)"
2022,Octubre,Maldivas,462,48,57,,105,"(4.697144,-74.140516)"
2022,Octubre,Maldivas,462,2,4,,6,"(6.171601,-75.427454)"
2022,Octubre,Malta,470,4,3,,7,"(10.445761,-75.516429)"
2022,Octubre,Malta,470,8,2,,10,"(3.541112,-76.384584)"
2022,Octubre,Malta,470,139,124,,263,"(4.697144,-74.140516)"
2022,Octubre,Malta,470,6,1,,7,"(6.171601,-75.427454)"
2022,Octubre,Marruecos,504,0,1,,1,"(10.886611,-74.776708)"
2022,Octubre,Marruecos,504,2,1,,3,"(3.541112,-76.384584)"
2022,Octubre,Marruecos,504,30,20,,50,"(4.697144,-74.140516)"
2022,Octubre,Marruecos,504,5,3,,8,"(6.171601,-75.427454)"
2022,Octubre,Mauricio,480,2,2,,4,"(4.697144,-74.140516)"
2022,Octubre,Mauritania,478,1,3,,4,"(4.697144,-74.140516)"
2022,Octubre,Martinica/Departamento de Ultramar Francés,474,1,0,,1,"(3.541112,-76.384584)"
2022,Octubre,Martinica/Departamento de Ultramar Francés,474,1,1,,2,"(4.697144,-74.140516)"
2022,Octubre,México,484,1,0,,1,"(0.814836,-77.662532)"
2022,Octubre,México,484,456,386,,842,"(10.445761,-75.516429)"
2022,Octubre,México,484,441,391,,832,"(10.886611,-74.776708)"
2022,Octubre,México,484,35,28,,63,"(11.117806,-74.232622)"
2022,Octubre,México,484,4,3,,7,"(12.586067,-81.702563)"
2022,Octubre,México,484,3561,3142,,6703,"(3.541112,-76.384584)"
2022,Octubre,México,484,47,39,,86,"(4.452882,-75.766298)"
2022,Octubre,México,484,27855,26382,,54237,"(4.697144,-74.140516)"
2022,Octubre,México,484,310,231,,541,"(4.815061,-75.736532)"
2022,Octubre,México,484,10196,9124,,19320,"(6.171601,-75.427454)"
2022,Octubre,México,484,140,110,,250,"(7.128456,-73.183637)"
2022,Octubre,México,484,77,86,,163,"(7.927209,-72.507910)"
2022,Octubre,Mayotte/Colectividad Territorial Francesa,175,1,1,,2,"(4.697144,-74.140516)"
2022,Octubre,Mayotte/Colectividad Territorial Francesa,175,0,1,,1,"(6.171601,-75.427454)"
2022,Octubre,República de Moldavia,498,1,0,,1,"(4.697144,-74.140516)"
2022,Octubre,Mónaco,492,2,1,,3,"(4.697144,-74.140516)"
2022,Octubre,Montenegro,499,0,2,,2,"(4.697144,-74.140516)"
2022,Octubre,Micronesia,583,2,1,,3,"(4.697144,-74.140516)"
2022,Octubre,Micronesia,583,1,0,,1,"(6.171601,-75.427454)"
2022,Octubre,Namibia,516,0,1,,1,"(4.697144,-74.140516)"
2022,Octubre,Nepal,524,5,4,,9,"(4.697144,-74.140516)"
2022,Octubre,Nepal,524,1,1,,2,"(6.171601,-75.427454)"
2022,Octubre,Nicaragua,558,1,1,,2,"(10.445761,-75.516429)"
2022,Octubre,Nicaragua,558,1,1,,2,"(10.886611,-74.776708)"
2022,Octubre,Nicaragua,558,4,7,,11,"(3.541112,-76.384584)"
2022,Octubre,Nicaragua,558,2,1,,3,"(4.452882,-75.766298)"
2022,Octubre,Nicaragua,558,17,41,,58,"(4.697144,-74.140516)"
2022,Octubre,Nicaragua,558,0,3,,3,"(4.815061,-75.736532)"
2022,Octubre,Nicaragua,558,19,30,,49,"(6.171601,-75.427454)"
2022,Octubre,Nicaragua,558,0,1,,1,"(7.128456,-73.183637)"
2022,Octubre,Nigeria,566,2,1,,3,"(4.697144,-74.140516)"
2022,Octubre,Noruega,578,6,4,,10,"(10.445761,-75.516429)"
2022,Octubre,Noruega,578,7,5,,12,"(3.541112,-76.384584)"
2022,Octubre,Noruega,578,37,33,,70,"(4.697144,-74.140516)"
2022,Octubre,Noruega,578,7,4,,11,"(6.171601,-75.427454)"
2022,Octubre,Nueva Caledonia/Territorio francés,540,0,2,,2,"(4.697144,-74.140516)"
2022,Octubre,Nueva Zelanda,554,0,2,,2,"(3.541112,-76.384584)"
2022,Octubre,Nueva Zelanda,554,35,25,,60,"(4.697144,-74.140516)"
2022,Octubre,Nueva Zelanda,554,4,4,,8,"(6.171601,-75.427454)"
2022,Octubre,Omán,512,5,8,,13,"(4.697144,-74.140516)"
2022,Octubre,Omán,512,0,1,,1,"(6.171601,-75.427454)"
2022,Octubre,Papúa Nueva Guinea,598,1,0,,1,"(10.445761,-75.516429)"
2022,Octubre,Papúa Nueva Guinea,598,0,3,,3,"(4.697144,-74.140516)"
2022,Octubre,Papúa Nueva Guinea,598,2,1,,3,"(6.171601,-75.427454)"
2022,Octubre,Pakistán,586,0,4,,4,"(4.697144,-74.140516)"
2022,Octubre,Pakistán,586,1,0,,1,"(7.128456,-73.183637)"
2022,Octubre,Panamá,591,14,76,,90,"(10.408582,-75.538003)"
2022,Octubre,Panamá,591,947,830,,1777,"(10.445761,-75.516429)"
2022,Octubre,Panamá,591,1167,1101,,2268,"(10.886611,-74.776708)"
2022,Octubre,Panamá,591,49,42,,91,"(11.117806,-74.232622)"
2022,Octubre,Panamá,591,0,1,,1,"(12.165168,-71.983761)"
2022,Octubre,Panamá,591,0,13,,13,"(12.5744111,-81.703935)"
2022,Octubre,Panamá,591,25,26,,51,"(12.586067,-81.702563)"
2022,Octubre,Panamá,591,2222,1742,,3964,"(3.541112,-76.384584)"
2022,Octubre,Panamá,591,0,13,,13,"(3.893038,-77.067921)"
2022,Octubre,Panamá,591,141,102,,243,"(4.452882,-75.766298)"
2022,Octubre,Panamá,591,7375,7806,,15181,"(4.697144,-74.140516)"
2022,Octubre,Panamá,591,259,215,,474,"(4.815061,-75.736532)"
2022,Octubre,Panamá,591,0,5,,5,"(6.17134,-75.427194)"
2022,Octubre,Panamá,591,3173,3095,,6268,"(6.171601,-75.427454)"
2022,Octubre,Panamá,591,0,7,,7,"(6.228046,-77.404104)"
2022,Octubre,Panamá,591,11,21,,32,"(7.102626,-77.762647)"
2022,Octubre,Panamá,591,86,69,,155,"(7.128456,-73.183637)"
2022,Octubre,Panamá,591,73,66,,139,"(7.927209,-72.507910)"
2022,Octubre,Panamá,591,20,51,,71,"(8.635765,-77.346578)"
2022,Octubre,Paraguay,600,2,2,,4,"(10.445761,-75.516429)"
2022,Octubre,Paraguay,600,4,17,,21,"(10.886611,-74.776708)"
2022,Octubre,Paraguay,600,2,1,,3,"(11.117806,-74.232622)"
2022,Octubre,Paraguay,600,43,75,,118,"(3.541112,-76.384584)"
2022,Octubre,Paraguay,600,5,2,,7,"(4.452882,-75.766298)"
2022,Octubre,Paraguay,600,338,435,,773,"(4.697144,-74.140516)"
2022,Octubre,Paraguay,600,7,4,,11,"(4.815061,-75.736532)"
2022,Octubre,Paraguay,600,33,73,,106,"(6.171601,-75.427454)"
2022,Octubre,Paraguay,600,0,1,,1,"(7.128456,-73.183637)"
2022,Octubre,Paraguay,600,1,2,,3,"(7.927209,-72.507910)"
2022,Octubre,Perú,604,0,7,,7,"(-0.193180,-74.784874)"
2022,Octubre,Perú,604,0,3,,3,"(-3.790089,-70.356599)"
2022,Octubre,Perú,604,61,103,,164,"(-4.197703,-69.941278)"
2022,Octubre,Perú,604,70,79,,149,"(-4.223468,-69.945098)"
2022,Octubre,Perú,604,0,1,,1,"(0.812436,-77.847006)"
2022,Octubre,Perú,604,32,42,,74,"(0.814836,-77.662532)"
2022,Octubre,Perú,604,52,41,,93,"(10.445761,-75.516429)"
2022,Octubre,Perú,604,29,26,,55,"(10.886611,-74.776708)"
2022,Octubre,Perú,604,5,3,,8,"(11.117806,-74.232622)"
2022,Octubre,Perú,604,254,262,,516,"(3.541112,-76.384584)"
2022,Octubre,Perú,604,4,4,,8,"(4.452882,-75.766298)"
2022,Octubre,Perú,604,4889,4976,,9865,"(4.697144,-74.140516)"
2022,Octubre,Perú,604,8,9,,17,"(4.815061,-75.736532)"
2022,Octubre,Perú,604,1074,948,,2022,"(6.171601,-75.427454)"
2022,Octubre,Perú,604,7,0,,7,"(7.128456,-73.183637)"
2022,Octubre,Perú,604,1,0,,1,"(7.927209,-72.507910)"
2022,Octubre,Polonia,616,3,3,,6,"(10.445761,-75.516429)"
2022,Octubre,Polonia,616,3,3,,6,"(3.541112,-76.384584)"
2022,Octubre,Polonia,616,53,126,,179,"(4.697144,-74.140516)"
2022,Octubre,Polonia,616,1,3,,4,"(6.171601,-75.427454)"
2022,Octubre,Portugal,620,11,2,,13,"(10.445761,-75.516429)"
2022,Octubre,Portugal,620,1,3,,4,"(10.886611,-74.776708)"
2022,Octubre,Portugal,620,1,1,,2,"(11.117806,-74.232622)"
2022,Octubre,Portugal,620,11,14,,25,"(3.541112,-76.384584)"
2022,Octubre,Portugal,620,306,323,,629,"(4.697144,-74.140516)"
2022,Octubre,Portugal,620,44,66,,110,"(6.171601,-75.427454)"
2022,Octubre,Puerto Rico/Territorio de Estados Unidos,630,4,4,,8,"(10.445761,-75.516429)"
2022,Octubre,Puerto Rico/Territorio de Estados Unidos,630,3,1,,4,"(10.886611,-74.776708)"
2022,Octubre,Puerto Rico/Territorio de Estados Unidos,630,3,1,,4,"(11.117806,-74.232622)"
2022,Octubre,Puerto Rico/Territorio de Estados Unidos,630,1,0,,1,"(12.586067,-81.702563)"
2022,Octubre,Puerto Rico/Territorio de Estados Unidos,630,35,27,,62,"(3.541112,-76.384584)"
2022,Octubre,Puerto Rico/Territorio de Estados Unidos,630,3,2,,5,"(4.452882,-75.766298)"
2022,Octubre,Puerto Rico/Territorio de Estados Unidos,630,344,309,,653,"(4.697144,-74.140516)"
2022,Octubre,Puerto Rico/Territorio de Estados Unidos,630,40,22,,62,"(6.171601,-75.427454)"
2022,Octubre,Puerto Rico/Territorio de Estados Unidos,630,2,0,,2,"(7.128456,-73.183637)"
2022,Octubre,Puerto Rico/Territorio de Estados Unidos,630,1,1,,2,"(7.927209,-72.507910)"
2022,Octubre,Qatar,634,0,1,,1,"(10.445761,-75.516429)"
2022,Octubre,Qatar,634,2,1,,3,"(3.541112,-76.384584)"
2022,Octubre,Qatar,634,26,37,,63,"(4.697144,-74.140516)"
2022,Octubre,Qatar,634,4,3,,7,"(6.171601,-75.427454)"
2022,Octubre,Reino Unido de Gran Bretaña e Irlanda del Norte,826,9,4,,13,"(10.445761,-75.516429)"
2022,Octubre,Reino Unido de Gran Bretaña e Irlanda del Norte,826,1,0,,1,"(10.886611,-74.776708)"
2022,Octubre,Reino Unido de Gran Bretaña e Irlanda del Norte,826,15,10,,25,"(3.541112,-76.384584)"
2022,Octubre,Reino Unido de Gran Bretaña e Irlanda del Norte,826,1491,1149,,2640,"(4.697144,-74.140516)"
2022,Octubre,Reino Unido de Gran Bretaña e Irlanda del Norte,826,4,0,,4,"(4.815061,-75.736532)"
2022,Octubre,Reino Unido de Gran Bretaña e Irlanda del Norte,826,15,11,,26,"(6.171601,-75.427454)"
2022,Octubre,República CentroÁfricana,140,3,0,,3,"(4.697144,-74.140516)"
2022,Octubre,Federación de Rusia,643,0,1,,1,"(10.445761,-75.516429)"
2022,Octubre,Federación de Rusia,643,1,1,,2,"(3.541112,-76.384584)"
2022,Octubre,Federación de Rusia,643,46,34,,80,"(4.697144,-74.140516)"
2022,Octubre,República Dominicana,214,129,122,,251,"(10.445761,-75.516429)"
2022,Octubre,República Dominicana,214,282,241,,523,"(10.886611,-74.776708)"
2022,Octubre,República Dominicana,214,7,15,,22,"(11.117806,-74.232622)"
2022,Octubre,República Dominicana,214,6,3,,9,"(12.586067,-81.702563)"
2022,Octubre,República Dominicana,214,804,692,,1496,"(3.541112,-76.384584)"
2022,Octubre,República Dominicana,214,8878,7778,,16657,"(4.697144,-74.140516)"
2022,Octubre,República Dominicana,214,99,69,,168,"(4.815061,-75.736532)"
2022,Octubre,República Dominicana,214,5628,4351,,9979,"(6.171601,-75.427454)"
2022,Octubre,República Dominicana,214,34,19,,53,"(7.128456,-73.183637)"
2022,Octubre,República Dominicana,214,5,3,,8,"(7.927209,-72.507910)"
2022,Octubre,República Democrática Popular de Corea,408,0,1,,1,"(4.697144,-74.140516)"
2022,Octubre,Rumania,642,0,2,,2,"(10.445761,-75.516429)"
2022,Octubre,Rumania,642,0,1,,1,"(3.541112,-76.384584)"
2022,Octubre,Rumania,642,10,13,,23,"(4.697144,-74.140516)"
2022,Octubre,Rwanda,646,1,0,,1,"(4.697144,-74.140516)"
2022,Octubre,San Cristóbal y Nevis,659,2,6,,8,"(4.697144,-74.140516)"
2022,Octubre,San Cristóbal y Nevis,659,0,4,,4,"(7.818934,-72.453226)"
2022,Octubre,San Cristóbal y Nevis,659,0,1,,1,"(7.916725,-72.462544)"
2022,Octubre,San  Vicente y las Granadinas,670,4,3,,7,"(4.697144,-74.140516)"
2022,Octubre,San  Vicente y las Granadinas,670,1,0,,1,"(6.171601,-75.427454)"
2022,Octubre,Santa Elena/Territorio Británico de Ultramar,654,1,0,,1,"(4.697144,-74.140516)"
2022,Octubre,Santa Lucia,662,1,3,,4,"(4.697144,-74.140516)"
2022,Octubre,Santa Sede/Ciudad del Vaticano,336,2,1,,3,"(4.697144,-74.140516)"
2022,Octubre,Senegal,686,1,7,,8,"(4.697144,-74.140516)"
2022,Octubre,Serbia,688,3,7,,10,"(4.697144,-74.140516)"
2022,Octubre,Seychelles,690,0,1,,1,"(4.697144,-74.140516)"
2022,Octubre,Sierra Leona,694,0,2,,2,"(4.697144,-74.140516)"
2022,Octubre,Singapur,702,1,0,,1,"(3.541112,-76.384584)"
2022,Octubre,Singapur,702,66,56,,122,"(4.697144,-74.140516)"
2022,Octubre,Somalia,706,0,1,,1,"(4.697144,-74.140516)"
2022,Octubre,Sri Lanka,144,0,2,,2,"(4.697144,-74.140516)"
2022,Octubre,Sudáfrica,710,1,1,,2,"(3.541112,-76.384584)"
2022,Octubre,Sudáfrica,710,15,10,,25,"(4.697144,-74.140516)"
2022,Octubre,Sudáfrica,710,3,0,,3,"(6.171601,-75.427454)"
2022,Octubre,Suecia,752,7,2,,9,"(10.445761,-75.516429)"
2022,Octubre,Suecia,752,0,2,,2,"(10.886611,-74.776708)"
2022,Octubre,Suecia,752,14,18,,32,"(3.541112,-76.384584)"
2022,Octubre,Suecia,752,76,72,,148,"(4.697144,-74.140516)"
2022,Octubre,Suecia,752,1,0,,1,"(4.815061,-75.736532)"
2022,Octubre,Suecia,752,10,8,,18,"(6.171601,-75.427454)"
2022,Octubre,Suiza,756,34,13,,47,"(10.445761,-75.516429)"
2022,Octubre,Suiza,756,1,3,,4,"(10.886611,-74.776708)"
2022,Octubre,Suiza,756,78,64,,142,"(3.541112,-76.384584)"
2022,Octubre,Suiza,756,1,1,,2,"(4.452882,-75.766298)"
2022,Octubre,Suiza,756,348,201,,549,"(4.697144,-74.140516)"
2022,Octubre,Suiza,756,6,7,,13,"(4.815061,-75.736532)"
2022,Octubre,Suiza,756,39,22,,61,"(6.171601,-75.427454)"
2022,Octubre,Suiza,756,0,1,,1,"(7.927209,-72.507910)"
2022,Octubre,Surinam,740,0,3,,3,"(10.445761,-75.516429)"
2022,Octubre,Surinam,740,0,1,,1,"(10.886611,-74.776708)"
2022,Octubre,Surinam,740,0,2,,2,"(3.541112,-76.384584)"
2022,Octubre,Surinam,740,9,36,,45,"(4.697144,-74.140516)"
2022,Octubre,Surinam,740,6,3,,9,"(6.171601,-75.427454)"
2022,Octubre,Taiwán,158,0,3,,3,"(10.445761,-75.516429)"
2022,Octubre,Taiwán,158,1,12,,13,"(4.697144,-74.140516)"
2022,Octubre,Tailandia,764,44,25,,69,"(4.697144,-74.140516)"
2022,Octubre,Tailandia,764,1,3,,4,"(6.171601,-75.427454)"
2022,Octubre,Tanzania,834,3,2,,5,"(4.697144,-74.140516)"
2022,Octubre,Togo,768,1,0,,1,"(4.697144,-74.140516)"
2022,Octubre,Trinidad y Tobago,780,0,1,,1,"(10.445761,-75.516429)"
2022,Octubre,Trinidad y Tobago,780,0,2,,2,"(10.886611,-74.776708)"
2022,Octubre,Trinidad y Tobago,780,0,1,,1,"(11.117806,-74.232622)"
2022,Octubre,Trinidad y Tobago,780,2,4,,6,"(3.541112,-76.384584)"
2022,Octubre,Trinidad y Tobago,780,20,31,,51,"(4.697144,-74.140516)"
2022,Octubre,Trinidad y Tobago,780,0,1,,1,"(4.815061,-75.736532)"
2022,Octubre,Trinidad y Tobago,780,6,6,,12,"(6.171601,-75.427454)"
2022,Octubre,Trinidad y Tobago,780,1,0,,1,"(7.927209,-72.507910)"
2022,Octubre,Túnez,788,1,1,,2,"(10.445761,-75.516429)"
2022,Octubre,Túnez,788,4,0,,4,"(4.697144,-74.140516)"
2022,Octubre,Túnez,788,1,1,,2,"(6.171601,-75.427454)"
2022,Octubre,Turquía,792,6,1,,7,"(10.445761,-75.516429)"
2022,Octubre,Turquía,792,11,14,,25,"(3.541112,-76.384584)"
2022,Octubre,Turquía,792,2178,1219,,3397,"(4.697144,-74.140516)"
2022,Octubre,Turquía,792,32,18,,50,"(6.171601,-75.427454)"
2022,Octubre,Tuvalu,798,2,0,,2,"(4.697144,-74.140516)"
2022,Octubre,Turkmenistán,795,5,3,,8,"(4.697144,-74.140516)"
2022,Octubre,Uganda,800,2,0,,2,"(4.697144,-74.140516)"
2022,Octubre,Uruguay,858,5,6,,11,"(10.445761,-75.516429)"
2022,Octubre,Uruguay,858,1,6,,7,"(10.886611,-74.776708)"
2022,Octubre,Uruguay,858,23,23,,46,"(3.541112,-76.384584)"
2022,Octubre,Uruguay,858,247,280,,527,"(4.697144,-74.140516)"
2022,Octubre,Uruguay,858,7,6,,13,"(4.815061,-75.736532)"
2022,Octubre,Uruguay,858,19,18,,37,"(6.171601,-75.427454)"
2022,Octubre,Venezuela,862,3,5,,8,"(10.445761,-75.516429)"
2022,Octubre,Venezuela,862,37,33,,70,"(10.886611,-74.776708)"
2022,Octubre,Venezuela,862,610,827,,1437,"(11.360009,-72.129330)"
2022,Octubre,Venezuela,862,24,27,,51,"(3.541112,-76.384584)"
2022,Octubre,Venezuela,862,4,2,,6,"(3.866713,-67.927521)"
2022,Octubre,Venezuela,862,2,6,,8,"(4.452882,-75.766298)"
2022,Octubre,Venezuela,862,171,410,,581,"(4.697144,-74.140516)"
2022,Octubre,Venezuela,862,4,12,,16,"(4.815061,-75.736532)"
2022,Octubre,Venezuela,862,52,87,,139,"(6.171601,-75.427454)"
2022,Octubre,Venezuela,862,10,13,,23,"(6.18189,-67.47535)"
2022,Octubre,Venezuela,862,61,106,,167,"(7.088729,-70.740253)"
2022,Octubre,Venezuela,862,14,6,,20,"(7.128456,-73.183637)"
2022,Octubre,Venezuela,862,788,967,,1755,"(7.818934,-72.453226)"
2022,Octubre,Venezuela,862,154,197,,351,"(7.916725,-72.462544)"
2022,Octubre,Venezuela,862,10,8,,18,"(7.927209,-72.507910)"
2022,Octubre,Venezuela,862,62,86,,148,"(8.36068,-72.409396)"
2022,Octubre,Vietnam,704,1,1,,2,"(4.697144,-74.140516)"
2022,Octubre,Islas Vírgenes Británicas/Territorio Británico de Ultramar,92,1,0,,1,"(3.541112,-76.384584)"
2022,Octubre,Islas Vírgenes Británicas/Territorio Británico de Ultramar,92,1,0,,1,"(6.171601,-75.427454)"
2022,Octubre,Islas Vírgenes Estadounidenses/Territorio de Estados Unidos,850,1,3,,4,"(4.697144,-74.140516)"
2022,Octubre,Zambia,894,1,0,,1,"(4.697144,-74.140516)"
2022,Octubre,Zimbabue,716,0,1,,1,"(6.171601,-75.427454)"
2022,Octubre,Anguila/Territorio Británico de Ultramar,660,3,3,,6,"(4.697144,-74.140516)"
2022,Octubre,Anguila/Territorio Británico de Ultramar,660,1,0,,1,"(6.171601,-75.427454)"
2022,Octubre,Islas Turcas y Caicos/Territorio Británico de Ultramar,796,0,1,,1,"(3.541112,-76.384584)"
2022,Octubre,Islas Turcas y Caicos/Territorio Británico de Ultramar,796,0,5,,5,"(4.697144,-74.140516)"
2022,Octubre,Islas Turcas y Caicos/Territorio Británico de Ultramar,796,0,1,,1,"(6.171601,-75.427454)"
2022,Octubre,Desconocido,99999,0,1,,1,"(10.886611,-74.776708)"
2022,Octubre,Desconocido,99999,1,0,,1,"(4.697144,-74.140516)"
2022,Noviembre,Albania,8,2,1,,3,"(4.697144,-74.140516)"
2022,Noviembre,Alemania,276,44,41,,85,"(10.445761,-75.516429)"
2022,Noviembre,Alemania,276,10,3,,13,"(10.886611,-74.776708)"
2022,Noviembre,Alemania,276,1,4,,5,"(11.117806,-74.232622)"
2022,Noviembre,Alemania,276,56,35,,91,"(3.541112,-76.384584)"
2022,Noviembre,Alemania,276,979,728,,1707,"(4.697144,-74.140516)"
2022,Noviembre,Alemania,276,3,2,,5,"(4.815061,-75.736532)"
2022,Noviembre,Alemania,276,70,59,,129,"(6.171601,-75.427454)"
2022,Noviembre,Andorra,20,1,1,,2,"(10.445761,-75.516429)"
2022,Noviembre,Andorra,20,48,47,,95,"(4.697144,-74.140516)"
2022,Noviembre,Andorra,20,0,1,,1,"(6.171601,-75.427454)"
2022,Noviembre,Angola,24,2,7,,9,"(4.697144,-74.140516)"
2022,Noviembre,Antigua y Barbuda,28,0,2,,2,"(4.697144,-74.140516)"
2022,Noviembre,Antigua y Barbuda,28,1,2,,3,"(6.171601,-75.427454)"
2022,Noviembre,Países Bajos,528,184,132,,316,"(10.445761,-75.516429)"
2022,Noviembre,Países Bajos,528,9,20,,29,"(10.886611,-74.776708)"
2022,Noviembre,Países Bajos,528,5,9,,14,"(11.117806,-74.232622)"
2022,Noviembre,Países Bajos,528,59,36,,95,"(3.541112,-76.384584)"
2022,Noviembre,Países Bajos,528,961,849,,1810,"(4.697144,-74.140516)"
2022,Noviembre,Países Bajos,528,5,1,,6,"(4.815061,-75.736532)"
2022,Noviembre,Países Bajos,528,85,85,,170,"(6.171601,-75.427454)"
2022,Noviembre,Países Bajos,528,1,2,,3,"(7.128456,-73.183637)"
2022,Noviembre,Arabia Saudita,682,0,1,,1,"(10.445761,-75.516429)"
2022,Noviembre,Arabia Saudita,682,2,3,,5,"(3.541112,-76.384584)"
2022,Noviembre,Arabia Saudita,682,12,28,,40,"(4.697144,-74.140516)"
2022,Noviembre,Arabia Saudita,682,0,1,,1,"(4.815061,-75.736532)"
2022,Noviembre,Arabia Saudita,682,1,2,,3,"(6.171601,-75.427454)"
2022,Noviembre,Argelia,12,1,3,,4,"(4.697144,-74.140516)"
2022,Noviembre,Argentina,32,0,4,,4,"(0.25129,-76.875963)"
2022,Noviembre,Argentina,32,5,6,,11,"(0.814836,-77.662532)"
2022,Noviembre,Argentina,32,28,18,,46,"(10.445761,-75.516429)"
2022,Noviembre,Argentina,32,13,16,,29,"(10.886611,-74.776708)"
2022,Noviembre,Argentina,32,11,6,,17,"(11.117806,-74.232622)"
2022,Noviembre,Argentina,32,101,91,,192,"(3.541112,-76.384584)"
2022,Noviembre,Argentina,32,11,7,,18,"(4.452882,-75.766298)"
2022,Noviembre,Argentina,32,4068,3991,,8059,"(4.697144,-74.140516)"
2022,Noviembre,Argentina,32,9,7,,16,"(4.815061,-75.736532)"
2022,Noviembre,Argentina,32,421,368,,789,"(6.171601,-75.427454)"
2022,Noviembre,Argentina,32,2,3,,5,"(7.128456,-73.183637)"
2022,Noviembre,Argentina,32,14,10,,24,"(7.927209,-72.507910)"
2022,Noviembre,República de Armenia,51,0,1,,1,"(4.697144,-74.140516)"
2022,Noviembre,República de Armenia,51,1,0,,1,"(6.171601,-75.427454)"
2022,Noviembre,República de Armenia,51,0,1,,1,"(7.916725,-72.462544)"
2022,Noviembre,Aruba,533,0,2,,2,"(10.408582,-75.538003)"
2022,Noviembre,Aruba,533,4,2,,6,"(10.445761,-75.516429)"
2022,Noviembre,Aruba,533,166,95,,261,"(10.886611,-74.776708)"
2022,Noviembre,Aruba,533,3,2,,5,"(11.117806,-74.232622)"
2022,Noviembre,Aruba,533,1,11,,12,"(11.247723,-74.213989)"
2022,Noviembre,Aruba,533,49,31,,80,"(3.541112,-76.384584)"
2022,Noviembre,Aruba,533,1454,1141,,2595,"(4.697144,-74.140516)"
2022,Noviembre,Aruba,533,4,0,,4,"(4.815061,-75.736532)"
2022,Noviembre,Aruba,533,488,422,,910,"(6.171601,-75.427454)"
2022,Noviembre,Aruba,533,4,18,,22,"(7.128456,-73.183637)"
2022,Noviembre,Australia,36,11,8,,19,"(10.445761,-75.516429)"
2022,Noviembre,Australia,36,6,2,,8,"(10.886611,-74.776708)"
2022,Noviembre,Australia,36,1,0,,1,"(11.117806,-74.232622)"
2022,Noviembre,Australia,36,61,37,,98,"(3.541112,-76.384584)"
2022,Noviembre,Australia,36,1311,1154,,2465,"(4.697144,-74.140516)"
2022,Noviembre,Australia,36,9,8,,17,"(4.815061,-75.736532)"
2022,Noviembre,Australia,36,127,98,,225,"(6.171601,-75.427454)"
2022,Noviembre,Australia,36,2,0,,2,"(7.128456,-73.183637)"
2022,Noviembre,Austria,40,4,4,,8,"(10.445761,-75.516429)"
2022,Noviembre,Austria,40,0,2,,2,"(10.886611,-74.776708)"
2022,Noviembre,Austria,40,3,0,,3,"(3.541112,-76.384584)"
2022,Noviembre,Austria,40,66,59,,125,"(4.697144,-74.140516)"
2022,Noviembre,Austria,40,4,3,,7,"(6.171601,-75.427454)"
2022,Noviembre,Azerbaiyán,31,2,0,,2,"(4.697144,-74.140516)"
2022,Noviembre,Bahamas,44,1,0,,1,"(10.408582,-75.538003)"
2022,Noviembre,Bahamas,44,1,16,,17,"(10.445761,-75.516429)"
2022,Noviembre,Bahamas,44,2,1,,3,"(10.886611,-74.776708)"
2022,Noviembre,Bahamas,44,16,8,,24,"(3.541112,-76.384584)"
2022,Noviembre,Bahamas,44,14,19,,33,"(4.697144,-74.140516)"
2022,Noviembre,Bahamas,44,2,1,,3,"(4.815061,-75.736532)"
2022,Noviembre,Bahamas,44,32,15,,47,"(6.171601,-75.427454)"
2022,Noviembre,Bahréin,48,0,1,,1,"(3.541112,-76.384584)"
2022,Noviembre,Bahréin,48,11,5,,16,"(4.697144,-74.140516)"
2022,Noviembre,Bangladesh,50,1,5,,6,"(4.697144,-74.140516)"
2022,Noviembre,Bangladesh,50,0,1,,1,"(6.171601,-75.427454)"
2022,Noviembre,Barbados,52,1,0,,1,"(12.586067,-81.702563)"
2022,Noviembre,Barbados,52,2,10,,12,"(3.541112,-76.384584)"
2022,Noviembre,Barbados,52,14,19,,33,"(4.697144,-74.140516)"
2022,Noviembre,Barbados,52,4,2,,6,"(6.171601,-75.427454)"
2022,Noviembre,República de Belarús,112,0,1,,1,"(7.818934,-72.453226)"
2022,Noviembre,Bélgica,56,13,11,,24,"(10.445761,-75.516429)"
2022,Noviembre,Bélgica,56,0,1,,1,"(10.886611,-74.776708)"
2022,Noviembre,Bélgica,56,22,11,,33,"(3.541112,-76.384584)"
2022,Noviembre,Bélgica,56,89,86,,175,"(4.697144,-74.140516)"
2022,Noviembre,Bélgica,56,0,2,,2,"(4.815061,-75.736532)"
2022,Noviembre,Bélgica,56,43,30,,73,"(6.171601,-75.427454)"
2022,Noviembre,Belice,84,0,1,,1,"(10.445761,-75.516429)"
2022,Noviembre,Belice,84,1,0,,1,"(10.886611,-74.776708)"
2022,Noviembre,Belice,84,0,1,,1,"(3.541112,-76.384584)"
2022,Noviembre,Belice,84,2,2,,4,"(4.697144,-74.140516)"
2022,Noviembre,Belice,84,0,1,,1,"(4.815061,-75.736532)"
2022,Noviembre,Belice,84,1,0,,1,"(6.171601,-75.427454)"
2022,Noviembre,Benín,204,1,0,,1,"(4.697144,-74.140516)"
2022,Noviembre,Benín,204,1,0,,1,"(6.171601,-75.427454)"
2022,Noviembre,Bermudas/Territorio Británico de Ultramar,60,1,1,,2,"(4.697144,-74.140516)"
2022,Noviembre,Bermudas/Territorio Británico de Ultramar,60,1,0,,1,"(6.171601,-75.427454)"
2022,Noviembre,Bolivia,68,2,3,,5,"(-4.197703,-69.941278)"
2022,Noviembre,Bolivia,68,1,0,,1,"(10.445761,-75.516429)"
2022,Noviembre,Bolivia,68,10,17,,27,"(3.541112,-76.384584)"
2022,Noviembre,Bolivia,68,335,519,,854,"(4.697144,-74.140516)"
2022,Noviembre,Bolivia,68,6,5,,11,"(4.815061,-75.736532)"
2022,Noviembre,Bolivia,68,19,25,,44,"(6.171601,-75.427454)"
2022,Noviembre,Bolivia,68,1,0,,1,"(7.128456,-73.183637)"
2022,Noviembre,Bosnia y Herzegovina,70,15,4,,19,"(4.697144,-74.140516)"
2022,Noviembre,Bosnia y Herzegovina,70,1,0,,1,"(6.171601,-75.427454)"
2022,Noviembre,Brasil,76,178,265,,443,"(-4.197703,-69.941278)"
2022,Noviembre,Brasil,76,2,4,,6,"(-4.223468,-69.945098)"
2022,Noviembre,Brasil,76,1,0,,1,"(0.814836,-77.662532)"
2022,Noviembre,Brasil,76,34,23,,57,"(10.445761,-75.516429)"
2022,Noviembre,Brasil,76,25,16,,41,"(10.886611,-74.776708)"
2022,Noviembre,Brasil,76,2,2,,4,"(11.117806,-74.232622)"
2022,Noviembre,Brasil,76,158,179,,337,"(3.541112,-76.384584)"
2022,Noviembre,Brasil,76,17,20,,37,"(4.452882,-75.766298)"
2022,Noviembre,Brasil,76,2999,3639,,6638,"(4.697144,-74.140516)"
2022,Noviembre,Brasil,76,51,46,,97,"(4.815061,-75.736532)"
2022,Noviembre,Brasil,76,480,477,,957,"(6.171601,-75.427454)"
2022,Noviembre,Brasil,76,4,5,,9,"(7.128456,-73.183637)"
2022,Noviembre,Brasil,76,12,9,,21,"(7.927209,-72.507910)"
2022,Noviembre,Brunei Darussalam,96,0,1,,1,"(4.697144,-74.140516)"
2022,Noviembre,Bulgaria,100,3,5,,8,"(4.697144,-74.140516)"
2022,Noviembre,Bulgaria,100,1,2,,3,"(6.171601,-75.427454)"
2022,Noviembre,Burkina Faso,854,0,1,,1,"(10.886611,-74.776708)"
2022,Noviembre,Burkina Faso,854,0,2,,2,"(4.697144,-74.140516)"
2022,Noviembre,Islas Caimán/Territorio Británico de Ultramar,136,5,0,,5,"(12.586067,-81.702563)"
2022,Noviembre,Islas Caimán/Territorio Británico de Ultramar,136,1,1,,2,"(3.541112,-76.384584)"
2022,Noviembre,Islas Caimán/Territorio Británico de Ultramar,136,8,2,,10,"(4.697144,-74.140516)"
2022,Noviembre,Islas Caimán/Territorio Británico de Ultramar,136,1,0,,1,"(4.815061,-75.736532)"
2022,Noviembre,Islas Caimán/Territorio Británico de Ultramar,136,1,2,,3,"(6.171601,-75.427454)"
2022,Noviembre,Camboya,116,1,0,,1,"(10.445761,-75.516429)"
2022,Noviembre,Camboya,116,1,0,,1,"(3.541112,-76.384584)"
2022,Noviembre,Camboya,116,3,0,,3,"(4.697144,-74.140516)"
2022,Noviembre,Camerún,120,0,1,,1,"(4.697144,-74.140516)"
2022,Noviembre,Canadá,124,146,130,,276,"(10.445761,-75.516429)"
2022,Noviembre,Canadá,124,23,17,,40,"(10.886611,-74.776708)"
2022,Noviembre,Canadá,124,1,3,,4,"(11.117806,-74.232622)"
2022,Noviembre,Canadá,124,62,55,,117,"(3.541112,-76.384584)"
2022,Noviembre,Canadá,124,4,6,,10,"(4.452882,-75.766298)"
2022,Noviembre,Canadá,124,1975,1666,,3641,"(4.697144,-74.140516)"
2022,Noviembre,Canadá,124,9,8,,17,"(4.815061,-75.736532)"
2022,Noviembre,Canadá,124,153,116,,269,"(6.171601,-75.427454)"
2022,Noviembre,Canadá,124,2,3,,5,"(7.128456,-73.183637)"
2022,Noviembre,Canadá,124,0,2,,2,"(7.927209,-72.507910)"
2022,Noviembre,Chad,148,0,1,,1,"(4.697144,-74.140516)"
2022,Noviembre,España,724,371,282,,653,"(10.445761,-75.516429)"
2022,Noviembre,España,724,14,12,,26,"(10.886611,-74.776708)"
2022,Noviembre,España,724,2,0,,2,"(11.117806,-74.232622)"
2022,Noviembre,España,724,2427,1835,,4262,"(3.541112,-76.384584)"
2022,Noviembre,España,724,7,5,,12,"(4.452882,-75.766298)"
2022,Noviembre,España,724,21199,17725,,38924,"(4.697144,-74.140516)"
2022,Noviembre,España,724,17,11,,28,"(4.815061,-75.736532)"
2022,Noviembre,España,724,3139,2468,,5607,"(6.171601,-75.427454)"
2022,Noviembre,Norfolk,574,1,0,,1,"(4.815061,-75.736532)"
2022,Noviembre,Colombia,170,0,1,,1,"(10.445761,-75.516429)"
2022,Noviembre,Colombia,170,24,84,,108,"(4.697144,-74.140516)"
2022,Noviembre,República Del Congo,178,0,1,,1,"(6.171601,-75.427454)"
2022,Noviembre,Comoras,174,1,1,,2,"(4.697144,-74.140516)"
2022,Noviembre,Isla Bouvet,74,0,1,,1,"(4.697144,-74.140516)"
2022,Noviembre,República Democrática del Congo,180,1,1,,2,"(4.697144,-74.140516)"
2022,Noviembre,República Democrática del Congo,180,1,0,,1,"(6.171601,-75.427454)"
2022,Noviembre,República de Corea,410,1,0,,1,"(10.445761,-75.516429)"
2022,Noviembre,República de Corea,410,28,29,,57,"(4.697144,-74.140516)"
2022,Noviembre,República de Corea,410,1,0,,1,"(6.171601,-75.427454)"
2022,Noviembre,Costa de Marfil,384,1,0,,1,"(3.541112,-76.384584)"
2022,Noviembre,Costa de Marfil,384,3,6,,9,"(4.697144,-74.140516)"
2022,Noviembre,Costa Rica,188,68,66,,134,"(10.445761,-75.516429)"
2022,Noviembre,Costa Rica,188,18,13,,31,"(10.886611,-74.776708)"
2022,Noviembre,Costa Rica,188,3,3,,6,"(11.117806,-74.232622)"
2022,Noviembre,Costa Rica,188,1,9,,10,"(12.5744111,-81.703935)"
2022,Noviembre,Costa Rica,188,57,63,,120,"(3.541112,-76.384584)"
2022,Noviembre,Costa Rica,188,0,1,,1,"(3.893038,-77.067921)"
2022,Noviembre,Costa Rica,188,1608,1791,,3399,"(4.697144,-74.140516)"
2022,Noviembre,Costa Rica,188,11,3,,14,"(4.815061,-75.736532)"
2022,Noviembre,Costa Rica,188,268,216,,484,"(6.171601,-75.427454)"
2022,Noviembre,Costa Rica,188,3,3,,6,"(7.128456,-73.183637)"
2022,Noviembre,Costa Rica,188,0,2,,2,"(7.927209,-72.507910)"
2022,Noviembre,Croacia,191,1,0,,1,"(3.541112,-76.384584)"
2022,Noviembre,Croacia,191,16,7,,23,"(4.697144,-74.140516)"
2022,Noviembre,Croacia,191,0,3,,3,"(6.171601,-75.427454)"
2022,Noviembre,Cuba,192,2,2,,4,"(10.445761,-75.516429)"
2022,Noviembre,Cuba,192,3,3,,6,"(10.886611,-74.776708)"
2022,Noviembre,Cuba,192,6,12,,18,"(3.541112,-76.384584)"
2022,Noviembre,Cuba,192,824,829,,1653,"(4.697144,-74.140516)"
2022,Noviembre,Cuba,192,3,3,,6,"(4.815061,-75.736532)"
2022,Noviembre,Cuba,192,530,498,,1028,"(6.171601,-75.427454)"
2022,Noviembre,Cuba,192,2,1,,3,"(7.128456,-73.183637)"
2022,Noviembre,Cuba,192,2,0,,2,"(7.927209,-72.507910)"
2022,Noviembre,Curazao,99999,52,32,,84,"(10.886611,-74.776708)"
2022,Noviembre,Curazao,99999,18,13,,31,"(3.541112,-76.384584)"
2022,Noviembre,Curazao,99999,1232,1134,,2366,"(4.697144,-74.140516)"
2022,Noviembre,Curazao,99999,2,0,,2,"(4.815061,-75.736532)"
2022,Noviembre,Curazao,99999,113,84,,197,"(6.171601,-75.427454)"
2022,Noviembre,República Checa,203,1,1,,2,"(10.445761,-75.516429)"
2022,Noviembre,República Checa,203,10,10,,20,"(4.697144,-74.140516)"
2022,Noviembre,República Checa,203,3,1,,4,"(6.171601,-75.427454)"
2022,Noviembre,Chile,152,27,36,,63,"(0.814836,-77.662532)"
2022,Noviembre,Chile,152,20,18,,38,"(10.445761,-75.516429)"
2022,Noviembre,Chile,152,60,40,,100,"(10.886611,-74.776708)"
2022,Noviembre,Chile,152,3,0,,3,"(11.117806,-74.232622)"
2022,Noviembre,Chile,152,2390,1632,,4022,"(3.541112,-76.384584)"
2022,Noviembre,Chile,152,22,17,,39,"(4.452882,-75.766298)"
2022,Noviembre,Chile,152,4770,4338,,9108,"(4.697144,-74.140516)"
2022,Noviembre,Chile,152,36,24,,60,"(4.815061,-75.736532)"
2022,Noviembre,Chile,152,217,183,,400,"(6.171601,-75.427454)"
2022,Noviembre,Chile,152,1,11,,12,"(7.128456,-73.183637)"
2022,Noviembre,Chile,152,20,11,,31,"(7.927209,-72.507910)"
2022,Noviembre,China,156,0,1,,1,"(3.541112,-76.384584)"
2022,Noviembre,China,156,2,14,,16,"(4.697144,-74.140516)"
2022,Noviembre,Chipre,196,2,2,,4,"(4.697144,-74.140516)"
2022,Noviembre,Chipre,196,0,1,,1,"(4.815061,-75.736532)"
2022,Noviembre,Chipre,196,1,0,,1,"(6.171601,-75.427454)"
2022,Noviembre,Dinamarca,208,2,0,,2,"(10.445761,-75.516429)"
2022,Noviembre,Dinamarca,208,1,1,,2,"(3.541112,-76.384584)"
2022,Noviembre,Dinamarca,208,34,29,,63,"(4.697144,-74.140516)"
2022,Noviembre,Dominica,212,1,1,,2,"(10.445761,-75.516429)"
2022,Noviembre,Dominica,212,1,0,,1,"(10.886611,-74.776708)"
2022,Noviembre,Dominica,212,1,0,,1,"(3.541112,-76.384584)"
2022,Noviembre,Dominica,212,7,4,,11,"(4.697144,-74.140516)"
2022,Noviembre,Dominica,212,3,1,,4,"(6.171601,-75.427454)"
2022,Noviembre,Ecuador,218,1,2,,3,"(-0.193180,-74.784874)"
2022,Noviembre,Ecuador,218,354,465,,819,"(0.25129,-76.875963)"
2022,Noviembre,Ecuador,218,13,15,,28,"(0.812436,-77.847006)"
2022,Noviembre,Ecuador,218,3321,4395,,7716,"(0.814836,-77.662532)"
2022,Noviembre,Ecuador,218,24,19,,43,"(1.813928,-78.763924)"
2022,Noviembre,Ecuador,218,0,4,,4,"(10.408582,-75.538003)"
2022,Noviembre,Ecuador,218,10,12,,22,"(10.445761,-75.516429)"
2022,Noviembre,Ecuador,218,12,32,,44,"(10.886611,-74.776708)"
2022,Noviembre,Ecuador,218,1,0,,1,"(11.117806,-74.232622)"
2022,Noviembre,Ecuador,218,1,1,,2,"(12.586067,-81.702563)"
2022,Noviembre,Ecuador,218,83,89,,172,"(3.541112,-76.384584)"
2022,Noviembre,Ecuador,218,2,1,,3,"(4.452882,-75.766298)"
2022,Noviembre,Ecuador,218,3219,4445,,7664,"(4.697144,-74.140516)"
2022,Noviembre,Ecuador,218,9,10,,19,"(4.815061,-75.736532)"
2022,Noviembre,Ecuador,218,3,7,,10,"(6.17134,-75.427194)"
2022,Noviembre,Ecuador,218,92,141,,233,"(6.171601,-75.427454)"
2022,Noviembre,Ecuador,218,2,3,,5,"(7.128456,-73.183637)"
2022,Noviembre,Ecuador,218,3,1,,4,"(7.927209,-72.507910)"
2022,Noviembre,Egipto,818,0,2,,2,"(10.408582,-75.538003)"
2022,Noviembre,Egipto,818,2,0,,2,"(10.445761,-75.516429)"
2022,Noviembre,Egipto,818,2,0,,2,"(3.541112,-76.384584)"
2022,Noviembre,Egipto,818,237,214,,451,"(4.697144,-74.140516)"
2022,Noviembre,Egipto,818,5,5,,10,"(6.171601,-75.427454)"
2022,Noviembre,El Salvador,222,4,18,,22,"(10.445761,-75.516429)"
2022,Noviembre,El Salvador,222,3,3,,6,"(10.886611,-74.776708)"
2022,Noviembre,El Salvador,222,0,2,,2,"(11.117806,-74.232622)"
2022,Noviembre,El Salvador,222,0,1,,1,"(12.586067,-81.702563)"
2022,Noviembre,El Salvador,222,14,11,,25,"(3.541112,-76.384584)"
2022,Noviembre,El Salvador,222,407,525,,932,"(4.697144,-74.140516)"
2022,Noviembre,El Salvador,222,3,3,,6,"(4.815061,-75.736532)"
2022,Noviembre,El Salvador,222,32,55,,87,"(6.171601,-75.427454)"
2022,Noviembre,Emiratos Árabes,784,7,17,,24,"(10.445761,-75.516429)"
2022,Noviembre,Emiratos Árabes,784,9,8,,17,"(3.541112,-76.384584)"
2022,Noviembre,Emiratos Árabes,784,1,0,,1,"(4.452882,-75.766298)"
2022,Noviembre,Emiratos Árabes,784,259,397,,656,"(4.697144,-74.140516)"
2022,Noviembre,Emiratos Árabes,784,21,38,,59,"(6.171601,-75.427454)"
2022,Noviembre,Eritrea,232,1,0,,1,"(4.697144,-74.140516)"
2022,Noviembre,Eslovaquia,703,1,0,,1,"(10.445761,-75.516429)"
2022,Noviembre,Eslovaquia,703,6,8,,14,"(4.697144,-74.140516)"
2022,Noviembre,Eslovaquia,703,0,1,,1,"(6.171601,-75.427454)"
2022,Noviembre,Eslovenia,705,1,0,,1,"(3.541112,-76.384584)"
2022,Noviembre,Eslovenia,705,2,3,,5,"(4.697144,-74.140516)"
2022,Noviembre,Estados Unidos de América,840,2,1,,3,"(10.408582,-75.538003)"
2022,Noviembre,Estados Unidos de América,840,2729,2132,,4861,"(10.445761,-75.516429)"
2022,Noviembre,Estados Unidos de América,840,2964,2356,,5320,"(10.886611,-74.776708)"
2022,Noviembre,Estados Unidos de América,840,92,58,,150,"(11.117806,-74.232622)"
2022,Noviembre,Estados Unidos de América,840,124,103,,227,"(12.586067,-81.702563)"
2022,Noviembre,Estados Unidos de América,840,6425,4507,,10932,"(3.541112,-76.384584)"
2022,Noviembre,Estados Unidos de América,840,740,530,,1270,"(4.452882,-75.766298)"
2022,Noviembre,Estados Unidos de América,840,33568,28775,,62343,"(4.697144,-74.140516)"
2022,Noviembre,Estados Unidos de América,840,1871,1269,,3140,"(4.815061,-75.736532)"
2022,Noviembre,Estados Unidos de América,840,3,2,,5,"(6.17134,-75.427194)"
2022,Noviembre,Estados Unidos de América,840,13046,10403,,23449,"(6.171601,-75.427454)"
2022,Noviembre,Estados Unidos de América,840,789,627,,1416,"(7.128456,-73.183637)"
2022,Noviembre,Estados Unidos de América,840,110,70,,180,"(7.927209,-72.507910)"
2022,Noviembre,Estonia,233,1,1,,2,"(10.445761,-75.516429)"
2022,Noviembre,Estonia,233,4,4,,8,"(4.697144,-74.140516)"
2022,Noviembre,Estonia,233,1,0,,1,"(4.815061,-75.736532)"
2022,Noviembre,Estonia,233,2,0,,2,"(6.171601,-75.427454)"
2022,Noviembre,Etiopia,231,0,4,,4,"(4.697144,-74.140516)"
2022,Noviembre,Etiopia,231,1,1,,2,"(6.171601,-75.427454)"
2022,Noviembre,Islas Fiji,242,1,0,,1,"(4.697144,-74.140516)"
2022,Noviembre,Filipinas,608,4,10,,14,"(4.697144,-74.140516)"
2022,Noviembre,Finlandia,246,1,1,,2,"(10.445761,-75.516429)"
2022,Noviembre,Finlandia,246,2,1,,3,"(3.541112,-76.384584)"
2022,Noviembre,Finlandia,246,26,15,,41,"(4.697144,-74.140516)"
2022,Noviembre,Francia,250,36,27,,63,"(10.445761,-75.516429)"
2022,Noviembre,Francia,250,10,5,,15,"(10.886611,-74.776708)"
2022,Noviembre,Francia,250,64,38,,102,"(3.541112,-76.384584)"
2022,Noviembre,Francia,250,2,2,,4,"(4.452882,-75.766298)"
2022,Noviembre,Francia,250,1975,1557,,3532,"(4.697144,-74.140516)"
2022,Noviembre,Francia,250,1,2,,3,"(4.815061,-75.736532)"
2022,Noviembre,Francia,250,108,68,,176,"(6.171601,-75.427454)"
2022,Noviembre,Francia,250,1,2,,3,"(7.128456,-73.183637)"
2022,Noviembre,Gabón,266,0,1,,1,"(4.697144,-74.140516)"
2022,Noviembre,Georgia,268,1,0,,1,"(3.541112,-76.384584)"
2022,Noviembre,Georgia,268,9,10,,19,"(4.697144,-74.140516)"
2022,Noviembre,Georgia,268,1,1,,2,"(6.171601,-75.427454)"
2022,Noviembre,Ghana,288,0,3,,3,"(10.445761,-75.516429)"
2022,Noviembre,Ghana,288,3,2,,5,"(4.697144,-74.140516)"
2022,Noviembre,Granada,308,1,1,,2,"(4.697144,-74.140516)"
2022,Noviembre,Grecia,300,2,3,,5,"(10.445761,-75.516429)"
2022,Noviembre,Grecia,300,3,1,,4,"(3.541112,-76.384584)"
2022,Noviembre,Grecia,300,29,14,,43,"(4.697144,-74.140516)"
2022,Noviembre,Grecia,300,6,1,,7,"(6.171601,-75.427454)"
2022,Noviembre,Guatemala,320,3,7,,10,"(10.445761,-75.516429)"
2022,Noviembre,Guatemala,320,9,13,,22,"(10.886611,-74.776708)"
2022,Noviembre,Guatemala,320,1,0,,1,"(11.117806,-74.232622)"
2022,Noviembre,Guatemala,320,0,2,,2,"(12.586067,-81.702563)"
2022,Noviembre,Guatemala,320,54,54,,108,"(3.541112,-76.384584)"
2022,Noviembre,Guatemala,320,3,8,,11,"(4.452882,-75.766298)"
2022,Noviembre,Guatemala,320,770,1057,,1827,"(4.697144,-74.140516)"
2022,Noviembre,Guatemala,320,11,9,,20,"(4.815061,-75.736532)"
2022,Noviembre,Guatemala,320,128,111,,239,"(6.171601,-75.427454)"
2022,Noviembre,Guatemala,320,4,2,,6,"(7.128456,-73.183637)"
2022,Noviembre,Guatemala,320,2,3,,5,"(7.927209,-72.507910)"
2022,Noviembre,Guyana,328,1,1,,2,"(10.886611,-74.776708)"
2022,Noviembre,Guyana,328,1,0,,1,"(3.541112,-76.384584)"
2022,Noviembre,Guyana,328,2,18,,20,"(4.697144,-74.140516)"
2022,Noviembre,Guyana,328,0,7,,7,"(6.171601,-75.427454)"
2022,Noviembre,Guinea,324,2,0,,2,"(4.697144,-74.140516)"
2022,Noviembre,Guinea Ecuatorial,226,4,1,,5,"(4.697144,-74.140516)"
2022,Noviembre,Guadalupe/Territorio Francés,312,1,0,,1,"(3.541112,-76.384584)"
2022,Noviembre,Guadalupe/Territorio Francés,312,2,0,,2,"(4.697144,-74.140516)"
2022,Noviembre,Guam/Territorio no incorporado de Estados Unidos,316,1,0,,1,"(4.697144,-74.140516)"
2022,Noviembre,Guayana Francesa/Departamento de Ultramar Francés,254,0,1,,1,"(3.541112,-76.384584)"
2022,Noviembre,Guayana Francesa/Departamento de Ultramar Francés,254,0,1,,1,"(4.697144,-74.140516)"
2022,Noviembre,Guayana Francesa/Departamento de Ultramar Francés,254,0,1,,1,"(6.171601,-75.427454)"
2022,Noviembre,Haití,332,2,9,,11,"(4.697144,-74.140516)"
2022,Noviembre,Honduras,340,0,7,,7,"(10.408582,-75.538003)"
2022,Noviembre,Honduras,340,8,21,,29,"(10.445761,-75.516429)"
2022,Noviembre,Honduras,340,10,15,,25,"(10.886611,-74.776708)"
2022,Noviembre,Honduras,340,1,1,,2,"(12.586067,-81.702563)"
2022,Noviembre,Honduras,340,12,33,,45,"(3.541112,-76.384584)"
2022,Noviembre,Honduras,340,62,123,,185,"(4.697144,-74.140516)"
2022,Noviembre,Honduras,340,7,6,,13,"(4.815061,-75.736532)"
2022,Noviembre,Honduras,340,38,50,,88,"(6.171601,-75.427454)"
2022,Noviembre,Honduras,340,2,3,,5,"(7.128456,-73.183637)"
2022,Noviembre,Hong Kong,344,5,7,,12,"(4.697144,-74.140516)"
2022,Noviembre,Hungría,348,1,0,,1,"(10.445761,-75.516429)"
2022,Noviembre,Hungría,348,1,1,,2,"(3.541112,-76.384584)"
2022,Noviembre,Hungría,348,6,4,,10,"(4.697144,-74.140516)"
2022,Noviembre,Hungría,348,1,0,,1,"(6.171601,-75.427454)"
2022,Noviembre,India,356,0,2,,2,"(10.445761,-75.516429)"
2022,Noviembre,India,356,0,1,,1,"(3.541112,-76.384584)"
2022,Noviembre,India,356,1,0,,1,"(4.452882,-75.766298)"
2022,Noviembre,India,356,31,24,,55,"(4.697144,-74.140516)"
2022,Noviembre,India,356,2,0,,2,"(4.815061,-75.736532)"
2022,Noviembre,India,356,4,2,,6,"(6.171601,-75.427454)"
2022,Noviembre,Indonesia,360,1,0,,1,"(3.541112,-76.384584)"
2022,Noviembre,Indonesia,360,3,13,,16,"(4.697144,-74.140516)"
2022,Noviembre,Indonesia,360,1,0,,1,"(6.171601,-75.427454)"
2022,Noviembre,Iraq,368,0,1,,1,"(3.541112,-76.384584)"
2022,Noviembre,Iraq,368,0,5,,5,"(4.697144,-74.140516)"
2022,Noviembre,República de Irlanda,372,2,1,,3,"(10.445761,-75.516429)"
2022,Noviembre,República de Irlanda,372,1,0,,1,"(3.541112,-76.384584)"
2022,Noviembre,República de Irlanda,372,11,7,,18,"(4.697144,-74.140516)"
2022,Noviembre,República de Irlanda,372,1,3,,4,"(6.171601,-75.427454)"
2022,Noviembre,Islandia,352,5,1,,6,"(10.445761,-75.516429)"
2022,Noviembre,Islandia,352,3,2,,5,"(3.541112,-76.384584)"
2022,Noviembre,Islandia,352,25,17,,42,"(4.697144,-74.140516)"
2022,Noviembre,Islandia,352,4,5,,9,"(6.171601,-75.427454)"
2022,Noviembre,Israel,376,17,1,,18,"(10.445761,-75.516429)"
2022,Noviembre,Israel,376,2,0,,2,"(10.886611,-74.776708)"
2022,Noviembre,Israel,376,9,8,,17,"(3.541112,-76.384584)"
2022,Noviembre,Israel,376,368,232,,600,"(4.697144,-74.140516)"
2022,Noviembre,Israel,376,1,0,,1,"(4.815061,-75.736532)"
2022,Noviembre,Israel,376,4,9,,13,"(6.171601,-75.427454)"
2022,Noviembre,Italia,380,56,40,,96,"(10.445761,-75.516429)"
2022,Noviembre,Italia,380,3,2,,5,"(10.886611,-74.776708)"
2022,Noviembre,Italia,380,99,48,,147,"(3.541112,-76.384584)"
2022,Noviembre,Italia,380,729,571,,1300,"(4.697144,-74.140516)"
2022,Noviembre,Italia,380,1,0,,1,"(4.815061,-75.736532)"
2022,Noviembre,Italia,380,112,70,,182,"(6.171601,-75.427454)"
2022,Noviembre,Jamaica,388,0,1,,1,"(10.408582,-75.538003)"
2022,Noviembre,Jamaica,388,0,7,,7,"(10.445761,-75.516429)"
2022,Noviembre,Jamaica,388,0,1,,1,"(10.886611,-74.776708)"
2022,Noviembre,Jamaica,388,0,3,,3,"(11.117806,-74.232622)"
2022,Noviembre,Jamaica,388,3,3,,6,"(3.541112,-76.384584)"
2022,Noviembre,Jamaica,388,27,51,,78,"(4.697144,-74.140516)"
2022,Noviembre,Jamaica,388,1,2,,3,"(6.17134,-75.427194)"
2022,Noviembre,Jamaica,388,10,8,,18,"(6.171601,-75.427454)"
2022,Noviembre,Japón,392,3,1,,4,"(10.445761,-75.516429)"
2022,Noviembre,Japón,392,3,1,,4,"(3.541112,-76.384584)"
2022,Noviembre,Japón,392,43,49,,92,"(4.697144,-74.140516)"
2022,Noviembre,Japón,392,1,0,,1,"(4.815061,-75.736532)"
2022,Noviembre,Japón,392,5,0,,5,"(6.171601,-75.427454)"
2022,Noviembre,Jordania,400,5,6,,11,"(4.697144,-74.140516)"
2022,Noviembre,Jordania,400,0,1,,1,"(6.171601,-75.427454)"
2022,Noviembre,Kazajistán,398,0,4,,4,"(4.697144,-74.140516)"
2022,Noviembre,Kenia,404,3,1,,4,"(3.541112,-76.384584)"
2022,Noviembre,Kenia,404,9,7,,16,"(4.697144,-74.140516)"
2022,Noviembre,Kirguistán,417,0,1,,1,"(3.541112,-76.384584)"
2022,Noviembre,Kirguistán,417,0,2,,2,"(4.697144,-74.140516)"
2022,Noviembre,Kuwait,414,12,7,,19,"(4.697144,-74.140516)"
2022,Noviembre,República Democrática Popular  Lao,418,1,0,,1,"(10.445761,-75.516429)"
2022,Noviembre,República Democrática Popular  Lao,418,0,1,,1,"(6.171601,-75.427454)"
2022,Noviembre,Lesoto,426,1,0,,1,"(4.697144,-74.140516)"
2022,Noviembre,Líbano,422,0,1,,1,"(10.408582,-75.538003)"
2022,Noviembre,Líbano,422,1,0,,1,"(10.886611,-74.776708)"
2022,Noviembre,Líbano,422,4,3,,7,"(3.541112,-76.384584)"
2022,Noviembre,Líbano,422,1,3,,4,"(4.697144,-74.140516)"
2022,Noviembre,Luxemburgo,442,2,3,,5,"(10.445761,-75.516429)"
2022,Noviembre,Luxemburgo,442,1,0,,1,"(3.541112,-76.384584)"
2022,Noviembre,Luxemburgo,442,8,5,,13,"(4.697144,-74.140516)"
2022,Noviembre,Luxemburgo,442,1,0,,1,"(4.815061,-75.736532)"
2022,Noviembre,Luxemburgo,442,2,0,,2,"(6.171601,-75.427454)"
2022,Noviembre,Macao,446,1,1,,2,"(4.697144,-74.140516)"
2022,Noviembre,Macao,446,2,1,,3,"(6.171601,-75.427454)"
2022,Noviembre,Malasia,458,0,1,,1,"(3.541112,-76.384584)"
2022,Noviembre,Malasia,458,8,13,,21,"(4.697144,-74.140516)"
2022,Noviembre,Malawi,454,0,1,,1,"(4.697144,-74.140516)"
2022,Noviembre,Maldivas,462,0,1,,1,"(3.541112,-76.384584)"
2022,Noviembre,Maldivas,462,5,6,,11,"(4.697144,-74.140516)"
2022,Noviembre,Maldivas,462,3,1,,4,"(6.171601,-75.427454)"
2022,Noviembre,Malí,466,2,1,,3,"(11.117806,-74.232622)"
2022,Noviembre,Malí,466,1,2,,3,"(4.697144,-74.140516)"
2022,Noviembre,Malí,466,0,1,,1,"(6.171601,-75.427454)"
2022,Noviembre,Malta,470,2,2,,4,"(10.445761,-75.516429)"
2022,Noviembre,Malta,470,3,6,,9,"(3.541112,-76.384584)"
2022,Noviembre,Malta,470,101,89,,190,"(4.697144,-74.140516)"
2022,Noviembre,Malta,470,12,12,,24,"(6.171601,-75.427454)"
2022,Noviembre,Malta,470,0,1,,1,"(7.128456,-73.183637)"
2022,Noviembre,Marruecos,504,49,37,,86,"(4.697144,-74.140516)"
2022,Noviembre,Marruecos,504,4,3,,7,"(6.171601,-75.427454)"
2022,Noviembre,Mauritania,478,0,1,,1,"(4.697144,-74.140516)"
2022,Noviembre,Martinica/Departamento de Ultramar Francés,474,1,0,,1,"(3.541112,-76.384584)"
2022,Noviembre,Martinica/Departamento de Ultramar Francés,474,1,0,,1,"(4.697144,-74.140516)"
2022,Noviembre,México,484,425,360,,785,"(10.445761,-75.516429)"
2022,Noviembre,México,484,379,341,,720,"(10.886611,-74.776708)"
2022,Noviembre,México,484,10,11,,21,"(11.117806,-74.232622)"
2022,Noviembre,México,484,1,3,,4,"(12.586067,-81.702563)"
2022,Noviembre,México,484,2269,1987,,4256,"(3.541112,-76.384584)"
2022,Noviembre,México,484,26,20,,46,"(4.452882,-75.766298)"
2022,Noviembre,México,484,23248,22222,,45471,"(4.697144,-74.140516)"
2022,Noviembre,México,484,241,142,,383,"(4.815061,-75.736532)"
2022,Noviembre,México,484,0,2,,2,"(6.17134,-75.427194)"
2022,Noviembre,México,484,9040,7889,,16929,"(6.171601,-75.427454)"
2022,Noviembre,México,484,137,80,,217,"(7.128456,-73.183637)"
2022,Noviembre,México,484,48,34,,82,"(7.927209,-72.507910)"
2022,Noviembre,Mayotte/Colectividad Territorial Francesa,175,0,1,,1,"(4.697144,-74.140516)"
2022,Noviembre,Mónaco,492,1,0,,1,"(3.541112,-76.384584)"
2022,Noviembre,Montenegro,499,0,1,,1,"(10.445761,-75.516429)"
2022,Noviembre,Micronesia,583,2,0,,2,"(4.697144,-74.140516)"
2022,Noviembre,Mozambique,508,2,0,,2,"(4.697144,-74.140516)"
2022,Noviembre,Namibia,516,1,1,,2,"(6.171601,-75.427454)"
2022,Noviembre,Nepal,524,2,1,,3,"(4.697144,-74.140516)"
2022,Noviembre,Nicaragua,558,1,0,,1,"(10.445761,-75.516429)"
2022,Noviembre,Nicaragua,558,3,1,,4,"(10.886611,-74.776708)"
2022,Noviembre,Nicaragua,558,0,1,,1,"(11.117806,-74.232622)"
2022,Noviembre,Nicaragua,558,0,4,,4,"(12.5744111,-81.703935)"
2022,Noviembre,Nicaragua,558,2,8,,10,"(3.541112,-76.384584)"
2022,Noviembre,Nicaragua,558,27,44,,71,"(4.697144,-74.140516)"
2022,Noviembre,Nicaragua,558,7,28,,35,"(6.171601,-75.427454)"
2022,Noviembre,Nicaragua,558,0,1,,1,"(7.128456,-73.183637)"
2022,Noviembre,Nigeria,566,0,1,,1,"(3.541112,-76.384584)"
2022,Noviembre,Nigeria,566,1,5,,6,"(4.697144,-74.140516)"
2022,Noviembre,Níger,562,2,1,,3,"(4.697144,-74.140516)"
2022,Noviembre,Noruega,578,6,2,,8,"(10.445761,-75.516429)"
2022,Noviembre,Noruega,578,2,2,,4,"(11.117806,-74.232622)"
2022,Noviembre,Noruega,578,6,1,,7,"(3.541112,-76.384584)"
2022,Noviembre,Noruega,578,34,17,,51,"(4.697144,-74.140516)"
2022,Noviembre,Noruega,578,1,0,,1,"(4.815061,-75.736532)"
2022,Noviembre,Noruega,578,6,6,,12,"(6.171601,-75.427454)"
2022,Noviembre,Nueva Caledonia/Territorio francés,540,1,0,,1,"(4.697144,-74.140516)"
2022,Noviembre,Nueva Zelanda,554,2,2,,4,"(3.541112,-76.384584)"
2022,Noviembre,Nueva Zelanda,554,73,47,,120,"(4.697144,-74.140516)"
2022,Noviembre,Nueva Zelanda,554,1,4,,5,"(6.171601,-75.427454)"
2022,Noviembre,Omán,512,4,10,,14,"(4.697144,-74.140516)"
2022,Noviembre,Omán,512,1,2,,3,"(6.171601,-75.427454)"
2022,Noviembre,Papúa Nueva Guinea,598,1,0,,1,"(10.445761,-75.516429)"
2022,Noviembre,Papúa Nueva Guinea,598,2,3,,5,"(4.697144,-74.140516)"
2022,Noviembre,Pakistán,586,1,0,,1,"(4.697144,-74.140516)"
2022,Noviembre,Palau,585,1,0,,1,"(10.886611,-74.776708)"
2022,Noviembre,Palau,585,1,0,,1,"(4.697144,-74.140516)"
2022,Noviembre,Panamá,591,24,85,,109,"(10.408582,-75.538003)"
2022,Noviembre,Panamá,591,882,800,,1682,"(10.445761,-75.516429)"
2022,Noviembre,Panamá,591,1161,1032,,2193,"(10.886611,-74.776708)"
2022,Noviembre,Panamá,591,0,2,,2,"(10.971302,-74.765397)"
2022,Noviembre,Panamá,591,58,48,,106,"(11.117806,-74.232622)"
2022,Noviembre,Panamá,591,0,1,,1,"(11.247723,-74.213989)"
2022,Noviembre,Panamá,591,1,16,,17,"(12.5744111,-81.703935)"
2022,Noviembre,Panamá,591,14,23,,37,"(12.586067,-81.702563)"
2022,Noviembre,Panamá,591,2140,1683,,3823,"(3.541112,-76.384584)"
2022,Noviembre,Panamá,591,106,90,,196,"(4.452882,-75.766298)"
2022,Noviembre,Panamá,591,6649,6888,,13537,"(4.697144,-74.140516)"
2022,Noviembre,Panamá,591,288,217,,505,"(4.815061,-75.736532)"
2022,Noviembre,Panamá,591,4,15,,19,"(6.17134,-75.427194)"
2022,Noviembre,Panamá,591,2839,2664,,5503,"(6.171601,-75.427454)"
2022,Noviembre,Panamá,591,0,2,,2,"(6.228046,-77.404104)"
2022,Noviembre,Panamá,591,13,16,,29,"(7.102626,-77.762647)"
2022,Noviembre,Panamá,591,128,110,,238,"(7.128456,-73.183637)"
2022,Noviembre,Panamá,591,63,45,,108,"(7.927209,-72.507910)"
2022,Noviembre,Panamá,591,0,7,,7,"(8.066966,-76.735404)"
2022,Noviembre,Panamá,591,35,79,,114,"(8.635765,-77.346578)"
2022,Noviembre,Panamá,591,0,11,,11,"(9.402978,-75.681599)"
2022,Noviembre,Paraguay,600,1,6,,7,"(10.445761,-75.516429)"
2022,Noviembre,Paraguay,600,4,7,,11,"(10.886611,-74.776708)"
2022,Noviembre,Paraguay,600,1,0,,1,"(11.117806,-74.232622)"
2022,Noviembre,Paraguay,600,30,28,,58,"(3.541112,-76.384584)"
2022,Noviembre,Paraguay,600,3,3,,6,"(4.452882,-75.766298)"
2022,Noviembre,Paraguay,600,301,362,,663,"(4.697144,-74.140516)"
2022,Noviembre,Paraguay,600,3,3,,6,"(4.815061,-75.736532)"
2022,Noviembre,Paraguay,600,22,33,,55,"(6.171601,-75.427454)"
2022,Noviembre,Paraguay,600,0,3,,3,"(7.128456,-73.183637)"
2022,Noviembre,Paraguay,600,3,0,,3,"(7.927209,-72.507910)"
2022,Noviembre,Perú,604,7,6,,13,"(-0.193180,-74.784874)"
2022,Noviembre,Perú,604,53,83,,136,"(-4.197703,-69.941278)"
2022,Noviembre,Perú,604,95,140,,235,"(-4.223468,-69.945098)"
2022,Noviembre,Perú,604,1,1,,2,"(0.25129,-76.875963)"
2022,Noviembre,Perú,604,19,23,,42,"(0.814836,-77.662532)"
2022,Noviembre,Perú,604,64,52,,116,"(10.445761,-75.516429)"
2022,Noviembre,Perú,604,32,30,,62,"(10.886611,-74.776708)"
2022,Noviembre,Perú,604,0,1,,1,"(11.117806,-74.232622)"
2022,Noviembre,Perú,604,242,236,,478,"(3.541112,-76.384584)"
2022,Noviembre,Perú,604,7,16,,23,"(4.452882,-75.766298)"
2022,Noviembre,Perú,604,4528,4861,,9389,"(4.697144,-74.140516)"
2022,Noviembre,Perú,604,14,25,,39,"(4.815061,-75.736532)"
2022,Noviembre,Perú,604,1249,1134,,2383,"(6.171601,-75.427454)"
2022,Noviembre,Perú,604,6,1,,7,"(7.128456,-73.183637)"
2022,Noviembre,Perú,604,5,3,,8,"(7.927209,-72.507910)"
2022,Noviembre,Palestina,99999,1,0,,1,"(4.697144,-74.140516)"
2022,Noviembre,Polonia,616,3,4,,7,"(10.445761,-75.516429)"
2022,Noviembre,Polonia,616,1,1,,2,"(10.886611,-74.776708)"
2022,Noviembre,Polonia,616,0,1,,1,"(3.541112,-76.384584)"
2022,Noviembre,Polonia,616,51,154,,205,"(4.697144,-74.140516)"
2022,Noviembre,Polonia,616,4,12,,16,"(6.171601,-75.427454)"
2022,Noviembre,Portugal,620,10,11,,21,"(10.445761,-75.516429)"
2022,Noviembre,Portugal,620,3,1,,4,"(10.886611,-74.776708)"
2022,Noviembre,Portugal,620,5,11,,16,"(3.541112,-76.384584)"
2022,Noviembre,Portugal,620,175,220,,395,"(4.697144,-74.140516)"
2022,Noviembre,Portugal,620,30,50,,80,"(6.171601,-75.427454)"
2022,Noviembre,Polinesia Francesa/Colectividad de Ultramar Francesa,258,0,1,,1,"(4.697144,-74.140516)"
2022,Noviembre,Puerto Rico/Territorio de Estados Unidos,630,4,1,,5,"(10.445761,-75.516429)"
2022,Noviembre,Puerto Rico/Territorio de Estados Unidos,630,7,4,,11,"(10.886611,-74.776708)"
2022,Noviembre,Puerto Rico/Territorio de Estados Unidos,630,0,2,,2,"(11.117806,-74.232622)"
2022,Noviembre,Puerto Rico/Territorio de Estados Unidos,630,1,1,,2,"(12.586067,-81.702563)"
2022,Noviembre,Puerto Rico/Territorio de Estados Unidos,630,33,17,,50,"(3.541112,-76.384584)"
2022,Noviembre,Puerto Rico/Territorio de Estados Unidos,630,6,2,,8,"(4.452882,-75.766298)"
2022,Noviembre,Puerto Rico/Territorio de Estados Unidos,630,477,475,,952,"(4.697144,-74.140516)"
2022,Noviembre,Puerto Rico/Territorio de Estados Unidos,630,31,24,,55,"(6.171601,-75.427454)"
2022,Noviembre,Puerto Rico/Territorio de Estados Unidos,630,0,1,,1,"(7.128456,-73.183637)"
2022,Noviembre,Puerto Rico/Territorio de Estados Unidos,630,1,1,,2,"(7.927209,-72.507910)"
2022,Noviembre,Qatar,634,0,1,,1,"(10.886611,-74.776708)"
2022,Noviembre,Qatar,634,14,20,,34,"(3.541112,-76.384584)"
2022,Noviembre,Qatar,634,136,349,,485,"(4.697144,-74.140516)"
2022,Noviembre,Qatar,634,11,49,,60,"(6.171601,-75.427454)"
2022,Noviembre,Reino Unido de Gran Bretaña e Irlanda del Norte,826,5,3,,8,"(10.445761,-75.516429)"
2022,Noviembre,Reino Unido de Gran Bretaña e Irlanda del Norte,826,1,0,,1,"(10.886611,-74.776708)"
2022,Noviembre,Reino Unido de Gran Bretaña e Irlanda del Norte,826,10,5,,15,"(3.541112,-76.384584)"
2022,Noviembre,Reino Unido de Gran Bretaña e Irlanda del Norte,826,1657,1378,,3035,"(4.697144,-74.140516)"
2022,Noviembre,Reino Unido de Gran Bretaña e Irlanda del Norte,826,21,23,,44,"(6.171601,-75.427454)"
2022,Noviembre,República CentroÁfricana,140,1,0,,1,"(3.541112,-76.384584)"
2022,Noviembre,República CentroÁfricana,140,2,4,,6,"(4.697144,-74.140516)"
2022,Noviembre,República CentroÁfricana,140,0,1,,1,"(6.171601,-75.427454)"
2022,Noviembre,Federación de Rusia,643,0,2,,2,"(10.445761,-75.516429)"
2022,Noviembre,Federación de Rusia,643,11,13,,24,"(4.697144,-74.140516)"
2022,Noviembre,República Dominicana,214,103,154,,257,"(10.445761,-75.516429)"
2022,Noviembre,República Dominicana,214,199,186,,385,"(10.886611,-74.776708)"
2022,Noviembre,República Dominicana,214,542,419,,961,"(3.541112,-76.384584)"
2022,Noviembre,República Dominicana,214,0,1,,1,"(4.452882,-75.766298)"
2022,Noviembre,República Dominicana,214,6675,5842,,12517,"(4.697144,-74.140516)"
2022,Noviembre,República Dominicana,214,121,81,,202,"(4.815061,-75.736532)"
2022,Noviembre,República Dominicana,214,0,4,,4,"(6.17134,-75.427194)"
2022,Noviembre,República Dominicana,214,5313,3966,,9279,"(6.171601,-75.427454)"
2022,Noviembre,República Dominicana,214,66,54,,120,"(7.128456,-73.183637)"
2022,Noviembre,República Dominicana,214,8,3,,11,"(7.927209,-72.507910)"
2022,Noviembre,Reunión,638,1,0,,1,"(4.697144,-74.140516)"
2022,Noviembre,Rumania,642,0,1,,1,"(10.445761,-75.516429)"
2022,Noviembre,Rumania,642,5,12,,17,"(4.697144,-74.140516)"
2022,Noviembre,Rumania,642,1,3,,4,"(6.171601,-75.427454)"
2022,Noviembre,Rwanda,646,4,3,,7,"(4.697144,-74.140516)"
2022,Noviembre,San Cristóbal y Nevis,659,4,5,,9,"(7.818934,-72.453226)"
2022,Noviembre,San Marino,674,5,6,,11,"(4.697144,-74.140516)"
2022,Noviembre,San  Vicente y las Granadinas,670,1,1,,2,"(4.697144,-74.140516)"
2022,Noviembre,Santa Elena/Territorio Británico de Ultramar,654,0,1,,1,"(0.814836,-77.662532)"
2022,Noviembre,Santa Lucia,662,0,1,,1,"(4.697144,-74.140516)"
2022,Noviembre,Senegal,686,3,3,,6,"(3.541112,-76.384584)"
2022,Noviembre,Senegal,686,5,2,,7,"(4.697144,-74.140516)"
2022,Noviembre,Serbia,688,1,0,,1,"(10.886611,-74.776708)"
2022,Noviembre,Serbia,688,1,1,,2,"(4.697144,-74.140516)"
2022,Noviembre,Seychelles,690,0,1,,1,"(4.697144,-74.140516)"
2022,Noviembre,Sierra Leona,694,1,0,,1,"(6.171601,-75.427454)"
2022,Noviembre,Singapur,702,0,1,,1,"(10.445761,-75.516429)"
2022,Noviembre,Singapur,702,1,0,,1,"(11.117806,-74.232622)"
2022,Noviembre,Singapur,702,0,1,,1,"(3.541112,-76.384584)"
2022,Noviembre,Singapur,702,26,28,,54,"(4.697144,-74.140516)"
2022,Noviembre,Singapur,702,3,1,,4,"(6.171601,-75.427454)"
2022,Noviembre,Sri Lanka,144,0,1,,1,"(4.697144,-74.140516)"
2022,Noviembre,Sri Lanka,144,1,0,,1,"(4.815061,-75.736532)"
2022,Noviembre,Sudáfrica,710,1,0,,1,"(10.886611,-74.776708)"
2022,Noviembre,Sudáfrica,710,2,1,,3,"(3.541112,-76.384584)"
2022,Noviembre,Sudáfrica,710,25,18,,43,"(4.697144,-74.140516)"
2022,Noviembre,Sudáfrica,710,1,1,,2,"(6.171601,-75.427454)"
2022,Noviembre,Sudán,736,1,2,,3,"(4.697144,-74.140516)"
2022,Noviembre,Suecia,752,5,7,,12,"(10.445761,-75.516429)"
2022,Noviembre,Suecia,752,0,1,,1,"(11.117806,-74.232622)"
2022,Noviembre,Suecia,752,14,6,,20,"(3.541112,-76.384584)"
2022,Noviembre,Suecia,752,66,41,,107,"(4.697144,-74.140516)"
2022,Noviembre,Suecia,752,14,5,,19,"(6.171601,-75.427454)"
2022,Noviembre,Suiza,756,15,7,,22,"(10.445761,-75.516429)"
2022,Noviembre,Suiza,756,0,1,,1,"(10.886611,-74.776708)"
2022,Noviembre,Suiza,756,0,1,,1,"(11.117806,-74.232622)"
2022,Noviembre,Suiza,756,38,23,,61,"(3.541112,-76.384584)"
2022,Noviembre,Suiza,756,1,0,,1,"(4.452882,-75.766298)"
2022,Noviembre,Suiza,756,322,186,,508,"(4.697144,-74.140516)"
2022,Noviembre,Suiza,756,0,4,,4,"(4.815061,-75.736532)"
2022,Noviembre,Suiza,756,46,18,,64,"(6.171601,-75.427454)"
2022,Noviembre,Surinam,740,0,1,,1,"(10.408582,-75.538003)"
2022,Noviembre,Surinam,740,0,1,,1,"(10.445761,-75.516429)"
2022,Noviembre,Surinam,740,0,2,,2,"(10.886611,-74.776708)"
2022,Noviembre,Surinam,740,3,1,,4,"(3.541112,-76.384584)"
2022,Noviembre,Surinam,740,10,18,,28,"(4.697144,-74.140516)"
2022,Noviembre,Surinam,740,3,1,,4,"(6.171601,-75.427454)"
2022,Noviembre,Surinam,740,2,0,,2,"(7.927209,-72.507910)"
2022,Noviembre,Taiwán,158,5,4,,9,"(4.697144,-74.140516)"
2022,Noviembre,Taiwán,158,0,1,,1,"(6.171601,-75.427454)"
2022,Noviembre,Tailandia,764,1,3,,4,"(3.541112,-76.384584)"
2022,Noviembre,Tailandia,764,52,61,,113,"(4.697144,-74.140516)"
2022,Noviembre,Tailandia,764,2,2,,4,"(6.171601,-75.427454)"
2022,Noviembre,Tanzania,834,0,1,,1,"(3.541112,-76.384584)"
2022,Noviembre,Tanzania,834,0,2,,2,"(4.697144,-74.140516)"
2022,Noviembre,Trinidad y Tobago,780,2,0,,2,"(10.886611,-74.776708)"
2022,Noviembre,Trinidad y Tobago,780,0,4,,4,"(3.541112,-76.384584)"
2022,Noviembre,Trinidad y Tobago,780,9,24,,33,"(4.697144,-74.140516)"
2022,Noviembre,Trinidad y Tobago,780,3,8,,11,"(6.171601,-75.427454)"
2022,Noviembre,Trinidad y Tobago,780,2,0,,2,"(7.128456,-73.183637)"
2022,Noviembre,Trinidad y Tobago,780,1,0,,1,"(7.927209,-72.507910)"
2022,Noviembre,Túnez,788,1,1,,2,"(4.697144,-74.140516)"
2022,Noviembre,Turquía,792,1,5,,6,"(10.445761,-75.516429)"
2022,Noviembre,Turquía,792,2,1,,3,"(10.886611,-74.776708)"
2022,Noviembre,Turquía,792,9,6,,15,"(3.541112,-76.384584)"
2022,Noviembre,Turquía,792,1394,927,,2321,"(4.697144,-74.140516)"
2022,Noviembre,Turquía,792,15,9,,24,"(6.171601,-75.427454)"
2022,Noviembre,Tuvalu,798,0,1,,1,"(4.697144,-74.140516)"
2022,Noviembre,Turkmenistán,795,2,1,,3,"(4.697144,-74.140516)"
2022,Noviembre,Uganda,800,3,1,,4,"(4.697144,-74.140516)"
2022,Noviembre,Uruguay,858,6,4,,10,"(10.445761,-75.516429)"
2022,Noviembre,Uruguay,858,8,6,,14,"(10.886611,-74.776708)"
2022,Noviembre,Uruguay,858,5,1,,6,"(11.117806,-74.232622)"
2022,Noviembre,Uruguay,858,56,57,,113,"(3.541112,-76.384584)"
2022,Noviembre,Uruguay,858,6,3,,9,"(4.452882,-75.766298)"
2022,Noviembre,Uruguay,858,342,310,,652,"(4.697144,-74.140516)"
2022,Noviembre,Uruguay,858,6,7,,13,"(4.815061,-75.736532)"
2022,Noviembre,Uruguay,858,22,34,,56,"(6.171601,-75.427454)"
2022,Noviembre,Uruguay,858,2,1,,3,"(7.128456,-73.183637)"
2022,Noviembre,Uruguay,858,2,1,,3,"(7.927209,-72.507910)"
2022,Noviembre,Uzbekistán,860,2,1,,3,"(4.697144,-74.140516)"
2022,Noviembre,Venezuela,862,17,11,,28,"(10.445761,-75.516429)"
2022,Noviembre,Venezuela,862,31,35,,66,"(10.886611,-74.776708)"
2022,Noviembre,Venezuela,862,2,0,,2,"(11.117806,-74.232622)"
2022,Noviembre,Venezuela,862,518,930,,1448,"(11.360009,-72.129330)"
2022,Noviembre,Venezuela,862,24,31,,55,"(3.541112,-76.384584)"
2022,Noviembre,Venezuela,862,5,3,,8,"(3.866713,-67.927521)"
2022,Noviembre,Venezuela,862,1,2,,3,"(4.452882,-75.766298)"
2022,Noviembre,Venezuela,862,239,653,,892,"(4.697144,-74.140516)"
2022,Noviembre,Venezuela,862,9,23,,32,"(4.815061,-75.736532)"
2022,Noviembre,Venezuela,862,46,88,,134,"(6.171601,-75.427454)"
2022,Noviembre,Venezuela,862,11,13,,24,"(6.18189,-67.47535)"
2022,Noviembre,Venezuela,862,49,112,,161,"(7.088729,-70.740253)"
2022,Noviembre,Venezuela,862,7,10,,17,"(7.128456,-73.183637)"
2022,Noviembre,Venezuela,862,765,946,,1711,"(7.818934,-72.453226)"
2022,Noviembre,Venezuela,862,134,219,,353,"(7.916725,-72.462544)"
2022,Noviembre,Venezuela,862,19,10,,29,"(7.927209,-72.507910)"
2022,Noviembre,Venezuela,862,72,105,,177,"(8.36068,-72.409396)"
2022,Noviembre,Vietnam,704,5,6,,11,"(4.697144,-74.140516)"
2022,Noviembre,Islas Vírgenes Británicas/Territorio Británico de Ultramar,92,0,4,,4,"(4.697144,-74.140516)"
2022,Noviembre,Islas Vírgenes Británicas/Territorio Británico de Ultramar,92,3,0,,3,"(6.171601,-75.427454)"
2022,Noviembre,Zambia,894,0,1,,1,"(4.697144,-74.140516)"
2022,Noviembre,Anguila/Territorio Británico de Ultramar,660,1,1,,2,"(4.697144,-74.140516)"
2022,Noviembre,Islas Turcas y Caicos/Territorio Británico de Ultramar,796,0,5,,5,"(10.445761,-75.516429)"
2022,Noviembre,Islas Turcas y Caicos/Territorio Británico de Ultramar,796,1,0,,1,"(3.541112,-76.384584)"
2022,Noviembre,Islas Turcas y Caicos/Territorio Británico de Ultramar,796,1,4,,5,"(4.697144,-74.140516)"
2022,Noviembre,Islas Turcas y Caicos/Territorio Británico de Ultramar,796,11,9,,20,"(6.171601,-75.427454)"
2022,Noviembre,Desconocido,99999,1,0,,1,"(4.697144,-74.140516)"
2022,Noviembre,Desconocido,99999,1,1,,2,"(6.171601,-75.427454)"
2022,Diciembre,Afganistán,4,0,2,,2,"(4.697144,-74.140516)"
2022,Diciembre,Albania,8,2,1,,3,"(4.697144,-74.140516)"
2022,Diciembre,Alemania,276,1,0,,1,"(0.814836,-77.662532)"
2022,Diciembre,Alemania,276,56,57,,113,"(10.445761,-75.516429)"
2022,Diciembre,Alemania,276,6,5,,11,"(10.886611,-74.776708)"
2022,Diciembre,Alemania,276,86,54,,140,"(3.541112,-76.384584)"
2022,Diciembre,Alemania,276,0,1,,1,"(4.452882,-75.766298)"
2022,Diciembre,Alemania,276,1255,835,,2090,"(4.697144,-74.140516)"
2022,Diciembre,Alemania,276,3,3,,6,"(4.815061,-75.736532)"
2022,Diciembre,Alemania,276,137,88,,225,"(6.171601,-75.427454)"
2022,Diciembre,Andorra,20,1,0,,1,"(10.445761,-75.516429)"
2022,Diciembre,Andorra,20,17,16,,33,"(4.697144,-74.140516)"
2022,Diciembre,Angola,24,0,2,,2,"(4.697144,-74.140516)"
2022,Diciembre,Angola,24,0,1,,1,"(6.171601,-75.427454)"
2022,Diciembre,Antigua y Barbuda,28,2,0,,2,"(4.697144,-74.140516)"
2022,Diciembre,Antigua y Barbuda,28,2,1,,3,"(6.171601,-75.427454)"
2022,Diciembre,Países Bajos,528,279,155,,434,"(10.445761,-75.516429)"
2022,Diciembre,Países Bajos,528,33,13,,46,"(10.886611,-74.776708)"
2022,Diciembre,Países Bajos,528,0,1,,1,"(11.247723,-74.213989)"
2022,Diciembre,Países Bajos,528,64,52,,116,"(3.541112,-76.384584)"
2022,Diciembre,Países Bajos,528,1143,944,,2087,"(4.697144,-74.140516)"
2022,Diciembre,Países Bajos,528,8,4,,12,"(4.815061,-75.736532)"
2022,Diciembre,Países Bajos,528,118,68,,186,"(6.171601,-75.427454)"
2022,Diciembre,Países Bajos,528,1,0,,1,"(7.927209,-72.507910)"
2022,Diciembre,Arabia Saudita,682,0,1,,1,"(10.445761,-75.516429)"
2022,Diciembre,Arabia Saudita,682,0,1,,1,"(3.541112,-76.384584)"
2022,Diciembre,Arabia Saudita,682,23,41,,64,"(4.697144,-74.140516)"
2022,Diciembre,Arabia Saudita,682,3,0,,3,"(6.171601,-75.427454)"
2022,Diciembre,Argelia,12,1,0,,1,"(10.445761,-75.516429)"
2022,Diciembre,Argelia,12,1,7,,8,"(4.697144,-74.140516)"
2022,Diciembre,Argentina,32,0,1,,1,"(0.25129,-76.875963)"
2022,Diciembre,Argentina,32,3,6,,9,"(0.814836,-77.662532)"
2022,Diciembre,Argentina,32,27,16,,43,"(10.445761,-75.516429)"
2022,Diciembre,Argentina,32,33,28,,61,"(10.886611,-74.776708)"
2022,Diciembre,Argentina,32,10,0,,10,"(11.117806,-74.232622)"
2022,Diciembre,Argentina,32,1,0,,1,"(12.586067,-81.702563)"
2022,Diciembre,Argentina,32,129,98,,227,"(3.541112,-76.384584)"
2022,Diciembre,Argentina,32,3,3,,6,"(4.452882,-75.766298)"
2022,Diciembre,Argentina,32,4757,3974,,8731,"(4.697144,-74.140516)"
2022,Diciembre,Argentina,32,3,2,,5,"(4.815061,-75.736532)"
2022,Diciembre,Argentina,32,532,412,,944,"(6.171601,-75.427454)"
2022,Diciembre,Argentina,32,2,4,,6,"(7.128456,-73.183637)"
2022,Diciembre,Argentina,32,5,2,,7,"(7.927209,-72.507910)"
2022,Diciembre,República de Armenia,51,1,1,,2,"(4.697144,-74.140516)"
2022,Diciembre,Aruba,533,1,1,,2,"(10.408582,-75.538003)"
2022,Diciembre,Aruba,533,14,12,,26,"(10.445761,-75.516429)"
2022,Diciembre,Aruba,533,230,150,,380,"(10.886611,-74.776708)"
2022,Diciembre,Aruba,533,1,0,,1,"(11.247723,-74.213989)"
2022,Diciembre,Aruba,533,74,53,,127,"(3.541112,-76.384584)"
2022,Diciembre,Aruba,533,2274,1668,,3942,"(4.697144,-74.140516)"
2022,Diciembre,Aruba,533,14,12,,26,"(4.815061,-75.736532)"
2022,Diciembre,Aruba,533,612,456,,1068,"(6.171601,-75.427454)"
2022,Diciembre,Aruba,533,12,30,,42,"(7.128456,-73.183637)"
2022,Diciembre,Australia,36,5,2,,7,"(10.445761,-75.516429)"
2022,Diciembre,Australia,36,4,2,,6,"(10.886611,-74.776708)"
2022,Diciembre,Australia,36,1,0,,1,"(12.586067,-81.702563)"
2022,Diciembre,Australia,36,36,31,,67,"(3.541112,-76.384584)"
2022,Diciembre,Australia,36,939,818,,1757,"(4.697144,-74.140516)"
2022,Diciembre,Australia,36,3,3,,6,"(4.815061,-75.736532)"
2022,Diciembre,Australia,36,114,94,,208,"(6.171601,-75.427454)"
2022,Diciembre,Australia,36,4,1,,5,"(7.128456,-73.183637)"
2022,Diciembre,Austria,40,5,6,,11,"(10.445761,-75.516429)"
2022,Diciembre,Austria,40,3,4,,7,"(3.541112,-76.384584)"
2022,Diciembre,Austria,40,83,53,,136,"(4.697144,-74.140516)"
2022,Diciembre,Austria,40,6,3,,9,"(6.171601,-75.427454)"
2022,Diciembre,Azerbaiyán,31,0,13,,13,"(4.697144,-74.140516)"
2022,Diciembre,Bahamas,44,1,0,,1,"(10.445761,-75.516429)"
2022,Diciembre,Bahamas,44,3,6,,9,"(10.886611,-74.776708)"
2022,Diciembre,Bahamas,44,26,16,,42,"(3.541112,-76.384584)"
2022,Diciembre,Bahamas,44,52,29,,81,"(4.697144,-74.140516)"
2022,Diciembre,Bahamas,44,18,9,,27,"(6.171601,-75.427454)"
2022,Diciembre,Bahréin,48,0,1,,1,"(10.445761,-75.516429)"
2022,Diciembre,Bahréin,48,1,0,,1,"(4.452882,-75.766298)"
2022,Diciembre,Bahréin,48,1,5,,6,"(4.697144,-74.140516)"
2022,Diciembre,Bahréin,48,2,1,,3,"(6.171601,-75.427454)"
2022,Diciembre,Bangladesh,50,0,1,,1,"(10.445761,-75.516429)"
2022,Diciembre,Bangladesh,50,1,3,,4,"(4.697144,-74.140516)"
2022,Diciembre,Barbados,52,2,1,,3,"(10.445761,-75.516429)"
2022,Diciembre,Barbados,52,4,2,,6,"(3.541112,-76.384584)"
2022,Diciembre,Barbados,52,14,18,,32,"(4.697144,-74.140516)"
2022,Diciembre,Barbados,52,2,0,,2,"(4.815061,-75.736532)"
2022,Diciembre,Barbados,52,11,7,,18,"(6.171601,-75.427454)"
2022,Diciembre,República de Belarús,112,1,0,,1,"(4.697144,-74.140516)"
2022,Diciembre,Bélgica,56,17,8,,25,"(10.445761,-75.516429)"
2022,Diciembre,Bélgica,56,1,0,,1,"(10.886611,-74.776708)"
2022,Diciembre,Bélgica,56,24,13,,37,"(3.541112,-76.384584)"
2022,Diciembre,Bélgica,56,157,105,,262,"(4.697144,-74.140516)"
2022,Diciembre,Bélgica,56,0,1,,1,"(4.815061,-75.736532)"
2022,Diciembre,Bélgica,56,33,23,,56,"(6.171601,-75.427454)"
2022,Diciembre,Belice,84,1,1,,2,"(10.445761,-75.516429)"
2022,Diciembre,Belice,84,1,1,,2,"(3.541112,-76.384584)"
2022,Diciembre,Belice,84,5,4,,9,"(4.697144,-74.140516)"
2022,Diciembre,Belice,84,0,1,,1,"(6.171601,-75.427454)"
2022,Diciembre,Belice,84,1,0,,1,"(7.128456,-73.183637)"
2022,Diciembre,Benín,204,1,0,,1,"(4.697144,-74.140516)"
2022,Diciembre,Bermudas/Territorio Británico de Ultramar,60,0,4,,4,"(4.697144,-74.140516)"
2022,Diciembre,Bolivia,68,4,3,,7,"(0.25129,-76.875963)"
2022,Diciembre,Bolivia,68,2,2,,4,"(0.814836,-77.662532)"
2022,Diciembre,Bolivia,68,1,1,,2,"(10.445761,-75.516429)"
2022,Diciembre,Bolivia,68,2,0,,2,"(10.886611,-74.776708)"
2022,Diciembre,Bolivia,68,10,19,,29,"(3.541112,-76.384584)"
2022,Diciembre,Bolivia,68,0,1,,1,"(4.452882,-75.766298)"
2022,Diciembre,Bolivia,68,457,502,,959,"(4.697144,-74.140516)"
2022,Diciembre,Bolivia,68,1,4,,5,"(4.815061,-75.736532)"
2022,Diciembre,Bolivia,68,14,19,,33,"(6.171601,-75.427454)"
2022,Diciembre,Bolivia,68,0,1,,1,"(7.128456,-73.183637)"
2022,Diciembre,Bosnia y Herzegovina,70,3,5,,8,"(4.697144,-74.140516)"
2022,Diciembre,Botsuana,72,1,1,,2,"(4.697144,-74.140516)"
2022,Diciembre,Brasil,76,212,261,,473,"(-4.197703,-69.941278)"
2022,Diciembre,Brasil,76,0,3,,3,"(-4.223468,-69.945098)"
2022,Diciembre,Brasil,76,1,0,,1,"(0.25129,-76.875963)"
2022,Diciembre,Brasil,76,0,2,,2,"(0.814836,-77.662532)"
2022,Diciembre,Brasil,76,19,28,,47,"(10.445761,-75.516429)"
2022,Diciembre,Brasil,76,15,25,,40,"(10.886611,-74.776708)"
2022,Diciembre,Brasil,76,1,0,,1,"(11.117806,-74.232622)"
2022,Diciembre,Brasil,76,121,135,,256,"(3.541112,-76.384584)"
2022,Diciembre,Brasil,76,0,2,,2,"(3.866713,-67.927521)"
2022,Diciembre,Brasil,76,30,18,,48,"(4.452882,-75.766298)"
2022,Diciembre,Brasil,76,3506,3627,,7133,"(4.697144,-74.140516)"
2022,Diciembre,Brasil,76,34,34,,68,"(4.815061,-75.736532)"
2022,Diciembre,Brasil,76,527,469,,996,"(6.171601,-75.427454)"
2022,Diciembre,Brasil,76,3,5,,8,"(7.128456,-73.183637)"
2022,Diciembre,Brasil,76,2,1,,3,"(7.927209,-72.507910)"
2022,Diciembre,Bulgaria,100,0,1,,1,"(3.541112,-76.384584)"
2022,Diciembre,Bulgaria,100,4,7,,11,"(4.697144,-74.140516)"
2022,Diciembre,Burkina Faso,854,1,0,,1,"(4.697144,-74.140516)"
2022,Diciembre,Burundi,108,1,0,,1,"(4.697144,-74.140516)"
2022,Diciembre,Cabo Verde,132,1,0,,1,"(10.445761,-75.516429)"
2022,Diciembre,Cabo Verde,132,0,1,,1,"(4.697144,-74.140516)"
2022,Diciembre,Cabo Verde,132,1,0,,1,"(6.171601,-75.427454)"
2022,Diciembre,Islas Caimán/Territorio Británico de Ultramar,136,0,1,,1,"(10.445761,-75.516429)"
2022,Diciembre,Islas Caimán/Territorio Británico de Ultramar,136,1,0,,1,"(10.886611,-74.776708)"
2022,Diciembre,Islas Caimán/Territorio Británico de Ultramar,136,4,1,,5,"(12.586067,-81.702563)"
2022,Diciembre,Islas Caimán/Territorio Británico de Ultramar,136,1,0,,1,"(3.541112,-76.384584)"
2022,Diciembre,Islas Caimán/Territorio Británico de Ultramar,136,6,6,,12,"(4.697144,-74.140516)"
2022,Diciembre,Islas Caimán/Territorio Británico de Ultramar,136,1,3,,4,"(4.815061,-75.736532)"
2022,Diciembre,Islas Caimán/Territorio Británico de Ultramar,136,4,0,,4,"(6.171601,-75.427454)"
2022,Diciembre,Camerún,120,2,1,,3,"(4.697144,-74.140516)"
2022,Diciembre,Canadá,124,272,232,,504,"(10.445761,-75.516429)"
2022,Diciembre,Canadá,124,55,59,,114,"(10.886611,-74.776708)"
2022,Diciembre,Canadá,124,14,8,,22,"(11.117806,-74.232622)"
2022,Diciembre,Canadá,124,1,0,,1,"(12.586067,-81.702563)"
2022,Diciembre,Canadá,124,80,65,,145,"(3.541112,-76.384584)"
2022,Diciembre,Canadá,124,11,9,,20,"(4.452882,-75.766298)"
2022,Diciembre,Canadá,124,3338,2650,,5988,"(4.697144,-74.140516)"
2022,Diciembre,Canadá,124,21,12,,33,"(4.815061,-75.736532)"
2022,Diciembre,Canadá,124,304,232,,536,"(6.171601,-75.427454)"
2022,Diciembre,Canadá,124,5,4,,9,"(7.128456,-73.183637)"
2022,Diciembre,Canadá,124,3,0,,3,"(7.927209,-72.507910)"
2022,Diciembre,Chad,148,0,1,,1,"(6.171601,-75.427454)"
2022,Diciembre,España,724,294,202,,496,"(10.445761,-75.516429)"
2022,Diciembre,España,724,26,23,,49,"(10.886611,-74.776708)"
2022,Diciembre,España,724,2106,1546,,3652,"(3.541112,-76.384584)"
2022,Diciembre,España,724,1,0,,1,"(4.452882,-75.766298)"
2022,Diciembre,España,724,23294,17409,,40703,"(4.697144,-74.140516)"
2022,Diciembre,España,724,16,26,,42,"(4.815061,-75.736532)"
2022,Diciembre,España,724,3478,2495,,5973,"(6.171601,-75.427454)"
2022,Diciembre,España,724,1,0,,1,"(7.128456,-73.183637)"
2022,Diciembre,Colombia,170,25,78,,103,"(4.697144,-74.140516)"
2022,Diciembre,República Del Congo,178,0,1,,1,"(4.697144,-74.140516)"
2022,Diciembre,Comoras,174,1,0,,1,"(4.697144,-74.140516)"
2022,Diciembre,República de Corea,410,1,0,,1,"(10.445761,-75.516429)"
2022,Diciembre,República de Corea,410,1,0,,1,"(10.886611,-74.776708)"
2022,Diciembre,República de Corea,410,1,0,,1,"(3.541112,-76.384584)"
2022,Diciembre,República de Corea,410,42,28,,70,"(4.697144,-74.140516)"
2022,Diciembre,Costa de Marfil,384,1,0,,1,"(10.445761,-75.516429)"
2022,Diciembre,Costa de Marfil,384,2,5,,7,"(4.697144,-74.140516)"
2022,Diciembre,Costa Rica,188,53,48,,101,"(10.445761,-75.516429)"
2022,Diciembre,Costa Rica,188,21,21,,42,"(10.886611,-74.776708)"
2022,Diciembre,Costa Rica,188,8,4,,12,"(11.117806,-74.232622)"
2022,Diciembre,Costa Rica,188,2,18,,20,"(12.5744111,-81.703935)"
2022,Diciembre,Costa Rica,188,74,64,,138,"(3.541112,-76.384584)"
2022,Diciembre,Costa Rica,188,6,3,,9,"(4.452882,-75.766298)"
2022,Diciembre,Costa Rica,188,1609,1493,,3102,"(4.697144,-74.140516)"
2022,Diciembre,Costa Rica,188,16,10,,26,"(4.815061,-75.736532)"
2022,Diciembre,Costa Rica,188,311,247,,558,"(6.171601,-75.427454)"
2022,Diciembre,Costa Rica,188,1,0,,1,"(7.128456,-73.183637)"
2022,Diciembre,Costa Rica,188,1,1,,2,"(7.927209,-72.507910)"
2022,Diciembre,Croacia,191,0,1,,1,"(10.445761,-75.516429)"
2022,Diciembre,Croacia,191,1,0,,1,"(3.541112,-76.384584)"
2022,Diciembre,Croacia,191,8,5,,13,"(4.697144,-74.140516)"
2022,Diciembre,Croacia,191,2,1,,3,"(6.171601,-75.427454)"
2022,Diciembre,Cuba,192,6,3,,9,"(10.445761,-75.516429)"
2022,Diciembre,Cuba,192,6,8,,14,"(10.886611,-74.776708)"
2022,Diciembre,Cuba,192,9,9,,18,"(3.541112,-76.384584)"
2022,Diciembre,Cuba,192,4,2,,6,"(4.452882,-75.766298)"
2022,Diciembre,Cuba,192,1246,1081,,2327,"(4.697144,-74.140516)"
2022,Diciembre,Cuba,192,4,4,,8,"(4.815061,-75.736532)"
2022,Diciembre,Cuba,192,632,566,,1198,"(6.171601,-75.427454)"
2022,Diciembre,Cuba,192,4,1,,5,"(7.128456,-73.183637)"
2022,Diciembre,Curazao,99999,3,2,,5,"(10.445761,-75.516429)"
2022,Diciembre,Curazao,99999,65,44,,109,"(10.886611,-74.776708)"
2022,Diciembre,Curazao,99999,1,0,,1,"(11.117806,-74.232622)"
2022,Diciembre,Curazao,99999,39,31,,70,"(3.541112,-76.384584)"
2022,Diciembre,Curazao,99999,1496,1232,,2728,"(4.697144,-74.140516)"
2022,Diciembre,Curazao,99999,4,3,,7,"(4.815061,-75.736532)"
2022,Diciembre,Curazao,99999,158,101,,259,"(6.171601,-75.427454)"
2022,Diciembre,Curazao,99999,1,0,,1,"(7.818934,-72.453226)"
2022,Diciembre,República Checa,203,0,1,,1,"(3.541112,-76.384584)"
2022,Diciembre,República Checa,203,15,21,,36,"(4.697144,-74.140516)"
2022,Diciembre,República Checa,203,2,2,,4,"(6.171601,-75.427454)"
2022,Diciembre,Chile,152,1,0,,1,"(0.25129,-76.875963)"
2022,Diciembre,Chile,152,26,20,,46,"(0.814836,-77.662532)"
2022,Diciembre,Chile,152,0,1,,1,"(1.813928,-78.763924)"
2022,Diciembre,Chile,152,39,23,,62,"(10.445761,-75.516429)"
2022,Diciembre,Chile,152,55,37,,92,"(10.886611,-74.776708)"
2022,Diciembre,Chile,152,6,5,,11,"(11.117806,-74.232622)"
2022,Diciembre,Chile,152,0,3,,3,"(12.586067,-81.702563)"
2022,Diciembre,Chile,152,3733,2327,,6060,"(3.541112,-76.384584)"
2022,Diciembre,Chile,152,23,14,,37,"(4.452882,-75.766298)"
2022,Diciembre,Chile,152,6892,5242,,12134,"(4.697144,-74.140516)"
2022,Diciembre,Chile,152,33,16,,49,"(4.815061,-75.736532)"
2022,Diciembre,Chile,152,659,428,,1087,"(6.171601,-75.427454)"
2022,Diciembre,Chile,152,13,8,,21,"(7.128456,-73.183637)"
2022,Diciembre,Chile,152,18,17,,35,"(7.927209,-72.507910)"
2022,Diciembre,China,156,1,0,,1,"(3.541112,-76.384584)"
2022,Diciembre,China,156,8,6,,14,"(4.697144,-74.140516)"
2022,Diciembre,Chipre,196,4,4,,8,"(4.697144,-74.140516)"
2022,Diciembre,Chipre,196,1,0,,1,"(6.171601,-75.427454)"
2022,Diciembre,Dinamarca,208,5,4,,9,"(10.445761,-75.516429)"
2022,Diciembre,Dinamarca,208,1,0,,1,"(10.886611,-74.776708)"
2022,Diciembre,Dinamarca,208,0,1,,1,"(11.117806,-74.232622)"
2022,Diciembre,Dinamarca,208,0,2,,2,"(3.541112,-76.384584)"
2022,Diciembre,Dinamarca,208,40,29,,69,"(4.697144,-74.140516)"
2022,Diciembre,Dinamarca,208,7,4,,11,"(6.171601,-75.427454)"
2022,Diciembre,Dominica,212,1,1,,2,"(10.886611,-74.776708)"
2022,Diciembre,Dominica,212,1,0,,1,"(3.541112,-76.384584)"
2022,Diciembre,Dominica,212,12,10,,22,"(4.697144,-74.140516)"
2022,Diciembre,Dominica,212,9,3,,12,"(6.171601,-75.427454)"
2022,Diciembre,Ecuador,218,645,702,,1347,"(0.25129,-76.875963)"
2022,Diciembre,Ecuador,218,33,28,,61,"(0.812436,-77.847006)"
2022,Diciembre,Ecuador,218,5259,5312,,10571,"(0.814836,-77.662532)"
2022,Diciembre,Ecuador,218,41,37,,78,"(1.813928,-78.763924)"
2022,Diciembre,Ecuador,218,0,1,,1,"(10.408582,-75.538003)"
2022,Diciembre,Ecuador,218,22,16,,38,"(10.445761,-75.516429)"
2022,Diciembre,Ecuador,218,20,37,,57,"(10.886611,-74.776708)"
2022,Diciembre,Ecuador,218,3,3,,6,"(11.117806,-74.232622)"
2022,Diciembre,Ecuador,218,90,103,,193,"(3.541112,-76.384584)"
2022,Diciembre,Ecuador,218,0,5,,5,"(3.893038,-77.067921)"
2022,Diciembre,Ecuador,218,1,2,,3,"(4.452882,-75.766298)"
2022,Diciembre,Ecuador,218,3835,4037,,7872,"(4.697144,-74.140516)"
2022,Diciembre,Ecuador,218,5,4,,9,"(4.815061,-75.736532)"
2022,Diciembre,Ecuador,218,161,131,,292,"(6.171601,-75.427454)"
2022,Diciembre,Ecuador,218,3,5,,8,"(7.128456,-73.183637)"
2022,Diciembre,Ecuador,218,1,0,,1,"(7.927209,-72.507910)"
2022,Diciembre,Egipto,818,0,1,,1,"(10.408582,-75.538003)"
2022,Diciembre,Egipto,818,1,0,,1,"(10.445761,-75.516429)"
2022,Diciembre,Egipto,818,1,1,,2,"(3.541112,-76.384584)"
2022,Diciembre,Egipto,818,68,180,,248,"(4.697144,-74.140516)"
2022,Diciembre,Egipto,818,1,0,,1,"(6.171601,-75.427454)"
2022,Diciembre,El Salvador,222,7,9,,16,"(10.445761,-75.516429)"
2022,Diciembre,El Salvador,222,5,1,,6,"(10.886611,-74.776708)"
2022,Diciembre,El Salvador,222,8,7,,15,"(3.541112,-76.384584)"
2022,Diciembre,El Salvador,222,407,412,,819,"(4.697144,-74.140516)"
2022,Diciembre,El Salvador,222,1,1,,2,"(4.815061,-75.736532)"
2022,Diciembre,El Salvador,222,32,50,,82,"(6.171601,-75.427454)"
2022,Diciembre,El Salvador,222,2,2,,4,"(7.128456,-73.183637)"
2022,Diciembre,Emiratos Árabes,784,8,14,,22,"(10.445761,-75.516429)"
2022,Diciembre,Emiratos Árabes,784,3,3,,6,"(10.886611,-74.776708)"
2022,Diciembre,Emiratos Árabes,784,9,12,,21,"(3.541112,-76.384584)"
2022,Diciembre,Emiratos Árabes,784,322,369,,691,"(4.697144,-74.140516)"
2022,Diciembre,Emiratos Árabes,784,2,0,,2,"(4.815061,-75.736532)"
2022,Diciembre,Emiratos Árabes,784,25,22,,47,"(6.171601,-75.427454)"
2022,Diciembre,Emiratos Árabes,784,1,0,,1,"(7.128456,-73.183637)"
2022,Diciembre,Eslovaquia,703,2,2,,4,"(4.697144,-74.140516)"
2022,Diciembre,Eslovaquia,703,3,3,,6,"(6.171601,-75.427454)"
2022,Diciembre,Eslovenia,705,2,2,,4,"(4.697144,-74.140516)"
2022,Diciembre,Estados Unidos de América,840,1,0,,1,"(10.408582,-75.538003)"
2022,Diciembre,Estados Unidos de América,840,3455,2651,,6106,"(10.445761,-75.516429)"
2022,Diciembre,Estados Unidos de América,840,4718,3617,,8335,"(10.886611,-74.776708)"
2022,Diciembre,Estados Unidos de América,840,269,200,,469,"(11.117806,-74.232622)"
2022,Diciembre,Estados Unidos de América,840,124,89,,213,"(12.586067,-81.702563)"
2022,Diciembre,Estados Unidos de América,840,8278,5801,,14079,"(3.541112,-76.384584)"
2022,Diciembre,Estados Unidos de América,840,922,596,,1518,"(4.452882,-75.766298)"
2022,Diciembre,Estados Unidos de América,840,40882,32222,,73105,"(4.697144,-74.140516)"
2022,Diciembre,Estados Unidos de América,840,2649,1858,,4507,"(4.815061,-75.736532)"
2022,Diciembre,Estados Unidos de América,840,0,5,,5,"(6.17134,-75.427194)"
2022,Diciembre,Estados Unidos de América,840,16639,12198,,28837,"(6.171601,-75.427454)"
2022,Diciembre,Estados Unidos de América,840,1145,861,,2006,"(7.128456,-73.183637)"
2022,Diciembre,Estados Unidos de América,840,80,50,,130,"(7.927209,-72.507910)"
2022,Diciembre,Estonia,233,5,2,,7,"(4.697144,-74.140516)"
2022,Diciembre,Etiopia,231,7,8,,15,"(4.697144,-74.140516)"
2022,Diciembre,Filipinas,608,1,0,,1,"(3.541112,-76.384584)"
2022,Diciembre,Filipinas,608,12,11,,23,"(4.697144,-74.140516)"
2022,Diciembre,Finlandia,246,6,1,,7,"(10.445761,-75.516429)"
2022,Diciembre,Finlandia,246,3,4,,7,"(3.541112,-76.384584)"
2022,Diciembre,Finlandia,246,24,16,,40,"(4.697144,-74.140516)"
2022,Diciembre,Finlandia,246,3,2,,5,"(6.171601,-75.427454)"
2022,Diciembre,Francia,250,31,16,,47,"(10.445761,-75.516429)"
2022,Diciembre,Francia,250,5,1,,6,"(10.886611,-74.776708)"
2022,Diciembre,Francia,250,76,55,,131,"(3.541112,-76.384584)"
2022,Diciembre,Francia,250,3,4,,7,"(4.452882,-75.766298)"
2022,Diciembre,Francia,250,2617,1782,,4399,"(4.697144,-74.140516)"
2022,Diciembre,Francia,250,5,2,,7,"(4.815061,-75.736532)"
2022,Diciembre,Francia,250,153,94,,247,"(6.171601,-75.427454)"
2022,Diciembre,Gabón,266,0,2,,2,"(4.697144,-74.140516)"
2022,Diciembre,Gambia,270,1,1,,2,"(4.697144,-74.140516)"
2022,Diciembre,Georgia,268,1,0,,1,"(10.886611,-74.776708)"
2022,Diciembre,Georgia,268,3,0,,3,"(3.541112,-76.384584)"
2022,Diciembre,Georgia,268,2,0,,2,"(4.452882,-75.766298)"
2022,Diciembre,Georgia,268,8,5,,13,"(4.697144,-74.140516)"
2022,Diciembre,Georgia,268,1,0,,1,"(4.815061,-75.736532)"
2022,Diciembre,Georgia,268,3,2,,5,"(6.171601,-75.427454)"
2022,Diciembre,Gibraltar/Territorio Británico de Ultramar,292,3,0,,3,"(4.697144,-74.140516)"
2022,Diciembre,Gibraltar/Territorio Británico de Ultramar,292,0,1,,1,"(6.171601,-75.427454)"
2022,Diciembre,Granada,308,1,1,,2,"(4.697144,-74.140516)"
2022,Diciembre,Grecia,300,23,13,,36,"(4.697144,-74.140516)"
2022,Diciembre,Grecia,300,6,1,,7,"(6.171601,-75.427454)"
2022,Diciembre,Guatemala,320,8,11,,19,"(10.445761,-75.516429)"
2022,Diciembre,Guatemala,320,9,15,,24,"(10.886611,-74.776708)"
2022,Diciembre,Guatemala,320,2,6,,8,"(11.117806,-74.232622)"
2022,Diciembre,Guatemala,320,0,6,,6,"(12.586067,-81.702563)"
2022,Diciembre,Guatemala,320,65,48,,113,"(3.541112,-76.384584)"
2022,Diciembre,Guatemala,320,5,5,,10,"(4.452882,-75.766298)"
2022,Diciembre,Guatemala,320,753,815,,1568,"(4.697144,-74.140516)"
2022,Diciembre,Guatemala,320,17,16,,33,"(4.815061,-75.736532)"
2022,Diciembre,Guatemala,320,97,103,,200,"(6.171601,-75.427454)"
2022,Diciembre,Guatemala,320,3,1,,4,"(7.128456,-73.183637)"
2022,Diciembre,Guatemala,320,4,1,,5,"(7.927209,-72.507910)"
2022,Diciembre,Guyana,328,0,1,,1,"(10.886611,-74.776708)"
2022,Diciembre,Guyana,328,0,2,,2,"(3.541112,-76.384584)"
2022,Diciembre,Guyana,328,1,14,,15,"(4.697144,-74.140516)"
2022,Diciembre,Guyana,328,0,1,,1,"(6.171601,-75.427454)"
2022,Diciembre,Guyana,328,0,3,,3,"(7.927209,-72.507910)"
2022,Diciembre,Guinea Ecuatorial,226,1,0,,1,"(3.541112,-76.384584)"
2022,Diciembre,Guinea Ecuatorial,226,1,4,,5,"(4.697144,-74.140516)"
2022,Diciembre,Guinea Ecuatorial,226,0,1,,1,"(6.171601,-75.427454)"
2022,Diciembre,Guinea Bissau,624,1,0,,1,"(4.697144,-74.140516)"
2022,Diciembre,Guadalupe/Territorio Francés,312,4,1,,5,"(4.697144,-74.140516)"
2022,Diciembre,Guayana Francesa/Departamento de Ultramar Francés,254,0,1,,1,"(3.541112,-76.384584)"
2022,Diciembre,Guayana Francesa/Departamento de Ultramar Francés,254,1,2,,3,"(6.171601,-75.427454)"
2022,Diciembre,Haití,332,0,1,,1,"(10.886611,-74.776708)"
2022,Diciembre,Haití,332,0,28,,28,"(4.697144,-74.140516)"
2022,Diciembre,Haití,332,1,0,,1,"(6.171601,-75.427454)"
2022,Diciembre,Honduras,340,7,16,,23,"(10.445761,-75.516429)"
2022,Diciembre,Honduras,340,7,11,,18,"(10.886611,-74.776708)"
2022,Diciembre,Honduras,340,1,2,,3,"(12.586067,-81.702563)"
2022,Diciembre,Honduras,340,26,28,,54,"(3.541112,-76.384584)"
2022,Diciembre,Honduras,340,65,103,,168,"(4.697144,-74.140516)"
2022,Diciembre,Honduras,340,4,8,,12,"(4.815061,-75.736532)"
2022,Diciembre,Honduras,340,44,42,,86,"(6.171601,-75.427454)"
2022,Diciembre,Honduras,340,1,0,,1,"(7.128456,-73.183637)"
2022,Diciembre,Hong Kong,344,1,2,,3,"(3.541112,-76.384584)"
2022,Diciembre,Hong Kong,344,7,2,,9,"(4.697144,-74.140516)"
2022,Diciembre,Hong Kong,344,0,1,,1,"(6.171601,-75.427454)"
2022,Diciembre,Hungría,348,17,9,,26,"(4.697144,-74.140516)"
2022,Diciembre,Hungría,348,2,3,,5,"(6.171601,-75.427454)"
2022,Diciembre,India,356,2,2,,4,"(3.541112,-76.384584)"
2022,Diciembre,India,356,45,38,,83,"(4.697144,-74.140516)"
2022,Diciembre,India,356,4,4,,8,"(6.171601,-75.427454)"
2022,Diciembre,Indonesia,360,0,1,,1,"(10.886611,-74.776708)"
2022,Diciembre,Indonesia,360,1,1,,2,"(3.541112,-76.384584)"
2022,Diciembre,Indonesia,360,14,7,,21,"(4.697144,-74.140516)"
2022,Diciembre,Indonesia,360,1,1,,2,"(6.171601,-75.427454)"
2022,Diciembre,Iraq,368,0,3,,3,"(4.697144,-74.140516)"
2022,Diciembre,República de Irlanda,372,3,1,,4,"(10.445761,-75.516429)"
2022,Diciembre,República de Irlanda,372,0,1,,1,"(11.117806,-74.232622)"
2022,Diciembre,República de Irlanda,372,2,1,,3,"(3.541112,-76.384584)"
2022,Diciembre,República de Irlanda,372,30,15,,45,"(4.697144,-74.140516)"
2022,Diciembre,República de Irlanda,372,5,3,,8,"(6.171601,-75.427454)"
2022,Diciembre,Islandia,352,11,9,,20,"(4.697144,-74.140516)"
2022,Diciembre,Islandia,352,1,1,,2,"(4.815061,-75.736532)"
2022,Diciembre,Islandia,352,1,0,,1,"(6.171601,-75.427454)"
2022,Diciembre,Israel,376,3,2,,5,"(10.445761,-75.516429)"
2022,Diciembre,Israel,376,1,1,,2,"(10.886611,-74.776708)"
2022,Diciembre,Israel,376,2,3,,5,"(3.541112,-76.384584)"
2022,Diciembre,Israel,376,186,124,,310,"(4.697144,-74.140516)"
2022,Diciembre,Israel,376,9,6,,15,"(6.171601,-75.427454)"
2022,Diciembre,Islas Aland/Provincia de Finlandia,248,1,0,,1,"(4.697144,-74.140516)"
2022,Diciembre,Italia,380,64,28,,92,"(10.445761,-75.516429)"
2022,Diciembre,Italia,380,5,1,,6,"(10.886611,-74.776708)"
2022,Diciembre,Italia,380,1,3,,4,"(11.117806,-74.232622)"
2022,Diciembre,Italia,380,1,0,,1,"(12.586067,-81.702563)"
2022,Diciembre,Italia,380,111,48,,159,"(3.541112,-76.384584)"
2022,Diciembre,Italia,380,1,3,,4,"(4.452882,-75.766298)"
2022,Diciembre,Italia,380,853,631,,1484,"(4.697144,-74.140516)"
2022,Diciembre,Italia,380,2,2,,4,"(4.815061,-75.736532)"
2022,Diciembre,Italia,380,145,77,,222,"(6.171601,-75.427454)"
2022,Diciembre,Islas Feroe/Región Autónoma de Dinamarca,234,1,1,,2,"(4.697144,-74.140516)"
2022,Diciembre,Jamaica,388,0,2,,2,"(10.408582,-75.538003)"
2022,Diciembre,Jamaica,388,5,9,,14,"(10.445761,-75.516429)"
2022,Diciembre,Jamaica,388,3,9,,12,"(10.886611,-74.776708)"
2022,Diciembre,Jamaica,388,1,1,,2,"(12.586067,-81.702563)"
2022,Diciembre,Jamaica,388,7,3,,10,"(3.541112,-76.384584)"
2022,Diciembre,Jamaica,388,63,50,,113,"(4.697144,-74.140516)"
2022,Diciembre,Jamaica,388,2,0,,2,"(4.815061,-75.736532)"
2022,Diciembre,Jamaica,388,2,4,,6,"(6.17134,-75.427194)"
2022,Diciembre,Jamaica,388,18,15,,33,"(6.171601,-75.427454)"
2022,Diciembre,Jamaica,388,1,0,,1,"(7.128456,-73.183637)"
2022,Diciembre,Japón,392,1,2,,3,"(10.445761,-75.516429)"
2022,Diciembre,Japón,392,1,1,,2,"(10.886611,-74.776708)"
2022,Diciembre,Japón,392,3,0,,3,"(3.541112,-76.384584)"
2022,Diciembre,Japón,392,38,28,,66,"(4.697144,-74.140516)"
2022,Diciembre,Japón,392,0,1,,1,"(4.815061,-75.736532)"
2022,Diciembre,Japón,392,2,0,,2,"(6.171601,-75.427454)"
2022,Diciembre,Jordania,400,5,5,,10,"(4.697144,-74.140516)"
2022,Diciembre,Jordania,400,2,0,,2,"(6.171601,-75.427454)"
2022,Diciembre,Kazajistán,398,1,0,,1,"(10.445761,-75.516429)"
2022,Diciembre,Kazajistán,398,1,6,,7,"(4.697144,-74.140516)"
2022,Diciembre,Kenia,404,1,0,,1,"(3.541112,-76.384584)"
2022,Diciembre,Kenia,404,18,11,,29,"(4.697144,-74.140516)"
2022,Diciembre,Kuwait,414,0,4,,4,"(4.697144,-74.140516)"
2022,Diciembre,República Democrática Popular  Lao,418,3,0,,3,"(4.697144,-74.140516)"
2022,Diciembre,Lituania,440,3,2,,5,"(4.697144,-74.140516)"
2022,Diciembre,Líbano,422,0,1,,1,"(10.445761,-75.516429)"
2022,Diciembre,Líbano,422,0,1,,1,"(11.117806,-74.232622)"
2022,Diciembre,Líbano,422,0,1,,1,"(3.541112,-76.384584)"
2022,Diciembre,Líbano,422,10,15,,25,"(4.697144,-74.140516)"
2022,Diciembre,Luxemburgo,442,1,0,,1,"(10.445761,-75.516429)"
2022,Diciembre,Luxemburgo,442,1,0,,1,"(3.541112,-76.384584)"
2022,Diciembre,Luxemburgo,442,22,12,,34,"(4.697144,-74.140516)"
2022,Diciembre,Luxemburgo,442,0,3,,3,"(6.171601,-75.427454)"
2022,Diciembre,Macao,446,18,4,,22,"(6.171601,-75.427454)"
2022,Diciembre,Malasia,458,3,5,,8,"(4.697144,-74.140516)"
2022,Diciembre,Maldivas,462,2,4,,6,"(4.697144,-74.140516)"
2022,Diciembre,Maldivas,462,1,2,,3,"(6.171601,-75.427454)"
2022,Diciembre,Malta,470,0,1,,1,"(10.445761,-75.516429)"
2022,Diciembre,Malta,470,0,1,,1,"(10.886611,-74.776708)"
2022,Diciembre,Malta,470,1,3,,4,"(3.541112,-76.384584)"
2022,Diciembre,Malta,470,105,77,,182,"(4.697144,-74.140516)"
2022,Diciembre,Malta,470,7,6,,13,"(6.171601,-75.427454)"
2022,Diciembre,Marruecos,504,1,0,,1,"(3.541112,-76.384584)"
2022,Diciembre,Marruecos,504,35,18,,53,"(4.697144,-74.140516)"
2022,Diciembre,Marruecos,504,1,1,,2,"(6.171601,-75.427454)"
2022,Diciembre,Mauricio,480,0,3,,3,"(4.697144,-74.140516)"
2022,Diciembre,Mauritania,478,0,2,,2,"(4.697144,-74.140516)"
2022,Diciembre,Martinica/Departamento de Ultramar Francés,474,1,3,,4,"(3.541112,-76.384584)"
2022,Diciembre,Martinica/Departamento de Ultramar Francés,474,1,3,,4,"(4.697144,-74.140516)"
2022,Diciembre,Martinica/Departamento de Ultramar Francés,474,0,1,,1,"(6.171601,-75.427454)"
2022,Diciembre,México,484,336,265,,601,"(10.445761,-75.516429)"
2022,Diciembre,México,484,263,212,,475,"(10.886611,-74.776708)"
2022,Diciembre,México,484,23,19,,42,"(11.117806,-74.232622)"
2022,Diciembre,México,484,2,1,,3,"(12.586067,-81.702563)"
2022,Diciembre,México,484,2053,1680,,3733,"(3.541112,-76.384584)"
2022,Diciembre,México,484,27,23,,50,"(4.452882,-75.766298)"
2022,Diciembre,México,484,24157,21375,,45532,"(4.697144,-74.140516)"
2022,Diciembre,México,484,235,199,,434,"(4.815061,-75.736532)"
2022,Diciembre,México,484,10247,8564,,18811,"(6.171601,-75.427454)"
2022,Diciembre,México,484,94,74,,168,"(7.128456,-73.183637)"
2022,Diciembre,México,484,28,23,,51,"(7.927209,-72.507910)"
2022,Diciembre,República de Moldavia,498,1,1,,2,"(4.697144,-74.140516)"
2022,Diciembre,Mozambique,508,1,0,,1,"(4.697144,-74.140516)"
2022,Diciembre,Mozambique,508,1,2,,3,"(6.171601,-75.427454)"
2022,Diciembre,Nicaragua,558,0,1,,1,"(10.445761,-75.516429)"
2022,Diciembre,Nicaragua,558,1,0,,1,"(11.117806,-74.232622)"
2022,Diciembre,Nicaragua,558,2,4,,6,"(3.541112,-76.384584)"
2022,Diciembre,Nicaragua,558,28,32,,60,"(4.697144,-74.140516)"
2022,Diciembre,Nicaragua,558,0,3,,3,"(4.815061,-75.736532)"
2022,Diciembre,Nicaragua,558,10,14,,24,"(6.171601,-75.427454)"
2022,Diciembre,Nicaragua,558,2,0,,2,"(7.128456,-73.183637)"
2022,Diciembre,Nigeria,566,1,1,,2,"(4.697144,-74.140516)"
2022,Diciembre,Noruega,578,13,5,,18,"(10.445761,-75.516429)"
2022,Diciembre,Noruega,578,3,1,,4,"(10.886611,-74.776708)"
2022,Diciembre,Noruega,578,7,4,,11,"(3.541112,-76.384584)"
2022,Diciembre,Noruega,578,54,34,,88,"(4.697144,-74.140516)"
2022,Diciembre,Noruega,578,1,0,,1,"(4.815061,-75.736532)"
2022,Diciembre,Noruega,578,10,4,,14,"(6.171601,-75.427454)"
2022,Diciembre,Nueva Caledonia/Territorio francés,540,1,3,,4,"(4.697144,-74.140516)"
2022,Diciembre,Nueva Zelanda,554,53,36,,89,"(4.697144,-74.140516)"
2022,Diciembre,Nueva Zelanda,554,0,2,,2,"(6.171601,-75.427454)"
2022,Diciembre,Omán,512,9,3,,12,"(4.697144,-74.140516)"
2022,Diciembre,Pakistán,586,2,0,,2,"(4.697144,-74.140516)"
2022,Diciembre,Panamá,591,15,60,,75,"(10.408582,-75.538003)"
2022,Diciembre,Panamá,591,915,748,,1663,"(10.445761,-75.516429)"
2022,Diciembre,Panamá,591,1362,1109,,2471,"(10.886611,-74.776708)"
2022,Diciembre,Panamá,591,0,3,,3,"(10.971302,-74.765397)"
2022,Diciembre,Panamá,591,81,60,,141,"(11.117806,-74.232622)"
2022,Diciembre,Panamá,591,0,2,,2,"(12.165168,-71.983761)"
2022,Diciembre,Panamá,591,2,17,,19,"(12.5744111,-81.703935)"
2022,Diciembre,Panamá,591,20,16,,36,"(12.586067,-81.702563)"
2022,Diciembre,Panamá,591,2210,1673,,3883,"(3.541112,-76.384584)"
2022,Diciembre,Panamá,591,0,1,,1,"(3.893038,-77.067921)"
2022,Diciembre,Panamá,591,149,93,,242,"(4.452882,-75.766298)"
2022,Diciembre,Panamá,591,7578,7072,,14650,"(4.697144,-74.140516)"
2022,Diciembre,Panamá,591,379,283,,662,"(4.815061,-75.736532)"
2022,Diciembre,Panamá,591,4,5,,9,"(6.17134,-75.427194)"
2022,Diciembre,Panamá,591,3296,2788,,6084,"(6.171601,-75.427454)"
2022,Diciembre,Panamá,591,25,24,,49,"(7.102626,-77.762647)"
2022,Diciembre,Panamá,591,104,82,,186,"(7.128456,-73.183637)"
2022,Diciembre,Panamá,591,107,59,,166,"(7.927209,-72.507910)"
2022,Diciembre,Panamá,591,37,54,,91,"(8.635765,-77.346578)"
2022,Diciembre,Paraguay,600,5,5,,10,"(10.445761,-75.516429)"
2022,Diciembre,Paraguay,600,1,4,,5,"(10.886611,-74.776708)"
2022,Diciembre,Paraguay,600,2,2,,4,"(11.117806,-74.232622)"
2022,Diciembre,Paraguay,600,35,34,,69,"(3.541112,-76.384584)"
2022,Diciembre,Paraguay,600,4,2,,6,"(4.452882,-75.766298)"
2022,Diciembre,Paraguay,600,224,292,,516,"(4.697144,-74.140516)"
2022,Diciembre,Paraguay,600,4,3,,7,"(4.815061,-75.736532)"
2022,Diciembre,Paraguay,600,13,6,,19,"(6.171601,-75.427454)"
2022,Diciembre,Paraguay,600,3,2,,5,"(7.128456,-73.183637)"
2022,Diciembre,Perú,604,3,1,,4,"(-0.193180,-74.784874)"
2022,Diciembre,Perú,604,98,92,,190,"(-4.197703,-69.941278)"
2022,Diciembre,Perú,604,93,62,,155,"(-4.223468,-69.945098)"
2022,Diciembre,Perú,604,4,4,,8,"(0.25129,-76.875963)"
2022,Diciembre,Perú,604,50,40,,90,"(0.814836,-77.662532)"
2022,Diciembre,Perú,604,0,2,,2,"(1.813928,-78.763924)"
2022,Diciembre,Perú,604,70,51,,121,"(10.445761,-75.516429)"
2022,Diciembre,Perú,604,19,17,,36,"(10.886611,-74.776708)"
2022,Diciembre,Perú,604,1,0,,1,"(11.117806,-74.232622)"
2022,Diciembre,Perú,604,1,0,,1,"(12.586067,-81.702563)"
2022,Diciembre,Perú,604,248,214,,462,"(3.541112,-76.384584)"
2022,Diciembre,Perú,604,6,9,,15,"(4.452882,-75.766298)"
2022,Diciembre,Perú,604,4229,4029,,8258,"(4.697144,-74.140516)"
2022,Diciembre,Perú,604,16,11,,27,"(4.815061,-75.736532)"
2022,Diciembre,Perú,604,1278,960,,2238,"(6.171601,-75.427454)"
2022,Diciembre,Perú,604,3,5,,8,"(7.128456,-73.183637)"
2022,Diciembre,Perú,604,4,2,,6,"(7.927209,-72.507910)"
2022,Diciembre,Palestina,99999,1,1,,2,"(6.171601,-75.427454)"
2022,Diciembre,Polonia,616,2,2,,4,"(10.445761,-75.516429)"
2022,Diciembre,Polonia,616,0,1,,1,"(10.886611,-74.776708)"
2022,Diciembre,Polonia,616,1,0,,1,"(11.117806,-74.232622)"
2022,Diciembre,Polonia,616,1,10,,11,"(3.541112,-76.384584)"
2022,Diciembre,Polonia,616,75,150,,225,"(4.697144,-74.140516)"
2022,Diciembre,Polonia,616,3,7,,10,"(6.171601,-75.427454)"
2022,Diciembre,Portugal,620,7,4,,11,"(10.445761,-75.516429)"
2022,Diciembre,Portugal,620,15,10,,25,"(3.541112,-76.384584)"
2022,Diciembre,Portugal,620,271,211,,482,"(4.697144,-74.140516)"
2022,Diciembre,Portugal,620,1,0,,1,"(4.815061,-75.736532)"
2022,Diciembre,Portugal,620,58,37,,95,"(6.171601,-75.427454)"
2022,Diciembre,Puerto Rico/Territorio de Estados Unidos,630,8,7,,15,"(10.445761,-75.516429)"
2022,Diciembre,Puerto Rico/Territorio de Estados Unidos,630,16,14,,30,"(10.886611,-74.776708)"
2022,Diciembre,Puerto Rico/Territorio de Estados Unidos,630,1,0,,1,"(11.117806,-74.232622)"
2022,Diciembre,Puerto Rico/Territorio de Estados Unidos,630,66,45,,111,"(3.541112,-76.384584)"
2022,Diciembre,Puerto Rico/Territorio de Estados Unidos,630,1,3,,4,"(4.452882,-75.766298)"
2022,Diciembre,Puerto Rico/Territorio de Estados Unidos,630,556,493,,1049,"(4.697144,-74.140516)"
2022,Diciembre,Puerto Rico/Territorio de Estados Unidos,630,52,44,,96,"(6.171601,-75.427454)"
2022,Diciembre,Puerto Rico/Territorio de Estados Unidos,630,4,0,,4,"(7.128456,-73.183637)"
2022,Diciembre,Qatar,634,3,7,,10,"(10.445761,-75.516429)"
2022,Diciembre,Qatar,634,1,2,,3,"(10.886611,-74.776708)"
2022,Diciembre,Qatar,634,0,3,,3,"(3.541112,-76.384584)"
2022,Diciembre,Qatar,634,65,126,,191,"(4.697144,-74.140516)"
2022,Diciembre,Qatar,634,5,10,,15,"(6.171601,-75.427454)"
2022,Diciembre,Qatar,634,1,0,,1,"(7.128456,-73.183637)"
2022,Diciembre,Reino Unido de Gran Bretaña e Irlanda del Norte,826,11,6,,17,"(10.445761,-75.516429)"
2022,Diciembre,Reino Unido de Gran Bretaña e Irlanda del Norte,826,3,2,,5,"(10.886611,-74.776708)"
2022,Diciembre,Reino Unido de Gran Bretaña e Irlanda del Norte,826,17,12,,29,"(3.541112,-76.384584)"
2022,Diciembre,Reino Unido de Gran Bretaña e Irlanda del Norte,826,2529,1820,,4349,"(4.697144,-74.140516)"
2022,Diciembre,Reino Unido de Gran Bretaña e Irlanda del Norte,826,2,0,,2,"(4.815061,-75.736532)"
2022,Diciembre,Reino Unido de Gran Bretaña e Irlanda del Norte,826,70,52,,122,"(6.171601,-75.427454)"
2022,Diciembre,República CentroÁfricana,140,0,1,,1,"(10.445761,-75.516429)"
2022,Diciembre,República CentroÁfricana,140,3,3,,6,"(4.697144,-74.140516)"
2022,Diciembre,Federación de Rusia,643,4,9,,13,"(4.697144,-74.140516)"
2022,Diciembre,República Dominicana,214,0,1,,1,"(10.408582,-75.538003)"
2022,Diciembre,República Dominicana,214,141,119,,260,"(10.445761,-75.516429)"
2022,Diciembre,República Dominicana,214,451,414,,865,"(10.886611,-74.776708)"
2022,Diciembre,República Dominicana,214,19,23,,42,"(11.117806,-74.232622)"
2022,Diciembre,República Dominicana,214,785,624,,1409,"(3.541112,-76.384584)"
2022,Diciembre,República Dominicana,214,2,3,,5,"(4.452882,-75.766298)"
2022,Diciembre,República Dominicana,214,8299,7009,,15308,"(4.697144,-74.140516)"
2022,Diciembre,República Dominicana,214,82,75,,157,"(4.815061,-75.736532)"
2022,Diciembre,República Dominicana,214,5787,4359,,10146,"(6.171601,-75.427454)"
2022,Diciembre,República Dominicana,214,54,42,,96,"(7.128456,-73.183637)"
2022,Diciembre,República Dominicana,214,5,0,,5,"(7.927209,-72.507910)"
2022,Diciembre,República Democrática Popular de Corea,408,0,1,,1,"(6.171601,-75.427454)"
2022,Diciembre,Rumania,642,1,0,,1,"(10.445761,-75.516429)"
2022,Diciembre,Rumania,642,1,0,,1,"(3.541112,-76.384584)"
2022,Diciembre,Rumania,642,12,3,,15,"(4.697144,-74.140516)"
2022,Diciembre,Rumania,642,5,2,,7,"(6.171601,-75.427454)"
2022,Diciembre,Rumania,642,0,1,,1,"(7.128456,-73.183637)"
2022,Diciembre,San Pedro y Miquelón/territorio de Ultramar de La Unión Europea,666,1,0,,1,"(4.697144,-74.140516)"
2022,Diciembre,San Cristóbal y Nevis,659,0,3,,3,"(10.445761,-75.516429)"
2022,Diciembre,San Cristóbal y Nevis,659,0,2,,2,"(4.697144,-74.140516)"
2022,Diciembre,San Cristóbal y Nevis,659,2,1,,3,"(7.088729,-70.740253)"
2022,Diciembre,San Cristóbal y Nevis,659,5,8,,13,"(7.818934,-72.453226)"
2022,Diciembre,San Marino,674,2,2,,4,"(4.697144,-74.140516)"
2022,Diciembre,San  Vicente y las Granadinas,670,0,1,,1,"(4.697144,-74.140516)"
2022,Diciembre,Santa Lucia,662,1,3,,4,"(4.697144,-74.140516)"
2022,Diciembre,Santa Sede/Ciudad del Vaticano,336,1,2,,3,"(4.697144,-74.140516)"
2022,Diciembre,Santo Tomé y Príncipe,678,1,0,,1,"(3.541112,-76.384584)"
2022,Diciembre,Serbia,688,1,0,,1,"(3.541112,-76.384584)"
2022,Diciembre,Serbia,688,3,0,,3,"(4.697144,-74.140516)"
2022,Diciembre,Singapur,702,1,0,,1,"(3.541112,-76.384584)"
2022,Diciembre,Singapur,702,32,23,,55,"(4.697144,-74.140516)"
2022,Diciembre,Singapur,702,1,0,,1,"(4.815061,-75.736532)"
2022,Diciembre,Singapur,702,3,0,,3,"(6.171601,-75.427454)"
2022,Diciembre,Sudáfrica,710,5,8,,13,"(4.697144,-74.140516)"
2022,Diciembre,Sudáfrica,710,0,1,,1,"(6.171601,-75.427454)"
2022,Diciembre,Suecia,752,0,1,,1,"(0.814836,-77.662532)"
2022,Diciembre,Suecia,752,15,4,,19,"(10.445761,-75.516429)"
2022,Diciembre,Suecia,752,1,0,,1,"(10.886611,-74.776708)"
2022,Diciembre,Suecia,752,1,0,,1,"(11.117806,-74.232622)"
2022,Diciembre,Suecia,752,14,8,,22,"(3.541112,-76.384584)"
2022,Diciembre,Suecia,752,91,69,,160,"(4.697144,-74.140516)"
2022,Diciembre,Suecia,752,10,8,,18,"(6.171601,-75.427454)"
2022,Diciembre,Suiza,756,32,19,,51,"(10.445761,-75.516429)"
2022,Diciembre,Suiza,756,11,8,,19,"(10.886611,-74.776708)"
2022,Diciembre,Suiza,756,85,43,,128,"(3.541112,-76.384584)"
2022,Diciembre,Suiza,756,0,1,,1,"(4.452882,-75.766298)"
2022,Diciembre,Suiza,756,417,264,,681,"(4.697144,-74.140516)"
2022,Diciembre,Suiza,756,1,3,,4,"(4.815061,-75.736532)"
2022,Diciembre,Suiza,756,89,44,,133,"(6.171601,-75.427454)"
2022,Diciembre,Suiza,756,1,0,,1,"(7.927209,-72.507910)"
2022,Diciembre,Surinam,740,3,0,,3,"(10.445761,-75.516429)"
2022,Diciembre,Surinam,740,0,1,,1,"(10.886611,-74.776708)"
2022,Diciembre,Surinam,740,2,1,,3,"(3.541112,-76.384584)"
2022,Diciembre,Surinam,740,5,11,,16,"(4.697144,-74.140516)"
2022,Diciembre,Surinam,740,0,1,,1,"(4.815061,-75.736532)"
2022,Diciembre,Surinam,740,0,1,,1,"(6.171601,-75.427454)"
2022,Diciembre,Surinam,740,2,0,,2,"(7.128456,-73.183637)"
2022,Diciembre,Taiwán,158,0,1,,1,"(3.541112,-76.384584)"
2022,Diciembre,Taiwán,158,0,4,,4,"(4.697144,-74.140516)"
2022,Diciembre,República de Tayikistán,762,0,1,,1,"(4.697144,-74.140516)"
2022,Diciembre,Tailandia,764,1,0,,1,"(10.445761,-75.516429)"
2022,Diciembre,Tailandia,764,4,4,,8,"(3.541112,-76.384584)"
2022,Diciembre,Tailandia,764,27,26,,53,"(4.697144,-74.140516)"
2022,Diciembre,Tailandia,764,1,0,,1,"(4.815061,-75.736532)"
2022,Diciembre,Tanzania,834,1,0,,1,"(10.445761,-75.516429)"
2022,Diciembre,Tanzania,834,2,1,,3,"(4.697144,-74.140516)"
2022,Diciembre,Trinidad y Tobago,780,1,2,,3,"(10.445761,-75.516429)"
2022,Diciembre,Trinidad y Tobago,780,2,0,,2,"(10.886611,-74.776708)"
2022,Diciembre,Trinidad y Tobago,780,1,3,,4,"(3.541112,-76.384584)"
2022,Diciembre,Trinidad y Tobago,780,2,3,,5,"(4.452882,-75.766298)"
2022,Diciembre,Trinidad y Tobago,780,12,14,,26,"(4.697144,-74.140516)"
2022,Diciembre,Trinidad y Tobago,780,1,0,,1,"(4.815061,-75.736532)"
2022,Diciembre,Trinidad y Tobago,780,6,9,,15,"(6.171601,-75.427454)"
2022,Diciembre,Trinidad y Tobago,780,1,0,,1,"(7.128456,-73.183637)"
2022,Diciembre,Trinidad y Tobago,780,0,2,,2,"(7.927209,-72.507910)"
2022,Diciembre,Túnez,788,1,1,,2,"(4.697144,-74.140516)"
2022,Diciembre,Túnez,788,1,0,,1,"(6.171601,-75.427454)"
2022,Diciembre,Turquía,792,0,3,,3,"(10.408582,-75.538003)"
2022,Diciembre,Turquía,792,1,0,,1,"(10.445761,-75.516429)"
2022,Diciembre,Turquía,792,1,0,,1,"(10.886611,-74.776708)"
2022,Diciembre,Turquía,792,4,4,,8,"(3.541112,-76.384584)"
2022,Diciembre,Turquía,792,1661,1139,,2800,"(4.697144,-74.140516)"
2022,Diciembre,Turquía,792,6,4,,10,"(6.171601,-75.427454)"
2022,Diciembre,Turkmenistán,795,4,0,,4,"(4.697144,-74.140516)"
2022,Diciembre,Turkmenistán,795,0,1,,1,"(6.171601,-75.427454)"
2022,Diciembre,Ucrania,804,0,1,,1,"(4.697144,-74.140516)"
2022,Diciembre,Uganda,800,0,1,,1,"(10.445761,-75.516429)"
2022,Diciembre,Uganda,800,0,1,,1,"(4.697144,-74.140516)"
2022,Diciembre,Uruguay,858,5,7,,12,"(10.445761,-75.516429)"
2022,Diciembre,Uruguay,858,6,4,,10,"(10.886611,-74.776708)"
2022,Diciembre,Uruguay,858,38,40,,78,"(3.541112,-76.384584)"
2022,Diciembre,Uruguay,858,1,0,,1,"(4.452882,-75.766298)"
2022,Diciembre,Uruguay,858,403,355,,758,"(4.697144,-74.140516)"
2022,Diciembre,Uruguay,858,12,13,,25,"(4.815061,-75.736532)"
2022,Diciembre,Uruguay,858,28,18,,46,"(6.171601,-75.427454)"
2022,Diciembre,Uruguay,858,1,2,,3,"(7.128456,-73.183637)"
2022,Diciembre,Uzbekistán,860,1,0,,1,"(4.697144,-74.140516)"
2022,Diciembre,Venezuela,862,12,3,,15,"(10.445761,-75.516429)"
2022,Diciembre,Venezuela,862,19,24,,43,"(10.886611,-74.776708)"
2022,Diciembre,Venezuela,862,914,1285,,2199,"(11.360009,-72.129330)"
2022,Diciembre,Venezuela,862,18,34,,52,"(3.541112,-76.384584)"
2022,Diciembre,Venezuela,862,10,6,,16,"(3.866713,-67.927521)"
2022,Diciembre,Venezuela,862,2,3,,5,"(4.452882,-75.766298)"
2022,Diciembre,Venezuela,862,288,599,,887,"(4.697144,-74.140516)"
2022,Diciembre,Venezuela,862,10,6,,16,"(4.815061,-75.736532)"
2022,Diciembre,Venezuela,862,56,58,,114,"(6.171601,-75.427454)"
2022,Diciembre,Venezuela,862,26,32,,58,"(6.18189,-67.47535)"
2022,Diciembre,Venezuela,862,177,250,,427,"(7.088729,-70.740253)"
2022,Diciembre,Venezuela,862,5,9,,14,"(7.128456,-73.183637)"
2022,Diciembre,Venezuela,862,1357,1776,,3133,"(7.818934,-72.453226)"
2022,Diciembre,Venezuela,862,376,418,,794,"(7.916725,-72.462544)"
2022,Diciembre,Venezuela,862,22,12,,34,"(7.927209,-72.507910)"
2022,Diciembre,Venezuela,862,136,208,,344,"(8.36068,-72.409396)"
2022,Diciembre,Vietnam,704,11,8,,19,"(4.697144,-74.140516)"
2022,Diciembre,Vietnam,704,1,1,,2,"(6.171601,-75.427454)"
2022,Diciembre,Islas Vírgenes Británicas/Territorio Británico de Ultramar,92,1,7,,8,"(10.445761,-75.516429)"
2022,Diciembre,Islas Vírgenes Británicas/Territorio Británico de Ultramar,92,1,1,,2,"(4.697144,-74.140516)"
2022,Diciembre,Islas Vírgenes Británicas/Territorio Británico de Ultramar,92,1,0,,1,"(6.171601,-75.427454)"
2022,Diciembre,Islas Vírgenes Estadounidenses/Territorio de Estados Unidos,850,1,1,,2,"(4.697144,-74.140516)"
2022,Diciembre,Anguila/Territorio Británico de Ultramar,660,1,4,,5,"(3.541112,-76.384584)"
2022,Diciembre,Anguila/Territorio Británico de Ultramar,660,3,7,,10,"(4.697144,-74.140516)"
2022,Diciembre,Islas Turcas y Caicos/Territorio Británico de Ultramar,796,10,7,,17,"(3.541112,-76.384584)"
2022,Diciembre,Islas Turcas y Caicos/Territorio Británico de Ultramar,796,2,6,,8,"(4.697144,-74.140516)"
2022,Diciembre,Islas Turcas y Caicos/Territorio Británico de Ultramar,796,2,0,,2,"(6.171601,-75.427454)"
2022,Diciembre,Desconocido,99999,1,0,,1,"(10.445761,-75.516429)"
2022,Diciembre,Desconocido,99999,2,1,,3,"(6.171601,-75.427454)"
